Gamecode,CODETEAM,J1,J2,TIME,DELTA_SCORE,OFF,DEF
1,TSO,P008790,P009649,12.6,4,32,28
1,TSO,P008790,P012019,13.767,5,33,28
1,TSO,P008790,P013293,8.533,7,23,16
1,TSO,P008790,P013295,7.683,-3,20,23
1,TSO,P008790,P013297,8.417,11,20,9
1,TSO,P008790,P013298,13.4,8,32,24
1,TSO,P009649,P012019,30.201,-13,54,67
1,TSO,P009649,P013293,28.367,-1,62,63
1,TSO,P009649,P013295,30.667,-10,64,74
1,TSO,P009649,P013296,28.301,-13,51,64
1,TSO,P009649,P013297,10.234,1,19,18
1,TSO,P009649,P013298,23.234,-4,50,54
1,TSO,P012019,P013293,21.767,1,43,42
1,TSO,P012019,P013295,22.633,-10,43,53
1,TSO,P012019,P013296,20.534,-12,31,43
1,TSO,P012019,P013297,11.668,3,21,18
1,TSO,P012019,P013298,16.634,-2,31,33
1,TSO,P013293,P013295,25.25,-1,58,59
1,TSO,P013293,P013296,23.934,-2,49,51
1,TSO,P013293,P013297,7.217,6,14,8
1,TSO,P013293,P013298,14.8,10,39,29
1,TSO,P013295,P013296,23.667,-6,47,53
1,TSO,P013295,P013298,15.5,-6,36,42
1,TSO,P013296,P013297,5.234,-5,6,11
1,TSO,P013296,P013298,13.934,-6,28,34
1,TSO,P013297,P013298,11.834,8,24,16
1,ULM,P006245,P006997,12.383,11,30,19
1,ULM,P006245,P007952,1.433,0,0,0
1,ULM,P006245,P010726,0.85,0,2,2
1,ULM,P006245,P011391,5.899,7,13,6
1,ULM,P006245,P011437,8.366,8,24,16
1,ULM,P006245,P012077,0.3,0,0,0
1,ULM,P006245,P012602,5.433,6,9,3
1,ULM,P006245,P013289,0.4,2,2,0
1,ULM,P006245,P013290,14.483,10,31,21
1,ULM,P006245,P013291,9.317,4,21,17
1,ULM,P006997,P010726,1.467,-2,0,2
1,ULM,P006997,P011391,8.883,9,22,13
1,ULM,P006997,P011437,20.7,8,45,37
1,ULM,P006997,P012077,10.017,-1,18,19
1,ULM,P006997,P012602,4.867,6,9,3
1,ULM,P006997,P013289,0.45,-3,0,3
1,ULM,P006997,P013290,24.717,11,51,40
1,ULM,P006997,P013291,15.384,5,29,24
1,ULM,P007952,P010726,1.9,-5,7,12
1,ULM,P007952,P011391,6.816,-14,11,25
1,ULM,P007952,P011437,3.483,-9,4,13
1,ULM,P007952,P012077,5.383,-14,11,25
1,ULM,P007952,P012602,3.066,-6,2,8
1,ULM,P007952,P013290,5.183,-8,9,17
1,ULM,P010726,P011391,4.699,-5,14,19
1,ULM,P010726,P011437,4.066,1,7,6
1,ULM,P010726,P012077,5.7,-8,11,19
1,ULM,P010726,P012602,1.099,5,7,2
1,ULM,P010726,P013289,4.899,2,11,9
1,ULM,P010726,P013290,4.817,-8,9,17
1,ULM,P010726,P013291,3.567,0,4,4
1,ULM,P011391,P011437,20.849,4,51,47
1,ULM,P011391,P012077,15.6,-9,37,46
1,ULM,P011391,P012602,10.065,-4,18,22
1,ULM,P011391,P013289,7.299,2,17,15
1,ULM,P011391,P013290,24.083,4,56,52
1,ULM,P011391,P013291,4.067,2,13,11
1,ULM,P011437,P012077,20.75,-2,43,45
1,ULM,P011437,P012602,6.966,-7,13,20
1,ULM,P011437,P013289,7.999,0,17,17
1,ULM,P011437,P013290,30.45,10,69,59
1,ULM,P011437,P013291,17.567,7,39,32
1,ULM,P012077,P012602,1.633,-6,2,8
1,ULM,P012077,P013289,5.35,-1,9,10
1,ULM,P012077,P013290,19.351,-4,44,48
1,ULM,P012077,P013291,11.384,5,25,20
1,ULM,P012602,P013289,4.499,2,12,10
1,ULM,P012602,P013290,10.733,4,17,13
1,ULM,P012602,P013291,3.367,4,7,3
1,ULM,P013289,P013290,6.4,-2,12,14
1,ULM,P013289,P013291,2.1,2,4,2
1,ULM,P013290,P013291,19.451,7,42,35
2,HTA,P001927,P005181,25.565,9,58,49
2,HTA,P001927,P009818,11.15,-10,16,26
2,HTA,P001927,P010386,16.633,-13,26,39
2,HTA,P001927,P010550,8.699,-2,12,14
2,HTA,P001927,P011157,19.416,-13,29,42
2,HTA,P001927,P011386,3.167,0,3,3
2,HTA,P001927,P012096,19.566,12,44,32
2,HTA,P001927,P013283,8.083,14,24,10
2,HTA,P001927,P013284,22.849,-1,48,49
2,HTA,P005181,P009818,11.433,-3,19,22
2,HTA,P005181,P010386,12.782,-5,25,30
2,HTA,P005181,P010550,4.899,0,9,9
2,HTA,P005181,P011157,13.499,-6,22,28
2,HTA,P005181,P011386,0.567,0,0,0
2,HTA,P005181,P012096,21.232,13,51,38
2,HTA,P005181,P013283,12.532,15,34,19
2,HTA,P005181,P013284,24.615,5,54,49
2,HTA,P009818,P010386,4.167,-7,4,11
2,HTA,P009818,P011157,10.967,-10,16,26
2,HTA,P009818,P012096,4.633,0,7,7
2,HTA,P009818,P013283,4.45,0,7,7
2,HTA,P009818,P013284,15.6,-10,23,33
2,HTA,P010386,P010550,4.416,2,9,7
2,HTA,P010386,P011157,8.983,-12,9,21
2,HTA,P010386,P012096,10.45,-5,20,25
2,HTA,P010386,P013283,3.216,-5,3,8
2,HTA,P010386,P013284,12.949,-15,20,35
2,HTA,P010550,P011157,2.966,-2,3,5
2,HTA,P010550,P011386,3.167,0,3,3
2,HTA,P010550,P012096,8.633,-4,10,14
2,HTA,P010550,P013283,1.95,-4,0,4
2,HTA,P010550,P013284,0.066,2,2,0
2,HTA,P011157,P011386,2.283,0,3,3
2,HTA,P011157,P012096,5.266,2,10,8
2,HTA,P011157,P013283,1.733,4,5,1
2,HTA,P011157,P013284,14.683,-15,19,34
2,HTA,P011386,P012096,3.167,0,3,3
2,HTA,P011386,P013283,0.317,0,0,0
2,HTA,P012096,P013283,13.733,12,34,22
2,HTA,P012096,P013284,14.316,10,37,27
2,HTA,P013283,P013284,11.182,12,29,17
2,JOV,P002361,P002507,13.883,4,31,27
2,JOV,P002361,P004834,4.983,-5,10,15
2,JOV,P002361,P005099,6.85,-15,9,24
2,JOV,P002361,P010161,11.799,11,31,20
2,JOV,P002361,P012349,1.15,-9,0,9
2,JOV,P002361,P012740,1.117,-7,0,7
2,JOV,P002361,P013285,15.049,0,32,32
2,JOV,P002361,P013287,17.782,4,41,37
2,JOV,P002361,PJUG,2.983,5,10,5
2,JOV,P002507,P005099,8.934,-5,14,19
2,JOV,P002507,P010161,13.816,16,34,18
2,JOV,P002507,P012349,4.017,1,6,5
2,JOV,P002507,P012740,4.334,1,6,5
2,JOV,P002507,P013285,22.0,12,49,37
2,JOV,P002507,P013286,1.317,0,0,0
2,JOV,P002507,P013287,18.666,11,43,32
2,JOV,P002507,PJUG,5.033,8,13,5
2,JOV,P004834,P005099,10.584,-11,15,26
2,JOV,P004834,P010161,6.383,4,14,10
2,JOV,P004834,P012349,8.517,-13,10,23
2,JOV,P004834,P012740,13.101,-9,19,28
2,JOV,P004834,P013285,4.55,-2,6,8
2,JOV,P004834,P013286,8.567,-2,14,16
2,JOV,P004834,P013287,8.45,6,19,13
2,JOV,P004834,PJUG,2.733,4,9,5
2,JOV,P005099,P012349,10.251,-12,13,25
2,JOV,P005099,P012740,13.785,-8,20,28
2,JOV,P005099,P013285,11.117,-7,18,25
2,JOV,P005099,P013286,7.601,-2,11,13
2,JOV,P005099,P013287,8.95,-4,16,20
2,JOV,P010161,P012349,2.316,-2,3,5
2,JOV,P010161,P012740,3.65,0,5,5
2,JOV,P010161,P013285,15.216,14,36,22
2,JOV,P010161,P013286,2.283,0,3,3
2,JOV,P010161,P013287,17.949,18,45,27
2,JOV,P010161,PJUG,7.516,11,21,10
2,JOV,P012349,P012740,12.534,-12,16,28
2,JOV,P012349,P013285,3.05,-1,6,7
2,JOV,P012349,P013286,8.4,-6,10,16
2,JOV,P012349,P013287,0.033,-2,0,2
2,JOV,P012740,P013285,6.751,1,11,10
2,JOV,P012740,P013286,9.884,-2,14,16
2,JOV,P012740,P013287,4.584,4,9,5
2,JOV,P013285,P013286,0.317,0,0,0
2,JOV,P013285,P013287,23.249,7,49,42
2,JOV,P013285,PJUG,5.033,8,13,5
2,JOV,P013286,P013287,1.167,4,4,0
2,JOV,P013287,PJUG,7.766,12,22,10
3,BAH,P003840,P004172,13.284,14,32,18
3,BAH,P003840,P008278,0.117,-3,0,3
3,BAH,P003840,P009601,19.618,8,48,40
3,BAH,P003840,P011192,19.434,10,41,31
3,BAH,P003840,P011201,9.784,-2,16,18
3,BAH,P003840,P011821,26.502,17,63,46
3,BAH,P003840,P011823,25.451,21,57,36
3,BAH,P003840,P012405,7.467,0,16,16
3,BAH,P003840,P012711,16.351,7,31,24
3,BAH,P004172,P009601,11.75,2,27,25
3,BAH,P004172,P011192,2.917,-4,0,4
3,BAH,P004172,P011201,9.9,1,15,14
3,BAH,P004172,P011821,11.467,3,25,22
3,BAH,P004172,P011823,11.784,12,28,16
3,BAH,P004172,P012405,7.0,-5,8,13
3,BAH,P004172,P012711,7.034,5,9,4
3,BAH,P008278,P009601,0.117,-3,0,3
3,BAH,P008278,P011201,0.117,-3,0,3
3,BAH,P008278,P012711,0.117,-3,0,3
3,BAH,P009601,P011192,9.984,2,22,20
3,BAH,P009601,P011201,6.367,-5,13,18
3,BAH,P009601,P011821,20.384,5,46,41
3,BAH,P009601,P011823,17.551,9,41,32
3,BAH,P009601,P012405,3.566,-3,8,11
3,BAH,P009601,P012711,1.467,-3,3,6
3,BAH,P011192,P011201,5.517,-4,2,6
3,BAH,P011192,P011821,16.951,10,39,29
3,BAH,P011192,P011823,14.667,5,29,24
3,BAH,P011192,P012405,7.567,1,12,11
3,BAH,P011192,P012711,12.367,4,19,15
3,BAH,P011201,P011821,4.367,-6,7,13
3,BAH,P011201,P011823,5.883,4,9,5
3,BAH,P011201,P012405,7.317,-8,8,16
3,BAH,P011201,P012711,9.884,-5,10,15
3,BAH,P011821,P011823,20.068,15,48,33
3,BAH,P011821,P012405,8.05,-3,16,19
3,BAH,P011821,P012711,10.551,7,24,17
3,BAH,P011823,P012711,8.4,10,16,6
3,BAH,P012405,P012711,8.901,-2,12,14
3,WOL,P003212,P004645,3.266,1,6,5
3,WOL,P003212,P005516,3.266,1,6,5
3,WOL,P003212,P006853,3.266,1,6,5
3,WOL,P003212,P008186,2.483,1,3,2
3,WOL,P003212,P012577,0.783,0,3,3
3,WOL,P004645,P005516,13.084,6,22,16
3,WOL,P004645,P006546,5.034,6,17,11
3,WOL,P004645,P006853,9.1,-1,11,12
3,WOL,P004645,P008186,13.134,11,26,15
3,WOL,P004645,P011248,6.667,-1,17,18
3,WOL,P004645,P012003,10.768,10,23,13
3,WOL,P004645,P012577,2.683,-4,6,10
3,WOL,P005516,P006546,4.601,3,10,7
3,WOL,P005516,P006853,9.6,-1,11,12
3,WOL,P005516,P008186,10.284,10,16,6
3,WOL,P005516,P011248,8.051,-9,10,19
3,WOL,P005516,P012003,10.352,7,16,9
3,WOL,P005516,P012577,7.417,-11,9,20
3,WOL,P005516,P012789,4.617,-10,0,10
3,WOL,P006546,P006853,0.117,0,0,0
3,WOL,P006546,P008186,8.784,3,24,21
3,WOL,P006546,P011248,24.601,-12,47,59
3,WOL,P006546,P012003,24.485,-2,54,56
3,WOL,P006546,P012577,21.751,-13,37,50
3,WOL,P006546,P012789,17.767,-13,27,40
3,WOL,P006853,P008186,6.3,3,5,2
3,WOL,P006853,P011248,1.9,-4,3,7
3,WOL,P006853,P012003,4.434,2,2,0
3,WOL,P006853,P012577,3.183,-4,6,10
3,WOL,P006853,P012789,0.5,0,0,0
3,WOL,P008186,P011248,8.634,0,21,21
3,WOL,P008186,P012003,14.518,7,30,23
3,WOL,P008186,P012577,3.867,-3,7,10
3,WOL,P011248,P012003,26.035,-10,51,61
3,WOL,P011248,P012577,25.468,-22,40,62
3,WOL,P011248,P012789,19.584,-18,27,45
3,WOL,P012003,P012577,21.768,-13,37,50
3,WOL,P012003,P012789,17.784,-13,27,40
3,WOL,P012577,P012789,20.084,-18,27,45
4,BES,P003783,P007914,15.133,16,44,28
4,BES,P003783,P008945,8.85,10,28,18
4,BES,P003783,P009680,12.15,12,38,26
4,BES,P003783,P010652,15.234,16,40,24
4,BES,P003783,P011379,1.75,-1,3,4
4,BES,P003783,P011927,5.3,1,7,6
4,BES,P003783,P011936,8.367,4,16,12
4,BES,P003783,P013255,2.084,-2,0,2
4,BES,P007914,P008945,10.766,7,30,23
4,BES,P007914,P009680,14.016,9,40,31
4,BES,P007914,P010652,13.15,18,40,22
4,BES,P007914,P011379,3.733,-4,5,9
4,BES,P007914,P011924,0.05,0,0,0
4,BES,P007914,P011927,3.333,3,7,4
4,BES,P007914,P011936,8.433,3,18,15
4,BES,P007914,P013255,0.05,0,0,0
4,BES,P008945,P009680,11.017,3,30,27
4,BES,P008945,P010652,17.167,16,49,33
4,BES,P008945,P011379,6.166,-7,11,18
4,BES,P008945,P011924,11.783,0,26,26
4,BES,P008945,P011927,12.316,6,30,24
4,BES,P008945,P011936,2.8,-1,6,7
4,BES,P008945,P013255,12.667,2,30,28
4,BES,P009680,P010652,11.351,16,38,22
4,BES,P009680,P011379,5.2,-1,10,11
4,BES,P009680,P011924,3.084,2,7,5
4,BES,P009680,P011927,1.433,-2,3,5
4,BES,P009680,P011936,9.717,9,27,18
4,BES,P009680,P013255,3.968,4,11,7
4,BES,P010652,P011924,9.3,3,20,17
4,BES,P010652,P011927,13.95,5,26,21
4,BES,P010652,P011936,8.901,7,19,12
4,BES,P010652,P013255,12.151,3,24,21
4,BES,P011379,P011924,9.483,3,22,19
4,BES,P011379,P011927,8.016,0,17,17
4,BES,P011379,P011936,9.033,3,18,15
4,BES,P011379,P013255,9.483,3,22,19
4,BES,P011924,P011927,18.099,2,39,37
4,BES,P011924,P011936,8.3,5,18,13
4,BES,P011924,P013255,20.033,5,44,39
4,BES,P011927,P011936,11.083,-3,16,19
4,BES,P011927,P013255,20.066,0,39,39
4,BES,P011936,P013255,11.034,5,22,17
4,BUD,P005637,P006561,6.534,-7,9,16
4,BUD,P005637,P006566,5.4,-7,6,13
4,BUD,P005637,P008325,11.683,-10,23,33
4,BUD,P005637,P010307,2.483,-1,8,9
4,BUD,P005637,P011150,8.3,-5,17,22
4,BUD,P005637,P011281,10.4,-19,15,34
4,BUD,P005637,P012606,7.867,2,17,15
4,BUD,P005637,P012630,13.384,-9,24,33
4,BUD,P005637,P013258,7.017,-12,9,21
4,BUD,P006561,P011150,1.417,-3,0,3
4,BUD,P006561,P011281,4.417,-11,2,13
4,BUD,P006561,P012606,3.167,1,7,6
4,BUD,P006561,P012630,7.584,-10,9,19
4,BUD,P006561,P013256,1.05,-3,0,3
4,BUD,P006561,P013258,6.167,-7,9,16
4,BUD,P006566,P008325,15.65,-6,22,28
4,BUD,P006566,P010307,0.05,0,0,0
4,BUD,P006566,P011150,12.75,-6,16,22
4,BUD,P006566,P011281,7.05,-6,6,12
4,BUD,P006566,P012606,8.65,0,16,16
4,BUD,P006566,P012630,2.95,0,6,6
4,BUD,P006566,P013256,10.3,1,16,15
4,BUD,P008325,P010307,3.266,-2,10,12
4,BUD,P008325,P011150,26.716,-5,57,62
4,BUD,P008325,P011281,16.049,-9,34,43
4,BUD,P008325,P012606,14.417,-1,29,30
4,BUD,P008325,P012630,12.617,-2,30,32
4,BUD,P008325,P013256,18.783,0,40,40
4,BUD,P008325,P013258,2.683,-5,7,12
4,BUD,P010307,P011150,3.116,0,10,10
4,BUD,P010307,P011281,3.266,-2,10,12
4,BUD,P010307,P012606,0.05,0,0,0
4,BUD,P010307,P012630,0.05,0,0,0
4,BUD,P010307,P013256,0.833,-1,2,3
4,BUD,P010307,P013258,0.15,-2,0,2
4,BUD,P011150,P011281,16.616,-7,34,41
4,BUD,P011150,P012606,13.417,1,27,26
4,BUD,P011150,P012630,12.334,0,28,28
4,BUD,P011150,P013256,21.733,-1,44,45
4,BUD,P011150,P013258,1.833,0,7,7
4,BUD,P011150,P013259,1.9,2,4,2
4,BUD,P011281,P012630,8.717,-12,15,27
4,BUD,P011281,P013256,10.066,-1,21,22
4,BUD,P011281,P013258,5.283,-13,7,20
4,BUD,P012606,P012630,13.434,2,28,26
4,BUD,P012606,P013256,11.667,0,23,23
4,BUD,P012606,P013258,3.567,1,9,8
4,BUD,P012606,P013259,1.9,2,4,2
4,BUD,P012630,P013256,8.767,-1,19,20
4,BUD,P012630,P013258,6.867,-10,9,19
4,BUD,P012630,P013259,1.9,2,4,2
4,BUD,P013256,P013258,1.833,0,7,7
4,BUD,P013256,P013259,1.9,2,4,2
5,CAN,P003425,P006588,22.417,8,48,40
5,CAN,P003425,P007560,2.167,1,5,4
5,CAN,P003425,P008121,24.033,4,49,45
5,CAN,P003425,P008966,23.8,6,52,46
5,CAN,P003425,P010452,3.783,-3,6,9
5,CAN,P003425,P011251,4.25,-2,6,8
5,CAN,P003425,P012016,2.4,-1,2,3
5,CAN,P003425,P012095,21.95,7,48,41
5,CAN,P005005,P010452,4.783,0,9,9
5,CAN,P005005,P010623,4.783,0,9,9
5,CAN,P005005,P011251,4.783,0,9,9
5,CAN,P005005,P012016,4.783,0,9,9
5,CAN,P006588,P007560,1.717,-1,3,4
5,CAN,P006588,P008121,20.7,9,45,36
5,CAN,P006588,P008966,20.467,11,48,37
5,CAN,P006588,P011251,2.3,-1,2,3
5,CAN,P006588,P012016,1.95,-3,0,3
5,CAN,P006588,P012095,20.117,9,46,37
5,CAN,P007560,P008966,1.717,-1,3,4
5,CAN,P007560,P010452,5.45,-3,13,16
5,CAN,P007560,P010623,5.0,-5,11,16
5,CAN,P007560,P011251,5.45,-3,13,16
5,CAN,P007560,P012016,5.45,-3,13,16
5,CAN,P007560,P012095,1.717,-1,3,4
5,CAN,P008121,P008966,22.716,7,51,44
5,CAN,P008121,P010452,7.349,-2,14,16
5,CAN,P008121,P010623,4.016,3,10,7
5,CAN,P008121,P011251,7.816,-1,14,15
5,CAN,P008121,P012016,5.333,0,8,8
5,CAN,P008121,P012095,20.233,8,45,37
5,CAN,P008966,P010452,3.966,-5,6,11
5,CAN,P008966,P010623,0.633,0,2,2
5,CAN,P008966,P011251,2.483,-1,6,7
5,CAN,P008966,P012095,21.95,7,48,41
5,CAN,P010452,P010623,13.799,-2,30,32
5,CAN,P010452,P011251,15.749,-3,34,37
5,CAN,P010452,P012016,13.616,0,30,30
5,CAN,P010452,P012095,1.833,-2,2,4
5,CAN,P010623,P011251,13.799,-2,30,32
5,CAN,P010623,P012016,13.166,-2,28,30
5,CAN,P011251,P012016,15.566,-3,30,33
5,TRN,P005438,P006382,8.883,4,19,15
5,TRN,P005438,P006724,21.566,2,48,46
5,TRN,P005438,P012593,14.8,-1,34,35
5,TRN,P005438,P012687,4.416,-3,12,15
5,TRN,P005438,P013269,7.233,-4,8,12
5,TRN,P005438,P013270,22.016,1,49,48
5,TRN,P005438,P013271,12.15,0,22,22
5,TRN,P005438,P013272,14.8,1,28,27
5,TRN,P006382,P006724,7.616,4,19,15
5,TRN,P006382,P012593,2.333,0,4,4
5,TRN,P006382,P012687,2.133,-1,5,6
5,TRN,P006382,P013269,2.216,-3,0,3
5,TRN,P006382,P013270,8.766,1,15,14
5,TRN,P006382,P013271,3.483,-3,0,3
5,TRN,P006382,P013272,8.966,2,14,12
5,TRN,P006724,P012593,11.334,-2,27,29
5,TRN,P006724,P012687,2.133,-1,5,6
5,TRN,P006724,P013269,6.05,-7,8,15
5,TRN,P006724,P013270,18.633,0,42,42
5,TRN,P006724,P013271,7.25,2,15,13
5,TRN,P006724,P013272,12.35,-2,28,30
5,TRN,P012593,P012687,8.233,-5,17,22
5,TRN,P012593,P013269,16.9,-5,28,33
5,TRN,P012593,P013270,15.717,3,44,41
5,TRN,P012593,P013271,21.933,-1,44,45
5,TRN,P012593,P013272,20.15,-1,42,43
5,TRN,P012687,P013269,5.95,-3,10,13
5,TRN,P012687,P013270,4.416,-3,12,15
5,TRN,P012687,P013271,8.233,-5,17,22
5,TRN,P012687,P013272,5.95,-3,10,13
5,TRN,P013269,P013270,9.233,1,22,21
5,TRN,P013269,P013271,16.549,2,30,28
5,TRN,P013269,P013272,18.933,-9,30,39
5,TRN,P013270,P013271,16.483,5,38,33
5,TRN,P013270,P013272,16.2,4,38,34
5,TRN,P013271,P013272,15.983,0,26,26
6,JER,P006625,P009879,8.817,-4,9,13
6,JER,P006625,P010431,0.55,1,1,0
6,JER,P006625,P010587,24.184,-7,39,46
6,JER,P006625,P011970,19.183,-5,37,42
6,JER,P006625,P013276,9.417,-8,10,18
6,JER,P006625,P013277,17.784,-6,28,34
6,JER,P006625,P013278,17.133,-3,30,33
6,JER,P006625,P013279,9.417,1,21,20
6,JER,P006625,P013281,3.983,-5,5,10
6,JER,P009879,P010431,5.168,0,8,8
6,JER,P009879,P010587,10.401,-5,9,14
6,JER,P009879,P011970,5.734,-3,8,11
6,JER,P009879,P013276,9.317,-9,7,16
6,JER,P009879,P013277,6.867,-1,10,11
6,JER,P009879,P013278,6.751,1,10,9
6,JER,P009879,P013279,8.101,-5,7,12
6,JER,P009879,P013281,3.384,-6,0,6
6,JER,P010431,P010587,4.4,-3,7,10
6,JER,P010431,P011970,8.334,-3,17,20
6,JER,P010431,P013276,3.001,-7,3,10
6,JER,P010431,P013277,2.1,-1,5,6
6,JER,P010431,P013278,7.583,5,17,12
6,JER,P010431,P013279,8.001,-2,14,16
6,JER,P010431,P013281,3.467,2,8,6
6,JER,P010587,P011970,17.9,-7,35,42
6,JER,P010587,P013276,9.385,-15,4,19
6,JER,P010587,P013277,17.451,-7,28,35
6,JER,P010587,P013278,19.866,-2,36,38
6,JER,P010587,P013279,12.518,-4,21,25
6,JER,P010587,P013281,5.167,-10,1,11
6,JER,P011970,P013276,6.568,-9,9,18
6,JER,P011970,P013277,15.017,-5,28,33
6,JER,P011970,P013278,20.016,-1,40,41
6,JER,P011970,P013279,13.301,1,31,30
6,JER,P011970,P013281,4.283,0,11,11
6,JER,P013276,P013277,4.218,-8,2,10
6,JER,P013276,P013279,10.018,-10,11,21
6,JER,P013276,P013281,6.884,-10,6,16
6,JER,P013277,P013278,14.733,-1,26,27
6,JER,P013277,P013279,1.634,1,5,4
6,JER,P013278,P013279,8.684,3,19,16
6,JER,P013278,P013281,2.166,2,6,4
6,JER,P013279,P013281,7.134,-5,11,16
6,PAM,P004863,P005356,4.767,-1,8,9
6,PAM,P004863,P006643,12.366,11,26,15
6,PAM,P004863,P007527,0.117,0,0,0
6,PAM,P004863,P010042,13.316,19,30,11
6,PAM,P004863,P010393,11.883,11,24,13
6,PAM,P004863,P010444,10.583,9,22,13
6,PAM,P004863,P011980,4.967,3,10,7
6,PAM,P004863,P011982,7.184,11,16,5
6,PAM,P004863,P012738,7.617,9,16,7
6,PAM,P005356,P006643,3.85,4,8,4
6,PAM,P005356,P007527,11.849,-9,19,28
6,PAM,P005356,P009864,8.433,-5,13,18
6,PAM,P005356,P010393,3.35,-1,8,9
6,PAM,P005356,P010444,5.266,1,10,9
6,PAM,P005356,P011980,13.266,-9,19,28
6,PAM,P005356,P011982,12.766,-14,19,33
6,PAM,P005356,P012738,2.917,-6,4,10
6,PAM,P006643,P007527,5.434,9,14,5
6,PAM,P006643,P010042,13.95,16,32,16
6,PAM,P006643,P010393,13.083,16,32,16
6,PAM,P006643,P010444,14.95,20,36,16
6,PAM,P006643,P011980,3.033,0,4,4
6,PAM,P006643,P011982,1.684,4,4,0
6,PAM,P006643,P012738,2.85,0,4,4
6,PAM,P007527,P009864,8.433,-5,13,18
6,PAM,P007527,P010042,9.951,7,23,16
6,PAM,P007527,P010393,9.884,2,23,21
6,PAM,P007527,P010444,6.3,8,16,8
6,PAM,P007527,P011980,11.699,-4,19,23
6,PAM,P007527,P011982,16.817,-11,28,39
6,PAM,P007527,P012738,7.184,-5,13,18
6,PAM,P009864,P011980,8.433,-5,13,18
6,PAM,P009864,P011982,8.433,-5,13,18
6,PAM,P010042,P010393,18.183,14,39,25
6,PAM,P010042,P010444,11.617,16,28,12
6,PAM,P010042,P011980,3.4,8,10,2
6,PAM,P010042,P011982,11.001,14,25,11
6,PAM,P010042,P012738,11.65,10,25,15
6,PAM,P010393,P010444,11.3,14,28,14
6,PAM,P010393,P011982,8.567,-3,15,18
6,PAM,P010393,P012738,10.35,-1,19,20
6,PAM,P010444,P011980,4.166,-1,6,7
6,PAM,P010444,P011982,3.35,1,6,5
6,PAM,P011980,P011982,13.633,-1,25,26
6,PAM,P011980,P012738,4.067,5,10,5
6,PAM,P011982,P012738,12.101,4,25,21
7,BOU,P004525,P004945,0.317,0,0,0
7,BOU,P004525,P006904,8.117,-6,12,18
7,BOU,P004525,P009552,2.883,1,7,6
7,BOU,P004525,P010449,13.333,20,41,21
7,BOU,P004525,P011837,15.884,13,39,26
7,BOU,P004525,P013264,2.683,0,7,7
7,BOU,P004525,P013265,21.133,14,53,39
7,BOU,P004525,P013266,21.45,14,53,39
7,BOU,P004945,P006904,9.6,0,24,24
7,BOU,P004945,P009552,12.433,9,33,24
7,BOU,P004945,P009556,11.867,8,31,23
7,BOU,P004945,P010449,4.267,9,11,2
7,BOU,P004945,P011837,1.434,0,2,2
7,BOU,P004945,P013264,13.55,9,35,26
7,BOU,P004945,P013266,2.0,1,4,3
7,BOU,P006904,P009552,11.433,-5,27,32
7,BOU,P006904,P009556,8.4,-3,21,24
7,BOU,P006904,P011837,8.251,-3,15,18
7,BOU,P006904,P013264,11.567,-2,30,32
7,BOU,P006904,P013265,10.084,-8,18,26
7,BOU,P006904,P013266,11.284,-5,21,26
7,BOU,P009552,P009556,13.733,7,36,29
7,BOU,P009552,P010449,7.733,13,22,9
7,BOU,P009552,P013264,16.283,7,42,35
7,BOU,P009552,P013265,6.733,-1,16,17
7,BOU,P009552,P013266,5.433,1,13,12
7,BOU,P009556,P010449,6.45,10,17,7
7,BOU,P009556,P011837,1.117,0,2,2
7,BOU,P009556,P013264,14.85,7,38,31
7,BOU,P009556,P013265,2.983,-1,7,8
7,BOU,P010449,P011837,9.9,15,29,14
7,BOU,P010449,P013264,9.666,8,24,16
7,BOU,P010449,P013265,16.049,19,47,28
7,BOU,P010449,P013266,13.866,18,41,23
7,BOU,P011837,P013264,2.267,-1,5,6
7,BOU,P011837,P013265,16.717,12,42,30
7,BOU,P011837,P013266,17.034,12,42,30
7,BOU,P013264,P013265,7.683,-3,19,22
7,BOU,P013264,P013266,6.383,-1,16,17
7,BOU,P013265,P013266,23.15,12,58,46
7,HAM,P003242,P006006,12.55,-4,26,30
7,HAM,P003242,P006420,7.817,-3,17,20
7,HAM,P003242,P008103,1.617,0,5,5
7,HAM,P003242,P010070,2.933,0,6,6
7,HAM,P003242,P011256,12.116,-12,18,30
7,HAM,P003242,P012695,4.783,1,10,9
7,HAM,P003242,P013308,22.134,-9,45,54
7,HAM,P003242,P013309,5.984,0,16,16
7,HAM,P003242,P013311,6.967,3,17,14
7,HAM,P003242,P013312,12.7,-6,23,29
7,HAM,P003242,P013313,10.667,-6,21,27
7,HAM,P006006,P006420,5.684,-5,12,17
7,HAM,P006006,P008103,8.767,-3,21,24
7,HAM,P006006,P010070,2.933,0,6,6
7,HAM,P006006,P011256,2.816,-4,4,8
7,HAM,P006006,P012695,7.216,4,17,13
7,HAM,P006006,P013308,9.617,-4,20,24
7,HAM,P006006,P013309,12.167,-8,27,35
7,HAM,P006006,P013311,11.867,2,27,25
7,HAM,P006006,P013312,5.183,-6,8,14
7,HAM,P006420,P008103,7.117,-6,13,19
7,HAM,P006420,P010070,3.083,-5,5,10
7,HAM,P006420,P011256,4.466,-8,4,12
7,HAM,P006420,P012695,1.617,-2,5,7
7,HAM,P006420,P013308,8.334,0,20,20
7,HAM,P006420,P013309,4.584,-4,7,11
7,HAM,P006420,P013311,9.401,-1,24,25
7,HAM,P006420,P013313,7.633,-2,13,15
7,HAM,P008103,P010070,3.083,-5,5,10
7,HAM,P008103,P011256,3.816,-7,2,9
7,HAM,P008103,P012695,7.683,-1,19,20
7,HAM,P008103,P013308,4.567,-1,13,14
7,HAM,P008103,P013309,10.067,-5,21,26
7,HAM,P008103,P013311,11.567,-4,27,31
7,HAM,P008103,P013312,3.533,-9,5,14
7,HAM,P008103,P013313,4.383,-3,5,8
7,HAM,P010070,P012695,3.383,-4,6,10
7,HAM,P010070,P013311,6.016,-5,11,16
7,HAM,P010070,P013313,2.633,-1,5,6
7,HAM,P011256,P012695,3.183,-1,6,7
7,HAM,P011256,P013308,13.449,-14,20,34
7,HAM,P011256,P013309,2.033,-5,0,5
7,HAM,P011256,P013312,10.566,-11,16,27
7,HAM,P011256,P013313,9.483,-14,10,24
7,HAM,P012695,P013308,4.8,0,12,12
7,HAM,P012695,P013309,4.283,4,11,7
7,HAM,P012695,P013311,9.283,1,23,22
7,HAM,P012695,P013312,3.633,-2,7,9
7,HAM,P013308,P013309,5.984,0,16,16
7,HAM,P013308,P013311,5.651,4,17,13
7,HAM,P013308,P013312,15.133,-10,28,38
7,HAM,P013308,P013313,10.667,-6,21,27
7,HAM,P013309,P013311,6.867,0,16,16
7,HAM,P013309,P013312,4.85,-5,9,14
7,HAM,P013309,P013313,2.717,3,5,2
7,HAM,P013311,P013312,1.917,-4,3,7
7,HAM,P013311,P013313,4.6,0,11,11
7,HAM,P013312,P013313,7.417,-7,13,20
8,CLU,P002820,P004862,2.3,2,6,4
8,CLU,P002820,P005714,4.217,-3,8,11
8,CLU,P002820,P006618,3.75,1,8,7
8,CLU,P002820,P010651,20.349,-4,42,46
8,CLU,P002820,P011801,2.116,0,5,5
8,CLU,P002820,P012620,8.883,-2,18,20
8,CLU,P002820,P012698,16.133,0,33,33
8,CLU,P002820,P013302,19.049,-5,38,43
8,CLU,P002820,P013304,20.599,-5,42,47
8,CLU,P004862,P005714,7.367,-6,17,23
8,CLU,P004862,P006618,10.034,0,25,25
8,CLU,P004862,P010651,5.734,-8,14,22
8,CLU,P004862,P011801,3.85,-5,9,14
8,CLU,P004862,P012698,11.034,-6,25,31
8,CLU,P004862,P013302,5.168,2,16,14
8,CLU,P004862,P013304,0.517,-3,0,3
8,CLU,P005714,P006618,7.867,-4,16,20
8,CLU,P005714,P010651,8.267,-6,17,23
8,CLU,P005714,P011801,11.533,2,25,23
8,CLU,P005714,P012620,0.467,-4,0,4
8,CLU,P005714,P012698,10.45,-13,16,29
8,CLU,P005714,P013302,7.484,7,19,12
8,CLU,P005714,P013304,5.284,3,14,11
8,CLU,P006618,P010651,4.484,-5,11,16
8,CLU,P006618,P011801,4.133,0,8,8
8,CLU,P006618,P012698,11.484,-1,27,28
8,CLU,P006618,P013302,4.184,5,13,8
8,CLU,P010651,P011801,8.283,0,20,20
8,CLU,P010651,P012620,8.416,2,18,16
8,CLU,P010651,P012698,19.033,-10,36,46
8,CLU,P010651,P013302,30.1,0,66,66
8,CLU,P010651,P013304,25.466,3,56,53
8,CLU,P011801,P012698,6.249,-5,8,13
8,CLU,P011801,P013302,7.8,3,20,17
8,CLU,P011801,P013304,5.7,5,17,12
8,CLU,P012620,P012698,1.55,0,4,4
8,CLU,P012620,P013302,7.333,-2,14,16
8,CLU,P012620,P013304,8.883,-2,18,20
8,CLU,P012698,P013302,17.167,-1,34,35
8,CLU,P012698,P013304,12.9,-4,25,29
8,CLU,P013302,P013304,24.383,-1,52,53
8,LJU,P003452,P003703,6.617,-3,14,17
8,LJU,P003452,P009753,6.116,-1,10,11
8,LJU,P003452,P012042,19.132,-3,39,42
8,LJU,P003452,P012700,14.266,-7,26,33
8,LJU,P003452,P012996,10.933,-3,22,25
8,LJU,P003452,P013260,13.282,-4,25,29
8,LJU,P003452,P013261,5.633,0,13,13
8,LJU,P003452,P013262,0.767,-4,0,4
8,LJU,P003452,P013263,2.85,-3,7,10
8,LJU,P003703,P009392,5.134,3,8,5
8,LJU,P003703,P009753,7.317,-1,13,14
8,LJU,P003703,P012042,9.717,4,25,21
8,LJU,P003703,P012700,10.55,1,29,28
8,LJU,P003703,P012996,10.751,9,32,23
8,LJU,P003703,P013260,0.217,3,3,0
8,LJU,P003703,P013261,13.618,12,36,24
8,LJU,P003703,P013262,8.351,4,20,16
8,LJU,P009392,P009753,3.984,2,8,6
8,LJU,P009392,P012042,0.467,0,3,3
8,LJU,P009392,P012996,1.617,1,3,2
8,LJU,P009392,P013260,0.467,0,3,3
8,LJU,P009392,P013261,5.601,3,11,8
8,LJU,P009392,P013262,5.134,3,8,5
8,LJU,P009753,P012042,8.5,8,23,15
8,LJU,P009753,P012700,8.483,0,16,16
8,LJU,P009753,P013260,6.067,12,20,8
8,LJU,P009753,P013261,7.534,12,23,11
8,LJU,P009753,P013262,4.667,0,7,7
8,LJU,P012042,P012700,22.366,2,49,47
8,LJU,P012042,P012996,17.333,0,38,38
8,LJU,P012042,P013260,19.183,4,46,42
8,LJU,P012042,P013261,15.184,8,42,34
8,LJU,P012042,P013263,2.85,-3,7,10
8,LJU,P012700,P012996,17.217,4,43,39
8,LJU,P012700,P013260,18.0,0,37,37
8,LJU,P012700,P013261,14.284,8,40,32
8,LJU,P012700,P013262,6.184,-1,17,18
8,LJU,P012700,P013263,2.85,-3,7,10
8,LJU,P012996,P013260,13.233,-7,24,31
8,LJU,P012996,P013261,18.201,2,44,42
8,LJU,P012996,P013262,6.651,2,18,16
8,LJU,P013260,P013261,12.334,5,34,29
8,LJU,P013260,P013262,2.967,-2,5,7
8,LJU,P013260,P013263,2.85,-3,7,10
8,LJU,P013261,P013262,10.551,6,25,19
9,ARI,P003240,P004292,8.499,-4,10,14
9,ARI,P003240,P008084,10.049,-9,13,22
9,ARI,P003240,P013248,5.418,-4,12,16
9,ARI,P003240,P013249,12.166,-7,15,22
9,ARI,P003240,P013250,10.734,-8,22,30
9,ARI,P003240,P013251,10.5,-4,21,25
9,ARI,P003240,P013252,9.816,4,21,17
9,ARI,P003240,P013355,3.466,-5,1,6
9,ARI,P003240,P013356,6.984,2,16,14
9,ARI,P003240,P013360,7.1,-5,17,22
9,ARI,P004292,P008084,17.832,-10,28,38
9,ARI,P004292,P013248,8.617,0,16,16
9,ARI,P004292,P013249,7.933,-9,5,14
9,ARI,P004292,P013250,5.65,8,18,10
9,ARI,P004292,P013251,12.181,-8,23,31
9,ARI,P004292,P013252,10.416,-2,19,21
9,ARI,P004292,P013355,2.116,-6,2,8
9,ARI,P004292,P013356,9.584,-3,15,18
9,ARI,P004292,P013360,6.832,-6,12,18
9,ARI,P008084,P013248,14.284,-5,30,35
9,ARI,P008084,P013249,15.866,-20,21,41
9,ARI,P008084,P013250,16.05,-2,39,41
9,ARI,P008084,P013251,9.131,-7,16,23
9,ARI,P008084,P013252,7.899,1,16,15
9,ARI,P008084,P013355,3.366,-10,2,12
9,ARI,P008084,P013356,17.201,-9,34,43
9,ARI,P008084,P013360,3.782,-5,5,10
9,ARI,P013248,P013249,10.167,-11,17,28
9,ARI,P013248,P013250,10.534,2,32,30
9,ARI,P013248,P013251,5.884,1,15,14
9,ARI,P013248,P013356,11.934,-5,27,32
9,ARI,P013248,P013360,1.434,-2,3,5
9,ARI,P013249,P013250,12.766,-11,22,33
9,ARI,P013249,P013251,3.067,1,5,4
9,ARI,P013249,P013252,6.833,1,10,9
9,ARI,P013249,P013355,2.983,-5,1,6
9,ARI,P013249,P013356,15.284,-10,27,37
9,ARI,P013249,P013360,1.067,-1,1,2
9,ARI,P013250,P013251,6.366,-3,15,18
9,ARI,P013250,P013252,4.417,3,12,9
9,ARI,P013250,P013355,3.433,-7,3,10
9,ARI,P013250,P013356,13.001,1,32,31
9,ARI,P013250,P013360,2.117,-3,5,8
9,ARI,P013251,P013252,6.166,-1,17,18
9,ARI,P013251,P013355,3.849,-7,3,10
9,ARI,P013251,P013356,1.7,1,5,4
9,ARI,P013251,P013360,9.816,-9,20,29
9,ARI,P013252,P013356,6.584,3,12,9
9,ARI,P013252,P013360,5.933,-1,17,18
9,ARI,P013355,P013360,1.183,-4,0,4
9,VNC,P003759,P005404,4.5,-1,13,14
9,VNC,P003759,P006571,1.3,1,4,3
9,VNC,P003759,P007759,12.049,22,35,13
9,VNC,P003759,P008858,8.833,17,25,8
9,VNC,P003759,P009400,4.616,2,11,9
9,VNC,P003759,P011909,10.866,18,31,13
9,VNC,P003759,P011928,8.483,10,21,11
9,VNC,P003759,P013305,9.349,11,28,17
9,VNC,P005404,P006571,2.733,3,9,6
9,VNC,P005404,P007759,2.05,3,8,5
9,VNC,P005404,P008858,4.517,2,7,5
9,VNC,P005404,P009400,6.933,-4,18,22
9,VNC,P005404,P011909,7.7,-2,18,20
9,VNC,P005404,P011928,6.167,-1,10,11
9,VNC,P005404,P012796,8.5,0,18,18
9,VNC,P005404,P013305,8.9,-4,23,27
9,VNC,P006571,P007759,1.817,-3,0,3
9,VNC,P006571,P008858,1.817,-3,0,3
9,VNC,P006571,P009400,2.733,3,9,6
9,VNC,P006571,P012796,3.25,-1,5,6
9,VNC,P006571,P013305,4.55,0,9,9
9,VNC,P007759,P008858,24.1,18,60,42
9,VNC,P007759,P009400,3.399,5,6,1
9,VNC,P007759,P011909,22.882,22,60,38
9,VNC,P007759,P011928,19.833,18,51,33
9,VNC,P007759,P012796,17.0,2,37,35
9,VNC,P007759,P013305,13.066,9,31,22
9,VNC,P008858,P011909,22.716,21,58,37
9,VNC,P008858,P011928,21.934,17,54,37
9,VNC,P008858,P012796,19.784,3,42,39
9,VNC,P008858,P013305,10.767,5,22,17
9,VNC,P009400,P011909,4.266,-5,6,11
9,VNC,P009400,P011928,4.066,0,7,7
9,VNC,P009400,P012796,5.216,-3,11,14
9,VNC,P009400,P013305,8.099,-2,20,22
9,VNC,P011909,P011928,19.083,14,45,31
9,VNC,P011909,P012796,17.666,-1,39,40
9,VNC,P011909,P013305,8.949,1,23,22
9,VNC,P011928,P012796,17.517,7,40,33
9,VNC,P011928,P013305,6.917,3,16,13
9,VNC,P012796,P013305,11.067,-7,20,27
10,LKB,P005521,P005656,18.916,5,38,33
10,LKB,P005521,P006586,21.95,6,42,36
10,LKB,P005521,P006860,4.95,-3,12,15
10,LKB,P005521,P009299,5.634,-3,13,16
10,LKB,P005521,P009898,5.167,-4,8,12
10,LKB,P005521,P010461,13.484,-1,22,23
10,LKB,P005521,P013247,21.1,0,38,38
10,LKB,P005521,PLXI,10.067,-8,11,19
10,LKB,P005656,P006586,20.632,8,42,34
10,LKB,P005656,P006860,7.399,-2,12,14
10,LKB,P005656,P009299,9.666,-1,17,18
10,LKB,P005656,P009898,7.749,-2,12,14
10,LKB,P005656,P010461,9.5,0,18,18
10,LKB,P005656,P013247,18.566,1,34,33
10,LKB,P005656,PLXI,9.032,-5,11,16
10,LKB,P006586,P006860,6.933,2,9,7
10,LKB,P006586,P009299,12.784,7,25,18
10,LKB,P006586,P009898,10.567,0,14,14
10,LKB,P006586,P010461,17.068,3,33,30
10,LKB,P006586,P013247,20.95,10,44,34
10,LKB,P006586,PLXI,15.184,4,23,19
10,LKB,P006860,P009299,11.933,-15,9,24
10,LKB,P006860,P009898,9.916,-11,7,18
10,LKB,P006860,P010461,1.333,-3,0,3
10,LKB,P006860,P013247,4.55,-1,10,11
10,LKB,P006860,PLXI,10.85,-15,9,24
10,LKB,P009299,P009898,13.166,-12,14,26
10,LKB,P009299,P010461,4.917,1,11,10
10,LKB,P009299,P013247,7.151,5,19,14
10,LKB,P009299,PLXI,16.017,-10,24,34
10,LKB,P009898,P010461,5.734,-3,9,12
10,LKB,P009898,P013247,0.95,-2,0,2
10,LKB,P009898,PLXI,14.883,-14,16,30
10,LKB,P010461,P013247,12.667,3,24,21
10,LKB,P010461,PLXI,8.901,0,15,15
10,LKB,P013247,PLXI,9.734,0,15,15
10,TTK,P004056,P004218,2.417,-1,4,5
10,TTK,P004056,P006598,0.75,0,2,2
10,TTK,P004056,P007917,1.817,0,2,2
10,TTK,P004056,P009025,13.618,4,28,24
10,TTK,P004056,P011935,9.067,3,20,17
10,TTK,P004056,P011973,13.618,4,28,24
10,TTK,P004056,P012259,11.918,3,25,22
10,TTK,P004056,P013300,1.267,3,3,0
10,TTK,P004218,P004619,1.583,3,3,0
10,TTK,P004218,P006598,10.85,3,21,18
10,TTK,P004218,P007917,0.2,0,2,2
10,TTK,P004218,P009025,12.9,-3,19,22
10,TTK,P004218,P011935,5.817,-5,6,11
10,TTK,P004218,P011973,11.217,-1,20,21
10,TTK,P004218,P012259,11.983,-3,19,22
10,TTK,P004218,P012415,4.2,2,10,8
10,TTK,P004218,P013300,7.233,1,12,11
10,TTK,P004619,P006598,3.933,5,9,4
10,TTK,P004619,P011935,2.35,2,6,4
10,TTK,P004619,P012415,3.933,5,9,4
10,TTK,P004619,P013300,3.933,5,9,4
10,TTK,P006598,P007917,2.583,-2,4,6
10,TTK,P006598,P009025,15.017,4,25,21
10,TTK,P006598,P011935,12.867,-5,18,23
10,TTK,P006598,P011973,13.917,-4,20,24
10,TTK,P006598,P012259,9.283,-3,14,17
10,TTK,P006598,P012415,10.1,8,23,15
10,TTK,P006598,P013300,12.7,10,28,18
10,TTK,P007917,P009025,3.067,3,5,2
10,TTK,P007917,P011935,1.733,-3,1,4
10,TTK,P007917,P011973,4.317,-1,5,6
10,TTK,P007917,P012259,3.367,-3,3,6
10,TTK,P007917,P012415,0.383,0,2,2
10,TTK,P007917,P013300,1.333,2,4,2
10,TTK,P009025,P011935,20.784,2,35,33
10,TTK,P009025,P011973,25.285,2,46,44
10,TTK,P009025,P012259,23.767,0,42,42
10,TTK,P009025,P012415,3.367,4,7,3
10,TTK,P009025,P013300,10.267,8,17,9
10,TTK,P011935,P011973,15.301,-6,25,31
10,TTK,P011935,P012259,14.733,-6,23,29
10,TTK,P011935,P012415,6.967,4,15,11
10,TTK,P011935,P013300,12.917,6,23,17
10,TTK,P011973,P012259,21.651,-4,39,43
10,TTK,P011973,P012415,1.35,1,3,2
10,TTK,P011973,P013300,4.884,5,10,5
10,TTK,P012259,P013300,3.366,0,3,3
10,TTK,P012415,P013300,10.1,8,23,15
11,TRN,P002387,P005438,9.384,2,19,17
11,TRN,P002387,P006382,4.317,-4,4,8
11,TRN,P002387,P006724,3.75,-3,6,9
11,TRN,P002387,P012593,5.7,-9,9,18
11,TRN,P002387,P012687,3.616,-6,6,12
11,TRN,P002387,P013269,1.433,-6,0,6
11,TRN,P002387,P013270,8.25,5,19,14
11,TRN,P002387,P013271,7.15,-3,13,16
11,TRN,P005438,P006382,11.35,0,21,21
11,TRN,P005438,P006724,10.117,6,25,19
11,TRN,P005438,P012593,4.184,-1,9,10
11,TRN,P005438,P012687,3.317,1,8,7
11,TRN,P005438,P013270,15.217,12,38,26
11,TRN,P005438,P013271,6.917,0,13,13
11,TRN,P005438,P013272,7.65,4,19,15
11,TRN,P006382,P006724,8.217,2,17,15
11,TRN,P006382,P012593,1.0,-3,0,3
11,TRN,P006382,P013270,10.35,3,21,18
11,TRN,P006382,P013271,3.133,-2,4,6
11,TRN,P006382,P013272,7.033,4,17,13
11,TRN,P006724,P012593,9.733,3,17,14
11,TRN,P006724,P012687,4.366,7,12,5
11,TRN,P006724,P013269,8.566,9,19,10
11,TRN,P006724,P013270,17.9,15,42,27
11,TRN,P006724,P013272,15.883,17,38,21
11,TRN,P012593,P012687,12.799,-3,25,28
11,TRN,P012593,P013269,19.516,1,40,39
11,TRN,P012593,P013270,15.233,0,32,32
11,TRN,P012593,P013271,16.633,-6,36,42
11,TRN,P012593,P013272,20.666,6,44,38
11,TRN,P012687,P013269,10.099,5,23,18
11,TRN,P012687,P013270,5.949,3,14,11
11,TRN,P012687,P013271,11.716,-4,23,27
11,TRN,P012687,P013272,12.466,9,29,20
11,TRN,P013269,P013270,10.983,0,21,21
11,TRN,P013269,P013271,11.733,-6,23,29
11,TRN,P013269,P013272,18.866,9,42,33
11,TRN,P013270,P013271,10.966,-6,21,27
11,TRN,P013270,P013272,20.616,4,44,40
11,TRN,P013271,P013272,13.216,-5,27,32
11,TSO,P008790,P009649,13.685,-4,27,31
11,TSO,P008790,P012019,16.202,-3,32,35
11,TSO,P008790,P013292,2.634,-4,4,8
11,TSO,P008790,P013293,11.502,-13,18,31
11,TSO,P008790,P013295,9.068,-1,18,19
11,TSO,P008790,P013297,9.768,-6,18,24
11,TSO,P008790,P013298,12.485,3,27,24
11,TSO,P009649,P012019,26.718,-2,54,56
11,TSO,P009649,P013292,4.55,-12,5,17
11,TSO,P009649,P013293,14.518,-17,21,38
11,TSO,P009649,P013295,18.501,-8,33,41
11,TSO,P009649,P013296,10.784,-1,22,23
11,TSO,P009649,P013297,19.534,-5,38,43
11,TSO,P009649,P013298,16.718,13,40,27
11,TSO,P012019,P013292,1.533,-5,2,7
11,TSO,P012019,P013293,16.585,-11,27,38
11,TSO,P012019,P013295,20.018,-5,36,41
11,TSO,P012019,P013296,8.317,3,19,16
11,TSO,P012019,P013297,22.101,-1,45,46
11,TSO,P012019,P013298,21.802,12,49,37
11,TSO,P013292,P013293,5.167,-3,9,12
11,TSO,P013292,P013295,4.633,-5,8,13
11,TSO,P013292,P013296,0.95,-4,0,4
11,TSO,P013292,P013297,5.183,-3,10,13
11,TSO,P013292,P013298,2.15,4,6,2
11,TSO,P013293,P013295,14.868,-3,28,31
11,TSO,P013293,P013296,5.884,-8,7,15
11,TSO,P013293,P013297,14.284,-4,25,29
11,TSO,P013293,P013298,10.268,3,21,18
11,TSO,P013295,P013296,5.184,-6,7,13
11,TSO,P013295,P013297,10.383,2,20,18
11,TSO,P013295,P013298,15.885,6,30,24
11,TSO,P013296,P013297,5.6,5,15,10
11,TSO,P013296,P013298,6.417,7,18,11
11,TSO,P013297,P013298,16.151,16,41,25
12,BUD,P005637,P006566,1.717,-9,0,9
12,BUD,P005637,P011150,2.4,-12,0,12
12,BUD,P005637,P011281,2.383,-7,4,11
12,BUD,P005637,P012606,6.6,-16,4,20
12,BUD,P005637,P012630,6.666,-12,8,20
12,BUD,P005637,P013258,7.183,-13,8,21
12,BUD,P005637,P013259,8.983,-23,8,31
12,BUD,P006566,P008325,17.383,15,44,29
12,BUD,P006566,P011150,17.466,11,42,31
12,BUD,P006566,P011281,15.833,14,41,27
12,BUD,P006566,P012606,4.434,-11,4,15
12,BUD,P006566,P012630,0.85,-5,0,5
12,BUD,P006566,P013256,18.583,12,45,33
12,BUD,P006566,P013258,2.017,-3,3,6
12,BUD,P006566,P013259,2.917,-12,1,13
12,BUD,P008325,P011150,32.399,21,70,49
12,BUD,P008325,P011281,32.966,22,74,52
12,BUD,P008325,P012606,1.517,1,3,2
12,BUD,P008325,P012630,10.183,6,22,16
12,BUD,P008325,P013256,34.516,23,77,54
12,BUD,P008325,P013258,9.1,4,18,14
12,BUD,P011150,P011281,33.716,14,70,56
12,BUD,P011150,P012606,2.85,-8,1,9
12,BUD,P011150,P012630,10.433,0,18,18
12,BUD,P011150,P013256,33.599,18,71,53
12,BUD,P011150,P013258,8.433,-5,11,16
12,BUD,P011150,P013259,3.9,-15,1,16
12,BUD,P011281,P012606,0.3,0,0,0
12,BUD,P011281,P012630,11.416,6,26,20
12,BUD,P011281,P013256,32.966,22,74,52
12,BUD,P011281,P013258,10.333,-4,19,23
12,BUD,P011281,P013259,2.683,-7,4,11
12,BUD,P012606,P012630,6.033,-12,4,16
12,BUD,P012606,P013256,2.717,-2,4,6
12,BUD,P012606,P013258,5.917,-5,7,12
12,BUD,P012606,P013259,8.1,-19,5,24
12,BUD,P012630,P013256,10.183,6,22,16
12,BUD,P012630,P013258,5.866,-1,12,13
12,BUD,P012630,P013259,6.966,-12,8,20
12,BUD,P013256,P013258,9.1,4,18,14
12,BUD,P013256,P013259,1.2,-3,1,4
12,BUD,P013258,P013259,7.183,-13,8,21
12,CAN,P003425,P005005,8.1,11,20,9
12,CAN,P003425,P006588,18.033,2,38,36
12,CAN,P003425,P007560,0.3,0,0,0
12,CAN,P003425,P008121,15.449,-10,25,35
12,CAN,P003425,P008966,15.549,2,31,29
12,CAN,P003425,P010452,5.016,-1,7,8
12,CAN,P003425,P010623,1.283,-3,0,3
12,CAN,P003425,P011251,7.7,-10,15,25
12,CAN,P003425,P012016,8.0,-1,14,15
12,CAN,P003425,P012095,14.766,14,30,16
12,CAN,P005005,P006588,5.167,6,13,7
12,CAN,P005005,P007560,0.3,0,0,0
12,CAN,P005005,P008966,7.417,12,20,8
12,CAN,P005005,P010452,3.65,7,9,2
12,CAN,P005005,P010623,1.017,2,2,0
12,CAN,P005005,P012016,1.7,1,2,1
12,CAN,P005005,P012095,9.117,13,22,9
12,CAN,P006588,P008121,17.483,-7,35,42
12,CAN,P006588,P008966,12.05,1,26,25
12,CAN,P006588,P010623,4.9,-3,10,13
12,CAN,P006588,P011251,12.117,-13,25,38
12,CAN,P006588,P012016,10.6,-2,22,24
12,CAN,P006588,P012095,10.25,12,23,11
12,CAN,P007560,P008966,0.3,0,0,0
12,CAN,P007560,P012095,0.3,0,0,0
12,CAN,P008121,P008966,17.816,-6,27,33
12,CAN,P008121,P010452,18.2,-3,32,35
12,CAN,P008121,P010623,21.717,-3,42,45
12,CAN,P008121,P011251,26.917,-9,55,64
12,CAN,P008121,P012016,18.067,-4,40,44
12,CAN,P008121,P012095,7.883,2,12,10
12,CAN,P008966,P010452,12.683,5,21,16
12,CAN,P008966,P010623,9.884,4,16,12
12,CAN,P008966,P011251,13.2,-3,24,27
12,CAN,P008966,P012095,12.033,9,23,14
12,CAN,P010452,P010623,17.634,2,34,32
12,CAN,P010452,P011251,14.6,4,30,26
12,CAN,P010452,P012016,9.167,-1,20,21
12,CAN,P010452,P012095,6.45,3,11,8
12,CAN,P010623,P011251,19.417,1,40,39
12,CAN,P010623,P012016,12.85,-5,28,33
12,CAN,P010623,P012095,2.234,1,4,3
12,CAN,P011251,P012016,13.717,-6,31,37
12,CAN,P012016,P012095,4.967,6,11,5
13,BAH,P003840,P004172,8.017,4,16,12
13,BAH,P003840,P009601,13.684,6,29,23
13,BAH,P003840,P011192,18.234,13,41,28
13,BAH,P003840,P011201,11.217,10,24,14
13,BAH,P003840,P011821,15.034,7,33,26
13,BAH,P003840,P011823,16.117,15,36,21
13,BAH,P003840,P012405,9.317,-2,17,19
13,BAH,P003840,P012711,13.384,15,32,17
13,BAH,P004172,P009601,11.084,11,31,20
13,BAH,P004172,P011192,6.201,8,20,12
13,BAH,P004172,P011201,10.3,-3,16,19
13,BAH,P004172,P011821,14.918,11,36,25
13,BAH,P004172,P011823,8.951,6,19,13
13,BAH,P004172,P012405,4.033,-1,7,8
13,BAH,P004172,P012711,15.368,4,31,27
13,BAH,P009601,P011192,20.435,11,47,36
13,BAH,P009601,P011201,13.4,6,27,21
13,BAH,P009601,P011821,17.351,8,40,32
13,BAH,P009601,P011823,12.051,19,32,13
13,BAH,P009601,P012405,6.366,-10,8,18
13,BAH,P009601,P012711,6.901,5,18,13
13,BAH,P011192,P011201,12.801,11,30,19
13,BAH,P011192,P011821,15.734,6,35,29
13,BAH,P011192,P011823,14.684,22,41,19
13,BAH,P011192,P012405,7.7,-3,12,15
13,BAH,P011192,P012711,10.151,8,26,18
13,BAH,P011201,P011821,7.55,-4,10,14
13,BAH,P011201,P011823,12.984,5,26,21
13,BAH,P011201,P012405,3.633,0,4,4
13,BAH,P011201,P012711,11.851,3,23,20
13,BAH,P011821,P011823,11.368,12,28,16
13,BAH,P011821,P012405,10.516,-6,17,23
13,BAH,P011821,P012711,14.001,6,29,23
13,BAH,P011823,P012711,9.317,1,18,17
13,BAH,P012405,P012711,5.367,6,11,5
13,BES,P003783,P007914,14.967,1,30,29
13,BES,P003783,P008945,11.017,-4,17,21
13,BES,P003783,P009680,11.217,-8,18,26
13,BES,P003783,P010652,15.501,-4,29,33
13,BES,P003783,P011379,5.966,-2,7,9
13,BES,P003783,P011927,8.683,4,15,11
13,BES,P003783,P011936,7.867,-4,15,19
13,BES,P003783,P013255,10.65,-7,13,20
13,BES,P007914,P008945,8.634,-6,16,22
13,BES,P007914,P009680,12.133,-8,22,30
13,BES,P007914,P010652,14.017,-1,28,29
13,BES,P007914,P011379,2.583,2,4,2
13,BES,P007914,P011924,1.633,0,2,2
13,BES,P007914,P011927,5.7,6,12,6
13,BES,P007914,P011936,10.983,-5,22,27
13,BES,P007914,P013255,6.95,-5,12,17
13,BES,P008945,P009680,11.234,-10,19,29
13,BES,P008945,P010652,8.934,-5,16,21
13,BES,P008945,P011379,8.783,-4,16,20
13,BES,P008945,P011924,8.2,-6,18,24
13,BES,P008945,P011927,9.216,-3,18,21
13,BES,P008945,P011936,4.3,-6,8,14
13,BES,P008945,P013255,17.75,-16,32,48
13,BES,P009680,P010652,14.4,-11,22,33
13,BES,P009680,P011379,0.5,-2,0,2
13,BES,P009680,P011924,5.183,-6,7,13
13,BES,P009680,P011936,12.266,-15,19,34
13,BES,P009680,P013255,9.867,-16,13,29
13,BES,P010652,P011924,6.983,-6,6,12
13,BES,P010652,P011927,6.517,3,10,7
13,BES,P010652,P011936,13.55,-5,19,24
13,BES,P010652,P013255,10.034,-11,10,21
13,BES,P011379,P011924,7.25,-3,16,19
13,BES,P011379,P011927,12.716,-3,23,26
13,BES,P011379,P011936,1.85,-3,3,6
13,BES,P011379,P013255,13.216,-5,23,28
13,BES,P011924,P011927,10.55,-4,18,22
13,BES,P011924,P011936,9.033,-5,10,15
13,BES,P011924,P013255,14.1,-10,23,33
13,BES,P011927,P011936,7.434,1,11,10
13,BES,P011927,P013255,16.116,-4,25,29
13,BES,P011936,P013255,11.517,-14,13,27
14,HTA,P001927,P004846,18.584,2,40,38
14,HTA,P001927,P005181,10.167,7,22,15
14,HTA,P001927,P010550,24.6,6,55,49
14,HTA,P001927,P011157,26.5,6,57,51
14,HTA,P001927,P012096,1.7,-1,1,2
14,HTA,P001927,P013284,24.917,8,57,49
14,HTA,P004846,P005181,6.2,4,16,12
14,HTA,P004846,P010550,18.517,5,43,38
14,HTA,P004846,P011157,22.533,3,51,48
14,HTA,P004846,P012096,3.816,-3,7,10
14,HTA,P004846,P013283,1.433,-3,3,6
14,HTA,P004846,P013284,19.517,8,48,40
14,HTA,P005181,P009818,7.25,0,17,17
14,HTA,P005181,P010386,9.317,-4,19,23
14,HTA,P005181,P010550,12.167,6,27,21
14,HTA,P005181,P011157,14.116,8,33,25
14,HTA,P005181,P012096,13.133,-7,26,33
14,HTA,P005181,P013283,10.083,-5,22,27
14,HTA,P005181,P013284,11.767,11,30,19
14,HTA,P009818,P010386,7.25,0,17,17
14,HTA,P009818,P012096,7.25,0,17,17
14,HTA,P009818,P013283,7.25,0,17,17
14,HTA,P010386,P010550,2.067,-4,2,6
14,HTA,P010386,P012096,9.317,-4,19,23
14,HTA,P010386,P013283,8.65,-2,19,21
14,HTA,P010386,P013284,0.667,-2,0,2
14,HTA,P010550,P011157,26.433,9,60,51
14,HTA,P010550,P012096,2.067,-4,2,6
14,HTA,P010550,P013283,1.4,-2,2,4
14,HTA,P010550,P013284,27.217,8,61,53
14,HTA,P011157,P012096,3.816,-3,7,10
14,HTA,P011157,P013283,1.433,-3,3,6
14,HTA,P011157,P013284,27.433,12,65,53
14,HTA,P012096,P013283,10.083,-5,22,27
14,HTA,P012096,P013284,1.35,-1,3,4
14,WOL,P003212,P004645,0.233,0,0,0
14,WOL,P003212,P005516,5.783,-2,13,15
14,WOL,P003212,P006853,5.783,-2,13,15
14,WOL,P003212,P008186,5.55,-2,13,15
14,WOL,P003212,P012577,5.55,-2,13,15
14,WOL,P003212,P012789,0.233,0,0,0
14,WOL,P004645,P005516,4.1,-2,6,8
14,WOL,P004645,P006853,7.433,-2,12,14
14,WOL,P004645,P008186,2.184,3,6,3
14,WOL,P004645,P009306,8.967,-7,17,24
14,WOL,P004645,P011248,17.884,1,39,38
14,WOL,P004645,P012003,22.351,-4,43,47
14,WOL,P004645,P012577,9.883,8,24,16
14,WOL,P004645,P012789,21.233,-5,41,46
14,WOL,P005516,P006853,11.666,0,28,28
14,WOL,P005516,P008186,11.75,1,28,27
14,WOL,P005516,P009306,0.167,-2,0,2
14,WOL,P005516,P011248,4.334,0,11,11
14,WOL,P005516,P012003,6.684,-2,12,14
14,WOL,P005516,P012577,9.384,0,24,24
14,WOL,P005516,P012789,3.4,-5,6,11
14,WOL,P006853,P008186,11.75,1,28,27
14,WOL,P006853,P011248,7.217,3,16,13
14,WOL,P006853,P012003,13.317,0,25,25
14,WOL,P006853,P012577,16.25,5,39,34
14,WOL,P006853,P012789,9.716,-1,19,20
14,WOL,P008186,P011248,5.951,5,15,10
14,WOL,P008186,P012003,6.651,1,12,11
14,WOL,P008186,P012577,10.867,0,24,24
14,WOL,P008186,P012789,0.833,-1,2,3
14,WOL,P009306,P011248,10.584,-12,19,31
14,WOL,P009306,P012003,10.417,-10,19,29
14,WOL,P009306,P012577,1.617,-5,2,7
14,WOL,P009306,P012789,10.584,-12,19,31
14,WOL,P011248,P012003,24.585,-4,48,52
14,WOL,P011248,P012577,14.851,3,32,29
14,WOL,P011248,P012789,20.334,-8,40,48
14,WOL,P012003,P012577,19.067,9,43,34
14,WOL,P012003,P012789,26.4,-6,54,60
14,WOL,P012577,P012789,14.467,6,35,29
15,JOV,P002361,P002507,10.3,3,24,21
15,JOV,P002361,P004834,7.316,1,16,15
15,JOV,P002361,P006771,3.0,-3,4,7
15,JOV,P002361,P010161,8.416,0,14,14
15,JOV,P002361,P012349,7.316,1,16,15
15,JOV,P002361,P012740,7.949,-2,21,23
15,JOV,P002361,P013285,8.567,8,19,11
15,JOV,P002361,P013287,10.533,3,24,21
15,JOV,P002361,PJUG,7.999,5,22,17
15,JOV,P002507,P006771,0.583,-3,0,3
15,JOV,P002507,P010161,11.733,-1,16,17
15,JOV,P002507,P012349,0.583,-3,0,3
15,JOV,P002507,P012740,12.666,2,34,32
15,JOV,P002507,P013285,15.533,0,32,32
15,JOV,P002507,P013287,20.366,4,47,43
15,JOV,P002507,PJUG,12.032,2,35,33
15,JOV,P004834,P006771,9.817,-12,13,25
15,JOV,P004834,P010161,5.316,1,13,12
15,JOV,P004834,P012349,13.616,-8,25,33
15,JOV,P004834,P012740,13.066,-8,24,32
15,JOV,P004834,P013285,11.2,5,23,18
15,JOV,P004834,P013286,3.983,-5,7,12
15,JOV,P004834,P013287,5.2,3,11,8
15,JOV,P004834,PJUG,5.75,3,12,9
15,JOV,P006771,P012349,9.883,-15,13,28
15,JOV,P006771,P012740,7.75,-9,11,20
15,JOV,P006771,P013285,3.417,-7,2,9
15,JOV,P006771,P013286,3.983,-5,7,12
15,JOV,P006771,P013287,0.517,0,0,0
15,JOV,P006771,PJUG,2.65,-6,2,8
15,JOV,P010161,P012349,0.633,-2,2,4
15,JOV,P010161,P012740,10.599,-1,19,20
15,JOV,P010161,P013285,12.733,1,21,20
15,JOV,P010161,P013287,16.649,2,27,25
15,JOV,P010161,PJUG,3.049,0,4,4
15,JOV,P012349,P012740,7.866,-11,13,24
15,JOV,P012349,P013285,6.583,-1,12,13
15,JOV,P012349,P013286,3.983,-5,7,12
15,JOV,P012349,PJUG,6.333,0,12,12
15,JOV,P012740,P013285,14.033,1,30,29
15,JOV,P012740,P013286,3.983,-5,7,12
15,JOV,P012740,P013287,18.099,5,45,40
15,JOV,P012740,PJUG,7.849,4,28,24
15,JOV,P013285,P013287,20.15,6,43,37
15,JOV,P013285,PJUG,14.716,7,38,31
15,JOV,P013287,PJUG,11.682,5,35,30
15,ULM,P006245,P006997,15.366,-3,36,39
15,ULM,P006245,P007952,5.25,2,12,10
15,ULM,P006245,P010726,3.333,-1,7,8
15,ULM,P006245,P011391,8.217,3,19,16
15,ULM,P006245,P011437,18.6,0,44,44
15,ULM,P006245,P012077,1.65,1,4,3
15,ULM,P006245,P013289,2.967,1,7,6
15,ULM,P006245,P013290,23.583,0,55,55
15,ULM,P006245,P013291,15.366,-3,36,39
15,ULM,P006997,P010726,3.05,0,5,5
15,ULM,P006997,P011437,18.817,0,41,41
15,ULM,P006997,P012077,6.167,3,10,7
15,ULM,P006997,P012602,1.7,2,2,0
15,ULM,P006997,P013290,20.0,-2,44,46
15,ULM,P006997,P013291,21.7,0,46,46
15,ULM,P007952,P010726,7.667,2,19,17
15,ULM,P007952,P011391,10.767,3,27,24
15,ULM,P007952,P011437,2.6,-1,6,7
15,ULM,P007952,P012077,6.017,3,17,14
15,ULM,P007952,P012602,5.517,1,15,14
15,ULM,P007952,P013290,5.25,2,12,10
15,ULM,P010726,P011391,11.183,3,25,22
15,ULM,P010726,P011437,0.167,0,0,0
15,ULM,P010726,P012077,10.733,4,23,19
15,ULM,P010726,P012602,10.733,4,23,19
15,ULM,P010726,P013289,2.833,3,6,3
15,ULM,P010726,P013290,3.5,-1,7,8
15,ULM,P010726,P013291,3.733,-2,5,7
15,ULM,P011391,P011437,5.467,0,12,12
15,ULM,P011391,P012077,11.733,2,26,24
15,ULM,P011391,P012602,9.433,0,21,21
15,ULM,P011391,P013289,5.8,4,13,9
15,ULM,P011391,P013290,8.867,4,20,16
15,ULM,P011391,P013291,1.733,-3,1,4
15,ULM,P011437,P012077,5.517,0,9,9
15,ULM,P011437,P012602,0.4,-2,0,2
15,ULM,P011437,P013289,1.817,2,5,3
15,ULM,P011437,P013290,23.884,2,53,51
15,ULM,P011437,P013291,19.867,-1,42,43
15,ULM,P012077,P012602,11.133,2,23,21
15,ULM,P012077,P013289,3.983,2,8,6
15,ULM,P012077,P013290,6.767,3,13,10
15,ULM,P012077,P013291,7.9,0,11,11
15,ULM,P012602,P013289,2.833,3,6,3
15,ULM,P012602,P013291,2.783,-2,2,4
15,ULM,P013289,P013290,2.967,1,7,6
15,ULM,P013290,P013291,20.65,-1,45,46
16,JER,P006625,P008912,13.117,-9,24,33
16,JER,P006625,P010431,15.417,31,50,19
16,JER,P006625,P010587,21.05,17,60,43
16,JER,P006625,P011970,23.667,26,65,39
16,JER,P006625,P013276,17.967,23,49,26
16,JER,P006625,P013277,15.55,-4,32,36
16,JER,P006625,P013278,6.734,-10,13,23
16,JER,P006625,P013279,8.417,11,20,9
16,JER,P006625,P013281,2.217,11,11,0
16,JER,P008912,P010431,3.967,-2,5,7
16,JER,P008912,P010587,11.834,-11,21,32
16,JER,P008912,P011970,12.084,1,23,22
16,JER,P008912,P013276,9.401,4,18,14
16,JER,P008912,P013277,15.967,-7,31,38
16,JER,P008912,P013278,6.15,-10,11,21
16,JER,P008912,P013279,2.884,-2,3,5
16,JER,P010431,P010587,13.683,28,47,19
16,JER,P010431,P011970,13.584,21,40,19
16,JER,P010431,P013276,13.067,17,36,19
16,JER,P010431,P013277,6.067,-4,6,10
16,JER,P010431,P013278,3.517,0,7,7
16,JER,P010431,P013279,6.017,14,18,4
16,JER,P010431,P013281,2.217,11,11,0
16,JER,P010587,P011970,18.683,17,52,35
16,JER,P010587,P013276,9.75,18,33,15
16,JER,P010587,P013277,12.033,-6,26,32
16,JER,P010587,P013278,12.567,-14,21,35
16,JER,P010587,P013279,9.55,4,18,14
16,JER,P010587,P013281,5.45,7,14,7
16,JER,P011970,P013276,18.201,15,46,31
16,JER,P011970,P013277,15.167,-2,28,30
16,JER,P011970,P013278,5.5,-4,8,12
16,JER,P011970,P013279,7.8,7,16,9
16,JER,P011970,P013281,5.45,7,14,7
16,JER,P013276,P013277,9.584,-2,15,17
16,JER,P013276,P013279,6.434,17,19,2
16,JER,P013277,P013278,7.667,-5,16,21
16,JER,P013277,P013279,0.233,2,2,0
16,JER,P013278,P013279,4.9,-9,5,14
16,JER,P013278,P013281,3.233,-4,3,7
16,JER,P013279,P013281,3.233,-4,3,7
16,LKB,P005113,P005521,13.983,-1,28,29
16,LKB,P005113,P005656,14.75,8,37,29
16,LKB,P005113,P006586,8.984,0,20,20
16,LKB,P005113,P006860,0.833,0,1,1
16,LKB,P005113,P009299,13.683,-1,26,27
16,LKB,P005113,P009898,9.65,-2,19,21
16,LKB,P005113,P013247,13.167,5,29,24
16,LKB,P005113,PLXI,8.75,-1,16,17
16,LKB,P005521,P005656,18.05,6,38,32
16,LKB,P005521,P006586,9.05,-4,15,19
16,LKB,P005521,P006860,1.467,-1,2,3
16,LKB,P005521,P009299,12.35,1,25,24
16,LKB,P005521,P009898,3.1,-3,5,8
16,LKB,P005521,P010461,7.417,-2,12,14
16,LKB,P005521,P013247,18.3,0,35,35
16,LKB,P005521,PLXI,1.883,-8,0,8
16,LKB,P005656,P006586,11.6,4,24,20
16,LKB,P005656,P009299,9.35,6,23,17
16,LKB,P005656,P009898,5.233,0,12,12
16,LKB,P005656,P010461,6.2,2,10,8
16,LKB,P005656,P013247,15.717,10,35,25
16,LKB,P005656,PLXI,2.9,4,9,5
16,LKB,P006586,P006860,5.1,-14,2,16
16,LKB,P006586,P009299,4.183,-11,6,17
16,LKB,P006586,P009898,14.4,-20,20,40
16,LKB,P006586,P010461,13.866,-24,16,40
16,LKB,P006586,P013247,10.317,-3,20,23
16,LKB,P006586,PLXI,13.9,-24,21,45
16,LKB,P006860,P009299,6.017,2,15,13
16,LKB,P006860,P009898,10.25,-12,15,27
16,LKB,P006860,P010461,10.284,-12,16,28
16,LKB,P006860,P013247,0.867,0,2,2
16,LKB,P006860,PLXI,9.65,-11,15,26
16,LKB,P009299,P009898,7.35,-5,15,20
16,LKB,P009299,P010461,7.65,-6,18,24
16,LKB,P009299,P013247,13.983,-2,29,31
16,LKB,P009299,PLXI,10.766,-12,19,31
16,LKB,P009898,P010461,9.9,-16,14,30
16,LKB,P009898,P013247,1.867,1,4,3
16,LKB,P009898,PLXI,16.45,-15,28,43
16,LKB,P010461,P013247,9.15,-6,16,22
16,LKB,P010461,PLXI,11.733,-24,18,42
16,LKB,P013247,PLXI,5.9,-9,10,19
17,ARI,P003240,P004292,13.415,0,21,21
17,ARI,P003240,P008084,10.283,-2,17,19
17,ARI,P003240,P013049,0.067,2,2,0
17,ARI,P003240,P013248,2.6,7,9,2
17,ARI,P003240,P013249,9.782,1,18,17
17,ARI,P003240,P013250,9.116,-9,9,18
17,ARI,P003240,P013251,4.8,2,6,4
17,ARI,P003240,P013252,12.733,-7,15,22
17,ARI,P003240,P013355,4.25,-4,2,6
17,ARI,P003240,P013356,9.834,-1,13,14
17,ARI,P003240,P013360,3.116,-5,0,5
17,ARI,P004292,P008084,18.715,-2,28,30
17,ARI,P004292,P013248,4.666,7,11,4
17,ARI,P004292,P013249,12.665,3,24,21
17,ARI,P004292,P013250,11.582,-3,19,22
17,ARI,P004292,P013251,7.633,4,12,8
17,ARI,P004292,P013252,14.766,-3,23,26
17,ARI,P004292,P013355,4.25,-4,2,6
17,ARI,P004292,P013356,7.767,-2,12,14
17,ARI,P004292,P013360,0.933,0,0,0
17,ARI,P008084,P013049,0.067,2,2,0
17,ARI,P008084,P013248,12.066,5,27,22
17,ARI,P008084,P013249,21.915,3,41,38
17,ARI,P008084,P013250,22.216,-4,43,47
17,ARI,P008084,P013251,14.749,-2,25,27
17,ARI,P008084,P013252,14.483,-4,21,25
17,ARI,P008084,P013355,3.317,-4,2,6
17,ARI,P008084,P013356,3.317,-4,2,6
17,ARI,P013049,P013250,0.067,2,2,0
17,ARI,P013049,P013252,0.067,2,2,0
17,ARI,P013248,P013249,12.066,5,27,22
17,ARI,P013248,P013250,9.983,-2,20,22
17,ARI,P013248,P013251,6.883,-2,14,16
17,ARI,P013249,P013250,19.515,-7,34,41
17,ARI,P013249,P013251,11.032,-3,18,21
17,ARI,P013249,P013252,13.815,-8,17,25
17,ARI,P013249,P013356,2.083,-1,5,6
17,ARI,P013249,P013360,2.183,-5,0,5
17,ARI,P013250,P013251,15.183,1,26,25
17,ARI,P013250,P013252,16.15,-6,22,28
17,ARI,P013250,P013355,0.933,0,0,0
17,ARI,P013250,P013356,2.067,1,1,0
17,ARI,P013250,P013360,3.116,-5,0,5
17,ARI,P013251,P013252,12.35,4,17,13
17,ARI,P013251,P013356,4.434,4,6,2
17,ARI,P013252,P013356,6.517,3,11,8
17,ARI,P013252,P013360,2.183,-5,0,5
17,ARI,P013355,P013356,3.317,-4,2,6
17,ARI,P013355,P013360,0.933,0,0,0
17,TTK,P004056,P004218,5.366,-3,7,10
17,TTK,P004056,P004619,2.6,1,6,5
17,TTK,P004056,P006598,7.95,4,17,13
17,TTK,P004056,P009025,11.233,-1,21,22
17,TTK,P004056,P011935,2.6,1,6,5
17,TTK,P004056,P011973,12.033,-1,21,22
17,TTK,P004056,P012259,6.683,-4,10,14
17,TTK,P004056,P013300,10.067,3,20,17
17,TTK,P004218,P006598,14.583,11,28,17
17,TTK,P004218,P009025,16.799,5,32,27
17,TTK,P004218,P011935,4.117,2,5,3
17,TTK,P004218,P011973,15.416,0,27,27
17,TTK,P004218,P012259,13.05,-4,22,26
17,TTK,P004218,P012415,1.617,-1,0,1
17,TTK,P004218,P013300,7.184,-2,7,9
17,TTK,P004619,P011935,2.6,1,6,5
17,TTK,P004619,P012259,2.6,1,6,5
17,TTK,P004619,P013300,2.6,1,6,5
17,TTK,P006598,P007917,3.733,1,6,5
17,TTK,P006598,P009025,27.366,19,54,35
17,TTK,P006598,P011935,8.367,6,11,5
17,TTK,P006598,P011973,25.183,14,49,35
17,TTK,P006598,P012259,8.167,3,18,15
17,TTK,P006598,P012415,1.617,-1,0,1
17,TTK,P006598,P013300,20.234,7,33,26
17,TTK,P007917,P009025,6.883,-2,10,12
17,TTK,P007917,P011935,0.25,0,0,0
17,TTK,P007917,P011973,6.883,-2,10,12
17,TTK,P007917,P012259,2.9,-3,4,7
17,TTK,P007917,P013300,6.883,-2,10,12
17,TTK,P009025,P011935,6.683,9,11,2
17,TTK,P009025,P011973,32.483,2,57,55
17,TTK,P009025,P012259,14.9,-7,26,33
17,TTK,P009025,P013300,22.317,3,37,34
17,TTK,P011935,P011973,4.5,4,6,2
17,TTK,P011935,P012259,2.917,-1,6,7
17,TTK,P011935,P012415,1.617,-1,0,1
17,TTK,P011935,P013300,11.217,7,17,10
17,TTK,P011973,P012259,15.7,-7,26,33
17,TTK,P011973,P013300,20.934,-2,32,34
17,TTK,P012259,P013300,7.551,-10,10,20
17,TTK,P012415,P013300,1.617,-1,0,1
18,LJU,P003452,P003703,19.799,0,42,42
18,LJU,P003452,P009392,9.4,11,28,17
18,LJU,P003452,P009753,15.016,0,29,29
18,LJU,P003452,P012042,23.798,0,53,53
18,LJU,P003452,P012700,15.766,-11,27,38
18,LJU,P003452,P012996,2.033,-2,5,7
18,LJU,P003452,P013260,5.566,6,19,13
18,LJU,P003452,P013262,1.367,3,5,2
18,LJU,P003452,P013263,8.183,5,24,19
18,LJU,P003703,P009392,11.2,9,26,17
18,LJU,P003703,P009753,15.816,3,33,30
18,LJU,P003703,P012042,22.965,1,47,46
18,LJU,P003703,P012700,15.866,-7,27,34
18,LJU,P003703,P012996,2.033,-2,5,7
18,LJU,P003703,P013260,3.0,4,7,3
18,LJU,P003703,P013261,4.533,4,10,6
18,LJU,P003703,P013262,4.234,4,9,5
18,LJU,P003703,P013263,9.35,4,18,14
18,LJU,P009392,P009753,6.366,-3,15,18
18,LJU,P009392,P012042,11.849,10,30,20
18,LJU,P009392,P012700,0.75,-1,1,2
18,LJU,P009392,P013260,12.416,5,28,23
18,LJU,P009392,P013261,8.632,2,19,17
18,LJU,P009392,P013262,8.6,7,22,15
18,LJU,P009392,P013263,14.383,16,35,19
18,LJU,P009753,P012042,17.249,-1,33,34
18,LJU,P009753,P012700,14.7,-8,21,29
18,LJU,P009753,P013260,4.916,-6,9,15
18,LJU,P009753,P013261,5.583,-6,10,16
18,LJU,P009753,P013262,2.75,-3,6,9
18,LJU,P012042,P012700,17.399,-9,32,41
18,LJU,P012042,P012996,2.033,-2,5,7
18,LJU,P012042,P013260,6.249,4,19,15
18,LJU,P012042,P013261,5.433,3,11,8
18,LJU,P012042,P013262,0.15,1,1,0
18,LJU,P012042,P013263,9.799,5,25,20
18,LJU,P012700,P012996,2.033,-2,5,7
18,LJU,P012700,P013260,3.7,-7,6,13
18,LJU,P012700,P013261,3.95,-2,7,9
18,LJU,P012700,P013262,1.867,-1,3,4
18,LJU,P012700,P013263,2.833,-4,7,11
18,LJU,P013260,P013261,7.216,-4,14,18
18,LJU,P013260,P013262,8.8,1,18,17
18,LJU,P013260,P013263,10.733,9,28,19
18,LJU,P013261,P013262,6.083,1,15,14
18,LJU,P013261,P013263,6.166,6,14,8
18,LJU,P013262,P013263,7.417,7,17,10
18,VNC,P003759,P005404,6.0,-4,10,14
18,VNC,P003759,P008052,5.767,-11,5,16
18,VNC,P003759,P008858,4.1,-8,3,11
18,VNC,P003759,P009400,4.734,-6,7,13
18,VNC,P003759,P011909,1.767,2,5,3
18,VNC,P003759,P011928,1.65,2,5,3
18,VNC,P003759,P013305,5.65,-11,5,16
18,VNC,P005404,P006571,1.05,-3,0,3
18,VNC,P005404,P008052,15.817,-8,34,42
18,VNC,P005404,P008858,23.583,-3,52,55
18,VNC,P005404,P009400,10.134,5,28,23
18,VNC,P005404,P011909,19.884,9,46,37
18,VNC,P005404,P011928,17.883,9,46,37
18,VNC,P005404,P012796,22.433,8,52,44
18,VNC,P005404,P013305,9.616,-9,16,25
18,VNC,P006571,P008052,1.05,-3,0,3
18,VNC,P006571,P008858,1.05,-3,0,3
18,VNC,P006571,P013305,1.05,-3,0,3
18,VNC,P008052,P008858,16.233,-12,33,45
18,VNC,P008052,P009400,10.484,-9,18,27
18,VNC,P008052,P011909,4.101,0,9,9
18,VNC,P008052,P011928,2.1,0,9,9
18,VNC,P008052,P012796,11.3,-1,24,25
18,VNC,P008052,P013305,14.016,-16,20,36
18,VNC,P008858,P009400,10.517,-5,20,25
18,VNC,P008858,P011909,17.417,3,36,33
18,VNC,P008858,P011928,17.85,3,39,36
18,VNC,P008858,P012796,24.716,2,51,49
18,VNC,P008858,P013305,12.466,-13,18,31
18,VNC,P009400,P011909,10.484,8,24,16
18,VNC,P009400,P011928,10.15,9,30,21
18,VNC,P009400,P012796,11.683,4,23,19
18,VNC,P009400,P013305,5.95,-10,6,16
18,VNC,P011909,P011928,19.783,9,44,35
18,VNC,P011909,P012796,22.1,9,48,39
18,VNC,P011928,P012796,18.116,8,39,31
18,VNC,P012796,P013305,7.316,-2,15,17
19,BOU,P004525,P006904,0.183,0,0,0
19,BOU,P004525,P009552,2.183,3,5,2
19,BOU,P004525,P009556,0.617,0,0,0
19,BOU,P004525,P010449,20.166,11,46,35
19,BOU,P004525,P010450,1.583,-1,3,4
19,BOU,P004525,P011837,16.983,7,38,31
19,BOU,P004525,P013264,1.183,1,3,2
19,BOU,P004525,P013265,19.066,13,44,31
19,BOU,P004525,P013266,19.432,10,45,35
19,BOU,P004945,P006904,5.35,-2,9,11
19,BOU,P004945,P009552,4.683,1,9,8
19,BOU,P004945,P010450,5.35,-2,9,11
19,BOU,P004945,P011837,0.667,-3,0,3
19,BOU,P004945,P013264,5.35,-2,9,11
19,BOU,P006904,P009552,14.566,1,26,25
19,BOU,P006904,P009556,9.199,9,21,12
19,BOU,P006904,P010450,15.25,3,30,27
19,BOU,P006904,P011837,4.75,-3,10,13
19,BOU,P006904,P013264,19.133,-2,36,38
19,BOU,P006904,P013265,4.066,-5,6,11
19,BOU,P006904,P013266,4.767,-9,6,15
19,BOU,P009552,P009556,7.566,5,15,10
19,BOU,P009552,P010449,2.183,3,5,2
19,BOU,P009552,P010450,13.083,7,26,19
19,BOU,P009552,P013264,14.566,1,26,25
19,BOU,P009552,P013265,3.666,-3,5,8
19,BOU,P009552,P013266,4.5,-2,7,9
19,BOU,P009556,P010449,0.617,0,0,0
19,BOU,P009556,P010450,7.133,7,15,8
19,BOU,P009556,P011837,2.25,4,6,2
19,BOU,P009556,P013264,9.199,9,21,12
19,BOU,P009556,P013265,2.683,2,6,4
19,BOU,P010449,P010450,2.1,1,5,4
19,BOU,P010449,P011837,17.317,9,40,31
19,BOU,P010449,P013264,1.7,3,5,2
19,BOU,P010449,P013265,18.883,13,44,31
19,BOU,P010449,P013266,19.766,12,47,35
19,BOU,P010450,P011837,3.967,-4,8,12
19,BOU,P010450,P013264,16.067,6,33,27
19,BOU,P010450,P013265,0.3,1,1,0
19,BOU,P010450,P013266,4.567,-2,10,12
19,BOU,P011837,P013264,5.084,-1,12,13
19,BOU,P011837,P013265,18.1,10,42,32
19,BOU,P011837,P013266,19.15,5,44,39
19,BOU,P013264,P013265,5.066,-4,9,13
19,BOU,P013264,P013266,5.984,-7,10,17
19,BOU,P013265,P013266,19.966,5,43,38
19,CLU,P002820,P004862,4.4,-5,6,11
19,CLU,P002820,P005714,8.15,-3,14,17
19,CLU,P002820,P006618,10.7,6,25,19
19,CLU,P002820,P010651,10.85,-10,16,26
19,CLU,P002820,P011801,8.95,-10,10,20
19,CLU,P002820,P012620,1.967,-3,3,6
19,CLU,P002820,P012698,8.317,14,25,11
19,CLU,P002820,P013302,22.517,0,46,46
19,CLU,P002820,P013304,18.217,7,39,32
19,CLU,P004862,P005714,10.65,-15,14,29
19,CLU,P004862,P006618,8.883,-15,10,25
19,CLU,P004862,P011801,3.467,-7,3,10
19,CLU,P004862,P012620,5.15,-7,7,14
19,CLU,P004862,P012698,8.75,-12,11,23
19,CLU,P004862,P013302,7.033,-5,10,15
19,CLU,P004862,P013304,4.267,-2,7,9
19,CLU,P005714,P006618,8.116,-13,11,24
19,CLU,P005714,P011801,6.45,-3,12,15
19,CLU,P005714,P012620,4.383,-5,8,13
19,CLU,P005714,P012698,7.983,-10,12,22
19,CLU,P005714,P013302,10.783,-3,18,21
19,CLU,P005714,P013304,8.017,0,15,15
19,CLU,P006618,P010651,5.6,-4,9,13
19,CLU,P006618,P011801,8.8,-14,9,23
19,CLU,P006618,P012620,9.566,-18,11,29
19,CLU,P006618,P012698,19.067,-7,35,42
19,CLU,P006618,P013302,12.2,5,28,23
19,CLU,P006618,P013304,7.2,8,18,10
19,CLU,P010651,P011801,5.2,-12,2,14
19,CLU,P010651,P012620,6.167,5,15,10
19,CLU,P010651,P012698,8.0,10,21,11
19,CLU,P010651,P013302,14.05,-1,28,29
19,CLU,P010651,P013304,10.333,4,21,17
19,CLU,P011801,P012620,5.716,-7,7,14
19,CLU,P011801,P012698,8.0,-14,7,21
19,CLU,P011801,P013302,8.267,-10,10,20
19,CLU,P011801,P013304,8.95,-15,8,23
19,CLU,P012620,P012698,12.566,-4,23,27
19,CLU,P012620,P013302,6.167,5,15,10
19,CLU,P012620,P013304,6.45,6,15,9
19,CLU,P012698,P013302,14.467,22,41,19
19,CLU,P012698,P013304,12.05,17,33,16
19,CLU,P013302,P013304,23.184,15,52,37
20,HAM,P003242,P006006,2.217,-5,2,7
20,HAM,P003242,P006420,0.817,-5,0,5
20,HAM,P003242,P010070,0.567,0,0,0
20,HAM,P003242,P011256,9.6,-8,22,30
20,HAM,P003242,P012695,5.384,-10,5,15
20,HAM,P003242,P013308,13.2,-5,30,35
20,HAM,P003242,P013309,13.767,1,29,28
20,HAM,P003242,P013311,9.6,-2,21,23
20,HAM,P003242,P013312,22.25,0,51,51
20,HAM,P003242,P013313,16.066,6,44,38
20,HAM,P006006,P006420,8.334,-10,13,23
20,HAM,P006006,P010070,11.117,-6,21,27
20,HAM,P006006,P011256,3.233,-4,8,12
20,HAM,P006006,P013308,1.067,-5,0,5
20,HAM,P006006,P013309,11.7,-6,23,29
20,HAM,P006006,P013311,8.967,-7,15,22
20,HAM,P006006,P013312,4.433,-1,10,11
20,HAM,P006420,P010070,9.7,-16,13,29
20,HAM,P006420,P011256,1.4,-7,0,7
20,HAM,P006420,P012695,1.433,-9,0,9
20,HAM,P006420,P013308,1.817,-7,0,7
20,HAM,P006420,P013309,8.7,-14,13,27
20,HAM,P006420,P013311,9.117,-14,13,27
20,HAM,P006420,P013313,0.75,-2,0,2
20,HAM,P010070,P011256,7.866,-9,14,23
20,HAM,P010070,P012695,1.433,-9,0,9
20,HAM,P010070,P013308,5.567,-9,6,15
20,HAM,P010070,P013309,11.65,-11,21,32
20,HAM,P010070,P013311,8.75,-11,13,24
20,HAM,P010070,P013312,7.5,-4,14,18
20,HAM,P010070,P013313,4.65,-5,6,11
20,HAM,P011256,P012695,0.3,-2,0,2
20,HAM,P011256,P013308,14.733,-17,28,45
20,HAM,P011256,P013309,2.733,0,8,8
20,HAM,P011256,P013312,15.766,-8,36,44
20,HAM,P011256,P013313,14.233,-13,28,41
20,HAM,P012695,P013308,0.567,-2,0,2
20,HAM,P012695,P013309,6.517,-17,5,22
20,HAM,P012695,P013311,6.25,-17,5,22
20,HAM,P012695,P013312,5.084,-8,5,13
20,HAM,P012695,P013313,0.3,-2,0,2
20,HAM,P013308,P013309,3.617,3,8,5
20,HAM,P013308,P013311,0.417,0,0,0
20,HAM,P013308,P013312,16.65,-5,36,41
20,HAM,P013308,P013313,17.433,-9,36,45
20,HAM,P013309,P013311,17.933,-13,34,47
20,HAM,P013309,P013312,16.15,4,37,33
20,HAM,P013309,P013313,6.633,13,22,9
20,HAM,P013311,P013312,9.233,1,21,20
20,HAM,P013311,P013313,3.133,11,14,3
20,HAM,P013312,P013313,19.666,5,50,45
20,PAM,P004548,P005356,1.067,5,5,0
20,PAM,P004548,P006643,5.0,0,13,13
20,PAM,P004548,P007527,3.016,1,5,4
20,PAM,P004548,P009864,0.717,-1,0,1
20,PAM,P004548,P010042,5.817,0,14,14
20,PAM,P004548,P010393,4.934,4,13,9
20,PAM,P004548,P010444,2.233,-1,6,7
20,PAM,P004548,P011980,4.966,2,11,9
20,PAM,P004548,P011982,4.9,6,11,5
20,PAM,P004548,P012738,6.95,8,18,10
20,PAM,P004863,P005356,4.483,5,13,8
20,PAM,P004863,P006643,3.367,8,10,2
20,PAM,P004863,P007527,8.716,9,28,19
20,PAM,P004863,P009864,4.516,-3,7,10
20,PAM,P004863,P010042,5.883,5,11,6
20,PAM,P004863,P010393,6.583,8,18,10
20,PAM,P004863,P010444,6.583,15,22,7
20,PAM,P004863,P011980,9.283,10,27,17
20,PAM,P004863,P011982,9.283,9,28,19
20,PAM,P004863,P012738,4.767,6,16,10
20,PAM,P005356,P006643,6.551,16,25,9
20,PAM,P005356,P007527,2.35,4,6,2
20,PAM,P005356,P009864,6.183,-5,10,15
20,PAM,P005356,P010042,8.933,1,21,20
20,PAM,P005356,P010393,13.234,14,38,24
20,PAM,P005356,P010444,3.55,4,11,7
20,PAM,P005356,P011980,0.383,0,0,0
20,PAM,P005356,P011982,3.85,-3,6,9
20,PAM,P005356,P012738,3.884,15,17,2
20,PAM,P006643,P007527,4.716,2,13,11
20,PAM,P006643,P009864,3.0,0,9,9
20,PAM,P006643,P010042,14.4,12,39,27
20,PAM,P006643,P010393,10.551,11,35,24
20,PAM,P006643,P010444,8.433,8,22,14
20,PAM,P006643,P011980,6.466,8,15,7
20,PAM,P006643,P012738,5.584,11,19,8
20,PAM,P007527,P009864,7.833,3,21,18
20,PAM,P007527,P010042,6.167,-1,16,17
20,PAM,P007527,P010393,6.934,0,19,19
20,PAM,P007527,P010444,6.183,5,19,14
20,PAM,P007527,P011980,13.315,13,36,23
20,PAM,P007527,P011982,15.533,11,42,31
20,PAM,P007527,P012738,6.233,5,15,10
20,PAM,P009864,P010042,8.834,-10,16,26
20,PAM,P009864,P010393,10.734,-7,21,28
20,PAM,P009864,P011980,2.216,0,4,4
20,PAM,P009864,P011982,7.767,-5,12,17
20,PAM,P010042,P010393,16.801,-7,37,44
20,PAM,P010042,P010444,10.05,8,25,17
20,PAM,P010042,P011980,6.783,11,18,7
20,PAM,P010042,P011982,5.968,-9,9,18
20,PAM,P010042,P012738,4.7,6,14,8
20,PAM,P010393,P010444,4.417,-1,11,12
20,PAM,P010393,P011982,8.868,-3,17,20
20,PAM,P010393,P012738,7.484,17,27,10
20,PAM,P010444,P011980,9.366,15,29,14
20,PAM,P010444,P011982,4.317,3,15,12
20,PAM,P011980,P011982,10.899,10,31,21
20,PAM,P011980,P012738,5.783,3,13,10
20,PAM,P011982,P012738,7.683,9,21,12
21,JOV,P002361,P002507,8.899,5,17,12
21,JOV,P002361,P004834,9.699,4,25,21
21,JOV,P002361,P005099,7.349,-2,20,22
21,JOV,P002361,P006771,1.933,2,2,0
21,JOV,P002361,P010161,7.183,4,15,11
21,JOV,P002361,P012349,7.083,-5,13,18
21,JOV,P002361,P012740,14.832,2,33,31
21,JOV,P002361,P013285,5.932,15,17,2
21,JOV,P002361,P013287,11.482,11,26,15
21,JOV,P002507,P005099,10.099,1,22,21
21,JOV,P002507,P006771,3.116,-1,5,6
21,JOV,P002507,P010161,9.55,-9,7,16
21,JOV,P002507,P012349,2.983,-9,0,9
21,JOV,P002507,P012740,14.232,4,29,25
21,JOV,P002507,P013285,18.482,7,31,24
21,JOV,P002507,P013286,6.2,-7,3,10
21,JOV,P002507,P013287,20.499,5,34,29
21,JOV,P004834,P005099,11.599,0,28,28
21,JOV,P004834,P010161,6.166,6,15,9
21,JOV,P004834,P012349,5.466,1,13,12
21,JOV,P004834,P012740,13.266,2,33,31
21,JOV,P004834,P013285,8.716,6,22,16
21,JOV,P004834,P013287,11.016,5,28,23
21,JOV,P005099,P006771,0.333,-3,0,3
21,JOV,P005099,P010161,2.333,0,4,4
21,JOV,P005099,P012349,1.266,-9,0,9
21,JOV,P005099,P012740,16.632,-3,39,42
21,JOV,P005099,P013285,16.782,13,40,27
21,JOV,P005099,P013287,20.399,7,47,40
21,JOV,P006771,P012740,2.783,2,5,3
21,JOV,P006771,P013285,1.183,-3,3,6
21,JOV,P006771,P013287,3.116,-1,5,6
21,JOV,P010161,P012349,7.316,-1,13,14
21,JOV,P010161,P012740,6.083,0,13,13
21,JOV,P010161,P013285,9.633,-3,9,12
21,JOV,P010161,P013286,6.2,-7,3,10
21,JOV,P010161,P013287,8.4,-2,9,11
21,JOV,P012349,P012740,7.216,-7,13,20
21,JOV,P012349,P013285,1.233,-1,0,1
21,JOV,P012349,P013286,1.233,-1,0,1
21,JOV,P012740,P013285,14.699,14,37,23
21,JOV,P012740,P013287,20.249,10,46,36
21,JOV,P013285,P013286,6.2,-7,3,10
21,JOV,P013285,P013287,25.932,11,50,39
21,JOV,P013286,P013287,4.967,-6,3,9
21,TSO,P003885,P008790,11.234,4,29,25
21,TSO,P003885,P009649,14.151,17,39,22
21,TSO,P003885,P012019,12.2,4,26,22
21,TSO,P003885,P013292,2.4,-6,3,9
21,TSO,P003885,P013293,7.201,-10,9,19
21,TSO,P003885,P013295,10.301,11,25,14
21,TSO,P003885,P013296,5.2,4,10,6
21,TSO,P003885,P013297,2.934,-3,5,8
21,TSO,P003885,P013298,11.851,-1,30,31
21,TSO,P008790,P009649,12.7,3,30,27
21,TSO,P008790,P012019,13.65,2,27,25
21,TSO,P008790,P013292,2.4,-6,3,9
21,TSO,P008790,P013293,4.884,-6,7,13
21,TSO,P008790,P013295,9.033,4,18,14
21,TSO,P008790,P013297,7.066,-7,6,13
21,TSO,P008790,P013298,12.233,-6,20,26
21,TSO,P009649,P012019,24.45,-5,44,49
21,TSO,P009649,P013293,5.084,7,11,4
21,TSO,P009649,P013295,24.368,8,46,38
21,TSO,P009649,P013296,17.417,5,31,26
21,TSO,P009649,P013297,21.834,-15,32,47
21,TSO,P009649,P013298,12.2,0,31,31
21,TSO,P012019,P013293,3.834,-4,6,10
21,TSO,P012019,P013295,17.5,0,26,26
21,TSO,P012019,P013296,13.633,-9,21,30
21,TSO,P012019,P013297,18.517,-15,22,37
21,TSO,P012019,P013298,12.216,-9,20,29
21,TSO,P013292,P013293,2.4,-6,3,9
21,TSO,P013292,P013298,2.4,-6,3,9
21,TSO,P013293,P013295,4.067,5,7,2
21,TSO,P013293,P013296,5.417,1,9,8
21,TSO,P013293,P013297,3.1,5,7,2
21,TSO,P013293,P013298,5.217,-12,5,17
21,TSO,P013295,P013296,14.134,9,25,16
21,TSO,P013295,P013297,18.734,-4,28,32
21,TSO,P013295,P013298,6.267,7,17,10
21,TSO,P013296,P013297,13.567,-3,23,26
21,TSO,P013296,P013298,5.7,-3,13,16
21,TSO,P013297,P013298,8.516,-10,13,23
22,ULM,P006245,P006997,18.301,-6,37,43
22,ULM,P006245,P007952,4.518,8,13,5
22,ULM,P006245,P010726,11.534,11,30,19
22,ULM,P006245,P011391,20.134,21,54,33
22,ULM,P006245,P011437,9.45,4,20,16
22,ULM,P006245,P012077,8.235,9,24,15
22,ULM,P006245,P012602,2.717,3,8,5
22,ULM,P006245,P013290,24.418,10,60,50
22,ULM,P006245,P013291,9.833,4,22,18
22,ULM,P006997,P010726,9.167,2,23,21
22,ULM,P006997,P011391,18.568,8,42,34
22,ULM,P006997,P011437,13.101,4,24,20
22,ULM,P006997,P012077,8.234,-1,15,16
22,ULM,P006997,P012602,1.467,0,3,3
22,ULM,P006997,P013290,24.385,4,51,47
22,ULM,P006997,P013291,6.317,-7,9,16
22,ULM,P007952,P010726,5.168,6,15,9
22,ULM,P007952,P011391,7.701,0,19,19
22,ULM,P007952,P011437,2.867,-8,2,10
22,ULM,P007952,P012077,8.602,7,26,19
22,ULM,P007952,P012602,2.567,0,4,4
22,ULM,P007952,P013290,8.951,0,22,22
22,ULM,P007952,P013291,2.234,-1,3,4
22,ULM,P010726,P011391,14.617,7,37,30
22,ULM,P010726,P012077,6.601,6,18,12
22,ULM,P010726,P012602,1.45,1,4,3
22,ULM,P010726,P013290,12.134,8,34,26
22,ULM,P010726,P013291,1.333,3,3,0
22,ULM,P011391,P011437,10.734,15,27,12
22,ULM,P011391,P012077,17.735,3,41,38
22,ULM,P011391,P012602,1.8,-2,4,6
22,ULM,P011391,P013290,28.252,23,75,52
22,ULM,P011391,P013291,3.399,13,13,0
22,ULM,P011437,P012077,6.634,1,13,12
22,ULM,P011437,P012602,2.117,1,3,2
22,ULM,P011437,P013290,18.201,6,36,30
22,ULM,P011437,P013291,9.7,1,19,18
22,ULM,P012077,P012602,2.284,2,8,6
22,ULM,P012077,P013290,15.702,7,41,34
22,ULM,P012077,P013291,1.317,6,6,0
22,ULM,P012602,P013290,3.884,0,7,7
22,ULM,P012602,P013291,3.05,-1,3,4
22,ULM,P013290,P013291,10.617,2,22,20
22,WOL,P004645,P005516,14.534,-10,26,36
22,WOL,P004645,P006546,15.451,-9,26,35
22,WOL,P004645,P008186,4.967,-7,4,11
22,WOL,P004645,P011248,10.234,-15,15,30
22,WOL,P004645,P012003,12.9,-3,21,24
22,WOL,P004645,P012577,4.583,-2,11,13
22,WOL,P004645,P012789,12.667,-10,21,31
22,WOL,P005516,P006546,21.9,-4,45,49
22,WOL,P005516,P008186,9.816,-7,12,19
22,WOL,P005516,P009306,2.683,0,5,5
22,WOL,P005516,P011248,19.6,-8,36,44
22,WOL,P005516,P012003,17.166,2,35,33
22,WOL,P005516,P012577,20.899,-1,45,46
22,WOL,P005516,P012789,20.734,-8,40,48
22,WOL,P006546,P008186,6.867,-8,6,14
22,WOL,P006546,P011248,16.067,-10,31,41
22,WOL,P006546,P012003,18.716,-5,39,44
22,WOL,P006546,P012577,14.049,1,36,35
22,WOL,P006546,P012789,20.15,-9,41,50
22,WOL,P008186,P009306,3.466,-2,8,10
22,WOL,P008186,P011248,14.199,-12,19,31
22,WOL,P008186,P012003,7.516,-6,12,18
22,WOL,P008186,P012577,9.965,-6,15,21
22,WOL,P009306,P011248,3.466,-2,8,10
22,WOL,P009306,P012003,0.783,-2,3,5
22,WOL,P009306,P012577,3.466,-2,8,10
22,WOL,P011248,P012003,13.099,-6,25,31
22,WOL,P011248,P012577,22.115,-4,47,51
22,WOL,P011248,P012789,12.284,-11,23,34
22,WOL,P012003,P012577,13.415,-4,30,34
22,WOL,P012003,P012789,17.733,-4,35,39
22,WOL,P012577,P012789,14.5,-6,32,38
23,BES,P003783,P007914,5.95,11,18,7
23,BES,P003783,P008945,1.983,1,7,6
23,BES,P003783,P009680,0.467,-1,0,1
23,BES,P003783,P010652,7.4,9,20,11
23,BES,P003783,P011379,4.25,-10,6,16
23,BES,P003783,P011924,7.667,0,17,17
23,BES,P003783,P011927,11.183,0,26,26
23,BES,P003783,P013255,7.7,-14,10,24
23,BES,P007914,P008945,16.766,4,42,38
23,BES,P007914,P009680,11.15,-5,20,25
23,BES,P007914,P010652,10.784,13,32,19
23,BES,P007914,P011379,10.933,-8,23,31
23,BES,P007914,P011924,17.35,1,43,42
23,BES,P007914,P011927,20.6,7,51,44
23,BES,P007914,P013255,15.267,-15,27,42
23,BES,P008945,P009680,13.666,-6,26,32
23,BES,P008945,P010652,5.684,12,21,9
23,BES,P008945,P011379,14.349,-11,31,42
23,BES,P008945,P011924,16.016,-3,38,41
23,BES,P008945,P011927,16.4,4,42,38
23,BES,P008945,P013255,17.2,-9,37,46
23,BES,P009680,P010652,1.617,5,5,0
23,BES,P009680,P011379,9.35,-12,15,27
23,BES,P009680,P011924,9.35,-12,15,27
23,BES,P009680,P011927,5.483,-3,9,12
23,BES,P009680,P013255,14.717,-6,26,32
23,BES,P010652,P011924,9.801,5,28,23
23,BES,P010652,P011927,12.884,6,35,29
23,BES,P010652,P013255,9.834,-6,19,25
23,BES,P011379,P011924,18.699,-18,34,52
23,BES,P011379,P011927,9.733,-7,21,28
23,BES,P011379,P013255,12.75,-22,22,44
23,BES,P011924,P011927,18.217,2,45,43
23,BES,P011924,P013255,16.9,-27,28,55
23,BES,P011927,P013255,17.9,-25,31,56
23,HTA,P001927,P004846,24.715,33,76,43
23,HTA,P001927,P010386,19.932,20,58,38
23,HTA,P001927,P010550,12.632,22,39,17
23,HTA,P001927,P011157,22.866,32,69,37
23,HTA,P001927,P011386,3.433,4,8,4
23,HTA,P001927,P012096,4.799,5,13,8
23,HTA,P001927,P013284,24.215,32,73,41
23,HTA,P004846,P005181,1.167,1,4,3
23,HTA,P004846,P010386,23.499,9,61,52
23,HTA,P004846,P010550,14.816,12,40,28
23,HTA,P004846,P011157,25.766,37,77,40
23,HTA,P004846,P011386,1.35,-8,1,9
23,HTA,P004846,P012096,3.933,-13,6,19
23,HTA,P004846,P013284,26.682,25,75,50
23,HTA,P005181,P010386,1.434,0,5,5
23,HTA,P005181,P010465,5.5,-11,7,18
23,HTA,P005181,P010550,6.784,-8,12,20
23,HTA,P005181,P011157,0.984,3,5,2
23,HTA,P005181,P011386,5.5,-11,7,18
23,HTA,P005181,P012096,5.65,-14,7,21
23,HTA,P005181,P013284,0.717,-4,1,5
23,HTA,P010386,P010550,10.617,-4,23,27
23,HTA,P010386,P011157,19.05,21,54,33
23,HTA,P010386,P011386,3.867,-8,7,15
23,HTA,P010386,P012096,6.45,-13,12,25
23,HTA,P010386,P013284,20.283,7,52,45
23,HTA,P010465,P010550,5.5,-11,7,18
23,HTA,P010465,P011386,5.5,-11,7,18
23,HTA,P010465,P012096,5.5,-11,7,18
23,HTA,P010550,P011157,11.35,22,36,14
23,HTA,P010550,P011386,10.6,-17,16,33
23,HTA,P010550,P012096,12.2,-20,18,38
23,HTA,P010550,P013284,12.833,12,33,21
23,HTA,P011157,P013284,24.116,29,71,42
23,HTA,P011386,P012096,10.6,-17,16,33
23,HTA,P011386,P013284,1.55,0,2,2
23,HTA,P012096,P013284,3.6,-5,5,10
24,BAH,P003840,P004172,1.267,-2,0,2
24,BAH,P003840,P009601,1.517,-6,0,6
24,BAH,P003840,P011192,17.817,-4,31,35
24,BAH,P003840,P011201,3.666,-4,8,12
24,BAH,P003840,P011821,14.467,-2,23,25
24,BAH,P003840,P011823,18.051,-4,31,35
24,BAH,P003840,P012711,17.283,-2,31,33
24,BAH,P004172,P009601,16.717,5,27,22
24,BAH,P004172,P011192,16.851,2,29,27
24,BAH,P004172,P011201,19.667,5,30,25
24,BAH,P004172,P011821,7.717,-3,5,8
24,BAH,P004172,P011823,6.701,-3,8,11
24,BAH,P004172,P012405,10.467,8,14,6
24,BAH,P004172,P012711,11.617,-8,15,23
24,BAH,P009601,P011192,12.2,2,24,22
24,BAH,P009601,P011201,16.583,5,27,22
24,BAH,P009601,P011821,6.434,-3,3,6
24,BAH,P009601,P011823,3.851,-3,5,8
24,BAH,P009601,P012405,8.1,10,12,2
24,BAH,P009601,P012711,5.866,-6,10,16
24,BAH,P011192,P011201,18.133,0,35,35
24,BAH,P011192,P011821,15.584,-2,25,27
24,BAH,P011192,P011823,21.835,-4,36,40
24,BAH,P011192,P012405,6.217,8,14,6
24,BAH,P011192,P012711,27.767,-10,46,56
24,BAH,P011201,P011821,5.383,1,3,2
24,BAH,P011201,P011823,8.034,-3,16,19
24,BAH,P011201,P012405,9.25,10,12,2
24,BAH,P011201,P012711,12.616,-10,21,31
24,BAH,P011821,P011823,15.834,-1,26,27
24,BAH,P011821,P012405,5.467,-2,2,4
24,BAH,P011821,P012711,15.05,0,25,25
24,BAH,P011823,P012711,19.634,-2,34,36
24,BAH,P012405,P012711,2.367,-2,2,4
24,CAN,P003425,P006588,11.483,0,20,20
24,CAN,P003425,P007560,0.2,2,2,0
24,CAN,P003425,P008121,18.466,24,46,22
24,CAN,P003425,P008966,13.65,24,34,10
24,CAN,P003425,P010452,14.55,15,35,20
24,CAN,P003425,P010623,0.183,0,0,0
24,CAN,P003425,P011251,23.766,15,50,35
24,CAN,P003425,P012016,7.883,-5,15,20
24,CAN,P003425,P012095,5.683,-7,6,13
24,CAN,P005005,P006588,2.4,-6,0,6
24,CAN,P005005,P010452,2.667,0,0,0
24,CAN,P005005,P010623,5.067,-6,0,6
24,CAN,P005005,P012016,5.067,-6,0,6
24,CAN,P005005,P012095,5.067,-6,0,6
24,CAN,P006588,P007560,3.4,-5,5,10
24,CAN,P006588,P008121,18.916,-4,31,35
24,CAN,P006588,P008966,12.399,1,21,20
24,CAN,P006588,P010452,3.6,-4,6,10
24,CAN,P006588,P010623,12.533,-14,14,28
24,CAN,P006588,P011251,12.616,-2,20,22
24,CAN,P006588,P012016,8.017,-11,7,18
24,CAN,P006588,P012095,10.7,-11,12,23
24,CAN,P007560,P008121,3.6,-3,7,10
24,CAN,P007560,P008966,0.95,0,2,2
24,CAN,P007560,P010452,1.55,0,5,5
24,CAN,P007560,P010623,3.4,-5,5,10
24,CAN,P007560,P012016,1.3,-1,2,3
24,CAN,P008121,P008966,20.116,21,43,22
24,CAN,P008121,P010452,13.933,16,35,19
24,CAN,P008121,P010623,11.149,-8,14,22
24,CAN,P008121,P011251,19.399,20,44,24
24,CAN,P008121,P012016,5.533,-1,11,12
24,CAN,P008121,P012095,6.616,-1,9,10
24,CAN,P008966,P010452,7.717,20,22,2
24,CAN,P008966,P010623,6.466,-3,9,12
24,CAN,P008966,P011251,14.783,22,34,12
24,CAN,P008966,P012095,4.383,-1,7,8
24,CAN,P010452,P010623,4.85,-2,3,5
24,CAN,P010452,P011251,14.35,13,33,20
24,CAN,P010452,P012016,8.083,-3,10,13
24,CAN,P010452,P012095,6.3,-3,3,6
24,CAN,P010623,P011251,1.316,-2,0,2
24,CAN,P010623,P012016,8.217,-9,2,11
24,CAN,P010623,P012095,11.683,-7,9,16
24,CAN,P011251,P012016,7.683,-7,13,20
24,CAN,P011251,P012095,5.683,-7,6,13
24,CAN,P012016,P012095,12.617,-13,8,21
25,BUD,P004222,P005637,4.8,2,10,8
25,BUD,P004222,P006561,6.951,8,14,6
25,BUD,P004222,P010307,3.867,2,10,8
25,BUD,P004222,P011150,5.717,4,12,8
25,BUD,P004222,P011281,6.584,2,12,10
25,BUD,P004222,P012606,6.034,6,12,6
25,BUD,P004222,P012630,5.567,8,12,4
25,BUD,P004222,P013258,7.484,8,14,6
25,BUD,P005637,P006561,0.283,1,1,0
25,BUD,P005637,P006566,14.033,13,30,17
25,BUD,P005637,P008325,13.133,11,31,20
25,BUD,P005637,P010307,7.2,2,19,17
25,BUD,P005637,P011150,24.999,22,58,36
25,BUD,P005637,P011281,23.083,21,55,34
25,BUD,P005637,P012606,4.466,7,9,2
25,BUD,P005637,P012630,1.45,0,2,2
25,BUD,P005637,P013258,0.816,1,1,0
25,BUD,P005637,P013259,7.133,8,16,8
25,BUD,P006561,P006566,1.567,-5,0,5
25,BUD,P006561,P008325,7.467,-8,11,19
25,BUD,P006561,P011150,1.2,3,3,0
25,BUD,P006561,P011281,3.051,-5,2,7
25,BUD,P006561,P012606,13.884,-1,24,25
25,BUD,P006561,P012630,11.467,5,23,18
25,BUD,P006561,P013258,13.334,6,26,20
25,BUD,P006566,P008325,8.5,-1,16,17
25,BUD,P006566,P011150,13.683,13,30,17
25,BUD,P006566,P011281,12.75,13,30,17
25,BUD,P006566,P012606,2.983,-6,2,8
25,BUD,P006566,P012630,2.05,-6,2,8
25,BUD,P006566,P013258,0.233,-1,2,3
25,BUD,P006566,P013259,7.133,8,16,8
25,BUD,P008325,P010307,3.333,0,9,9
25,BUD,P008325,P011150,12.783,11,31,20
25,BUD,P008325,P011281,12.417,6,29,23
25,BUD,P008325,P012606,11.783,-3,21,24
25,BUD,P008325,P012630,7.383,-4,15,19
25,BUD,P008325,P013258,6.133,-4,13,17
25,BUD,P010307,P011150,7.2,2,19,17
25,BUD,P010307,P011281,7.2,2,19,17
25,BUD,P011150,P011281,24.0,23,57,34
25,BUD,P011150,P012606,4.116,7,9,2
25,BUD,P011150,P012630,1.1,0,2,2
25,BUD,P011150,P013258,1.733,3,3,0
25,BUD,P011150,P013259,7.133,8,16,8
25,BUD,P011281,P012606,4.334,-1,6,7
25,BUD,P011281,P012630,0.4,0,0,0
25,BUD,P011281,P013258,3.584,-5,2,7
25,BUD,P011281,P013259,7.133,8,16,8
25,BUD,P012606,P012630,12.65,4,27,23
25,BUD,P012606,P013258,12.55,3,26,23
25,BUD,P012630,P013258,10.133,9,25,16
25,TRN,P005438,P006382,6.683,-4,5,9
25,TRN,P005438,P006724,13.367,-6,20,26
25,TRN,P005438,P012593,8.816,-2,17,19
25,TRN,P005438,P012687,7.283,-12,4,16
25,TRN,P005438,P013269,2.7,-2,5,7
25,TRN,P005438,P013270,11.267,1,23,22
25,TRN,P005438,P013271,8.45,6,21,15
25,TRN,P005438,P013272,6.166,-1,13,14
25,TRN,P006382,P006724,8.483,-5,9,14
25,TRN,P006382,P012593,4.533,-1,6,7
25,TRN,P006382,P012687,5.416,-12,2,14
25,TRN,P006382,P013269,5.084,5,9,4
25,TRN,P006382,P013270,8.267,-1,10,11
25,TRN,P006382,P013271,6.617,8,12,4
25,TRN,P006382,P013272,6.117,2,11,9
25,TRN,P006724,P012593,13.283,-8,22,30
25,TRN,P006724,P012687,11.65,-17,14,31
25,TRN,P006724,P013269,7.317,0,15,15
25,TRN,P006724,P013270,8.451,0,16,16
25,TRN,P006724,P013271,9.501,3,22,19
25,TRN,P006724,P013272,6.216,-3,10,13
25,TRN,P012593,P012687,18.25,-27,22,49
25,TRN,P012593,P013269,19.351,-10,30,40
25,TRN,P012593,P013270,9.817,0,23,23
25,TRN,P012593,P013271,22.168,-14,39,53
25,TRN,P012593,P013272,22.65,-14,37,51
25,TRN,P012687,P013269,11.784,-14,16,30
25,TRN,P012687,P013270,4.25,-12,0,12
25,TRN,P012687,P013271,15.384,-20,20,40
25,TRN,P012687,P013272,11.183,-22,10,32
25,TRN,P013269,P013270,9.651,1,20,19
25,TRN,P013269,P013271,22.302,-11,38,49
25,TRN,P013269,P013272,18.951,-9,27,36
25,TRN,P013270,P013271,15.417,4,32,28
25,TRN,P013270,P013272,13.284,-1,28,29
25,TRN,P013271,P013272,19.901,-12,32,44
26,HAM,P003242,P006006,11.617,-14,13,27
26,HAM,P003242,P006420,9.65,0,14,14
26,HAM,P003242,P010070,1.733,4,6,2
26,HAM,P003242,P011256,17.467,-13,30,43
26,HAM,P003242,P012695,13.05,-3,30,33
26,HAM,P003242,P013308,15.701,-8,24,32
26,HAM,P003242,P013309,12.333,-2,26,28
26,HAM,P003242,P013312,14.317,-12,29,41
26,HAM,P006006,P006420,9.2,-10,7,17
26,HAM,P006006,P010070,5.533,-1,8,9
26,HAM,P006006,P011256,12.483,-5,21,26
26,HAM,P006006,P012695,0.7,-5,0,5
26,HAM,P006006,P013308,14.267,-15,15,30
26,HAM,P006006,P013309,6.349,0,12,12
26,HAM,P006006,P013310,2.4,-2,6,8
26,HAM,P006006,P013312,8.583,-4,18,22
26,HAM,P006420,P010070,5.8,-7,6,13
26,HAM,P006420,P011256,4.883,3,7,4
26,HAM,P006420,P012695,6.25,3,13,10
26,HAM,P006420,P013308,14.467,-11,16,27
26,HAM,P006420,P013309,9.783,-3,15,18
26,HAM,P006420,P013310,1.767,-3,2,5
26,HAM,P010070,P011256,2.183,5,6,1
26,HAM,P010070,P012695,5.566,5,13,8
26,HAM,P010070,P013308,5.8,-7,6,13
26,HAM,P010070,P013309,9.332,7,19,12
26,HAM,P010070,P013310,3.15,-1,5,6
26,HAM,P010070,P013312,5.299,11,15,4
26,HAM,P011256,P012695,14.367,-10,31,41
26,HAM,P011256,P013308,13.901,-10,20,30
26,HAM,P011256,P013309,14.516,0,35,35
26,HAM,P011256,P013310,3.533,3,13,10
26,HAM,P011256,P013312,21.267,-13,45,58
26,HAM,P012695,P013308,10.368,-6,18,24
26,HAM,P012695,P013309,20.25,-2,43,45
26,HAM,P012695,P013310,4.45,3,12,9
26,HAM,P012695,P013312,16.667,-9,36,45
26,HAM,P013308,P013309,11.934,-13,14,27
26,HAM,P013308,P013310,1.934,-4,2,6
26,HAM,P013308,P013312,10.168,-10,17,27
26,HAM,P013309,P013310,5.083,4,16,12
26,HAM,P013309,P013312,16.816,1,40,39
26,HAM,P013310,P013312,5.083,4,16,12
26,JER,P006625,P009879,4.767,5,14,9
26,JER,P006625,P010431,7.85,-2,6,8
26,JER,P006625,P010587,15.3,15,39,24
26,JER,P006625,P011970,14.999,10,38,28
26,JER,P006625,P013276,8.867,3,17,14
26,JER,P006625,P013277,13.584,9,36,27
26,JER,P006625,P013278,12.916,12,34,22
26,JER,P006625,P013279,7.199,6,15,9
26,JER,P006625,P013281,1.65,2,5,3
26,JER,P009879,P010431,3.05,-3,3,6
26,JER,P009879,P010587,6.767,2,14,12
26,JER,P009879,P011970,6.516,-6,11,17
26,JER,P009879,P013276,8.683,-11,12,23
26,JER,P009879,P013277,11.233,1,23,22
26,JER,P009879,P013278,5.55,3,13,10
26,JER,P009879,P013279,1.033,-3,2,5
26,JER,P009879,P013281,6.533,-8,8,16
26,JER,P010431,P010587,11.333,9,26,17
26,JER,P010431,P011970,12.916,3,26,23
26,JER,P010431,P013276,9.0,-3,15,18
26,JER,P010431,P013277,9.6,5,19,14
26,JER,P010431,P013278,10.766,6,22,16
26,JER,P010431,P013279,7.699,-1,11,12
26,JER,P010431,P013281,4.05,6,12,6
26,JER,P010587,P011970,15.733,10,44,34
26,JER,P010587,P013276,8.117,5,25,20
26,JER,P010587,P013277,19.551,17,49,32
26,JER,P010587,P013278,19.5,14,44,30
26,JER,P010587,P013279,6.166,3,13,10
26,JER,P010587,P013281,5.201,9,14,5
26,JER,P011970,P013276,14.449,-1,31,32
26,JER,P011970,P013277,12.1,7,35,28
26,JER,P011970,P013278,14.766,4,37,33
26,JER,P011970,P013279,13.248,3,26,23
26,JER,P011970,P013281,6.533,2,16,14
26,JER,P013276,P013277,10.317,0,24,24
26,JER,P013276,P013278,1.467,-2,5,7
26,JER,P013276,P013279,5.349,-2,9,11
26,JER,P013276,P013281,6.283,-5,14,19
26,JER,P013277,P013278,13.9,11,31,20
26,JER,P013277,P013281,6.851,6,15,9
26,JER,P013278,P013279,7.899,5,17,12
26,JER,P013278,P013281,6.3,3,9,6
26,JER,P013279,P013281,4.399,1,11,10
27,CLU,P002820,P004862,21.268,-5,47,52
27,CLU,P002820,P005714,14.434,0,30,30
27,CLU,P002820,P006618,11.168,-3,25,28
27,CLU,P002820,P010651,2.983,-6,6,12
27,CLU,P002820,P011797,3.367,1,10,9
27,CLU,P002820,P011801,3.884,-7,6,13
27,CLU,P002820,P012698,7.234,-8,15,23
27,CLU,P002820,P013302,20.684,-2,48,50
27,CLU,P002820,P013304,13.25,-6,29,35
27,CLU,P004862,P005714,14.884,4,32,28
27,CLU,P004862,P006618,7.868,1,18,17
27,CLU,P004862,P010651,3.267,-11,3,14
27,CLU,P004862,P011797,1.45,3,6,3
27,CLU,P004862,P011801,2.684,-1,4,5
27,CLU,P004862,P012698,6.051,-7,10,17
27,CLU,P004862,P013302,20.701,-7,45,52
27,CLU,P004862,P013304,15.367,-9,31,40
27,CLU,P005714,P006618,5.5,-2,12,14
27,CLU,P005714,P011797,2.033,-3,8,11
27,CLU,P005714,P011801,5.083,-2,13,15
27,CLU,P005714,P012698,5.083,-2,13,15
27,CLU,P005714,P013302,15.384,3,33,30
27,CLU,P005714,P013304,13.467,2,31,29
27,CLU,P006618,P010651,10.85,7,32,25
27,CLU,P006618,P011797,13.733,7,44,37
27,CLU,P006618,P011801,15.917,-2,43,45
27,CLU,P006618,P012698,19.267,-3,52,55
27,CLU,P006618,P013302,9.101,3,22,19
27,CLU,P010651,P011797,9.616,7,29,22
27,CLU,P010651,P011801,10.05,5,29,24
27,CLU,P010651,P012698,11.733,0,32,32
27,CLU,P010651,P013302,4.0,-13,6,19
27,CLU,P010651,P013304,3.033,-13,3,16
27,CLU,P011797,P011801,13.716,2,41,39
27,CLU,P011797,P012698,13.716,2,41,39
27,CLU,P011797,P013302,1.3,3,6,3
27,CLU,P011797,P013304,1.133,-2,3,5
27,CLU,P011801,P012698,18.467,-2,48,50
27,CLU,P011801,P013302,1.667,-1,3,4
27,CLU,P011801,P013304,2.4,0,5,5
27,CLU,P012698,P013302,5.867,-7,12,19
27,CLU,P012698,P013304,3.25,-5,5,10
27,CLU,P013302,P013304,14.1,-11,29,40
27,PAM,P004863,P005356,14.55,9,47,38
27,PAM,P004863,P006643,5.167,-7,13,20
27,PAM,P004863,P007527,12.934,13,42,29
27,PAM,P004863,P009864,4.567,5,17,12
27,PAM,P004863,P010042,4.499,-3,9,12
27,PAM,P004863,P010393,10.783,0,29,29
27,PAM,P004863,P010444,5.7,-1,16,17
27,PAM,P004863,P011980,7.133,2,24,22
27,PAM,P004863,P011982,10.166,11,34,23
27,PAM,P004863,P012738,6.233,-1,17,18
27,PAM,P005356,P006643,5.067,3,18,15
27,PAM,P005356,P007527,10.067,10,32,22
27,PAM,P005356,P009864,5.899,3,19,16
27,PAM,P005356,P010042,8.615,21,36,15
27,PAM,P005356,P010393,11.666,16,41,25
27,PAM,P005356,P010444,8.033,19,36,17
27,PAM,P005356,P010750,1.183,-1,3,4
27,PAM,P005356,P011980,7.649,7,29,22
27,PAM,P005356,P011982,10.482,23,43,20
27,PAM,P005356,P012738,4.117,2,12,10
27,PAM,P006643,P007527,5.334,-5,11,16
27,PAM,P006643,P009864,0.883,-2,2,4
27,PAM,P006643,P010042,2.85,3,8,5
27,PAM,P006643,P010393,4.217,-4,8,12
27,PAM,P006643,P010444,2.917,2,11,9
27,PAM,P006643,P011980,2.683,1,10,9
27,PAM,P006643,P012738,2.95,-7,3,10
27,PAM,P007527,P009864,4.467,-1,11,12
27,PAM,P007527,P010042,10.267,-16,10,26
27,PAM,P007527,P010393,19.017,-15,35,50
27,PAM,P007527,P010444,6.417,-3,11,14
27,PAM,P007527,P010750,1.183,-1,3,4
27,PAM,P007527,P011980,1.717,5,8,3
27,PAM,P007527,P011982,11.634,-2,23,25
27,PAM,P007527,P012738,9.967,-5,22,27
27,PAM,P009864,P010042,5.9,1,11,10
27,PAM,P009864,P010393,2.75,-6,3,9
27,PAM,P009864,P010750,3.65,1,7,6
27,PAM,P009864,P011980,8.9,11,28,17
27,PAM,P009864,P011982,9.584,8,26,18
27,PAM,P010042,P010393,13.833,-2,28,30
27,PAM,P010042,P010444,10.582,2,26,24
27,PAM,P010042,P010750,3.15,0,4,4
27,PAM,P010042,P011980,9.049,2,21,19
27,PAM,P010042,P011982,19.049,-4,38,42
27,PAM,P010042,P012738,3.734,-4,5,9
27,PAM,P010393,P010444,6.483,3,16,13
27,PAM,P010393,P010750,1.183,-1,3,4
27,PAM,P010393,P011982,12.633,-2,27,29
27,PAM,P010393,P012738,9.967,-5,22,27
27,PAM,P010444,P010750,0.683,-2,0,2
27,PAM,P010444,P011980,5.449,-3,15,18
27,PAM,P010444,P011982,11.532,3,29,26
27,PAM,P010750,P011980,3.15,0,4,4
27,PAM,P010750,P011982,3.15,0,4,4
27,PAM,P011980,P011982,11.666,7,33,26
27,PAM,P011982,P012738,2.9,0,7,7
28,BOU,P004525,P006904,2.317,0,2,2
28,BOU,P004525,P009552,5.334,-1,10,11
28,BOU,P004525,P009556,8.417,9,20,11
28,BOU,P004525,P010449,19.7,8,46,38
28,BOU,P004525,P010450,2.483,2,6,4
28,BOU,P004525,P011837,14.2,7,32,25
28,BOU,P004525,P013264,0.8,-1,3,4
28,BOU,P004525,P013265,21.217,9,45,36
28,BOU,P004525,P013266,13.6,-1,28,29
28,BOU,P004945,P006904,7.183,10,20,10
28,BOU,P004945,P009552,7.183,10,20,10
28,BOU,P004945,P010450,6.7,13,20,7
28,BOU,P004945,P013264,7.183,10,20,10
28,BOU,P004945,P013265,0.483,-3,0,3
28,BOU,P006904,P009552,15.7,13,36,23
28,BOU,P006904,P009556,7.05,3,14,11
28,BOU,P006904,P010450,12.9,16,34,18
28,BOU,P006904,P013264,13.383,13,34,21
28,BOU,P006904,P013265,2.8,-3,2,5
28,BOU,P006904,P013266,1.467,0,2,2
28,BOU,P009552,P009556,7.05,3,14,11
28,BOU,P009552,P010449,4.134,-1,10,11
28,BOU,P009552,P010450,14.017,16,36,20
28,BOU,P009552,P013264,14.5,13,36,23
28,BOU,P009552,P013265,5.817,-4,10,14
28,BOU,P009552,P013266,5.601,-1,12,13
28,BOU,P009556,P010449,7.217,11,20,9
28,BOU,P009556,P010450,5.85,5,14,9
28,BOU,P009556,P011837,7.217,11,20,9
28,BOU,P009556,P013264,5.85,5,14,9
28,BOU,P009556,P013265,8.417,9,20,11
28,BOU,P010449,P010450,4.817,4,10,6
28,BOU,P010449,P011837,17.684,8,36,28
28,BOU,P010449,P013264,5.401,0,9,9
28,BOU,P010449,P013265,21.167,8,45,37
28,BOU,P010449,P013266,17.084,-2,32,34
28,BOU,P010450,P011837,1.217,2,2,0
28,BOU,P010450,P013264,16.034,17,41,24
28,BOU,P010450,P013265,1.683,3,3,0
28,BOU,P010450,P013266,5.167,2,10,8
28,BOU,P011837,P013264,3.484,1,4,3
28,BOU,P011837,P013265,16.467,6,34,28
28,BOU,P011837,P013266,10.467,-3,16,19
28,BOU,P013264,P013265,2.75,-4,2,6
28,BOU,P013264,P013266,5.751,-2,9,11
28,BOU,P013265,P013266,15.067,-1,27,28
28,VNC,P005177,P005404,15.916,-6,32,38
28,VNC,P005177,P006571,4.0,-10,8,18
28,VNC,P005177,P008052,18.932,-25,33,58
28,VNC,P005177,P009400,9.633,-9,13,22
28,VNC,P005177,P011928,11.283,-10,15,25
28,VNC,P005177,P012796,14.766,-2,28,30
28,VNC,P005177,P013305,17.666,-14,35,49
28,VNC,P005404,P006571,4.9,-9,5,14
28,VNC,P005404,P008052,15.966,-20,26,46
28,VNC,P005404,P009400,19.45,1,29,28
28,VNC,P005404,P011928,21.183,4,36,32
28,VNC,P005404,P012796,23.683,7,47,40
28,VNC,P005404,P013305,30.366,-13,53,66
28,VNC,P006571,P008052,8.167,-18,10,28
28,VNC,P006571,P009400,7.434,-17,7,24
28,VNC,P006571,P011928,0.9,-5,0,5
28,VNC,P006571,P013305,7.267,-13,10,23
28,VNC,P008052,P009400,11.3,-21,11,32
28,VNC,P008052,P011928,7.166,-16,7,23
28,VNC,P008052,P012796,10.649,-8,20,28
28,VNC,P008052,P013305,20.216,-24,33,57
28,VNC,P009400,P011928,18.166,0,29,29
28,VNC,P009400,P012796,19.149,5,31,26
28,VNC,P009400,P013305,21.2,-7,32,39
28,VNC,P011928,P012796,18.883,7,33,26
28,VNC,P011928,P013305,18.683,0,32,32
28,VNC,P012796,P013305,23.066,3,45,42
29,LJU,P003452,P003703,22.083,-14,38,52
29,LJU,P003452,P009392,3.533,-3,5,8
29,LJU,P003452,P009431,0.3,-2,0,2
29,LJU,P003452,P009753,6.9,-12,9,21
29,LJU,P003452,P012042,22.25,-15,38,53
29,LJU,P003452,P012700,13.067,-11,22,33
29,LJU,P003452,P012996,9.2,-6,14,20
29,LJU,P003452,P013260,9.366,-6,17,23
29,LJU,P003452,P013263,7.433,1,17,16
29,LJU,P003703,P009392,4.916,-1,7,8
29,LJU,P003703,P009431,6.449,-3,10,13
29,LJU,P003703,P009753,7.017,-7,9,16
29,LJU,P003703,P011261,6.333,-1,10,11
29,LJU,P003703,P012042,23.117,-10,38,48
29,LJU,P003703,P012700,17.767,-7,28,35
29,LJU,P003703,P012996,15.366,-7,24,31
29,LJU,P003703,P013260,10.982,-3,19,22
29,LJU,P003703,P013263,8.166,1,17,16
29,LJU,P009392,P009431,6.467,3,13,10
29,LJU,P009392,P009753,5.133,-4,9,13
29,LJU,P009392,P011261,5.417,2,12,10
29,LJU,P009392,P012042,4.683,0,8,8
29,LJU,P009392,P012700,1.184,3,4,1
29,LJU,P009392,P012996,0.15,2,2,0
29,LJU,P009392,P013260,7.617,6,16,10
29,LJU,P009392,P013263,5.5,4,8,4
29,LJU,P009431,P009753,2.933,-5,4,9
29,LJU,P009431,P011261,10.833,1,22,21
29,LJU,P009431,P012700,5.167,3,11,8
29,LJU,P009431,P012996,5.566,1,12,11
29,LJU,P009431,P013260,7.7,-1,15,16
29,LJU,P009431,P013263,3.317,3,5,2
29,LJU,P009753,P011261,5.317,1,8,7
29,LJU,P009753,P012042,8.951,-4,13,17
29,LJU,P009753,P012700,6.134,-2,9,11
29,LJU,P009753,P013260,9.083,-3,15,18
29,LJU,P011261,P012042,2.684,4,4,0
29,LJU,P011261,P012700,7.534,6,14,8
29,LJU,P011261,P012996,5.566,1,12,11
29,LJU,P011261,P013260,8.117,4,18,14
29,LJU,P011261,P013263,2.267,2,4,2
29,LJU,P012042,P012700,16.018,-6,25,31
29,LJU,P012042,P012996,9.95,-6,14,20
29,LJU,P012042,P013260,11.75,3,22,19
29,LJU,P012042,P013263,7.933,2,18,16
29,LJU,P012700,P012996,12.533,-4,18,22
29,LJU,P012700,P013260,6.134,4,12,8
29,LJU,P012700,P013263,3.134,2,9,7
29,LJU,P012996,P013260,3.733,-1,8,9
29,LJU,P013260,P013263,7.25,5,14,9
29,TTK,P004056,P004619,1.4,-1,3,4
29,TTK,P004056,P006598,10.566,6,24,18
29,TTK,P004056,P007917,2.633,3,7,4
29,TTK,P004056,P009025,10.016,4,23,19
29,TTK,P004056,P011935,5.016,0,11,11
29,TTK,P004056,P011973,11.049,6,24,18
29,TTK,P004056,P012259,5.183,1,10,9
29,TTK,P004056,P012415,1.017,0,2,2
29,TTK,P004056,P013300,2.916,1,4,3
29,TTK,P004619,P007917,0.75,1,3,2
29,TTK,P004619,P009025,3.25,-3,7,10
29,TTK,P004619,P011935,2.5,-4,4,8
29,TTK,P004619,P012259,3.25,-3,7,10
29,TTK,P004619,P013300,1.85,-2,4,6
29,TTK,P006598,P007917,4.8,-1,7,8
29,TTK,P006598,P009025,25.099,9,52,43
29,TTK,P006598,P010811,0.667,-1,1,2
29,TTK,P006598,P011935,23.283,3,46,43
29,TTK,P006598,P011973,27.416,9,57,48
29,TTK,P006598,P012259,3.783,2,7,5
29,TTK,P006598,P012415,6.917,2,10,8
29,TTK,P006598,P013300,16.733,-1,32,33
29,TTK,P007917,P009025,4.049,-1,4,5
29,TTK,P007917,P010811,0.667,-1,1,2
29,TTK,P007917,P011935,4.05,-5,3,8
29,TTK,P007917,P011973,4.583,-1,6,7
29,TTK,P007917,P012259,0.75,1,3,2
29,TTK,P007917,P012415,4.433,-4,3,7
29,TTK,P007917,P013300,4.217,0,7,7
29,TTK,P009025,P011935,28.199,7,58,51
29,TTK,P009025,P011973,31.249,13,64,51
29,TTK,P009025,P012259,8.7,0,20,20
29,TTK,P009025,P012415,10.083,7,14,7
29,TTK,P009025,P013300,20.483,4,42,38
29,TTK,P010811,P011935,0.667,-1,1,2
29,TTK,P010811,P011973,0.667,-1,1,2
29,TTK,P011935,P011973,26.616,9,55,46
29,TTK,P011935,P012259,4.167,-3,10,13
29,TTK,P011935,P012415,9.633,5,13,8
29,TTK,P011935,P013300,21.933,1,43,42
29,TTK,P011973,P012259,5.45,3,13,10
29,TTK,P011973,P012415,9.3,7,14,7
29,TTK,P011973,P013300,21.066,7,42,35
29,TTK,P012259,P013300,3.517,-1,10,11
29,TTK,P012415,P013300,5.417,3,8,5
30,ARI,P003240,P004292,10.417,3,24,21
30,ARI,P003240,P008084,12.651,5,23,18
30,ARI,P003240,P013248,6.767,0,10,10
30,ARI,P003240,P013249,4.834,1,12,11
30,ARI,P003240,P013250,16.901,9,38,29
30,ARI,P003240,P013251,11.617,4,29,25
30,ARI,P003240,P013252,5.617,3,16,13
30,ARI,P003240,P013355,13.751,9,34,25
30,ARI,P003240,P013356,13.484,7,37,30
30,ARI,P003240,P013360,0.95,0,0,0
30,ARI,P003240,P013375,7.551,7,17,10
30,ARI,P004292,P008084,6.833,4,13,9
30,ARI,P004292,P013248,4.133,-2,4,6
30,ARI,P004292,P013249,13.216,5,31,26
30,ARI,P004292,P013250,4.966,3,12,9
30,ARI,P004292,P013251,10.949,10,27,17
30,ARI,P004292,P013252,3.6,5,11,6
30,ARI,P004292,P013355,14.316,6,37,31
30,ARI,P004292,P013356,15.216,5,39,34
30,ARI,P004292,P013375,4.55,-3,10,13
30,ARI,P008084,P013248,11.983,-5,15,20
30,ARI,P008084,P013249,7.35,-4,10,14
30,ARI,P008084,P013250,14.067,8,29,21
30,ARI,P008084,P013251,13.016,-1,22,23
30,ARI,P008084,P013252,3.917,8,12,4
30,ARI,P008084,P013355,4.817,4,11,7
30,ARI,P008084,P013360,0.95,0,0,0
30,ARI,P008084,P013375,7.284,9,17,8
30,ARI,P013248,P013249,6.366,-2,8,10
30,ARI,P013248,P013250,7.2,1,11,10
30,ARI,P013248,P013251,12.183,-2,18,20
30,ARI,P013248,P013356,1.15,3,3,0
30,ARI,P013248,P013360,0.95,0,0,0
30,ARI,P013248,P013375,1.8,-1,3,4
30,ARI,P013249,P013250,3.5,-2,6,8
30,ARI,P013249,P013251,8.599,5,17,12
30,ARI,P013249,P013252,2.6,3,9,6
30,ARI,P013249,P013355,7.75,2,20,18
30,ARI,P013249,P013356,9.366,7,27,20
30,ARI,P013249,P013375,3.283,-3,8,11
30,ARI,P013250,P013251,11.433,8,30,22
30,ARI,P013250,P013252,4.25,5,14,9
30,ARI,P013250,P013355,9.667,7,24,17
30,ARI,P013250,P013356,7.05,5,20,15
30,ARI,P013250,P013360,0.95,0,0,0
30,ARI,P013250,P013375,4.484,8,12,4
30,ARI,P013251,P013252,3.566,6,13,7
30,ARI,P013251,P013355,6.45,9,22,13
30,ARI,P013251,P013356,9.183,14,31,17
30,ARI,P013251,P013375,1.8,-1,3,4
30,ARI,P013252,P013356,3.933,2,13,11
30,ARI,P013252,P013375,3.917,8,12,4
30,ARI,P013355,P013356,14.2,6,38,32
30,ARI,P013355,P013375,5.117,-3,10,13
30,ARI,P013356,P013375,3.55,-5,8,13
30,LKB,P005521,P005656,10.116,-8,13,21
30,LKB,P005521,P006212,7.8,9,23,14
30,LKB,P005521,P006586,13.216,-7,27,34
30,LKB,P005521,P009299,10.317,0,19,19
30,LKB,P005521,P009898,13.683,3,31,28
30,LKB,P005521,P010461,13.9,-12,23,35
30,LKB,P005521,P013247,9.85,-10,15,25
30,LKB,P005521,PLXI,15.25,-3,33,36
30,LKB,P005656,P006212,4.067,-1,6,7
30,LKB,P005656,P006586,5.866,-10,3,13
30,LKB,P005656,P009299,22.3,-8,39,47
30,LKB,P005656,P009898,5.433,-10,5,15
30,LKB,P005656,P010461,18.166,-7,33,40
30,LKB,P005656,P013247,18.633,-2,34,36
30,LKB,P005656,PLXI,11.683,-2,23,25
30,LKB,P006212,P006586,9.8,-5,19,24
30,LKB,P006212,P009299,8.551,-4,14,18
30,LKB,P006212,P009898,11.267,-1,27,28
30,LKB,P006212,P013247,3.117,2,4,2
30,LKB,P006212,PLXI,12.934,4,31,27
30,LKB,P006586,P009299,6.617,-13,5,18
30,LKB,P006586,P009898,16.016,-12,30,42
30,LKB,P006586,P010461,9.5,-13,13,26
30,LKB,P006586,P013247,3.817,-8,2,10
30,LKB,P006586,PLXI,14.5,-12,29,41
30,LKB,P009299,P009898,9.384,-11,13,24
30,LKB,P009299,P010461,16.933,-5,33,38
30,LKB,P009299,P013247,17.4,0,34,34
30,LKB,P009299,PLXI,15.634,-3,31,34
30,LKB,P009898,P010461,6.7,-5,11,16
30,LKB,P009898,PLXI,16.717,-4,35,39
30,LKB,P010461,P013247,17.083,-10,32,42
30,LKB,P010461,PLXI,12.85,-8,27,35
30,LKB,P013247,PLXI,10.9,-4,23,27
34,BES,P003783,P007914,9.05,3,21,18
34,BES,P003783,P008945,6.018,10,19,9
34,BES,P003783,P009680,11.767,4,30,26
34,BES,P003783,P010652,10.484,7,26,19
34,BES,P003783,P011379,3.15,4,7,3
34,BES,P003783,P011927,5.901,11,21,10
34,BES,P003783,P011936,1.967,4,7,3
34,BES,P003783,P013255,14.267,9,37,28
34,BES,P007914,P009680,12.332,1,26,25
34,BES,P007914,P010652,7.583,1,18,17
34,BES,P007914,P011379,10.082,-5,19,24
34,BES,P007914,P011924,6.216,-5,10,15
34,BES,P007914,P011927,5.333,-5,11,16
34,BES,P007914,P011936,5.466,-10,9,19
34,BES,P007914,P012233,2.399,-2,6,8
34,BES,P007914,P012624,1.616,0,4,4
34,BES,P007914,P013255,10.583,6,24,18
34,BES,P008945,P009680,6.051,3,16,13
34,BES,P008945,P010652,8.717,17,24,7
34,BES,P008945,P011379,11.017,18,35,17
34,BES,P008945,P011924,15.733,27,49,22
34,BES,P008945,P011927,17.717,36,61,25
34,BES,P008945,P011936,15.117,27,47,20
34,BES,P008945,P013255,6.634,10,21,11
34,BES,P009680,P010652,10.55,4,25,21
34,BES,P009680,P011379,5.816,-2,8,10
34,BES,P009680,P011924,6.616,0,12,12
34,BES,P009680,P011927,2.017,2,9,7
34,BES,P009680,P011936,3.75,-5,5,10
34,BES,P009680,P013255,14.633,9,37,28
34,BES,P010652,P011924,6.166,11,18,7
34,BES,P010652,P011927,6.333,14,19,5
34,BES,P010652,P011936,4.749,7,13,6
34,BES,P010652,P012233,0.233,0,0,0
34,BES,P010652,P012624,0.233,0,0,0
34,BES,P010652,P013255,12.484,11,33,22
34,BES,P011379,P011924,15.783,11,41,30
34,BES,P011379,P011927,15.283,15,46,31
34,BES,P011379,P011936,15.75,8,42,34
34,BES,P011379,P012233,2.166,-2,6,8
34,BES,P011379,P012624,1.383,0,4,4
34,BES,P011379,P013255,3.966,5,8,3
34,BES,P011924,P011927,15.333,22,47,25
34,BES,P011924,P011936,18.416,15,49,34
34,BES,P011924,P013255,3.533,7,10,3
34,BES,P011927,P011936,18.083,24,56,32
34,BES,P011927,P012233,2.399,-2,6,8
34,BES,P011927,P012624,1.616,0,4,4
34,BES,P011927,P013255,4.517,7,16,9
34,BES,P011936,P012233,0.783,-2,2,4
34,BES,P011936,P013255,0.583,0,2,2
34,BES,P012233,P012624,1.616,0,4,4
34,ULM,P006245,P006997,9.784,-13,21,34
34,ULM,P006245,P007952,5.099,-11,6,17
34,ULM,P006245,P010582,5.766,-12,8,20
34,ULM,P006245,P010726,3.767,-3,10,13
34,ULM,P006245,P011391,8.283,-14,11,25
34,ULM,P006245,P011437,9.617,-13,15,28
34,ULM,P006245,P012602,1.15,-5,0,5
34,ULM,P006245,P013289,6.351,-7,15,22
34,ULM,P006245,P013290,13.234,-17,27,44
34,ULM,P006245,P013291,4.017,-5,7,12
34,ULM,P006997,P007952,2.233,-5,3,8
34,ULM,P006997,P010582,6.617,-6,15,21
34,ULM,P006997,P010726,5.984,-7,12,19
34,ULM,P006997,P011391,5.017,-2,12,14
34,ULM,P006997,P011437,13.001,-12,24,36
34,ULM,P006997,P013289,5.384,-3,14,17
34,ULM,P006997,P013290,17.018,-16,36,52
34,ULM,P006997,P013291,4.834,-8,7,15
34,ULM,P007952,P010582,10.733,-22,10,32
34,ULM,P007952,P010726,4.0,-1,7,8
34,ULM,P007952,P011391,5.666,-8,7,15
34,ULM,P007952,P011437,4.783,-13,2,15
34,ULM,P007952,P012602,2.967,-7,2,9
34,ULM,P007952,P013290,4.617,-12,3,15
34,ULM,P007952,P013291,2.834,-9,0,9
34,ULM,P010582,P010726,9.783,0,22,22
34,ULM,P010582,P011391,15.549,-5,34,39
34,ULM,P010582,P011437,12.083,-12,21,33
34,ULM,P010582,P012602,5.933,-3,12,15
34,ULM,P010582,P013289,6.833,2,19,17
34,ULM,P010582,P013290,9.001,-13,15,28
34,ULM,P010582,P013291,2.834,-9,0,9
34,ULM,P010726,P011391,11.933,8,30,22
34,ULM,P010726,P011437,10.717,0,22,22
34,ULM,P010726,P012602,6.033,10,18,8
34,ULM,P010726,P013289,13.1,5,35,30
34,ULM,P010726,P013290,5.534,-5,12,17
34,ULM,P010726,P013291,0.817,-3,0,3
34,ULM,P011391,P011437,18.383,-6,37,43
34,ULM,P011391,P012602,9.716,2,20,18
34,ULM,P011391,P013289,14.033,2,31,29
34,ULM,P011391,P013290,10.284,-9,18,27
34,ULM,P011437,P012602,4.916,3,10,7
34,ULM,P011437,P013289,14.15,0,28,28
34,ULM,P011437,P013290,20.235,-24,30,54
34,ULM,P011437,P013291,7.251,-15,7,22
34,ULM,P012602,P013289,7.166,7,18,11
34,ULM,P012602,P013290,2.234,-5,0,5
34,ULM,P012602,P013291,0.417,-2,0,2
34,ULM,P013289,P013290,10.651,-10,20,30
34,ULM,P013290,P013291,7.668,-17,7,24
33,CAN,P003425,P005005,11.717,-7,17,24
33,CAN,P003425,P006588,24.117,0,43,43
33,CAN,P003425,P008121,17.65,-1,33,34
33,CAN,P003425,P008966,13.1,-2,23,25
33,CAN,P003425,P010452,8.35,-11,10,21
33,CAN,P003425,P011251,19.883,-1,38,39
33,CAN,P003425,P012016,13.167,-3,24,27
33,CAN,P003425,P012095,9.484,-7,12,19
33,CAN,P005005,P006588,8.867,-1,15,16
33,CAN,P005005,P008966,0.883,-3,0,3
33,CAN,P005005,P010452,8.35,-9,9,18
33,CAN,P005005,P010623,2.4,0,4,4
33,CAN,P005005,P011251,3.4,-1,7,8
33,CAN,P005005,P012016,10.134,-1,18,19
33,CAN,P005005,P012095,10.717,-6,14,20
33,CAN,P006588,P008121,17.6,3,35,32
33,CAN,P006588,P008966,11.05,2,21,19
33,CAN,P006588,P010452,3.1,-3,3,6
33,CAN,P006588,P010623,2.35,2,7,5
33,CAN,P006588,P011251,21.0,2,42,40
33,CAN,P006588,P012016,12.317,3,26,23
33,CAN,P006588,P012095,5.467,0,8,8
33,CAN,P008121,P008966,16.05,-4,28,32
33,CAN,P008121,P010452,8.283,-9,10,19
33,CAN,P008121,P010623,8.233,-5,12,17
33,CAN,P008121,P011251,21.016,-4,38,42
33,CAN,P008121,P012016,9.833,-2,17,19
33,CAN,P008121,P012095,4.867,-2,7,9
33,CAN,P008966,P010452,5.883,-9,7,16
33,CAN,P008966,P010623,3.833,-5,5,10
33,CAN,P008966,P011251,12.05,-4,21,25
33,CAN,P008966,P012095,4.883,-3,7,10
33,CAN,P010452,P010623,8.283,-7,9,16
33,CAN,P010452,P011251,3.966,-11,3,14
33,CAN,P010452,P012016,7.65,-6,9,15
33,CAN,P010452,P012095,12.667,-7,16,23
33,CAN,P010623,P011251,4.533,-4,7,11
33,CAN,P010623,P012016,6.8,0,11,11
33,CAN,P010623,P012095,6.1,-1,9,10
33,CAN,P011251,P012016,11.816,3,24,21
33,CAN,P012016,P012095,8.151,-6,11,17
33,HTA,P001927,P004846,6.784,3,16,13
33,HTA,P001927,P005181,4.933,6,15,9
33,HTA,P001927,P009877,2.45,7,9,2
33,HTA,P001927,P010386,22.233,8,44,36
33,HTA,P001927,P010550,21.499,7,44,37
33,HTA,P001927,P011157,12.916,3,26,23
33,HTA,P001927,P012096,20.983,14,49,35
33,HTA,P001927,P013284,16.866,8,33,25
33,HTA,P004846,P005181,13.367,1,22,21
33,HTA,P004846,P009877,5.233,0,9,9
33,HTA,P004846,P010386,6.25,1,14,13
33,HTA,P004846,P010550,11.167,2,21,19
33,HTA,P004846,P011157,7.25,9,17,8
33,HTA,P004846,P012096,16.617,-5,27,32
33,HTA,P004846,P013284,11.8,-3,18,21
33,HTA,P005181,P009877,6.266,4,13,9
33,HTA,P005181,P010550,10.617,0,19,19
33,HTA,P005181,P011157,6.666,11,18,7
33,HTA,P005181,P012096,14.766,-2,26,28
33,HTA,P005181,P013284,10.917,-4,15,19
33,HTA,P009877,P011157,2.066,6,6,0
33,HTA,P009877,P012096,6.266,4,13,9
33,HTA,P009877,P013284,2.783,-5,2,7
33,HTA,P010386,P010550,19.899,9,41,32
33,HTA,P010386,P011157,10.283,1,19,18
33,HTA,P010386,P012096,16.05,8,34,26
33,HTA,P010386,P013284,17.749,9,36,27
33,HTA,P010550,P011157,11.666,6,25,19
33,HTA,P010550,P012096,21.333,2,41,39
33,HTA,P010550,P013284,25.883,10,49,39
33,HTA,P011157,P012096,7.766,5,18,13
33,HTA,P011157,P013284,9.183,7,19,12
33,HTA,P012096,P013284,19.483,-2,32,34
37,LJU,P003452,P003703,18.534,3,37,34
37,LJU,P003452,P009392,8.95,9,23,14
37,LJU,P003452,P009431,14.917,8,29,21
37,LJU,P003452,P009753,20.916,12,44,32
37,LJU,P003452,P011261,0.15,-2,0,2
37,LJU,P003452,P012042,13.399,1,31,30
37,LJU,P003452,P012700,18.666,1,36,35
37,LJU,P003452,P013260,10.133,5,22,17
37,LJU,P003452,P013263,6.467,3,14,11
37,LJU,P003703,P009392,4.034,-2,8,10
37,LJU,P003703,P009431,10.518,6,23,17
37,LJU,P003703,P009753,17.183,4,33,29
37,LJU,P003703,P012042,15.35,-17,20,37
37,LJU,P003703,P012700,20.867,-6,37,43
37,LJU,P003703,P013260,7.251,-13,6,19
37,LJU,P003703,P013263,6.867,-7,8,15
37,LJU,P009392,P009431,4.234,1,13,12
37,LJU,P009392,P009753,5.366,12,16,4
37,LJU,P009392,P011261,2.6,4,6,2
37,LJU,P009392,P012042,10.516,12,24,12
37,LJU,P009392,P012700,2.917,1,7,6
37,LJU,P009392,P013260,10.817,14,30,16
37,LJU,P009392,P013263,8.434,5,17,12
37,LJU,P009431,P009753,9.8,8,18,10
37,LJU,P009431,P012042,1.0,-4,1,5
37,LJU,P009431,P012700,11.317,4,20,16
37,LJU,P009431,P013260,6.801,-6,10,16
37,LJU,P009431,P013263,4.617,3,10,7
37,LJU,P009753,P011261,1.2,2,4,2
37,LJU,P009753,P012042,14.016,3,30,27
37,LJU,P009753,P012700,18.45,-1,32,33
37,LJU,P009753,P013260,8.333,4,15,11
37,LJU,P011261,P012042,2.75,2,6,4
37,LJU,P011261,P012700,0.15,-2,0,2
37,LJU,P011261,P013260,2.75,2,6,4
37,LJU,P011261,P013263,1.4,2,2,0
37,LJU,P012042,P012700,17.433,-16,27,43
37,LJU,P012042,P013260,16.299,1,30,29
37,LJU,P012042,P013263,10.033,-2,15,17
37,LJU,P012700,P013260,13.783,-14,16,30
37,LJU,P012700,P013263,8.549,-3,13,16
37,LJU,P013260,P013263,12.233,3,21,18
37,LKB,P005113,P005521,6.701,-2,8,10
37,LKB,P005113,P005656,15.633,25,41,16
37,LKB,P005113,P006212,4.15,-5,4,9
37,LKB,P005113,P006586,8.25,11,23,12
37,LKB,P005113,P009299,21.55,17,48,31
37,LKB,P005113,P009898,16.117,8,35,27
37,LKB,P005113,P013247,19.7,22,48,26
37,LKB,P005113,PLXI,11.367,-8,17,25
37,LKB,P005521,P005656,9.5,-11,6,17
37,LKB,P005521,P006212,0.517,2,2,0
37,LKB,P005521,P006586,8.834,-13,8,21
37,LKB,P005521,P009299,7.0,-3,8,11
37,LKB,P005521,P009898,5.134,-7,8,15
37,LKB,P005521,P010461,9.133,-14,8,22
37,LKB,P005521,P013247,10.7,-9,8,17
37,LKB,P005521,PLXI,5.817,-7,8,15
37,LKB,P005656,P006586,15.299,4,31,27
37,LKB,P005656,P009299,13.982,17,35,18
37,LKB,P005656,P009898,11.482,5,28,23
37,LKB,P005656,P010461,9.682,-14,10,24
37,LKB,P005656,P013247,24.648,15,51,36
37,LKB,P005656,PLXI,1.166,-1,2,3
37,LKB,P006212,P006586,0.517,2,2,0
37,LKB,P006212,P009299,6.0,-9,6,15
37,LKB,P006212,P009898,6.517,-7,8,15
37,LKB,P006212,P010461,2.367,-2,4,6
37,LKB,P006212,PLXI,6.0,-9,6,15
37,LKB,P006586,P009299,3.933,11,15,4
37,LKB,P006586,P009898,5.533,0,12,12
37,LKB,P006586,P010181,0.15,0,0,0
37,LKB,P006586,P010461,8.833,-10,10,20
37,LKB,P006586,P013247,15.716,4,31,27
37,LKB,P006586,PLXI,1.267,-5,0,5
37,LKB,P009299,P009898,18.7,-6,35,41
37,LKB,P009299,P010461,5.266,-10,6,16
37,LKB,P009299,P013247,16.932,19,42,23
37,LKB,P009299,PLXI,14.033,-12,21,33
37,LKB,P009898,P010181,0.15,0,0,0
37,LKB,P009898,P010461,8.083,-13,12,25
37,LKB,P009898,P013247,12.949,10,33,23
37,LKB,P009898,PLXI,12.267,-14,17,31
37,LKB,P010181,P010461,0.15,0,0,0
37,LKB,P010181,PLXI,0.15,0,0,0
37,LKB,P010461,P013247,8.982,-9,10,19
37,LKB,P010461,PLXI,3.9,-8,4,12
37,LKB,P013247,PLXI,5.233,-4,9,13
38,BOU,P004525,P004945,0.283,0,0,0
38,BOU,P004525,P006904,8.633,0,14,14
38,BOU,P004525,P009552,6.584,12,17,5
38,BOU,P004525,P009556,1.95,2,4,2
38,BOU,P004525,P010449,15.667,1,24,23
38,BOU,P004525,P010450,6.35,5,14,9
38,BOU,P004525,P011837,15.233,-10,15,25
38,BOU,P004525,P013264,2.483,-1,6,7
38,BOU,P004525,P013265,17.95,-4,24,28
38,BOU,P004525,P013266,22.067,-1,34,35
38,BOU,P004945,P006904,5.216,0,8,8
38,BOU,P004945,P009552,4.933,0,8,8
38,BOU,P004945,P010450,5.216,0,8,8
38,BOU,P004945,P013264,5.216,0,8,8
38,BOU,P006904,P009552,6.967,4,12,8
38,BOU,P006904,P009556,1.833,3,3,0
38,BOU,P006904,P010450,10.566,6,21,15
38,BOU,P006904,P011837,6.266,0,7,7
38,BOU,P006904,P013264,9.566,2,17,15
38,BOU,P006904,P013265,5.15,-3,4,7
38,BOU,P006904,P013266,8.667,0,14,14
38,BOU,P009552,P009556,3.667,0,8,8
38,BOU,P009552,P010449,9.0,4,21,17
38,BOU,P009552,P010450,11.267,4,22,18
38,BOU,P009552,P013264,9.383,-4,16,20
38,BOU,P009552,P013265,4.783,2,11,9
38,BOU,P009552,P013266,7.284,10,17,7
38,BOU,P009556,P010449,7.867,2,16,14
38,BOU,P009556,P010450,11.267,7,21,14
38,BOU,P009556,P011837,7.6,7,13,6
38,BOU,P009556,P013264,9.317,5,17,12
38,BOU,P009556,P013266,1.567,2,2,0
38,BOU,P010449,P010450,9.367,2,20,18
38,BOU,P010449,P011837,13.717,-5,19,24
38,BOU,P010449,P013264,6.9,-2,14,16
38,BOU,P010449,P013265,13.583,-5,22,27
38,BOU,P010449,P013266,14.767,-1,24,25
38,BOU,P010450,P011837,7.75,7,15,8
38,BOU,P010450,P013264,17.483,4,33,29
38,BOU,P010450,P013265,0.233,-2,2,4
38,BOU,P010450,P013266,6.501,7,16,9
38,BOU,P011837,P013264,6.167,7,11,4
38,BOU,P011837,P013265,13.95,-10,15,25
38,BOU,P011837,P013266,15.517,-8,17,25
38,BOU,P013264,P013265,0.633,-4,0,4
38,BOU,P013264,P013266,4.984,1,10,9
38,BOU,P013265,P013266,18.65,-6,26,32
38,TTK,P004056,P004619,0.533,-2,2,4
38,TTK,P004056,P006598,2.383,0,7,7
38,TTK,P004056,P007917,6.833,-3,12,15
38,TTK,P004056,P009025,12.699,-2,27,29
38,TTK,P004056,P011935,2.433,-2,2,4
38,TTK,P004056,P011973,8.816,-3,20,23
38,TTK,P004056,P012259,8.199,3,19,16
38,TTK,P004056,P012415,5.317,-3,9,12
38,TTK,P004056,P013300,3.583,4,10,6
38,TTK,P004619,P006598,7.6,8,14,6
38,TTK,P004619,P007917,1.567,0,2,2
38,TTK,P004619,P009025,9.667,4,19,15
38,TTK,P004619,P011935,1.933,-4,3,7
38,TTK,P004619,P011973,7.1,6,14,8
38,TTK,P004619,P012259,1.567,0,2,2
38,TTK,P004619,P012415,2.366,-8,3,11
38,TTK,P004619,P013300,10.067,4,17,13
38,TTK,P006598,P007917,3.283,-10,2,12
38,TTK,P006598,P009025,17.183,6,30,24
38,TTK,P006598,P011935,7.016,-2,9,11
38,TTK,P006598,P011973,17.584,5,28,23
38,TTK,P006598,P012259,3.6,0,7,7
38,TTK,P006598,P012415,2.467,-4,0,4
38,TTK,P006598,P013300,14.816,5,23,18
38,TTK,P007917,P009025,19.317,-12,24,36
38,TTK,P007917,P011935,4.233,-7,2,9
38,TTK,P007917,P011973,12.1,-6,17,23
38,TTK,P007917,P012259,12.384,-3,16,19
38,TTK,P007917,P012415,6.884,1,11,10
38,TTK,P007917,P013300,10.667,-8,10,18
38,TTK,P009025,P011935,10.016,-4,14,18
38,TTK,P009025,P011973,29.95,6,51,45
38,TTK,P009025,P012259,14.25,0,23,23
38,TTK,P009025,P012415,12.451,-5,20,25
38,TTK,P009025,P013300,27.267,7,44,37
38,TTK,P011935,P011973,5.65,3,9,6
38,TTK,P011935,P012259,3.8,-4,2,6
38,TTK,P011935,P012415,2.8,-6,3,9
38,TTK,P011935,P013300,9.383,-6,12,18
38,TTK,P011973,P012259,7.433,1,14,13
38,TTK,P011973,P012415,10.901,-6,14,20
38,TTK,P011973,P013300,23.734,10,37,27
38,TTK,P012259,P012415,1.417,1,3,2
38,TTK,P012259,P013300,4.35,2,6,4
38,TTK,P012415,P013300,12.401,-6,17,23
40,CLU,P002820,P004862,18.35,13,46,33
40,CLU,P002820,P005714,9.533,15,27,12
40,CLU,P002820,P006618,6.2,2,17,15
40,CLU,P002820,P010651,2.951,5,10,5
40,CLU,P002820,P011797,5.3,1,15,14
40,CLU,P002820,P011801,1.117,6,8,2
40,CLU,P002820,P012698,5.083,-1,10,11
40,CLU,P002820,P013302,16.067,18,46,28
40,CLU,P002820,P013304,13.267,17,37,20
40,CLU,P004862,P005714,9.533,15,27,12
40,CLU,P004862,P006618,7.283,6,21,15
40,CLU,P004862,P010651,1.834,-1,2,3
40,CLU,P004862,P011797,6.383,5,19,14
40,CLU,P004862,P012698,6.166,3,14,11
40,CLU,P004862,P013302,16.033,16,42,26
40,CLU,P004862,P013304,12.15,11,29,18
40,CLU,P005714,P006618,3.733,9,14,5
40,CLU,P005714,P010651,5.933,7,16,9
40,CLU,P005714,P011801,5.933,7,16,9
40,CLU,P005714,P012698,0.65,2,2,0
40,CLU,P005714,P013302,14.816,20,41,21
40,CLU,P005714,P013304,11.733,13,29,16
40,CLU,P006618,P010651,9.951,7,22,15
40,CLU,P006618,P011797,13.15,9,31,22
40,CLU,P006618,P011801,9.134,10,22,12
40,CLU,P006618,P012620,1.283,-1,2,3
40,CLU,P006618,P012698,9.366,6,22,16
40,CLU,P006618,P013301,3.15,4,9,5
40,CLU,P006618,P013302,7.55,8,20,12
40,CLU,P010651,P011797,7.734,9,19,10
40,CLU,P010651,P011801,14.784,22,43,21
40,CLU,P010651,P012698,4.25,4,10,6
40,CLU,P010651,P013301,1.867,5,7,2
40,CLU,P010651,P013302,10.501,12,28,16
40,CLU,P010651,P013304,6.667,14,23,9
40,CLU,P011797,P011801,7.734,9,19,10
40,CLU,P011797,P012620,5.783,-3,10,13
40,CLU,P011797,P012698,13.866,4,30,26
40,CLU,P011797,P013301,7.65,2,17,15
40,CLU,P011797,P013302,5.25,6,15,9
40,CLU,P011797,P013304,6.75,2,17,15
40,CLU,P011801,P012698,4.25,4,10,6
40,CLU,P011801,P013301,1.867,5,7,2
40,CLU,P011801,P013302,8.667,13,26,13
40,CLU,P011801,P013304,5.65,12,21,9
40,CLU,P012620,P012698,5.783,-3,10,13
40,CLU,P012620,P013301,5.783,-3,10,13
40,CLU,P012620,P013304,4.5,-2,8,10
40,CLU,P012698,P013301,5.783,-3,10,13
40,CLU,P012698,P013302,2.766,2,6,4
40,CLU,P012698,P013304,6.833,-2,12,14
40,CLU,P013301,P013304,4.5,-2,8,10
40,CLU,P013302,P013304,17.15,21,48,27
40,HAM,P003242,P006420,15.033,-16,23,39
40,HAM,P003242,P010070,1.617,-2,0,2
40,HAM,P003242,P011256,16.733,-2,34,36
40,HAM,P003242,P012690,6.617,-2,14,16
40,HAM,P003242,P012695,8.733,-8,14,22
40,HAM,P003242,P013308,17.167,-13,31,44
40,HAM,P003242,P013309,9.467,-11,14,25
40,HAM,P003242,P013310,2.35,-1,4,5
40,HAM,P003242,P013311,3.25,-8,3,11
40,HAM,P003242,P013312,15.501,-9,27,36
40,HAM,P006420,P010070,8.435,-16,9,25
40,HAM,P006420,P011256,11.567,-10,19,29
40,HAM,P006420,P012690,1.05,-2,2,4
40,HAM,P006420,P012695,10.75,-16,17,33
40,HAM,P006420,P013308,10.767,-13,18,31
40,HAM,P006420,P013309,12.517,-19,18,37
40,HAM,P006420,P013311,7.234,-16,9,25
40,HAM,P006420,P013312,10.051,-12,13,25
40,HAM,P010070,P011256,5.651,-4,9,13
40,HAM,P010070,P012690,4.5,2,10,8
40,HAM,P010070,P012695,6.367,-13,10,23
40,HAM,P010070,P013308,2.434,-4,3,7
40,HAM,P010070,P013309,13.684,-14,21,35
40,HAM,P010070,P013310,4.866,-4,9,13
40,HAM,P010070,P013311,7.567,-14,11,25
40,HAM,P010070,P013312,9.351,-3,14,17
40,HAM,P011256,P012690,9.267,1,20,19
40,HAM,P011256,P012695,5.7,-1,10,11
40,HAM,P011256,P013308,17.084,-11,30,41
40,HAM,P011256,P013309,5.3,5,13,8
40,HAM,P011256,P013310,2.35,-1,4,5
40,HAM,P011256,P013312,15.884,-1,33,34
40,HAM,P012690,P013308,6.617,-2,14,16
40,HAM,P012690,P013309,5.067,-1,10,11
40,HAM,P012690,P013310,1.283,2,4,2
40,HAM,P012690,P013312,10.067,2,22,20
40,HAM,P012695,P013308,6.45,-8,9,17
40,HAM,P012695,P013309,12.866,-17,23,40
40,HAM,P012695,P013310,3.583,-6,5,11
40,HAM,P012695,P013311,9.333,-22,12,34
40,HAM,P012695,P013312,2.15,-1,4,5
40,HAM,P013308,P013309,3.9,-8,6,14
40,HAM,P013308,P013310,2.35,-1,4,5
40,HAM,P013308,P013311,1.383,-2,2,4
40,HAM,P013308,P013312,15.784,-14,27,41
40,HAM,P013309,P013310,4.866,-4,9,13
40,HAM,P013309,P013311,12.2,-24,16,40
40,HAM,P013309,P013312,11.801,-7,18,25
40,HAM,P013310,P013311,3.583,-6,5,11
40,HAM,P013310,P013312,3.633,1,8,7
40,HAM,P013311,P013312,4.25,-4,6,10
31,BUD,P004222,P005637,0.283,-2,0,2
31,BUD,P004222,P006566,0.283,-2,0,2
31,BUD,P004222,P011150,5.416,-1,9,10
31,BUD,P004222,P011281,3.433,-5,1,6
31,BUD,P004222,P012606,9.866,0,19,19
31,BUD,P004222,P012630,10.166,-4,17,21
31,BUD,P004222,P013256,11.716,-2,19,21
31,BUD,P004222,P013258,6.833,0,11,11
31,BUD,P005637,P006561,3.817,1,8,7
31,BUD,P005637,P006566,8.566,-1,18,19
31,BUD,P005637,P008325,21.549,5,51,46
31,BUD,P005637,P011150,23.716,6,57,51
31,BUD,P005637,P011281,17.916,-1,39,40
31,BUD,P005637,P012606,10.716,-2,27,29
31,BUD,P005637,P012630,8.383,3,20,17
31,BUD,P005637,P013258,7.65,7,16,9
31,BUD,P006561,P011150,3.817,1,8,7
31,BUD,P006561,P011281,3.817,1,8,7
31,BUD,P006561,P012630,1.7,2,4,2
31,BUD,P006561,P013258,2.117,-1,4,5
31,BUD,P006566,P008325,8.283,1,18,17
31,BUD,P006566,P011150,8.566,-1,18,19
31,BUD,P006566,P011281,8.566,-1,18,19
31,BUD,P008325,P011150,22.216,14,63,49
31,BUD,P008325,P011281,14.466,4,37,33
31,BUD,P008325,P012606,12.999,5,41,36
31,BUD,P008325,P012630,6.733,1,16,15
31,BUD,P008325,P013256,2.267,3,8,5
31,BUD,P008325,P013258,8.083,15,26,11
31,BUD,P011150,P011281,20.416,1,45,44
31,BUD,P011150,P012606,14.349,10,48,38
31,BUD,P011150,P012630,10.083,4,25,21
31,BUD,P011150,P013256,7.4,4,17,13
31,BUD,P011150,P013258,9.817,18,30,12
31,BUD,P011281,P012606,4.649,-4,14,18
31,BUD,P011281,P012630,4.033,-1,5,6
31,BUD,P011281,P013256,3.5,-3,1,4
31,BUD,P011281,P013258,6.2,9,16,7
31,BUD,P012606,P012630,15.982,-1,33,34
31,BUD,P012606,P013256,11.849,3,27,24
31,BUD,P012606,P013258,11.182,9,31,22
31,BUD,P012630,P013256,10.199,-4,17,21
31,BUD,P012630,P013258,7.249,-4,11,15
31,BUD,P013256,P013258,9.133,3,19,16
31,TSO,P003885,P008790,3.817,-4,7,11
31,TSO,P003885,P009649,9.768,-14,19,33
31,TSO,P003885,P012019,6.7,-5,12,17
31,TSO,P003885,P013292,1.633,-3,3,6
31,TSO,P003885,P013293,3.217,-6,7,13
31,TSO,P003885,P013295,6.267,-4,12,16
31,TSO,P003885,P013296,2.85,-1,5,6
31,TSO,P003885,P013297,4.384,-8,10,18
31,TSO,P003885,P013298,5.7,-7,13,20
31,TSO,P008790,P009649,9.733,-1,25,26
31,TSO,P008790,P012019,11.5,1,30,29
31,TSO,P008790,P013292,1.317,3,5,2
31,TSO,P008790,P013293,10.033,-6,16,22
31,TSO,P008790,P013295,12.733,-2,30,32
31,TSO,P008790,P013297,5.316,4,12,8
31,TSO,P008790,P013298,8.883,1,23,22
31,TSO,P009649,P012019,23.332,3,52,49
31,TSO,P009649,P013292,1.05,-4,0,4
31,TSO,P009649,P013293,12.45,-7,22,29
31,TSO,P009649,P013295,25.5,-4,54,58
31,TSO,P009649,P013296,18.466,-1,33,34
31,TSO,P009649,P013297,13.833,-4,29,33
31,TSO,P009649,P013298,16.2,-8,38,46
31,TSO,P012019,P013292,3.016,4,8,4
31,TSO,P012019,P013293,8.733,-4,11,15
31,TSO,P012019,P013295,21.516,2,48,46
31,TSO,P012019,P013296,15.732,3,30,27
31,TSO,P012019,P013297,7.649,6,19,13
31,TSO,P012019,P013298,10.882,6,30,24
31,TSO,P013292,P013295,1.35,3,5,2
31,TSO,P013292,P013296,2.016,1,3,2
31,TSO,P013292,P013297,1.05,-4,0,4
31,TSO,P013292,P013298,3.3,0,8,8
31,TSO,P013293,P013295,12.183,-8,17,25
31,TSO,P013293,P013296,5.25,-1,8,9
31,TSO,P013293,P013297,7.266,1,17,16
31,TSO,P013293,P013298,9.8,-9,18,27
31,TSO,P013295,P013296,16.75,-1,31,32
31,TSO,P013295,P013297,11.5,-1,24,25
31,TSO,P013295,P013298,18.733,-1,43,44
31,TSO,P013296,P013297,7.616,0,14,14
31,TSO,P013296,P013298,10.316,0,20,20
31,TSO,P013297,P013298,10.65,-10,19,29
32,BAH,P003840,P004172,5.1,1,15,14
32,BAH,P003840,P009601,14.0,16,36,20
32,BAH,P003840,P011192,17.551,11,43,32
32,BAH,P003840,P011201,9.467,8,23,15
32,BAH,P003840,P011821,13.567,4,35,31
32,BAH,P003840,P011823,8.451,6,25,19
32,BAH,P003840,P012405,11.55,-1,21,22
32,BAH,P003840,P012711,10.918,3,34,31
32,BAH,P004172,P009601,5.483,12,19,7
32,BAH,P004172,P011192,4.483,0,11,11
32,BAH,P004172,P011201,9.7,15,33,18
32,BAH,P004172,P011821,11.066,14,29,15
32,BAH,P004172,P011823,8.417,16,31,15
32,BAH,P004172,P012405,5.283,0,11,11
32,BAH,P004172,P012711,10.4,2,27,25
32,BAH,P008278,P008282,3.7,4,10,6
32,BAH,P008278,P011201,3.7,4,10,6
32,BAH,P008278,P011821,0.417,1,1,0
32,BAH,P008278,P011823,3.7,4,10,6
32,BAH,P008278,PLQV,3.283,3,9,6
32,BAH,P008282,P009601,3.283,8,11,3
32,BAH,P008282,P011192,2.566,8,11,3
32,BAH,P008282,P011201,4.9,6,12,6
32,BAH,P008282,P011821,4.183,11,14,3
32,BAH,P008282,P011823,4.9,6,12,6
32,BAH,P008282,P012405,2.566,8,11,3
32,BAH,P008282,P012711,0.483,2,2,0
32,BAH,P008282,PLQV,3.283,3,9,6
32,BAH,P009601,P011192,17.65,24,52,28
32,BAH,P009601,P011201,13.8,23,36,13
32,BAH,P009601,P011821,13.316,25,44,19
32,BAH,P009601,P011823,9.417,21,29,8
32,BAH,P009601,P012405,9.416,9,23,14
32,BAH,P009601,P012711,3.167,6,14,8
32,BAH,P011192,P011201,9.067,11,22,11
32,BAH,P011192,P011821,15.533,8,43,35
32,BAH,P011192,P011823,7.534,10,22,12
32,BAH,P011192,P012405,13.899,3,29,26
32,BAH,P011192,P012711,10.117,1,27,26
32,BAH,P011201,P011821,7.4,17,21,4
32,BAH,P011201,P011823,17.334,28,53,25
32,BAH,P011201,P012405,2.183,1,3,2
32,BAH,P011201,P012711,6.034,4,18,14
32,BAH,P011201,PLQV,3.283,3,9,6
32,BAH,P011821,P011823,9.484,18,28,10
32,BAH,P011821,P012405,14.466,4,33,29
32,BAH,P011821,P012711,13.3,6,36,30
32,BAH,P011823,P012711,6.684,4,21,17
32,BAH,P011823,PLQV,3.283,3,9,6
32,BAH,P012405,P012711,7.233,-4,13,17
32,TRN,P005438,P006382,4.217,-3,11,14
32,TRN,P005438,P006724,8.55,-23,8,31
32,TRN,P005438,P012242,6.783,-10,9,19
32,TRN,P005438,P012593,17.049,-29,23,52
32,TRN,P005438,P012687,10.034,-13,17,30
32,TRN,P005438,P013269,10.666,-22,15,37
32,TRN,P005438,P013270,7.267,-15,17,32
32,TRN,P005438,P013271,12.3,-11,22,33
32,TRN,P005438,P013272,13.466,-30,18,48
32,TRN,P006382,P006724,5.383,1,12,11
32,TRN,P006382,P012593,2.25,-4,2,6
32,TRN,P006382,P012687,9.367,-8,20,28
32,TRN,P006382,P013269,4.784,4,13,9
32,TRN,P006382,P013270,9.984,3,28,25
32,TRN,P006382,P013271,5.034,1,15,14
32,TRN,P006382,P013272,7.917,2,19,17
32,TRN,P006724,P012242,4.417,-6,6,12
32,TRN,P006724,P012593,9.233,-18,12,30
32,TRN,P006724,P012687,14.633,-15,22,37
32,TRN,P006724,P013269,15.217,-11,28,39
32,TRN,P006724,P013270,14.717,-6,28,34
32,TRN,P006724,P013271,2.4,-3,2,5
32,TRN,P006724,P013272,13.65,-11,26,37
32,TRN,P012242,P012593,5.35,-9,6,15
32,TRN,P012242,P012687,4.9,-6,6,12
32,TRN,P012242,P013270,1.433,-1,3,4
32,TRN,P012242,P013271,2.366,-4,3,7
32,TRN,P012242,P013272,1.883,-4,3,7
32,TRN,P012593,P012687,8.1,-11,10,21
32,TRN,P012593,P013269,11.349,-17,19,36
32,TRN,P012593,P013270,3.633,-6,9,15
32,TRN,P012593,P013271,7.983,-7,10,17
32,TRN,P012593,P013272,10.849,-19,17,36
32,TRN,P012687,P013269,10.367,-6,17,23
32,TRN,P012687,P013270,16.484,-11,32,43
32,TRN,P012687,P013271,9.584,-6,17,23
32,TRN,P012687,P013272,11.067,-8,19,27
32,TRN,P013269,P013270,17.134,-10,34,44
32,TRN,P013269,P013271,8.483,-5,10,15
32,TRN,P013269,P013272,21.4,-17,40,57
32,TRN,P013270,P013271,8.817,-5,18,23
32,TRN,P013270,P013272,19.267,-13,39,52
32,TRN,P013271,P013272,10.233,-8,15,23
35,JOV,P002361,P002507,10.583,-4,23,27
35,JOV,P002361,P004834,6.116,-4,7,11
35,JOV,P002361,P005099,12.466,-8,24,32
35,JOV,P002361,P010161,11.099,-2,22,24
35,JOV,P002361,P012349,6.717,4,15,11
35,JOV,P002361,P012740,6.05,-2,9,11
35,JOV,P002361,P013287,9.982,-12,15,27
35,JOV,P002361,PJUG,3.783,-4,5,9
35,JOV,P002507,P005099,14.75,-7,28,35
35,JOV,P002507,P006771,1.05,-5,0,5
35,JOV,P002507,P010161,15.066,-8,27,35
35,JOV,P002507,P012349,12.433,0,20,20
35,JOV,P002507,P012740,11.9,0,20,20
35,JOV,P002507,P013285,14.05,-7,20,27
35,JOV,P002507,P013287,12.2,-11,23,34
35,JOV,P002507,PJUG,6.5,-2,11,13
35,JOV,P004834,P005099,3.583,0,6,6
35,JOV,P004834,P006771,2.367,-1,2,3
35,JOV,P004834,P010161,5.833,-2,7,9
35,JOV,P004834,P012349,5.934,2,9,7
35,JOV,P004834,P012740,8.2,-6,7,13
35,JOV,P004834,P013285,4.367,-3,4,7
35,JOV,P004834,P013287,4.549,-9,2,11
35,JOV,P004834,PJUG,0.983,-5,0,5
35,JOV,P005099,P010161,7.533,-5,16,21
35,JOV,P005099,P012349,8.4,8,18,10
35,JOV,P005099,P012740,9.683,1,18,17
35,JOV,P005099,P013285,5.867,1,10,9
35,JOV,P005099,P013287,9.933,-15,16,31
35,JOV,P005099,PJUG,1.117,-3,0,3
35,JOV,P006771,P012349,3.417,-6,2,8
35,JOV,P006771,P012740,3.417,-6,2,8
35,JOV,P006771,P013285,3.417,-6,2,8
35,JOV,P010161,P012349,13.716,-1,24,25
35,JOV,P010161,P012740,11.883,-6,16,22
35,JOV,P010161,P013285,14.683,-13,21,34
35,JOV,P010161,P013287,16.949,-19,28,47
35,JOV,P010161,PJUG,6.366,-4,11,15
35,JOV,P012349,P012740,19.0,-5,30,35
35,JOV,P012349,P013285,16.533,-7,23,30
35,JOV,P012349,P013287,4.883,-5,9,14
35,JOV,P012349,PJUG,1.967,-2,2,4
35,JOV,P012740,P013285,18.933,-9,27,36
35,JOV,P012740,P013287,10.866,-11,15,26
35,JOV,P013285,P013287,11.65,-13,19,32
35,JOV,P013285,PJUG,3.7,-3,6,9
35,JOV,P013287,PJUG,5.516,-5,9,14
35,WOL,P003212,P006853,3.333,-2,4,6
35,WOL,P003212,P008186,3.333,-2,4,6
35,WOL,P003212,P011248,3.333,-2,4,6
35,WOL,P003212,P012577,3.333,-2,4,6
35,WOL,P004645,P005516,16.433,10,34,24
35,WOL,P004645,P006546,13.868,2,23,21
35,WOL,P004645,P006853,7.583,12,19,7
35,WOL,P004645,P008186,3.684,-2,0,2
35,WOL,P004645,P011248,9.101,9,17,8
35,WOL,P004645,P012003,22.168,12,42,30
35,WOL,P004645,P012577,7.767,11,23,12
35,WOL,P004645,P012789,11.6,6,22,16
35,WOL,P005516,P006546,14.883,9,30,21
35,WOL,P005516,P006853,7.15,4,20,16
35,WOL,P005516,P008186,5.7,2,9,7
35,WOL,P005516,P011248,7.866,6,22,16
35,WOL,P005516,P012003,19.533,17,44,27
35,WOL,P005516,P012577,15.666,16,44,28
35,WOL,P005516,P012789,11.633,8,29,21
35,WOL,P006546,P008186,4.517,-4,2,6
35,WOL,P006546,P011248,6.067,-4,9,13
35,WOL,P006546,P012003,17.284,9,35,26
35,WOL,P006546,P012577,8.866,12,26,14
35,WOL,P006546,P012789,10.983,4,23,19
35,WOL,P006853,P008186,7.4,2,12,10
35,WOL,P006853,P011248,14.4,10,33,23
35,WOL,P006853,P012003,11.517,10,25,15
35,WOL,P006853,P012577,13.167,2,30,28
35,WOL,P006853,P012789,8.25,6,21,15
35,WOL,P008186,P011248,10.216,2,17,15
35,WOL,P008186,P012003,7.834,6,13,7
35,WOL,P008186,P012577,9.316,4,19,15
35,WOL,P011248,P012003,14.634,12,32,20
35,WOL,P011248,P012577,16.916,9,42,33
35,WOL,P011248,P012789,10.067,2,24,22
35,WOL,P012003,P012577,16.2,20,46,26
35,WOL,P012003,P012789,16.766,10,35,25
35,WOL,P012577,P012789,7.633,4,22,18
36,ARI,P003240,P004292,9.266,-7,15,22
36,ARI,P003240,P013049,0.283,0,0,0
36,ARI,P003240,P013248,2.649,4,7,3
36,ARI,P003240,P013249,7.117,-3,10,13
36,ARI,P003240,P013250,12.284,6,25,19
36,ARI,P003240,P013251,4.516,-6,6,12
36,ARI,P003240,P013252,2.199,-3,4,7
36,ARI,P003240,P013253,6.466,5,14,9
36,ARI,P003240,P013355,13.518,-3,21,24
36,ARI,P003240,P013356,8.483,-6,14,20
36,ARI,P003240,P013360,6.683,5,12,7
36,ARI,P004292,P013049,0.283,0,0,0
36,ARI,P004292,P013248,9.916,5,25,20
36,ARI,P004292,P013249,19.166,-11,32,43
36,ARI,P004292,P013250,19.467,-4,36,40
36,ARI,P004292,P013251,7.334,0,14,14
36,ARI,P004292,P013252,10.266,-10,12,22
36,ARI,P004292,P013253,7.215,-5,11,16
36,ARI,P004292,P013355,9.5,-8,14,22
36,ARI,P004292,P013356,20.049,-17,32,49
36,ARI,P004292,P013360,6.266,5,13,8
36,ARI,P013049,P013249,0.283,0,0,0
36,ARI,P013049,P013355,0.283,0,0,0
36,ARI,P013248,P013249,6.533,-1,16,17
36,ARI,P013248,P013250,8.933,5,22,17
36,ARI,P013248,P013251,2.6,3,6,3
36,ARI,P013248,P013253,1.616,5,5,0
36,ARI,P013248,P013356,7.983,3,20,17
36,ARI,P013248,P013360,2.766,4,7,3
36,ARI,P013249,P013250,19.15,-8,32,40
36,ARI,P013249,P013251,1.984,-4,4,8
36,ARI,P013249,P013252,7.8,-11,8,19
36,ARI,P013249,P013253,0.633,-1,0,1
36,ARI,P013249,P013355,8.15,-1,12,13
36,ARI,P013249,P013356,18.216,-9,30,39
36,ARI,P013249,P013360,0.9,-3,0,3
36,ARI,P013250,P013251,5.367,0,8,8
36,ARI,P013250,P013252,8.783,-8,8,16
36,ARI,P013250,P013253,6.384,3,11,8
36,ARI,P013250,P013355,12.068,2,23,21
36,ARI,P013250,P013356,20.916,-5,38,43
36,ARI,P013250,P013360,5.784,5,9,4
36,ARI,P013251,P013252,6.7,-2,12,14
36,ARI,P013251,P013253,2.9,2,4,2
36,ARI,P013251,P013355,1.667,-5,0,5
36,ARI,P013251,P013356,3.384,-2,8,10
36,ARI,P013251,P013360,7.416,-2,10,12
36,ARI,P013252,P013253,4.316,-2,4,6
36,ARI,P013252,P013356,8.949,-13,10,23
36,ARI,P013252,P013360,4.183,1,6,5
36,ARI,P013253,P013355,5.867,-1,11,12
36,ARI,P013253,P013356,6.349,-6,10,16
36,ARI,P013253,P013360,5.45,8,10,2
36,ARI,P013355,P013356,8.867,-5,14,19
36,ARI,P013355,P013360,3.884,1,5,4
36,JER,P006625,P009879,1.049,0,0,0
36,JER,P006625,P010431,12.55,13,32,19
36,JER,P006625,P010587,9.834,-1,14,15
36,JER,P006625,P011970,23.032,10,48,38
36,JER,P006625,P013276,12.433,8,27,19
36,JER,P006625,P013277,13.349,0,23,23
36,JER,P006625,P013278,14.333,1,24,23
36,JER,P006625,P013279,10.983,13,28,15
36,JER,P006625,P013281,5.233,0,8,8
36,JER,P009879,P010431,5.333,2,10,8
36,JER,P009879,P010587,5.85,-2,10,12
36,JER,P009879,P011970,1.799,-4,0,4
36,JER,P009879,P013276,5.382,-3,5,8
36,JER,P009879,P013277,1.517,1,5,4
36,JER,P009879,P013278,1.517,1,5,4
36,JER,P009879,P013279,5.149,-3,5,8
36,JER,P010431,P010587,10.335,-6,14,20
36,JER,P010431,P011970,18.416,17,48,31
36,JER,P010431,P013276,19.734,15,47,32
36,JER,P010431,P013277,8.167,8,20,12
36,JER,P010431,P013278,7.05,-1,12,13
36,JER,P010431,P013279,16.183,10,39,29
36,JER,P010431,P013281,5.1,6,14,8
36,JER,P010587,P011970,12.033,-11,14,25
36,JER,P010587,P013276,7.701,-6,9,15
36,JER,P010587,P013277,11.084,-5,16,21
36,JER,P010587,P013278,12.05,-4,18,22
36,JER,P010587,P013279,8.6,-5,11,16
36,JER,P010587,P013281,1.517,0,2,2
36,JER,P011970,P013276,16.816,11,41,30
36,JER,P011970,P013277,15.232,5,30,25
36,JER,P011970,P013278,16.149,-4,24,28
36,JER,P011970,P013279,15.299,6,35,29
36,JER,P011970,P013281,8.816,6,20,14
36,JER,P013276,P013277,3.717,4,8,4
36,JER,P013276,P013278,1.067,-2,0,2
36,JER,P013276,P013279,16.799,9,39,30
36,JER,P013276,P013281,3.883,8,12,4
36,JER,P013277,P013278,14.816,-2,27,29
36,JER,P013277,P013281,6.25,-3,11,14
36,JER,P013278,P013279,3.3,1,4,3
36,JER,P013278,P013281,6.45,-2,10,12
36,JER,P013279,P013281,4.083,9,11,2
39,PAM,P004548,P005356,1.55,-1,4,5
39,PAM,P004548,P006643,6.633,-2,15,17
39,PAM,P004548,P007527,6.116,2,16,14
39,PAM,P004548,P009864,5.583,-2,13,15
39,PAM,P004548,P010042,2.2,3,6,3
39,PAM,P004548,P010393,7.666,6,21,15
39,PAM,P004548,P010444,0.433,1,1,0
39,PAM,P004548,P011980,2.2,-2,5,7
39,PAM,P004548,P011982,3.233,6,11,5
39,PAM,P004548,P012738,3.85,5,12,7
39,PAM,P005356,P006643,6.083,6,14,8
39,PAM,P005356,P009864,5.766,0,15,15
39,PAM,P005356,P010042,5.383,5,13,8
39,PAM,P005356,P010393,5.166,10,17,7
39,PAM,P005356,P010444,4.117,8,9,1
39,PAM,P005356,P010750,5.716,10,15,5
39,PAM,P005356,P011980,7.483,4,15,11
39,PAM,P005356,P011982,6.566,8,18,10
39,PAM,P005356,P012738,2.766,6,8,2
39,PAM,P006643,P007527,5.65,-5,13,18
39,PAM,P006643,P009864,8.383,-3,19,22
39,PAM,P006643,P010042,11.033,7,28,21
39,PAM,P006643,P010393,5.233,3,13,10
39,PAM,P006643,P010444,4.0,5,11,6
39,PAM,P006643,P010750,3.567,4,10,6
39,PAM,P006643,P011980,11.25,2,27,25
39,PAM,P006643,P012738,4.1,3,10,7
39,PAM,P007527,P009864,3.45,-3,8,11
39,PAM,P007527,P010042,6.934,-3,20,23
39,PAM,P007527,P010393,11.95,3,29,26
39,PAM,P007527,P010444,7.75,5,19,14
39,PAM,P007527,P010750,6.867,1,15,14
39,PAM,P007527,P011980,7.967,-3,22,25
39,PAM,P007527,P011982,14.267,5,38,33
39,PAM,P007527,P012738,8.717,-2,24,26
39,PAM,P009864,P010042,7.2,6,21,15
39,PAM,P009864,P010393,7.916,10,25,15
39,PAM,P009864,P010750,1.499,5,7,2
39,PAM,P009864,P011980,3.833,-7,7,14
39,PAM,P009864,P011982,3.366,6,13,7
39,PAM,P010042,P010393,7.767,10,26,16
39,PAM,P010042,P010444,5.75,6,17,11
39,PAM,P010042,P010750,5.233,5,16,11
39,PAM,P010042,P011980,11.983,0,29,29
39,PAM,P010042,P011982,8.717,3,27,24
39,PAM,P010042,P012738,6.8,-2,17,19
39,PAM,P010393,P010444,9.8,4,20,16
39,PAM,P010393,P010750,11.449,11,29,18
39,PAM,P010393,P011982,16.766,17,48,31
39,PAM,P010393,P012738,4.283,6,16,10
39,PAM,P010444,P010750,15.484,10,36,26
39,PAM,P010444,P011980,6.967,11,21,10
39,PAM,P010444,P011982,12.767,10,30,20
39,PAM,P010750,P011980,6.367,5,17,12
39,PAM,P010750,P011982,14.249,12,36,24
39,PAM,P010750,P012738,0.833,1,3,2
39,PAM,P011980,P011982,6.75,0,17,17
39,PAM,P011980,P012738,7.2,-2,16,18
39,PAM,P011982,P012738,7.383,1,22,21
39,VNC,P003759,P005177,8.433,-15,10,25
39,VNC,P003759,P005404,7.35,-14,5,19
39,VNC,P003759,P006571,6.817,-10,10,20
39,VNC,P003759,P008052,2.217,-3,0,3
39,VNC,P003759,P011928,4.15,-7,2,9
39,VNC,P003759,P012588,6.416,-12,8,20
39,VNC,P003759,P013305,3.817,-3,5,8
39,VNC,P005177,P005404,9.25,-16,13,29
39,VNC,P005177,P006571,10.784,-12,21,33
39,VNC,P005177,P008052,7.583,5,21,16
39,VNC,P005177,P011928,7.816,-7,13,20
39,VNC,P005177,P012588,12.983,-11,26,37
39,VNC,P005177,P012796,10.1,1,26,25
39,VNC,P005177,P013305,9.983,3,26,23
39,VNC,P005404,P006571,9.5,-15,13,28
39,VNC,P005404,P008052,20.0,-9,44,53
39,VNC,P005404,P011928,15.15,-12,25,37
39,VNC,P005404,P012588,15.316,-14,32,46
39,VNC,P005404,P012796,22.633,-11,52,63
39,VNC,P005404,P013305,20.733,-9,44,53
39,VNC,P006571,P008052,0.7,1,3,2
39,VNC,P006571,P011928,2.017,-3,2,5
39,VNC,P006571,P012588,9.5,-9,19,28
39,VNC,P006571,P012796,4.0,-3,8,11
39,VNC,P006571,P013305,2.75,3,8,5
39,VNC,P008052,P011928,16.916,-7,34,41
39,VNC,P008052,P012588,10.733,3,31,28
39,VNC,P008052,P012796,24.699,-2,62,64
39,VNC,P008052,P013305,27.616,-4,65,69
39,VNC,P011928,P012588,1.599,-5,0,5
39,VNC,P011928,P012796,16.349,-8,34,42
39,VNC,P011928,P013305,17.999,-11,34,45
39,VNC,P012588,P012796,13.983,-1,36,37
39,VNC,P012588,P013305,13.866,1,36,35
39,VNC,P012796,P013305,26.232,-4,62,66
49,BOU,P004525,P004945,9.933,-4,21,25
49,BOU,P004525,P006904,13.968,3,28,25
49,BOU,P004525,P009552,12.351,0,23,23
49,BOU,P004525,P009556,12.202,4,28,24
49,BOU,P004525,P010449,10.234,4,21,17
49,BOU,P004525,P010450,6.217,3,11,8
49,BOU,P004525,P011837,4.834,2,8,6
49,BOU,P004525,P013264,4.75,-2,11,13
49,BOU,P004525,P013265,11.568,2,30,28
49,BOU,P004525,P013266,12.351,12,39,27
49,BOU,P004945,P006904,4.6,-5,5,10
49,BOU,P004945,P009552,6.267,-1,12,13
49,BOU,P004945,P009556,6.267,-1,12,13
49,BOU,P004945,P010449,0.566,-1,3,4
49,BOU,P004945,P011837,7.35,-10,9,19
49,BOU,P004945,P013264,10.633,-12,15,27
49,BOU,P004945,P013265,10.466,-15,16,31
49,BOU,P004945,P013266,13.05,-7,27,34
49,BOU,P006904,P009552,11.267,0,22,22
49,BOU,P006904,P009556,6.317,-4,10,14
49,BOU,P006904,P010449,7.284,5,16,11
49,BOU,P006904,P010450,7.384,7,17,10
49,BOU,P006904,P011837,1.717,0,2,2
49,BOU,P006904,P013264,2.4,8,10,2
49,BOU,P006904,P013265,3.834,7,14,7
49,BOU,P006904,P013266,4.501,15,20,5
49,BOU,P009552,P009556,8.784,-5,14,19
49,BOU,P009552,P010449,6.251,0,9,9
49,BOU,P009552,P010450,5.667,7,15,8
49,BOU,P009552,P013264,3.817,1,8,7
49,BOU,P009552,P013265,4.234,-5,4,9
49,BOU,P009552,P013266,6.034,7,17,10
49,BOU,P009556,P010449,0.934,0,0,0
49,BOU,P009556,P011837,1.484,2,4,2
49,BOU,P009556,P013264,2.067,-2,5,7
49,BOU,P009556,P013265,6.535,3,16,13
49,BOU,P009556,P013266,6.618,11,23,12
49,BOU,P010449,P010450,6.217,3,11,8
49,BOU,P010449,P011837,7.8,-1,12,13
49,BOU,P010449,P013264,5.783,-4,8,12
49,BOU,P010449,P013265,9.434,-3,18,21
49,BOU,P010449,P013266,8.833,-3,18,21
49,BOU,P010450,P011837,2.05,0,2,2
49,BOU,P010450,P013264,1.5,4,6,2
49,BOU,P010450,P013266,1.833,4,6,2
49,BOU,P011837,P013264,11.583,-11,17,28
49,BOU,P011837,P013265,14.367,-9,23,32
49,BOU,P011837,P013266,14.483,-9,23,32
49,BOU,P013264,P013265,18.1,-18,28,46
49,BOU,P013264,P013266,19.967,-12,36,48
49,BOU,P013265,P013266,23.334,-10,47,57
49,LKB,P005113,P005521,21.483,21,46,25
49,LKB,P005113,P005656,22.183,12,49,37
49,LKB,P005113,P006212,3.15,0,4,4
49,LKB,P005113,P006586,4.9,1,11,10
49,LKB,P005113,P009299,10.417,-1,20,21
49,LKB,P005113,P009898,17.816,13,38,25
49,LKB,P005113,P010181,3.5,-5,4,9
49,LKB,P005113,PLXI,17.883,7,40,33
49,LKB,P005521,P005656,23.15,20,52,32
49,LKB,P005521,P006212,5.034,-1,6,7
49,LKB,P005521,P006586,5.367,5,15,10
49,LKB,P005521,P009299,10.334,6,22,16
49,LKB,P005521,P009898,20.233,15,43,28
49,LKB,P005521,P010181,2.0,1,2,1
49,LKB,P005521,P010461,6.467,-2,13,15
49,LKB,P005521,PLXI,20.2,15,49,34
49,LKB,P005656,P006586,8.784,-3,18,21
49,LKB,P005656,P009299,9.884,-6,21,27
49,LKB,P005656,P009898,17.599,10,39,29
49,LKB,P005656,P010181,4.367,-8,4,12
49,LKB,P005656,P010461,6.2,-8,9,17
49,LKB,P005656,PLXI,23.833,3,52,49
49,LKB,P006212,P006586,5.583,-1,13,14
49,LKB,P006212,P009299,10.617,-2,19,21
49,LKB,P006212,P009898,6.217,-3,7,10
49,LKB,P006212,P010181,2.0,3,5,2
49,LKB,P006212,P010461,7.467,-2,15,17
49,LKB,P006212,PLXI,2.4,-2,7,9
49,LKB,P006586,P009299,10.1,-1,29,30
49,LKB,P006586,P009898,3.033,-6,3,9
49,LKB,P006586,P010181,2.867,0,5,5
49,LKB,P006586,P010461,9.233,-5,21,26
49,LKB,P006586,PLXI,9.133,-2,25,27
49,LKB,P009299,P009898,10.467,-2,14,16
49,LKB,P009299,P010181,4.367,-6,7,13
49,LKB,P009299,P010461,9.85,-7,21,28
49,LKB,P009299,PLXI,7.5,-9,23,32
49,LKB,P009898,P010461,6.0,-6,8,14
49,LKB,P009898,PLXI,13.899,7,32,25
49,LKB,P010181,P010461,2.867,0,5,5
49,LKB,P010181,PLXI,3.5,-5,4,9
49,LKB,P010461,PLXI,8.116,-6,20,26
41,TSO,P003885,P008790,3.383,0,7,7
41,TSO,P003885,P009649,16.067,-3,27,30
41,TSO,P003885,P012019,18.3,-1,32,33
41,TSO,P003885,P013293,3.916,-6,5,11
41,TSO,P003885,P013295,8.966,0,20,20
41,TSO,P003885,P013296,11.15,-8,18,26
41,TSO,P003885,P013297,5.6,8,12,4
41,TSO,P003885,P013298,13.15,10,27,17
41,TSO,P008790,P009649,8.267,5,23,18
41,TSO,P008790,P012019,5.617,8,16,8
41,TSO,P008790,P013293,8.267,5,23,18
41,TSO,P008790,P013295,5.75,-5,11,16
41,TSO,P008790,P013297,6.434,4,18,14
41,TSO,P008790,P013298,1.55,-1,2,3
41,TSO,P009649,P012019,30.684,-12,53,65
41,TSO,P009649,P013292,0.15,-2,0,2
41,TSO,P009649,P013293,12.067,-7,27,34
41,TSO,P009649,P013295,17.251,-17,36,53
41,TSO,P009649,P013296,22.101,-30,30,60
41,TSO,P009649,P013297,26.418,-10,54,64
41,TSO,P009649,P013298,18.467,0,34,34
41,TSO,P012019,P013292,0.15,-2,0,2
41,TSO,P012019,P013293,6.75,0,16,16
41,TSO,P012019,P013295,17.2,2,39,37
41,TSO,P012019,P013296,23.717,-16,38,54
41,TSO,P012019,P013297,25.117,9,54,45
41,TSO,P012019,P013298,23.733,12,48,36
41,TSO,P013292,P013295,0.15,-2,0,2
41,TSO,P013292,P013297,0.15,-2,0,2
41,TSO,P013293,P013295,5.467,-6,13,19
41,TSO,P013293,P013296,3.65,-13,2,15
41,TSO,P013293,P013297,8.151,-1,22,23
41,TSO,P013295,P013296,14.768,-2,36,38
41,TSO,P013295,P013297,16.401,-3,39,42
41,TSO,P013295,P013298,11.583,13,34,21
41,TSO,P013296,P013297,15.551,-11,29,40
41,TSO,P013296,P013298,15.867,4,35,31
41,TSO,P013297,P013298,18.05,10,40,30
41,WOL,P003212,P006546,1.984,-1,4,5
41,WOL,P003212,P006853,7.001,8,22,14
41,WOL,P003212,P008186,2.217,3,6,3
41,WOL,P003212,P011248,5.284,9,18,9
41,WOL,P003212,P012577,7.001,8,22,14
41,WOL,P003212,P012789,4.517,5,16,11
41,WOL,P004645,P005516,12.55,0,20,20
41,WOL,P004645,P006546,13.75,-4,20,24
41,WOL,P004645,P006853,1.816,-9,0,9
41,WOL,P004645,P008186,9.3,-6,12,18
41,WOL,P004645,P011248,1.05,-5,0,5
41,WOL,P004645,P012003,14.583,-9,20,29
41,WOL,P004645,P012789,5.283,-3,8,11
41,WOL,P005516,P006546,13.0,2,22,20
41,WOL,P005516,P006853,6.067,-7,10,17
41,WOL,P005516,P008186,12.6,-2,22,24
41,WOL,P005516,P011248,4.701,-2,13,15
41,WOL,P005516,P012003,21.401,-4,40,44
41,WOL,P005516,P012577,6.484,-1,15,16
41,WOL,P005516,P012789,8.801,-2,18,20
41,WOL,P006546,P006853,6.133,-2,12,14
41,WOL,P006546,P008186,9.7,-1,15,16
41,WOL,P006546,P011248,2.034,-4,3,7
41,WOL,P006546,P012003,18.916,-3,33,36
41,WOL,P006546,P012577,7.15,0,17,17
41,WOL,P006546,P012789,10.933,-3,22,25
41,WOL,P006853,P008186,8.099,-3,18,21
41,WOL,P006853,P011248,18.334,14,49,35
41,WOL,P006853,P012003,20.899,0,44,44
41,WOL,P006853,P012577,23.717,20,61,41
41,WOL,P006853,P012789,19.534,11,48,37
41,WOL,P008186,P011248,6.867,-6,15,21
41,WOL,P008186,P012003,16.416,-9,29,38
41,WOL,P008186,P012577,9.333,0,23,23
41,WOL,P011248,P012003,17.151,2,42,40
41,WOL,P011248,P012577,19.018,19,55,36
41,WOL,P011248,P012789,15.301,17,45,28
41,WOL,P012003,P012577,21.05,11,52,41
41,WOL,P012003,P012789,21.584,8,48,40
41,WOL,P012577,P012789,18.451,19,51,32
42,BES,P003783,P007914,8.35,10,21,11
42,BES,P003783,P008945,8.917,7,19,12
42,BES,P003783,P009680,13.05,17,31,14
42,BES,P003783,P010652,6.734,-1,13,14
42,BES,P003783,P011927,6.434,11,18,7
42,BES,P003783,P011936,12.284,10,26,16
42,BES,P003783,P013255,6.767,10,20,10
42,BES,P007914,P008945,7.4,-8,11,19
42,BES,P007914,P009680,6.816,7,15,8
42,BES,P007914,P010652,9.534,-8,16,24
42,BES,P007914,P011924,6.867,-12,9,21
42,BES,P007914,P011927,4.517,-4,11,15
42,BES,P007914,P011936,6.867,11,20,9
42,BES,P007914,P013255,10.517,-4,17,21
42,BES,P008945,P009680,10.584,4,20,16
42,BES,P008945,P010652,17.451,-13,29,42
42,BES,P008945,P011379,2.8,-3,3,6
42,BES,P008945,P011924,19.201,-14,31,45
42,BES,P008945,P011927,15.551,2,30,28
42,BES,P008945,P011936,15.084,-6,24,30
42,BES,P008945,P013255,15.484,3,33,30
42,BES,P009680,P010652,4.15,0,7,7
42,BES,P009680,P011924,3.3,1,5,4
42,BES,P009680,P011927,6.667,14,17,3
42,BES,P009680,P011936,11.333,15,24,9
42,BES,P009680,P013255,9.5,14,25,11
42,BES,P010652,P011924,18.117,-10,35,45
42,BES,P010652,P011927,13.267,-3,30,33
42,BES,P010652,P011936,15.734,-4,33,37
42,BES,P010652,P013255,14.417,-5,29,34
42,BES,P011379,P011924,2.8,-3,3,6
42,BES,P011379,P011927,2.8,-3,3,6
42,BES,P011379,P011936,2.8,-3,3,6
42,BES,P011924,P011927,16.3,-3,32,35
42,BES,P011924,P011936,13.583,0,29,29
42,BES,P011924,P013255,17.3,1,36,35
42,BES,P011927,P011936,14.45,5,28,23
42,BES,P011927,P013255,10.95,13,31,18
42,BES,P011936,P013255,11.333,12,33,21
42,JOV,P002361,P002507,7.717,-4,11,15
42,JOV,P002361,P004834,1.984,-4,2,6
42,JOV,P002361,P005099,1.034,-7,0,7
42,JOV,P002361,P006771,4.95,-7,7,14
42,JOV,P002361,P010161,5.367,-7,4,11
42,JOV,P002361,P012740,5.751,-8,4,12
42,JOV,P002361,P013285,0.35,-2,0,2
42,JOV,P002361,P013287,5.6,-6,9,15
42,JOV,P002361,PJUG,2.583,1,7,6
42,JOV,P002507,P004834,7.117,4,15,11
42,JOV,P002507,P005099,13.551,9,29,20
42,JOV,P002507,P006771,9.4,3,18,15
42,JOV,P002507,P010161,7.767,-1,13,14
42,JOV,P002507,P012740,15.134,-1,26,27
42,JOV,P002507,P013285,18.267,14,42,28
42,JOV,P002507,P013286,1.767,-2,0,2
42,JOV,P002507,P013287,17.0,10,38,28
42,JOV,P002507,PJUG,6.216,8,20,12
42,JOV,P004834,P005099,14.917,-7,26,33
42,JOV,P004834,P006771,2.15,-2,5,7
42,JOV,P004834,P010161,6.117,-2,11,13
42,JOV,P004834,P012740,12.501,-2,26,28
42,JOV,P004834,P013285,15.4,2,31,29
42,JOV,P004834,P013286,6.833,-5,12,17
42,JOV,P004834,P013287,10.967,-9,19,28
42,JOV,P004834,PJUG,4.55,-7,5,12
42,JOV,P005099,P006771,3.017,3,7,4
42,JOV,P005099,P010161,2.7,-5,4,9
42,JOV,P005099,P012740,9.918,-2,22,24
42,JOV,P005099,P013285,21.967,7,44,37
42,JOV,P005099,P013286,6.45,-5,7,12
42,JOV,P005099,P013287,17.034,-5,29,34
42,JOV,P005099,PJUG,5.816,-4,8,12
42,JOV,P006771,P010161,2.367,-8,0,8
42,JOV,P006771,P012740,6.1,-5,9,14
42,JOV,P006771,P013285,5.3,4,11,7
42,JOV,P006771,P013286,2.15,-2,5,7
42,JOV,P006771,P013287,10.183,1,23,22
42,JOV,P006771,PJUG,2.583,1,7,6
42,JOV,P010161,P012740,8.917,-7,10,17
42,JOV,P010161,P013285,5.667,2,16,14
42,JOV,P010161,P013286,1.1,-4,0,4
42,JOV,P010161,P013287,4.767,0,12,12
42,JOV,P010161,PJUG,2.367,4,10,6
42,JOV,P012740,P013285,11.517,7,28,21
42,JOV,P012740,P013286,3.25,-6,5,11
42,JOV,P012740,P013287,8.984,-4,18,22
42,JOV,P013285,P013286,5.35,-1,7,8
42,JOV,P013285,P013287,21.067,3,43,40
42,JOV,P013285,PJUG,8.183,0,18,18
42,JOV,P013286,P013287,7.5,-3,12,15
42,JOV,P013287,PJUG,10.766,1,25,24
43,CAN,P003425,P005005,2.4,5,8,3
43,CAN,P003425,P006588,6.35,10,21,11
43,CAN,P003425,P008121,8.3,2,20,18
43,CAN,P003425,P008966,8.3,2,20,18
43,CAN,P003425,P010452,4.35,-3,7,10
43,CAN,P003425,P011251,2.4,5,8,3
43,CAN,P003425,P012095,8.3,2,20,18
43,CAN,P003425,P012777,2.4,5,8,3
43,CAN,P005005,P006588,10.618,21,35,14
43,CAN,P005005,P007560,13.117,24,44,20
43,CAN,P005005,P008966,2.267,-1,4,5
43,CAN,P005005,P010452,8.601,3,27,24
43,CAN,P005005,P010623,14.652,12,45,33
43,CAN,P005005,P011251,9.868,24,39,15
43,CAN,P005005,P012016,10.534,32,43,11
43,CAN,P005005,P012095,8.167,11,20,9
43,CAN,P005005,P012777,16.184,21,47,26
43,CAN,P006588,P007560,2.167,7,9,2
43,CAN,P006588,P008121,5.017,10,21,11
43,CAN,P006588,P008966,7.067,7,23,16
43,CAN,P006588,P010623,7.118,14,26,12
43,CAN,P006588,P011251,8.568,24,33,9
43,CAN,P006588,P012016,2.834,11,16,5
43,CAN,P006588,P012095,7.067,7,23,16
43,CAN,P006588,P012777,5.734,13,17,4
43,CAN,P007560,P008121,3.883,3,12,9
43,CAN,P007560,P008966,1.783,0,5,5
43,CAN,P007560,P010452,7.417,3,21,18
43,CAN,P007560,P010623,7.417,3,21,18
43,CAN,P007560,P011251,2.167,7,9,2
43,CAN,P007560,P012016,9.65,26,35,9
43,CAN,P007560,P012095,7.416,17,26,9
43,CAN,P007560,P012777,12.983,18,42,24
43,CAN,P008121,P008966,12.016,10,36,26
43,CAN,P008121,P010452,6.017,-4,9,13
43,CAN,P008121,P010623,5.067,4,17,13
43,CAN,P008121,P011251,1.567,-3,4,7
43,CAN,P008121,P012016,3.884,-1,11,12
43,CAN,P008121,P012095,12.983,12,41,29
43,CAN,P008121,P012777,4.866,3,17,14
43,CAN,P008966,P010452,4.35,-3,7,10
43,CAN,P008966,P010623,4.2,7,15,8
43,CAN,P008966,P012095,14.283,9,40,31
43,CAN,P008966,P012777,2.866,5,10,5
43,CAN,P010452,P010623,10.268,2,29,27
43,CAN,P010452,P011251,1.617,2,8,6
43,CAN,P010452,P012016,4.701,8,15,7
43,CAN,P010452,P012095,5.584,-6,7,13
43,CAN,P010452,P012777,5.567,-6,14,20
43,CAN,P010623,P011251,6.868,9,26,17
43,CAN,P010623,P012016,8.085,10,28,18
43,CAN,P010623,P012095,5.434,4,15,11
43,CAN,P010623,P012777,9.767,-1,26,27
43,CAN,P011251,P012016,5.251,10,24,14
43,CAN,P011251,P012777,7.434,6,21,15
43,CAN,P012016,P012095,5.85,16,21,5
43,CAN,P012016,P012777,6.883,12,23,11
43,CAN,P012095,P012777,9.516,20,31,11
43,ULM,P006245,P006997,12.234,-19,19,38
43,ULM,P006245,P007952,8.7,0,28,28
43,ULM,P006245,P010726,3.25,-1,7,8
43,ULM,P006245,P011391,16.866,-3,44,47
43,ULM,P006245,P012077,22.4,-14,53,67
43,ULM,P006245,P012172,0.383,-2,0,2
43,ULM,P006245,P012602,7.783,-7,24,31
43,ULM,P006245,P013289,13.117,-6,29,35
43,ULM,P006245,P013290,17.867,-8,36,44
43,ULM,P006997,P010726,6.117,-15,8,23
43,ULM,P006997,P011391,6.067,-16,8,24
43,ULM,P006997,P012077,11.517,-22,21,43
43,ULM,P006997,P012602,4.55,-15,3,18
43,ULM,P006997,P013289,9.867,-17,16,33
43,ULM,P006997,P013290,13.384,-28,21,49
43,ULM,P007952,P010726,3.483,-7,8,15
43,ULM,P007952,P011391,12.366,-9,32,41
43,ULM,P007952,P012077,11.916,-11,28,39
43,ULM,P007952,P012602,5.383,-2,19,21
43,ULM,P007952,P013290,7.616,-7,13,20
43,ULM,P010726,P011391,13.616,-27,22,49
43,ULM,P010726,P012077,6.466,-10,14,24
43,ULM,P010726,P012172,5.416,-12,4,16
43,ULM,P010726,P012602,9.966,-19,13,32
43,ULM,P010726,P013289,10.333,-15,12,27
43,ULM,P010726,P013290,9.217,-26,12,38
43,ULM,P011391,P012077,22.982,-13,54,67
43,ULM,P011391,P012172,5.416,-12,4,16
43,ULM,P011391,P012602,16.316,-21,33,54
43,ULM,P011391,P013289,11.316,-3,22,25
43,ULM,P011391,P013290,15.583,-16,29,45
43,ULM,P012077,P012602,9.166,-4,25,29
43,ULM,P012077,P013289,12.583,-2,31,33
43,ULM,P012077,P013290,20.966,-20,42,62
43,ULM,P012172,P012602,5.416,-12,4,16
43,ULM,P012172,P013289,5.033,-10,4,14
43,ULM,P012602,P013289,8.166,-12,11,23
43,ULM,P012602,P013290,2.85,-12,0,12
43,ULM,P013289,P013290,14.317,-15,27,42
44,HTA,P001927,P004846,4.583,1,9,8
44,HTA,P001927,P005181,15.684,4,29,25
44,HTA,P001927,P010386,33.65,-3,60,63
44,HTA,P001927,P010550,22.15,-14,35,49
44,HTA,P001927,P011157,24.9,-5,42,47
44,HTA,P001927,P012096,15.633,11,31,20
44,HTA,P001927,P013284,23.6,-2,46,48
44,HTA,P004846,P005181,5.767,-1,13,14
44,HTA,P004846,P010386,3.183,0,6,6
44,HTA,P004846,P010550,6.45,-1,14,15
44,HTA,P004846,P011157,4.583,1,9,8
44,HTA,P004846,P012096,6.867,-2,15,17
44,HTA,P004846,P013284,4.367,-2,10,12
44,HTA,P005181,P010386,14.867,1,26,25
44,HTA,P005181,P010550,8.834,-13,13,26
44,HTA,P005181,P011157,8.65,-2,11,13
44,HTA,P005181,P012096,16.367,11,36,25
44,HTA,P005181,P013284,12.367,0,28,28
44,HTA,P010386,P010550,22.733,-16,35,51
44,HTA,P010386,P011157,23.883,-8,39,47
44,HTA,P010386,P012096,14.433,10,28,18
44,HTA,P010386,P013284,24.183,-4,46,50
44,HTA,P010550,P011157,18.633,-11,29,40
44,HTA,P010550,P012096,7.3,-3,13,16
44,HTA,P010550,P013284,22.3,-14,41,55
44,HTA,P011157,P012096,6.65,4,13,9
44,HTA,P011157,P013284,13.833,-7,25,32
44,HTA,P012096,P013284,13.55,5,28,23
44,TRN,P002387,P005438,2.667,-1,5,6
44,TRN,P002387,P006382,7.883,-2,15,17
44,TRN,P002387,P006724,6.1,-1,9,10
44,TRN,P002387,P012593,5.9,-5,8,13
44,TRN,P002387,P012687,8.617,2,21,19
44,TRN,P002387,P013269,2.734,1,4,3
44,TRN,P002387,P013270,9.9,-1,19,20
44,TRN,P002387,P013271,6.467,-1,15,16
44,TRN,P005438,P006724,2.733,-4,0,4
44,TRN,P005438,P012593,13.983,-2,24,26
44,TRN,P005438,P012687,2.667,-1,5,6
44,TRN,P005438,P013269,12.816,-4,21,25
44,TRN,P005438,P013270,1.5,-3,2,5
44,TRN,P005438,P013271,12.75,-1,26,27
44,TRN,P005438,P013272,12.816,-4,21,25
44,TRN,P006382,P006724,5.533,-6,8,14
44,TRN,P006382,P012593,3.3,-4,3,7
44,TRN,P006382,P012687,3.933,2,12,10
44,TRN,P006382,P013269,1.534,-2,2,4
44,TRN,P006382,P013270,8.7,-4,17,21
44,TRN,P006382,P013271,3.1,2,9,7
44,TRN,P006382,P013272,0.817,-2,2,4
44,TRN,P006724,P012593,6.882,-6,7,13
44,TRN,P006724,P012687,4.433,10,14,4
44,TRN,P006724,P013269,8.183,2,13,11
44,TRN,P006724,P013270,8.983,-2,15,17
44,TRN,P006724,P013272,6.149,-1,10,11
44,TRN,P012593,P012687,7.4,8,19,11
44,TRN,P012593,P013269,20.299,10,43,33
44,TRN,P012593,P013270,7.483,-2,13,15
44,TRN,P012593,P013271,19.25,11,44,33
44,TRN,P012593,P013272,20.299,10,43,33
44,TRN,P012687,P013269,11.633,13,26,13
44,TRN,P012687,P013270,10.833,6,24,18
44,TRN,P012687,P013271,13.8,4,29,25
44,TRN,P012687,P013272,9.616,12,22,10
44,TRN,P013269,P013270,14.117,1,26,25
44,TRN,P013269,P013271,21.916,7,46,39
44,TRN,P013269,P013272,27.432,8,55,47
44,TRN,P013270,P013271,12.233,1,26,25
44,TRN,P013270,P013272,11.383,0,22,22
44,TRN,P013271,P013272,21.216,9,45,36
45,BAH,P003840,P008282,2.983,-8,5,13
45,BAH,P003840,P009601,17.683,7,41,34
45,BAH,P003840,P011192,17.967,11,41,30
45,BAH,P003840,P011201,23.6,15,59,44
45,BAH,P003840,P011821,30.067,36,75,39
45,BAH,P003840,P011823,30.434,21,76,55
45,BAH,P003840,P012405,3.733,1,7,6
45,BAH,P003840,P012711,19.801,9,40,31
45,BAH,P008282,P009601,2.983,-8,5,13
45,BAH,P008282,P011192,1.333,-7,2,9
45,BAH,P008282,P011201,5.716,-8,11,19
45,BAH,P008282,P011821,2.8,-5,4,9
45,BAH,P008282,P011823,6.416,-14,11,25
45,BAH,P008282,P012711,3.433,-6,6,12
45,BAH,P009601,P011192,9.1,9,19,10
45,BAH,P009601,P011201,8.583,-2,22,24
45,BAH,P009601,P011821,14.7,15,36,21
45,BAH,P009601,P011823,11.55,5,31,26
45,BAH,P009601,P012405,3.733,1,7,6
45,BAH,P009601,P012711,2.4,1,3,2
45,BAH,P011192,P011201,5.633,2,16,14
45,BAH,P011192,P011821,15.15,10,35,25
45,BAH,P011192,P011823,17.0,4,43,39
45,BAH,P011192,P012405,0.9,0,0,0
45,BAH,P011192,P012711,10.117,-13,16,29
45,BAH,P011201,P011821,19.2,29,52,23
45,BAH,P011201,P011823,22.5,13,55,42
45,BAH,P011201,P012405,2.833,1,7,6
45,BAH,P011201,P012711,17.267,10,38,28
45,BAH,P011821,P011823,26.734,29,69,40
45,BAH,P011821,P012405,3.733,1,7,6
45,BAH,P011821,P012711,19.084,9,38,29
45,BAH,P011823,P012711,20.834,2,43,41
45,BUD,P004222,P006561,11.466,-5,22,27
45,BUD,P004222,P006566,8.933,5,22,17
45,BUD,P004222,P011150,4.35,-16,0,16
45,BUD,P004222,P011281,4.816,-7,8,15
45,BUD,P004222,P012606,9.183,-8,14,22
45,BUD,P004222,P012630,7.116,11,22,11
45,BUD,P005637,P006566,6.417,-4,8,12
45,BUD,P005637,P008325,19.15,-4,36,40
45,BUD,P005637,P011150,19.15,-4,36,40
45,BUD,P005637,P011281,18.5,-5,34,39
45,BUD,P005637,P012606,4.233,-3,6,9
45,BUD,P005637,P012630,3.367,13,14,1
45,BUD,P005637,P013258,5.783,-9,10,19
45,BUD,P006561,P006566,12.482,3,27,24
45,BUD,P006561,P008325,3.549,-2,5,7
45,BUD,P006561,P011150,6.733,-15,4,19
45,BUD,P006561,P011281,5.149,-6,9,15
45,BUD,P006561,P012606,12.399,-11,18,29
45,BUD,P006561,P012630,8.282,8,23,15
45,BUD,P006566,P008325,15.799,-12,25,37
45,BUD,P006566,P011150,16.45,-15,24,39
45,BUD,P006566,P011281,14.216,-7,27,34
45,BUD,P006566,P012606,16.349,-6,32,38
45,BUD,P006566,P012630,8.282,8,23,15
45,BUD,P008325,P011150,27.366,-9,52,61
45,BUD,P008325,P011281,24.666,-10,47,57
45,BUD,P008325,P012606,13.282,-12,22,34
45,BUD,P008325,P012630,4.533,10,15,5
45,BUD,P008325,P013258,5.783,-9,10,19
45,BUD,P011150,P011281,26.866,-21,46,67
45,BUD,P011150,P012606,16.799,-24,22,46
45,BUD,P011150,P012630,3.367,13,14,1
45,BUD,P011150,P013258,5.783,-9,10,19
45,BUD,P011281,P012606,11.949,-20,16,36
45,BUD,P011281,P012630,5.983,17,23,6
45,BUD,P011281,P013258,5.783,-9,10,19
45,BUD,P012606,P012630,5.666,4,14,10
46,CLU,P002820,P004862,4.317,-6,4,10
46,CLU,P002820,P005714,10.416,1,21,20
46,CLU,P002820,P006618,11.083,-1,21,22
46,CLU,P002820,P010651,6.9,-8,7,15
46,CLU,P002820,P011797,7.1,2,11,9
46,CLU,P002820,P011801,1.75,2,7,5
46,CLU,P002820,P012620,2.4,-3,4,7
46,CLU,P002820,P012698,15.5,-6,26,32
46,CLU,P002820,P013302,7.366,3,10,7
46,CLU,P002820,P013304,7.5,-4,9,13
46,CLU,P004862,P005714,1.133,1,2,1
46,CLU,P004862,P006618,6.1,-4,8,12
46,CLU,P004862,P010651,17.051,-2,37,39
46,CLU,P004862,P011797,16.401,9,39,30
46,CLU,P004862,P012698,8.034,0,15,15
46,CLU,P004862,P013302,11.417,1,26,25
46,CLU,P004862,P013304,13.351,5,33,28
46,CLU,P005714,P006618,10.416,1,21,20
46,CLU,P005714,P011797,1.25,-2,2,4
46,CLU,P005714,P011801,1.75,2,7,5
46,CLU,P005714,P012620,2.4,-3,4,7
46,CLU,P005714,P012698,10.416,1,21,20
46,CLU,P005714,P013302,3.883,3,6,3
46,CLU,P006618,P010651,4.967,-5,6,11
46,CLU,P006618,P011797,5.55,-5,8,13
46,CLU,P006618,P011801,1.75,2,7,5
46,CLU,P006618,P012620,2.4,-3,4,7
46,CLU,P006618,P012698,12.683,-4,23,27
46,CLU,P006618,P013302,6.583,3,10,7
46,CLU,P010651,P011797,26.0,15,58,43
46,CLU,P010651,P012698,13.817,3,28,25
46,CLU,P010651,P013302,21.183,7,44,37
46,CLU,P010651,P013304,23.35,10,52,42
46,CLU,P011797,P012698,14.017,13,32,19
46,CLU,P011797,P013302,20.783,8,44,36
46,CLU,P011797,P013304,22.967,20,54,34
46,CLU,P011801,P012698,1.75,2,7,5
46,CLU,P012620,P012698,2.4,-3,4,7
46,CLU,P012698,P013302,10.566,8,20,12
46,CLU,P012698,P013304,12.817,10,28,18
46,CLU,P013302,P013304,18.483,7,40,33
46,JER,P006625,P008912,2.166,-12,0,12
46,JER,P006625,P010431,6.849,6,18,12
46,JER,P006625,P010587,14.783,3,31,28
46,JER,P006625,P011970,12.299,-13,23,36
46,JER,P006625,P013276,10.115,-3,22,25
46,JER,P006625,P013277,14.916,-8,27,35
46,JER,P006625,P013278,11.25,-5,19,24
46,JER,P006625,P013279,3.983,2,10,8
46,JER,P006625,P013281,4.167,2,6,4
46,JER,P008912,P010431,6.666,4,16,12
46,JER,P008912,P010587,12.633,3,20,17
46,JER,P008912,P011970,14.499,-7,26,33
46,JER,P008912,P013276,12.233,-10,21,31
46,JER,P008912,P013277,8.95,-9,11,20
46,JER,P008912,P013278,8.833,2,16,14
46,JER,P008912,P013279,8.649,0,17,17
46,JER,P008912,P013281,0.767,1,1,0
46,JER,P010431,P010587,11.049,-5,17,22
46,JER,P010431,P011970,8.832,3,21,18
46,JER,P010431,P013276,14.748,1,33,32
46,JER,P010431,P013277,5.483,5,11,6
46,JER,P010431,P013278,5.116,4,9,5
46,JER,P010431,P013279,8.049,-2,19,21
46,JER,P010587,P011970,18.416,-6,31,37
46,JER,P010587,P013276,16.249,-7,25,32
46,JER,P010587,P013277,18.217,4,33,29
46,JER,P010587,P013278,14.65,7,28,21
46,JER,P010587,P013279,12.082,-4,20,24
46,JER,P010587,P013281,4.317,5,7,2
46,JER,P011970,P013276,18.215,-8,33,41
46,JER,P011970,P013277,18.1,-15,31,46
46,JER,P011970,P013278,12.75,-8,25,33
46,JER,P011970,P013279,7.532,0,14,14
46,JER,P011970,P013281,0.617,-2,0,2
46,JER,P013276,P013277,9.083,-12,13,25
46,JER,P013276,P013278,4.133,-2,7,9
46,JER,P013276,P013279,11.949,1,26,25
46,JER,P013276,P013281,0.067,0,0,0
46,JER,P013277,P013278,14.801,1,28,27
46,JER,P013277,P013279,0.683,0,0,0
46,JER,P013277,P013281,4.167,2,6,4
46,JER,P013278,P013279,1.283,-2,1,3
46,JER,P013278,P013281,4.184,3,7,4
46,JER,P013279,P013281,1.45,1,1,0
47,HAM,P003242,P006420,4.05,1,8,7
47,HAM,P003242,P011256,13.217,-7,23,30
47,HAM,P003242,P012695,0.4,-2,0,2
47,HAM,P003242,P013308,15.85,-17,24,41
47,HAM,P003242,P013309,5.95,-7,7,14
47,HAM,P003242,P013311,1.283,-1,2,3
47,HAM,P003242,P013312,14.1,-17,20,37
47,HAM,P003242,P013313,17.75,-14,28,42
47,HAM,P006420,P010070,11.618,5,21,16
47,HAM,P006420,P011256,10.401,7,19,12
47,HAM,P006420,P012695,8.451,3,16,13
47,HAM,P006420,P013308,7.25,-9,8,17
47,HAM,P006420,P013309,8.418,9,20,11
47,HAM,P006420,P013311,5.267,5,11,6
47,HAM,P006420,P013313,7.217,3,13,10
47,HAM,P010070,P011256,6.668,6,11,5
47,HAM,P010070,P012695,8.768,3,16,13
47,HAM,P010070,P013308,4.217,-8,2,10
47,HAM,P010070,P013309,7.401,7,18,11
47,HAM,P010070,P013311,5.584,5,11,6
47,HAM,P010070,P013312,0.317,0,0,0
47,HAM,P010070,P013313,3.167,2,5,3
47,HAM,P011256,P012695,3.501,4,6,2
47,HAM,P011256,P013308,20.717,-10,33,43
47,HAM,P011256,P013309,4.501,10,10,0
47,HAM,P011256,P013310,4.383,3,11,8
47,HAM,P011256,P013311,1.084,2,2,0
47,HAM,P011256,P013312,14.884,-5,26,31
47,HAM,P011256,P013313,21.784,-2,39,41
47,HAM,P012695,P013308,2.567,-5,2,7
47,HAM,P012695,P013309,8.184,-4,15,19
47,HAM,P012695,P013310,1.9,-4,2,6
47,HAM,P012695,P013311,7.884,-1,13,14
47,HAM,P012695,P013312,2.617,-6,2,8
47,HAM,P013308,P013309,7.401,-12,8,20
47,HAM,P013308,P013310,5.267,3,13,10
47,HAM,P013308,P013311,0.75,0,2,2
47,HAM,P013308,P013312,19.851,-13,33,46
47,HAM,P013308,P013313,24.534,-17,39,56
47,HAM,P013309,P013310,4.1,-4,6,10
47,HAM,P013309,P013311,9.083,-2,17,19
47,HAM,P013309,P013312,10.8,-13,13,26
47,HAM,P013309,P013313,11.034,0,18,18
47,HAM,P013310,P013311,2.55,-4,4,8
47,HAM,P013310,P013312,8.15,-1,17,18
47,HAM,P013310,P013313,6.25,3,15,12
47,HAM,P013311,P013312,4.9,-5,8,13
47,HAM,P013311,P013313,2.283,1,6,5
47,HAM,P013312,P013313,21.717,-12,37,49
47,VNC,P003759,P005177,8.3,-1,11,12
47,VNC,P003759,P005404,10.084,-15,14,29
47,VNC,P003759,P008052,8.568,-2,10,12
47,VNC,P003759,P009400,16.468,4,30,26
47,VNC,P003759,P011928,13.433,-6,26,32
47,VNC,P003759,P012800,13.417,-4,25,29
47,VNC,P003759,P013305,17.734,-8,28,36
47,VNC,P005177,P005404,2.083,2,6,4
47,VNC,P005177,P008052,5.817,3,8,5
47,VNC,P005177,P009400,6.617,4,11,7
47,VNC,P005177,P011928,4.716,1,11,10
47,VNC,P005177,P012796,2.233,5,8,3
47,VNC,P005177,P012800,5.633,-2,8,10
47,VNC,P005177,P013305,6.733,4,13,9
47,VNC,P005404,P008052,6.133,2,11,9
47,VNC,P005404,P009400,10.667,1,21,20
47,VNC,P005404,P011928,18.801,-2,37,39
47,VNC,P005404,P012796,14.85,15,34,19
47,VNC,P005404,P012800,18.767,6,40,34
47,VNC,P005404,P013305,18.351,-9,29,38
47,VNC,P008052,P009400,12.784,5,21,16
47,VNC,P008052,P012796,5.499,8,14,6
47,VNC,P008052,P012800,9.15,7,19,12
47,VNC,P008052,P013305,8.317,1,13,12
47,VNC,P009400,P011928,9.034,8,24,16
47,VNC,P009400,P012796,5.35,9,15,6
47,VNC,P009400,P012800,12.834,15,32,17
47,VNC,P009400,P013305,13.518,6,26,20
47,VNC,P011928,P012796,12.501,12,30,18
47,VNC,P011928,P012800,21.867,7,48,41
47,VNC,P011928,P013305,23.384,4,48,44
47,VNC,P012796,P012800,17.6,18,42,24
47,VNC,P012796,P013305,13.967,13,33,20
47,VNC,P012800,P013305,24.8,9,54,45
48,PAM,P004548,P005356,5.05,-4,13,17
48,PAM,P004548,P006643,6.7,-5,17,22
48,PAM,P004548,P007527,5.35,1,15,14
48,PAM,P004548,P009864,4.033,0,11,11
48,PAM,P004548,P010393,5.467,-7,13,20
48,PAM,P004548,P010444,3.117,-4,9,13
48,PAM,P004548,P011980,4.933,4,15,11
48,PAM,P004548,P011982,3.7,2,11,9
48,PAM,P004548,P012738,3.25,1,8,7
48,PAM,P004863,P005356,7.034,5,19,14
48,PAM,P004863,P006643,9.384,10,24,14
48,PAM,P004863,P007527,5.984,4,13,9
48,PAM,P004863,P009864,4.751,1,9,8
48,PAM,P004863,P010393,9.318,5,20,15
48,PAM,P004863,P010444,3.167,-1,9,10
48,PAM,P004863,P011980,3.7,4,12,8
48,PAM,P004863,P011982,3.634,-1,8,9
48,PAM,P004863,P012738,5.1,9,14,5
48,PAM,P005356,P006643,11.834,1,31,30
48,PAM,P005356,P009864,1.4,5,5,0
48,PAM,P005356,P010393,5.651,-7,12,19
48,PAM,P005356,P010444,9.034,2,25,23
48,PAM,P005356,P010750,7.433,9,19,10
48,PAM,P005356,P011980,13.866,17,39,22
48,PAM,P005356,P011982,7.683,9,20,11
48,PAM,P005356,P012738,9.083,3,21,18
48,PAM,P006643,P007527,7.95,0,18,18
48,PAM,P006643,P009864,5.95,1,14,13
48,PAM,P006643,P010393,12.834,-3,30,33
48,PAM,P006643,P010444,3.967,-10,9,19
48,PAM,P006643,P010750,3.7,-4,8,12
48,PAM,P006643,P011980,6.95,4,19,15
48,PAM,P006643,P012738,9.867,10,26,16
48,PAM,P007527,P009864,12.1,-4,28,32
48,PAM,P007527,P010393,15.717,8,38,30
48,PAM,P007527,P010444,6.534,1,15,14
48,PAM,P007527,P010750,9.15,-1,22,23
48,PAM,P007527,P011980,4.767,-4,12,16
48,PAM,P007527,P011982,12.534,4,32,28
48,PAM,P007527,P012738,1.85,7,7,0
48,PAM,P009864,P010393,10.951,3,26,23
48,PAM,P009864,P010750,4.716,0,13,13
48,PAM,P009864,P011980,2.549,-2,7,9
48,PAM,P009864,P011982,7.55,0,19,19
48,PAM,P010393,P010444,6.733,-4,17,21
48,PAM,P010393,P010750,6.583,3,17,14
48,PAM,P010393,P011982,8.534,4,20,16
48,PAM,P010393,P012738,3.684,2,7,5
48,PAM,P010444,P010750,9.284,8,22,14
48,PAM,P010444,P011980,8.835,7,23,16
48,PAM,P010444,P011982,11.601,13,31,18
48,PAM,P010750,P011980,10.0,5,24,19
48,PAM,P010750,P011982,12.883,12,33,21
48,PAM,P010750,P012738,2.583,0,6,6
48,PAM,P011980,P011982,11.683,9,32,23
48,PAM,P011980,P012738,7.249,8,21,13
48,PAM,P011982,P012738,1.066,0,2,2
48,TTK,P004056,P004619,4.033,-5,7,12
48,TTK,P004056,P007917,3.433,-6,4,10
48,TTK,P004056,P009025,5.616,-4,11,15
48,TTK,P004056,P011935,2.183,2,7,5
48,TTK,P004056,P011973,1.583,1,4,3
48,TTK,P004056,P012259,5.616,-4,11,15
48,TTK,P004619,P006598,1.55,-1,3,4
48,TTK,P004619,P007917,3.4,-8,3,11
48,TTK,P004619,P009025,5.583,-6,10,16
48,TTK,P004619,P011935,2.183,2,7,5
48,TTK,P004619,P012259,4.033,-5,7,12
48,TTK,P004619,P013300,1.55,-1,3,4
48,TTK,P006598,P007917,4.35,-2,7,9
48,TTK,P006598,P009025,13.684,-9,22,31
48,TTK,P006598,P010465,4.85,-3,9,12
48,TTK,P006598,P011935,2.367,-2,2,4
48,TTK,P006598,P011973,12.134,-8,19,27
48,TTK,P006598,P012259,4.85,-3,9,12
48,TTK,P006598,P012415,2.117,-2,4,6
48,TTK,P006598,P013300,8.834,-6,13,19
48,TTK,P007917,P009025,12.333,-13,20,33
48,TTK,P007917,P010465,2.45,-1,7,8
48,TTK,P007917,P010811,0.383,-3,0,3
48,TTK,P007917,P011935,2.1,-4,2,6
48,TTK,P007917,P011973,7.216,-4,15,19
48,TTK,P007917,P012259,3.433,-6,4,10
48,TTK,P007917,P012415,1.717,-1,2,3
48,TTK,P007917,P013300,8.517,-4,16,20
48,TTK,P009025,P010465,19.95,11,58,47
48,TTK,P009025,P010811,0.383,-3,0,3
48,TTK,P009025,P011935,15.217,6,42,36
48,TTK,P009025,P011973,28.434,-2,66,68
48,TTK,P009025,P012259,11.283,-9,20,29
48,TTK,P009025,P012415,11.717,6,27,21
48,TTK,P009025,P013300,25.068,3,60,57
48,TTK,P010465,P011935,10.433,3,34,31
48,TTK,P010465,P011973,21.05,-2,55,57
48,TTK,P010465,P012259,7.533,-12,12,24
48,TTK,P010465,P012415,7.883,9,21,12
48,TTK,P010465,P013300,16.383,3,48,45
48,TTK,P010811,P011935,0.383,-3,0,3
48,TTK,P010811,P011973,0.383,-3,0,3
48,TTK,P011935,P011973,12.417,-8,30,38
48,TTK,P011935,P012259,5.683,-9,10,19
48,TTK,P011935,P012415,4.7,5,12,7
48,TTK,P011935,P013300,13.934,-4,34,38
48,TTK,P011973,P012259,9.933,-13,16,29
48,TTK,P011973,P012415,8.417,3,19,16
48,TTK,P011973,P013300,22.901,-8,52,60
48,TTK,P012259,P013300,3.5,-11,3,14
48,TTK,P012415,P013300,10.317,4,23,19
50,ARI,P003240,P004292,16.833,-15,26,41
50,ARI,P003240,P013248,0.583,-2,2,4
50,ARI,P003240,P013249,6.4,-6,7,13
50,ARI,P003240,P013250,13.617,-8,18,26
50,ARI,P003240,P013251,5.5,-4,2,6
50,ARI,P003240,P013252,10.783,-11,15,26
50,ARI,P003240,P013253,14.283,-13,26,39
50,ARI,P003240,P013355,8.817,-4,11,15
50,ARI,P003240,P013356,0.75,1,3,2
50,ARI,P003240,P013393,1.466,-5,2,7
50,ARI,P003240,P013395,1.7,-1,0,1
50,ARI,P004292,P013248,1.55,0,4,4
50,ARI,P004292,P013249,18.684,6,44,38
50,ARI,P004292,P013250,22.884,3,51,48
50,ARI,P004292,P013251,8.434,-3,11,14
50,ARI,P004292,P013252,14.183,-16,19,35
50,ARI,P004292,P013253,21.233,-1,50,51
50,ARI,P004292,P013355,12.817,11,35,24
50,ARI,P004292,P013356,0.75,1,3,2
50,ARI,P004292,P013393,4.3,-2,9,11
50,ARI,P013248,P013249,4.55,2,9,7
50,ARI,P013248,P013250,3.783,0,7,7
50,ARI,P013248,P013251,4.75,2,9,7
50,ARI,P013248,P013253,0.783,-2,2,4
50,ARI,P013248,P013356,3.783,0,7,7
50,ARI,P013248,P013393,1.55,0,4,4
50,ARI,P013249,P013250,21.183,7,47,40
50,ARI,P013249,P013251,14.517,-5,21,26
50,ARI,P013249,P013252,8.8,-11,9,20
50,ARI,P013249,P013253,12.717,8,34,26
50,ARI,P013249,P013355,10.8,12,31,19
50,ARI,P013249,P013356,3.783,0,7,7
50,ARI,P013249,P013393,2.634,3,7,4
50,ARI,P013250,P013251,15.667,-6,21,27
50,ARI,P013250,P013252,11.767,-10,17,27
50,ARI,P013250,P013253,18.567,5,45,40
50,ARI,P013250,P013355,15.05,9,34,25
50,ARI,P013250,P013356,3.783,0,7,7
50,ARI,P013250,P013393,1.867,1,5,4
50,ARI,P013250,P013395,1.7,-1,0,1
50,ARI,P013251,P013252,7.233,-8,7,15
50,ARI,P013251,P013253,3.483,-1,5,6
50,ARI,P013251,P013355,6.034,0,7,7
50,ARI,P013251,P013356,3.783,0,7,7
50,ARI,P013251,P013393,0.967,2,2,0
50,ARI,P013251,P013395,1.7,-1,0,1
50,ARI,P013252,P013253,12.133,-10,18,28
50,ARI,P013252,P013356,0.75,1,3,2
50,ARI,P013252,P013393,0.883,-3,0,3
50,ARI,P013253,P013355,9.45,9,30,21
50,ARI,P013253,P013356,0.75,1,3,2
50,ARI,P013253,P013393,3.533,-4,7,11
50,ARI,P013355,P013395,1.7,-1,0,1
50,LJU,P003452,P003703,24.45,7,51,44
50,LJU,P003452,P009392,15.15,14,38,24
50,LJU,P003452,P009431,2.55,-1,6,7
50,LJU,P003452,P009753,9.067,-7,20,27
50,LJU,P003452,P011261,2.15,-6,2,8
50,LJU,P003452,P012042,22.584,10,52,42
50,LJU,P003452,P012700,25.0,15,55,40
50,LJU,P003452,P012996,12.516,4,21,17
50,LJU,P003452,P013260,12.634,-5,31,36
50,LJU,P003452,P013262,2.367,-7,4,11
50,LJU,P003703,P009392,9.517,16,23,7
50,LJU,P003703,P009431,3.1,-2,8,10
50,LJU,P003703,P009753,6.867,-1,12,13
50,LJU,P003703,P011261,4.984,1,5,4
50,LJU,P003703,P012042,20.634,5,37,32
50,LJU,P003703,P012700,24.567,14,46,32
50,LJU,P003703,P012996,12.883,4,21,17
50,LJU,P003703,P013260,5.517,-5,14,19
50,LJU,P003703,P013262,2.367,-7,4,11
50,LJU,P003703,P013263,1.85,0,3,3
50,LJU,P009392,P009431,2.483,-2,5,7
50,LJU,P009392,P009753,8.967,-2,17,19
50,LJU,P009392,P011261,3.317,-2,4,6
50,LJU,P009392,P012042,9.384,16,28,12
50,LJU,P009392,P012700,16.75,16,40,24
50,LJU,P009392,P012996,2.933,5,7,2
50,LJU,P009392,P013260,11.267,1,26,25
50,LJU,P009392,P013263,0.3,-2,0,2
50,LJU,P009431,P009753,4.733,-1,11,12
50,LJU,P009431,P012700,3.033,-3,7,10
50,LJU,P009431,P013260,5.583,-4,13,17
50,LJU,P009431,P013263,0.85,-3,2,5
50,LJU,P009753,P011261,4.85,-3,6,9
50,LJU,P009753,P012042,3.751,2,9,7
50,LJU,P009753,P012700,9.384,0,18,18
50,LJU,P009753,P013260,10.117,-4,23,27
50,LJU,P011261,P012042,2.467,1,1,0
50,LJU,P011261,P012700,5.301,3,7,4
50,LJU,P011261,P012996,0.367,0,0,0
50,LJU,P011261,P013260,1.6,-3,2,5
50,LJU,P011261,P013263,1.3,1,1,0
50,LJU,P012042,P012700,22.184,14,44,30
50,LJU,P012042,P012996,9.95,-1,14,15
50,LJU,P012042,P013260,7.251,3,22,19
50,LJU,P012042,P013262,2.367,-7,4,11
50,LJU,P012042,P013263,1.3,1,1,0
50,LJU,P012700,P012996,12.883,4,21,17
50,LJU,P012700,P013260,9.217,3,25,22
50,LJU,P012700,P013262,1.067,0,2,2
50,LJU,P012700,P013263,2.15,-2,3,5
50,LJU,P013260,P013262,1.3,-7,2,9
50,LJU,P013260,P013263,0.85,-3,2,5
51,BAH,P003840,P004172,12.8,19,43,24
51,BAH,P003840,P005348,0.017,0,0,0
51,BAH,P003840,P009601,21.85,15,51,36
51,BAH,P003840,P011192,20.517,0,41,41
51,BAH,P003840,P011201,22.566,7,42,35
51,BAH,P003840,P011823,19.733,-3,42,45
51,BAH,P003840,P012405,3.367,1,3,2
51,BAH,P003840,P012711,10.95,13,30,17
51,BAH,P004172,P005348,9.117,-4,11,15
51,BAH,P004172,P009601,13.833,15,36,21
51,BAH,P004172,P011192,13.134,9,36,27
51,BAH,P004172,P011201,13.683,12,28,16
51,BAH,P004172,P011823,17.484,5,41,36
51,BAH,P004172,P012711,17.417,16,41,25
51,BAH,P005348,P008278,0.483,0,0,0
51,BAH,P005348,P008282,0.483,0,0,0
51,BAH,P005348,P009601,3.1,-5,0,5
51,BAH,P005348,P011192,5.3,0,10,10
51,BAH,P005348,P011201,3.8,-4,1,5
51,BAH,P005348,P011823,7.567,-2,11,13
51,BAH,P005348,P012711,8.533,-1,11,12
51,BAH,P008278,P008282,0.483,0,0,0
51,BAH,P008278,P011823,0.483,0,0,0
51,BAH,P008278,P012711,0.483,0,0,0
51,BAH,P008282,P011823,0.483,0,0,0
51,BAH,P008282,P012711,0.483,0,0,0
51,BAH,P009601,P011192,17.033,2,31,29
51,BAH,P009601,P011201,22.583,6,38,32
51,BAH,P009601,P011823,15.883,-3,31,34
51,BAH,P009601,P012405,3.367,1,3,2
51,BAH,P009601,P012711,6.883,13,18,5
51,BAH,P011192,P011201,17.617,-3,25,28
51,BAH,P011192,P011823,24.634,2,53,51
51,BAH,P011192,P012405,3.367,1,3,2
51,BAH,P011192,P012711,11.534,1,25,24
51,BAH,P011201,P011823,18.866,-8,27,35
51,BAH,P011201,P012405,3.367,1,3,2
51,BAH,P011201,P012711,12.85,13,28,15
51,BAH,P011823,P012711,13.867,1,27,26
51,TSO,P003885,P008790,7.4,7,17,10
51,TSO,P003885,P009649,16.851,1,27,26
51,TSO,P003885,P012019,6.517,2,12,10
51,TSO,P003885,P013292,2.716,-3,3,6
51,TSO,P003885,P013293,2.017,0,3,3
51,TSO,P003885,P013295,13.817,-5,20,25
51,TSO,P003885,P013297,11.701,-8,15,23
51,TSO,P003885,P013298,19.117,-2,31,33
51,TSO,P008790,P009649,13.735,7,27,20
51,TSO,P008790,P012019,13.851,0,26,26
51,TSO,P008790,P013292,5.267,5,11,6
51,TSO,P008790,P013293,3.367,2,7,5
51,TSO,P008790,P013295,7.551,5,13,8
51,TSO,P008790,P013297,9.251,-4,16,20
51,TSO,P008790,P013298,15.118,6,31,25
51,TSO,P009649,P012019,13.568,-5,26,31
51,TSO,P009649,P013292,3.567,4,6,2
51,TSO,P009649,P013293,5.384,-3,9,12
51,TSO,P009649,P013295,26.601,-13,40,53
51,TSO,P009649,P013297,26.235,-16,43,59
51,TSO,P009649,P013298,28.935,-7,50,57
51,TSO,P012019,P013292,3.4,1,7,6
51,TSO,P012019,P013293,4.85,-3,6,9
51,TSO,P012019,P013295,6.933,-11,9,20
51,TSO,P012019,P013297,12.617,-9,23,32
51,TSO,P012019,P013298,13.8,-7,27,34
51,TSO,P013292,P013293,0.85,2,2,0
51,TSO,P013292,P013295,2.8,3,4,1
51,TSO,P013292,P013297,1.617,3,4,1
51,TSO,P013292,P013298,4.583,1,7,6
51,TSO,P013293,P013295,6.217,-6,10,16
51,TSO,P013293,P013297,8.584,-9,12,21
51,TSO,P013293,P013298,8.267,-3,15,18
51,TSO,P013295,P013297,23.084,-23,32,55
51,TSO,P013295,P013298,25.201,-10,40,50
51,TSO,P013297,P013298,24.651,-22,39,61
52,BUD,P004222,P005637,2.083,2,2,0
52,BUD,P004222,P006561,10.366,-20,17,37
52,BUD,P004222,P006566,5.466,3,10,7
52,BUD,P004222,P010307,6.799,-8,13,21
52,BUD,P004222,P011150,7.833,-12,12,24
52,BUD,P004222,P011281,11.166,-16,18,34
52,BUD,P004222,P012606,3.566,-1,6,7
52,BUD,P004222,P012630,10.466,-14,16,30
52,BUD,P004222,P013258,1.183,-2,2,4
52,BUD,P005637,P006561,6.983,2,13,11
52,BUD,P005637,P006566,12.783,0,25,25
52,BUD,P005637,P008325,15.95,-4,33,37
52,BUD,P005637,P010307,4.583,-1,7,8
52,BUD,P005637,P011150,20.533,-5,40,45
52,BUD,P005637,P011281,9.033,-4,13,17
52,BUD,P005637,P012606,16.433,-4,33,37
52,BUD,P005637,P012630,2.083,2,2,0
52,BUD,P006561,P006566,1.1,0,3,3
52,BUD,P006561,P008325,6.633,5,14,9
52,BUD,P006561,P010307,13.332,-8,23,31
52,BUD,P006561,P011150,12.533,-11,20,31
52,BUD,P006561,P011281,18.382,-17,31,48
52,BUD,P006561,P012606,3.2,1,7,6
52,BUD,P006561,P012630,8.383,-16,14,30
52,BUD,P006561,P013258,5.416,0,10,10
52,BUD,P006566,P008325,11.2,-2,23,25
52,BUD,P006566,P010307,2.783,1,5,4
52,BUD,P006566,P011150,13.483,-1,28,29
52,BUD,P006566,P011281,2.7,2,5,3
52,BUD,P006566,P012606,13.966,-1,28,29
52,BUD,P006566,P012630,3.183,2,5,3
52,BUD,P008325,P010307,4.733,2,8,6
52,BUD,P008325,P011150,16.45,-4,33,37
52,BUD,P008325,P011281,7.083,-3,12,15
52,BUD,P008325,P012606,16.45,-4,33,37
52,BUD,P008325,P013258,4.233,2,8,6
52,BUD,P010307,P011150,8.166,-2,13,15
52,BUD,P010307,P011281,12.532,-6,22,28
52,BUD,P010307,P012606,3.583,-1,6,7
52,BUD,P010307,P012630,2.533,-5,5,10
52,BUD,P010307,P013258,5.416,0,10,10
52,BUD,P011150,P011281,12.183,-17,17,34
52,BUD,P011150,P012606,19.533,-5,39,44
52,BUD,P011150,P012630,4.75,-11,6,17
52,BUD,P011281,P012606,2.85,-5,4,9
52,BUD,P011281,P012630,9.983,-14,16,30
52,BUD,P011281,P013258,5.416,0,10,10
52,BUD,P012606,P012630,0.483,0,0,0
52,HTA,P001927,P004846,10.1,8,24,16
52,HTA,P001927,P010386,17.434,1,38,37
52,HTA,P001927,P010550,8.967,-1,20,21
52,HTA,P001927,P011157,16.151,-1,35,36
52,HTA,P001927,P011386,0.517,-4,0,4
52,HTA,P001927,P012096,1.283,2,3,1
52,HTA,P001927,P013284,15.284,-1,32,33
52,HTA,P004846,P005181,10.033,13,26,13
52,HTA,P004846,P009877,4.917,6,13,7
52,HTA,P004846,P010386,11.45,10,29,19
52,HTA,P004846,P010550,2.183,4,8,4
52,HTA,P004846,P011157,13.0,13,34,21
52,HTA,P004846,P011386,10.583,15,31,16
52,HTA,P004846,P012096,9.683,13,28,15
52,HTA,P004846,P013284,12.383,10,27,17
52,HTA,P005181,P009877,5.484,6,13,7
52,HTA,P005181,P010386,5.2,-3,9,12
52,HTA,P005181,P010550,9.267,0,17,17
52,HTA,P005181,P011157,8.467,10,21,11
52,HTA,P005181,P011386,18.9,13,43,30
52,HTA,P005181,P012096,12.433,6,29,23
52,HTA,P005181,P013284,7.416,7,14,7
52,HTA,P009877,P010550,2.884,4,6,2
52,HTA,P009877,P011157,1.584,4,4,0
52,HTA,P009877,P011386,7.801,10,19,9
52,HTA,P009877,P012096,4.917,6,13,7
52,HTA,P009877,P013282,1.3,0,2,2
52,HTA,P009877,P013284,2.317,4,6,2
52,HTA,P010386,P010550,13.8,-2,31,33
52,HTA,P010386,P011157,16.151,-1,35,36
52,HTA,P010386,P011386,6.267,-5,14,19
52,HTA,P010386,P012096,7.433,1,17,16
52,HTA,P010386,P013284,16.601,-1,35,36
52,HTA,P010550,P011157,14.268,6,32,26
52,HTA,P010550,P011386,11.617,6,25,19
52,HTA,P010550,P012096,5.016,-1,11,12
52,HTA,P010550,P013282,1.3,0,2,2
52,HTA,P010550,P013284,13.034,4,28,24
52,HTA,P011157,P011386,10.001,10,25,15
52,HTA,P011157,P012096,1.6,3,7,4
52,HTA,P011157,P013284,21.318,8,47,39
52,HTA,P011386,P012096,12.983,8,34,26
52,HTA,P011386,P013282,1.3,0,2,2
52,HTA,P011386,P013284,10.767,7,23,16
52,HTA,P012096,P013284,3.316,2,6,4
52,HTA,P013282,P013284,1.3,0,2,2
53,TRN,P002387,P005438,5.35,10,17,7
53,TRN,P002387,P006382,11.55,9,34,25
53,TRN,P002387,P006724,15.35,3,41,38
53,TRN,P002387,P012593,6.15,0,13,13
53,TRN,P002387,P012687,11.067,-6,26,32
53,TRN,P002387,P013269,3.3,-6,9,15
53,TRN,P002387,P013270,17.684,-1,45,46
53,TRN,P002387,P013271,2.75,-1,7,8
53,TRN,P002387,P013272,0.267,0,0,0
53,TRN,P005438,P006382,4.917,9,14,5
53,TRN,P005438,P006724,5.234,6,15,9
53,TRN,P005438,P012593,11.3,-11,13,24
53,TRN,P005438,P012687,1.55,1,3,2
53,TRN,P005438,P013269,11.967,-16,12,28
53,TRN,P005438,P013270,7.134,5,16,11
53,TRN,P005438,P013271,13.2,-12,14,26
53,TRN,P005438,P013272,13.084,-16,12,28
53,TRN,P006382,P006724,10.817,7,32,25
53,TRN,P006382,P012593,2.55,4,8,4
53,TRN,P006382,P012687,4.517,1,12,11
53,TRN,P006382,P013269,0.683,-5,0,5
53,TRN,P006382,P013270,12.667,9,34,25
53,TRN,P006382,P013271,1.85,2,2,0
53,TRN,P006382,P013272,1.117,0,0,0
53,TRN,P006724,P012593,6.5,-2,13,15
53,TRN,P006724,P012687,10.383,-7,21,28
53,TRN,P006724,P013269,2.966,-9,4,13
53,TRN,P006724,P013270,16.0,-4,38,42
53,TRN,P006724,P013272,1.95,-6,0,6
53,TRN,P012593,P012687,5.833,7,16,9
53,TRN,P012593,P013269,18.101,2,32,30
53,TRN,P012593,P013270,10.184,2,21,19
53,TRN,P012593,P013271,17.217,4,32,28
53,TRN,P012593,P013272,18.101,2,32,30
53,TRN,P012687,P013269,6.183,6,20,14
53,TRN,P012687,P013270,11.717,-13,23,36
53,TRN,P012687,P013271,4.517,8,16,8
53,TRN,P012687,P013272,3.833,7,11,4
53,TRN,P013269,P013270,10.7,-7,22,29
53,TRN,P013269,P013271,20.584,-1,39,40
53,TRN,P013269,P013272,20.784,-4,34,38
53,TRN,P013270,P013271,9.934,2,20,18
53,TRN,P013270,P013272,8.784,-1,13,14
53,TRN,P013271,P013272,19.684,2,34,32
53,ULM,P005422,P006245,1.75,1,5,4
53,ULM,P005422,P007952,4.767,-3,5,8
53,ULM,P005422,P011391,7.601,-6,6,12
53,ULM,P005422,P011437,21.801,13,48,35
53,ULM,P005422,P012077,15.25,16,41,25
53,ULM,P005422,P013289,17.984,19,48,29
53,ULM,P005422,P013290,18.817,13,45,32
53,ULM,P005422,P013291,6.234,3,14,11
53,ULM,P006245,P006997,4.233,-2,2,4
53,ULM,P006245,P007952,1.833,-5,4,9
53,ULM,P006245,P010726,6.066,-7,6,13
53,ULM,P006245,P011391,4.449,-5,6,11
53,ULM,P006245,P012077,4.967,-4,6,10
53,ULM,P006245,P013289,4.517,-1,11,12
53,ULM,P006245,P013290,8.383,-6,17,23
53,ULM,P006245,P013291,6.134,-3,11,14
53,ULM,P006997,P010726,5.433,-1,5,6
53,ULM,P006997,P011391,3.433,-7,2,9
53,ULM,P006997,P011437,4.067,-6,10,16
53,ULM,P006997,P012077,6.267,-8,10,18
53,ULM,P006997,P013290,4.9,-7,9,16
53,ULM,P006997,P013291,4.867,-1,10,11
53,ULM,P007952,P010726,1.833,-5,4,9
53,ULM,P007952,P011391,6.45,-8,9,17
53,ULM,P007952,P011437,4.767,-3,5,8
53,ULM,P007952,P013290,6.6,-8,9,17
53,ULM,P007952,P013291,0.15,0,0,0
53,ULM,P010726,P011391,4.449,-5,6,11
53,ULM,P010726,P011437,1.2,1,3,2
53,ULM,P010726,P012077,3.4,-1,3,4
53,ULM,P010726,P013290,3.866,-5,6,11
53,ULM,P010726,P013291,2.817,-1,3,4
53,ULM,P011391,P011437,11.051,-13,10,23
53,ULM,P011391,P012077,5.95,-8,5,13
53,ULM,P011391,P013289,4.817,-1,5,6
53,ULM,P011391,P013290,11.383,-19,11,30
53,ULM,P011391,P013291,2.417,0,4,4
53,ULM,P011437,P012077,22.867,13,60,47
53,ULM,P011437,P013289,19.784,21,52,31
53,ULM,P011437,P013290,22.134,6,52,46
53,ULM,P011437,P013291,10.001,8,28,20
53,ULM,P012077,P013289,21.567,17,56,39
53,ULM,P012077,P013290,18.617,7,51,44
53,ULM,P012077,P013291,12.451,4,32,28
53,ULM,P013289,P013290,18.217,17,51,34
53,ULM,P013289,P013291,10.318,8,29,21
53,ULM,P013290,P013291,9.151,2,25,23
54,CAN,P003425,P005005,2.283,-3,2,5
54,CAN,P003425,P006588,28.05,19,59,40
54,CAN,P003425,P008121,30.884,17,63,46
54,CAN,P003425,P008966,20.05,17,42,25
54,CAN,P003425,P010452,0.434,1,2,1
54,CAN,P003425,P011251,19.751,8,41,33
54,CAN,P003425,P012016,4.884,1,9,8
54,CAN,P003425,P012095,11.25,9,22,13
54,CAN,P003425,P012165,5.95,-1,12,13
54,CAN,P005005,P006588,5.584,-5,7,12
54,CAN,P005005,P008121,2.5,-3,2,5
54,CAN,P005005,P008966,3.35,-5,4,9
54,CAN,P005005,P010452,4.133,-7,4,11
54,CAN,P005005,P010623,9.5,-12,11,23
54,CAN,P005005,P011251,5.534,-6,6,12
54,CAN,P005005,P012016,6.15,-7,7,14
54,CAN,P005005,P012095,6.683,-9,7,16
54,CAN,P005005,P012165,2.283,-3,2,5
54,CAN,P006588,P008121,30.4,15,59,44
54,CAN,P006588,P008966,23.1,12,46,34
54,CAN,P006588,P010623,7.5,-9,7,16
54,CAN,P006588,P011251,23.634,2,43,41
54,CAN,P006588,P012016,8.9,-2,12,14
54,CAN,P006588,P012095,12.35,8,23,15
54,CAN,P006588,P012165,3.55,0,8,8
54,CAN,P008121,P008966,20.05,17,42,25
54,CAN,P008121,P010452,2.701,2,6,4
54,CAN,P008121,P010623,4.4,-3,4,7
54,CAN,P008121,P011251,22.101,4,41,37
54,CAN,P008121,P012016,9.284,-2,13,15
54,CAN,P008121,P012095,13.734,10,26,16
54,CAN,P008121,P012165,5.95,-1,12,13
54,CAN,P008966,P010452,0.3,0,0,0
54,CAN,P008966,P010623,3.35,-5,4,9
54,CAN,P008966,P011251,12.984,4,26,22
54,CAN,P008966,P012095,10.416,8,20,12
54,CAN,P010452,P010623,6.4,-6,8,14
54,CAN,P010452,P011251,3.667,-4,4,8
54,CAN,P010452,P012016,6.417,-7,8,15
54,CAN,P010452,P012095,3.167,-1,6,7
54,CAN,P010452,P012165,0.117,2,2,0
54,CAN,P010623,P011251,7.45,-10,6,16
54,CAN,P010623,P012016,10.55,-10,11,21
54,CAN,P010623,P012095,6.45,-5,9,14
54,CAN,P011251,P012016,10.667,-6,13,19
54,CAN,P011251,P012095,0.334,0,0,0
54,CAN,P011251,P012165,3.55,0,8,8
54,CAN,P012016,P012095,4.884,-3,7,10
54,CAN,P012095,P012165,2.4,-1,4,5
54,JOV,P002361,P002507,17.483,-2,30,32
54,JOV,P002361,P004834,9.317,6,20,14
54,JOV,P002361,P005099,11.766,-11,18,29
54,JOV,P002361,P006771,10.934,17,24,7
54,JOV,P002361,P010161,3.466,-3,3,6
54,JOV,P002361,P012740,10.0,7,19,12
54,JOV,P002361,P013285,5.767,-7,11,18
54,JOV,P002361,P013287,17.717,-1,31,32
54,JOV,P002361,PJUG,6.75,2,12,10
54,JOV,P002507,P004834,6.85,7,17,10
54,JOV,P002507,P005099,26.449,-12,41,53
54,JOV,P002507,P006771,11.25,7,21,14
54,JOV,P002507,P010161,10.634,-1,19,20
54,JOV,P002507,P012740,10.834,7,19,12
54,JOV,P002507,P013285,22.3,-8,38,46
54,JOV,P002507,P013287,25.2,-12,38,50
54,JOV,P002507,PJUG,6.0,-2,9,11
54,JOV,P004834,P005099,6.3,4,16,12
54,JOV,P004834,P006771,10.267,15,24,9
54,JOV,P004834,P010161,4.316,-5,5,10
54,JOV,P004834,P012740,7.316,-1,11,12
54,JOV,P004834,P013285,10.95,2,21,19
54,JOV,P004834,P013287,10.75,2,18,16
54,JOV,P004834,PJUG,4.334,6,8,2
54,JOV,P005099,P006771,5.033,-6,5,11
54,JOV,P005099,P010161,9.817,1,20,19
54,JOV,P005099,P012740,5.783,2,7,5
54,JOV,P005099,P013285,22.633,-8,39,47
54,JOV,P005099,P013287,25.632,-20,35,55
54,JOV,P005099,PJUG,3.583,-6,3,9
54,JOV,P006771,P010161,2.083,1,3,2
54,JOV,P006771,P012740,5.35,13,16,3
54,JOV,P006771,P013285,6.183,-1,10,11
54,JOV,P006771,P013287,10.634,9,20,11
54,JOV,P006771,PJUG,6.734,9,13,4
54,JOV,P010161,P012740,3.05,-8,1,9
54,JOV,P010161,P013285,11.467,-4,20,24
54,JOV,P010161,P013287,12.867,-7,21,28
54,JOV,P010161,PJUG,2.1,2,4,2
54,JOV,P012740,P013285,5.4,-5,4,9
54,JOV,P012740,P013287,11.333,4,18,14
54,JOV,P012740,PJUG,0.134,1,1,0
54,JOV,P013285,P013287,21.533,-18,29,47
54,JOV,P013285,PJUG,3.567,1,4,3
54,JOV,P013287,PJUG,8.134,3,14,11
55,BES,P003783,P007914,10.066,16,32,16
55,BES,P003783,P008945,19.133,-4,36,40
55,BES,P003783,P009680,22.383,6,51,45
55,BES,P003783,P010652,15.899,0,32,32
55,BES,P003783,P011379,4.6,-9,3,12
55,BES,P003783,P011924,15.382,-1,31,32
55,BES,P003783,P011927,9.45,11,30,19
55,BES,P003783,P013255,7.751,-3,17,20
55,BES,P007914,P008945,5.966,2,13,11
55,BES,P007914,P009680,9.983,9,29,20
55,BES,P007914,P010652,6.599,-1,12,13
55,BES,P007914,P011924,7.749,-5,12,17
55,BES,P007914,P011927,9.416,12,29,17
55,BES,P007914,P013255,2.217,7,13,6
55,BES,P008945,P009680,22.016,-4,39,43
55,BES,P008945,P010652,18.833,-15,36,51
55,BES,P008945,P011379,9.533,-10,10,20
55,BES,P008945,P011924,24.399,-21,42,63
55,BES,P008945,P011927,15.55,-17,27,44
55,BES,P008945,P013255,16.434,-23,21,44
55,BES,P009680,P010652,15.316,-1,31,32
55,BES,P009680,P011379,5.683,-7,4,11
55,BES,P009680,P011924,19.499,-7,35,42
55,BES,P009680,P011927,6.817,9,23,14
55,BES,P009680,P013255,9.567,-1,20,21
55,BES,P010652,P011924,23.132,-15,44,59
55,BES,P010652,P011927,8.333,-13,14,27
55,BES,P010652,P013255,6.484,-11,11,22
55,BES,P011379,P011924,4.933,-1,7,8
55,BES,P011379,P011927,3.85,-3,6,9
55,BES,P011379,P013255,9.533,-10,10,20
55,BES,P011924,P011927,10.866,-17,16,33
55,BES,P011924,P013255,10.9,-13,17,30
55,BES,P011927,P013255,11.718,-10,27,37
55,WOL,P003212,P005516,5.95,-8,10,18
55,WOL,P003212,P006853,1.75,-1,2,3
55,WOL,P003212,P011248,10.05,-6,21,27
55,WOL,P003212,P012003,2.917,3,9,6
55,WOL,P003212,P012577,10.05,-6,21,27
55,WOL,P003212,P012789,9.483,-6,21,27
55,WOL,P004645,P005516,12.683,17,33,16
55,WOL,P004645,P006853,14.15,10,33,23
55,WOL,P004645,P008186,13.95,10,33,23
55,WOL,P004645,P011248,3.15,-2,5,7
55,WOL,P004645,P012003,15.833,15,38,23
55,WOL,P004645,P012577,1.683,5,5,0
55,WOL,P004645,P012789,1.883,5,5,0
55,WOL,P005516,P006853,14.933,19,41,22
55,WOL,P005516,P008186,16.233,26,48,22
55,WOL,P005516,P011248,12.65,-7,29,36
55,WOL,P005516,P012003,17.133,16,44,28
55,WOL,P005516,P012577,12.65,-7,29,36
55,WOL,P005516,P012789,9.1,-16,14,30
55,WOL,P006853,P008186,19.833,20,52,32
55,WOL,P006853,P011248,12.883,-1,25,26
55,WOL,P006853,P012003,22.133,15,48,33
55,WOL,P006853,P012577,11.416,6,25,19
55,WOL,P006853,P012789,5.166,-4,6,10
55,WOL,P008186,P011248,8.45,10,26,16
55,WOL,P008186,P012003,18.883,25,51,26
55,WOL,P008186,P012577,7.183,17,26,9
55,WOL,P011248,P012003,17.933,5,40,35
55,WOL,P011248,P012577,25.849,5,60,55
55,WOL,P011248,P012789,18.299,-12,34,46
55,WOL,P012003,P012577,16.466,12,40,28
55,WOL,P012003,P012789,11.166,-3,22,25
55,WOL,P012577,P012789,18.099,-12,34,46
56,JER,P006625,P008912,16.252,12,44,32
56,JER,P006625,P009879,6.416,1,15,14
56,JER,P006625,P010431,13.034,3,26,23
56,JER,P006625,P010587,17.517,4,37,33
56,JER,P006625,P011970,19.951,6,47,41
56,JER,P006625,P013277,16.083,15,45,30
56,JER,P006625,P013279,10.084,-2,16,18
56,JER,P006625,P013281,9.267,5,22,17
56,JER,P008912,P009879,5.699,3,14,11
56,JER,P008912,P010431,13.933,1,33,32
56,JER,P008912,P010587,12.549,13,36,23
56,JER,P008912,P011970,13.168,5,41,36
56,JER,P008912,P013277,15.283,16,52,36
56,JER,P008912,P013279,10.417,0,19,19
56,JER,P008912,P013281,8.567,2,21,19
56,JER,P009879,P010431,4.432,6,9,3
56,JER,P009879,P010587,8.432,4,19,15
56,JER,P009879,P011970,7.299,2,21,19
56,JER,P009879,P013277,6.515,4,16,12
56,JER,P009879,P013279,4.183,2,8,6
56,JER,P009879,P013281,0.616,2,2,0
56,JER,P010431,P010587,19.5,4,41,37
56,JER,P010431,P011970,15.168,-5,30,35
56,JER,P010431,P013277,15.399,3,39,36
56,JER,P010431,P013279,11.851,0,20,20
56,JER,P010431,P013281,6.483,-4,14,18
56,JER,P010587,P011970,16.917,1,39,38
56,JER,P010587,P013277,16.749,9,44,35
56,JER,P010587,P013279,13.284,1,24,23
56,JER,P010587,P013281,5.916,0,12,12
56,JER,P011970,P013277,17.017,0,42,42
56,JER,P011970,P013279,12.201,-1,25,26
56,JER,P011970,P013281,13.151,-4,27,31
56,JER,P013277,P013279,3.467,-1,10,11
56,JER,P013277,P013281,6.883,2,16,14
56,JER,P013279,P013281,6.317,1,14,13
56,LJU,P003452,P003703,12.466,2,25,23
56,LJU,P003452,P009392,14.199,-9,33,42
56,LJU,P003452,P009431,7.732,-4,18,22
56,LJU,P003452,P009753,10.383,-10,17,27
56,LJU,P003452,P011261,3.299,3,11,8
56,LJU,P003452,P012042,18.517,-14,36,50
56,LJU,P003452,P012700,14.467,-7,29,36
56,LJU,P003452,P012996,12.349,-13,27,40
56,LJU,P003452,P013260,14.516,-20,32,52
56,LJU,P003703,P009392,9.85,5,20,15
56,LJU,P003703,P009431,6.799,1,11,10
56,LJU,P003703,P009753,6.65,-4,6,10
56,LJU,P003703,P011261,4.983,1,6,5
56,LJU,P003703,P012042,11.117,0,18,18
56,LJU,P003703,P012700,11.2,-1,16,17
56,LJU,P003703,P012996,8.599,0,14,14
56,LJU,P009392,P009431,7.283,-1,17,18
56,LJU,P009392,P009753,3.466,-2,7,9
56,LJU,P009392,P011261,8.166,8,23,15
56,LJU,P009392,P012042,15.166,1,34,33
56,LJU,P009392,P012700,5.8,6,14,8
56,LJU,P009392,P012996,15.466,-3,34,37
56,LJU,P009392,P013260,13.332,-5,34,39
56,LJU,P009431,P009753,3.749,2,9,7
56,LJU,P009431,P011261,6.299,6,15,9
56,LJU,P009431,P012700,1.616,-3,0,3
56,LJU,P009431,P012996,7.716,-3,16,19
56,LJU,P009431,P013260,4.666,-2,14,16
56,LJU,P009753,P011261,7.782,0,16,16
56,LJU,P009753,P012042,12.933,-12,19,31
56,LJU,P009753,P012700,11.733,-8,16,24
56,LJU,P009753,P013260,10.032,-6,22,28
56,LJU,P011261,P012042,7.733,3,18,15
56,LJU,P011261,P012700,4.033,-2,5,7
56,LJU,P011261,P012996,6.983,9,20,11
56,LJU,P011261,P013260,9.782,8,30,22
56,LJU,P012042,P012700,18.434,-5,35,40
56,LJU,P012042,P012996,10.617,-3,23,26
56,LJU,P012042,P013260,16.683,-10,37,47
56,LJU,P012700,P012996,4.067,-5,6,11
56,LJU,P012700,P013260,8.85,-7,19,26
56,LJU,P012996,P013260,10.467,-6,28,34
57,ARI,P003240,P004292,12.483,-8,24,32
57,ARI,P003240,P013248,0.6,2,2,0
57,ARI,P003240,P013249,4.9,8,16,8
57,ARI,P003240,P013250,5.684,3,15,12
57,ARI,P003240,P013251,4.516,-1,9,10
57,ARI,P003240,P013252,6.0,-4,12,16
57,ARI,P003240,P013253,8.983,-5,19,24
57,ARI,P003240,P013355,9.083,0,20,20
57,ARI,P003240,P013360,9.4,-6,16,22
57,ARI,P003240,P013393,1.083,3,3,0
57,ARI,P004292,P013248,1.433,1,3,2
57,ARI,P004292,P013249,13.334,5,40,35
57,ARI,P004292,P013250,12.651,-8,31,39
57,ARI,P004292,P013251,14.649,1,33,32
57,ARI,P004292,P013252,7.184,-8,15,23
57,ARI,P004292,P013253,15.501,-5,38,43
57,ARI,P004292,P013355,18.883,1,46,45
57,ARI,P004292,P013360,8.633,-8,14,22
57,ARI,P004292,P013393,5.249,5,12,7
57,ARI,P013248,P013249,10.416,8,22,14
57,ARI,P013248,P013250,9.633,5,19,14
57,ARI,P013248,P013251,9.816,6,20,14
57,ARI,P013248,P013253,1.15,2,4,2
57,ARI,P013248,P013360,0.95,0,2,2
57,ARI,P013248,P013393,7.666,8,16,8
57,ARI,P013249,P013250,19.284,5,47,42
57,ARI,P013249,P013251,17.9,7,41,34
57,ARI,P013249,P013252,5.117,1,13,12
57,ARI,P013249,P013253,11.601,7,33,26
57,ARI,P013249,P013355,10.301,5,32,27
57,ARI,P013249,P013360,2.817,2,8,6
57,ARI,P013249,P013393,7.666,8,16,8
57,ARI,P013250,P013251,14.95,-3,28,31
57,ARI,P013250,P013252,7.384,0,19,19
57,ARI,P013250,P013253,11.501,2,32,30
57,ARI,P013250,P013355,8.134,-4,20,24
57,ARI,P013250,P013360,1.117,0,2,2
57,ARI,P013250,P013393,10.266,4,19,15
57,ARI,P013251,P013252,1.2,-2,2,4
57,ARI,P013251,P013253,6.417,4,17,13
57,ARI,P013251,P013355,12.933,0,28,28
57,ARI,P013251,P013360,3.133,-5,3,8
57,ARI,P013251,P013393,10.282,9,19,10
57,ARI,P013252,P013253,10.534,-6,23,29
57,ARI,P013252,P013360,2.867,-6,2,8
57,ARI,P013252,P013393,1.85,1,6,5
57,ARI,P013253,P013355,8.317,3,23,20
57,ARI,P013253,P013360,4.15,-7,5,12
57,ARI,P013253,P013393,1.85,1,6,5
57,ARI,P013355,P013360,5.933,-2,12,14
57,ARI,P013355,P013393,2.616,1,3,2
57,BOU,P004525,P006904,15.05,-9,27,36
57,BOU,P004525,P009552,2.584,-3,5,8
57,BOU,P004525,P009556,8.883,0,15,15
57,BOU,P004525,P010450,2.783,3,8,5
57,BOU,P004525,P011837,16.699,-2,27,29
57,BOU,P004525,P013264,1.25,-1,5,6
57,BOU,P004525,P013265,17.75,-9,29,38
57,BOU,P004525,P013266,17.133,-3,32,35
57,BOU,P006904,P009552,13.451,1,30,29
57,BOU,P006904,P009556,8.3,5,20,15
57,BOU,P006904,P010450,11.35,0,30,30
57,BOU,P006904,P011837,14.699,-7,27,34
57,BOU,P006904,P013264,15.65,-1,40,41
57,BOU,P006904,P013265,18.15,-11,32,43
57,BOU,P006904,P013266,21.15,-14,42,56
57,BOU,P009552,P009556,9.967,12,28,16
57,BOU,P009552,P010450,8.851,6,22,16
57,BOU,P009552,P013264,13.617,8,33,25
57,BOU,P009552,P013265,7.35,-1,16,17
57,BOU,P009552,P013266,8.984,-3,18,21
57,BOU,P009556,P010450,8.617,8,26,18
57,BOU,P009556,P011837,8.882,-1,18,19
57,BOU,P009556,P013264,9.966,11,31,20
57,BOU,P009556,P013265,10.232,3,20,17
57,BOU,P009556,P013266,10.549,6,26,20
57,BOU,P010450,P011837,8.199,0,26,26
57,BOU,P010450,P013264,14.317,1,40,39
57,BOU,P010450,P013265,0.05,-2,0,2
57,BOU,P010450,P013266,14.233,0,40,40
57,BOU,P011837,P013264,5.799,-3,18,21
57,BOU,P011837,P013265,14.299,-5,19,24
57,BOU,P011837,P013266,21.415,-2,45,47
57,BOU,P013264,P013265,6.449,-1,16,17
57,BOU,P013264,P013266,15.816,-6,41,47
57,BOU,P013265,P013266,17.516,-10,28,38
59,HAM,P003242,P006420,8.134,2,22,20
59,HAM,P003242,P010070,4.134,5,12,7
59,HAM,P003242,P011256,20.351,14,46,32
59,HAM,P003242,P012695,13.184,8,25,17
59,HAM,P003242,P013308,21.851,18,50,32
59,HAM,P003242,P013309,15.568,8,41,33
59,HAM,P003242,P013310,1.7,1,3,2
59,HAM,P003242,P013312,23.668,21,54,33
59,HAM,P003242,P013313,18.618,15,51,36
59,HAM,P006420,P010070,9.484,-4,22,26
59,HAM,P006420,P011256,5.084,0,13,13
59,HAM,P006420,P012695,3.833,-5,5,10
59,HAM,P006420,P013308,5.85,-9,12,21
59,HAM,P006420,P013309,12.334,-8,27,35
59,HAM,P006420,P013310,2.767,1,3,2
59,HAM,P006420,P013313,10.718,-1,28,29
59,HAM,P010070,P011256,1.717,3,5,2
59,HAM,P010070,P012695,1.9,-5,3,8
59,HAM,P010070,P013308,5.934,-13,11,24
59,HAM,P010070,P013309,11.818,-7,22,29
59,HAM,P010070,P013310,1.067,0,0,0
59,HAM,P010070,P013312,2.851,-2,3,5
59,HAM,P010070,P013313,10.435,-1,22,23
59,HAM,P011256,P012695,9.134,7,18,11
59,HAM,P011256,P013308,14.017,13,29,16
59,HAM,P011256,P013309,8.051,4,22,18
59,HAM,P011256,P013312,16.984,17,38,21
59,HAM,P011256,P013313,12.934,10,33,23
59,HAM,P012695,P013308,9.567,-2,15,17
59,HAM,P012695,P013309,8.267,-3,17,20
59,HAM,P012695,P013310,1.7,1,3,2
59,HAM,P012695,P013312,10.751,7,22,15
59,HAM,P013308,P013309,11.034,-11,23,34
59,HAM,P013308,P013310,1.7,1,3,2
59,HAM,P013308,P013312,21.418,13,46,33
59,HAM,P013308,P013313,17.701,6,43,37
59,HAM,P013309,P013310,1.067,0,0,0
59,HAM,P013309,P013312,11.435,5,27,22
59,HAM,P013309,P013313,15.502,0,37,37
59,HAM,P013310,P013313,1.067,0,0,0
59,HAM,P013312,P013313,14.701,11,34,23
59,TTK,P004056,P004619,2.217,-2,4,6
59,TTK,P004056,P006598,4.284,-3,8,11
59,TTK,P004056,P007917,2.634,-2,4,6
59,TTK,P004056,P009025,7.001,-7,15,22
59,TTK,P004056,P010465,6.217,-9,10,19
59,TTK,P004056,P011935,9.183,-12,12,24
59,TTK,P004056,P011973,12.834,-14,21,35
59,TTK,P004056,P012415,6.467,-6,13,19
59,TTK,P004056,P013300,9.367,-9,13,22
59,TTK,P004619,P006598,4.317,2,12,10
59,TTK,P004619,P007917,4.467,3,14,11
59,TTK,P004619,P009025,2.384,-1,4,5
59,TTK,P004619,P010465,6.534,0,16,16
59,TTK,P004619,P011935,0.1,2,2,0
59,TTK,P004619,P011973,1.017,-3,0,3
59,TTK,P004619,P013300,5.1,-1,12,13
59,TTK,P006598,P007917,8.617,1,18,17
59,TTK,P006598,P009025,13.252,-16,14,30
59,TTK,P006598,P010465,12.234,-4,18,22
59,TTK,P006598,P011935,7.901,-9,10,19
59,TTK,P006598,P011973,13.685,-20,14,34
59,TTK,P006598,P012415,1.967,-6,2,8
59,TTK,P006598,P013300,7.683,3,16,13
59,TTK,P007917,P009025,8.801,4,21,17
59,TTK,P007917,P010465,15.634,1,35,34
59,TTK,P007917,P011973,9.567,3,18,15
59,TTK,P007917,P012415,2.117,-3,5,8
59,TTK,P007917,P013300,12.767,5,33,28
59,TTK,P009025,P010465,20.186,7,44,37
59,TTK,P009025,P011935,13.235,-1,25,26
59,TTK,P009025,P011973,22.253,-5,44,49
59,TTK,P009025,P012415,11.585,-3,29,32
59,TTK,P009025,P013300,10.251,6,24,18
59,TTK,P010465,P011935,9.684,7,19,12
59,TTK,P010465,P011973,20.068,-1,37,38
59,TTK,P010465,P012415,8.301,3,24,21
59,TTK,P010465,P013300,17.95,0,37,37
59,TTK,P011935,P011973,17.051,-12,27,39
59,TTK,P011935,P012415,9.467,-2,19,21
59,TTK,P011935,P013300,7.983,-5,10,15
59,TTK,P011973,P012415,12.701,-4,28,32
59,TTK,P011973,P013300,14.3,0,27,27
59,TTK,P012415,P013300,6.667,-7,12,19
60,CLU,P002820,P004862,5.634,-9,5,14
60,CLU,P002820,P005714,12.217,-10,19,29
60,CLU,P002820,P006618,12.601,-19,16,35
60,CLU,P002820,P010651,2.3,-6,0,6
60,CLU,P002820,P011797,9.418,7,25,18
60,CLU,P002820,P012620,5.467,-7,9,16
60,CLU,P002820,P012698,21.751,-6,40,46
60,CLU,P002820,P013302,11.967,13,28,15
60,CLU,P002820,P013304,10.317,13,26,13
60,CLU,P004862,P005714,1.516,-2,4,6
60,CLU,P004862,P006618,9.616,2,22,20
60,CLU,P004862,P010651,11.65,-2,20,22
60,CLU,P004862,P011797,17.1,7,39,32
60,CLU,P004862,P012698,8.4,0,17,17
60,CLU,P004862,P013302,14.933,10,36,26
60,CLU,P004862,P013304,8.751,-2,13,15
60,CLU,P005714,P006618,8.117,-13,13,26
60,CLU,P005714,P010651,3.3,3,12,9
60,CLU,P005714,P011797,5.85,-1,16,17
60,CLU,P005714,P012620,5.467,-7,9,16
60,CLU,P005714,P012698,15.534,-6,29,35
60,CLU,P005714,P013302,10.566,2,22,20
60,CLU,P005714,P013304,5.633,2,8,6
60,CLU,P006618,P010651,3.15,-1,5,6
60,CLU,P006618,P011797,8.95,5,24,19
60,CLU,P006618,P012620,5.467,-7,9,16
60,CLU,P006618,P012698,16.534,-10,30,40
60,CLU,P006618,P013302,7.033,11,21,10
60,CLU,P010651,P011797,11.617,6,28,22
60,CLU,P010651,P012698,4.567,-4,8,12
60,CLU,P010651,P013302,11.617,6,28,22
60,CLU,P010651,P013304,7.467,-2,11,13
60,CLU,P011797,P012698,15.501,20,47,27
60,CLU,P011797,P013302,23.317,27,64,37
60,CLU,P011797,P013304,14.251,13,33,20
60,CLU,P012620,P012698,5.467,-7,9,16
60,CLU,P012698,P013302,18.05,26,50,24
60,CLU,P012698,P013304,10.2,15,26,11
60,CLU,P013302,P013304,18.717,13,39,26
60,VNC,P003759,P005177,5.7,3,11,8
60,VNC,P003759,P005404,14.683,1,31,30
60,VNC,P003759,P008052,12.65,10,32,22
60,VNC,P003759,P009400,3.083,2,11,9
60,VNC,P003759,P011909,12.65,-8,20,28
60,VNC,P003759,P011928,3.783,-14,1,15
60,VNC,P003759,P012800,4.95,-5,8,13
60,VNC,P003759,P013305,8.233,-5,18,23
60,VNC,P005177,P005404,6.3,-2,12,14
60,VNC,P005177,P008052,5.7,3,11,8
60,VNC,P005177,P011909,6.833,-4,12,16
60,VNC,P005177,P011928,5.25,-4,13,17
60,VNC,P005177,P012796,5.25,-4,13,17
60,VNC,P005177,P012800,4.65,1,12,11
60,VNC,P005177,P013305,4.117,3,12,9
60,VNC,P005404,P008052,13.95,7,33,26
60,VNC,P005404,P009400,3.65,5,13,8
60,VNC,P005404,P011909,17.467,-10,28,38
60,VNC,P005404,P011928,8.3,-16,8,24
60,VNC,P005404,P012796,7.567,-10,10,20
60,VNC,P005404,P012800,8.784,-3,13,16
60,VNC,P005404,P013305,8.299,-8,16,24
60,VNC,P008052,P009400,3.816,3,13,10
60,VNC,P008052,P011909,11.65,0,22,22
60,VNC,P008052,P012796,3.183,-5,5,10
60,VNC,P008052,P012800,5.4,-1,13,14
60,VNC,P008052,P013305,6.983,3,19,16
60,VNC,P009400,P011928,12.934,2,25,23
60,VNC,P009400,P012796,13.667,3,27,24
60,VNC,P009400,P012800,14.517,-2,27,29
60,VNC,P009400,P013305,15.333,7,36,29
60,VNC,P011909,P011928,6.35,-12,6,18
60,VNC,P011909,P012796,5.35,-4,8,12
60,VNC,P011909,P012800,6.767,1,11,10
60,VNC,P011909,P013305,4.933,-11,5,16
60,VNC,P011928,P012796,20.384,1,40,39
60,VNC,P011928,P012800,21.134,-1,37,38
60,VNC,P011928,P013305,18.533,-8,34,42
60,VNC,P012796,P012800,21.584,3,42,39
60,VNC,P012796,P013305,17.283,0,35,35
60,VNC,P012800,P013305,18.35,-1,37,38
61,BES,P003783,P007914,14.6,11,38,27
61,BES,P003783,P008945,5.8,11,19,8
61,BES,P003783,P009680,13.333,8,35,27
61,BES,P003783,P010652,10.217,9,29,20
61,BES,P003783,P011379,3.85,3,7,4
61,BES,P003783,P011924,2.05,-2,2,4
61,BES,P003783,P011927,2.3,1,6,5
61,BES,P003783,P011936,4.1,3,11,8
61,BES,P003783,P013255,11.35,4,29,25
61,BES,P007914,P008945,6.633,15,26,11
61,BES,P007914,P009680,19.466,13,53,40
61,BES,P007914,P010652,16.766,16,41,25
61,BES,P007914,P011379,3.85,3,7,4
61,BES,P007914,P011924,12.216,6,25,19
61,BES,P007914,P011927,3.917,5,10,5
61,BES,P007914,P011936,11.133,6,21,15
61,BES,P007914,P013255,10.483,1,23,22
61,BES,P008945,P009680,6.633,15,26,11
61,BES,P008945,P010652,13.433,16,46,30
61,BES,P008945,P011379,7.0,4,16,12
61,BES,P008945,P011924,14.633,9,43,34
61,BES,P008945,P011927,13.8,5,36,31
61,BES,P008945,P011936,11.5,4,30,26
61,BES,P008945,P013255,2.3,1,6,5
61,BES,P009680,P010652,11.466,10,33,23
61,BES,P009680,P011379,3.85,3,7,4
61,BES,P009680,P011924,8.183,3,20,17
61,BES,P009680,P011927,1.317,0,5,5
61,BES,P009680,P011936,5.833,0,13,13
61,BES,P009680,P013255,7.783,0,20,20
61,BES,P010652,P011924,15.149,13,37,24
61,BES,P010652,P011927,11.2,11,30,19
61,BES,P010652,P011936,13.283,11,27,16
61,BES,P010652,P013255,9.95,2,21,19
61,BES,P011379,P011924,8.683,-6,16,22
61,BES,P011379,P011927,6.633,-4,14,18
61,BES,P011379,P011936,6.633,-4,14,18
61,BES,P011379,P013255,1.433,-3,3,6
61,BES,P011924,P011927,16.85,6,43,37
61,BES,P011924,P011936,19.966,4,43,39
61,BES,P011924,P013255,2.866,-5,3,8
61,BES,P011927,P011936,16.85,6,43,37
61,BES,P011927,P013255,3.733,-2,9,11
61,BES,P011936,P013255,6.966,-2,14,16
61,TSO,P003885,P008790,9.634,6,27,21
61,TSO,P003885,P009649,21.217,1,44,43
61,TSO,P003885,P012019,12.118,1,23,22
61,TSO,P003885,P013292,6.783,-4,17,21
61,TSO,P003885,P013293,12.684,-4,30,34
61,TSO,P003885,P013295,14.4,-1,29,30
61,TSO,P003885,P013297,10.084,-14,15,29
61,TSO,P003885,P013298,9.284,3,27,24
61,TSO,P008790,P009649,19.984,-8,45,53
61,TSO,P008790,P012019,20.051,-14,37,51
61,TSO,P008790,P013292,3.233,3,11,8
61,TSO,P008790,P013293,14.717,-11,32,43
61,TSO,P008790,P013295,15.2,-13,24,37
61,TSO,P008790,P013297,7.617,-9,11,20
61,TSO,P008790,P013298,11.9,-2,25,27
61,TSO,P009649,P012019,20.834,-9,38,47
61,TSO,P009649,P013292,5.75,2,15,13
61,TSO,P009649,P013293,17.334,-13,34,47
61,TSO,P009649,P013295,20.833,-5,39,44
61,TSO,P009649,P013297,11.734,-12,19,31
61,TSO,P009649,P013298,10.85,8,30,22
61,TSO,P012019,P013292,0.85,-2,0,2
61,TSO,P012019,P013293,11.901,-14,21,35
61,TSO,P012019,P013295,20.1,-13,31,44
61,TSO,P012019,P013297,10.684,-11,14,25
61,TSO,P012019,P013298,14.134,2,32,30
61,TSO,P013292,P013293,4.533,-3,13,16
61,TSO,P013292,P013295,1.183,0,2,2
61,TSO,P013292,P013297,2.517,-7,4,11
61,TSO,P013292,P013298,2.283,-5,6,11
61,TSO,P013293,P013295,8.433,-15,11,26
61,TSO,P013293,P013297,9.334,-13,19,32
61,TSO,P013293,P013298,3.2,-7,8,15
61,TSO,P013295,P013297,11.4,-12,13,25
61,TSO,P013295,P013298,15.783,-1,35,36
61,TSO,P013297,P013298,7.434,-14,9,23
62,CAN,P003425,P006588,16.95,4,29,25
62,CAN,P003425,P008121,21.716,4,40,36
62,CAN,P003425,P008966,16.1,4,36,32
62,CAN,P003425,P010452,4.766,0,11,11
62,CAN,P003425,P011251,14.249,3,22,19
62,CAN,P003425,P012016,5.616,0,4,4
62,CAN,P003425,P012095,7.467,1,18,17
62,CAN,P005005,P006588,5.483,5,13,8
62,CAN,P005005,P008966,3.433,-7,2,9
62,CAN,P005005,P010452,7.083,-11,8,19
62,CAN,P005005,P010623,12.566,-6,21,27
62,CAN,P005005,P011251,1.55,-5,0,5
62,CAN,P005005,P012016,9.133,1,19,18
62,CAN,P005005,P012095,11.016,-1,21,22
62,CAN,P006588,P008121,19.9,6,34,28
62,CAN,P006588,P008966,15.367,8,32,24
62,CAN,P006588,P010623,8.433,7,18,11
62,CAN,P006588,P011251,11.0,0,15,15
62,CAN,P006588,P012016,10.016,3,15,12
62,CAN,P006588,P012095,14.383,11,32,21
62,CAN,P008121,P008966,20.933,4,41,37
62,CAN,P008121,P010452,6.649,-2,11,13
62,CAN,P008121,P010623,4.833,0,5,5
62,CAN,P008121,P011251,16.549,-2,22,24
62,CAN,P008121,P012016,5.616,0,4,4
62,CAN,P008121,P012095,10.0,6,23,17
62,CAN,P008966,P010452,9.882,-11,11,22
62,CAN,P008966,P010623,9.149,-7,7,14
62,CAN,P008966,P011251,13.999,-7,18,25
62,CAN,P008966,P012095,12.133,4,25,21
62,CAN,P010452,P010623,9.849,-13,8,21
62,CAN,P010452,P011251,7.982,-7,7,14
62,CAN,P010452,P012016,4.733,-2,8,10
62,CAN,P010452,P012095,7.516,-6,12,18
62,CAN,P010623,P011251,4.733,-10,0,10
62,CAN,P010623,P012016,9.133,1,19,18
62,CAN,P010623,P012095,14.432,4,26,22
62,CAN,P011251,P012016,4.983,0,4,4
62,CAN,P011251,P012095,0.883,0,0,0
62,CAN,P012016,P012095,9.766,1,19,18
62,WOL,P003212,P006853,7.166,3,16,13
62,WOL,P003212,P008186,3.216,-2,4,6
62,WOL,P003212,P011248,8.049,3,16,13
62,WOL,P003212,P012003,0.883,0,0,0
62,WOL,P003212,P012577,8.049,3,16,13
62,WOL,P003212,P012789,4.833,5,12,7
62,WOL,P004645,P005516,12.434,-3,17,20
62,WOL,P004645,P006546,13.467,9,24,15
62,WOL,P004645,P006853,2.75,-4,6,10
62,WOL,P004645,P008186,12.633,4,22,18
62,WOL,P004645,P011248,7.367,0,13,13
62,WOL,P004645,P012003,16.383,7,30,23
62,WOL,P004645,P012789,4.834,-1,8,9
62,WOL,P005516,P006546,9.651,-3,13,16
62,WOL,P005516,P006853,8.617,-8,14,22
62,WOL,P005516,P008186,18.817,0,28,28
62,WOL,P005516,P011248,12.167,-10,13,23
62,WOL,P005516,P012003,17.216,2,22,20
62,WOL,P005516,P012577,10.916,-5,11,16
62,WOL,P005516,P012789,4.85,-9,2,11
62,WOL,P006546,P006853,0.317,-1,2,3
62,WOL,P006546,P008186,10.3,1,16,15
62,WOL,P006546,P011248,6.5,1,17,16
62,WOL,P006546,P012003,13.483,10,26,16
62,WOL,P006546,P012577,1.033,-4,2,6
62,WOL,P006546,P012789,4.517,3,12,9
62,WOL,P006853,P008186,7.9,-3,16,19
62,WOL,P006853,P011248,15.717,-2,31,33
62,WOL,P006853,P012003,6.3,-1,13,14
62,WOL,P006853,P012577,15.833,1,29,28
62,WOL,P006853,P012789,11.0,-1,21,22
62,WOL,P008186,P011248,12.299,0,20,20
62,WOL,P008186,P012003,17.416,7,27,20
62,WOL,P008186,P012577,10.683,-3,15,18
62,WOL,P011248,P012003,14.882,9,27,18
62,WOL,P011248,P012577,20.815,2,36,34
62,WOL,P011248,P012789,16.2,1,31,30
62,WOL,P012003,P012577,9.999,3,14,11
62,WOL,P012003,P012789,8.966,3,17,14
62,WOL,P012577,P012789,11.532,3,21,18
63,JOV,P002361,P002507,2.967,-6,3,9
63,JOV,P002361,P004834,1.1,2,3,1
63,JOV,P002361,P006771,4.067,-4,6,10
63,JOV,P002361,P010161,1.5,-1,3,4
63,JOV,P002361,P012740,3.667,-1,6,7
63,JOV,P002361,P013285,0.4,-3,0,3
63,JOV,P002361,P013287,2.567,-3,3,6
63,JOV,P002507,P004834,3.45,0,4,4
63,JOV,P002507,P005099,19.667,2,46,44
63,JOV,P002507,P006771,8.45,-1,15,16
63,JOV,P002507,P010161,18.217,-5,37,42
63,JOV,P002507,P012740,13.834,-4,22,26
63,JOV,P002507,P013285,18.217,-2,37,39
63,JOV,P002507,P013286,9.017,-2,21,23
63,JOV,P002507,P013287,8.767,14,24,10
63,JOV,P002507,PJUG,1.95,-4,3,7
63,JOV,P004834,P005099,5.849,-2,12,14
63,JOV,P004834,P006771,8.8,3,22,19
63,JOV,P004834,P010161,13.134,-3,23,26
63,JOV,P004834,P012740,13.65,4,31,27
63,JOV,P004834,P013285,9.7,-2,17,19
63,JOV,P004834,P013286,6.483,0,16,16
63,JOV,P004834,P013287,4.966,0,13,13
63,JOV,P004834,PJUG,2.0,-2,3,5
63,JOV,P005099,P006771,4.3,1,10,9
63,JOV,P005099,P010161,16.9,-4,37,41
63,JOV,P005099,P012740,10.833,-4,22,26
63,JOV,P005099,P013285,19.116,-3,43,46
63,JOV,P005099,P013286,8.667,-2,21,23
63,JOV,P005099,P013287,8.066,15,27,12
63,JOV,P005099,PJUG,3.066,-3,6,9
63,JOV,P006771,P010161,8.233,-1,17,18
63,JOV,P006771,P012740,16.133,4,34,30
63,JOV,P006771,P013285,3.2,3,8,5
63,JOV,P006771,P013286,10.416,0,23,23
63,JOV,P006771,P013287,5.533,3,13,10
63,JOV,P010161,P012740,15.55,-3,29,32
63,JOV,P010161,P013285,19.668,-10,36,46
63,JOV,P010161,P013286,10.833,-5,25,30
63,JOV,P010161,P013287,5.184,8,15,7
63,JOV,P010161,PJUG,2.517,-8,2,10
63,JOV,P012740,P013285,9.967,-2,16,18
63,JOV,P012740,P013286,11.866,3,29,26
63,JOV,P012740,P013287,6.433,3,15,12
63,JOV,P012740,PJUG,0.067,0,0,0
63,JOV,P013285,P013286,3.667,-5,8,13
63,JOV,P013285,P013287,9.983,14,29,15
63,JOV,P013285,PJUG,3.95,-6,6,12
63,JOV,P013286,P013287,1.183,3,5,2
63,JOV,P013287,PJUG,2.25,-1,4,5
63,TRN,P002387,P005438,3.234,10,12,2
63,TRN,P002387,P006382,10.35,-1,19,20
63,TRN,P002387,P006724,5.35,-3,11,14
63,TRN,P002387,P012593,4.183,2,10,8
63,TRN,P002387,P012687,14.316,5,35,30
63,TRN,P002387,P013269,8.183,-4,18,22
63,TRN,P002387,P013270,18.416,3,41,38
63,TRN,P002387,P013271,6.9,8,20,12
63,TRN,P002387,P013272,7.4,0,14,14
63,TRN,P005438,P006382,0.8,4,4,0
63,TRN,P005438,P012593,15.817,-2,30,32
63,TRN,P005438,P012687,5.066,2,12,10
63,TRN,P005438,P013269,15.584,0,32,32
63,TRN,P005438,P013270,5.7,8,18,10
63,TRN,P005438,P013271,19.617,1,41,40
63,TRN,P005438,P013272,20.25,1,43,42
63,TRN,P006382,P006724,0.267,0,0,0
63,TRN,P006382,P012593,1.1,2,4,2
63,TRN,P006382,P012687,5.65,0,10,10
63,TRN,P006382,P013269,3.9,-5,5,10
63,TRN,P006382,P013270,9.25,-3,15,18
63,TRN,P006382,P013271,4.583,-1,9,10
63,TRN,P006382,P013272,5.5,0,10,10
63,TRN,P006724,P012593,2.283,1,5,4
63,TRN,P006724,P012687,6.483,-5,13,18
63,TRN,P006724,P013269,3.933,-6,8,14
63,TRN,P006724,P013270,6.483,-5,13,18
63,TRN,P006724,P013272,1.133,-2,2,4
63,TRN,P012593,P012687,4.366,-6,5,11
63,TRN,P012593,P013269,14.517,1,31,30
63,TRN,P012593,P013270,3.633,3,10,7
63,TRN,P012593,P013271,15.934,-5,30,35
63,TRN,P012593,P013272,17.167,0,35,35
63,TRN,P012687,P013269,5.299,-2,14,16
63,TRN,P012687,P013270,17.215,4,41,37
63,TRN,P012687,P013271,7.315,6,21,15
63,TRN,P012687,P013272,9.482,-8,13,21
63,TRN,P013269,P013270,11.966,0,30,30
63,TRN,P013269,P013271,20.167,5,45,40
63,TRN,P013269,P013272,18.983,-1,41,42
63,TRN,P013270,P013271,10.866,15,34,19
63,TRN,P013270,P013272,11.999,-1,26,27
63,TRN,P013271,P013272,19.35,-1,40,41
64,BUD,P004222,P005637,1.2,4,4,0
64,BUD,P004222,P006561,10.234,-3,23,26
64,BUD,P004222,P010307,1.3,1,6,5
64,BUD,P004222,P011150,9.117,2,19,17
64,BUD,P004222,P011281,10.417,5,27,22
64,BUD,P004222,P012606,6.334,3,16,13
64,BUD,P004222,P012630,7.134,-8,13,21
64,BUD,P005637,P006566,4.267,3,13,10
64,BUD,P005637,P008325,29.35,2,70,68
64,BUD,P005637,P010307,5.05,3,10,7
64,BUD,P005637,P011150,25.8,6,63,57
64,BUD,P005637,P011281,14.05,6,36,30
64,BUD,P005637,P012606,19.55,6,48,42
64,BUD,P005637,P012630,22.933,-6,52,58
64,BUD,P006561,P008325,4.217,2,8,6
64,BUD,P006561,P010307,4.184,1,12,11
64,BUD,P006561,P011150,11.817,0,23,23
64,BUD,P006561,P011281,12.684,4,29,25
64,BUD,P006561,P012606,5.884,-2,14,16
64,BUD,P006561,P012630,8.784,-6,15,21
64,BUD,P006566,P008325,4.267,3,13,10
64,BUD,P006566,P011150,4.267,3,13,10
64,BUD,P006566,P012606,4.267,3,13,10
64,BUD,P008325,P010307,7.934,3,16,13
64,BUD,P008325,P011150,28.5,4,67,63
64,BUD,P008325,P011281,16.317,5,38,33
64,BUD,P008325,P012606,19.1,1,46,45
64,BUD,P008325,P012630,24.583,-4,54,58
64,BUD,P010307,P011150,4.434,5,11,6
64,BUD,P010307,P011281,5.234,0,13,13
64,BUD,P010307,P012606,4.0,4,9,5
64,BUD,P010307,P012630,4.8,-1,11,12
64,BUD,P011150,P011281,20.733,11,48,37
64,BUD,P011150,P012606,21.467,4,52,48
64,BUD,P011150,P012630,24.333,-11,48,59
64,BUD,P011281,P012606,7.167,9,22,13
64,BUD,P011281,P012630,20.334,0,47,47
64,BUD,P012606,P012630,13.967,-12,28,40
64,ULM,P005422,P006245,19.55,-4,45,49
64,ULM,P005422,P006997,32.034,-4,69,73
64,ULM,P005422,P010726,6.967,-4,10,14
64,ULM,P005422,P011391,16.933,17,47,30
64,ULM,P005422,P012077,25.201,-3,51,54
64,ULM,P005422,P013289,7.5,-6,15,21
64,ULM,P005422,P013290,38.567,-6,86,92
64,ULM,P005422,P013291,24.384,-18,45,63
64,ULM,P006245,P006997,14.6,1,33,32
64,ULM,P006245,P011391,9.1,8,26,18
64,ULM,P006245,P012077,5.117,6,13,7
64,ULM,P006245,P013289,4.1,-4,9,13
64,ULM,P006245,P013290,21.15,1,50,49
64,ULM,P006245,P013291,10.983,-4,24,28
64,ULM,P006997,P010726,2.85,-3,4,7
64,ULM,P006997,P011391,15.2,18,44,26
64,ULM,P006997,P012077,19.167,2,42,40
64,ULM,P006997,P013290,32.5,1,74,73
64,ULM,P006997,P013291,18.517,-19,30,49
64,ULM,P010726,P011391,4.882,0,13,13
64,ULM,P010726,P012077,6.033,-8,9,17
64,ULM,P010726,P013289,3.933,-3,9,12
64,ULM,P010726,P013290,3.366,-6,7,13
64,ULM,P010726,P013291,2.301,-4,0,4
64,ULM,P011391,P012077,10.266,15,30,15
64,ULM,P011391,P013289,3.949,1,11,10
64,ULM,P011391,P013290,16.266,17,49,32
64,ULM,P012077,P013289,5.0,-6,9,15
64,ULM,P012077,P013290,23.2,0,53,53
64,ULM,P012077,P013291,15.684,-10,29,39
64,ULM,P013289,P013290,5.033,-8,12,20
64,ULM,P013289,P013291,2.617,-2,7,9
64,ULM,P013290,P013291,23.05,-15,45,60
65,BAH,P003840,P004172,7.134,0,17,17
65,BAH,P003840,P009601,23.717,1,57,56
65,BAH,P003840,P011192,23.083,-1,54,55
65,BAH,P003840,P011201,22.367,-1,57,58
65,BAH,P003840,P011823,20.767,7,50,43
65,BAH,P003840,P012405,0.8,0,0,0
65,BAH,P003840,P012711,6.6,-10,13,23
65,BAH,P004172,P005348,4.167,4,8,4
65,BAH,P004172,P009601,13.518,3,30,27
65,BAH,P004172,P011192,17.984,9,37,28
65,BAH,P004172,P011201,13.101,5,32,27
65,BAH,P004172,P011823,14.018,5,25,20
65,BAH,P004172,P012711,14.15,10,31,21
65,BAH,P005348,P009601,1.767,-2,2,4
65,BAH,P005348,P011192,4.167,4,8,4
65,BAH,P005348,P011823,3.417,4,6,2
65,BAH,P005348,P012711,3.15,6,8,2
65,BAH,P009601,P011192,30.584,2,72,70
65,BAH,P009601,P011201,28.267,2,68,66
65,BAH,P009601,P011823,20.501,6,47,41
65,BAH,P009601,P012405,0.8,0,0,0
65,BAH,P009601,P012711,10.85,-4,24,28
65,BAH,P011192,P011201,29.05,4,69,65
65,BAH,P011192,P011823,24.967,12,54,42
65,BAH,P011192,P012405,0.8,0,0,0
65,BAH,P011192,P012711,17.233,2,34,32
65,BAH,P011201,P011823,20.834,8,51,43
65,BAH,P011201,P012405,0.8,0,0,0
65,BAH,P011201,P012711,13.917,-2,31,33
65,BAH,P011823,P012711,7.5,6,15,9
65,HTA,P001927,P004846,24.5,0,55,55
65,HTA,P001927,P005181,1.934,3,3,0
65,HTA,P001927,P010386,26.817,-4,61,65
65,HTA,P001927,P010550,10.518,5,22,17
65,HTA,P001927,P011386,0.817,1,3,2
65,HTA,P001927,P012096,24.634,-1,53,54
65,HTA,P001927,P013284,25.501,2,61,59
65,HTA,P001927,P013402,5.951,6,14,8
65,HTA,P004846,P005181,1.267,3,3,0
65,HTA,P004846,P010386,22.133,-7,48,55
65,HTA,P004846,P010550,8.717,4,19,15
65,HTA,P004846,P012096,19.783,-3,43,46
65,HTA,P004846,P013284,20.5,-1,48,49
65,HTA,P004846,P013402,1.1,4,4,0
65,HTA,P005181,P009877,2.533,-6,2,8
65,HTA,P005181,P010550,11.767,-8,17,25
65,HTA,P005181,P011386,9.833,-11,14,25
65,HTA,P005181,P012096,3.75,-6,3,9
65,HTA,P005181,P013284,5.484,4,12,8
65,HTA,P005181,P013402,10.5,-11,14,25
65,HTA,P009877,P010550,2.533,-6,2,8
65,HTA,P009877,P011386,2.533,-6,2,8
65,HTA,P009877,P013402,2.533,-6,2,8
65,HTA,P010386,P010550,7.167,-2,15,17
65,HTA,P010386,P011386,0.817,1,3,2
65,HTA,P010386,P012096,23.65,-1,53,54
65,HTA,P010386,P013284,22.817,-5,54,59
65,HTA,P010386,P013402,3.867,2,10,8
65,HTA,P010550,P011386,10.65,-10,17,27
65,HTA,P010550,P012096,8.067,-5,10,15
65,HTA,P010550,P013284,10.068,5,24,19
65,HTA,P010550,P013402,11.917,-7,18,25
65,HTA,P011386,P012096,3.083,-6,3,9
65,HTA,P011386,P013284,5.034,2,12,10
65,HTA,P011386,P013402,9.833,-11,14,25
65,HTA,P012096,P013284,19.967,-2,46,48
65,HTA,P012096,P013402,7.934,-4,13,17
65,HTA,P013284,P013402,9.501,7,23,16
66,JER,P006625,P008912,20.365,2,39,37
66,JER,P006625,P009879,15.166,26,41,15
66,JER,P006625,P010431,20.248,12,48,36
66,JER,P006625,P013263,14.482,28,42,14
66,JER,P006625,P013277,13.749,15,31,16
66,JER,P006625,P013279,14.149,-4,25,29
66,JER,P006625,P013281,16.365,17,42,25
66,JER,P008912,P009879,13.45,4,27,23
66,JER,P008912,P010431,22.398,2,48,46
66,JER,P008912,P013263,6.749,4,14,10
66,JER,P008912,P013277,14.416,-2,25,27
66,JER,P008912,P013279,20.699,-4,39,43
66,JER,P008912,P013281,11.715,-6,20,26
66,JER,P009879,P010431,20.899,20,54,34
66,JER,P009879,P013263,13.149,32,45,13
66,JER,P009879,P013277,14.45,21,39,18
66,JER,P009879,P013279,12.85,0,23,23
66,JER,P009879,P013281,14.032,25,43,18
66,JER,P010431,P013263,12.765,14,35,21
66,JER,P010431,P013277,14.449,8,35,27
66,JER,P010431,P013279,18.849,2,40,38
66,JER,P010431,P013281,16.848,6,40,34
66,JER,P013263,P013277,9.482,21,28,7
66,JER,P013263,P013281,13.365,17,36,19
66,JER,P013277,P013279,13.35,-1,26,27
66,JER,P013277,P013281,11.432,18,32,14
66,JER,P013279,P013281,10.099,3,23,20
66,VNC,P003759,P005177,1.583,-6,0,6
66,VNC,P003759,P005404,9.467,-3,17,20
66,VNC,P003759,P008052,15.734,-1,33,34
66,VNC,P003759,P009400,14.216,-12,22,34
66,VNC,P003759,P011909,13.917,-10,22,32
66,VNC,P003759,P012800,19.416,-17,31,48
66,VNC,P003759,P013305,13.999,-7,23,30
66,VNC,P005177,P005404,2.35,-1,3,4
66,VNC,P005177,P006571,6.533,-4,10,14
66,VNC,P005177,P008052,4.416,1,8,7
66,VNC,P005177,P009400,5.766,-9,7,16
66,VNC,P005177,P011909,6.216,-4,10,14
66,VNC,P005177,P012800,1.9,-6,0,6
66,VNC,P005177,P013305,3.7,-11,2,13
66,VNC,P005404,P006571,7.95,-11,11,22
66,VNC,P005404,P008052,13.317,-10,24,34
66,VNC,P005404,P009400,9.433,-9,13,22
66,VNC,P005404,P011909,14.45,-5,26,31
66,VNC,P005404,P012588,5.783,0,11,11
66,VNC,P005404,P012800,12.583,-6,22,28
66,VNC,P005404,P013305,17.467,-11,29,40
66,VNC,P006571,P008052,10.016,-9,16,25
66,VNC,P006571,P009400,6.233,-11,7,18
66,VNC,P006571,P011909,10.449,-6,18,24
66,VNC,P006571,P012800,0.317,0,0,0
66,VNC,P006571,P013305,7.034,-15,10,25
66,VNC,P008052,P009400,15.2,-9,25,34
66,VNC,P008052,P011909,18.683,-4,36,40
66,VNC,P008052,P012800,13.067,-4,27,31
66,VNC,P008052,P013305,12.567,-4,27,31
66,VNC,P009400,P011909,10.599,-11,14,25
66,VNC,P009400,P012588,5.783,0,11,11
66,VNC,P009400,P012800,19.599,-11,33,44
66,VNC,P009400,P013305,18.099,-20,28,48
66,VNC,P011909,P012800,11.967,-14,16,30
66,VNC,P011909,P013305,11.183,-10,18,28
66,VNC,P012588,P012800,5.783,0,11,11
66,VNC,P012588,P013305,5.783,0,11,11
66,VNC,P012800,P013305,17.432,-10,28,38
67,CLU,P002820,P004862,6.667,-12,10,22
67,CLU,P002820,P005714,16.733,-13,36,49
67,CLU,P002820,P006618,7.317,-10,11,21
67,CLU,P002820,P010651,1.367,-3,0,3
67,CLU,P002820,P011797,19.217,-20,37,57
67,CLU,P002820,P012698,13.101,-7,20,27
67,CLU,P002820,P013302,20.267,-20,35,55
67,CLU,P002820,P013304,18.467,-15,35,50
67,CLU,P004862,P005714,3.066,1,9,8
67,CLU,P004862,P006618,3.983,-1,9,10
67,CLU,P004862,P010651,10.468,5,23,18
67,CLU,P004862,P011797,11.301,-10,21,31
67,CLU,P004862,P012698,11.367,9,28,19
67,CLU,P004862,P013302,18.35,-8,39,47
67,CLU,P004862,P013304,18.334,-8,37,45
67,CLU,P005714,P006618,6.9,-7,13,20
67,CLU,P005714,P011797,14.033,-12,33,45
67,CLU,P005714,P012698,10.533,-2,23,25
67,CLU,P005714,P013302,15.032,-10,34,44
67,CLU,P005714,P013304,12.899,-5,32,37
67,CLU,P006618,P010651,1.617,2,5,3
67,CLU,P006618,P011797,7.6,-3,18,21
67,CLU,P006618,P012698,8.284,-2,18,20
67,CLU,P006618,P013302,3.866,-8,4,12
67,CLU,P006618,P013304,1.433,-3,2,5
67,CLU,P010651,P011797,6.251,-3,11,14
67,CLU,P010651,P012698,6.618,13,17,4
67,CLU,P010651,P013302,8.551,3,18,15
67,CLU,P010651,P013304,9.468,3,18,15
67,CLU,P011797,P012698,8.318,3,16,13
67,CLU,P011797,P013302,20.45,-27,36,63
67,CLU,P011797,P013304,20.834,-24,36,60
67,CLU,P012698,P013302,14.017,8,28,20
67,CLU,P012698,P013304,13.034,10,26,16
67,CLU,P013302,P013304,30.267,-14,62,76
67,TTK,P004056,P004619,3.367,-11,2,13
67,TTK,P004056,P006598,3.634,-7,4,11
67,TTK,P004056,P007917,3.083,-9,2,11
67,TTK,P004056,P009025,5.717,-12,8,20
67,TTK,P004056,P010465,2.083,-5,4,9
67,TTK,P004056,P011935,3.267,-3,8,11
67,TTK,P004056,P013300,1.717,-1,4,5
67,TTK,P004619,P006598,8.417,0,17,17
67,TTK,P004619,P007917,8.434,-7,13,20
67,TTK,P004619,P009025,10.384,-5,21,26
67,TTK,P004619,P010465,5.4,-1,13,14
67,TTK,P004619,P011935,1.95,2,8,6
67,TTK,P004619,P012415,0.517,0,2,2
67,TTK,P004619,P013300,3.067,2,8,6
67,TTK,P006598,P007917,9.201,-5,13,18
67,TTK,P006598,P009025,16.118,-5,30,35
67,TTK,P006598,P010465,8.517,0,18,18
67,TTK,P006598,P011935,8.734,-1,19,20
67,TTK,P006598,P013300,9.851,-2,19,21
67,TTK,P007917,P009025,21.967,16,53,37
67,TTK,P007917,P010465,17.166,23,48,25
67,TTK,P007917,P011935,14.616,26,43,17
67,TTK,P007917,P012415,6.333,15,23,8
67,TTK,P007917,P013300,11.4,17,29,12
67,TTK,P009025,P010465,31.317,21,84,63
67,TTK,P009025,P011935,30.484,23,83,60
67,TTK,P009025,P012415,14.367,14,44,30
67,TTK,P009025,P013300,25.318,12,61,49
67,TTK,P010465,P011935,28.95,27,82,55
67,TTK,P010465,P012415,15.45,17,47,30
67,TTK,P010465,P013300,20.717,14,52,38
67,TTK,P011935,P012415,14.933,17,45,28
67,TTK,P011935,P013300,23.334,13,56,43
67,TTK,P012415,P013300,10.2,5,27,22
68,HAM,P003242,P005478,8.517,-6,12,18
68,HAM,P003242,P006420,3.384,0,6,6
68,HAM,P003242,P010070,8.218,-11,13,24
68,HAM,P003242,P011256,13.967,-8,24,32
68,HAM,P003242,P012695,8.2,-7,14,21
68,HAM,P003242,P013308,14.783,-4,24,28
68,HAM,P003242,P013311,10.0,-11,13,24
68,HAM,P003242,P013312,14.65,-11,25,36
68,HAM,P003242,P013313,12.217,-10,17,27
68,HAM,P005478,P006420,9.551,0,19,19
68,HAM,P005478,P008103,11.367,-4,21,25
68,HAM,P005478,P010070,11.084,-15,15,30
68,HAM,P005478,P011256,1.383,-2,0,2
68,HAM,P005478,P012695,5.35,0,7,7
68,HAM,P005478,P013308,8.8,5,18,13
68,HAM,P005478,P013311,18.501,-8,33,41
68,HAM,P005478,P013313,4.983,-10,7,17
68,HAM,P006420,P008103,7.101,-2,13,15
68,HAM,P006420,P010070,6.084,-6,10,16
68,HAM,P006420,P011256,3.8,-5,7,12
68,HAM,P006420,P013308,7.584,1,16,15
68,HAM,P006420,P013311,13.051,-3,26,29
68,HAM,P006420,P013313,4.117,-5,7,12
68,HAM,P008103,P010070,7.7,-2,14,16
68,HAM,P008103,P011256,3.15,-1,3,4
68,HAM,P008103,P012695,1.8,1,3,2
68,HAM,P008103,P013308,5.634,-1,10,11
68,HAM,P008103,P013311,10.184,-2,21,23
68,HAM,P008103,P013312,1.35,3,3,0
68,HAM,P008103,P013313,5.05,-4,8,12
68,HAM,P010070,P011256,9.083,-3,19,22
68,HAM,P010070,P012695,6.684,-3,14,17
68,HAM,P010070,P013311,13.201,-16,22,38
68,HAM,P010070,P013312,4.517,2,12,10
68,HAM,P010070,P013313,9.833,-10,17,27
68,HAM,P011256,P012695,4.95,-5,9,14
68,HAM,P011256,P013308,10.734,-7,15,22
68,HAM,P011256,P013311,3.666,-5,7,12
68,HAM,P011256,P013312,15.117,-5,27,32
68,HAM,P011256,P013313,15.35,-7,25,32
68,HAM,P012695,P013308,2.833,-1,3,4
68,HAM,P012695,P013311,5.533,-3,8,11
68,HAM,P012695,P013312,4.65,-6,10,16
68,HAM,P013308,P013311,9.683,2,19,17
68,HAM,P013308,P013312,11.0,-8,16,24
68,HAM,P013308,P013313,10.617,-7,15,22
68,HAM,P013311,P013312,1.366,-5,1,6
68,HAM,P013311,P013313,8.283,-13,14,27
68,HAM,P013312,P013313,11.35,-2,18,20
68,LKB,P005113,P005521,20.384,11,45,34
68,LKB,P005113,P005656,21.984,17,53,36
68,LKB,P005113,P009299,15.15,8,36,28
68,LKB,P005113,P009898,16.367,9,36,27
68,LKB,P005113,P010181,0.433,3,3,0
68,LKB,P005113,P013247,6.367,11,22,11
68,LKB,P005113,PLXI,7.251,9,17,8
68,LKB,P005521,P005656,20.384,11,45,34
68,LKB,P005521,P006212,2.95,0,7,7
68,LKB,P005521,P009299,14.317,5,33,28
68,LKB,P005521,P009898,17.133,6,35,29
68,LKB,P005521,P010461,2.95,0,7,7
68,LKB,P005521,P013247,6.184,5,17,12
68,LKB,P005521,PLXI,9.034,6,19,13
68,LKB,P005656,P006212,2.033,-1,4,5
68,LKB,P005656,P009299,17.183,7,40,33
68,LKB,P005656,P009898,16.367,9,36,27
68,LKB,P005656,P010181,2.466,2,7,5
68,LKB,P005656,P013247,8.4,10,26,16
68,LKB,P005656,PLXI,7.251,9,17,8
68,LKB,P006212,P009299,12.25,8,27,19
68,LKB,P006212,P009898,4.75,-2,8,10
68,LKB,P006212,P010181,2.033,-1,4,5
68,LKB,P006212,P010461,15.984,7,34,27
68,LKB,P006212,P013247,16.084,6,34,28
68,LKB,P006212,PLXI,15.984,7,34,27
68,LKB,P009299,P009898,10.333,1,20,19
68,LKB,P009299,P010181,2.466,2,7,5
68,LKB,P009299,P010461,10.217,9,23,14
68,LKB,P009299,P013247,17.05,15,43,28
68,LKB,P009299,PLXI,10.634,9,23,14
68,LKB,P009898,P010461,4.75,-2,8,10
68,LKB,P009898,P013247,3.584,1,9,8
68,LKB,P009898,PLXI,11.184,6,24,18
68,LKB,P010181,P013247,2.466,2,7,5
68,LKB,P010461,P013247,14.051,7,30,23
68,LKB,P010461,PLXI,15.984,7,34,27
68,LKB,P013247,PLXI,15.618,11,36,25
69,ARI,P003240,P004292,19.983,2,30,28
69,ARI,P003240,P012638,1.45,0,2,2
69,ARI,P003240,P013248,1.55,2,4,2
69,ARI,P003240,P013251,21.016,-3,30,33
69,ARI,P003240,P013252,21.916,-2,34,36
69,ARI,P003240,P013253,20.65,1,28,27
69,ARI,P003240,P013355,4.867,-2,4,6
69,ARI,P003240,P013356,8.067,-2,9,11
69,ARI,P003240,P013393,9.416,-1,19,20
69,ARI,P003240,P013395,4.417,-3,8,11
69,ARI,P004292,P012638,4.217,2,6,4
69,ARI,P004292,P013248,6.784,2,15,13
69,ARI,P004292,P013251,27.267,2,42,40
69,ARI,P004292,P013252,16.983,0,25,25
69,ARI,P004292,P013253,17.766,-1,22,23
69,ARI,P004292,P013355,7.883,-2,7,9
69,ARI,P004292,P013356,5.816,-4,3,7
69,ARI,P004292,P013393,15.934,1,30,29
69,ARI,P004292,P013395,3.967,-2,8,10
69,ARI,P012638,P013248,2.417,0,4,4
69,ARI,P012638,P013251,4.667,-2,4,6
69,ARI,P012638,P013252,1.75,-2,0,2
69,ARI,P012638,P013253,1.45,0,2,2
69,ARI,P012638,P013355,1.0,2,2,0
69,ARI,P012638,P013393,3.717,0,4,4
69,ARI,P013248,P013251,6.784,2,15,13
69,ARI,P013248,P013393,6.784,2,15,13
69,ARI,P013248,P013395,2.817,0,7,7
69,ARI,P013251,P013252,20.699,-7,27,34
69,ARI,P013251,P013253,17.316,0,21,21
69,ARI,P013251,P013355,5.2,0,5,5
69,ARI,P013251,P013356,4.783,-1,5,6
69,ARI,P013251,P013393,17.55,-3,30,33
69,ARI,P013251,P013395,5.45,-8,9,17
69,ARI,P013252,P013253,17.333,3,26,23
69,ARI,P013252,P013356,5.667,2,9,7
69,ARI,P013252,P013393,10.766,-5,18,23
69,ARI,P013252,P013395,5.35,-5,9,14
69,ARI,P013253,P013355,7.3,-2,7,9
69,ARI,P013253,P013356,10.8,-2,12,14
69,ARI,P013253,P013393,2.983,2,7,5
69,ARI,P013253,P013395,2.934,3,7,4
69,ARI,P013355,P013356,5.133,-4,3,7
69,ARI,P013355,P013393,0.8,0,0,0
69,ARI,P013355,P013395,0.217,0,0,0
69,ARI,P013356,P013395,2.934,3,7,4
69,ARI,P013393,P013395,5.45,-8,9,17
69,PAM,P004863,P005356,0.667,0,0,0
69,PAM,P004863,P006643,7.6,1,13,12
69,PAM,P004863,P007527,4.533,5,10,5
69,PAM,P004863,P010042,5.45,-1,7,8
69,PAM,P004863,P010393,6.134,-1,6,7
69,PAM,P004863,P010444,5.183,5,11,6
69,PAM,P004863,P011980,4.166,5,11,6
69,PAM,P004863,P011982,3.4,3,4,1
69,PAM,P004863,P012738,5.467,-1,6,7
69,PAM,P005356,P006643,3.5,-4,4,8
69,PAM,P005356,P007527,4.033,3,7,4
69,PAM,P005356,P010042,13.634,8,25,17
69,PAM,P005356,P010393,6.051,-2,6,8
69,PAM,P005356,P010444,10.967,0,14,14
69,PAM,P005356,P010750,3.133,-7,2,9
69,PAM,P005356,P011980,7.35,0,14,14
69,PAM,P005356,P011982,13.934,5,23,18
69,PAM,P005356,P012738,6.467,1,13,12
69,PAM,P006643,P007527,5.599,-1,11,12
69,PAM,P006643,P010042,8.95,-5,11,16
69,PAM,P006643,P010393,4.5,-2,7,9
69,PAM,P006643,P010444,7.799,1,14,13
69,PAM,P006643,P010750,3.449,-3,5,8
69,PAM,P006643,P011980,9.699,-4,15,19
69,PAM,P006643,P011982,0.35,0,0,0
69,PAM,P006643,P012738,6.75,-7,8,15
69,PAM,P007527,P010042,7.383,0,9,9
69,PAM,P007527,P010393,8.2,2,14,12
69,PAM,P007527,P010444,10.065,2,16,14
69,PAM,P007527,P010750,6.999,0,15,15
69,PAM,P007527,P011980,6.682,0,13,13
69,PAM,P007527,P011982,13.316,6,23,17
69,PAM,P007527,P012738,8.85,3,18,15
69,PAM,P010042,P010393,12.184,-2,12,14
69,PAM,P010042,P010444,12.3,6,17,11
69,PAM,P010042,P010750,2.233,2,2,0
69,PAM,P010042,P011980,8.1,5,17,12
69,PAM,P010042,P011982,16.067,11,25,14
69,PAM,P010042,P012738,12.367,0,19,19
69,PAM,P010393,P010444,7.217,-2,7,9
69,PAM,P010393,P010750,7.733,1,14,13
69,PAM,P010393,P011982,15.651,1,19,18
69,PAM,P010393,P012738,12.934,1,19,18
69,PAM,P010444,P010750,5.682,-5,8,13
69,PAM,P010444,P011980,12.382,6,26,20
69,PAM,P010444,P011982,13.933,3,19,16
69,PAM,P010750,P011980,4.632,-6,5,11
69,PAM,P010750,P011982,8.916,-2,14,16
69,PAM,P010750,P012738,6.683,0,11,11
69,PAM,P011980,P011982,5.766,6,15,9
69,PAM,P011980,P012738,3.083,-4,4,8
69,PAM,P011982,P012738,11.867,7,22,15
70,BOU,P004525,P004945,5.567,-1,7,8
70,BOU,P004525,P006904,15.917,-3,35,38
70,BOU,P004525,P009552,6.217,5,14,9
70,BOU,P004525,P010449,2.284,7,7,0
70,BOU,P004525,P010450,0.067,2,2,0
70,BOU,P004525,P011837,14.467,-4,31,35
70,BOU,P004525,P013264,2.534,0,2,2
70,BOU,P004525,P013265,22.802,3,49,46
70,BOU,P004525,P013266,23.285,3,49,46
70,BOU,P004945,P009552,11.35,11,30,19
70,BOU,P004945,P010449,7.433,10,23,13
70,BOU,P004945,P010450,6.083,7,20,13
70,BOU,P004945,P013264,7.567,6,18,12
70,BOU,P004945,P013265,6.201,2,13,11
70,BOU,P004945,P013266,5.867,1,9,8
70,BOU,P006904,P009552,4.816,-1,10,11
70,BOU,P006904,P010449,3.083,0,6,6
70,BOU,P006904,P010450,3.083,0,6,6
70,BOU,P006904,P011837,14.467,-4,31,35
70,BOU,P006904,P013264,3.366,-2,6,8
70,BOU,P006904,P013265,16.2,-5,35,40
70,BOU,P006904,P013266,16.2,-5,35,40
70,BOU,P009552,P010449,17.283,9,44,35
70,BOU,P009552,P010450,14.699,6,38,32
70,BOU,P009552,P013264,16.166,2,36,34
70,BOU,P009552,P013265,8.001,3,20,17
70,BOU,P009552,P013266,13.2,1,28,27
70,BOU,P010449,P010450,14.766,8,40,32
70,BOU,P010449,P013264,17.25,6,38,32
70,BOU,P010449,P013265,3.785,7,13,6
70,BOU,P010449,P013266,8.984,5,21,16
70,BOU,P010450,P013264,14.149,4,33,29
70,BOU,P010450,P013265,0.617,4,7,3
70,BOU,P010450,P013266,5.6,1,14,13
70,BOU,P011837,P013265,14.467,-4,31,35
70,BOU,P011837,P013266,14.467,-4,31,35
70,BOU,P013264,P013265,4.251,-4,3,7
70,BOU,P013264,P013266,9.517,-4,16,20
70,BOU,P013265,P013266,23.952,-2,49,51
70,LJU,P003452,P003703,17.784,-3,34,37
70,LJU,P003452,P007641,0.55,2,4,2
70,LJU,P003452,P009392,5.934,-8,10,18
70,LJU,P003452,P009753,20.3,8,45,37
70,LJU,P003452,P012042,26.367,9,61,52
70,LJU,P003452,P012700,26.35,10,62,52
70,LJU,P003452,P012996,11.617,4,25,21
70,LJU,P003452,P013260,15.967,8,39,31
70,LJU,P003452,P013262,6.467,-2,12,14
70,LJU,P003703,P007641,0.133,0,0,0
70,LJU,P003703,P009392,12.217,-17,20,37
70,LJU,P003703,P009753,12.033,3,21,18
70,LJU,P003703,P012042,19.817,-10,38,48
70,LJU,P003703,P012700,14.417,1,29,28
70,LJU,P003703,P012996,11.117,-10,20,30
70,LJU,P003703,P013260,4.5,-10,8,18
70,LJU,P003703,P013262,4.25,-2,6,8
70,LJU,P007641,P009392,0.133,0,0,0
70,LJU,P007641,P009753,0.1,0,0,0
70,LJU,P007641,P012042,0.1,0,0,0
70,LJU,P007641,P012996,0.583,2,4,2
70,LJU,P007641,P013260,0.55,2,4,2
70,LJU,P007641,P013262,0.583,2,4,2
70,LJU,P009392,P009753,3.533,-6,5,11
70,LJU,P009392,P012042,9.917,-21,18,39
70,LJU,P009392,P012700,4.367,-11,5,16
70,LJU,P009392,P012996,8.65,-11,12,23
70,LJU,P009392,P013260,4.466,-13,8,21
70,LJU,P009392,P013262,3.183,-1,2,3
70,LJU,P009753,P012042,22.65,3,47,44
70,LJU,P009753,P012700,19.817,8,44,36
70,LJU,P009753,P013260,12.167,-4,26,30
70,LJU,P012042,P012700,25.767,7,58,51
70,LJU,P012042,P012996,9.3,-3,21,24
70,LJU,P012042,P013260,17.55,-5,41,46
70,LJU,P012700,P012996,9.066,1,17,16
70,LJU,P012700,P013260,15.383,3,35,32
70,LJU,P012700,P013262,4.033,-3,6,9
70,LJU,P012996,P013260,8.266,-1,21,22
70,LJU,P012996,P013262,7.133,-2,12,14
70,LJU,P013260,P013262,2.883,0,6,6
71,HTA,P001927,P004846,0.383,-1,0,1
71,HTA,P001927,P010386,5.517,2,13,11
71,HTA,P001927,P010550,20.55,6,43,37
71,HTA,P001927,P011386,15.65,4,33,29
71,HTA,P001927,P012096,18.7,4,37,33
71,HTA,P001927,P013284,1.85,2,6,4
71,HTA,P001927,P013402,19.55,7,40,33
71,HTA,P004846,P005181,16.283,15,38,23
71,HTA,P004846,P009877,5.2,3,12,9
71,HTA,P004846,P010386,16.666,14,38,24
71,HTA,P004846,P010550,6.533,2,13,11
71,HTA,P004846,P012096,11.466,11,26,15
71,HTA,P004846,P013284,10.133,12,25,13
71,HTA,P005181,P009877,7.434,10,23,13
71,HTA,P005181,P010386,16.883,15,38,23
71,HTA,P005181,P010550,6.15,3,13,10
71,HTA,P005181,P012096,11.683,12,26,14
71,HTA,P005181,P013282,1.067,5,7,2
71,HTA,P005181,P013283,2.834,7,11,4
71,HTA,P005181,P013284,11.9,14,29,15
71,HTA,P005181,P013402,2.234,7,11,4
71,HTA,P009877,P010386,5.2,3,12,9
71,HTA,P009877,P010550,0.333,1,1,0
71,HTA,P009877,P012096,0.333,1,1,0
71,HTA,P009877,P013282,1.067,5,7,2
71,HTA,P009877,P013283,2.567,8,12,4
71,HTA,P009877,P013284,6.7,6,17,11
71,HTA,P009877,P013402,2.234,7,11,4
71,HTA,P010386,P010550,11.667,5,26,21
71,HTA,P010386,P011386,0.617,0,3,3
71,HTA,P010386,P012096,15.35,12,33,21
71,HTA,P010386,P013283,0.6,0,0,0
71,HTA,P010386,P013284,12.583,14,31,17
71,HTA,P010386,P013402,4.517,3,10,7
71,HTA,P010550,P011386,15.65,4,33,29
71,HTA,P010550,P012096,25.183,8,51,43
71,HTA,P010550,P013283,0.333,1,1,0
71,HTA,P010550,P013284,2.183,3,7,4
71,HTA,P010550,P013402,19.55,7,40,33
71,HTA,P011386,P012096,15.65,4,33,29
71,HTA,P011386,P013402,15.033,4,30,26
71,HTA,P012096,P013283,0.933,1,1,0
71,HTA,P012096,P013284,5.866,10,14,4
71,HTA,P012096,P013402,17.7,5,34,29
71,HTA,P013282,P013283,1.067,5,7,2
71,HTA,P013282,P013402,1.067,5,7,2
71,HTA,P013283,P013284,2.1,3,5,2
71,HTA,P013283,P013402,2.234,7,11,4
71,HTA,P013284,P013402,3.017,4,10,6
71,TSO,P003885,P008790,3.217,-2,4,6
71,TSO,P003885,P009649,15.417,-18,24,42
71,TSO,P003885,P012019,13.701,-17,20,37
71,TSO,P003885,P013292,3.751,-9,2,11
71,TSO,P003885,P013293,10.867,-6,21,27
71,TSO,P003885,P013295,7.034,-8,10,18
71,TSO,P003885,P013297,7.967,-9,13,22
71,TSO,P003885,P013298,10.918,-7,14,21
71,TSO,P008790,P009649,18.384,-6,32,38
71,TSO,P008790,P012019,17.268,-3,32,35
71,TSO,P008790,P013292,0.35,0,0,0
71,TSO,P008790,P013293,5.817,-1,10,11
71,TSO,P008790,P013295,10.467,-2,20,22
71,TSO,P008790,P013297,5.517,0,10,10
71,TSO,P008790,P013298,15.784,-2,28,30
71,TSO,P009649,P012019,32.334,-26,54,80
71,TSO,P009649,P013292,2.734,-5,2,7
71,TSO,P009649,P013293,15.733,-12,28,40
71,TSO,P009649,P013295,21.317,-15,36,51
71,TSO,P009649,P013297,19.284,-17,30,47
71,TSO,P009649,P013298,23.601,-13,38,51
71,TSO,P012019,P013292,2.034,-9,0,9
71,TSO,P012019,P013293,14.367,-7,26,33
71,TSO,P012019,P013295,21.234,-18,35,53
71,TSO,P012019,P013297,18.067,-16,27,43
71,TSO,P012019,P013298,21.535,-12,34,46
71,TSO,P013292,P013295,3.434,-4,2,6
71,TSO,P013292,P013297,0.667,-5,0,5
71,TSO,P013292,P013298,3.434,-4,2,6
71,TSO,P013293,P013295,10.25,-7,18,25
71,TSO,P013293,P013297,7.4,-4,13,17
71,TSO,P013293,P013298,4.234,1,8,7
71,TSO,P013295,P013297,5.8,-8,7,15
71,TSO,P013295,P013298,13.668,-10,20,30
71,TSO,P013297,P013298,12.434,-9,20,29
72,BAH,P003840,P004172,15.049,5,29,24
72,BAH,P003840,P005348,1.317,-2,0,2
72,BAH,P003840,P009601,18.983,5,40,35
72,BAH,P003840,P011192,17.399,0,35,35
72,BAH,P003840,P011201,23.283,0,43,43
72,BAH,P003840,P011823,19.15,-4,31,35
72,BAH,P003840,P012711,16.883,0,30,30
72,BAH,P004172,P005348,6.483,-3,11,14
72,BAH,P004172,P009601,13.533,7,31,24
72,BAH,P004172,P011192,14.382,10,36,26
72,BAH,P004172,P011201,19.166,13,41,28
72,BAH,P004172,P011823,20.816,0,39,39
72,BAH,P004172,P012711,18.699,16,41,25
72,BAH,P005348,P009601,5.067,-3,9,12
72,BAH,P005348,P011192,5.467,-6,7,13
72,BAH,P005348,P011201,2.183,1,4,3
72,BAH,P005348,P011823,7.65,-5,11,16
72,BAH,P005348,P012711,2.433,-2,2,4
72,BAH,P009601,P011192,19.216,6,44,38
72,BAH,P009601,P011201,19.283,2,40,38
72,BAH,P009601,P011823,15.184,-3,28,31
72,BAH,P009601,P012711,10.066,6,24,18
72,BAH,P011192,P011201,18.316,9,43,34
72,BAH,P011192,P011823,19.967,0,37,37
72,BAH,P011192,P012711,14.649,5,34,29
72,BAH,P011201,P011823,22.9,8,45,37
72,BAH,P011201,P012711,18.733,11,40,29
72,BAH,P011823,P012711,13.733,4,25,21
72,ULM,P005422,P006245,5.499,4,12,8
72,ULM,P005422,P006997,16.6,3,30,27
72,ULM,P005422,P007952,2.183,1,5,4
72,ULM,P005422,P011391,18.583,-8,33,41
72,ULM,P005422,P011437,24.15,-11,39,50
72,ULM,P005422,P012077,5.266,2,12,10
72,ULM,P005422,P013289,5.05,-2,7,9
72,ULM,P005422,P013290,24.383,-9,39,48
72,ULM,P005422,P013291,16.882,-8,27,35
72,ULM,P006245,P006997,4.216,3,13,10
72,ULM,P006245,P007952,0.567,-4,0,4
72,ULM,P006245,P010726,4.25,-1,9,10
72,ULM,P006245,P011391,2.849,-5,3,8
72,ULM,P006245,P011437,1.55,1,2,1
72,ULM,P006245,P012077,10.733,-2,22,24
72,ULM,P006245,P013289,9.183,3,15,12
72,ULM,P006245,P013290,8.516,5,19,14
72,ULM,P006245,P013291,10.633,8,29,21
72,ULM,P006997,P010726,2.05,5,9,4
72,ULM,P006997,P011391,13.6,-1,26,27
72,ULM,P006997,P011437,15.267,3,28,25
72,ULM,P006997,P012077,4.233,5,15,10
72,ULM,P006997,P013290,16.083,-1,28,29
72,ULM,P006997,P013291,5.883,7,15,8
72,ULM,P007952,P010726,0.567,-4,0,4
72,ULM,P007952,P011437,2.183,1,5,4
72,ULM,P007952,P012077,2.75,-3,5,8
72,ULM,P007952,P013291,2.75,-3,5,8
72,ULM,P010726,P011391,1.633,-2,0,2
72,ULM,P010726,P012077,4.25,-1,9,10
72,ULM,P010726,P013289,1.633,-2,0,2
72,ULM,P010726,P013291,2.617,1,9,8
72,ULM,P011391,P011437,18.2,-7,32,39
72,ULM,P011391,P012077,3.816,-2,6,8
72,ULM,P011391,P013289,1.633,-2,0,2
72,ULM,P011391,P013290,18.066,-12,31,43
72,ULM,P011391,P013291,5.816,-9,9,18
72,ULM,P011437,P012077,6.433,4,13,9
72,ULM,P011437,P013289,4.317,-4,4,8
72,ULM,P011437,P013290,23.517,-13,34,47
72,ULM,P011437,P013291,12.583,-14,15,29
72,ULM,P012077,P013289,8.633,-1,13,14
72,ULM,P012077,P013290,6.1,0,12,12
72,ULM,P012077,P013291,10.25,2,25,23
72,ULM,P013289,P013290,8.584,1,14,13
72,ULM,P013289,P013291,8.767,-1,15,16
72,ULM,P013290,P013291,16.683,-7,27,34
73,BUD,P004222,P005637,5.867,3,12,9
73,BUD,P004222,P006566,12.301,14,25,11
73,BUD,P004222,P010307,4.85,-1,6,7
73,BUD,P004222,P011150,13.334,7,24,17
73,BUD,P004222,P011281,11.384,5,21,16
73,BUD,P004222,P012606,8.467,0,14,14
73,BUD,P004222,P012630,5.167,2,9,7
73,BUD,P004222,P013256,12.634,6,21,15
73,BUD,P005637,P006561,4.784,-2,9,11
73,BUD,P005637,P006566,12.15,-3,24,27
73,BUD,P005637,P008325,7.166,-9,12,21
73,BUD,P005637,P010307,2.7,-4,2,6
73,BUD,P005637,P011150,17.817,-8,33,41
73,BUD,P005637,P011281,12.183,-3,23,26
73,BUD,P005637,P012606,5.634,-5,10,15
73,BUD,P005637,P012630,2.967,-1,7,8
73,BUD,P006561,P006566,2.267,-7,0,7
73,BUD,P006561,P010307,1.817,-1,2,3
73,BUD,P006561,P011150,4.784,-2,9,11
73,BUD,P006561,P011281,3.6,1,9,8
73,BUD,P006561,P012606,7.651,-6,14,20
73,BUD,P006561,P012630,7.334,-6,14,20
73,BUD,P006561,P013256,4.367,-5,7,12
73,BUD,P006566,P008325,6.283,-6,12,18
73,BUD,P006566,P011150,16.817,3,32,29
73,BUD,P006566,P011281,16.817,0,31,31
73,BUD,P006566,P012606,4.034,1,6,5
73,BUD,P006566,P012630,4.034,-2,5,7
73,BUD,P006566,P013256,8.701,4,13,9
73,BUD,P008325,P010307,4.783,-1,10,11
73,BUD,P008325,P011150,8.433,-5,18,23
73,BUD,P008325,P011281,6.283,-6,12,18
73,BUD,P008325,P012606,4.783,-1,10,11
73,BUD,P008325,P012630,2.633,-2,4,6
73,BUD,P008325,P013256,3.9,2,10,8
73,BUD,P010307,P011150,5.417,2,10,8
73,BUD,P010307,P012606,11.45,-3,18,21
73,BUD,P010307,P012630,6.033,-5,8,13
73,BUD,P010307,P013256,8.75,1,16,15
73,BUD,P011150,P011281,18.183,-5,31,36
73,BUD,P011150,P012606,12.284,-1,24,25
73,BUD,P011150,P012630,4.25,-2,8,10
73,BUD,P011150,P013256,10.017,7,19,12
73,BUD,P011281,P012606,4.733,-3,10,13
73,BUD,P011281,P012630,6.65,5,15,10
73,BUD,P011281,P013256,10.367,2,20,18
73,BUD,P012606,P012630,13.15,-11,21,32
73,BUD,P012606,P013256,16.55,-3,29,32
73,BUD,P012630,P013256,13.45,-6,21,27
73,JOV,P002361,P002507,8.75,14,25,11
73,JOV,P002361,P004834,5.55,-1,15,16
73,JOV,P002361,P005099,9.883,10,25,15
73,JOV,P002361,P006771,4.283,1,13,12
73,JOV,P002361,P009672,9.583,9,27,18
73,JOV,P002361,P010161,4.9,4,13,9
73,JOV,P002361,P012740,8.7,8,24,16
73,JOV,P002361,P013285,3.633,6,11,5
73,JOV,P002361,PJUG,2.65,1,7,6
73,JOV,P002507,P005099,15.116,9,34,25
73,JOV,P002507,P006771,6.65,4,11,7
73,JOV,P002507,P009672,11.2,9,21,12
73,JOV,P002507,P010161,11.45,6,26,20
73,JOV,P002507,P012740,9.651,8,18,10
73,JOV,P002507,P013285,16.083,9,33,24
73,JOV,P002507,P013286,1.45,-2,0,2
73,JOV,P002507,PJUG,10.25,3,20,17
73,JOV,P004834,P005099,8.734,-6,12,18
73,JOV,P004834,P006771,8.433,-3,19,22
73,JOV,P004834,P009672,10.617,-10,15,25
73,JOV,P004834,P010161,6.55,1,16,15
73,JOV,P004834,P012740,12.434,-7,23,30
73,JOV,P004834,P013285,9.35,-2,16,18
73,JOV,P004834,P013286,2.267,-6,0,6
73,JOV,P004834,PJUG,4.733,-2,8,10
73,JOV,P005099,P009672,11.783,1,16,15
73,JOV,P005099,P010161,12.25,2,30,28
73,JOV,P005099,P012740,10.734,3,19,16
73,JOV,P005099,P013285,16.816,1,32,31
73,JOV,P005099,P013286,0.967,-2,0,2
73,JOV,P005099,PJUG,9.849,-6,16,22
73,JOV,P006771,P009672,9.333,-4,18,22
73,JOV,P006771,P010161,5.75,5,12,7
73,JOV,P006771,P012740,10.65,-4,20,24
73,JOV,P006771,P013285,8.05,6,17,11
73,JOV,P006771,P013286,2.75,-6,0,6
73,JOV,P006771,PJUG,4.433,5,10,5
73,JOV,P009672,P012740,18.268,1,31,30
73,JOV,P009672,P013285,8.7,-2,9,11
73,JOV,P009672,P013286,3.717,-8,0,8
73,JOV,P009672,PJUG,4.799,0,7,7
73,JOV,P010161,P012740,4.0,0,10,10
73,JOV,P010161,P013285,16.733,9,40,31
73,JOV,P010161,PJUG,10.367,1,21,20
73,JOV,P012740,P013285,9.851,1,17,16
73,JOV,P012740,P013286,3.717,-8,0,8
73,JOV,P012740,PJUG,1.067,2,2,0
73,JOV,P013285,PJUG,12.516,0,21,21
74,TRN,P002387,P005438,2.3,-1,7,8
74,TRN,P002387,P006382,13.833,2,30,28
74,TRN,P002387,P006724,15.0,6,37,31
74,TRN,P002387,P012593,13.799,9,35,26
74,TRN,P002387,P012687,3.1,3,10,7
74,TRN,P002387,P013269,14.534,13,43,30
74,TRN,P002387,P013270,22.016,13,55,42
74,TRN,P002387,P013271,3.0,11,12,1
74,TRN,P002387,P013272,4.15,0,11,11
74,TRN,P005438,P006382,0.783,-3,0,3
74,TRN,P005438,P006724,5.716,-8,4,12
74,TRN,P005438,P012593,11.883,-23,16,39
74,TRN,P005438,P013269,13.717,-17,20,37
74,TRN,P005438,P013270,3.466,-2,4,6
74,TRN,P005438,P013271,7.084,-10,11,21
74,TRN,P005438,P013272,13.183,-20,18,38
74,TRN,P006382,P006724,9.617,-1,23,24
74,TRN,P006382,P012593,7.816,-3,15,18
74,TRN,P006382,P012687,1.35,2,4,2
74,TRN,P006382,P013269,7.383,-1,17,18
74,TRN,P006382,P013270,15.983,4,36,32
74,TRN,P006382,P013271,2.933,6,8,2
74,TRN,P006382,P013272,5.366,-2,11,13
74,TRN,P006724,P012593,14.433,-2,26,28
74,TRN,P006724,P012687,3.1,3,10,7
74,TRN,P006724,P013269,18.616,-9,33,42
74,TRN,P006724,P013270,19.867,8,45,37
74,TRN,P006724,P013272,8.783,-9,10,19
74,TRN,P012593,P013269,19.583,-11,37,48
74,TRN,P012593,P013270,15.799,10,36,26
74,TRN,P012593,P013271,7.783,-7,15,22
74,TRN,P012593,P013272,17.5,-21,28,49
74,TRN,P012687,P013269,1.75,1,6,5
74,TRN,P012687,P013270,3.1,3,10,7
74,TRN,P013269,P013270,19.733,16,48,32
74,TRN,P013269,P013271,11.283,1,25,24
74,TRN,P013269,P013272,17.733,-17,27,44
74,TRN,P013270,P013271,4.766,13,16,3
74,TRN,P013270,P013272,9.866,3,18,15
74,TRN,P013271,P013272,8.283,-10,13,23
74,WOL,P003212,P004645,0.033,0,0,0
74,WOL,P003212,P005516,0.85,-2,2,4
74,WOL,P003212,P006546,0.467,2,4,2
74,WOL,P003212,P006853,3.433,-1,9,10
74,WOL,P003212,P011248,4.684,-1,15,16
74,WOL,P003212,P012577,4.684,-1,15,16
74,WOL,P003212,P012789,4.717,-1,15,16
74,WOL,P004645,P005516,12.084,5,27,22
74,WOL,P004645,P006546,6.467,10,17,7
74,WOL,P004645,P006853,4.183,1,8,7
74,WOL,P004645,P008186,13.234,7,30,23
74,WOL,P004645,P011248,3.8,-2,8,10
74,WOL,P004645,P012003,13.234,7,30,23
74,WOL,P004645,P012789,0.033,0,0,0
74,WOL,P005516,P006546,11.267,16,29,13
74,WOL,P005516,P006853,14.233,10,29,19
74,WOL,P005516,P008186,17.268,-3,33,36
74,WOL,P005516,P011248,13.051,-4,25,29
74,WOL,P005516,P012003,17.501,-4,33,37
74,WOL,P005516,P012577,9.067,-6,14,20
74,WOL,P005516,P012789,8.483,8,20,12
74,WOL,P006546,P006853,8.617,5,23,18
74,WOL,P006546,P008186,9.417,6,19,13
74,WOL,P006546,P011248,10.634,3,27,24
74,WOL,P006546,P012003,12.034,5,28,23
74,WOL,P006546,P012577,2.017,-2,4,6
74,WOL,P006546,P012789,7.484,7,25,18
74,WOL,P006853,P008186,10.1,-3,16,19
74,WOL,P006853,P011248,19.833,13,49,36
74,WOL,P006853,P012003,15.233,2,33,31
74,WOL,P006853,P012577,13.466,6,29,23
74,WOL,P006853,P012789,15.966,15,44,29
74,WOL,P008186,P011248,9.083,-14,10,24
74,WOL,P008186,P012003,21.25,-3,38,41
74,WOL,P008186,P012577,6.916,-10,6,16
74,WOL,P011248,P012003,14.817,-14,27,41
74,WOL,P011248,P012577,14.684,-7,29,36
74,WOL,P011248,P012789,17.818,10,50,40
74,WOL,P012003,P012577,10.433,-11,14,25
74,WOL,P012003,P012789,6.234,-2,17,19
74,WOL,P012577,P012789,11.201,3,29,26
75,BES,P003783,P008945,16.567,3,28,25
75,BES,P003783,P009680,19.767,-3,40,43
75,BES,P003783,P010652,11.816,3,22,19
75,BES,P003783,P011379,11.05,1,18,17
75,BES,P003783,P011924,2.034,-2,0,2
75,BES,P003783,P011927,2.384,0,0,0
75,BES,P003783,P011936,17.384,4,35,31
75,BES,P003783,P013255,22.266,2,45,43
75,BES,P008945,P009680,14.2,4,31,27
75,BES,P008945,P010652,17.75,-7,27,34
75,BES,P008945,P011379,6.483,3,12,9
75,BES,P008945,P011924,10.834,-9,18,27
75,BES,P008945,P011927,10.684,0,20,20
75,BES,P008945,P011936,21.651,0,40,40
75,BES,P008945,P013255,14.899,6,32,26
75,BES,P009680,P010652,12.383,2,27,25
75,BES,P009680,P011379,8.884,-4,13,17
75,BES,P009680,P011924,5.201,-3,7,10
75,BES,P009680,P011927,2.05,6,6,0
75,BES,P009680,P011936,17.501,4,41,37
75,BES,P009680,P013255,20.35,2,47,45
75,BES,P010652,P011924,12.084,-10,21,31
75,BES,P010652,P011927,8.634,-6,14,20
75,BES,P010652,P011936,19.417,-9,36,45
75,BES,P010652,P013255,13.516,-1,25,26
75,BES,P011379,P011924,2.834,-2,0,2
75,BES,P011379,P011927,0.85,0,0,0
75,BES,P011379,P011936,8.117,5,13,8
75,BES,P011379,P013255,10.05,1,16,15
75,BES,P011924,P011927,8.917,-6,14,20
75,BES,P011924,P011936,13.318,-10,21,31
75,BES,P011924,P013255,5.318,-6,3,9
75,BES,P011927,P011936,10.684,0,20,20
75,BES,P011927,P013255,1.933,6,6,0
75,BES,P011936,P013255,18.2,6,42,36
75,CAN,P003425,P006588,25.316,14,52,38
75,CAN,P003425,P007560,0.217,1,1,0
75,CAN,P003425,P008121,25.316,14,52,38
75,CAN,P003425,P008966,14.133,5,29,24
75,CAN,P003425,P010452,0.483,0,2,2
75,CAN,P003425,P011251,15.25,9,35,26
75,CAN,P003425,P012016,10.683,7,19,12
75,CAN,P003425,P012095,9.866,6,18,12
75,CAN,P005005,P006588,3.834,-3,4,7
75,CAN,P005005,P008966,1.167,-5,0,5
75,CAN,P005005,P010452,4.216,-3,7,10
75,CAN,P005005,P010623,8.05,-6,11,17
75,CAN,P005005,P011251,7.167,-4,11,15
75,CAN,P005005,P012016,6.883,-1,11,12
75,CAN,P005005,P012095,0.883,-2,0,2
75,CAN,P006588,P007560,0.217,1,1,0
75,CAN,P006588,P008121,26.216,12,52,40
75,CAN,P006588,P008966,16.083,-2,29,31
75,CAN,P006588,P010452,0.483,0,2,2
75,CAN,P006588,P010623,6.017,-7,6,13
75,CAN,P006588,P011251,21.267,2,41,39
75,CAN,P006588,P012016,14.75,7,25,18
75,CAN,P006588,P012095,11.149,4,20,16
75,CAN,P007560,P008121,0.217,1,1,0
75,CAN,P007560,P012016,0.217,1,1,0
75,CAN,P008121,P008966,14.916,3,29,26
75,CAN,P008121,P010452,3.0,0,8,8
75,CAN,P008121,P010623,3.417,-2,6,8
75,CAN,P008121,P011251,18.667,7,41,34
75,CAN,P008121,P012016,13.317,7,25,18
75,CAN,P008121,P012095,9.866,6,18,12
75,CAN,P008966,P010623,1.95,-7,0,7
75,CAN,P008966,P011251,12.1,0,21,21
75,CAN,P008966,P012095,3.983,-2,8,10
75,CAN,P010452,P010623,8.666,-5,18,23
75,CAN,P010452,P011251,8.233,-4,19,23
75,CAN,P010452,P012016,8.666,-5,18,23
75,CAN,P010452,P012095,2.849,-3,6,9
75,CAN,P010623,P011251,13.8,-10,24,34
75,CAN,P010623,P012016,12.733,-5,24,29
75,CAN,P010623,P012095,4.099,-6,7,13
75,CAN,P011251,P012016,16.483,-2,35,37
75,CAN,P011251,P012095,3.233,-2,9,11
75,CAN,P012016,P012095,9.932,-1,14,15
76,BOU,P004525,P004945,21.267,3,46,43
76,BOU,P004525,P006904,4.399,-1,6,7
76,BOU,P004525,P009552,0.283,0,0,0
76,BOU,P004525,P010449,23.266,2,48,46
76,BOU,P004525,P010450,4.7,-5,7,12
76,BOU,P004525,P011837,18.867,4,38,34
76,BOU,P004525,P013264,2.9,-2,7,9
76,BOU,P004525,P013265,22.182,7,48,41
76,BOU,P004945,P006904,7.45,7,15,8
76,BOU,P004945,P009552,5.884,6,13,7
76,BOU,P004945,P010449,20.684,-2,44,46
76,BOU,P004945,P010450,10.351,1,20,19
76,BOU,P004945,P011837,17.717,-1,34,35
76,BOU,P004945,P013264,9.767,0,20,20
76,BOU,P004945,P013265,19.416,6,44,38
76,BOU,P006904,P009552,11.3,-1,19,20
76,BOU,P006904,P010449,11.866,-14,18,32
76,BOU,P006904,P010450,10.35,2,19,17
76,BOU,P006904,P011837,6.033,-4,12,16
76,BOU,P006904,P013264,16.117,-6,29,35
76,BOU,P006904,P013265,9.749,-11,14,25
76,BOU,P009552,P010449,5.45,-13,6,19
76,BOU,P009552,P010450,8.001,3,17,14
76,BOU,P009552,P013264,11.034,-4,19,23
76,BOU,P009552,P013265,3.316,-7,2,9
76,BOU,P010449,P010450,5.801,-11,9,20
76,BOU,P010449,P011837,22.984,-1,46,47
76,BOU,P010449,P013264,10.984,-20,19,39
76,BOU,P010449,P013265,29.165,-5,58,63
76,BOU,P010450,P011837,1.017,-5,0,5
76,BOU,P010450,P013264,10.368,-1,19,20
76,BOU,P010450,P013265,2.416,0,5,5
76,BOU,P011837,P013264,4.5,-7,8,15
76,BOU,P011837,P013265,22.35,2,46,44
76,BOU,P013264,P013265,8.066,-12,15,27
76,JER,P006625,P008912,18.05,-1,37,38
76,JER,P006625,P009879,12.9,-10,21,31
76,JER,P006625,P010431,8.384,-2,19,21
76,JER,P006625,P011970,20.601,0,43,43
76,JER,P006625,P013263,8.55,-1,14,15
76,JER,P006625,P013277,9.617,-1,18,19
76,JER,P006625,P013279,17.984,-4,38,42
76,JER,P006625,P013281,10.05,-1,18,19
76,JER,P008912,P009879,7.566,1,19,18
76,JER,P008912,P010431,10.4,18,35,17
76,JER,P008912,P011970,21.117,13,50,37
76,JER,P008912,P013263,6.733,10,22,12
76,JER,P008912,P013277,17.317,8,38,30
76,JER,P008912,P013279,21.65,5,46,41
76,JER,P008912,P013281,10.699,6,25,19
76,JER,P009879,P010431,12.266,1,27,26
76,JER,P009879,P011970,10.1,-7,15,22
76,JER,P009879,P013263,11.05,4,23,19
76,JER,P009879,P013277,0.85,0,0,0
76,JER,P009879,P013279,7.616,-9,12,21
76,JER,P009879,P013281,12.316,0,23,23
76,JER,P010431,P011970,13.317,3,30,27
76,JER,P010431,P013263,9.633,9,28,19
76,JER,P010431,P013277,5.6,8,15,7
76,JER,P010431,P013279,9.267,2,20,18
76,JER,P010431,P013281,6.733,5,18,13
76,JER,P011970,P013263,6.683,2,15,13
76,JER,P011970,P013277,18.167,8,38,30
76,JER,P011970,P013279,24.751,5,51,46
76,JER,P011970,P013281,11.0,4,22,18
76,JER,P013263,P013277,1.833,4,8,4
76,JER,P013263,P013281,7.05,4,14,10
76,JER,P013277,P013279,16.334,4,30,26
76,JER,P013277,P013281,2.95,1,5,4
76,JER,P013279,P013281,10.866,1,23,22
77,LJU,P003452,P003703,18.0,-10,35,45
77,LJU,P003452,P007641,0.983,-2,2,4
77,LJU,P003452,P009392,9.601,2,19,17
77,LJU,P003452,P009431,11.067,-1,29,30
77,LJU,P003452,P009753,4.667,-10,3,13
77,LJU,P003452,P012042,19.85,-3,42,45
77,LJU,P003452,P012700,9.666,-7,13,20
77,LJU,P003452,P012996,13.116,-4,22,26
77,LJU,P003452,P013260,10.45,-1,27,28
77,LJU,P003703,P007641,5.466,-9,13,22
77,LJU,P003703,P009392,11.817,-10,23,33
77,LJU,P003703,P009431,4.717,-2,16,18
77,LJU,P003703,P009753,1.834,-3,3,6
77,LJU,P003703,P012042,23.266,-14,49,63
77,LJU,P003703,P012700,6.783,-2,10,12
77,LJU,P003703,P012996,16.916,-13,28,41
77,LJU,P003703,P013260,5.933,-1,19,20
77,LJU,P007641,P009392,8.716,-6,22,28
77,LJU,P007641,P009431,2.766,2,6,4
77,LJU,P007641,P011261,1.833,4,6,2
77,LJU,P007641,P012042,7.616,-12,18,30
77,LJU,P007641,P012700,0.683,-2,0,2
77,LJU,P007641,P012996,9.749,-10,22,32
77,LJU,P007641,P013260,3.716,-5,7,12
77,LJU,P009392,P009431,7.467,9,20,11
77,LJU,P009392,P009753,3.551,-9,5,14
77,LJU,P009392,P011261,1.833,4,6,2
77,LJU,P009392,P012042,19.35,-17,39,56
77,LJU,P009392,P012700,5.05,-13,7,20
77,LJU,P009392,P012996,15.733,-17,30,47
77,LJU,P009392,P013260,10.35,-11,21,32
77,LJU,P009431,P009753,3.25,-9,0,9
77,LJU,P009431,P011261,1.833,4,6,2
77,LJU,P009431,P012042,6.95,7,25,18
77,LJU,P009431,P012700,6.666,-6,11,17
77,LJU,P009431,P012996,5.533,3,15,12
77,LJU,P009431,P013260,12.683,-3,32,35
77,LJU,P009753,P012042,3.134,-7,5,12
77,LJU,P009753,P012700,4.55,-13,2,15
77,LJU,P009753,P013260,4.55,-13,2,15
77,LJU,P011261,P012996,1.833,4,6,2
77,LJU,P012042,P012700,10.316,-13,14,27
77,LJU,P012042,P012996,20.499,-23,33,56
77,LJU,P012042,P013260,13.883,-10,35,45
77,LJU,P012700,P012996,11.666,-10,19,29
77,LJU,P012700,P013260,11.016,-18,16,34
77,LJU,P012996,P013260,9.083,-10,17,27
77,PAM,P004863,P005356,4.683,7,15,8
77,PAM,P004863,P006643,5.433,20,22,2
77,PAM,P004863,P007527,3.3,5,7,2
77,PAM,P004863,P010042,1.633,-6,0,6
77,PAM,P004863,P010393,2.283,7,7,0
77,PAM,P004863,P011980,4.067,11,15,4
77,PAM,P004863,P011982,4.833,-1,7,8
77,PAM,P004863,P012738,5.7,5,15,10
77,PAM,P005356,P006643,4.767,10,21,11
77,PAM,P005356,P007527,1.9,0,5,5
77,PAM,P005356,P010042,12.117,8,39,31
77,PAM,P005356,P010393,5.0,6,14,8
77,PAM,P005356,P010444,6.167,3,17,14
77,PAM,P005356,P010568,5.634,2,13,11
77,PAM,P005356,P010750,4.567,11,20,9
77,PAM,P005356,P011980,8.367,17,29,12
77,PAM,P005356,P011982,10.934,1,29,28
77,PAM,P005356,P012738,12.6,15,42,27
77,PAM,P006643,P007527,10.15,10,31,21
77,PAM,P006643,P010042,4.749,-1,14,15
77,PAM,P006643,P010393,8.966,5,24,19
77,PAM,P006643,P010444,5.801,3,18,15
77,PAM,P006643,P010568,4.684,-12,5,17
77,PAM,P006643,P010750,7.383,3,21,18
77,PAM,P006643,P011980,10.483,8,32,24
77,PAM,P006643,P011982,4.0,4,13,9
77,PAM,P006643,P012738,7.916,10,27,17
77,PAM,P007527,P010042,5.133,8,13,5
77,PAM,P007527,P010393,10.566,13,28,15
77,PAM,P007527,P010444,11.801,10,33,23
77,PAM,P007527,P010568,6.9,-7,12,19
77,PAM,P007527,P010750,3.717,8,16,8
77,PAM,P007527,P011980,11.217,-1,25,26
77,PAM,P007527,P011982,9.283,11,19,8
77,PAM,P007527,P012738,2.233,-1,3,4
77,PAM,P010042,P010393,10.499,11,26,15
77,PAM,P010042,P010444,6.467,11,20,9
77,PAM,P010042,P010568,1.617,3,6,3
77,PAM,P010042,P010750,5.85,10,23,13
77,PAM,P010042,P011980,3.75,11,15,4
77,PAM,P010042,P011982,13.85,11,39,28
77,PAM,P010042,P012738,12.199,2,33,31
77,PAM,P010393,P010444,6.4,7,19,12
77,PAM,P010393,P010568,4.6,-6,7,13
77,PAM,P010393,P010750,6.783,-2,17,19
77,PAM,P010393,P011980,4.566,-6,7,13
77,PAM,P010393,P011982,11.699,17,27,10
77,PAM,P010393,P012738,5.566,4,12,8
77,PAM,P010444,P010568,6.067,-6,9,15
77,PAM,P010444,P010750,6.834,14,28,14
77,PAM,P010444,P011980,9.668,6,26,20
77,PAM,P010444,P011982,5.067,4,10,6
77,PAM,P010568,P010750,2.383,-4,2,6
77,PAM,P010568,P011980,10.25,-14,14,28
77,PAM,P010568,P011982,4.784,-1,8,9
77,PAM,P010568,P012738,1.417,1,4,3
77,PAM,P010750,P011980,5.733,7,18,11
77,PAM,P010750,P011982,1.267,5,8,3
77,PAM,P010750,P012738,3.283,4,11,7
77,PAM,P011980,P011982,4.684,-3,5,8
77,PAM,P011980,P012738,5.283,12,18,6
77,PAM,P011982,P012738,10.467,0,27,27
78,ARI,P004292,P012638,8.2,-8,17,25
78,ARI,P004292,P013049,7.334,0,19,19
78,ARI,P004292,P013248,10.333,-11,13,24
78,ARI,P004292,P013252,16.084,-3,33,36
78,ARI,P004292,P013253,18.433,0,36,36
78,ARI,P004292,P013355,17.883,-6,33,39
78,ARI,P004292,P013356,19.216,-7,36,43
78,ARI,P004292,P013393,8.417,-8,8,16
78,ARI,P004292,P013395,14.1,-1,25,26
78,ARI,P012638,P013049,3.8,-8,6,14
78,ARI,P012638,P013248,5.817,-11,9,20
78,ARI,P012638,P013252,9.85,-8,17,25
78,ARI,P012638,P013253,6.567,-5,14,19
78,ARI,P012638,P013355,9.05,-8,16,24
78,ARI,P012638,P013356,6.167,-9,12,21
78,ARI,P012638,P013393,4.783,-7,4,11
78,ARI,P012638,P013395,8.434,-12,9,21
78,ARI,P013049,P013252,10.017,-11,19,30
78,ARI,P013049,P013253,5.783,-1,13,14
78,ARI,P013049,P013355,7.383,-5,11,16
78,ARI,P013049,P013356,7.25,0,18,18
78,ARI,P013049,P013393,2.784,-5,4,9
78,ARI,P013049,P013395,5.117,-10,6,16
78,ARI,P013248,P013253,6.201,-12,7,19
78,ARI,P013248,P013355,2.7,-6,7,13
78,ARI,P013248,P013356,7.2,-12,6,18
78,ARI,P013248,P013393,7.8,-8,6,14
78,ARI,P013248,P013395,5.817,-12,4,16
78,ARI,P013252,P013253,16.149,4,34,30
78,ARI,P013252,P013355,17.733,-8,27,35
78,ARI,P013252,P013356,10.417,-1,25,26
78,ARI,P013252,P013393,4.267,-6,6,12
78,ARI,P013252,P013395,15.283,-3,27,30
78,ARI,P013253,P013355,17.349,-2,36,38
78,ARI,P013253,P013356,12.4,-1,26,27
78,ARI,P013253,P013393,5.967,-4,6,10
78,ARI,P013253,P013395,14.883,1,28,27
78,ARI,P013355,P013356,8.216,-2,14,16
78,ARI,P013355,P013395,15.75,-7,28,35
78,ARI,P013356,P013393,9.05,-9,12,21
78,ARI,P013356,P013395,4.816,1,11,10
78,ARI,P013393,P013395,5.2,-9,2,11
78,HAM,P003242,P005478,4.75,1,9,8
78,HAM,P003242,P006006,3.483,4,13,9
78,HAM,P003242,P006420,7.083,11,22,11
78,HAM,P003242,P010070,2.967,-7,4,11
78,HAM,P003242,P011256,13.5,11,28,17
78,HAM,P003242,P013308,12.199,16,27,11
78,HAM,P003242,P013309,6.333,11,19,8
78,HAM,P003242,P013311,5.033,7,16,9
78,HAM,P003242,P013312,8.183,7,16,9
78,HAM,P003242,P013313,16.533,15,34,19
78,HAM,P005478,P006006,12.2,-4,29,33
78,HAM,P005478,P008103,13.716,-3,31,34
78,HAM,P005478,P010070,2.4,-8,2,10
78,HAM,P005478,P011256,4.066,1,10,9
78,HAM,P005478,P013308,9.616,2,24,22
78,HAM,P005478,P013309,9.633,2,19,17
78,HAM,P005478,P013311,11.217,-1,25,26
78,HAM,P005478,P013312,2.783,-1,6,7
78,HAM,P005478,P013313,3.483,3,5,2
78,HAM,P006006,P006420,3.916,2,12,10
78,HAM,P006006,P008103,12.633,-6,28,34
78,HAM,P006006,P010070,3.15,-13,2,15
78,HAM,P006006,P011256,3.083,-4,6,10
78,HAM,P006006,P013308,5.35,2,15,13
78,HAM,P006006,P013309,8.266,7,24,17
78,HAM,P006006,P013311,12.383,4,35,31
78,HAM,P006420,P008103,3.133,-3,4,7
78,HAM,P006420,P010070,4.667,0,10,10
78,HAM,P006420,P011256,6.267,-1,12,13
78,HAM,P006420,P013308,2.733,8,8,0
78,HAM,P006420,P013309,7.816,16,24,8
78,HAM,P006420,P013311,6.449,17,22,5
78,HAM,P006420,P013313,8.8,14,22,8
78,HAM,P008103,P010070,1.6,-9,0,9
78,HAM,P008103,P011256,5.149,-4,10,14
78,HAM,P008103,P013308,8.966,4,24,20
78,HAM,P008103,P013309,9.116,2,19,17
78,HAM,P008103,P013311,10.133,1,23,22
78,HAM,P008103,P013312,3.416,2,9,7
78,HAM,P008103,P013313,2.066,4,4,0
78,HAM,P010070,P011256,2.167,-8,2,10
78,HAM,P010070,P013309,2.5,8,8,0
78,HAM,P010070,P013311,4.9,0,10,10
78,HAM,P010070,P013313,3.917,5,10,5
78,HAM,P011256,P013308,15.115,16,34,18
78,HAM,P011256,P013309,1.367,-1,2,3
78,HAM,P011256,P013312,10.049,7,20,13
78,HAM,P011256,P013313,13.833,11,28,17
78,HAM,P013308,P013309,3.683,1,8,7
78,HAM,P013308,P013311,2.367,3,9,6
78,HAM,P013308,P013312,11.599,9,25,16
78,HAM,P013308,P013313,13.032,19,30,11
78,HAM,P013309,P013311,12.899,21,36,15
78,HAM,P013309,P013312,1.55,2,5,3
78,HAM,P013309,P013313,8.633,15,20,5
78,HAM,P013311,P013313,5.283,12,12,0
78,HAM,P013312,P013313,8.816,10,19,9
79,CLU,P002820,P004862,16.866,-7,39,46
79,CLU,P002820,P005714,15.117,6,38,32
79,CLU,P002820,P006618,9.516,3,19,16
79,CLU,P002820,P012620,9.299,-4,21,25
79,CLU,P002820,P012698,12.017,6,29,23
79,CLU,P002820,P013301,4.883,-1,11,12
79,CLU,P002820,P013302,19.817,3,51,48
79,CLU,P002820,P013304,19.417,-2,48,50
79,CLU,P004862,P005714,19.65,4,52,48
79,CLU,P004862,P006618,4.783,2,12,10
79,CLU,P004862,P012620,3.016,-8,5,13
79,CLU,P004862,P012698,8.917,0,24,24
79,CLU,P004862,P013302,22.45,-4,57,61
79,CLU,P004862,P013304,18.85,-7,47,54
79,CLU,P005714,P006618,8.85,4,25,21
79,CLU,P005714,P012620,3.933,2,13,11
79,CLU,P005714,P012698,13.284,7,41,34
79,CLU,P005714,P013301,0.483,0,2,2
79,CLU,P005714,P013302,24.984,11,67,56
79,CLU,P005714,P013304,16.967,6,46,40
79,CLU,P006618,P012620,13.615,8,32,24
79,CLU,P006618,P012698,19.882,10,47,37
79,CLU,P006618,P013301,7.449,1,15,14
79,CLU,P006618,P013302,10.667,10,32,22
79,CLU,P006618,P013304,4.766,2,6,4
79,CLU,P012620,P012698,13.615,8,32,24
79,CLU,P012620,P013301,7.449,1,15,14
79,CLU,P012620,P013302,6.666,-1,22,23
79,CLU,P012620,P013304,5.599,-6,8,14
79,CLU,P012698,P013301,7.449,1,15,14
79,CLU,P012698,P013302,15.801,12,48,36
79,CLU,P012698,P013304,10.167,4,24,20
79,CLU,P013301,P013304,2.083,2,2,0
79,CLU,P013302,P013304,21.683,-3,55,58
79,LKB,P005113,P005521,10.467,10,32,22
79,LKB,P005113,P005656,24.584,8,66,58
79,LKB,P005113,P006586,10.284,7,29,22
79,LKB,P005113,P009299,21.984,5,61,56
79,LKB,P005113,P009898,11.967,0,24,24
79,LKB,P005113,P013247,11.6,5,39,34
79,LKB,P005113,PLXI,7.45,-3,13,16
79,LKB,P005521,P005656,11.7,12,36,24
79,LKB,P005521,P006586,5.434,0,12,12
79,LKB,P005521,P006860,7.95,-8,12,20
79,LKB,P005521,P009299,12.05,3,36,33
79,LKB,P005521,P009898,4.933,3,12,9
79,LKB,P005521,P010181,2.6,0,2,2
79,LKB,P005521,P010461,9.183,-6,16,22
79,LKB,P005521,P013247,12.483,2,30,28
79,LKB,P005521,PLXI,1.8,0,4,4
79,LKB,P005656,P006586,13.018,6,36,30
79,LKB,P005656,P009299,24.584,5,69,64
79,LKB,P005656,P009898,13.234,0,26,26
79,LKB,P005656,P010461,3.867,0,10,10
79,LKB,P005656,P013247,14.1,4,46,42
79,LKB,P005656,PLXI,8.717,-3,15,18
79,LKB,P006586,P006860,6.167,-14,8,22
79,LKB,P006586,P009299,10.268,-2,31,33
79,LKB,P006586,P009898,6.267,-11,7,18
79,LKB,P006586,P010461,8.901,-15,15,30
79,LKB,P006586,P013247,10.684,4,31,27
79,LKB,P006586,PLXI,5.717,-7,7,14
79,LKB,P006860,P009299,2.1,-6,5,11
79,LKB,P006860,P009898,3.833,-6,6,12
79,LKB,P006860,P010181,2.6,0,2,2
79,LKB,P006860,P010461,11.55,-15,17,32
79,LKB,P006860,P013247,6.6,-4,9,13
79,LKB,P006860,PLXI,5.4,-7,9,16
79,LKB,P009299,P009898,11.117,0,24,24
79,LKB,P009299,P010461,4.7,-6,13,19
79,LKB,P009299,P013247,13.333,0,44,44
79,LKB,P009299,PLXI,6.6,-3,13,16
79,LKB,P009898,P010461,5.1,-6,8,14
79,LKB,P009898,PLXI,11.817,-4,21,25
79,LKB,P010181,P010461,2.6,0,2,2
79,LKB,P010181,P013247,2.6,0,2,2
79,LKB,P010461,P013247,9.1,-5,16,21
79,LKB,P010461,PLXI,6.667,-7,11,18
79,LKB,P013247,PLXI,2.3,-6,3,9
80,TTK,P004056,P004619,6.501,6,17,11
80,TTK,P004056,P006598,1.467,-1,1,2
80,TTK,P004056,P007917,2.467,1,6,5
80,TTK,P004056,P009025,12.25,2,27,25
80,TTK,P004056,P010465,9.734,4,25,21
80,TTK,P004056,P010587,6.45,2,12,10
80,TTK,P004056,P011935,4.55,0,10,10
80,TTK,P004056,P011973,1.316,-3,1,4
80,TTK,P004056,P013300,4.733,1,13,12
80,TTK,P004619,P006598,2.167,-2,4,6
80,TTK,P004619,P007917,4.65,-1,8,9
80,TTK,P004619,P009025,9.001,2,19,17
80,TTK,P004619,P010465,6.784,6,15,9
80,TTK,P004619,P010587,4.767,-3,7,10
80,TTK,P004619,P011973,0.867,0,2,2
80,TTK,P004619,P012415,1.184,-2,2,4
80,TTK,P004619,P013300,3.551,2,10,8
80,TTK,P006598,P007917,1.3,-2,2,4
80,TTK,P006598,P009025,3.733,-6,2,8
80,TTK,P006598,P010465,1.2,-1,1,2
80,TTK,P006598,P010587,5.133,-7,3,10
80,TTK,P006598,P011935,4.016,-5,1,6
80,TTK,P006598,P011973,2.333,-2,2,4
80,TTK,P006598,P012415,1.05,0,2,2
80,TTK,P006598,P013300,2.333,-2,2,4
80,TTK,P007917,P009025,6.217,-3,8,11
80,TTK,P007917,P010465,6.167,-6,6,12
80,TTK,P007917,P010587,4.0,-7,2,9
80,TTK,P007917,P011935,1.034,-1,0,1
80,TTK,P007917,P011973,1.783,-6,0,6
80,TTK,P007917,P013300,2.25,-7,0,7
80,TTK,P009025,P010465,32.049,3,59,56
80,TTK,P009025,P010587,19.199,-3,35,38
80,TTK,P009025,P011935,21.932,1,40,39
80,TTK,P009025,P011973,18.482,-3,30,33
80,TTK,P009025,P012415,3.367,-2,4,6
80,TTK,P009025,P013300,18.966,1,32,31
80,TTK,P010465,P010587,16.316,-2,31,33
80,TTK,P010465,P011935,21.166,3,41,38
80,TTK,P010465,P011973,18.582,-8,29,37
80,TTK,P010465,P012415,3.05,0,4,4
80,TTK,P010465,P013300,18.616,-3,29,32
80,TTK,P010587,P011935,15.616,-3,28,31
80,TTK,P010587,P011973,8.732,-5,17,22
80,TTK,P010587,P012415,0.317,-2,0,2
80,TTK,P010587,P013300,6.866,-6,9,15
80,TTK,P011935,P011973,14.582,0,25,25
80,TTK,P011935,P012415,0.183,0,0,0
80,TTK,P011935,P013300,12.849,1,19,18
80,TTK,P011973,P012415,4.1,0,6,6
80,TTK,P011973,P013300,15.615,-9,16,25
80,TTK,P012415,P013300,4.417,-2,6,8
80,VNC,P003759,P005177,10.183,4,17,13
80,VNC,P003759,P005404,5.483,1,8,7
80,VNC,P003759,P008052,4.783,4,8,4
80,VNC,P003759,P009400,1.733,-2,4,6
80,VNC,P003759,P011909,4.2,0,4,4
80,VNC,P003759,P011928,7.6,-3,13,16
80,VNC,P003759,P012800,7.367,-1,13,14
80,VNC,P003759,P013305,8.183,1,17,16
80,VNC,P005177,P005404,5.016,2,8,6
80,VNC,P005177,P008052,8.8,10,20,10
80,VNC,P005177,P011909,10.334,8,20,12
80,VNC,P005177,P011928,8.117,3,16,13
80,VNC,P005177,P012796,6.734,9,19,10
80,VNC,P005177,P012800,11.901,11,28,17
80,VNC,P005177,P013305,6.583,5,16,11
80,VNC,P005404,P008052,8.999,14,26,12
80,VNC,P005404,P011909,5.199,7,16,9
80,VNC,P005404,P011928,2.4,-4,0,4
80,VNC,P005404,P012796,5.366,10,18,8
80,VNC,P005404,P012800,5.0,8,16,8
80,VNC,P005404,P013305,5.933,6,12,6
80,VNC,P008052,P009400,3.65,-10,4,14
80,VNC,P008052,P011909,11.733,9,32,23
80,VNC,P008052,P011928,0.55,-1,0,1
80,VNC,P008052,P012796,13.516,6,34,28
80,VNC,P008052,P012800,13.833,5,32,27
80,VNC,P008052,P013305,7.332,3,12,9
80,VNC,P009400,P011909,7.4,-8,8,16
80,VNC,P009400,P011928,13.116,-4,17,21
80,VNC,P009400,P012796,15.033,-12,17,29
80,VNC,P009400,P012800,16.766,-14,21,35
80,VNC,P009400,P013305,9.366,-6,13,19
80,VNC,P011909,P011928,10.3,0,12,12
80,VNC,P011909,P012796,17.833,9,40,31
80,VNC,P011909,P012800,20.367,9,42,33
80,VNC,P011909,P013305,0.766,2,2,0
80,VNC,P011928,P012796,14.65,0,20,20
80,VNC,P011928,P012800,20.317,0,33,33
80,VNC,P011928,P013305,11.95,-3,21,24
80,VNC,P012796,P012800,26.783,6,52,46
80,VNC,P012796,P013305,10.549,0,16,16
80,VNC,P012800,P013305,14.266,-4,23,27
