Gamecode,CODETEAM,J1,TIME,DELTA_SCORE,OFF,DEF
1,HAM,P001990,13.934,4,25,21
1,HAM,P009663,17.168,-9,31,40
1,HAM,P011168,26.068,-24,52,76
1,HAM,P011187,22.834,-11,46,57
1,HAM,P012578,19.201,-4,36,40
1,HAM,P012579,17.584,-12,29,41
1,HAM,P012580,26.001,-11,49,60
1,HAM,P012581,24.085,-13,41,54
1,HAM,P012582,22.101,-14,53,67
1,HAM,P012648,8.567,-7,16,23
1,HAM,P012694,2.467,1,7,6
1,PMT,P001686,15.083,10,42,32
1,PMT,P002020,23.55,7,50,43
1,PMT,P002644,25.583,9,54,45
1,PMT,P011066,24.149,15,64,49
1,PMT,P011823,14.417,11,43,32
1,PMT,P011943,13.284,6,34,28
1,PMT,P011944,20.632,10,49,39
1,PMT,P011947,6.75,-4,14,18
1,PMT,P011966,15.851,5,33,28
1,PMT,P012599,23.632,13,56,43
1,PMT,P012600,15.702,15,41,26
1,PMT,P012601,1.367,3,5,2
2,LLI,P004479,25.1,11,48,37
2,LLI,P004773,17.267,-7,27,34
2,LLI,P005247,22.949,15,52,37
2,LLI,P006600,21.367,-7,33,40
2,LLI,P009649,23.701,0,40,40
2,LLI,P009680,20.4,-1,38,39
2,LLI,P012020,18.633,14,43,29
2,LLI,P012585,20.4,7,42,35
2,LLI,P012586,30.183,3,57,54
2,VNC,P003759,23.134,8,48,40
2,VNC,P004117,18.151,-15,25,40
2,VNC,P004381,27.167,2,49,47
2,VNC,P009400,12.733,-22,12,34
2,VNC,P011909,30.784,11,62,51
2,VNC,P011928,37.784,-5,65,70
2,VNC,P012587,10.167,-10,15,25
2,VNC,P012590,15.818,-10,23,33
2,VNC,P012591,24.267,6,46,40
3,PRS,P003481,16.366,7,41,34
3,PRS,P004512,16.983,20,49,29
3,PRS,P005793,22.033,13,61,48
3,PRS,P010801,3.083,-4,6,10
3,PRS,P011551,1.533,-3,0,3
3,PRS,P011887,13.65,10,38,28
3,PRS,P012608,22.733,19,61,42
3,PRS,P012609,21.249,7,56,49
3,PRS,P012610,20.916,22,55,33
3,PRS,P012611,21.749,12,54,42
3,PRS,P012613,19.067,20,51,31
3,PRS,P012640,20.633,12,53,41
3,WOL,P002333,13.467,-3,31,34
3,WOL,P002387,29.918,-33,55,88
3,WOL,P004229,5.7,-4,7,11
3,WOL,P004645,3.033,-3,6,9
3,WOL,P005516,24.017,-12,45,57
3,WOL,P006154,23.267,-1,55,56
3,WOL,P006907,3.083,4,10,6
3,WOL,P008104,23.551,-23,47,70
3,WOL,P011150,32.068,-24,61,85
3,WOL,P012576,20.167,-18,40,58
3,WOL,P012577,21.734,-18,33,51
4,HTA,P003533,25.386,25,63,38
4,HTA,P004846,17.752,10,47,37
4,HTA,P006835,24.152,19,63,44
4,HTA,P007759,28.152,23,74,51
4,HTA,P010465,24.734,14,59,45
4,HTA,P010550,27.635,15,71,56
4,HTA,P011990,16.435,12,40,28
4,HTA,P011991,31.119,24,80,56
4,HTA,P012028,0.867,-2,0,2
4,HTA,P012592,1.983,-3,3,6
4,HTA,P012706,1.8,-2,0,2
4,LJU,P002561,2.85,-4,0,4
4,LJU,P003452,26.05,-22,51,73
4,LJU,P005969,33.618,-15,68,83
4,LJU,P007066,13.017,-8,21,29
4,LJU,P008883,19.685,-8,34,42
4,LJU,P009395,29.234,-21,54,75
4,LJU,P010594,11.834,-2,22,24
4,LJU,P010771,1.183,-4,1,5
4,LJU,P011261,16.283,-16,28,44
4,LJU,P012598,24.734,-19,48,67
4,LJU,P012700,21.517,-16,38,54
5,BES,P003783,33.566,9,54,45
5,BES,P007914,30.167,8,52,44
5,BES,P007917,30.3,-3,47,50
5,BES,P008945,8.133,-6,12,18
5,BES,P009582,26.55,-3,43,46
5,BES,P011357,10.984,-1,21,22
5,BES,P011379,10.384,4,17,13
5,BES,P011936,28.117,2,42,40
5,BES,P012647,21.799,-5,27,32
5,JOV,P002361,23.201,0,37,37
5,JOV,P002507,22.867,3,34,31
5,JOV,P005094,22.118,4,32,28
5,JOV,P006771,16.818,-2,20,22
5,JOV,P010161,12.534,-4,24,28
5,JOV,P010166,12.883,12,25,13
5,JOV,P010458,12.651,-14,17,31
5,JOV,P010709,0.217,2,2,0
5,JOV,P011247,24.901,-4,36,40
5,JOV,P011248,18.033,7,30,23
5,JOV,P012076,15.968,0,28,28
5,JOV,PJUG,17.819,-9,25,34
6,BOU,P004525,20.166,19,46,27
6,BOU,P010431,21.467,3,52,49
6,BOU,P010449,24.65,13,63,50
6,BOU,P010450,17.166,5,33,28
6,BOU,P010718,20.599,16,47,31
6,BOU,P011161,13.066,5,23,18
6,BOU,P011836,19.833,-3,44,47
6,BOU,P011837,18.551,8,46,38
6,BOU,P012619,21.448,8,44,36
6,BOU,P012628,23.049,6,52,46
6,WRO,P001694,29.733,-1,58,59
6,WRO,P003034,15.167,-18,21,39
6,WRO,P005531,27.916,-5,60,65
6,WRO,P009896,33.033,-10,63,73
6,WRO,P011900,21.168,-14,37,51
6,WRO,P012308,1.7,-1,2,3
6,WRO,P012699,21.449,-6,41,47
6,WRO,P012735,28.484,-14,50,64
6,WRO,P012736,21.35,-11,38,49
7,CLU,P004862,29.149,2,59,57
7,CLU,P005113,16.499,10,40,30
7,CLU,P005373,15.918,-7,24,31
7,CLU,P005714,19.0,11,39,28
7,CLU,P010569,28.583,4,57,53
7,CLU,P011797,23.3,9,44,35
7,CLU,P011801,23.484,9,48,39
7,CLU,P012620,1.517,-3,0,3
7,CLU,P012621,28.449,15,64,49
7,CLU,P012698,14.101,-5,25,30
7,TTK,P000497,2.183,-5,0,5
7,TTK,P004801,12.318,-7,23,30
7,TTK,P005000,30.502,-14,53,67
7,TTK,P005685,12.151,9,26,17
7,TTK,P006693,16.451,-8,25,33
7,TTK,P009845,11.767,-5,21,26
7,TTK,P011239,14.467,-16,16,32
7,TTK,P011834,30.735,2,56,54
7,TTK,P011925,27.634,-2,48,50
7,TTK,P012056,21.884,-2,42,44
7,TTK,P012697,19.918,3,45,42
8,BUD,P002740,22.801,9,44,35
8,BUD,P004397,4.55,-1,7,8
8,BUD,P004945,24.518,14,50,36
8,BUD,P006561,4.267,-4,5,9
8,BUD,P006566,9.084,17,25,8
8,BUD,P007398,17.2,2,32,30
8,BUD,P010248,18.117,4,32,28
8,BUD,P010432,20.867,10,44,34
8,BUD,P011935,23.117,-4,39,43
8,BUD,P012605,15.434,1,28,27
8,BUD,P012606,24.567,10,48,38
8,BUD,P012630,15.483,-3,26,29
8,LKB,P002012,31.768,-13,52,65
8,LKB,P004664,28.717,-11,43,54
8,LKB,P005521,22.769,-18,34,52
8,LKB,P006230,17.95,-4,35,39
8,LKB,P007029,32.368,-15,47,62
8,LKB,P008856,14.752,-3,23,26
8,LKB,P010461,21.785,-7,30,37
8,LKB,P012583,8.234,2,13,11
8,LKB,PLXI,21.667,14,48,34
9,ARI,P002867,12.416,-10,19,29
9,ARI,P003240,28.649,-14,44,58
9,ARI,P004292,22.217,-4,41,45
9,ARI,P012615,23.632,-9,37,46
9,ARI,P012616,1.1,2,2,0
9,ARI,P012702,17.849,-11,27,38
9,ARI,P012707,11.398,-1,25,26
9,ARI,P012708,30.998,-6,52,58
9,ARI,P012716,25.048,-14,41,55
9,ARI,P012717,9.5,-5,14,19
9,ARI,P012722,17.183,-8,28,36
9,CAN,P001607,13.717,-14,20,34
9,CAN,P003425,26.285,30,62,32
9,CAN,P003637,19.284,13,47,34
9,CAN,P004160,9.068,0,17,17
9,CAN,P005005,19.584,14,48,34
9,CAN,P006588,19.018,3,40,37
9,CAN,P007560,15.567,7,28,21
9,CAN,P007644,16.285,-6,30,36
9,CAN,P008121,16.501,-2,24,26
9,CAN,P010385,22.267,21,46,25
9,CAN,P010452,20.051,19,46,27
9,CAN,P010484,2.383,-5,2,7
10,TRN,P001479,13.368,-3,23,26
10,TRN,P005059,30.518,-2,56,58
10,TRN,P005738,26.501,-7,47,54
10,TRN,P006382,13.917,-12,23,35
10,TRN,P009903,23.734,-2,43,45
10,TRN,P012593,15.734,-2,24,26
10,TRN,P012594,11.701,-6,17,23
10,TRN,P012595,24.435,2,49,47
10,TRN,P012596,16.268,-8,27,35
10,TRN,P012597,23.834,-10,41,51
10,ULM,P005422,23.467,2,44,42
10,ULM,P007952,3.617,-5,8,13
10,ULM,P010106,22.417,-7,38,45
10,ULM,P010582,28.967,5,56,51
10,ULM,P010726,4.066,0,9,9
10,ULM,P011391,10.001,9,24,15
10,ULM,P011457,13.117,1,25,24
10,ULM,P012603,28.301,13,59,46
10,ULM,P012604,26.383,6,48,42
10,ULM,P012629,22.085,9,47,38
10,ULM,P012703,17.584,17,42,25
11,BES,P003783,28.35,12,66,54
11,BES,P007914,27.932,17,68,51
11,BES,P007917,16.833,23,52,29
11,BES,P009582,26.784,2,52,50
11,BES,P011357,17.967,13,41,28
11,BES,P011379,4.683,6,13,7
11,BES,P011936,30.867,9,61,52
11,BES,P012233,1.45,5,6,1
11,BES,P012622,24.334,11,52,41
11,BES,P012624,0.683,2,3,1
11,BES,P012647,20.117,10,46,36
11,PMT,P001686,23.683,-5,44,49
11,PMT,P002644,17.032,-17,33,50
11,PMT,P009559,20.682,-19,34,53
11,PMT,P011066,19.501,-3,32,35
11,PMT,P011823,22.966,-5,37,42
11,PMT,P011943,11.248,-15,17,32
11,PMT,P011944,21.883,8,42,34
11,PMT,P011947,16.299,-14,28,42
11,PMT,P011966,17.348,-15,35,50
11,PMT,P012599,15.449,-4,23,27
11,PMT,P012600,13.899,-21,25,46
12,JOV,P002361,33.684,3,68,65
12,JOV,P002507,21.784,-2,40,42
12,JOV,P005094,34.134,7,68,61
12,JOV,P006771,8.434,-4,14,18
12,JOV,P010161,2.367,-1,6,7
12,JOV,P010166,8.233,-4,12,16
12,JOV,P010458,36.752,5,76,71
12,JOV,P010709,2.067,-4,1,5
12,JOV,P011247,32.902,9,66,57
12,JOV,P012076,23.235,3,48,45
12,JOV,PJUG,21.418,-7,41,48
12,LJU,P001235,0.017,0,0,0
12,LJU,P002561,6.4,8,12,4
12,LJU,P003452,33.383,-7,66,73
12,LJU,P005969,40.615,2,84,82
12,LJU,P007066,15.049,-2,22,24
12,LJU,P008883,30.799,3,61,58
12,LJU,P009395,35.216,0,71,71
12,LJU,P010594,4.433,6,10,4
12,LJU,P011261,4.133,-7,0,7
12,LJU,P012598,36.7,-5,74,79
12,LJU,P012700,18.25,-3,35,38
13,HTA,P003533,15.465,4,35,31
13,HTA,P004267,36.115,17,85,68
13,HTA,P004846,34.115,11,77,66
13,HTA,P007759,35.299,7,77,70
13,HTA,P010550,31.382,9,73,64
13,HTA,P011973,29.4,11,64,53
13,HTA,P011990,11.515,-4,24,28
13,HTA,P012592,1.983,-6,0,6
13,HTA,P012706,4.716,-4,10,14
13,WOL,P002387,23.434,-1,47,48
13,WOL,P003212,19.5,-8,37,45
13,WOL,P004229,12.883,-11,22,33
13,WOL,P005516,21.501,-3,43,46
13,WOL,P006154,4.967,-1,10,11
13,WOL,P006546,30.368,-4,60,64
13,WOL,P006907,7.184,-8,13,21
13,WOL,P011150,30.801,-3,66,69
13,WOL,P012576,25.901,1,53,52
13,WOL,P012577,20.133,-8,39,47
13,WOL,PLCT,3.333,1,10,9
14,PRS,P003481,13.549,6,29,23
14,PRS,P004512,13.183,-2,24,26
14,PRS,P005793,21.417,-4,43,47
14,PRS,P011887,5.401,-1,5,6
14,PRS,P012608,27.483,1,54,53
14,PRS,P012609,25.083,14,58,44
14,PRS,P012610,25.549,3,55,52
14,PRS,P012611,21.549,3,48,45
14,PRS,P012613,25.282,9,48,39
14,PRS,P012640,21.499,1,41,40
14,VNC,P000968,29.266,-3,62,65
14,VNC,P003759,33.166,2,65,63
14,VNC,P004117,13.349,-17,12,29
14,VNC,P009400,18.716,-12,29,41
14,VNC,P011909,25.683,2,53,51
14,VNC,P011928,33.483,3,73,70
14,VNC,P012587,0.3,2,2,0
14,VNC,P012590,11.116,-5,13,18
14,VNC,P012591,34.916,-2,66,68
15,HAM,P009663,23.349,-2,56,58
15,HAM,P010070,1.15,0,0,0
15,HAM,P011168,30.199,-16,72,88
15,HAM,P011187,27.082,5,63,58
15,HAM,P012578,9.766,7,22,15
15,HAM,P012579,19.098,-3,49,52
15,HAM,P012580,24.598,-6,56,62
15,HAM,P012581,15.766,-5,37,42
15,HAM,P012582,22.983,-2,57,59
15,HAM,P012648,14.4,-4,32,36
15,HAM,P012694,10.466,-8,22,30
15,HAM,P012695,1.133,4,4,0
15,LLI,P004479,12.766,-5,26,31
15,LLI,P004773,14.766,-3,28,31
15,LLI,P005247,20.115,-1,48,49
15,LLI,P006600,30.766,4,77,73
15,LLI,P009649,28.515,4,71,67
15,LLI,P009680,23.015,11,63,52
15,LLI,P012020,9.232,2,23,21
15,LLI,P012585,33.666,13,93,80
15,LLI,P012586,27.149,5,71,66
16,BOU,P004525,20.999,0,33,33
16,BOU,P010431,18.834,4,40,36
16,BOU,P010449,25.317,15,50,35
16,BOU,P010450,19.316,1,30,29
16,BOU,P010718,17.433,-12,25,37
16,BOU,P011161,14.683,-8,29,37
16,BOU,P011836,30.718,20,66,46
16,BOU,P011837,19.017,6,48,42
16,BOU,P012619,7.683,-9,9,18
16,BOU,P012628,26.0,18,65,47
16,TRN,P001479,11.416,4,17,13
16,TRN,P005059,26.583,-7,49,56
16,TRN,P005738,28.583,-11,55,66
16,TRN,P006382,15.082,-3,20,23
16,TRN,P009903,27.15,-3,53,56
16,TRN,P012593,20.283,-6,38,44
16,TRN,P012594,17.566,-7,27,34
16,TRN,P012595,30.199,1,59,58
16,TRN,P012596,12.849,-4,19,23
16,TRN,P012597,10.284,1,23,22
17,CAN,P001607,20.651,3,57,54
17,CAN,P003425,18.183,22,48,26
17,CAN,P003637,13.567,18,37,19
17,CAN,P005005,25.234,16,75,59
17,CAN,P006588,21.818,20,67,47
17,CAN,P007560,24.451,13,65,52
17,CAN,P007644,9.783,2,27,25
17,CAN,P008121,14.734,17,45,28
17,CAN,P009864,16.284,14,48,34
17,CAN,P010385,13.817,14,34,20
17,CAN,P010452,15.3,2,36,34
17,CAN,P010484,6.183,4,16,12
17,ULM,P004744,4.817,0,10,10
17,ULM,P005422,26.134,-6,64,70
17,ULM,P007952,17.899,-16,34,50
17,ULM,P010106,19.1,-21,33,54
17,ULM,P010582,22.4,-18,44,62
17,ULM,P010726,6.517,-9,10,19
17,ULM,P011391,17.285,-13,38,51
17,ULM,P011457,7.484,-9,13,22
17,ULM,P012603,30.834,-19,66,85
17,ULM,P012629,22.467,-19,46,65
17,ULM,P012703,25.068,-15,52,67
18,ARI,P002867,13.166,4,22,18
18,ARI,P003240,25.2,-17,45,62
18,ARI,P004292,27.016,9,56,47
18,ARI,P012615,16.45,-3,27,30
18,ARI,P012702,22.548,-2,48,50
18,ARI,P012707,17.416,-10,29,39
18,ARI,P012708,29.482,-13,60,73
18,ARI,P012716,24.566,-3,43,46
18,ARI,P012717,10.666,-11,18,29
18,ARI,P012722,13.485,-4,22,26
18,LKB,P002012,32.602,10,73,63
18,LKB,P004664,22.118,8,50,42
18,LKB,P005521,18.6,2,35,33
18,LKB,P006230,17.318,10,37,27
18,LKB,P006901,1.567,2,4,2
18,LKB,P007029,33.751,20,80,60
18,LKB,P008856,19.401,3,39,36
18,LKB,P010190,1.484,-2,2,4
18,LKB,P010461,16.317,12,38,26
18,LKB,P011329,0.017,0,0,0
18,LKB,P012583,9.834,-13,12,25
18,LKB,PLXI,27.001,-2,50,52
19,BUD,P002740,16.867,-5,29,34
19,BUD,P004945,27.485,-5,50,55
19,BUD,P006561,17.734,2,34,32
19,BUD,P007398,17.15,-2,33,35
19,BUD,P009214,5.134,-1,11,12
19,BUD,P010248,15.134,-1,27,28
19,BUD,P010432,23.2,0,47,47
19,BUD,P011935,18.283,-4,35,39
19,BUD,P012605,14.467,-1,28,29
19,BUD,P012606,25.534,-1,49,50
19,BUD,P012630,19.017,8,42,34
19,TTK,P004801,13.833,-2,28,30
19,TTK,P005000,22.5,3,46,43
19,TTK,P005685,10.783,6,27,21
19,TTK,P006693,14.733,6,32,26
19,TTK,P011239,29.216,-4,52,56
19,TTK,P011834,30.066,6,61,55
19,TTK,P011925,30.866,-1,56,57
19,TTK,P012056,22.732,0,46,46
19,TTK,P012697,25.266,-4,47,51
20,CLU,P004862,31.417,8,60,52
20,CLU,P005113,23.4,12,51,39
20,CLU,P005373,13.383,-5,17,22
20,CLU,P005714,19.782,1,30,29
20,CLU,P010569,19.85,-2,36,38
20,CLU,P011797,25.6,5,48,43
20,CLU,P011801,12.682,-3,17,20
20,CLU,P012620,4.016,-6,2,8
20,CLU,P012621,27.9,7,57,50
20,CLU,P012698,21.965,-2,32,34
20,WRO,P001694,35.451,-9,59,68
20,WRO,P003034,13.266,-3,19,22
20,WRO,P005531,30.701,-5,55,60
20,WRO,P009896,30.75,4,54,50
20,WRO,P011900,18.617,-9,29,38
20,WRO,P012699,27.533,1,45,44
20,WRO,P012735,22.567,12,47,35
20,WRO,P012736,13.699,-2,18,20
20,WRO,P012749,7.416,-4,9,13
21,LLI,P004479,5.517,-11,6,17
21,LLI,P004773,10.733,-11,18,29
21,LLI,P005247,10.566,-14,14,28
21,LLI,P006600,31.4,11,76,65
21,LLI,P009649,29.434,26,85,59
21,LLI,P009672,22.05,0,52,52
21,LLI,P009680,20.683,10,51,41
21,LLI,P012020,7.2,3,21,18
21,LLI,P012585,29.267,23,81,58
21,LLI,P012586,33.15,23,91,68
21,PMT,P001686,17.216,-2,36,38
21,PMT,P002020,6.801,-4,15,19
21,PMT,P002644,25.116,-11,52,63
21,PMT,P009559,17.967,-13,40,53
21,PMT,P011066,28.066,-12,64,76
21,PMT,P011823,23.917,2,55,53
21,PMT,P011943,21.184,-15,40,55
21,PMT,P011944,22.5,2,52,50
21,PMT,P011946,2.266,-2,2,4
21,PMT,P011966,15.834,-9,31,40
21,PMT,P012600,19.133,4,48,44
22,HAM,P001990,6.383,-10,6,16
22,HAM,P009663,19.581,-32,29,61
22,HAM,P010070,11.632,-18,20,38
22,HAM,P011168,23.898,-17,48,65
22,HAM,P011187,30.232,-17,55,72
22,HAM,P012578,12.333,-16,20,36
22,HAM,P012579,17.432,-15,37,52
22,HAM,P012580,27.981,-31,38,69
22,HAM,P012581,11.383,-10,13,23
22,HAM,P012582,22.765,-10,43,53
22,HAM,P012648,16.365,-4,36,40
22,PRS,P003481,15.033,6,40,34
22,PRS,P004512,16.45,29,46,17
22,PRS,P005793,16.066,-1,37,38
22,PRS,P009556,18.316,2,43,41
22,PRS,P010801,4.766,4,10,6
22,PRS,P012608,21.682,34,62,28
22,PRS,P012609,18.399,4,48,44
22,PRS,P012610,22.615,34,65,31
22,PRS,P012611,19.333,33,52,19
22,PRS,P012612,4.066,2,8,6
22,PRS,P012613,22.615,34,65,31
22,PRS,P012640,20.649,-1,49,50
23,HTA,P003533,12.283,-1,29,30
23,HTA,P004267,14.333,12,42,30
23,HTA,P004846,22.533,10,60,50
23,HTA,P006835,22.832,21,63,42
23,HTA,P007759,30.732,17,79,62
23,HTA,P010465,31.416,14,71,57
23,HTA,P010550,24.483,1,56,55
23,HTA,P011973,20.4,11,46,35
23,HTA,P011991,20.983,-5,39,44
23,VNC,P000968,11.201,5,29,24
23,VNC,P003759,27.034,-1,61,62
23,VNC,P004117,4.916,-1,9,10
23,VNC,P004381,26.067,-17,50,67
23,VNC,P008052,20.368,-11,44,55
23,VNC,P009400,9.6,1,22,21
23,VNC,P011909,22.918,-11,38,49
23,VNC,P011928,25.067,-19,44,63
23,VNC,P012590,22.9,-9,49,58
23,VNC,P012591,29.934,-17,59,76
24,JOV,P002361,33.266,12,72,60
24,JOV,P002507,28.034,-8,59,67
24,JOV,P005094,24.983,18,64,46
24,JOV,P006771,24.148,-9,56,65
24,JOV,P010161,28.834,6,70,64
24,JOV,P010166,6.483,-8,16,24
24,JOV,P010458,34.566,17,84,67
24,JOV,P010708,0.383,1,4,3
24,JOV,P010709,8.35,-6,16,22
24,JOV,P012076,16.582,16,44,28
24,JOV,PJUG,19.366,6,50,44
24,WOL,P002333,14.865,-16,25,41
24,WOL,P002387,30.083,8,68,60
24,WOL,P003212,26.949,-13,58,71
24,WOL,P004645,20.165,-16,41,57
24,WOL,P005516,30.382,2,68,66
24,WOL,P006154,8.565,0,18,18
24,WOL,P011150,34.498,-5,81,86
24,WOL,P012576,29.75,10,70,60
24,WOL,P012577,29.733,-15,61,76
25,BES,P003783,19.1,2,41,39
25,BES,P007914,20.382,-2,35,37
25,BES,P007917,17.016,8,30,22
25,BES,P008945,25.798,7,42,35
25,BES,P009582,17.549,-7,35,42
25,BES,P011357,6.883,2,18,16
25,BES,P011379,10.434,11,25,14
25,BES,P011936,33.148,9,62,53
25,BES,P012622,26.999,11,47,36
25,BES,P012647,22.681,-6,30,36
25,LJU,P003452,13.482,-5,13,18
25,LJU,P005969,28.466,-10,43,53
25,LJU,P007066,23.699,-8,32,40
25,LJU,P008883,25.783,-2,50,52
25,LJU,P009395,22.05,-3,39,42
25,LJU,P010594,20.333,4,36,32
25,LJU,P012598,33.366,-7,60,67
25,LJU,P012700,32.816,-4,57,61
26,BOU,P000498,12.216,-8,23,31
26,BOU,P004525,15.668,-1,31,32
26,BOU,P010431,19.983,1,48,47
26,BOU,P010449,28.067,12,72,60
26,BOU,P010450,16.183,-9,28,37
26,BOU,P010718,15.901,-1,38,39
26,BOU,P011161,20.517,10,48,38
26,BOU,P011836,20.383,13,55,42
26,BOU,P011837,17.366,7,40,33
26,BOU,P012628,28.683,-5,63,68
26,BOU,P012755,5.033,1,14,13
26,CLU,P004862,25.598,-1,57,58
26,CLU,P005113,19.849,-8,37,45
26,CLU,P005373,19.232,3,42,39
26,CLU,P010569,26.531,-9,59,68
26,CLU,P011797,30.865,0,68,68
26,CLU,P011801,28.164,0,69,69
26,CLU,P012620,6.433,2,17,15
26,CLU,P012621,22.998,-6,46,52
26,CLU,P012698,20.315,-1,45,46
27,BUD,P002740,22.866,7,55,48
27,BUD,P004945,20.183,1,44,43
27,BUD,P006561,14.933,-2,42,44
27,BUD,P006566,4.7,-2,8,10
27,BUD,P007398,20.516,16,64,48
27,BUD,P009214,16.683,3,47,44
27,BUD,P010432,25.066,16,61,45
27,BUD,P011935,22.099,10,54,44
27,BUD,P012605,18.599,12,57,45
27,BUD,P012606,21.4,2,46,44
27,BUD,P012630,12.95,7,37,30
27,WRO,P001694,28.468,-11,61,72
27,WRO,P003034,18.533,-4,40,44
27,WRO,P005531,28.001,-13,59,72
27,WRO,P009896,21.467,-10,49,59
27,WRO,P011165,23.701,-6,56,62
27,WRO,P011900,20.699,-10,40,50
27,WRO,P011902,11.532,-3,28,31
27,WRO,P012699,23.3,5,62,57
27,WRO,P012736,11.5,-11,22,33
27,WRO,P012749,12.799,-7,28,35
28,ARI,P002867,19.632,-1,31,32
28,ARI,P004292,28.484,-5,52,57
28,ARI,P010387,7.749,-13,6,19
28,ARI,P012615,32.251,15,62,47
28,ARI,P012702,19.916,3,39,36
28,ARI,P012707,22.117,8,32,24
28,ARI,P012708,25.783,-3,44,47
28,ARI,P012716,25.401,4,45,41
28,ARI,P012722,18.667,2,29,27
28,TTK,P000497,5.383,5,10,5
28,TTK,P005000,25.834,-4,40,44
28,TTK,P005685,6.984,3,12,9
28,TTK,P006693,24.834,-6,40,46
28,TTK,P009845,2.6,-4,2,6
28,TTK,P011239,23.633,1,47,46
28,TTK,P011834,23.435,1,37,36
28,TTK,P011925,32.985,-9,52,61
28,TTK,P012056,33.15,1,59,58
28,TTK,P012697,21.167,2,31,29
29,LKB,P002012,25.684,-13,49,62
29,LKB,P004664,20.501,-15,35,50
29,LKB,P005521,27.466,-17,54,71
29,LKB,P006230,15.583,-12,34,46
29,LKB,P006901,10.583,-8,17,25
29,LKB,P008856,19.816,-11,39,50
29,LKB,P010190,20.551,-17,30,47
29,LKB,P010461,19.2,-6,32,38
29,LKB,P011329,1.867,-3,4,7
29,LKB,P012583,13.566,-10,27,37
29,LKB,PLXI,25.183,-13,49,62
29,ULM,P005422,18.301,9,39,30
29,ULM,P007952,12.967,-4,22,26
29,ULM,P010582,17.467,5,42,37
29,ULM,P010726,14.402,4,34,30
29,ULM,P011391,1.867,3,7,4
29,ULM,P011457,19.568,7,46,39
29,ULM,P012066,12.883,7,36,29
29,ULM,P012602,1.867,3,7,4
29,ULM,P012603,20.433,18,53,35
29,ULM,P012604,25.167,26,70,44
29,ULM,P012629,25.717,24,66,42
29,ULM,P012703,29.366,23,73,50
30,CAN,P001607,18.316,0,39,39
30,CAN,P003425,21.683,14,48,34
30,CAN,P003637,6.733,-1,13,14
30,CAN,P004160,21.216,6,44,38
30,CAN,P005005,16.6,-3,31,34
30,CAN,P006588,25.5,16,55,39
30,CAN,P007560,12.5,11,32,21
30,CAN,P007644,10.517,11,25,14
30,CAN,P008121,22.949,15,54,39
30,CAN,P009864,15.416,-7,30,37
30,CAN,P010385,14.066,10,32,22
30,CAN,P010452,14.499,-2,32,34
30,TRN,P001479,16.683,6,38,32
30,TRN,P005059,25.45,-10,44,54
30,TRN,P005738,23.317,-20,35,55
30,TRN,P006382,21.285,-5,41,46
30,TRN,P007828,14.483,0,31,31
30,TRN,P009903,22.916,-9,42,51
30,TRN,P012593,23.734,-7,49,56
30,TRN,P012594,18.716,-9,29,38
30,TRN,P012595,18.499,-18,25,43
30,TRN,P012596,14.917,2,31,29
31,LJU,P002661,30.984,-5,71,76
31,LJU,P003452,35.367,-15,68,83
31,LJU,P005969,3.267,1,6,5
31,LJU,P007066,18.601,-1,46,47
31,LJU,P009395,30.234,-4,61,65
31,LJU,P010594,14.467,4,32,28
31,LJU,P010771,2.334,-2,8,10
31,LJU,P011261,9.449,-2,14,16
31,LJU,P012598,20.467,-9,37,46
31,LJU,P012700,34.835,-2,72,74
31,PMT,P001686,20.483,4,49,45
31,PMT,P002020,3.933,-8,5,13
31,PMT,P002644,30.983,5,71,66
31,PMT,P009559,28.882,2,60,58
31,PMT,P011066,32.9,13,78,65
31,PMT,P011823,13.616,8,28,20
31,PMT,P011943,14.35,3,40,37
31,PMT,P011944,20.766,1,36,35
31,PMT,P011966,6.966,-6,12,18
31,PMT,P012600,27.116,13,71,58
32,BES,P003783,14.734,-6,29,35
32,BES,P007914,17.185,-9,30,39
32,BES,P007917,15.868,-12,36,48
32,BES,P008945,20.4,9,53,44
32,BES,P009582,25.818,4,56,52
32,BES,P011357,6.784,8,17,9
32,BES,P011379,2.967,0,8,8
32,BES,P011936,32.868,-2,71,73
32,BES,P012622,34.102,0,79,79
32,BES,P012647,29.284,-2,61,63
32,WOL,P002333,6.916,-11,10,21
32,WOL,P002387,32.848,-6,68,74
32,WOL,P003212,14.849,-2,29,31
32,WOL,P004645,25.283,-6,51,57
32,WOL,P005516,28.299,9,72,63
32,WOL,P006154,4.632,-2,6,8
32,WOL,P011150,27.333,-4,62,66
32,WOL,P012576,18.232,10,43,33
32,WOL,P012577,31.366,11,81,70
32,WOL,PLCT,10.232,11,28,17
33,JOV,P002361,23.634,-3,39,42
33,JOV,P002507,17.766,-6,26,32
33,JOV,P005094,30.934,-6,52,58
33,JOV,P006771,20.568,-3,38,41
33,JOV,P010161,23.717,-9,38,47
33,JOV,P010166,7.483,-8,7,15
33,JOV,P010458,9.267,0,14,14
33,JOV,P010708,2.684,-9,0,9
33,JOV,P011248,27.633,-10,42,52
33,JOV,P012076,16.935,0,35,35
33,JOV,PJUG,19.384,-21,29,50
33,VNC,P000968,19.2,11,45,34
33,VNC,P003759,31.049,16,64,48
33,VNC,P004117,11.716,-8,16,24
33,VNC,P004381,31.433,17,65,48
33,VNC,P008052,11.084,14,32,18
33,VNC,P009400,5.034,-1,6,7
33,VNC,P011909,21.583,9,47,38
33,VNC,P011928,22.284,3,38,35
33,VNC,P012587,6.216,-1,9,10
33,VNC,P012588,0.35,2,2,0
33,VNC,P012590,14.284,3,25,22
33,VNC,P012591,25.767,10,46,36
34,HAM,P001990,18.699,-6,44,50
34,HAM,P009663,29.082,-30,57,87
34,HAM,P010070,8.866,-7,15,22
34,HAM,P011168,19.85,-27,30,57
34,HAM,P011187,1.883,-6,2,8
34,HAM,P012578,25.232,-28,47,75
34,HAM,P012579,11.366,-4,20,24
34,HAM,P012580,25.616,-36,43,79
34,HAM,P012581,29.599,-31,55,86
34,HAM,P012648,12.182,-4,22,26
34,HAM,P012694,14.766,-11,25,36
34,HAM,P012695,2.849,-5,0,5
34,HTA,P003533,13.967,20,46,26
34,HTA,P004267,14.216,-10,19,29
34,HTA,P004846,22.133,10,56,46
34,HTA,P006835,22.067,18,60,42
34,HTA,P007759,23.867,43,80,37
34,HTA,P010465,22.017,34,71,37
34,HTA,P010550,19.483,14,49,35
34,HTA,P011973,22.517,27,65,38
34,HTA,P011990,13.483,17,39,22
34,HTA,P011991,16.467,20,54,34
34,HTA,P012592,5.633,3,10,7
34,HTA,P012706,4.15,-1,6,7
35,LLI,P004479,10.017,-10,21,31
35,LLI,P004773,7.566,-8,18,26
35,LLI,P005247,13.866,-12,24,36
35,LLI,P006600,35.398,4,87,83
35,LLI,P009649,30.499,12,78,66
35,LLI,P009672,34.981,6,81,75
35,LLI,P009680,19.616,-10,44,54
35,LLI,P012585,38.065,0,84,84
35,LLI,P012586,34.982,-2,73,75
35,PRS,P003481,12.266,-2,23,25
35,PRS,P004512,25.166,1,57,56
35,PRS,P005793,19.766,7,52,45
35,PRS,P009556,11.85,-4,22,26
35,PRS,P012608,27.566,5,75,70
35,PRS,P012609,30.116,7,75,68
35,PRS,P012610,25.732,9,64,55
35,PRS,P012611,15.717,-2,31,33
35,PRS,P012613,29.916,-3,68,71
35,PRS,P012640,26.9,2,63,61
36,BOU,P000498,19.733,-7,35,42
36,BOU,P004525,23.184,-17,32,49
36,BOU,P010431,21.817,14,54,40
36,BOU,P010449,15.017,-3,33,36
36,BOU,P010450,6.933,-4,7,11
36,BOU,P010718,21.633,12,51,39
36,BOU,P011161,14.733,-13,21,34
36,BOU,P011836,20.016,5,49,44
36,BOU,P011837,21.117,1,50,49
36,BOU,P012619,15.683,-5,21,26
36,BOU,P012628,20.134,-23,27,50
36,CAN,P001607,16.349,3,37,34
36,CAN,P003425,24.549,6,51,45
36,CAN,P003637,15.6,-4,31,35
36,CAN,P004160,4.282,7,11,4
36,CAN,P005005,22.066,14,46,32
36,CAN,P006588,23.549,-3,47,50
36,CAN,P007560,14.816,-1,31,32
36,CAN,P007644,4.95,2,13,11
36,CAN,P008121,22.332,-1,45,46
36,CAN,P009864,17.2,-4,33,37
36,CAN,P010385,17.215,10,36,26
36,CAN,P010452,17.082,11,39,28
37,LKB,P002012,29.75,6,71,65
37,LKB,P005521,18.734,-17,33,50
37,LKB,P006230,14.933,1,32,31
37,LKB,P006901,7.034,-2,19,21
37,LKB,P007029,32.816,10,87,77
37,LKB,P008856,29.217,-1,69,70
37,LKB,P010190,12.25,-3,23,26
37,LKB,P010461,14.167,-4,28,32
37,LKB,P012583,14.116,-3,34,37
37,LKB,PLXI,26.983,8,64,56
37,TRN,P001479,16.599,9,47,38
37,TRN,P005059,25.583,6,63,57
37,TRN,P005738,23.4,-8,46,54
37,TRN,P006382,8.417,9,22,13
37,TRN,P007828,15.449,1,39,38
37,TRN,P009903,21.999,-3,43,46
37,TRN,P012593,24.499,-1,60,61
37,TRN,P012594,20.066,0,43,43
37,TRN,P012595,25.983,-12,52,64
37,TRN,P012596,18.0,4,50,46
38,TTK,P000497,2.133,1,6,5
38,TTK,P004801,11.267,-5,18,23
38,TTK,P005000,23.499,-1,54,55
38,TTK,P005685,12.433,-1,22,23
38,TTK,P006693,18.917,-15,37,52
38,TTK,P011239,25.534,-1,54,55
38,TTK,P011834,22.45,-16,39,55
38,TTK,P011925,31.766,2,64,62
38,TTK,P012056,29.085,-21,53,74
38,TTK,P012697,22.916,-8,43,51
38,ULM,P005422,26.799,9,63,54
38,ULM,P006997,11.402,-3,17,20
38,ULM,P007952,15.401,-7,28,35
38,ULM,P010582,24.301,16,57,41
38,ULM,P010726,9.818,-2,16,18
38,ULM,P011457,12.635,-7,21,28
38,ULM,P012603,25.283,15,65,50
38,ULM,P012604,21.183,22,59,37
38,ULM,P012629,23.0,7,54,47
38,ULM,P012703,30.183,15,75,60
39,ARI,P002867,10.451,-3,19,22
39,ARI,P003240,23.302,4,40,36
39,ARI,P004292,23.985,13,53,40
39,ARI,P010387,0.767,3,5,2
39,ARI,P012615,23.935,9,46,37
39,ARI,P012616,1.951,3,7,4
39,ARI,P012702,12.383,4,27,23
39,ARI,P012707,19.867,-1,32,33
39,ARI,P012708,25.9,24,54,30
39,ARI,P012716,31.384,16,66,50
39,ARI,P012722,11.184,4,21,17
39,ARI,P012760,14.901,9,30,21
39,WRO,P001694,30.616,-9,46,55
39,WRO,P003034,19.216,-1,30,31
39,WRO,P005531,23.749,-8,41,49
39,WRO,P009896,20.783,-16,33,49
39,WRO,P011165,22.666,-9,39,48
39,WRO,P011900,8.033,-8,11,19
39,WRO,P011901,13.882,0,22,22
39,WRO,P011902,9.383,-8,17,25
39,WRO,P012308,3.484,-1,6,7
39,WRO,P012699,22.666,-8,39,47
39,WRO,P012736,18.232,-5,24,29
39,WRO,P012749,7.285,-12,7,19
40,BUD,P002740,15.55,-6,28,34
40,BUD,P004945,23.833,-7,42,49
40,BUD,P006561,2.383,-3,5,8
40,BUD,P006566,10.533,-13,16,29
40,BUD,P007398,20.549,-11,36,47
40,BUD,P010432,34.183,-10,62,72
40,BUD,P011935,32.366,-4,65,69
40,BUD,P012605,11.85,-8,20,28
40,BUD,P012606,30.116,-6,59,65
40,BUD,P012630,18.632,-7,37,44
40,CLU,P004862,19.865,5,42,37
40,CLU,P005113,19.166,7,39,32
40,CLU,P005373,14.199,4,33,29
40,CLU,P005714,21.216,9,49,40
40,CLU,P010569,25.165,12,57,45
40,CLU,P011797,20.199,5,42,37
40,CLU,P011801,27.899,13,64,51
40,CLU,P012621,31.249,13,72,59
40,CLU,P012698,21.032,7,47,40
41,PMT,P002020,3.45,-12,4,16
41,PMT,P002644,14.533,-13,32,45
41,PMT,P009559,23.133,-3,45,48
41,PMT,P011066,20.0,-9,37,46
41,PMT,P011823,27.383,-9,50,59
41,PMT,P011943,14.683,-4,25,29
41,PMT,P011944,31.883,-18,55,73
41,PMT,P011946,6.866,-2,14,16
41,PMT,P011947,18.766,1,47,46
41,PMT,P011966,11.449,-5,25,30
41,PMT,P012600,26.366,-11,56,67
41,PMT,P012601,1.483,0,5,5
41,PRS,P003481,14.183,0,36,36
41,PRS,P004512,18.784,16,42,26
41,PRS,P005793,14.867,2,38,36
41,PRS,P009556,14.85,2,38,36
41,PRS,P010801,1.483,0,5,5
41,PRS,P011887,1.483,0,5,5
41,PRS,P012608,25.133,15,58,43
41,PRS,P012609,20.167,1,49,48
41,PRS,P012610,25.15,15,58,43
41,PRS,P012611,18.35,16,42,26
41,PRS,P012613,25.15,15,58,43
41,PRS,P012640,20.4,3,51,48
42,HTA,P003533,6.968,1,16,15
42,HTA,P004267,3.234,-2,6,8
42,HTA,P004846,22.767,7,56,49
42,HTA,P006835,16.05,-4,41,45
42,HTA,P007759,31.2,8,79,71
42,HTA,P010465,33.416,8,82,74
42,HTA,P010550,30.317,10,76,66
42,HTA,P011973,26.948,11,68,57
42,HTA,P011991,29.1,1,66,65
42,LLI,P003850,8.05,-9,11,20
42,LLI,P004479,16.516,-22,25,47
42,LLI,P004773,8.099,-7,12,19
42,LLI,P005247,26.615,9,72,63
42,LLI,P006600,31.948,1,79,78
42,LLI,P008274,2.517,-1,4,5
42,LLI,P009649,22.699,-5,51,56
42,LLI,P009680,25.232,5,65,60
42,LLI,P012585,28.982,0,70,70
42,LLI,P012586,29.332,-11,61,72
43,HAM,P001990,3.666,-1,9,10
43,HAM,P009663,24.383,-9,47,56
43,HAM,P010070,13.367,-11,26,37
43,HAM,P011168,22.317,-24,38,62
43,HAM,P012578,3.216,-5,5,10
43,HAM,P012579,22.366,-12,42,54
43,HAM,P012580,27.383,-18,54,72
43,HAM,P012581,21.932,-27,46,73
43,HAM,P012582,20.167,-9,43,52
43,HAM,P012648,10.566,-19,13,32
43,HAM,P012694,16.616,-18,28,46
43,HAM,P012695,14.016,-7,29,36
43,JOV,P002361,18.95,7,47,40
43,JOV,P005094,19.999,19,52,33
43,JOV,P006771,20.283,18,50,32
43,JOV,P009572,18.548,19,51,32
43,JOV,P010161,25.316,12,73,61
43,JOV,P010166,20.832,18,70,52
43,JOV,P010708,19.865,16,41,25
43,JOV,P010709,11.6,11,32,21
43,JOV,P011248,22.965,15,63,48
43,JOV,P012349,5.183,6,14,8
43,JOV,PJUG,16.449,19,47,28
44,BES,P003783,16.466,4,33,29
44,BES,P007914,17.166,5,36,31
44,BES,P007917,9.4,8,19,11
44,BES,P008945,30.666,1,52,51
44,BES,P009582,24.282,7,49,42
44,BES,P011357,4.933,6,16,10
44,BES,P011379,6.883,3,13,10
44,BES,P011936,30.567,2,54,52
44,BES,P012622,31.449,-3,53,56
44,BES,P012647,28.183,-3,45,48
44,VNC,P000968,17.833,-5,33,38
44,VNC,P003759,24.983,-4,43,47
44,VNC,P004117,9.367,6,20,14
44,VNC,P004381,30.7,9,57,48
44,VNC,P008052,23.717,-6,39,45
44,VNC,P009400,14.633,-6,23,29
44,VNC,P011928,21.933,-8,34,42
44,VNC,P012587,9.284,-10,11,21
44,VNC,P012590,18.7,-8,31,39
44,VNC,P012591,28.85,2,49,47
45,LJU,P001235,18.983,6,42,36
45,LJU,P002661,30.983,-10,61,71
45,LJU,P003452,27.633,-14,50,64
45,LJU,P007066,17.717,-7,34,41
45,LJU,P009395,25.066,-4,47,51
45,LJU,P010594,2.95,-10,2,12
45,LJU,P011261,11.534,-2,20,22
45,LJU,P012598,29.468,4,60,56
45,LJU,P012700,35.666,-3,74,77
45,WOL,P003212,17.184,16,43,27
45,WOL,P004229,9.734,-4,16,20
45,WOL,P004645,24.217,14,57,43
45,WOL,P005516,32.234,5,68,63
45,WOL,P006154,15.483,7,35,28
45,WOL,P006907,8.001,-3,15,18
45,WOL,P011150,31.401,15,76,61
45,WOL,P012576,20.4,-1,40,41
45,WOL,P012577,33.201,-2,69,71
45,WOL,PLCT,8.15,-7,11,18
46,BOU,P000498,15.983,-5,31,36
46,BOU,P004525,22.218,-4,42,46
46,BOU,P010431,16.867,3,33,30
46,BOU,P010450,16.034,-9,26,35
46,BOU,P010718,30.3,2,57,55
46,BOU,P011161,24.017,10,47,37
46,BOU,P011836,17.782,9,36,27
46,BOU,P011837,24.1,13,56,43
46,BOU,P012619,15.9,-8,22,30
46,BOU,P012628,16.799,14,40,26
46,BUD,P002740,17.399,-5,30,35
46,BUD,P004945,30.082,-4,53,57
46,BUD,P007398,20.999,0,39,39
46,BUD,P009214,6.199,0,10,10
46,BUD,P010248,23.166,4,47,43
46,BUD,P010432,16.832,-9,26,35
46,BUD,P011935,32.866,-7,58,65
46,BUD,P012605,15.466,-3,27,30
46,BUD,P012606,24.532,-2,46,48
46,BUD,P012630,12.449,1,29,28
47,ARI,P002867,25.234,12,45,33
47,ARI,P003240,29.001,-5,41,46
47,ARI,P010387,4.3,-5,6,11
47,ARI,P012615,19.617,8,33,25
47,ARI,P012616,3.417,-1,2,3
47,ARI,P012702,15.85,7,31,24
47,ARI,P012707,27.45,-3,37,40
47,ARI,P012708,29.134,-3,42,45
47,ARI,P012716,31.084,-5,44,49
47,ARI,P012760,14.918,-15,14,29
47,CLU,P004862,22.116,-7,31,38
47,CLU,P005113,21.583,-2,31,33
47,CLU,P005373,13.417,-2,18,20
47,CLU,P005714,23.85,10,44,34
47,CLU,P010569,19.917,-5,24,29
47,CLU,P011797,28.4,6,48,42
47,CLU,P011801,29.55,10,48,38
47,CLU,P012620,0.1,-1,0,1
47,CLU,P012621,18.4,-10,22,32
47,CLU,P012698,22.667,11,39,28
48,ULM,P005422,31.4,-2,71,73
48,ULM,P006997,9.333,2,23,21
48,ULM,P010106,24.9,10,62,52
48,ULM,P010582,24.45,20,63,43
48,ULM,P010726,8.5,5,22,17
48,ULM,P011457,13.1,7,32,25
48,ULM,P012066,4.25,1,10,9
48,ULM,P012603,16.816,-23,32,55
48,ULM,P012604,35.667,3,85,82
48,ULM,P012629,27.334,3,69,66
48,ULM,P012703,29.25,-1,71,72
48,WRO,P001694,27.033,-14,55,69
48,WRO,P003034,16.6,-12,36,48
48,WRO,P009896,28.417,10,70,60
48,WRO,P011165,35.8,-17,77,94
48,WRO,P011278,20.15,7,49,42
48,WRO,P011901,21.05,16,58,42
48,WRO,P011902,16.9,5,40,35
48,WRO,P012699,27.334,-13,58,71
48,WRO,P012736,27.533,0,67,67
48,WRO,P012749,4.183,-7,5,12
49,TRN,P001479,15.084,-8,30,38
49,TRN,P005059,17.334,-4,35,39
49,TRN,P005738,33.366,16,84,68
49,TRN,P006382,15.867,-1,33,34
49,TRN,P009903,30.7,9,75,66
49,TRN,P012593,21.45,13,55,42
49,TRN,P012594,27.666,9,66,57
49,TRN,P012595,24.333,-1,54,55
49,TRN,P012596,10.85,-7,13,20
49,TRN,P012597,28.35,-1,60,61
49,TTK,P000497,4.251,-5,4,9
49,TTK,P005000,37.684,-2,83,85
49,TTK,P005685,6.434,0,14,14
49,TTK,P006693,17.833,-1,35,36
49,TTK,P009845,2.933,1,8,7
49,TTK,P011239,34.851,-6,72,78
49,TTK,P011834,28.767,-5,61,66
49,TTK,P011925,33.651,-5,72,77
49,TTK,P012056,30.65,2,68,66
49,TTK,P012697,27.951,-4,63,67
50,CAN,P001607,17.249,-8,35,43
50,CAN,P003425,22.75,19,53,34
50,CAN,P003637,16.616,-2,38,40
50,CAN,P004160,9.65,-1,12,13
50,CAN,P005005,18.783,9,49,40
50,CAN,P006588,23.499,18,53,35
50,CAN,P007560,13.166,5,30,25
50,CAN,P007644,6.083,-6,7,13
50,CAN,P008121,21.783,11,47,36
50,CAN,P009864,19.617,13,46,33
50,CAN,P010385,14.299,4,35,31
50,CAN,P010452,16.5,-7,35,42
50,LKB,P002012,25.149,-6,46,52
50,LKB,P004664,26.366,-1,61,62
50,LKB,P005521,22.683,4,49,45
50,LKB,P006230,15.833,-10,33,43
50,LKB,P006901,2.65,3,6,3
50,LKB,P007029,23.433,-13,43,56
50,LKB,P008856,13.633,-10,16,26
50,LKB,P010190,7.133,1,19,18
50,LKB,P010461,20.733,-1,39,40
50,LKB,P012583,15.633,-8,30,38
50,LKB,PLXI,26.749,-14,43,57
51,PMT,P001686,10.533,2,24,22
51,PMT,P002644,21.432,-2,39,41
51,PMT,P009559,17.15,-13,29,42
51,PMT,P011066,30.216,-15,53,68
51,PMT,P011823,20.833,-15,37,52
51,PMT,P011943,4.533,2,8,6
51,PMT,P011944,27.733,-11,46,57
51,PMT,P011946,5.6,-1,9,10
51,PMT,P011947,19.816,0,30,30
51,PMT,P011966,4.0,2,8,6
51,PMT,P012599,29.199,-8,53,61
51,PMT,P012600,8.95,-11,19,30
51,WOL,P002387,25.899,8,52,44
51,WOL,P003212,20.265,8,45,37
51,WOL,P004229,14.333,-11,22,33
51,WOL,P004645,10.466,7,27,20
51,WOL,P005516,30.099,3,53,50
51,WOL,P006154,13.233,6,30,24
51,WOL,P006907,1.383,-3,0,3
51,WOL,P011150,28.982,19,72,53
51,WOL,P012576,25.565,25,63,38
51,WOL,P012577,26.349,8,54,46
51,WOL,PLCT,3.416,0,7,7
52,LJU,P001235,12.216,3,24,21
52,LJU,P002661,30.45,-2,72,74
52,LJU,P003452,31.482,-14,68,82
52,LJU,P007066,15.45,-9,36,45
52,LJU,P009392,10.434,2,26,24
52,LJU,P009395,24.349,1,51,50
52,LJU,P010594,3.184,-1,6,7
52,LJU,P011261,4.582,2,12,10
52,LJU,P012598,32.099,-9,68,77
52,LJU,P012700,35.749,-13,72,85
52,VNC,P000968,6.483,-4,13,17
52,VNC,P003759,19.783,4,44,40
52,VNC,P004381,30.333,14,76,62
52,VNC,P008052,26.082,2,65,63
52,VNC,P009400,21.016,12,52,40
52,VNC,P011928,28.35,0,61,61
52,VNC,P012587,11.132,-11,23,34
52,VNC,P012590,24.683,6,63,57
52,VNC,P012591,32.133,17,78,61
53,BES,P003783,19.865,5,46,41
53,BES,P005348,6.316,2,17,15
53,BES,P007914,22.265,4,47,43
53,BES,P007917,9.6,-3,20,23
53,BES,P008945,25.567,16,61,45
53,BES,P009582,26.715,13,63,50
53,BES,P011357,3.233,0,6,6
53,BES,P011379,11.415,-1,21,22
53,BES,P011936,27.265,3,60,57
53,BES,P012622,22.399,8,46,38
53,BES,P012647,25.35,13,63,50
53,HAM,P009663,27.784,-18,52,70
53,HAM,P011168,28.584,-7,59,66
53,HAM,P011187,12.217,6,26,20
53,HAM,P012579,24.334,-8,45,53
53,HAM,P012580,24.051,-3,46,49
53,HAM,P012581,23.817,-20,44,64
53,HAM,P012582,23.883,-16,43,59
53,HAM,P012648,10.183,1,24,23
53,HAM,P012694,16.118,4,35,31
53,HAM,P012695,9.034,1,16,15
54,JOV,P002361,18.516,-14,31,45
54,JOV,P005094,33.016,-6,60,66
54,JOV,P006771,23.849,-5,45,50
54,JOV,P009572,15.149,1,32,31
54,JOV,P010161,28.8,-10,56,66
54,JOV,P010166,10.733,1,27,26
54,JOV,P010708,21.266,4,45,41
54,JOV,P011248,28.816,1,61,60
54,JOV,P012349,9.233,-15,8,23
54,JOV,PJUG,10.617,-12,15,27
54,LLI,P003850,6.7,-11,6,17
54,LLI,P004479,24.601,5,44,39
54,LLI,P004773,11.95,4,23,19
54,LLI,P005247,21.034,17,52,35
54,LLI,P006600,32.984,24,81,57
54,LLI,P009649,24.034,0,50,50
54,LLI,P009680,29.701,13,71,58
54,LLI,P012585,23.817,7,56,49
54,LLI,P012586,25.184,-4,52,56
55,HTA,P003533,12.3,-12,23,35
55,HTA,P004267,17.35,-14,31,45
55,HTA,P004846,25.384,-18,53,71
55,HTA,P006835,25.183,-18,51,69
55,HTA,P007759,28.7,-19,64,83
55,HTA,P010465,29.367,-17,68,85
55,HTA,P010550,27.999,-17,68,85
55,HTA,P011973,25.617,-13,58,71
55,HTA,P011990,7.5,-7,17,24
55,HTA,P012592,0.6,0,2,2
55,PRS,P003481,13.6,5,35,30
55,PRS,P004512,17.0,17,51,34
55,PRS,P005793,18.283,4,43,39
55,PRS,P009556,15.833,4,41,37
55,PRS,P010801,2.433,2,9,7
55,PRS,P011551,1.55,-2,4,6
55,PRS,P012608,24.167,23,73,50
55,PRS,P012609,19.667,8,51,43
55,PRS,P012610,24.167,23,73,50
55,PRS,P012611,16.367,19,56,37
55,PRS,P012613,24.167,23,73,50
55,PRS,P012640,22.766,9,61,52
56,BOU,P000498,20.349,16,60,44
56,BOU,P004525,10.583,-5,24,29
56,BOU,P010431,26.449,-7,61,68
56,BOU,P010450,12.15,-16,22,38
56,BOU,P010718,27.117,-3,67,70
56,BOU,P011161,19.65,-20,36,56
56,BOU,P011836,24.916,-4,55,59
56,BOU,P011837,20.899,22,55,33
56,BOU,P012619,17.033,-18,37,55
56,BOU,P012628,20.849,15,63,48
56,LKB,P002012,27.434,-3,61,64
56,LKB,P004664,24.216,-4,62,66
56,LKB,P005521,18.983,9,56,47
56,LKB,P006230,24.584,6,64,58
56,LKB,P006901,7.633,2,26,24
56,LKB,P007029,30.383,13,84,71
56,LKB,P008856,14.751,5,33,28
56,LKB,P010190,4.334,-9,5,14
56,LKB,P010461,14.799,-5,33,38
56,LKB,PLXI,32.883,6,76,70
57,CAN,P001607,23.798,7,48,41
57,CAN,P003425,16.2,6,34,28
57,CAN,P003637,5.4,-7,6,13
57,CAN,P004160,19.332,15,45,30
57,CAN,P005005,21.515,1,36,35
57,CAN,P007560,16.082,3,31,28
57,CAN,P007644,16.382,-3,27,30
57,CAN,P008121,18.483,12,46,34
57,CAN,P009864,17.667,14,40,26
57,CAN,P010385,16.649,-1,30,31
57,CAN,P010452,27.349,19,66,47
57,CAN,P010484,1.133,-1,1,2
57,TTK,P005000,31.116,-7,53,60
57,TTK,P005685,6.033,-4,10,14
57,TTK,P006693,24.9,-7,45,52
57,TTK,P009845,8.483,-8,12,20
57,TTK,P011239,30.233,-8,53,61
57,TTK,P011925,39.149,-13,69,82
57,TTK,P011975,7.8,-1,12,13
57,TTK,P012056,31.032,-13,53,66
57,TTK,P012697,21.249,-4,38,42
58,TRN,P001479,13.018,5,33,28
58,TRN,P005059,26.351,15,65,50
58,TRN,P005738,26.984,4,51,47
58,TRN,P006382,7.417,3,19,16
58,TRN,P007828,2.834,-7,2,9
58,TRN,P009903,23.834,5,42,37
58,TRN,P012593,13.901,3,29,26
58,TRN,P012594,14.068,-5,22,27
58,TRN,P012595,25.984,5,47,42
58,TRN,P012596,15.885,4,42,38
58,TRN,P012597,29.734,13,68,55
58,WRO,P003034,12.768,-10,22,32
58,WRO,P005531,30.051,-4,57,61
58,WRO,P009896,26.55,4,51,47
58,WRO,P011165,22.635,-4,46,50
58,WRO,P011900,19.385,-12,31,43
58,WRO,P011901,7.251,-7,10,17
58,WRO,P011902,8.217,-4,12,16
58,WRO,P012010,31.318,-3,62,65
58,WRO,P012699,23.135,-8,48,56
58,WRO,P012736,18.7,3,36,33
59,CLU,P004862,31.934,3,66,63
59,CLU,P005113,21.233,12,47,35
59,CLU,P005373,18.55,-1,37,38
59,CLU,P005714,17.833,-1,37,38
59,CLU,P010569,22.384,12,51,39
59,CLU,P011797,28.033,12,62,50
59,CLU,P011801,18.782,5,38,33
59,CLU,P012620,2.917,8,13,5
59,CLU,P012621,14.117,-3,24,27
59,CLU,P012698,24.217,8,55,47
59,ULM,P005422,20.834,-18,31,49
59,ULM,P006997,7.334,-16,6,22
59,ULM,P007952,8.701,-15,13,28
59,ULM,P010106,24.666,15,55,40
59,ULM,P010582,24.817,2,50,48
59,ULM,P010726,5.101,-11,4,15
59,ULM,P011457,18.783,17,51,34
59,ULM,P012603,27.951,5,58,53
59,ULM,P012604,31.1,6,62,56
59,ULM,P012629,15.4,-14,25,39
59,ULM,P012703,15.318,-26,20,46
60,ARI,P002867,26.367,-6,31,37
60,ARI,P003240,29.582,3,56,53
60,ARI,P004292,6.883,-6,4,10
60,ARI,P010387,2.417,3,6,3
60,ARI,P012615,21.75,15,44,29
60,ARI,P012616,12.183,9,29,20
60,ARI,P012702,20.7,7,27,20
60,ARI,P012707,13.332,-12,15,27
60,ARI,P012708,27.116,12,54,42
60,ARI,P012716,20.366,-10,21,31
60,ARI,P012760,19.299,-5,38,43
60,BUD,P004945,31.35,15,57,42
60,BUD,P006566,3.667,-7,6,13
60,BUD,P007398,22.9,1,38,37
60,BUD,P009214,3.733,-4,7,11
60,BUD,P010248,13.467,3,21,18
60,BUD,P010432,26.017,-5,42,47
60,BUD,P011935,36.268,2,56,54
60,BUD,P012605,14.233,0,19,19
60,BUD,P012606,28.535,-5,44,49
60,BUD,P012630,19.835,-10,25,35
61,HTA,P003533,16.384,-5,30,35
61,HTA,P004267,13.218,-6,28,34
61,HTA,P004846,27.752,-8,62,70
61,HTA,P006835,32.818,-8,73,81
61,HTA,P007759,27.134,-4,65,69
61,HTA,P010465,24.451,-3,59,62
61,HTA,P011973,22.351,0,57,57
61,HTA,P011990,5.667,0,10,10
61,HTA,P011991,30.235,-11,61,72
61,PMT,P001686,21.351,16,58,42
61,PMT,P002020,8.067,5,21,16
61,PMT,P002644,18.45,6,39,33
61,PMT,P011823,21.552,3,59,56
61,PMT,P011943,5.951,-5,15,20
61,PMT,P011944,22.968,12,61,49
61,PMT,P011947,18.151,-3,40,43
61,PMT,P011966,23.701,8,58,50
61,PMT,P012599,28.718,-1,61,62
61,PMT,P012600,31.101,4,78,74
62,JOV,P002361,35.652,1,73,72
62,JOV,P005094,28.783,-20,54,74
62,JOV,P006771,24.834,-10,49,59
62,JOV,P009572,24.401,4,57,53
62,JOV,P010161,23.533,-1,52,53
62,JOV,P010708,19.701,3,44,41
62,JOV,P010709,16.651,19,43,24
62,JOV,P011248,27.2,-23,50,73
62,JOV,P012349,24.25,-8,48,56
62,PRS,P003481,12.033,-11,27,38
62,PRS,P004512,23.033,4,44,40
62,PRS,P005793,20.416,-1,49,50
62,PRS,P009556,14.217,-1,37,38
62,PRS,P012608,30.782,8,64,56
62,PRS,P012609,31.083,9,76,67
62,PRS,P012610,30.899,8,64,56
62,PRS,P012611,19.866,-4,36,40
62,PRS,P012612,8.883,13,26,13
62,PRS,P012613,7.6,-2,13,15
62,PRS,P012640,26.183,12,69,57
63,BES,P003783,11.317,-17,9,26
63,BES,P005348,18.267,1,34,33
63,BES,P007914,19.75,-10,37,47
63,BES,P007917,1.9,-8,0,8
63,BES,P008945,29.283,14,73,59
63,BES,P009582,29.217,17,72,55
63,BES,P011357,2.417,-2,2,4
63,BES,P011379,8.399,-8,12,20
63,BES,P011936,28.433,4,58,54
63,BES,P012622,23.95,-6,45,51
63,BES,P012647,27.067,0,58,58
63,LLI,P004479,21.4,9,47,38
63,LLI,P004773,16.15,9,34,25
63,LLI,P005247,32.584,1,65,64
63,LLI,P006600,27.799,-3,55,58
63,LLI,P009680,31.083,-1,64,65
63,LLI,P012020,12.184,6,28,22
63,LLI,P012585,30.05,-1,65,66
63,LLI,P012586,28.75,-5,57,62
64,HAM,P001990,5.767,-4,14,18
64,HAM,P009663,23.751,6,54,48
64,HAM,P010070,11.9,-3,23,26
64,HAM,P011168,22.45,4,51,47
64,HAM,P011187,18.734,-2,39,41
64,HAM,P012579,20.318,-9,40,49
64,HAM,P012580,21.101,8,46,38
64,HAM,P012581,22.782,12,52,40
64,HAM,P012582,29.001,5,66,61
64,HAM,P012648,12.567,-6,26,32
64,HAM,P012695,11.634,4,19,15
64,LJU,P001235,17.516,13,33,20
64,LJU,P002661,27.016,-10,59,69
64,LJU,P003452,35.949,-8,72,80
64,LJU,P007066,9.8,-18,14,32
64,LJU,P009392,12.9,-17,24,41
64,LJU,P009395,14.732,-9,22,31
64,LJU,P010594,2.55,-9,0,9
64,LJU,P010771,15.417,23,46,23
64,LJU,P011261,20.133,31,53,22
64,LJU,P012598,11.466,-6,21,27
64,LJU,P012700,32.516,-5,71,76
65,VNC,P003759,15.0,4,38,34
65,VNC,P004117,10.65,9,23,14
65,VNC,P004381,31.333,11,73,62
65,VNC,P008052,22.967,11,51,40
65,VNC,P009400,27.334,16,62,46
65,VNC,P011928,31.383,8,74,66
65,VNC,P012587,5.883,-1,14,15
65,VNC,P012590,23.5,11,52,41
65,VNC,P012591,31.95,11,78,67
65,WOL,P002387,31.267,-14,56,70
65,WOL,P004229,11.967,-5,19,24
65,WOL,P004645,15.334,-6,34,40
65,WOL,P005516,25.918,-16,44,60
65,WOL,P006154,24.484,-10,50,60
65,WOL,P006907,9.967,-5,20,25
65,WOL,P012576,22.284,-10,43,53
65,WOL,P012577,31.317,-11,64,75
65,WOL,PLCT,27.467,-3,55,58
66,ARI,P002867,14.5,-2,19,21
66,ARI,P003240,9.266,-7,9,16
66,ARI,P004292,27.433,0,51,51
66,ARI,P012615,23.982,-15,34,49
66,ARI,P012616,11.133,11,25,14
66,ARI,P012702,15.067,-6,19,25
66,ARI,P012707,30.249,-6,51,57
66,ARI,P012708,19.033,-3,28,31
66,ARI,P012716,25.766,-10,43,53
66,ARI,P012760,23.566,3,46,43
66,BOU,P000498,5.184,-7,4,11
66,BOU,P004525,21.984,3,45,42
66,BOU,P010431,27.684,4,48,44
66,BOU,P010450,10.218,-10,10,20
66,BOU,P010718,25.833,6,44,38
66,BOU,P011161,19.017,-5,33,38
66,BOU,P011836,29.833,14,62,48
66,BOU,P011837,18.017,4,27,23
66,BOU,P012617,24.684,20,54,34
66,BOU,P012628,17.551,6,33,27
67,BUD,P002740,22.15,-8,33,41
67,BUD,P004945,31.851,-15,53,68
67,BUD,P007398,16.184,0,26,26
67,BUD,P009214,7.566,-5,15,20
67,BUD,P010248,21.567,-9,39,48
67,BUD,P010432,18.434,-8,28,36
67,BUD,P011935,32.435,-12,52,64
67,BUD,P012605,11.684,-13,16,29
67,BUD,P012606,28.667,-5,53,58
67,BUD,P012630,9.467,-10,20,30
67,ULM,P005422,25.734,18,61,43
67,ULM,P006997,24.083,15,58,43
67,ULM,P010106,26.2,14,53,39
67,ULM,P010582,25.266,10,50,40
67,ULM,P010726,4.25,0,5,5
67,ULM,P011457,15.634,2,29,27
67,ULM,P012603,23.566,11,52,41
67,ULM,P012604,18.7,5,31,26
67,ULM,P012629,20.334,7,47,40
67,ULM,P012703,16.233,3,34,31
68,CLU,P004862,27.733,25,67,42
68,CLU,P005113,18.266,14,35,21
68,CLU,P005373,17.582,22,50,28
68,CLU,P005714,16.232,12,41,29
68,CLU,P010569,17.083,10,41,31
68,CLU,P010997,1.933,4,7,3
68,CLU,P011797,26.899,33,67,34
68,CLU,P011801,19.182,22,50,28
68,CLU,P011907,1.933,4,7,3
68,CLU,P012620,13.349,10,34,24
68,CLU,P012621,24.732,18,55,37
68,CLU,P012698,15.066,16,36,20
68,TRN,P001479,20.267,-8,32,40
68,TRN,P005059,14.416,-18,15,33
68,TRN,P005738,23.882,-32,39,71
68,TRN,P006382,17.884,-3,27,30
68,TRN,P007828,16.0,-1,33,34
68,TRN,P009903,21.999,-27,30,57
68,TRN,P012593,26.316,-23,44,67
68,TRN,P012594,9.583,-19,12,31
68,TRN,P012595,13.966,-18,15,33
68,TRN,P012596,13.85,-9,19,28
68,TRN,P012597,21.832,-32,34,66
69,CAN,P001607,22.916,13,56,43
69,CAN,P003425,15.317,-1,25,26
69,CAN,P003637,18.95,-1,44,45
69,CAN,P004160,7.75,3,12,9
69,CAN,P005005,24.849,-12,51,63
69,CAN,P007560,17.534,-1,30,31
69,CAN,P007644,18.016,14,47,33
69,CAN,P008121,12.684,11,25,14
69,CAN,P009864,12.483,-16,11,27
69,CAN,P010385,13.668,13,32,19
69,CAN,P010452,17.666,2,34,32
69,CAN,P010484,18.167,-5,38,43
69,WRO,P003034,18.434,-15,29,44
69,WRO,P005531,22.651,-19,30,49
69,WRO,P009896,25.351,12,52,40
69,WRO,P011165,32.218,3,69,66
69,WRO,P011900,20.634,-4,41,45
69,WRO,P011901,8.383,16,26,10
69,WRO,P011902,18.283,11,45,34
69,WRO,P012010,27.367,-13,46,59
69,WRO,P012699,16.05,2,36,34
69,WRO,P012736,10.634,-13,11,24
70,LKB,P002012,32.733,19,79,60
70,LKB,P004868,12.866,-17,14,31
70,LKB,P005521,36.016,19,83,64
70,LKB,P006230,30.333,9,63,54
70,LKB,P006901,4.35,2,12,10
70,LKB,P008856,40.416,17,85,68
70,LKB,P010190,13.566,-22,18,40
70,LKB,P010461,14.066,3,30,27
70,LKB,PLXI,40.649,5,81,76
70,TTK,P005000,38.2,-11,73,84
70,TTK,P005685,7.117,-4,16,20
70,TTK,P006693,20.984,1,43,42
70,TTK,P009845,6.983,6,20,14
70,TTK,P011239,37.883,-3,70,73
70,TTK,P011834,18.75,-7,25,32
70,TTK,P011925,41.35,-6,80,86
70,TTK,P011975,3.85,-6,8,14
70,TTK,P012056,35.483,0,70,70
70,TTK,P012697,14.4,-5,25,30
71,PMT,P001686,25.619,2,52,50
71,PMT,P002020,7.616,-1,17,18
71,PMT,P002644,30.653,11,71,60
71,PMT,P010549,12.901,-2,29,31
71,PMT,P011823,16.118,2,38,36
71,PMT,P011943,20.169,8,46,38
71,PMT,P011944,23.952,4,51,47
71,PMT,P011947,26.135,6,59,53
71,PMT,P011966,24.835,0,53,53
71,PMT,P012600,12.017,5,29,24
71,VNC,P000968,24.05,-7,48,55
71,VNC,P003759,25.517,-6,51,57
71,VNC,P004117,12.983,1,29,28
71,VNC,P008052,26.717,-3,56,59
71,VNC,P009400,26.417,-2,54,56
71,VNC,P011928,22.833,-1,49,50
71,VNC,P012587,27.216,-4,57,61
71,VNC,P012591,34.267,-13,66,79
72,HAM,P001990,15.917,-11,26,37
72,HAM,P009663,27.617,-11,47,58
72,HAM,P010070,22.767,-2,42,44
72,HAM,P011187,24.467,2,47,45
72,HAM,P012579,23.701,-1,45,46
72,HAM,P012580,23.75,-7,40,47
72,HAM,P012581,19.417,-9,36,45
72,HAM,P012582,14.367,-12,22,34
72,HAM,P012648,12.434,-7,21,28
72,HAM,P012694,3.567,-1,7,8
72,HAM,P012695,12.001,-6,22,28
72,WOL,P002387,22.319,1,43,42
72,WOL,P003212,18.836,8,37,29
72,WOL,P004229,10.684,-2,25,27
72,WOL,P004645,26.568,18,59,41
72,WOL,P005516,25.668,2,49,47
72,WOL,P006154,21.284,17,55,38
72,WOL,P006907,11.668,-4,19,23
72,WOL,P012576,18.668,11,40,29
72,WOL,P012577,30.652,13,64,51
72,WOL,PLCT,13.668,1,29,28
73,LJU,P001235,2.05,1,3,2
73,LJU,P002661,31.017,-3,82,85
73,LJU,P003452,34.717,2,83,81
73,LJU,P005969,30.95,-4,75,79
73,LJU,P007066,25.516,-1,62,63
73,LJU,P009392,10.383,-3,19,22
73,LJU,P010594,11.9,1,28,27
73,LJU,P011261,5.017,-3,13,16
73,LJU,P012598,20.034,-11,43,54
73,LJU,P012700,28.416,-9,67,76
73,LLI,P003850,5.166,-7,9,16
73,LLI,P004773,25.966,2,64,62
73,LLI,P005247,28.899,-7,59,66
73,LLI,P006600,27.7,11,77,66
73,LLI,P008274,10.083,-2,22,24
73,LLI,P009680,34.266,8,89,81
73,LLI,P012020,10.216,0,21,21
73,LLI,P012584,0.05,0,0,0
73,LLI,P012585,26.166,13,79,66
73,LLI,P012586,31.483,12,85,73
74,BES,P003783,19.816,-1,37,38
74,BES,P005348,15.216,6,23,17
74,BES,P007914,26.566,8,55,47
74,BES,P007917,1.65,-3,2,5
74,BES,P008945,20.182,6,31,25
74,BES,P009582,23.915,6,34,28
74,BES,P011357,9.216,5,21,16
74,BES,P011379,10.516,-5,13,18
74,BES,P011936,27.332,-7,45,52
74,BES,P012622,26.932,7,47,40
74,BES,P012647,18.649,3,32,29
74,PRS,P003481,12.834,4,28,24
74,PRS,P004512,16.834,-5,25,30
74,PRS,P005793,19.818,-1,34,35
74,PRS,P012608,27.3,-11,35,46
74,PRS,P012609,29.051,-5,45,50
74,PRS,P012610,25.617,-11,33,44
74,PRS,P012611,18.901,3,38,35
74,PRS,P012612,6.267,4,9,5
74,PRS,P012613,20.633,-3,30,33
74,PRS,P012640,22.75,0,38,38
75,HTA,P003533,9.133,-6,20,26
75,HTA,P004267,7.55,0,16,16
75,HTA,P004846,23.883,7,64,57
75,HTA,P006835,29.35,7,78,71
75,HTA,P007759,34.116,5,89,84
75,HTA,P010465,26.968,-4,67,71
75,HTA,P011973,30.867,10,83,73
75,HTA,P011990,3.516,0,9,9
75,HTA,P011991,34.617,1,89,88
75,JOV,P005094,34.798,-8,81,89
75,JOV,P006771,19.582,12,54,42
75,JOV,P009572,8.532,-4,24,28
75,JOV,P010161,13.383,-12,27,39
75,JOV,P010708,4.8,-2,11,13
75,JOV,P011247,32.716,0,77,77
75,JOV,P011248,31.216,-4,75,79
75,JOV,P012349,10.749,-10,26,36
75,JOV,P012780,29.432,12,80,68
75,JOV,PJUG,14.782,-4,40,44
76,BOU,P000498,18.416,7,44,37
76,BOU,P004525,16.316,-3,34,37
76,BOU,P010431,23.1,16,45,29
76,BOU,P010450,1.883,6,6,0
76,BOU,P010718,28.851,24,64,40
76,BOU,P011161,19.783,-5,44,49
76,BOU,P011836,23.684,22,52,30
76,BOU,P011837,30.15,24,64,40
76,BOU,P012617,21.584,12,42,30
76,BOU,P012619,9.85,-5,22,27
76,BOU,P012628,6.383,-3,13,16
76,TTK,P000497,4.334,-11,7,18
76,TTK,P004801,22.801,-14,35,49
76,TTK,P005000,37.369,-10,67,77
76,TTK,P006693,29.818,-2,59,61
76,TTK,P009845,7.301,-15,12,27
76,TTK,P011239,34.935,-3,61,64
76,TTK,P011834,23.967,-8,46,54
76,TTK,P011925,29.451,-10,41,51
76,TTK,P011975,2.284,-5,5,10
76,TTK,P012697,7.75,-17,2,19
77,LKB,P002012,25.115,18,59,41
77,LKB,P004868,19.517,10,38,28
77,LKB,P005521,22.933,18,55,37
77,LKB,P006901,14.884,-14,16,30
77,LKB,P007029,23.299,-15,32,47
77,LKB,P008856,28.249,9,59,50
77,LKB,P010190,14.467,-6,19,25
77,LKB,P010461,20.399,-6,37,43
77,LKB,PLXI,31.132,6,60,54
77,WRO,P003034,16.949,-4,24,28
77,WRO,P005531,34.282,-3,67,70
77,WRO,P009896,22.917,0,47,47
77,WRO,P011900,28.65,5,56,51
77,WRO,P011901,7.567,2,10,8
77,WRO,P011902,9.916,-7,9,16
77,WRO,P012010,32.432,-6,61,67
77,WRO,P012699,28.866,-3,55,58
77,WRO,P012736,18.416,-4,26,30
78,CAN,P001607,13.984,5,34,29
78,CAN,P003425,26.017,17,58,41
78,CAN,P003637,21.534,-1,40,41
78,CAN,P004160,25.2,19,54,35
78,CAN,P005005,16.884,2,40,38
78,CAN,P007560,19.084,23,54,31
78,CAN,P007644,25.734,22,66,44
78,CAN,P009864,16.617,6,43,37
78,CAN,P010385,14.601,20,34,14
78,CAN,P010452,18.6,-1,33,34
78,CAN,P010484,1.75,-2,4,6
78,CLU,P004862,26.099,-27,40,67
78,CLU,P005113,24.734,-2,48,50
78,CLU,P005373,9.9,-14,13,27
78,CLU,P005714,23.267,-15,40,55
78,CLU,P010569,21.816,-16,36,52
78,CLU,P011797,14.934,-7,25,32
78,CLU,P011801,25.4,-15,45,60
78,CLU,P012620,0.067,-2,0,2
78,CLU,P012621,25.749,-1,51,52
78,CLU,P012698,28.034,-11,52,63
79,BUD,P002740,21.9,1,48,47
79,BUD,P004397,4.183,-5,6,11
79,BUD,P004945,16.333,-1,42,43
79,BUD,P006566,4.983,-11,6,17
79,BUD,P007398,24.117,-2,52,54
79,BUD,P009214,10.666,-3,24,27
79,BUD,P010248,33.133,-2,73,75
79,BUD,P010432,11.867,4,25,21
79,BUD,P011935,30.151,10,68,58
79,BUD,P012605,16.418,10,34,24
79,BUD,P012606,28.582,-8,64,72
79,BUD,P012630,22.667,17,48,31
79,TRN,P001479,17.083,-14,20,34
79,TRN,P005738,27.917,12,76,64
79,TRN,P006382,16.302,-14,27,41
79,TRN,P007828,8.066,-9,15,24
79,TRN,P009903,29.833,9,74,65
79,TRN,P012593,15.966,13,40,27
79,TRN,P012594,26.183,15,62,47
79,TRN,P012595,31.434,-15,61,76
79,TRN,P012596,15.167,-11,22,33
79,TRN,P012597,37.049,4,83,79
80,ARI,P002867,22.35,-6,41,47
80,ARI,P003240,30.967,-11,63,74
80,ARI,P004292,25.783,-5,49,54
80,ARI,P010387,10.866,2,23,21
80,ARI,P012702,25.599,-12,46,58
80,ARI,P012707,35.134,1,76,75
80,ARI,P012708,28.566,-21,49,70
80,ARI,P012716,26.901,-4,53,57
80,ARI,P012722,10.384,3,22,19
80,ARI,P012760,8.45,-2,18,20
80,ULM,P005422,29.584,9,64,55
80,ULM,P006997,13.366,-5,29,34
80,ULM,P007952,17.683,8,39,31
80,ULM,P010106,35.6,11,82,71
80,ULM,P010582,33.799,13,79,66
80,ULM,P010726,13.25,1,27,26
80,ULM,P011457,20.05,-9,32,41
80,ULM,P012603,26.851,19,67,48
80,ULM,P012604,25.417,8,59,51
80,ULM,P012703,9.4,0,17,17
81,JOV,P002361,26.167,15,59,44
81,JOV,P002507,6.767,-3,11,14
81,JOV,P005094,16.934,-8,29,37
81,JOV,P006771,14.049,12,34,22
81,JOV,P009572,5.75,0,15,15
81,JOV,P010161,13.818,-11,20,31
81,JOV,P010708,15.583,23,43,20
81,JOV,P011247,20.084,-13,28,41
81,JOV,P011248,29.502,-6,49,55
81,JOV,P012349,23.067,11,50,39
81,JOV,P012780,17.651,-17,25,42
81,JOV,PJUG,10.633,12,32,20
81,PMT,P001686,20.283,-7,34,41
81,PMT,P002020,11.966,8,27,19
81,PMT,P002644,29.999,2,56,54
81,PMT,P010549,17.982,-1,30,31
81,PMT,P011823,17.748,-9,35,44
81,PMT,P011943,9.05,-3,20,23
81,PMT,P011944,23.498,4,45,41
81,PMT,P011947,25.149,0,50,50
81,PMT,P011966,18.083,-5,35,40
81,PMT,P012600,26.232,-4,48,52
82,BES,P003783,19.017,-1,36,37
82,BES,P005348,5.917,1,13,12
82,BES,P007914,19.167,-7,40,47
82,BES,P007917,11.1,1,23,22
82,BES,P008945,28.401,-5,53,58
82,BES,P009582,23.084,-10,39,49
82,BES,P011357,1.517,-2,0,2
82,BES,P011379,9.033,-1,21,22
82,BES,P011936,22.4,-2,40,42
82,BES,P012622,31.335,-4,56,60
82,BES,P012647,29.034,0,54,54
82,HTA,P003533,11.867,7,29,22
82,HTA,P004267,11.217,9,19,10
82,HTA,P004846,22.251,1,47,46
82,HTA,P006835,20.684,-6,43,49
82,HTA,P007759,28.899,5,63,58
82,HTA,P010465,26.501,-1,48,49
82,HTA,P010550,20.716,10,40,30
82,HTA,P011973,28.133,-1,52,53
82,HTA,P011991,29.732,6,64,58
83,LJU,P002661,28.682,-12,58,70
83,LJU,P003042,6.4,-9,8,17
83,LJU,P003452,35.399,-11,68,79
83,LJU,P005969,29.516,-9,61,70
83,LJU,P007066,24.699,-3,47,50
83,LJU,P009392,11.383,-5,19,24
83,LJU,P010594,3.1,-4,8,12
83,LJU,P011261,12.5,-8,18,26
83,LJU,P012598,17.683,-4,35,39
83,LJU,P012700,30.633,-15,63,78
83,PRS,P004512,13.633,5,24,19
83,PRS,P005793,23.517,4,54,50
83,PRS,P009556,14.433,0,34,34
83,PRS,P010801,0.867,0,3,3
83,PRS,P011887,16.951,5,48,43
83,PRS,P012608,25.568,16,59,43
83,PRS,P012609,29.783,7,62,55
83,PRS,P012610,25.568,16,59,43
83,PRS,P012612,8.201,12,29,17
83,PRS,P012613,22.367,-2,43,45
83,PRS,P012640,19.117,17,50,33
84,LLI,P004479,5.267,7,16,9
84,LLI,P004773,15.983,5,35,30
84,LLI,P005247,24.901,18,67,49
84,LLI,P006600,25.834,19,75,56
84,LLI,P008274,4.433,6,12,6
84,LLI,P009649,17.867,2,45,43
84,LLI,P009672,15.517,-10,37,47
84,LLI,P009680,25.717,20,67,47
84,LLI,P012020,14.117,-5,26,31
84,LLI,P012584,0.05,0,0,0
84,LLI,P012585,21.251,3,55,52
84,LLI,P012586,29.068,5,70,65
84,WOL,P003212,17.916,-14,43,57
84,WOL,P004229,8.683,-11,15,26
84,WOL,P004645,15.482,10,38,28
84,WOL,P005516,26.599,-4,54,58
84,WOL,P006154,21.149,-18,45,63
84,WOL,P006907,21.299,-21,38,59
84,WOL,P012576,31.315,-3,72,75
84,WOL,P012577,32.949,-14,73,87
84,WOL,PLCT,24.598,5,57,52
85,HAM,P001990,12.433,1,25,24
85,HAM,P009663,24.834,-14,47,61
85,HAM,P010070,17.984,2,44,42
85,HAM,P011168,23.817,-24,40,64
85,HAM,P011187,14.566,-1,30,31
85,HAM,P012579,15.134,-3,33,36
85,HAM,P012580,21.6,-22,36,58
85,HAM,P012581,18.95,-16,31,47
85,HAM,P012582,31.784,-8,67,75
85,HAM,P012648,9.316,2,16,14
85,HAM,P012694,6.049,-6,6,12
85,HAM,P012695,3.533,4,10,6
85,VNC,P000968,14.833,0,31,31
85,VNC,P003759,15.85,4,40,36
85,VNC,P004381,25.167,17,63,46
85,VNC,P008052,24.767,19,63,44
85,VNC,P009400,18.899,11,48,37
85,VNC,P011909,24.75,14,54,40
85,VNC,P011928,26.767,6,56,50
85,VNC,P012493,0.983,-1,4,5
85,VNC,P012587,18.8,1,44,43
85,VNC,P012588,2.25,-2,4,6
85,VNC,P012591,26.934,16,63,47
86,BOU,P000498,13.932,-2,31,33
86,BOU,P004525,21.633,9,57,48
86,BOU,P010431,24.9,20,65,45
86,BOU,P010718,26.199,-8,54,62
86,BOU,P011161,16.582,-4,34,38
86,BOU,P011836,25.866,-5,53,58
86,BOU,P011837,22.399,5,52,47
86,BOU,P012617,25.284,7,58,51
86,BOU,P012619,10.1,1,16,15
86,BOU,P012628,13.1,2,25,23
86,ULM,P005422,28.1,-3,54,57
86,ULM,P010106,26.75,-11,55,66
86,ULM,P010582,28.467,-8,55,63
86,ULM,P010726,2.4,-5,4,9
86,ULM,P011391,5.517,-2,11,13
86,ULM,P011457,18.549,11,42,31
86,ULM,P012603,26.785,-2,65,67
86,ULM,P012604,33.951,-3,71,74
86,ULM,P012629,12.968,-2,32,34
86,ULM,P012703,16.518,0,31,31
87,ARI,P002867,24.217,-2,45,47
87,ARI,P003240,33.752,-4,58,62
87,ARI,P010177,3.667,8,10,2
87,ARI,P010387,7.316,2,14,12
87,ARI,P012616,12.117,-8,12,20
87,ARI,P012702,17.501,6,37,31
87,ARI,P012707,29.617,0,47,47
87,ARI,P012716,33.718,1,61,60
87,ARI,P012717,15.6,-5,21,26
87,ARI,P012722,12.833,0,21,21
87,ARI,P012760,9.667,-8,9,17
87,TRN,P001479,16.449,1,28,27
87,TRN,P005738,23.55,1,41,40
87,TRN,P006382,17.433,-3,31,34
87,TRN,P007828,19.416,7,36,29
87,TRN,P009903,23.282,1,37,36
87,TRN,P012593,22.75,-2,38,40
87,TRN,P012595,26.099,3,43,40
87,TRN,P012596,16.717,1,32,31
87,TRN,P012597,31.216,5,59,54
87,TRN,P012687,3.083,-4,0,4
88,BUD,P002740,21.7,-13,43,56
88,BUD,P004397,21.5,4,43,39
88,BUD,P004945,19.433,-14,32,46
88,BUD,P006566,17.334,-19,26,45
88,BUD,P007398,20.216,-12,36,48
88,BUD,P009214,4.633,-6,7,13
88,BUD,P010248,28.617,-10,54,64
88,BUD,P010432,11.383,-17,16,33
88,BUD,P011935,13.734,-22,20,42
88,BUD,P012605,20.167,-16,32,48
88,BUD,P012606,21.283,-10,41,51
88,CAN,P001607,22.666,23,58,35
88,CAN,P003425,17.051,7,39,32
88,CAN,P003637,15.884,5,37,32
88,CAN,P004160,24.116,22,60,38
88,CAN,P005005,14.083,16,36,20
88,CAN,P007560,7.599,0,17,17
88,CAN,P007644,21.384,16,54,38
88,CAN,P008121,18.601,8,44,36
88,CAN,P009864,20.966,10,46,36
88,CAN,P010385,16.801,20,47,27
88,CAN,P010452,16.183,10,38,28
88,CAN,P010484,4.666,-2,9,11
89,CLU,P004862,30.015,6,88,82
89,CLU,P005113,21.95,2,57,55
89,CLU,P005373,20.549,10,56,46
89,CLU,P005714,13.9,-11,30,41
89,CLU,P010569,32.831,21,97,76
89,CLU,P011797,26.398,16,79,63
89,CLU,P011801,29.899,0,79,79
89,CLU,P012620,9.2,-2,16,18
89,CLU,P012621,13.116,5,28,23
89,CLU,P012698,27.132,-2,70,72
89,LKB,P002012,33.833,-1,87,88
89,LKB,P004868,16.384,-11,32,43
89,LKB,P005521,30.55,-9,78,87
89,LKB,P006901,10.767,-5,24,29
89,LKB,P007029,36.65,6,101,95
89,LKB,P008856,19.5,-13,40,53
89,LKB,P010190,15.65,-1,37,38
89,LKB,P010461,26.516,2,69,67
89,LKB,PLXI,35.15,-13,87,100
90,TTK,P000497,7.399,2,15,13
90,TTK,P004801,25.665,-12,36,48
90,TTK,P005000,22.3,-14,32,46
90,TTK,P005685,4.717,-6,7,13
90,TTK,P006693,26.082,10,50,40
90,TTK,P009845,4.816,0,9,9
90,TTK,P011239,30.466,-3,55,58
90,TTK,P011834,18.15,-14,29,43
90,TTK,P011925,33.183,-6,61,67
90,TTK,P011975,3.9,5,14,9
90,TTK,P012697,23.317,-7,47,54
90,WRO,P003034,22.651,19,56,37
90,WRO,P005531,35.536,14,71,57
90,WRO,P007472,13.752,-4,23,27
90,WRO,P009896,17.185,-10,24,34
90,WRO,P011900,33.318,5,69,64
90,WRO,P011901,21.402,14,50,36
90,WRO,P011902,4.5,5,14,9
90,WRO,P012699,33.269,-1,59,60
90,WRO,P012736,10.868,-1,15,16
90,WRO,P012749,7.534,4,19,15
91,HAM,P001990,17.467,-2,43,45
91,HAM,P009663,21.134,-7,38,45
91,HAM,P010070,20.368,0,49,49
91,HAM,P011168,22.534,-12,40,52
91,HAM,P011187,18.867,-7,45,52
91,HAM,P012579,19.817,-4,48,52
91,HAM,P012580,25.034,-13,42,55
91,HAM,P012581,23.617,-1,52,53
91,HAM,P012582,19.167,-9,35,44
91,HAM,P012648,7.334,-14,13,27
91,HAM,P012694,4.666,-1,10,11
91,PMT,P001686,26.099,3,64,61
91,PMT,P002020,13.9,11,33,22
91,PMT,P002644,22.182,7,61,54
91,PMT,P010549,22.066,18,55,37
91,PMT,P011823,17.817,7,36,29
91,PMT,P011942,14.849,-8,35,43
91,PMT,P011944,22.033,8,54,46
91,PMT,P011947,8.466,0,19,19
91,PMT,P011966,24.533,1,54,53
91,PMT,P012600,28.05,23,74,51
92,LLI,P005247,25.917,11,65,54
92,LLI,P006600,27.217,4,71,67
92,LLI,P008274,14.551,7,26,19
92,LLI,P009649,24.949,-2,59,61
92,LLI,P009672,9.949,5,28,23
92,LLI,P009680,30.867,5,78,73
92,LLI,P012020,12.783,0,24,24
92,LLI,P012585,31.367,-4,75,79
92,LLI,P012586,22.4,-6,49,55
92,VNC,P000968,13.401,1,26,25
92,VNC,P003759,11.084,-3,17,20
92,VNC,P004117,13.7,-7,25,32
92,VNC,P004381,26.6,-5,65,70
92,VNC,P008052,24.051,0,59,59
92,VNC,P009400,19.251,-5,40,45
92,VNC,P011909,16.25,-3,34,37
92,VNC,P011928,31.167,2,81,79
92,VNC,P012590,19.384,-13,38,51
92,VNC,P012591,25.117,13,70,57
93,PRS,P004512,17.183,21,51,30
93,PRS,P005793,24.333,16,66,50
93,PRS,P009556,13.832,4,32,28
93,PRS,P010801,2.116,3,9,6
93,PRS,P011232,12.166,4,28,24
93,PRS,P011551,2.116,3,9,6
93,PRS,P011887,18.265,17,49,32
93,PRS,P012608,26.166,27,78,51
93,PRS,P012609,11.266,10,29,19
93,PRS,P012610,26.166,27,78,51
93,PRS,P012613,22.599,10,57,47
93,PRS,P012640,23.782,13,64,51
93,WOL,P002387,19.865,-15,39,54
93,WOL,P003212,22.066,-19,41,60
93,WOL,P004229,17.499,-20,31,51
93,WOL,P004645,21.584,-11,44,55
93,WOL,P005516,27.083,-18,57,75
93,WOL,P006154,23.932,-14,48,62
93,WOL,P006907,6.433,-11,10,21
93,WOL,P012576,15.433,-9,33,42
93,WOL,P012577,23.133,-23,42,65
93,WOL,P012789,7.067,-2,15,17
93,WOL,PLCT,15.9,-13,35,48
94,HTA,P003533,13.75,14,40,26
94,HTA,P004267,16.834,9,46,37
94,HTA,P004846,22.467,7,53,46
94,HTA,P006835,20.817,20,57,37
94,HTA,P007759,23.634,-1,48,49
94,HTA,P010465,26.184,11,61,50
94,HTA,P010550,20.367,-3,43,46
94,HTA,P011973,25.068,-1,50,51
94,HTA,P011991,30.884,19,77,58
94,LJU,P003042,2.417,-8,2,10
94,LJU,P003452,36.969,-16,74,90
94,LJU,P005969,26.601,-11,51,62
94,LJU,P009392,8.467,-8,13,21
94,LJU,P009395,34.801,-3,70,73
94,LJU,P010594,12.351,-1,31,32
94,LJU,P011261,23.452,-10,51,61
94,LJU,P012598,18.601,-5,35,40
94,LJU,P012700,36.351,-13,73,86
95,BES,P003783,11.867,-13,12,25
95,BES,P005348,16.484,-8,32,40
95,BES,P007914,12.933,-3,24,27
95,BES,P008945,29.617,2,69,67
95,BES,P009582,24.399,0,56,56
95,BES,P011357,7.65,5,22,17
95,BES,P011379,14.484,1,25,24
95,BES,P011936,31.584,2,72,70
95,BES,P012622,25.399,1,49,48
95,BES,P012647,25.583,-7,44,51
95,JOV,P002507,20.182,5,43,38
95,JOV,P005094,25.465,-1,54,55
95,JOV,P006771,24.151,-2,46,48
95,JOV,P009572,11.732,2,19,17
95,JOV,P010161,0.017,0,0,0
95,JOV,P010708,9.884,-3,18,21
95,JOV,P010709,5.166,-3,11,14
95,JOV,P011247,29.366,0,66,66
95,JOV,P011248,26.7,5,61,56
95,JOV,P012349,14.534,5,31,26
95,JOV,P012780,18.432,7,43,36
95,JOV,PJUG,14.366,5,33,28
96,BOU,P000498,21.251,-5,28,33
96,BOU,P004525,19.485,8,31,23
96,BOU,P010431,18.352,17,41,24
96,BOU,P010450,19.968,-1,26,27
96,BOU,P010718,20.751,8,48,40
96,BOU,P011836,12.4,10,28,18
96,BOU,P011837,12.834,2,29,27
96,BOU,P012617,25.234,8,55,47
96,BOU,P012618,17.251,6,33,27
96,BOU,P012619,9.917,1,10,9
96,BOU,P012628,22.567,-9,31,40
96,WRO,P003034,16.85,-12,17,29
96,WRO,P007472,7.333,-2,13,15
96,WRO,P009896,23.017,2,45,43
96,WRO,P011278,5.816,-2,5,7
96,WRO,P011900,33.134,-4,57,61
96,WRO,P011901,27.316,2,51,49
96,WRO,P012601,31.266,-7,47,54
96,WRO,P012699,31.084,-6,53,59
96,WRO,P012736,20.55,-14,22,36
96,WRO,P012749,3.634,-2,5,7
97,CLU,P004862,23.184,-14,48,62
97,CLU,P005113,17.367,-11,36,47
97,CLU,P005373,21.716,0,44,44
97,CLU,P005714,11.734,-4,23,27
97,CLU,P010569,26.883,-3,60,63
97,CLU,P011797,25.95,-16,47,63
97,CLU,P011801,27.95,-4,61,65
97,CLU,P012621,19.5,-8,44,52
97,CLU,P012698,25.716,5,57,52
97,TTK,P004801,29.666,18,67,49
97,TTK,P005000,21.25,12,60,48
97,TTK,P005685,14.05,1,30,29
97,TTK,P006693,31.799,9,71,62
97,TTK,P009845,4.25,2,13,11
97,TTK,P011239,25.932,10,65,55
97,TTK,P011834,37.949,10,94,84
97,TTK,P011925,34.233,0,73,73
97,TTK,P011975,0.866,-7,2,9
98,BUD,P002740,26.115,5,57,52
98,BUD,P004397,13.7,-5,19,24
98,BUD,P004945,27.316,2,58,56
98,BUD,P006566,26.499,2,62,60
98,BUD,P007398,15.3,-2,30,32
98,BUD,P010248,25.166,3,58,55
98,BUD,P010432,14.85,-4,25,29
98,BUD,P011281,22.032,3,46,43
98,BUD,P011935,10.767,4,22,18
98,BUD,P012605,3.817,1,10,9
98,BUD,P012606,14.433,1,28,27
98,LKB,P002012,28.9,6,61,55
98,LKB,P004868,9.816,-2,20,22
98,LKB,P005521,28.165,-5,61,66
98,LKB,P006230,20.083,12,42,30
98,LKB,P006901,1.533,0,2,2
98,LKB,P007029,30.05,-3,58,61
98,LKB,P008856,26.366,0,46,46
98,LKB,P010190,6.783,-2,16,18
98,LKB,P010461,17.883,-11,37,48
98,LKB,PLXI,30.416,-5,62,67
99,ARI,P002867,16.968,-17,20,37
99,ARI,P004292,20.866,-18,39,57
99,ARI,P010177,1.85,0,4,4
99,ARI,P010387,17.034,-13,23,36
99,ARI,P012616,19.401,-19,30,49
99,ARI,P012702,20.201,-8,36,44
99,ARI,P012707,19.167,-10,30,40
99,ARI,P012708,23.366,-13,41,54
99,ARI,P012716,18.385,-7,31,38
99,ARI,P012717,22.967,-15,42,57
99,ARI,P012722,14.834,-14,25,39
99,ARI,P012760,4.966,-6,4,10
99,CAN,P001607,18.35,12,39,27
99,CAN,P003425,18.617,13,44,31
99,CAN,P003637,16.95,9,41,32
99,CAN,P004160,22.251,18,50,32
99,CAN,P005005,15.667,6,37,31
99,CAN,P007560,8.484,11,21,10
99,CAN,P007644,28.718,21,65,44
99,CAN,P008121,19.684,15,47,32
99,CAN,P009864,12.633,4,31,27
99,CAN,P010385,15.384,18,37,19
99,CAN,P010452,16.85,8,38,30
99,CAN,P010484,6.417,5,15,10
100,TRN,P001479,22.299,6,52,46
100,TRN,P005738,29.583,1,57,56
100,TRN,P006382,12.251,5,27,22
100,TRN,P007828,6.999,-7,5,12
100,TRN,P009903,28.116,-11,57,68
100,TRN,P012593,21.799,-10,36,46
100,TRN,P012595,31.016,4,71,67
100,TRN,P012597,31.583,-1,74,75
100,TRN,P012687,16.349,3,36,33
100,ULM,P005422,22.216,-3,55,58
100,ULM,P006997,15.45,-6,33,39
100,ULM,P010106,22.7,-15,43,58
100,ULM,P010582,18.817,11,39,28
100,ULM,P010726,14.784,-5,29,34
100,ULM,P011457,10.234,0,14,14
100,ULM,P012603,29.084,6,71,65
100,ULM,P012604,26.401,3,54,51
100,ULM,P012629,20.501,1,40,39
100,ULM,P012703,19.818,18,47,29
101,BES,P003783,25.499,-21,40,61
101,BES,P005348,5.116,-8,11,19
101,BES,P007914,28.067,-2,54,56
101,BES,P008945,19.666,6,40,34
101,BES,P009582,13.15,-11,20,31
101,BES,P011357,3.833,-13,5,18
101,BES,P011379,15.033,-12,23,35
101,BES,P011924,17.866,-23,27,50
101,BES,P011936,22.266,-5,38,43
101,BES,P012622,28.633,-9,53,62
101,BES,P012647,20.866,3,39,36
101,PMT,P001686,10.766,4,28,24
101,PMT,P002020,3.084,-8,2,10
101,PMT,P002644,22.75,11,49,38
101,PMT,P010549,22.35,23,53,30
101,PMT,P011823,17.634,10,42,32
101,PMT,P011942,3.084,-8,2,10
101,PMT,P011943,30.118,24,67,43
101,PMT,P011944,16.183,-9,24,33
101,PMT,P011947,19.267,17,48,31
101,PMT,P011966,26.801,29,73,44
101,PMT,P012600,27.968,2,57,55
102,JOV,P002361,17.669,13,44,31
102,JOV,P002507,22.102,4,41,37
102,JOV,P005094,16.918,-6,31,37
102,JOV,P006771,20.501,3,43,40
102,JOV,P010458,15.067,-2,36,38
102,JOV,P010708,13.05,1,29,28
102,JOV,P011247,27.0,-8,50,58
102,JOV,P011248,28.501,13,63,50
102,JOV,P012349,19.668,2,38,36
102,JOV,P012780,4.683,-6,10,16
102,JOV,PJUG,14.851,-4,30,34
102,LJU,P002561,4.799,-1,9,10
102,LJU,P003452,30.467,-2,62,64
102,LJU,P005969,35.684,-1,72,73
102,LJU,P009392,5.484,-5,10,15
102,LJU,P009395,36.484,0,73,73
102,LJU,P010594,27.667,-3,55,58
102,LJU,P011261,13.133,-4,24,28
102,LJU,P012598,13.899,1,32,31
102,LJU,P012700,32.383,5,68,63
103,HTA,P003533,8.451,-8,12,20
103,HTA,P004267,13.65,-1,28,29
103,HTA,P004846,18.417,2,44,42
103,HTA,P006835,24.3,8,61,53
103,HTA,P007759,29.333,6,62,56
103,HTA,P010465,31.667,18,77,59
103,HTA,P010550,22.083,3,44,41
103,HTA,P011973,17.466,-3,36,39
103,HTA,P011991,34.633,15,81,66
103,WOL,P002387,25.101,-6,56,62
103,WOL,P003212,20.317,-13,39,52
103,WOL,P004645,12.583,-3,19,22
103,WOL,P005516,30.966,7,69,62
103,WOL,P006154,15.95,0,27,27
103,WOL,P006546,25.633,-3,59,62
103,WOL,P012576,30.516,-2,66,68
103,WOL,P012577,25.5,-9,47,56
103,WOL,P012789,9.484,-6,15,21
103,WOL,PLCT,3.95,-5,8,13
104,PRS,P004512,14.901,-5,28,33
104,PRS,P005793,17.618,3,41,38
104,PRS,P009556,17.234,27,50,23
104,PRS,P010801,10.001,4,13,9
104,PRS,P011232,19.367,29,56,27
104,PRS,P011551,3.95,3,5,2
104,PRS,P011887,7.834,-5,12,17
104,PRS,P012608,23.368,7,52,45
104,PRS,P012609,21.134,19,56,37
104,PRS,P012610,23.435,5,52,47
104,PRS,P012613,22.284,31,70,39
104,PRS,P012640,18.884,32,65,33
104,VNC,P003759,15.967,-8,27,35
104,VNC,P004381,16.117,-19,27,46
104,VNC,P008052,14.967,-8,31,39
104,VNC,P009400,13.433,-8,27,35
104,VNC,P011909,30.684,-19,51,70
104,VNC,P011928,32.601,-28,56,84
104,VNC,P012587,18.218,-10,36,46
104,VNC,P012590,29.784,-25,50,75
104,VNC,P012591,28.234,-25,45,70
105,HAM,P001990,13.401,1,37,36
105,HAM,P009663,24.033,9,57,48
105,HAM,P010070,10.567,-9,17,26
105,HAM,P011168,25.182,9,46,37
105,HAM,P011187,15.967,-7,26,33
105,HAM,P012579,20.317,-2,41,43
105,HAM,P012580,23.383,0,47,47
105,HAM,P012581,24.783,7,52,45
105,HAM,P012582,28.7,13,66,53
105,HAM,P012648,10.967,1,26,25
105,HAM,P012694,1.283,-4,0,4
105,HAM,P012695,1.417,-8,0,8
105,LLI,P004773,19.618,-3,39,42
105,LLI,P005247,20.818,5,42,37
105,LLI,P006600,27.868,-6,56,62
105,LLI,P008274,15.184,-2,27,29
105,LLI,P009649,26.701,-4,50,54
105,LLI,P009672,24.851,5,59,54
105,LLI,P009680,31.602,-2,65,67
105,LLI,P012020,12.134,4,25,21
105,LLI,P012585,21.234,-7,42,49
106,BOU,P000498,14.483,6,32,26
106,BOU,P004525,18.5,10,40,30
106,BOU,P010431,19.8,11,41,30
106,BOU,P010450,17.633,4,37,33
106,BOU,P010718,22.366,8,42,34
106,BOU,P011161,23.182,0,46,46
106,BOU,P011836,21.499,2,39,37
106,BOU,P011837,17.516,7,28,21
106,BOU,P012617,22.533,7,39,32
106,BOU,P012618,17.199,5,41,36
106,BOU,P012619,5.284,0,10,10
106,TRN,P001479,14.533,-9,22,31
106,TRN,P005059,19.4,-4,30,34
106,TRN,P005738,25.384,-1,45,46
106,TRN,P006382,10.816,-14,12,26
106,TRN,P007828,2.35,4,9,5
106,TRN,P009903,24.968,-15,31,46
106,TRN,P012593,18.182,-11,33,44
106,TRN,P012594,16.55,-11,25,36
106,TRN,P012595,27.284,-3,49,52
106,TRN,P012596,15.032,3,36,33
106,TRN,P012597,25.501,1,43,42
107,CAN,P001607,25.0,7,60,53
107,CAN,P003425,18.967,-18,31,49
107,CAN,P003637,22.734,-3,50,53
107,CAN,P004160,14.684,5,35,30
107,CAN,P005005,16.901,-7,37,44
107,CAN,P006588,16.5,11,48,37
107,CAN,P007560,8.617,1,22,21
107,CAN,P007644,5.084,-1,12,13
107,CAN,P008121,28.233,3,62,59
107,CAN,P009864,21.932,-4,48,52
107,CAN,P010385,23.069,0,51,51
107,CAN,P010452,23.284,-14,39,53
107,ULM,P005422,32.467,-7,71,78
107,ULM,P006997,15.449,-4,26,30
107,ULM,P007952,10.3,5,27,22
107,ULM,P010106,32.366,0,76,76
107,ULM,P010582,31.2,22,82,60
107,ULM,P010726,7.833,-15,10,25
107,ULM,P011457,12.915,6,33,27
107,ULM,P012603,29.55,8,77,69
107,ULM,P012604,34.699,-1,76,77
107,ULM,P012703,18.216,6,37,31
108,ARI,P003240,28.233,9,49,40
108,ARI,P004292,24.849,10,50,40
108,ARI,P010387,2.45,1,5,4
108,ARI,P012616,14.717,3,19,16
108,ARI,P012702,19.717,12,43,31
108,ARI,P012707,22.801,1,33,32
108,ARI,P012708,24.434,11,48,37
108,ARI,P012716,23.766,10,45,35
108,ARI,P012717,18.75,-9,27,36
108,ARI,P012722,5.784,-2,8,10
108,ARI,P012760,14.499,-1,18,19
108,LKB,P002012,27.582,0,48,48
108,LKB,P004868,15.35,-11,19,30
108,LKB,P005521,34.382,2,58,56
108,LKB,P006230,20.617,2,33,31
108,LKB,P006901,18.516,-11,21,32
108,LKB,P007029,29.7,-4,47,51
108,LKB,P010190,26.749,-9,34,43
108,LKB,P010461,19.382,-11,27,38
108,LKB,P011329,7.717,-3,13,16
109,BUD,P002740,20.533,-12,42,54
109,BUD,P004945,22.934,-18,37,55
109,BUD,P006566,23.35,-13,44,57
109,BUD,P007398,20.566,-13,38,51
109,BUD,P009214,12.483,-13,26,39
109,BUD,P010248,24.15,-27,41,68
109,BUD,P010432,15.85,4,32,28
109,BUD,P011281,9.417,-17,13,30
109,BUD,P011935,22.017,-5,38,43
109,BUD,P012606,28.7,-1,54,55
109,TTK,P000497,11.35,11,30,19
109,TTK,P004801,21.817,5,45,40
109,TTK,P005000,18.384,8,41,33
109,TTK,P005685,4.6,0,7,7
109,TTK,P006693,35.883,23,89,66
109,TTK,P009845,4.117,0,7,7
109,TTK,P011239,35.4,23,89,66
109,TTK,P011834,33.083,23,84,61
109,TTK,P011925,33.85,22,80,58
109,TTK,P011975,1.033,1,5,4
109,TTK,P012771,0.483,-1,3,4
110,CLU,P004862,23.35,5,52,47
110,CLU,P005113,20.983,6,48,42
110,CLU,P005373,18.899,0,32,32
110,CLU,P005714,18.816,-6,33,39
110,CLU,P010569,21.183,10,47,37
110,CLU,P011797,10.183,4,24,20
110,CLU,P011801,25.2,1,51,50
110,CLU,P012620,13.499,1,22,21
110,CLU,P012621,24.983,-1,49,50
110,CLU,P012698,22.899,0,42,42
110,WRO,P003034,19.017,6,38,32
110,WRO,P007472,2.967,-8,0,8
110,WRO,P009896,24.166,-6,44,50
110,WRO,P011278,9.201,-4,13,17
110,WRO,P011900,26.183,2,61,59
110,WRO,P011901,25.217,8,60,52
110,WRO,P012308,9.083,7,20,13
110,WRO,P012601,26.266,-1,56,57
110,WRO,P012699,33.167,-8,56,64
110,WRO,P012736,24.733,-16,32,48
111,LLI,P004773,17.617,-8,30,38
111,LLI,P005247,26.95,-10,52,62
111,LLI,P006600,30.116,4,72,68
111,LLI,P008274,3.8,1,7,6
111,LLI,P009649,23.9,6,57,51
111,LLI,P009672,27.417,5,65,60
111,LLI,P009680,32.266,7,79,72
111,LLI,P012020,9.684,-6,14,20
111,LLI,P012585,28.25,6,69,63
111,PMT,P001686,28.3,-1,72,73
111,PMT,P002020,15.133,-3,30,33
111,PMT,P002644,30.733,7,65,58
111,PMT,P010549,25.967,0,61,61
111,PMT,P011823,9.284,-1,25,26
111,PMT,P011942,18.766,3,45,42
111,PMT,P011944,27.55,-8,54,62
111,PMT,P011966,14.584,-8,26,34
111,PMT,P012600,29.683,6,62,56
112,HAM,P001990,16.583,-16,29,45
112,HAM,P009663,23.752,-12,61,73
112,HAM,P010070,12.618,-21,24,45
112,HAM,P011168,25.252,-14,65,79
112,HAM,P011187,14.417,-16,27,43
112,HAM,P012579,22.652,-7,53,60
112,HAM,P012580,22.818,-7,55,62
112,HAM,P012581,24.65,-27,55,82
112,HAM,P012582,23.75,-11,56,67
112,HAM,P012648,9.884,-17,19,36
112,HAM,P012694,3.634,3,11,8
112,PRS,P004512,15.167,13,51,38
112,PRS,P005793,20.034,4,56,52
112,PRS,P009556,17.567,20,51,31
112,PRS,P011232,19.967,25,64,39
112,PRS,P011551,9.317,2,28,26
112,PRS,P011887,9.85,2,34,32
112,PRS,P012608,22.434,9,69,60
112,PRS,P012609,24.367,25,70,45
112,PRS,P012610,22.434,9,69,60
112,PRS,P012613,15.517,14,41,27
112,PRS,P012640,23.351,22,67,45
113,HTA,P003533,13.899,-11,23,34
113,HTA,P004267,17.782,29,61,32
113,HTA,P004846,30.932,27,86,59
113,HTA,P006835,32.532,8,75,67
113,HTA,P007759,33.332,9,79,70
113,HTA,P010465,29.099,1,64,63
113,HTA,P011973,26.099,30,77,47
113,HTA,P011990,13.683,-4,29,33
113,HTA,P012028,1.316,3,3,0
113,HTA,P012706,1.083,3,3,0
113,HTA,P012793,0.233,0,0,0
113,VNC,P003759,25.866,-10,52,62
113,VNC,P004117,25.367,-17,47,64
113,VNC,P008052,12.784,-5,32,37
113,VNC,P009400,22.8,-16,41,57
113,VNC,P011909,24.25,-14,47,61
113,VNC,P012587,26.75,-10,56,66
113,VNC,P012590,31.567,-17,65,82
113,VNC,P012591,30.616,-6,65,71
114,JOV,P002361,24.285,-2,51,53
114,JOV,P002507,21.984,3,52,49
114,JOV,P006771,24.667,14,59,45
114,JOV,P010161,14.601,2,34,32
114,JOV,P010458,20.467,6,48,42
114,JOV,P010709,2.433,-2,3,5
114,JOV,P011247,28.717,22,78,56
114,JOV,P011248,25.7,11,57,46
114,JOV,P012349,16.75,9,38,29
114,JOV,P012780,20.401,12,50,38
114,WOL,P003212,23.95,-8,53,61
114,WOL,P004229,20.018,6,49,43
114,WOL,P004645,29.717,-23,53,76
114,WOL,P005516,22.933,-12,37,49
114,WOL,P006154,23.584,5,54,49
114,WOL,P006907,15.083,7,34,27
114,WOL,P012576,17.999,-17,28,45
114,WOL,P012577,34.217,-17,68,85
114,WOL,P012789,3.366,-1,5,6
114,WOL,PLCT,9.133,-15,14,29
115,BES,P005348,11.566,6,31,25
115,BES,P007914,17.817,-3,32,35
115,BES,P007917,10.034,11,28,17
115,BES,P008945,20.95,14,53,39
115,BES,P009582,16.315,-10,30,40
115,BES,P011379,10.833,6,23,17
115,BES,P011924,21.367,-7,42,49
115,BES,P011936,32.633,4,71,67
115,BES,P012622,29.318,5,65,60
115,BES,P012647,29.167,-1,65,66
115,LJU,P002561,8.967,-2,17,19
115,LJU,P003452,31.001,-3,67,70
115,LJU,P005969,34.751,-5,71,76
115,LJU,P007066,5.833,-1,11,12
115,LJU,P009392,14.85,4,33,29
115,LJU,P009395,36.285,-1,77,78
115,LJU,P010594,21.567,-9,48,57
115,LJU,P011261,12.75,0,24,24
115,LJU,P012700,34.001,-8,67,75
116,BOU,P000498,16.482,-1,38,39
116,BOU,P004525,13.765,-2,32,34
116,BOU,P010431,25.349,8,60,52
116,BOU,P010450,21.299,2,53,51
116,BOU,P011161,16.082,3,43,40
116,BOU,P011836,26.233,11,66,55
116,BOU,P011837,15.449,-2,37,39
116,BOU,P012617,20.166,16,53,37
116,BOU,P012618,19.966,9,51,42
116,BOU,P012619,4.583,2,10,8
116,BOU,P012628,20.616,-1,47,48
116,CLU,P004862,27.333,-17,64,81
116,CLU,P005113,9.833,-21,16,37
116,CLU,P005373,22.367,8,58,50
116,CLU,P005714,24.45,-1,53,54
116,CLU,P010569,19.533,-7,42,49
116,CLU,P011797,23.067,-6,54,60
116,CLU,P011801,29.817,15,73,58
116,CLU,P012620,4.283,3,8,5
116,CLU,P012621,20.967,-13,39,52
116,CLU,P012698,18.35,-6,38,44
117,BUD,P002740,20.051,14,45,31
117,BUD,P004397,22.718,3,45,42
117,BUD,P004945,17.818,-6,31,37
117,BUD,P006566,15.618,-16,26,42
117,BUD,P007398,14.316,-4,25,29
117,BUD,P010248,28.567,-2,53,55
117,BUD,P010432,11.434,3,27,24
117,BUD,P011281,29.417,1,56,55
117,BUD,P011935,17.35,-5,35,40
117,BUD,P012606,22.716,17,57,40
117,WRO,P003034,6.651,-10,6,16
117,WRO,P007472,2.384,-2,4,6
117,WRO,P009896,31.266,9,69,60
117,WRO,P011278,22.567,4,50,46
117,WRO,P011900,27.068,-4,48,52
117,WRO,P011901,19.8,-12,33,45
117,WRO,P012308,3.867,2,4,2
117,WRO,P012601,28.218,2,58,56
117,WRO,P012699,30.116,3,68,65
117,WRO,P012736,7.867,-8,9,17
117,WRO,P012749,20.201,11,46,35
118,ARI,P003240,21.517,5,50,45
118,ARI,P004292,27.733,15,74,59
118,ARI,P010387,11.966,1,23,22
118,ARI,P012616,1.933,-1,7,8
118,ARI,P012702,14.2,7,36,29
118,ARI,P012708,25.632,2,57,55
118,ARI,P012716,28.401,8,72,64
118,ARI,P012717,23.868,12,57,45
118,ARI,P012722,8.45,-3,13,16
118,ARI,P012760,17.35,6,46,40
118,ARI,P012792,18.95,-2,40,42
118,TTK,P000497,8.183,1,18,17
118,TTK,P004801,22.832,-17,50,67
118,TTK,P005000,30.699,5,71,66
118,TTK,P005685,2.033,-1,5,6
118,TTK,P006693,28.95,-8,60,68
118,TTK,P009845,2.917,-5,3,8
118,TTK,P011239,31.932,-8,61,69
118,TTK,P011834,33.583,-4,74,78
118,TTK,P011925,33.399,-7,72,79
118,TTK,P011975,5.35,-4,11,15
118,TTK,P011978,0.117,-2,0,2
119,LKB,P002012,27.1,-5,63,68
119,LKB,P004664,33.267,11,82,71
119,LKB,P004868,15.734,6,37,31
119,LKB,P005521,6.133,6,16,10
119,LKB,P006230,23.85,15,62,47
119,LKB,P006901,23.8,7,58,51
119,LKB,P007029,32.2,2,75,73
119,LKB,P010190,21.833,-9,47,56
119,LKB,P010461,16.083,-13,30,43
119,ULM,P005422,29.466,8,76,68
119,ULM,P006997,15.417,-12,25,37
119,ULM,P007952,12.1,-3,25,28
119,ULM,P010106,16.884,4,42,38
119,ULM,P010582,24.866,5,56,51
119,ULM,P010726,18.183,-9,37,46
119,ULM,P011457,12.017,-16,17,33
119,ULM,P012603,28.651,1,69,68
119,ULM,P012604,23.666,8,61,53
119,ULM,P012703,18.75,-6,42,48
120,CAN,P001607,14.75,1,33,32
120,CAN,P003425,24.915,-20,43,63
120,CAN,P003637,8.367,-10,9,19
120,CAN,P004160,16.415,-17,25,42
120,CAN,P005005,16.966,-2,31,33
120,CAN,P006588,20.95,-4,44,48
120,CAN,P007560,19.582,-5,44,49
120,CAN,P007644,16.966,-18,22,40
120,CAN,P008121,18.999,-13,43,56
120,CAN,P009864,13.499,-15,23,38
120,CAN,P010385,17.182,0,40,40
120,CAN,P010452,11.399,-7,23,30
120,TRN,P001479,17.1,5,35,30
120,TRN,P005059,8.717,6,22,16
120,TRN,P005738,22.9,17,63,46
120,TRN,P006382,11.899,16,28,12
120,TRN,P007828,15.1,18,34,16
120,TRN,P009903,18.634,13,52,39
120,TRN,P012593,24.683,7,55,48
120,TRN,P012594,15.383,4,42,38
120,TRN,P012595,23.551,18,63,45
120,TRN,P012596,21.366,9,46,37
120,TRN,P012597,17.934,4,47,43
120,TRN,P012687,2.733,-7,3,10
121,LJU,P002561,16.633,-6,36,42
121,LJU,P003452,35.434,-6,90,96
121,LJU,P005969,36.033,-4,91,95
121,LJU,P007066,24.984,6,71,65
121,LJU,P009392,16.783,-16,31,47
121,LJU,P009395,38.233,0,98,98
121,LJU,P011261,31.9,1,83,82
121,PMT,P001686,22.15,-1,59,60
121,PMT,P002020,6.267,6,18,12
121,PMT,P002644,24.183,-4,64,68
121,PMT,P010549,15.918,5,34,29
121,PMT,P011823,27.402,9,69,60
121,PMT,P011942,25.917,13,75,62
121,PMT,P011943,12.184,0,26,26
121,PMT,P011944,22.617,2,62,60
121,PMT,P011947,16.217,-3,40,43
121,PMT,P011966,7.95,-5,20,25
121,PMT,P012600,19.2,3,58,55
122,BES,P005348,19.382,8,35,27
122,BES,P007914,19.634,-5,32,37
122,BES,P008945,22.431,20,42,22
122,BES,P009582,24.914,14,47,33
122,BES,P011357,13.199,-7,19,26
122,BES,P011379,4.033,-3,5,8
122,BES,P011924,23.049,1,41,40
122,BES,P011936,24.883,4,47,43
122,BES,P012233,0.017,-2,0,2
122,BES,P012622,22.482,13,39,26
122,BES,P012647,25.966,22,53,31
122,WOL,P002387,10.866,-19,7,26
122,WOL,P003212,21.517,-9,36,45
122,WOL,P004229,7.55,-2,12,14
122,WOL,P004645,12.751,-5,20,25
122,WOL,P005516,20.617,-6,26,32
122,WOL,P006154,9.867,1,17,16
122,WOL,P006546,26.934,-16,34,50
122,WOL,P006907,8.917,4,16,12
122,WOL,P012576,11.167,-14,7,21
122,WOL,P012577,28.667,-7,42,49
122,WOL,P012789,21.284,3,40,37
122,WOL,PLCT,19.868,5,38,33
123,JOV,P002507,18.866,-2,37,39
123,JOV,P006771,13.183,-3,22,25
123,JOV,P010161,24.231,12,60,48
123,JOV,P010458,12.799,2,31,29
123,JOV,P010708,0.933,3,3,0
123,JOV,P010709,5.766,-4,9,13
123,JOV,P011247,25.883,12,65,53
123,JOV,P011248,31.332,-4,62,66
123,JOV,P012349,24.066,7,53,46
123,JOV,P012780,23.332,6,54,48
123,JOV,PJUG,19.599,11,49,38
123,VNC,P000968,26.783,10,62,52
123,VNC,P003759,27.216,11,62,51
123,VNC,P004117,20.35,-15,31,46
123,VNC,P008052,26.833,-7,58,65
123,VNC,P009400,9.933,-3,17,20
123,VNC,P011909,30.449,-5,64,69
123,VNC,P011928,5.599,-5,11,16
123,VNC,P012587,5.8,-9,11,20
123,VNC,P012590,12.833,-18,19,37
123,VNC,P012591,34.199,1,70,69
124,HAM,P009663,24.931,-17,59,76
124,HAM,P010070,4.667,-15,7,22
124,HAM,P011168,32.017,2,83,81
124,HAM,P011187,14.068,-3,38,41
124,HAM,P012579,17.585,-12,41,53
124,HAM,P012580,26.633,-9,64,73
124,HAM,P012581,28.549,-7,71,78
124,HAM,P012582,21.484,-7,56,63
124,HAM,P012648,11.75,-10,32,42
124,HAM,P012694,12.066,9,38,29
124,HAM,P012695,6.25,-16,16,32
124,HTA,P003533,22.583,13,69,56
124,HTA,P004267,31.717,29,99,70
124,HTA,P004846,29.75,19,89,70
124,HTA,P007759,23.066,8,65,57
124,HTA,P011973,25.95,-1,72,73
124,HTA,P011990,31.783,15,95,80
124,HTA,P012028,5.017,-7,9,16
124,HTA,P012592,2.3,-6,4,10
124,HTA,P012706,2.367,0,6,6
124,HTA,P012793,0.85,0,2,2
124,HTA,P012794,24.617,15,80,65
125,LLI,P004773,23.134,-7,46,53
125,LLI,P005247,24.999,-14,46,60
125,LLI,P006600,26.967,-17,47,64
125,LLI,P008274,7.684,11,20,9
125,LLI,P009649,27.95,-13,51,64
125,LLI,P009672,14.95,-10,31,41
125,LLI,P009680,28.402,-18,52,70
125,LLI,P012020,13.034,0,30,30
125,LLI,P012584,1.267,4,6,2
125,LLI,P012585,31.618,-21,56,77
125,PRS,P003481,11.417,11,27,16
125,PRS,P004512,18.466,5,42,37
125,PRS,P005793,21.733,2,48,46
125,PRS,P009556,5.933,14,23,9
125,PRS,P011232,17.217,17,45,28
125,PRS,P011551,1.583,-6,2,8
125,PRS,P011887,7.649,-10,16,26
125,PRS,P012608,27.249,3,58,55
125,PRS,P012609,24.7,32,68,36
125,PRS,P012610,24.699,2,51,49
125,PRS,P012613,14.999,0,31,31
125,PRS,P012640,24.35,15,59,44
126,BOU,P000498,15.985,9,33,24
126,BOU,P004525,13.966,0,30,30
126,BOU,P010431,22.5,-3,41,44
126,BOU,P010718,32.034,9,66,57
126,BOU,P011161,17.601,5,37,32
126,BOU,P011836,31.035,8,62,54
126,BOU,P011837,21.2,2,40,38
126,BOU,P012617,28.666,-3,57,60
126,BOU,P012618,23.801,6,52,46
126,BOU,P012628,18.217,7,42,35
126,CAN,P001607,18.268,-5,30,35
126,CAN,P003425,26.732,-3,54,57
126,CAN,P003637,29.016,-1,55,56
126,CAN,P004160,15.984,-7,29,36
126,CAN,P005005,9.434,-12,13,25
126,CAN,P006588,30.483,-1,59,60
126,CAN,P007560,1.767,1,4,3
126,CAN,P008121,33.799,3,67,64
126,CAN,P009864,29.15,-2,54,56
126,CAN,P010385,15.85,-6,30,36
126,CAN,P010452,14.517,-7,25,32
127,LKB,P002012,26.832,-1,52,53
127,LKB,P004664,27.615,-1,56,57
127,LKB,P004868,13.166,-5,18,23
127,LKB,P006230,21.766,-7,36,43
127,LKB,P006901,11.249,1,13,12
127,LKB,P007029,32.665,-1,58,59
127,LKB,P009898,20.849,-8,37,45
127,LKB,P010190,27.616,-9,46,55
127,LKB,P010461,18.232,1,34,33
127,TRN,P001479,15.633,5,28,23
127,TRN,P005059,25.549,6,50,44
127,TRN,P005738,24.365,1,48,47
127,TRN,P006382,15.616,3,27,24
127,TRN,P007828,13.233,7,22,15
127,TRN,P009903,22.665,4,49,45
127,TRN,P012593,24.699,5,48,43
127,TRN,P012594,18.198,-6,33,39
127,TRN,P012595,2.183,2,5,3
127,TRN,P012596,17.333,2,27,25
127,TRN,P012597,20.516,1,43,42
128,TTK,P000497,4.05,8,13,5
128,TTK,P004801,18.0,2,42,40
128,TTK,P005000,24.633,11,57,46
128,TTK,P005685,3.883,-6,5,11
128,TTK,P006693,32.566,-2,61,63
128,TTK,P009845,7.25,0,12,12
128,TTK,P010477,17.117,-4,30,34
128,TTK,P011239,30.767,14,75,61
128,TTK,P011834,27.284,1,56,55
128,TTK,P011925,34.45,6,74,68
128,ULM,P005422,26.001,14,60,46
128,ULM,P006997,21.934,0,44,44
128,ULM,P007952,7.467,-9,9,18
128,ULM,P010106,26.968,7,62,55
128,ULM,P010582,28.435,-3,55,58
128,ULM,P010726,8.9,0,15,15
128,ULM,P011457,11.401,-15,14,29
128,ULM,P012066,3.067,-7,5,12
128,ULM,P012603,17.601,-4,35,39
128,ULM,P012604,32.535,3,70,67
128,ULM,P012703,15.701,-16,26,42
129,ARI,P003240,17.566,5,38,33
129,ARI,P004292,25.533,21,63,42
129,ARI,P010387,7.8,-12,13,25
129,ARI,P012615,13.867,8,36,28
129,ARI,P012638,1.55,4,6,2
129,ARI,P012702,14.067,0,24,24
129,ARI,P012708,26.116,22,61,39
129,ARI,P012716,25.982,21,64,43
129,ARI,P012717,27.749,18,63,45
129,ARI,P012722,8.199,-1,16,17
129,ARI,P012760,16.1,16,44,28
129,ARI,P012792,15.466,8,37,29
129,WRO,P003034,18.132,-2,33,35
129,WRO,P009896,30.998,-27,52,79
129,WRO,P011278,15.616,-10,30,40
129,WRO,P011900,27.315,-6,48,54
129,WRO,P011901,22.099,-10,39,49
129,WRO,P012601,23.916,-15,40,55
129,WRO,P012699,31.799,-28,54,82
129,WRO,P012749,30.115,-12,59,71
130,BUD,P002740,14.967,-11,20,31
130,BUD,P004945,17.233,6,43,37
130,BUD,P005637,19.451,-10,26,36
130,BUD,P006566,30.851,4,62,58
130,BUD,P007398,22.5,3,45,42
130,BUD,P008325,20.167,4,44,40
130,BUD,P010248,19.834,-6,33,39
130,BUD,P011281,25.684,2,56,54
130,BUD,P012606,29.318,-2,56,58
130,CLU,P004862,24.415,7,53,46
130,CLU,P005113,24.299,11,57,46
130,CLU,P005373,15.415,-4,22,26
130,CLU,P005714,14.799,-8,29,37
130,CLU,P010569,17.949,-3,26,29
130,CLU,P010997,2.2,1,3,2
130,CLU,P011797,27.498,3,57,54
130,CLU,P011801,28.614,0,55,55
130,CLU,P012620,5.499,-2,11,13
130,CLU,P012621,26.832,8,61,53
130,CLU,P012698,12.465,-3,21,24
131,PMT,P001686,27.799,-17,48,65
131,PMT,P002020,12.967,-1,20,21
131,PMT,P002691,3.984,-3,5,8
131,PMT,P005301,14.583,-5,28,33
131,PMT,P011823,27.032,-20,52,72
131,PMT,P011942,15.949,6,32,26
131,PMT,P011943,26.683,-19,41,60
131,PMT,P011944,19.416,-18,37,55
131,PMT,P011947,17.766,-6,33,39
131,PMT,P011966,18.2,0,36,36
131,PMT,P012600,15.616,-22,28,50
131,PRS,P003481,9.217,3,16,13
131,PRS,P004512,16.266,11,48,37
131,PRS,P005793,12.5,0,31,31
131,PRS,P009556,15.734,10,30,20
131,PRS,P011232,17.918,13,38,25
131,PRS,P011887,7.983,-1,16,17
131,PRS,P012608,23.483,11,61,50
131,PRS,P012609,21.851,16,52,36
131,PRS,P012610,23.433,9,59,50
131,PRS,P012612,10.951,3,23,20
131,PRS,P012613,15.334,15,38,23
131,PRS,P012640,25.335,15,53,38
132,HTA,P003533,10.75,-7,18,25
132,HTA,P004267,8.533,-6,29,35
132,HTA,P004846,29.449,4,82,78
132,HTA,P007759,28.582,-6,72,78
132,HTA,P007867,15.216,-12,23,35
132,HTA,P010550,28.682,0,69,69
132,HTA,P011973,35.216,-1,86,87
132,HTA,P011990,12.767,3,27,24
132,HTA,P012794,30.8,5,74,69
132,LLI,P004773,24.701,3,59,56
132,LLI,P006600,26.635,-3,68,71
132,LLI,P009649,27.535,9,73,64
132,LLI,P009680,22.718,3,59,56
132,LLI,P012020,13.367,7,32,25
132,LLI,P012584,3.367,2,10,8
132,LLI,P012585,27.768,-4,68,72
132,LLI,P012586,31.501,8,76,68
132,LLI,P012797,22.418,-5,55,60
133,HAM,P001990,10.517,3,27,24
133,HAM,P009663,28.835,-10,64,74
133,HAM,P010070,9.667,0,21,21
133,HAM,P011168,26.952,-7,56,63
133,HAM,P012579,17.768,-10,34,44
133,HAM,P012580,23.617,-4,47,51
133,HAM,P012581,31.368,-4,76,80
133,HAM,P012582,25.268,-6,59,65
133,HAM,P012648,18.701,7,49,42
133,HAM,P012695,2.25,1,7,6
133,HAM,P012696,5.067,0,10,10
133,JOV,P002507,21.933,9,60,51
133,JOV,P006771,24.816,11,63,52
133,JOV,P010161,14.733,-5,33,38
133,JOV,P010458,26.833,7,66,59
133,JOV,P010709,6.333,2,17,15
133,JOV,P011247,26.166,6,62,56
133,JOV,P011248,32.366,6,79,73
133,JOV,P012349,11.6,-8,23,31
133,JOV,P012780,19.499,4,43,39
133,JOV,PJUG,15.716,-2,34,36
134,BES,P005348,2.034,-8,0,8
134,BES,P007914,26.851,0,68,68
134,BES,P008945,37.65,-4,81,85
134,BES,P011357,7.167,3,20,17
134,BES,P011379,14.517,-9,18,27
134,BES,P011924,21.718,-6,50,56
134,BES,P011936,29.383,1,62,61
134,BES,P012622,32.417,2,69,67
134,BES,P012647,36.234,-10,74,84
134,BES,P012711,17.034,-19,38,57
134,VNC,P000968,10.034,9,30,21
134,VNC,P003759,18.267,-6,26,32
134,VNC,P004381,34.649,1,76,75
134,VNC,P008052,31.167,15,85,70
134,VNC,P009400,16.918,4,41,37
134,VNC,P011909,30.082,8,69,61
134,VNC,P011928,17.466,-11,28,39
134,VNC,P012587,10.767,5,29,24
134,VNC,P012591,33.483,3,75,72
134,VNC,P012796,22.167,22,71,49
135,LJU,P001235,15.2,6,38,32
135,LJU,P002561,8.199,-7,15,22
135,LJU,P003452,13.033,-4,26,30
135,LJU,P003514,16.216,-1,32,33
135,LJU,P005969,28.25,2,66,64
135,LJU,P007066,16.399,-7,34,41
135,LJU,P009392,23.099,-5,53,58
135,LJU,P009395,23.6,5,55,50
135,LJU,P010594,16.9,3,36,33
135,LJU,P011261,19.166,-1,43,44
135,LJU,P012700,19.933,-1,47,48
135,WOL,P002387,23.751,-3,53,56
135,WOL,P003212,18.152,1,41,40
135,WOL,P004645,3.683,4,10,6
135,WOL,P005516,20.232,5,47,42
135,WOL,P006154,9.951,-2,19,21
135,WOL,P006546,30.501,-2,67,69
135,WOL,P006907,6.5,1,15,14
135,WOL,P011150,31.566,5,77,72
135,WOL,P012576,25.901,0,56,56
135,WOL,P012577,19.434,1,45,44
135,WOL,P012789,10.334,0,25,25
136,BOU,P000498,19.732,3,36,33
136,BOU,P004525,22.166,8,48,40
136,BOU,P010431,24.317,-5,48,53
136,BOU,P010450,16.865,2,30,28
136,BOU,P010718,24.534,-7,46,53
136,BOU,P011161,16.533,1,30,29
136,BOU,P011836,18.452,-8,35,43
136,BOU,P011837,18.833,-6,29,35
136,BOU,P012617,19.418,-7,34,41
136,BOU,P012618,19.15,-1,34,35
136,BUD,P002740,20.933,4,40,36
136,BUD,P004945,24.484,2,52,50
136,BUD,P005637,20.067,5,45,40
136,BUD,P006566,0.533,2,2,0
136,BUD,P007398,11.65,2,22,20
136,BUD,P008325,10.85,-8,16,24
136,BUD,P010248,27.5,14,56,42
136,BUD,P011281,23.9,4,49,45
136,BUD,P011935,20.517,-3,39,42
136,BUD,P012606,23.9,-2,45,47
136,BUD,P012630,15.666,0,24,24
137,ARI,P003240,24.067,-15,39,54
137,ARI,P004292,17.466,-14,28,42
137,ARI,P012615,15.05,-13,17,30
137,ARI,P012702,22.101,5,46,41
137,ARI,P012708,29.034,-10,56,66
137,ARI,P012716,23.668,-6,45,51
137,ARI,P012717,27.335,-5,59,64
137,ARI,P012722,3.883,-5,4,9
137,ARI,P012760,11.633,-14,22,36
137,ARI,P012792,25.768,-3,54,57
137,CLU,P004862,27.334,14,67,53
137,CLU,P005113,20.634,9,50,41
137,CLU,P005373,18.917,9,40,31
137,CLU,P005714,17.634,5,36,31
137,CLU,P010569,22.817,9,54,45
137,CLU,P011797,7.967,0,18,18
137,CLU,P011801,25.818,4,48,44
137,CLU,P012620,4.533,0,9,9
137,CLU,P012621,30.617,15,68,53
137,CLU,P012698,23.734,15,60,45
138,ULM,P005422,33.633,-5,73,78
138,ULM,P007952,5.133,-9,5,14
138,ULM,P010106,24.401,-6,52,58
138,ULM,P010582,30.333,-6,69,75
138,ULM,P010726,6.4,-1,17,18
138,ULM,P011391,2.85,-1,9,10
138,ULM,P011457,13.533,-4,26,30
138,ULM,P012603,26.467,-8,62,70
138,ULM,P012604,32.017,-2,74,76
138,ULM,P012703,25.233,-18,53,71
138,WRO,P003034,16.684,7,40,33
138,WRO,P009896,23.251,5,60,55
138,WRO,P011278,14.601,8,35,27
138,WRO,P011901,16.551,5,40,35
138,WRO,P012010,25.285,7,61,54
138,WRO,P012094,28.167,13,77,64
138,WRO,P012601,25.468,4,65,61
138,WRO,P012699,27.835,15,71,56
138,WRO,P012736,22.168,-4,51,55
139,TRN,P001479,19.25,5,38,33
139,TRN,P005059,26.183,6,50,44
139,TRN,P005738,23.967,-19,35,54
139,TRN,P006382,12.266,9,23,14
139,TRN,P009903,20.683,-6,37,43
139,TRN,P012593,30.283,-15,49,64
139,TRN,P012594,13.967,-9,21,30
139,TRN,P012596,16.1,4,30,26
139,TRN,P012597,31.701,-11,58,69
139,TRN,P012687,5.6,-4,9,13
139,TTK,P004801,22.733,12,52,40
139,TTK,P005000,23.05,-3,40,43
139,TTK,P006693,33.116,24,72,48
139,TTK,P006883,9.399,-12,9,21
139,TTK,P009845,4.549,-2,9,11
139,TTK,P010477,19.766,-2,32,34
139,TTK,P011239,29.967,12,64,52
139,TTK,P011834,21.483,1,38,37
139,TTK,P011925,31.849,8,65,57
139,TTK,P011975,4.083,2,9,7
140,CAN,P001607,13.3,-11,21,32
140,CAN,P003425,26.834,19,73,54
140,CAN,P003637,10.983,6,25,19
140,CAN,P004160,16.718,-5,30,35
140,CAN,P004466,9.899,-7,20,27
140,CAN,P005005,17.984,12,43,31
140,CAN,P006588,20.334,10,52,42
140,CAN,P007644,7.2,0,20,20
140,CAN,P008121,24.366,7,63,56
140,CAN,P009864,21.733,9,59,50
140,CAN,P010385,14.999,-5,21,26
140,CAN,P010452,15.65,5,33,28
140,LKB,P002012,24.084,-4,58,62
140,LKB,P004868,17.4,-11,32,43
140,LKB,P006230,14.367,-8,25,33
140,LKB,P006901,19.401,-1,46,47
140,LKB,P007029,32.116,-1,70,71
140,LKB,P009898,32.383,2,75,73
140,LKB,P010190,15.967,-12,26,38
140,LKB,P010461,23.666,7,53,46
140,LKB,PLXI,20.616,-12,35,47
141,PMT,P001686,27.266,19,63,44
141,PMT,P002020,3.666,-2,5,7
141,PMT,P002644,25.033,19,55,36
141,PMT,P002691,3.083,0,5,5
141,PMT,P005301,17.816,7,41,34
141,PMT,P011823,14.966,8,36,28
141,PMT,P011942,25.766,10,56,46
141,PMT,P011943,10.566,4,22,18
141,PMT,P011944,16.5,-6,29,35
141,PMT,P011947,18.35,18,41,23
141,PMT,P011966,19.983,33,57,24
141,PMT,P012600,17.0,25,45,20
141,WOL,P002387,23.816,-6,40,46
141,WOL,P003212,3.784,-8,4,12
141,WOL,P004645,4.134,-4,3,7
141,WOL,P005516,18.299,-10,32,42
141,WOL,P006154,23.1,-14,32,46
141,WOL,P006546,30.75,-13,54,67
141,WOL,P006907,12.9,-13,19,32
141,WOL,P011150,13.2,-15,23,38
141,WOL,P012576,11.085,-20,11,31
141,WOL,P012577,30.017,-25,49,74
141,WOL,P012789,28.915,-7,53,60
142,LJU,P001235,6.466,-6,13,19
142,LJU,P002561,23.032,5,63,58
142,LJU,P003452,34.282,-2,85,87
142,LJU,P003514,16.216,-19,25,44
142,LJU,P005969,32.465,-8,76,84
142,LJU,P007066,14.932,-9,33,42
142,LJU,P009392,12.183,4,32,28
142,LJU,P009395,30.316,-10,70,80
142,LJU,P010594,17.265,-9,37,46
142,LJU,P010771,5.3,2,14,12
142,LJU,P011261,7.533,-3,17,20
142,VNC,P000968,13.651,-2,37,39
142,VNC,P003759,17.717,10,45,35
142,VNC,P004381,30.133,16,80,64
142,VNC,P008052,16.134,7,43,36
142,VNC,P009400,15.633,3,38,35
142,VNC,P011909,7.951,13,23,10
142,VNC,P011928,23.867,4,61,57
142,VNC,P012259,13.3,7,37,30
142,VNC,P012587,4.867,-9,11,20
142,VNC,P012591,34.468,5,86,81
142,VNC,P012796,22.284,1,59,58
143,BES,P003783,17.7,3,41,38
143,BES,P007917,6.717,-11,8,19
143,BES,P008945,28.335,6,56,50
143,BES,P011357,3.017,-4,4,8
143,BES,P011379,25.699,11,49,38
143,BES,P011924,25.851,0,57,57
143,BES,P011936,29.051,16,62,46
143,BES,P012622,33.617,20,74,54
143,BES,P012647,34.317,22,81,59
143,BES,P012711,20.701,-8,38,46
143,HAM,P001990,16.017,3,31,28
143,HAM,P009663,22.4,-13,32,45
143,HAM,P010070,17.833,4,38,34
143,HAM,P011168,23.167,-7,44,51
143,HAM,P011187,23.784,-3,48,51
143,HAM,P012579,27.851,4,60,56
143,HAM,P012580,31.233,-12,53,65
143,HAM,P012581,31.785,-20,54,74
143,HAM,P012582,20.367,-8,36,44
143,HAM,P012648,7.184,-5,12,17
143,HAM,P012694,3.384,2,7,5
144,JOV,P002507,26.783,10,56,46
144,JOV,P006771,28.867,3,56,53
144,JOV,P010161,1.3,1,2,1
144,JOV,P010458,27.95,11,59,48
144,JOV,P010677,29.433,5,61,56
144,JOV,P010709,1.05,-1,0,1
144,JOV,P011247,24.917,9,59,50
144,JOV,P011248,23.65,-6,47,53
144,JOV,P012349,12.05,-9,23,32
144,JOV,P012780,13.217,-8,26,34
144,JOV,PJUG,10.783,-5,21,26
144,LLI,P004773,15.866,-5,31,36
144,LLI,P006600,28.466,-12,45,57
144,LLI,P009649,31.499,-13,59,72
144,LLI,P009680,29.999,-17,46,63
144,LLI,P012020,11.533,10,35,25
144,LLI,P012585,27.316,8,64,56
144,LLI,P012586,26.216,-4,53,57
144,LLI,P012797,29.1,23,67,44
145,HTA,P003533,17.65,4,42,38
145,HTA,P004846,26.183,-15,52,67
145,HTA,P007759,30.334,-12,63,75
145,HTA,P007867,29.266,-18,62,80
145,HTA,P010465,15.449,-10,34,44
145,HTA,P010550,29.083,-11,58,69
145,HTA,P011973,19.267,-16,41,57
145,HTA,P012028,0.867,-2,4,6
145,HTA,P012706,0.867,-2,4,6
145,HTA,P012794,31.034,-8,70,78
145,PRS,P004512,16.566,26,52,26
145,PRS,P005793,10.184,13,27,14
145,PRS,P009556,11.95,-11,30,41
145,PRS,P011232,16.8,-13,40,53
145,PRS,P012608,28.05,29,74,45
145,PRS,P012609,23.799,-2,59,61
145,PRS,P012610,28.05,29,74,45
145,PRS,P012611,15.617,17,46,29
145,PRS,P012612,12.684,4,34,30
145,PRS,P012613,21.683,9,57,48
145,PRS,P012640,14.617,-11,27,38
146,BOU,P000498,20.816,7,44,37
146,BOU,P004525,22.566,20,58,38
146,BOU,P010431,16.918,10,44,34
146,BOU,P010450,6.85,15,24,9
146,BOU,P010718,20.918,21,60,39
146,BOU,P011161,18.115,10,40,30
146,BOU,P011836,17.434,13,46,33
146,BOU,P011837,13.85,16,40,24
146,BOU,P012617,16.967,24,54,30
146,BOU,P012618,18.85,9,43,34
146,BOU,P012619,7.3,8,21,13
146,BOU,P012628,19.416,12,46,34
146,LKB,P002012,28.416,-32,52,84
146,LKB,P004868,14.683,-5,23,28
146,LKB,P006230,19.833,-18,37,55
146,LKB,P006901,20.999,-31,33,64
146,LKB,P007029,30.633,-20,57,77
146,LKB,P009898,28.433,-16,50,66
146,LKB,P010190,17.383,-19,30,49
146,LKB,P010461,20.166,-15,34,49
146,LKB,P011329,7.666,-12,15,27
146,LKB,PLXI,11.783,3,24,21
147,CAN,P001607,9.949,-20,7,27
147,CAN,P003425,30.051,10,66,56
147,CAN,P003637,21.301,5,44,39
147,CAN,P004160,10.782,-5,14,19
147,CAN,P004466,7.917,-10,15,25
147,CAN,P005005,13.651,-19,11,30
147,CAN,P006588,21.051,7,48,41
147,CAN,P007644,9.116,0,19,19
147,CAN,P008121,26.349,9,62,53
147,CAN,P009864,21.333,4,47,43
147,CAN,P010385,16.95,-17,18,35
147,CAN,P010452,11.55,-14,14,28
147,TTK,P004801,19.834,12,42,30
147,TTK,P005000,25.083,4,51,47
147,TTK,P006693,31.933,9,66,57
147,TTK,P006883,25.884,20,64,44
147,TTK,P009845,9.267,1,15,14
147,TTK,P010477,12.867,2,25,23
147,TTK,P011239,12.366,-10,21,31
147,TTK,P011834,30.933,5,68,63
147,TTK,P011925,31.833,7,63,56
148,TRN,P001479,14.901,9,32,23
148,TRN,P005059,25.001,7,50,43
148,TRN,P005738,25.101,-3,53,56
148,TRN,P006382,19.352,4,39,35
148,TRN,P009903,27.118,6,57,51
148,TRN,P012593,20.484,6,42,36
148,TRN,P012594,12.117,1,27,26
148,TRN,P012596,12.884,0,28,28
148,TRN,P012597,31.851,3,71,68
148,TRN,P012687,11.201,-3,26,29
148,WRO,P003034,11.666,-13,18,31
148,WRO,P005531,28.582,-3,52,55
148,WRO,P009896,27.132,9,59,50
148,WRO,P011278,5.383,-8,7,15
148,WRO,P011901,11.033,3,26,23
148,WRO,P012010,18.633,-7,32,39
148,WRO,P012094,23.866,-7,47,54
148,WRO,P012601,32.699,-1,70,71
148,WRO,P012699,26.531,-8,48,56
148,WRO,P012736,14.465,5,36,31
149,CLU,P004862,10.534,-4,22,26
149,CLU,P005113,17.401,-11,31,42
149,CLU,P005373,20.684,17,51,34
149,CLU,P005714,22.251,9,50,41
149,CLU,P010569,19.235,-8,36,44
149,CLU,P010997,1.017,-1,2,3
149,CLU,P011797,24.801,-4,48,52
149,CLU,P011801,25.351,7,56,49
149,CLU,P012620,15.651,13,39,26
149,CLU,P012621,32.534,10,77,67
149,CLU,P012698,10.551,-8,13,21
149,ULM,P005422,23.249,-11,39,50
149,ULM,P007952,12.516,4,29,25
149,ULM,P010106,30.398,6,72,66
149,ULM,P010582,31.082,-9,64,73
149,ULM,P010726,8.817,-10,9,19
149,ULM,P011391,0.267,0,0,0
149,ULM,P011457,17.266,0,33,33
149,ULM,P012603,26.815,5,61,56
149,ULM,P012604,27.215,-8,52,60
149,ULM,P012703,22.365,3,46,43
150,ARI,P002867,4.8,3,10,7
150,ARI,P003240,24.216,-2,40,42
150,ARI,P004292,25.683,0,51,51
150,ARI,P012615,19.6,3,40,37
150,ARI,P012702,13.767,-9,25,34
150,ARI,P012708,33.201,-3,66,69
150,ARI,P012716,19.8,5,39,34
150,ARI,P012717,20.4,-2,36,38
150,ARI,P012722,0.883,0,2,2
150,ARI,P012760,25.35,10,49,39
150,ARI,P012792,12.3,0,22,22
150,BUD,P002740,21.5,4,45,41
150,BUD,P004945,22.616,6,43,37
150,BUD,P005637,24.734,-5,42,47
150,BUD,P008325,15.566,12,35,23
150,BUD,P009214,2.583,-4,0,4
150,BUD,P010248,24.4,-13,40,53
150,BUD,P011281,22.966,3,47,44
150,BUD,P011935,15.715,4,33,29
150,BUD,P012606,31.399,-3,56,59
150,BUD,P012630,18.516,-9,34,43
151,HTA,P003533,14.084,-9,35,44
151,HTA,P004846,23.734,-14,54,68
151,HTA,P007759,25.966,-9,65,74
151,HTA,P007867,22.182,0,63,63
151,HTA,P010465,27.7,-5,71,76
151,HTA,P010550,29.567,0,79,79
151,HTA,P011973,28.016,-2,76,78
151,HTA,P011990,3.1,2,9,7
151,HTA,P012794,25.651,-3,73,76
151,PMT,P001686,33.998,5,92,87
151,PMT,P002644,22.732,13,74,61
151,PMT,P005301,13.865,-2,32,34
151,PMT,P010549,1.683,0,5,5
151,PMT,P011823,17.265,-5,39,44
151,PMT,P011942,24.882,16,76,60
151,PMT,P011943,3.566,2,13,11
151,PMT,P011944,27.065,12,75,63
151,PMT,P011947,9.816,-3,29,32
151,PMT,P011966,12.932,-4,38,42
151,PMT,P012600,32.181,6,92,86
152,JOV,P002507,22.75,-12,47,59
152,JOV,P006771,24.685,-17,45,62
152,JOV,P010161,10.199,-1,19,20
152,JOV,P010458,15.782,-6,31,37
152,JOV,P010677,27.168,-4,60,64
152,JOV,P010708,0.033,0,0,0
152,JOV,P011247,32.584,-1,67,68
152,JOV,P011248,6.667,0,11,11
152,JOV,P012349,21.535,6,50,44
152,JOV,P012780,19.418,-2,36,38
152,JOV,PJUG,19.184,2,44,42
152,PRS,P004512,12.8,7,27,20
152,PRS,P005793,18.35,3,37,34
152,PRS,P011232,17.484,1,41,40
152,PRS,P012608,26.234,9,55,46
152,PRS,P012609,24.917,8,61,53
152,PRS,P012610,26.401,7,55,48
152,PRS,P012611,16.484,-12,29,41
152,PRS,P012612,14.067,4,38,34
152,PRS,P012613,21.818,-8,43,51
152,PRS,P012640,21.45,16,59,43
153,BES,P003783,17.317,-9,32,41
153,BES,P007914,20.084,-15,35,50
153,BES,P007917,10.017,-14,15,29
153,BES,P008945,24.033,-13,43,56
153,BES,P011357,6.933,-1,14,15
153,BES,P011379,14.45,-11,23,34
153,BES,P011924,16.267,-2,30,32
153,BES,P011936,22.416,-20,39,59
153,BES,P012622,25.1,2,50,48
153,BES,P012647,19.966,-13,34,47
153,BES,P012711,23.417,-9,45,54
153,LLI,P004479,10.901,1,19,18
153,LLI,P004773,14.934,-5,26,31
153,LLI,P005247,16.034,27,50,23
153,LLI,P006600,21.934,3,46,43
153,LLI,P009649,24.434,-2,46,48
153,LLI,P009680,18.649,-11,28,39
153,LLI,P012020,18.067,18,47,29
153,LLI,P012584,1.117,-3,2,5
153,LLI,P012585,24.6,22,64,42
153,LLI,P012586,21.352,32,65,33
153,LLI,P012797,27.983,23,72,49
154,HAM,P001990,12.251,-19,25,44
154,HAM,P009663,21.767,-19,47,66
154,HAM,P010070,12.483,-8,31,39
154,HAM,P011168,23.265,-8,49,57
154,HAM,P011187,18.232,-12,36,48
154,HAM,P012579,15.466,-9,36,45
154,HAM,P012580,28.384,-29,58,87
154,HAM,P012581,30.765,-26,59,85
154,HAM,P012582,10.616,-5,17,22
154,HAM,P012648,22.283,-16,48,64
154,HAM,P012695,4.483,-4,9,13
154,LJU,P002561,14.25,3,36,33
154,LJU,P003452,24.668,35,80,45
154,LJU,P003514,17.166,0,43,43
154,LJU,P005969,24.866,26,76,50
154,LJU,P007066,15.616,11,43,32
154,LJU,P009392,14.765,10,39,29
154,LJU,P009395,18.917,18,56,38
154,LJU,P010594,25.234,21,75,54
154,LJU,P010771,5.466,2,15,13
154,LJU,P010912,4.183,2,12,10
154,LJU,P011261,11.348,-1,23,24
154,LJU,P012700,23.516,28,72,44
155,VNC,P003759,26.234,2,46,44
155,VNC,P004117,22.851,-31,21,52
155,VNC,P004381,35.334,-13,52,65
155,VNC,P008052,21.533,-9,27,36
155,VNC,P009400,27.584,2,47,45
155,VNC,P011928,21.284,-16,30,46
155,VNC,P012259,30.734,-18,44,62
155,VNC,P012587,13.934,-5,18,23
155,VNC,P012588,0.517,-2,0,2
155,WOL,P002387,26.149,18,56,38
155,WOL,P004645,13.851,0,19,19
155,WOL,P005516,34.183,15,66,51
155,WOL,P006154,25.45,4,39,35
155,WOL,P006546,21.767,1,39,38
155,WOL,P006907,14.633,18,37,19
155,WOL,P012576,22.4,7,42,35
155,WOL,P012577,23.967,16,44,28
155,WOL,P012789,17.6,11,33,22
156,ARI,P002867,10.183,0,17,17
156,ARI,P004292,31.101,-2,53,55
156,ARI,P012615,21.351,-5,39,44
156,ARI,P012702,20.501,-12,35,47
156,ARI,P012708,26.401,-8,45,53
156,ARI,P012716,29.134,-7,47,54
156,ARI,P012717,23.334,-6,34,40
156,ARI,P012760,17.983,5,31,26
156,ARI,P012792,20.017,-5,39,44
156,BOU,P000498,16.066,3,32,29
156,BOU,P004525,17.25,2,35,33
156,BOU,P010431,23.799,9,47,38
156,BOU,P010718,25.049,7,46,39
156,BOU,P011161,16.2,-1,29,30
156,BOU,P011836,22.749,6,41,35
156,BOU,P011837,20.949,0,37,37
156,BOU,P012617,23.933,5,44,39
156,BOU,P012618,19.05,8,39,31
156,BOU,P012628,14.95,1,30,29
157,BUD,P002740,29.383,-3,50,53
157,BUD,P004945,21.415,-9,36,45
157,BUD,P005637,22.633,7,45,38
157,BUD,P008325,26.75,4,49,45
157,BUD,P009214,2.35,-8,0,8
157,BUD,P010248,18.249,-8,31,39
157,BUD,P011281,34.316,1,66,65
157,BUD,P011935,22.133,-11,35,46
157,BUD,P012606,27.116,1,49,48
157,BUD,P012630,20.65,6,39,33
157,ULM,P005422,27.332,6,46,40
157,ULM,P007952,12.515,11,28,17
157,ULM,P010106,29.665,-3,57,60
157,ULM,P010582,29.398,-1,50,51
157,ULM,P010726,12.649,14,29,15
157,ULM,P011457,17.682,-7,31,38
157,ULM,P012603,34.731,3,68,65
157,ULM,P012604,32.482,-7,56,63
157,ULM,P012703,28.531,4,55,51
158,CLU,P005113,22.783,0,45,45
158,CLU,P005373,16.535,4,39,35
158,CLU,P005714,19.884,-5,43,48
158,CLU,P010569,20.117,10,45,35
158,CLU,P011797,32.967,10,75,65
158,CLU,P011801,32.667,16,79,63
158,CLU,P012620,3.034,-8,0,8
158,CLU,P012621,25.684,1,54,53
158,CLU,P012698,26.334,-3,60,63
158,TRN,P001479,12.567,-3,23,26
158,TRN,P005059,22.968,-1,51,52
158,TRN,P005738,27.436,-2,60,62
158,TRN,P006382,11.618,1,22,21
158,TRN,P007828,0.033,0,0,0
158,TRN,P009903,21.551,0,52,52
158,TRN,P012593,18.501,4,45,41
158,TRN,P012594,14.384,-2,30,32
158,TRN,P012595,22.419,-9,44,53
158,TRN,P012596,17.685,-4,28,32
158,TRN,P012597,30.853,-9,60,69
159,CAN,P001607,15.633,11,33,22
159,CAN,P003425,17.667,13,45,32
159,CAN,P003637,16.316,12,41,29
159,CAN,P004160,23.683,12,51,39
159,CAN,P004466,15.949,0,31,31
159,CAN,P005005,16.766,22,49,27
159,CAN,P006588,12.817,14,38,24
159,CAN,P007560,13.983,2,26,24
159,CAN,P007644,16.899,6,33,27
159,CAN,P009864,16.583,13,43,30
159,CAN,P010385,18.833,16,43,27
159,CAN,P010452,14.866,-1,27,28
159,WRO,P003034,20.467,-5,37,42
159,WRO,P005531,24.218,-21,40,61
159,WRO,P009896,19.534,-19,31,50
159,WRO,P011900,20.1,-12,31,43
159,WRO,P011901,18.668,-11,26,37
159,WRO,P011902,6.0,3,13,10
159,WRO,P012094,21.016,-17,40,57
159,WRO,P012308,6.417,-2,11,13
159,WRO,P012601,21.602,-18,35,53
159,WRO,P012699,21.2,-12,39,51
159,WRO,P012736,20.783,-6,37,43
160,LKB,P004868,29.034,-1,55,56
160,LKB,P005521,16.968,-14,33,47
160,LKB,P006230,13.351,-9,26,35
160,LKB,P006901,7.233,-2,14,16
160,LKB,P007029,35.099,-16,61,77
160,LKB,P009898,27.283,-7,53,60
160,LKB,P010190,11.083,-4,18,22
160,LKB,P010461,26.649,-6,47,53
160,LKB,PLXI,33.3,-16,58,74
160,TTK,P004801,21.749,-1,37,38
160,TTK,P005000,26.749,14,65,51
160,TTK,P006693,31.9,11,72,61
160,TTK,P006883,33.749,24,81,57
160,TTK,P009845,10.116,-7,16,23
160,TTK,P010477,11.95,3,27,24
160,TTK,P011272,0.05,-1,0,1
160,TTK,P011834,27.499,14,61,47
160,TTK,P011925,36.233,18,81,63
161,PMT,P001686,19.05,-28,37,65
161,PMT,P002020,10.932,12,32,20
161,PMT,P002644,21.099,-12,48,60
161,PMT,P005301,25.031,-1,60,61
161,PMT,P010549,10.733,-7,21,28
161,PMT,P011823,19.749,-6,44,50
161,PMT,P011942,20.849,-15,49,64
161,PMT,P011943,10.166,-4,21,25
161,PMT,P011944,20.75,0,44,44
161,PMT,P011947,11.999,-2,30,32
161,PMT,P011966,16.982,-11,42,53
161,PMT,P012600,12.65,-6,32,38
161,VNC,P000968,14.5,18,48,30
161,VNC,P003759,25.732,-4,60,64
161,VNC,P004117,19.816,-2,41,43
161,VNC,P004381,24.382,-7,55,62
161,VNC,P008052,23.999,22,80,58
161,VNC,P009400,19.482,0,44,44
161,VNC,P011928,18.616,14,55,41
161,VNC,P012259,23.899,23,74,51
161,VNC,P012290,0.467,-2,0,2
161,VNC,P012587,6.866,-1,18,19
161,VNC,P012591,22.231,19,65,46
162,HAM,P009663,20.801,2,46,44
162,HAM,P010070,19.684,5,44,39
162,HAM,P011168,29.968,-6,64,70
162,HAM,P011187,14.268,-14,25,39
162,HAM,P012579,22.068,-9,43,52
162,HAM,P012580,26.668,9,59,50
162,HAM,P012581,30.551,-9,67,76
162,HAM,P012582,18.284,-14,35,49
162,HAM,P012648,7.684,-10,17,27
162,HAM,P012695,10.034,-4,20,24
162,WOL,P002387,17.884,2,40,38
162,WOL,P003212,15.516,-4,35,39
162,WOL,P004645,22.449,7,55,48
162,WOL,P005516,24.484,14,59,45
162,WOL,P006154,19.85,-3,38,41
162,WOL,P006546,27.783,2,64,62
162,WOL,P006907,5.117,-3,11,14
162,WOL,P012576,19.949,-3,42,45
162,WOL,P012577,27.367,23,77,54
162,WOL,P012789,19.601,15,49,34
163,LJU,P002561,10.383,-6,20,26
163,LJU,P003452,29.618,2,68,66
163,LJU,P003514,11.467,-7,23,30
163,LJU,P005969,29.618,-1,65,66
163,LJU,P007066,18.533,-14,31,45
163,LJU,P009392,7.883,-8,15,23
163,LJU,P009395,32.368,0,75,75
163,LJU,P010594,17.868,7,38,31
163,LJU,P010771,2.4,1,5,4
163,LJU,P011261,8.734,0,20,20
163,LJU,P012700,31.133,-9,65,74
163,LLI,P004479,12.866,8,32,24
163,LLI,P004773,21.399,24,66,42
163,LLI,P006600,25.584,1,56,55
163,LLI,P008274,6.067,6,13,7
163,LLI,P009649,24.134,-15,40,55
163,LLI,P009680,24.567,7,63,56
163,LLI,P012020,14.416,6,36,30
163,LLI,P012585,32.317,11,79,68
163,LLI,P012586,17.883,-1,34,35
163,LLI,P012797,20.767,-12,41,53
164,BES,P003783,15.884,-26,19,45
164,BES,P007914,16.701,-25,20,45
164,BES,P007917,12.701,1,29,28
164,BES,P008945,25.933,-7,48,55
164,BES,P011357,2.033,1,5,4
164,BES,P011379,18.317,-21,31,52
164,BES,P011924,12.549,-6,24,30
164,BES,P011936,30.8,-7,62,69
164,BES,P012622,28.5,-1,60,61
164,BES,P012647,30.382,-10,57,67
164,BES,P012711,6.2,-14,5,19
164,PRS,P004512,19.684,17,53,36
164,PRS,P005793,11.534,3,25,22
164,PRS,P009556,1.55,6,6,0
164,PRS,P011232,17.65,12,43,31
164,PRS,P012608,25.401,11,60,49
164,PRS,P012609,21.767,14,55,41
164,PRS,P012610,25.051,10,59,49
164,PRS,P012611,21.65,19,51,32
164,PRS,P012612,14.6,12,35,23
164,PRS,P012613,22.351,11,52,41
164,PRS,P012640,18.767,0,36,36
165,HTA,P003533,8.366,2,23,21
165,HTA,P004846,17.132,-14,33,47
165,HTA,P006835,21.667,0,51,51
165,HTA,P007759,30.633,-1,70,71
165,HTA,P007867,28.933,17,71,54
165,HTA,P010465,1.017,5,5,0
165,HTA,P010550,21.8,4,45,41
165,HTA,P011973,28.334,7,64,57
165,HTA,P011991,18.851,-7,35,42
165,HTA,P012794,23.267,17,58,41
165,JOV,P002507,26.015,5,57,52
165,JOV,P006771,24.115,-21,43,64
165,JOV,P010161,18.0,0,40,40
165,JOV,P010458,13.833,-16,18,34
165,JOV,P010677,28.433,4,64,60
165,JOV,P011247,25.949,0,59,59
165,JOV,P012349,19.3,-2,44,46
165,JOV,P012780,20.8,3,51,48
165,JOV,PJUG,23.55,-3,49,52
166,BOU,P000498,15.033,4,29,25
166,BOU,P004525,16.633,4,26,22
166,BOU,P010431,23.334,4,38,34
166,BOU,P010718,24.484,0,41,41
166,BOU,P011161,15.049,2,28,26
166,BOU,P011836,23.45,0,42,42
166,BOU,P011837,17.7,0,35,35
166,BOU,P012617,24.967,0,39,39
166,BOU,P012618,22.217,4,33,29
166,BOU,P012628,17.133,2,29,27
166,TTK,P004801,19.149,-1,30,31
166,TTK,P005000,22.95,-4,34,38
166,TTK,P006693,20.833,-10,32,42
166,TTK,P006883,27.35,4,45,41
166,TTK,P009845,5.217,-5,7,12
166,TTK,P010477,20.634,1,36,35
166,TTK,P011239,11.95,-5,16,21
166,TTK,P011272,3.717,-1,7,8
166,TTK,P011834,27.567,-6,42,48
166,TTK,P011925,36.85,2,64,62
166,TTK,P011975,3.783,5,7,2
167,LKB,P002012,27.817,15,63,48
167,LKB,P004868,13.266,12,31,19
167,LKB,P006901,21.033,5,48,43
167,LKB,P007029,30.249,7,65,58
167,LKB,P009898,28.4,6,63,57
167,LKB,P010190,24.898,21,64,43
167,LKB,P010461,26.733,4,60,56
167,LKB,P011329,1.383,0,2,2
167,LKB,PLXI,26.216,10,59,49
167,WRO,P003034,16.849,3,40,37
167,WRO,P005531,23.917,-1,47,48
167,WRO,P009896,22.833,-16,35,51
167,WRO,P011900,25.816,-13,52,65
167,WRO,P011901,14.649,-12,22,34
167,WRO,P011902,3.383,-7,3,10
167,WRO,P012094,28.133,-2,62,64
167,WRO,P012601,27.732,-15,49,64
167,WRO,P012699,26.05,-3,54,57
167,WRO,P012736,10.633,-14,11,25
168,CAN,P001607,15.567,3,35,32
168,CAN,P003425,29.433,-5,76,81
168,CAN,P003637,24.617,-7,59,66
168,CAN,P004160,4.699,-4,8,12
168,CAN,P005005,15.883,4,39,35
168,CAN,P006588,28.766,-7,72,79
168,CAN,P007560,10.651,7,28,21
168,CAN,P008121,34.15,-4,88,92
168,CAN,P009864,25.333,-13,54,67
168,CAN,P010385,19.667,11,57,46
168,CAN,P010452,16.234,5,39,34
168,CLU,P005113,15.886,-16,28,44
168,CLU,P005373,29.883,18,88,70
168,CLU,P005714,18.934,-4,47,51
168,CLU,P010569,39.669,1,95,94
168,CLU,P010997,2.634,-1,5,6
168,CLU,P011801,37.734,12,98,86
168,CLU,P012620,11.484,-1,29,30
168,CLU,P012621,35.218,-4,88,92
168,CLU,P012698,33.568,5,87,82
169,BUD,P002740,14.784,11,38,27
169,BUD,P004945,17.583,14,43,29
169,BUD,P005637,19.4,31,55,24
169,BUD,P006566,17.167,15,43,28
169,BUD,P008325,15.6,3,37,34
169,BUD,P009214,3.383,-5,4,9
169,BUD,P010248,20.95,21,56,35
169,BUD,P010389,9.184,-8,17,25
169,BUD,P011281,21.5,23,58,35
169,BUD,P011935,20.6,-12,42,54
169,BUD,P012606,20.55,2,49,47
169,BUD,P012630,19.299,0,43,43
169,TRN,P001479,9.0,1,18,17
169,TRN,P005059,23.284,-20,44,64
169,TRN,P005738,27.35,-8,55,63
169,TRN,P006382,22.4,-10,37,47
169,TRN,P007828,6.799,5,18,13
169,TRN,P009903,17.516,-15,32,47
169,TRN,P012594,8.9,-11,16,27
169,TRN,P012595,32.217,-12,69,81
169,TRN,P012596,18.984,-9,37,46
169,TRN,P012597,25.983,-12,48,60
169,TRN,P012687,7.567,-4,16,20
170,ARI,P002867,6.766,-9,9,18
170,ARI,P004292,28.051,19,70,51
170,ARI,P010177,1.1,2,4,2
170,ARI,P010387,19.717,26,46,20
170,ARI,P012615,17.4,9,30,21
170,ARI,P012702,13.017,9,32,23
170,ARI,P012708,7.251,-5,15,20
170,ARI,P012716,34.568,26,78,52
170,ARI,P012717,22.601,11,56,45
170,ARI,P012722,11.083,-2,19,21
170,ARI,P012760,15.784,10,32,22
170,ARI,P012792,22.667,4,39,35
170,ULM,P005422,22.267,-13,43,56
170,ULM,P007952,16.467,-8,22,30
170,ULM,P010582,27.651,-7,52,59
170,ULM,P010726,22.416,-9,34,43
170,ULM,P011188,15.917,-10,18,28
170,ULM,P011457,17.967,-13,23,36
170,ULM,P012603,23.951,-7,48,55
170,ULM,P012604,23.534,-12,44,56
170,ULM,P012703,23.285,-13,43,56
170,ULM,P012704,6.55,-8,3,11
171,JOV,P002361,18.016,-9,32,41
171,JOV,P002507,19.367,-2,40,42
171,JOV,P006771,26.333,-8,48,56
171,JOV,P010161,12.416,-1,32,33
171,JOV,P010458,18.499,-11,32,43
171,JOV,P010677,27.183,-23,52,75
171,JOV,P011247,21.432,3,45,42
171,JOV,P012349,19.567,0,47,47
171,JOV,P012780,19.232,-10,37,47
171,JOV,PJUG,17.95,-9,35,44
171,PMT,P001686,15.983,-5,27,32
171,PMT,P002020,10.833,-3,28,31
171,PMT,P002644,29.116,21,71,50
171,PMT,P010549,3.85,-8,4,12
171,PMT,P011823,10.883,-7,23,30
171,PMT,P011942,34.216,24,88,64
171,PMT,P011944,29.916,16,76,60
171,PMT,P011947,26.266,23,66,43
171,PMT,P011966,10.083,-2,18,20
171,PMT,P012600,28.849,11,69,58
172,BES,P003783,22.267,-19,39,58
172,BES,P007914,16.668,-11,24,35
172,BES,P007917,10.383,-5,22,27
172,BES,P008945,15.101,-2,30,32
172,BES,P011357,6.484,-6,9,15
172,BES,P011924,27.034,-11,53,64
172,BES,P011936,28.767,-20,47,67
172,BES,P012622,20.666,-7,41,48
172,BES,P012647,31.367,-13,60,73
172,BES,P012711,21.268,-11,40,51
172,HTA,P003533,8.617,0,15,15
172,HTA,P004846,20.134,11,44,33
172,HTA,P006835,20.151,15,45,30
172,HTA,P007759,22.333,11,56,45
172,HTA,P007867,25.417,12,63,51
172,HTA,P010465,12.368,4,26,22
172,HTA,P010550,23.633,14,58,44
172,HTA,P011973,26.784,10,65,55
172,HTA,P011991,24.818,16,62,46
172,HTA,P012592,0.65,1,3,2
172,HTA,P012794,15.1,11,33,22
173,LJU,P002561,10.117,-23,10,33
173,LJU,P003452,20.249,-20,42,62
173,LJU,P003514,25.748,-37,35,72
173,LJU,P005969,29.881,-30,56,86
173,LJU,P007066,16.3,-23,29,52
173,LJU,P009392,19.748,-18,37,55
173,LJU,P010594,19.017,-37,22,59
173,LJU,P010771,17.598,-21,31,52
173,LJU,P011261,18.033,-25,32,57
173,LJU,P012700,23.299,-31,36,67
173,PRS,P004512,17.9,33,59,26
173,PRS,P005793,20.85,23,59,36
173,PRS,P009556,17.883,20,49,29
173,PRS,P011232,22.1,20,60,40
173,PRS,P012608,22.117,33,70,37
173,PRS,P012610,21.967,35,70,35
173,PRS,P012611,19.8,35,65,30
173,PRS,P012612,18.033,18,49,31
173,PRS,P012613,17.55,28,54,26
173,PRS,P012640,21.8,20,60,40
174,LLI,P004773,19.083,-10,33,43
174,LLI,P005247,23.533,3,50,47
174,LLI,P006600,23.399,-8,46,54
174,LLI,P008274,4.8,6,11,5
174,LLI,P009649,13.066,-12,23,35
174,LLI,P009680,24.333,2,54,52
174,LLI,P012020,15.25,2,32,30
174,LLI,P012585,21.032,11,46,35
174,LLI,P012586,28.033,-9,54,63
174,LLI,P012797,27.466,-10,51,61
174,WOL,P002387,12.216,0,28,28
174,WOL,P003212,14.798,2,34,32
174,WOL,P004645,23.4,6,48,42
174,WOL,P005516,28.783,8,60,52
174,WOL,P006154,25.682,4,56,52
174,WOL,P006546,28.782,6,64,58
174,WOL,P006907,12.882,6,27,21
174,WOL,P012576,22.149,10,52,42
174,WOL,P012577,15.032,-10,25,35
174,WOL,P012789,16.266,-7,31,38
175,HAM,P001990,16.2,-6,30,36
175,HAM,P009663,26.249,-2,61,63
175,HAM,P010070,10.15,1,23,22
175,HAM,P011168,14.383,-2,35,37
175,HAM,P011187,13.751,-5,22,27
175,HAM,P012579,23.502,3,49,46
175,HAM,P012580,22.599,-15,41,56
175,HAM,P012581,27.616,-4,64,68
175,HAM,P012582,6.65,-5,14,19
175,HAM,P012648,11.733,-2,21,23
175,HAM,P012694,17.75,1,37,36
175,HAM,P012695,9.417,1,18,17
175,VNC,P003759,21.5,12,56,44
175,VNC,P004117,23.15,9,53,44
175,VNC,P004381,26.367,14,64,50
175,VNC,P008052,22.633,10,53,43
175,VNC,P009400,14.65,-5,30,35
175,VNC,P011928,22.133,-5,42,47
175,VNC,P012259,13.633,-7,26,33
175,VNC,P012587,20.85,7,48,41
175,VNC,P012588,13.734,-3,29,32
175,VNC,P012591,21.35,3,49,46
176,BOU,P000498,14.217,-13,22,35
176,BOU,P010449,25.533,-3,52,55
176,BOU,P010450,21.417,-1,45,46
176,BOU,P010718,24.417,0,52,52
176,BOU,P011161,18.634,4,41,37
176,BOU,P011836,18.534,-2,35,37
176,BOU,P011837,10.617,-9,14,23
176,BOU,P012617,14.468,-1,29,30
176,BOU,P012618,14.683,14,40,26
176,BOU,P012619,14.751,-10,28,38
176,BOU,P012628,22.734,1,47,46
176,ULM,P005422,22.299,9,49,40
176,ULM,P007952,13.633,1,25,24
176,ULM,P010582,27.617,13,60,47
176,ULM,P010726,18.733,2,43,41
176,ULM,P011188,14.366,0,32,32
176,ULM,P011391,3.917,4,12,8
176,ULM,P011457,16.534,-4,35,39
176,ULM,P012066,3.517,1,9,8
176,ULM,P012603,25.634,4,53,49
176,ULM,P012604,22.45,-1,48,49
176,ULM,P012703,31.3,-9,59,68
177,ARI,P002867,15.167,3,27,24
177,ARI,P003240,25.95,8,54,46
177,ARI,P004292,23.968,6,52,46
177,ARI,P010177,0.25,1,1,0
177,ARI,P010387,12.601,10,36,26
177,ARI,P012615,21.418,23,55,32
177,ARI,P012702,16.717,-6,29,35
177,ARI,P012716,25.901,6,58,52
177,ARI,P012717,18.583,-16,29,45
177,ARI,P012722,7.55,5,16,11
177,ARI,P012760,8.3,-6,12,18
177,ARI,P012792,23.6,1,51,50
177,TRN,P001479,19.55,-6,33,39
177,TRN,P005059,24.283,-6,47,53
177,TRN,P005738,19.417,4,42,38
177,TRN,P006382,17.4,-1,29,30
177,TRN,P007828,15.7,-1,30,31
177,TRN,P009903,20.3,-13,39,52
177,TRN,P012595,30.0,-13,58,71
177,TRN,P012596,19.717,6,38,32
177,TRN,P012597,33.633,-5,69,74
178,BUD,P004945,7.5,0,14,14
178,BUD,P005637,12.317,-1,23,24
178,BUD,P006566,18.817,4,39,35
178,BUD,P007398,21.466,11,51,40
178,BUD,P008325,21.05,26,59,33
178,BUD,P009214,6.666,-9,11,20
178,BUD,P010248,18.95,-13,31,44
178,BUD,P010389,20.867,5,47,42
178,BUD,P011281,23.017,12,52,40
178,BUD,P011935,21.017,23,56,33
178,BUD,P012606,13.5,11,35,24
178,BUD,P012630,14.833,-4,32,36
178,CAN,P001607,13.601,-13,23,36
178,CAN,P003425,24.167,-3,49,52
178,CAN,P003637,12.6,-10,17,27
178,CAN,P004160,8.184,-11,14,25
178,CAN,P004466,8.185,6,20,14
178,CAN,P005005,14.25,1,31,30
178,CAN,P006588,26.068,-9,50,59
178,CAN,P007560,11.736,0,24,24
178,CAN,P007644,20.55,-6,37,43
178,CAN,P008121,27.283,-9,53,62
178,CAN,P010385,18.535,-3,40,43
178,CAN,P010452,14.851,-8,27,35
179,CLU,P004862,34.349,-3,74,77
179,CLU,P005113,24.167,1,55,54
179,CLU,P005373,13.533,-8,28,36
179,CLU,P005714,15.767,-8,26,34
179,CLU,P010569,27.632,9,68,59
179,CLU,P011801,30.55,13,72,59
179,CLU,P012620,4.3,-14,5,19
179,CLU,P012621,31.815,-13,67,80
179,CLU,P012698,17.882,-2,40,42
179,LKB,P005521,17.234,-6,35,41
179,LKB,P006901,18.199,-3,43,46
179,LKB,P007029,33.283,-5,70,75
179,LKB,P009898,31.933,6,74,68
179,LKB,P010190,15.85,14,45,31
179,LKB,P010461,31.45,14,75,61
179,LKB,P011329,18.167,6,45,39
179,LKB,PLXI,33.884,-1,73,74
180,TTK,P004801,29.201,14,64,50
180,TTK,P005000,13.2,4,24,20
180,TTK,P006693,34.118,7,72,65
180,TTK,P006883,15.317,5,26,21
180,TTK,P009845,1.25,0,2,2
180,TTK,P010477,10.8,2,22,20
180,TTK,P011239,28.484,18,70,52
180,TTK,P011272,0.833,2,2,0
180,TTK,P011834,29.601,15,67,52
180,TTK,P011925,36.368,11,79,68
180,TTK,P011975,0.833,2,2,0
180,WRO,P005531,34.633,-12,63,75
180,WRO,P007472,0.833,-2,0,2
180,WRO,P009896,33.016,-10,61,71
180,WRO,P011900,25.949,-15,43,58
180,WRO,P011902,13.666,-9,19,28
180,WRO,P012094,32.633,-13,65,78
180,WRO,P012308,4.283,1,5,4
180,WRO,P012699,29.933,-16,52,68
180,WRO,P012736,25.049,-4,42,46
181,LLI,P004773,13.5,0,29,29
181,LLI,P005247,20.083,12,48,36
181,LLI,P006600,21.684,15,60,45
181,LLI,P008274,1.383,-2,0,2
181,LLI,P009649,19.917,11,52,41
181,LLI,P009672,17.0,10,44,34
181,LLI,P009680,16.999,9,39,30
181,LLI,P012020,18.316,8,40,32
181,LLI,P012585,22.083,16,58,42
181,LLI,P012586,23.001,14,61,47
181,LLI,P012797,26.034,22,69,47
181,TTK,P004801,19.533,-3,43,46
181,TTK,P005000,21.001,-14,36,50
181,TTK,P006693,27.883,-23,52,75
181,TTK,P006883,16.249,-4,37,41
181,TTK,P009845,6.233,-6,12,18
181,TTK,P010477,20.466,-20,34,54
181,TTK,P011239,26.833,-16,46,62
181,TTK,P011834,25.766,-17,50,67
181,TTK,P011925,34.648,-14,73,87
181,TTK,P011975,1.383,2,2,0
182,JOV,P002361,23.851,12,56,44
182,JOV,P002507,23.868,3,46,43
182,JOV,P006771,11.701,-10,18,28
182,JOV,P010161,12.534,-2,26,28
182,JOV,P010458,27.584,11,62,51
182,JOV,P010677,18.5,-1,36,37
182,JOV,P011247,31.418,7,74,67
182,JOV,P011248,26.699,20,67,47
182,JOV,P012780,15.983,4,40,36
182,JOV,PJUG,7.867,1,15,14
182,ULM,P005422,23.951,7,48,41
182,ULM,P006997,8.534,-7,12,19
182,ULM,P007952,6.483,-7,9,16
182,ULM,P010106,24.068,1,52,51
182,ULM,P010582,30.885,-5,62,67
182,ULM,P010726,4.334,-7,6,13
182,ULM,P011188,13.001,-8,23,31
182,ULM,P011457,17.469,-12,36,48
182,ULM,P012603,25.318,7,56,49
182,ULM,P012604,26.67,-3,58,61
182,ULM,P012703,19.302,-11,33,44
183,BES,P003783,18.017,-3,39,42
183,BES,P007914,13.0,5,29,24
183,BES,P007917,4.8,-8,7,15
183,BES,P008945,27.232,6,58,52
183,BES,P011379,16.55,3,29,26
183,BES,P011924,14.75,-6,27,33
183,BES,P011936,22.332,8,46,38
183,BES,P012622,36.132,0,73,73
183,BES,P012647,21.949,-2,42,44
183,BES,P012711,25.233,7,50,43
183,CAN,P001607,11.15,-10,19,29
183,CAN,P003425,29.618,7,61,54
183,CAN,P003637,23.867,5,51,46
183,CAN,P004160,10.134,-2,18,20
183,CAN,P005005,13.601,-6,21,27
183,CAN,P006588,20.617,3,39,36
183,CAN,P007560,3.2,-4,7,11
183,CAN,P007644,0.25,-2,0,2
183,CAN,P008121,28.683,2,57,55
183,CAN,P009864,17.733,-3,33,36
183,CAN,P010385,22.018,3,45,42
183,CAN,P010452,19.134,-3,39,42
184,ARI,P002867,8.767,-11,11,22
184,ARI,P003240,28.785,-17,48,65
184,ARI,P004292,26.634,-12,47,59
184,ARI,P010177,2.084,-2,2,4
184,ARI,P010387,8.234,-6,15,21
184,ARI,P012615,19.034,-15,29,44
184,ARI,P012702,12.034,-10,22,32
184,ARI,P012716,27.817,-18,46,64
184,ARI,P012717,27.101,-18,49,67
184,ARI,P012722,7.934,-1,15,16
184,ARI,P012760,12.934,-12,19,31
184,ARI,P012792,18.652,-18,32,50
184,PMT,P001686,13.9,7,30,23
184,PMT,P002020,2.083,2,4,2
184,PMT,P002644,23.651,10,52,42
184,PMT,P002691,4.4,-1,8,9
184,PMT,P005301,25.717,19,62,43
184,PMT,P011823,14.266,16,39,23
184,PMT,P011942,22.833,20,59,39
184,PMT,P011943,23.349,13,54,41
184,PMT,P011944,27.666,24,68,44
184,PMT,P011947,19.084,9,42,33
184,PMT,P012600,23.051,21,57,36
185,JOV,P002361,23.651,-5,44,49
185,JOV,P002507,23.517,-11,45,56
185,JOV,P006771,4.7,2,6,4
185,JOV,P010161,5.433,-5,7,12
185,JOV,P010458,22.35,-6,42,48
185,JOV,P010677,19.65,-16,29,45
185,JOV,P011247,31.468,-9,61,70
185,JOV,P011248,34.868,-15,63,78
185,JOV,P012349,14.517,-2,25,27
185,JOV,P012780,19.851,-13,28,41
185,PRS,P003481,17.749,5,37,32
185,PRS,P004512,6.883,-4,11,15
185,PRS,P005793,15.216,-3,26,29
185,PRS,P009556,11.983,-7,17,24
185,PRS,P011232,28.716,14,60,46
185,PRS,P012608,28.015,23,69,46
185,PRS,P012609,20.716,14,48,34
185,PRS,P012610,25.265,13,56,43
185,PRS,P012613,23.832,15,57,42
185,PRS,P012640,21.615,10,49,39
186,CLU,P004862,23.333,-12,42,54
186,CLU,P005113,15.8,-13,26,39
186,CLU,P005373,13.417,3,32,29
186,CLU,P005714,27.083,0,59,59
186,CLU,P010569,21.383,-12,38,50
186,CLU,P011797,16.817,-11,30,41
186,CLU,P011801,17.283,-10,35,45
186,CLU,P012620,5.2,3,11,8
186,CLU,P012621,31.384,-7,62,69
186,CLU,P012698,28.3,-1,60,61
186,LLI,P004479,2.85,3,9,6
186,LLI,P004773,10.817,15,31,16
186,LLI,P005247,24.134,9,53,44
186,LLI,P009649,21.716,3,49,46
186,LLI,P009672,23.783,2,53,51
186,LLI,P009680,23.633,8,52,44
186,LLI,P012020,22.384,9,52,43
186,LLI,P012585,27.4,1,63,62
186,LLI,P012586,22.633,2,50,48
186,LLI,P012797,20.65,8,43,35
187,BOU,P004525,18.484,-3,43,46
187,BOU,P010431,24.717,5,60,55
187,BOU,P010449,17.217,-7,34,41
187,BOU,P010718,20.117,-1,45,46
187,BOU,P011161,14.434,6,31,25
187,BOU,P011836,26.55,13,66,53
187,BOU,P011837,21.851,14,57,43
187,BOU,P012617,22.784,20,61,41
187,BOU,P012618,13.117,2,24,22
187,BOU,P012628,20.734,16,54,38
187,PMT,P001686,12.635,-3,23,26
187,PMT,P002020,3.483,-4,11,15
187,PMT,P002644,26.434,-1,60,61
187,PMT,P002691,14.601,-1,35,36
187,PMT,P005301,23.051,-8,45,53
187,PMT,P011823,13.567,-12,22,34
187,PMT,P011942,19.7,-8,39,47
187,PMT,P011943,18.467,-5,39,44
187,PMT,P011944,25.466,-15,46,61
187,PMT,P011966,12.467,-9,22,31
187,PMT,P012600,30.134,1,68,67
188,BES,P003783,20.384,-6,40,46
188,BES,P007914,8.116,-7,16,23
188,BES,P007917,0.917,0,4,4
188,BES,P008945,21.516,7,54,47
188,BES,P011379,17.5,-13,29,42
188,BES,P011924,17.3,-10,36,46
188,BES,P011936,32.6,13,84,71
188,BES,P012622,26.2,18,63,45
188,BES,P012647,29.817,16,84,68
188,BES,P012711,25.65,7,60,53
188,HTA,P003533,4.0,3,10,7
188,HTA,P004267,10.268,3,26,23
188,HTA,P004846,29.035,-1,68,69
188,HTA,P006835,26.637,6,61,55
188,HTA,P007759,16.603,-4,30,34
188,HTA,P007867,32.785,-2,76,78
188,HTA,P010465,16.917,-9,37,46
188,HTA,P010550,27.934,-4,62,66
188,HTA,P011973,21.435,-15,45,60
188,HTA,P011991,8.634,9,19,10
188,HTA,P012794,5.767,-11,11,22
189,LLI,P004479,5.75,0,19,19
189,LLI,P004773,13.0,-4,25,29
189,LLI,P005247,14.032,-12,30,42
189,LLI,P006600,23.066,-2,55,57
189,LLI,P009649,24.467,-2,51,53
189,LLI,P009672,22.582,-15,44,59
189,LLI,P009680,17.516,-10,36,46
189,LLI,P012020,6.65,-3,16,19
189,LLI,P012585,24.416,-9,53,62
189,LLI,P012586,23.85,-4,49,53
189,LLI,P012797,24.666,-4,52,56
189,PRS,P004512,14.784,10,32,22
189,PRS,P005793,11.433,3,27,24
189,PRS,P009556,13.45,-3,34,37
189,PRS,P011232,23.732,5,64,59
189,PRS,P012608,26.549,16,65,49
189,PRS,P012609,22.599,9,58,49
189,PRS,P012610,26.399,13,68,55
189,PRS,P012611,15.033,4,32,28
189,PRS,P012613,23.033,2,52,50
189,PRS,P012640,22.983,6,63,57
190,BES,P003783,17.935,-1,37,38
190,BES,P007914,19.434,-7,36,43
190,BES,P007917,1.25,-5,1,6
190,BES,P008945,29.318,-10,54,64
190,BES,P011357,0.367,0,0,0
190,BES,P011379,23.169,0,49,49
190,BES,P011924,18.717,-7,38,45
190,BES,P011936,21.751,-13,35,48
190,BES,P012622,21.634,-8,33,41
190,BES,P012647,29.468,-8,52,60
190,BES,P012711,16.967,-1,35,36
190,BOU,P004525,15.117,7,35,28
190,BOU,P010431,21.116,2,42,40
190,BOU,P010449,13.949,4,24,20
190,BOU,P010718,23.434,4,55,51
190,BOU,P011161,18.783,8,38,30
190,BOU,P011836,29.383,-1,61,62
190,BOU,P011837,21.734,10,47,37
190,BOU,P012617,26.051,8,62,54
190,BOU,P012618,13.516,8,29,21
190,BOU,P012628,16.917,10,37,27
191,LLI,P004773,18.302,-2,40,42
191,LLI,P005247,19.967,14,54,40
191,LLI,P006600,21.967,-14,37,51
191,LLI,P009649,15.418,-15,25,40
191,LLI,P009672,24.884,5,62,57
191,LLI,P009680,25.301,-13,53,66
191,LLI,P012020,15.268,4,36,32
191,LLI,P012585,27.85,-13,58,71
191,LLI,P012586,9.984,3,21,18
191,LLI,P012797,21.069,-9,39,48
191,PRS,P004512,20.417,8,50,42
191,PRS,P005793,7.917,1,17,16
191,PRS,P009556,12.75,4,28,24
191,PRS,P011232,22.151,3,52,49
191,PRS,P012608,27.251,4,65,61
191,PRS,P012609,21.0,0,44,44
191,PRS,P012610,27.018,4,65,61
191,PRS,P012611,19.283,3,46,43
191,PRS,P012613,22.017,8,51,43
191,PRS,P012640,20.201,5,47,42
192,BES,P003783,16.785,22,48,26
192,BES,P007914,23.101,0,44,44
192,BES,P008945,27.251,-6,46,52
192,BES,P011379,15.284,12,37,25
192,BES,P011924,6.1,1,11,10
192,BES,P011936,32.769,9,68,59
192,BES,P012622,30.535,3,58,55
192,BES,P012647,30.802,8,60,52
192,BES,P012711,17.383,6,38,32
192,BOU,P004525,16.032,-1,27,28
192,BOU,P010431,24.383,-5,46,51
192,BOU,P010449,18.766,5,40,35
192,BOU,P010718,21.616,1,41,40
192,BOU,P011161,17.533,-11,27,38
192,BOU,P011836,23.5,-8,42,50
192,BOU,P011837,18.483,-12,31,43
192,BOU,P012617,21.233,-16,31,47
192,BOU,P012618,21.516,1,40,39
192,BOU,P012628,16.933,-9,30,39
194,BES,P003783,20.866,-14,34,48
194,BES,P007914,28.316,-7,50,57
194,BES,P007917,5.766,-8,4,12
194,BES,P008945,31.833,-22,50,72
194,BES,P011357,10.567,-15,10,25
194,BES,P011379,28.516,-20,46,66
194,BES,P011924,26.15,-28,33,61
194,BES,P011936,15.532,-6,26,32
194,BES,P012647,12.434,2,31,29
194,BES,P012711,20.015,-12,31,43
194,BOU,P000498,2.116,1,4,3
194,BOU,P004525,18.983,12,42,30
194,BOU,P010431,17.584,14,44,30
194,BOU,P010449,21.616,18,48,30
194,BOU,P010450,10.617,19,25,6
194,BOU,P010718,21.983,15,50,35
194,BOU,P011161,24.401,17,55,38
194,BOU,P011836,23.484,5,53,48
194,BOU,P011837,16.95,24,42,18
194,BOU,P012617,16.584,7,37,30
194,BOU,P012618,9.583,-8,16,24
194,BOU,P012628,16.099,6,29,23
195,BOU,P000498,12.449,1,28,27
195,BOU,P004525,18.332,-5,31,36
195,BOU,P010431,10.449,-9,21,30
195,BOU,P010449,14.949,2,24,22
195,BOU,P010718,23.849,-16,36,52
195,BOU,P011161,19.083,-10,25,35
195,BOU,P011836,24.616,-11,39,50
195,BOU,P011837,16.449,-5,28,33
195,BOU,P012617,19.416,-6,28,34
195,BOU,P012618,20.599,-5,30,35
195,BOU,P012628,19.799,-1,30,31
195,PRS,P003481,14.0,1,25,24
195,PRS,P004512,17.9,4,31,27
195,PRS,P005793,5.283,-5,9,14
195,PRS,P009556,15.516,-4,28,32
195,PRS,P011232,23.167,4,43,39
195,PRS,P011887,1.083,0,3,3
195,PRS,P012608,24.484,17,49,32
195,PRS,P012609,18.1,8,38,30
195,PRS,P012610,22.317,19,45,26
195,PRS,P012611,20.817,5,36,31
195,PRS,P012613,17.717,13,37,24
195,PRS,P012640,19.616,3,41,38
196,BOU,P004525,14.2,5,33,28
196,BOU,P010431,15.2,-2,34,36
196,BOU,P010449,23.333,-3,46,49
196,BOU,P010450,2.233,-3,3,6
196,BOU,P010718,21.567,2,48,46
196,BOU,P011161,17.0,4,35,31
196,BOU,P011836,27.733,-13,53,66
196,BOU,P011837,20.417,-4,40,44
196,BOU,P012617,24.417,-6,50,56
196,BOU,P012618,17.65,-4,36,40
196,BOU,P012628,16.25,-16,27,43
196,PRS,P003481,13.8,10,33,23
196,PRS,P004512,18.216,-8,36,44
196,PRS,P009556,9.683,8,19,11
196,PRS,P011232,16.35,6,40,34
196,PRS,P012608,30.267,2,70,68
196,PRS,P012609,20.1,16,47,31
196,PRS,P012610,26.2,-2,56,58
196,PRS,P012611,17.4,-6,35,41
196,PRS,P012613,25.517,2,56,54
196,PRS,P012640,22.467,12,53,41
