GAMECODE,CODETEAM,joueur_1,joueur_2,TIME,DELTA_SCORE,OFF,DEF
1,TSO,P009649,P013295,0 days 00:30:40,-10,64,74
1,TSO,P009649,P012019,0 days 00:30:12,-13,54,67
1,TSO,P009649,P013293,0 days 00:28:22,-1,62,63
1,TSO,P009649,P013296,0 days 00:28:18,-13,51,64
1,TSO,P013293,P013295,0 days 00:25:15,-1,58,59
1,TSO,P013293,P013296,0 days 00:23:56,-2,49,51
1,TSO,P013295,P013296,0 days 00:23:40,-6,47,53
1,TSO,P009649,P013298,0 days 00:23:14,-4,50,54
1,TSO,P012019,P013295,0 days 00:22:38,-10,43,53
1,TSO,P012019,P013293,0 days 00:21:46,1,43,42
1,TSO,P012019,P013296,0 days 00:20:32,-12,31,43
1,TSO,P012019,P013298,0 days 00:16:38,-2,31,33
1,TSO,P013295,P013298,0 days 00:15:30,-6,36,42
1,TSO,P013293,P013298,0 days 00:14:48,10,39,29
1,TSO,P013296,P013298,0 days 00:13:56,-6,28,34
1,TSO,P008790,P012019,0 days 00:13:46,5,33,28
1,TSO,P008790,P013298,0 days 00:13:24,8,32,24
1,TSO,P008790,P009649,0 days 00:12:36,4,32,28
1,TSO,P013297,P013298,0 days 00:11:50,8,24,16
1,TSO,P012019,P013297,0 days 00:11:40,3,21,18
1,TSO,P009649,P013297,0 days 00:10:14,1,19,18
1,TSO,P008790,P013293,0 days 00:08:32,7,23,16
1,TSO,P008790,P013297,0 days 00:08:25,11,20,9
1,TSO,P008790,P013295,0 days 00:07:41,-3,20,23
1,TSO,P013293,P013297,0 days 00:07:13,6,14,8
1,TSO,P013296,P013297,0 days 00:05:14,-5,6,11
1,ULM,P011437,P013290,0 days 00:30:27,10,69,59
1,ULM,P006997,P013290,0 days 00:24:43,11,51,40
1,ULM,P011391,P013290,0 days 00:24:05,4,56,52
1,ULM,P011391,P011437,0 days 00:20:51,4,51,47
1,ULM,P011437,P012077,0 days 00:20:45,-2,43,45
1,ULM,P006997,P011437,0 days 00:20:42,8,45,37
1,ULM,P013290,P013291,0 days 00:19:27,7,42,35
1,ULM,P012077,P013290,0 days 00:19:21,-4,44,48
1,ULM,P011437,P013291,0 days 00:17:34,7,39,32
1,ULM,P011391,P012077,0 days 00:15:36,-9,37,46
1,ULM,P006997,P013291,0 days 00:15:23,5,29,24
1,ULM,P006245,P013290,0 days 00:14:29,10,31,21
1,ULM,P006245,P006997,0 days 00:12:23,11,30,19
1,ULM,P012077,P013291,0 days 00:11:23,5,25,20
1,ULM,P012602,P013290,0 days 00:10:44,4,17,13
1,ULM,P011391,P012602,0 days 00:10:04,-4,18,22
1,ULM,P006997,P012077,0 days 00:10:01,-1,18,19
1,ULM,P006245,P013291,0 days 00:09:19,4,21,17
1,ULM,P006997,P011391,0 days 00:08:53,9,22,13
1,ULM,P006245,P011437,0 days 00:08:22,8,24,16
1,ULM,P011437,P013289,0 days 00:08:00,0,17,17
1,ULM,P011391,P013289,0 days 00:07:18,2,17,15
1,ULM,P011437,P012602,0 days 00:06:58,-7,13,20
1,ULM,P007952,P011391,0 days 00:06:49,-14,11,25
1,ULM,P013289,P013290,0 days 00:06:24,-2,12,14
1,ULM,P006245,P011391,0 days 00:05:54,7,13,6
1,ULM,P010726,P012077,0 days 00:05:42,-8,11,19
1,ULM,P006245,P012602,0 days 00:05:26,6,9,3
1,ULM,P007952,P012077,0 days 00:05:23,-14,11,25
1,ULM,P012077,P013289,0 days 00:05:21,-1,9,10
1,ULM,P007952,P013290,0 days 00:05:11,-8,9,17
1,ULM,P010726,P013289,0 days 00:04:54,2,11,9
1,ULM,P006997,P012602,0 days 00:04:52,6,9,3
1,ULM,P010726,P013290,0 days 00:04:49,-8,9,17
1,ULM,P010726,P011391,0 days 00:04:42,-5,14,19
1,ULM,P012602,P013289,0 days 00:04:30,2,12,10
1,ULM,P011391,P013291,0 days 00:04:04,2,13,11
1,ULM,P010726,P011437,0 days 00:04:04,1,7,6
1,ULM,P010726,P013291,0 days 00:03:34,0,4,4
1,ULM,P007952,P011437,0 days 00:03:29,-9,4,13
1,ULM,P012602,P013291,0 days 00:03:22,4,7,3
1,ULM,P007952,P012602,0 days 00:03:04,-6,2,8
1,ULM,P013289,P013291,0 days 00:02:06,2,4,2
1,ULM,P007952,P010726,0 days 00:01:54,-5,7,12
1,ULM,P012077,P012602,0 days 00:01:38,-6,2,8
1,ULM,P006997,P010726,0 days 00:01:28,-2,0,2
1,ULM,P006245,P007952,0 days 00:01:26,0,0,0
1,ULM,P010726,P012602,0 days 00:01:06,5,7,2
1,ULM,P006245,P010726,0 days 00:00:51,0,2,2
1,ULM,P006997,P013289,0 days 00:00:27,-3,0,3
1,ULM,P006245,P013289,0 days 00:00:24,2,2,0
1,ULM,P006245,P012077,0 days 00:00:18,0,0,0
2,JOV,P013285,P013287,0 days 00:23:15,7,49,42
2,JOV,P002507,P013285,0 days 00:22:00,12,49,37
2,JOV,P002507,P013287,0 days 00:18:40,11,43,32
2,JOV,P010161,P013287,0 days 00:17:57,18,45,27
2,JOV,P002361,P013287,0 days 00:17:47,4,41,37
2,JOV,P010161,P013285,0 days 00:15:13,14,36,22
2,JOV,P002361,P013285,0 days 00:15:03,0,32,32
2,JOV,P002361,P002507,0 days 00:13:53,4,31,27
2,JOV,P002507,P010161,0 days 00:13:49,16,34,18
2,JOV,P005099,P012740,0 days 00:13:47,-8,20,28
2,JOV,P004834,P012740,0 days 00:13:06,-9,19,28
2,JOV,P012349,P012740,0 days 00:12:32,-12,16,28
2,JOV,P002361,P010161,0 days 00:11:48,11,31,20
2,JOV,P005099,P013285,0 days 00:11:07,-7,18,25
2,JOV,P004834,P005099,0 days 00:10:35,-11,15,26
2,JOV,P005099,P012349,0 days 00:10:15,-12,13,25
2,JOV,P012740,P013286,0 days 00:09:53,-2,14,16
2,JOV,P005099,P013287,0 days 00:08:57,-4,16,20
2,JOV,P002507,P005099,0 days 00:08:56,-5,14,19
2,JOV,P004834,P013286,0 days 00:08:34,-2,14,16
2,JOV,P004834,P012349,0 days 00:08:31,-13,10,23
2,JOV,P004834,P013287,0 days 00:08:27,6,19,13
2,JOV,P012349,P013286,0 days 00:08:24,-6,10,16
2,JOV,P013287,PJUG,0 days 00:07:46,12,22,10
2,JOV,P005099,P013286,0 days 00:07:36,-2,11,13
2,JOV,P010161,PJUG,0 days 00:07:31,11,21,10
2,JOV,P002361,P005099,0 days 00:06:51,-15,9,24
2,JOV,P012740,P013285,0 days 00:06:45,1,11,10
2,JOV,P004834,P010161,0 days 00:06:23,4,14,10
2,JOV,P013285,PJUG,0 days 00:05:02,8,13,5
2,JOV,P002507,PJUG,0 days 00:05:02,8,13,5
2,JOV,P002361,P004834,0 days 00:04:59,-5,10,15
2,JOV,P012740,P013287,0 days 00:04:35,4,9,5
2,JOV,P004834,P013285,0 days 00:04:33,-2,6,8
2,JOV,P002507,P012740,0 days 00:04:20,1,6,5
2,JOV,P002507,P012349,0 days 00:04:01,1,6,5
2,JOV,P010161,P012740,0 days 00:03:39,0,5,5
2,JOV,P012349,P013285,0 days 00:03:03,-1,6,7
2,JOV,P002361,PJUG,0 days 00:02:59,5,10,5
2,JOV,P004834,PJUG,0 days 00:02:44,4,9,5
2,JOV,P010161,P012349,0 days 00:02:19,-2,3,5
2,JOV,P010161,P013286,0 days 00:02:17,0,3,3
2,JOV,P002507,P013286,0 days 00:01:19,0,0,0
2,JOV,P013286,P013287,0 days 00:01:10,4,4,0
2,JOV,P002361,P012349,0 days 00:01:09,-9,0,9
2,JOV,P002361,P012740,0 days 00:01:07,-7,0,7
2,JOV,P013285,P013286,0 days 00:00:19,0,0,0
2,JOV,P012349,P013287,0 days 00:00:02,-2,0,2
2,HTA,P001927,P005181,0 days 00:25:34,9,58,49
2,HTA,P005181,P013284,0 days 00:24:37,5,54,49
2,HTA,P001927,P013284,0 days 00:22:51,-1,48,49
2,HTA,P005181,P012096,0 days 00:21:14,13,51,38
2,HTA,P001927,P012096,0 days 00:19:34,12,44,32
2,HTA,P001927,P011157,0 days 00:19:25,-13,29,42
2,HTA,P001927,P010386,0 days 00:16:38,-13,26,39
2,HTA,P009818,P013284,0 days 00:15:36,-10,23,33
2,HTA,P011157,P013284,0 days 00:14:41,-15,19,34
2,HTA,P012096,P013284,0 days 00:14:19,10,37,27
2,HTA,P012096,P013283,0 days 00:13:44,12,34,22
2,HTA,P005181,P011157,0 days 00:13:30,-6,22,28
2,HTA,P010386,P013284,0 days 00:12:57,-15,20,35
2,HTA,P005181,P010386,0 days 00:12:47,-5,25,30
2,HTA,P005181,P013283,0 days 00:12:32,15,34,19
2,HTA,P005181,P009818,0 days 00:11:26,-3,19,22
2,HTA,P013283,P013284,0 days 00:11:11,12,29,17
2,HTA,P001927,P009818,0 days 00:11:09,-10,16,26
2,HTA,P009818,P011157,0 days 00:10:58,-10,16,26
2,HTA,P010386,P012096,0 days 00:10:27,-5,20,25
2,HTA,P010386,P011157,0 days 00:08:59,-12,9,21
2,HTA,P001927,P010550,0 days 00:08:42,-2,12,14
2,HTA,P010550,P012096,0 days 00:08:38,-4,10,14
2,HTA,P001927,P013283,0 days 00:08:05,14,24,10
2,HTA,P011157,P012096,0 days 00:05:16,2,10,8
2,HTA,P005181,P010550,0 days 00:04:54,0,9,9
2,HTA,P009818,P012096,0 days 00:04:38,0,7,7
2,HTA,P009818,P013283,0 days 00:04:27,0,7,7
2,HTA,P010386,P010550,0 days 00:04:25,2,9,7
2,HTA,P009818,P010386,0 days 00:04:10,-7,4,11
2,HTA,P010386,P013283,0 days 00:03:13,-5,3,8
2,HTA,P010550,P011386,0 days 00:03:10,0,3,3
2,HTA,P001927,P011386,0 days 00:03:10,0,3,3
2,HTA,P011386,P012096,0 days 00:03:10,0,3,3
2,HTA,P010550,P011157,0 days 00:02:58,-2,3,5
2,HTA,P011157,P011386,0 days 00:02:17,0,3,3
2,HTA,P010550,P013283,0 days 00:01:57,-4,0,4
2,HTA,P011157,P013283,0 days 00:01:44,4,5,1
2,HTA,P005181,P011386,0 days 00:00:34,0,0,0
2,HTA,P011386,P013283,0 days 00:00:19,0,0,0
2,HTA,P010550,P013284,0 days 00:00:04,2,2,0
3,WOL,P011248,P012003,0 days 00:26:02,-10,51,61
3,WOL,P011248,P012577,0 days 00:25:28,-22,40,62
3,WOL,P006546,P011248,0 days 00:24:36,-12,47,59
3,WOL,P006546,P012003,0 days 00:24:29,-2,54,56
3,WOL,P012003,P012577,0 days 00:21:46,-13,37,50
3,WOL,P006546,P012577,0 days 00:21:45,-13,37,50
3,WOL,P012577,P012789,0 days 00:20:05,-18,27,45
3,WOL,P011248,P012789,0 days 00:19:35,-18,27,45
3,WOL,P012003,P012789,0 days 00:17:47,-13,27,40
3,WOL,P006546,P012789,0 days 00:17:46,-13,27,40
3,WOL,P008186,P012003,0 days 00:14:31,7,30,23
3,WOL,P004645,P008186,0 days 00:13:08,11,26,15
3,WOL,P004645,P005516,0 days 00:13:05,6,22,16
3,WOL,P004645,P012003,0 days 00:10:46,10,23,13
3,WOL,P005516,P012003,0 days 00:10:21,7,16,9
3,WOL,P005516,P008186,0 days 00:10:17,10,16,6
3,WOL,P005516,P006853,0 days 00:09:36,-1,11,12
3,WOL,P004645,P006853,0 days 00:09:06,-1,11,12
3,WOL,P006546,P008186,0 days 00:08:47,3,24,21
3,WOL,P008186,P011248,0 days 00:08:38,0,21,21
3,WOL,P005516,P011248,0 days 00:08:03,-9,10,19
3,WOL,P005516,P012577,0 days 00:07:25,-11,9,20
3,WOL,P004645,P011248,0 days 00:06:40,-1,17,18
3,WOL,P006853,P008186,0 days 00:06:18,3,5,2
3,WOL,P004645,P006546,0 days 00:05:02,6,17,11
3,WOL,P005516,P012789,0 days 00:04:37,-10,0,10
3,WOL,P005516,P006546,0 days 00:04:36,3,10,7
3,WOL,P006853,P012003,0 days 00:04:26,2,2,0
3,WOL,P008186,P012577,0 days 00:03:52,-3,7,10
3,WOL,P003212,P006853,0 days 00:03:16,1,6,5
3,WOL,P003212,P005516,0 days 00:03:16,1,6,5
3,WOL,P003212,P004645,0 days 00:03:16,1,6,5
3,WOL,P006853,P012577,0 days 00:03:11,-4,6,10
3,WOL,P004645,P012577,0 days 00:02:41,-4,6,10
3,WOL,P003212,P008186,0 days 00:02:29,1,3,2
3,WOL,P006853,P011248,0 days 00:01:54,-4,3,7
3,WOL,P003212,P012577,0 days 00:00:47,0,3,3
3,WOL,P006853,P012789,0 days 00:00:30,0,0,0
3,WOL,P006546,P006853,0 days 00:00:07,0,0,0
3,BAH,P003840,P011821,0 days 00:26:30,17,63,46
3,BAH,P003840,P011823,0 days 00:25:27,21,57,36
3,BAH,P009601,P011821,0 days 00:20:23,5,46,41
3,BAH,P011821,P011823,0 days 00:20:04,15,48,33
3,BAH,P003840,P009601,0 days 00:19:37,8,48,40
3,BAH,P003840,P011192,0 days 00:19:26,10,41,31
3,BAH,P009601,P011823,0 days 00:17:33,9,41,32
3,BAH,P011192,P011821,0 days 00:16:57,10,39,29
3,BAH,P003840,P012711,0 days 00:16:21,7,31,24
3,BAH,P011192,P011823,0 days 00:14:40,5,29,24
3,BAH,P003840,P004172,0 days 00:13:17,14,32,18
3,BAH,P011192,P012711,0 days 00:12:22,4,19,15
3,BAH,P004172,P011823,0 days 00:11:47,12,28,16
3,BAH,P004172,P009601,0 days 00:11:45,2,27,25
3,BAH,P004172,P011821,0 days 00:11:28,3,25,22
3,BAH,P011821,P012711,0 days 00:10:33,7,24,17
3,BAH,P009601,P011192,0 days 00:09:59,2,22,20
3,BAH,P004172,P011201,0 days 00:09:54,1,15,14
3,BAH,P011201,P012711,0 days 00:09:53,-5,10,15
3,BAH,P003840,P011201,0 days 00:09:47,-2,16,18
3,BAH,P012405,P012711,0 days 00:08:54,-2,12,14
3,BAH,P011823,P012711,0 days 00:08:24,10,16,6
3,BAH,P011821,P012405,0 days 00:08:03,-3,16,19
3,BAH,P011192,P012405,0 days 00:07:34,1,12,11
3,BAH,P003840,P012405,0 days 00:07:28,0,16,16
3,BAH,P011201,P012405,0 days 00:07:19,-8,8,16
3,BAH,P004172,P012711,0 days 00:07:02,5,9,4
3,BAH,P004172,P012405,0 days 00:07:00,-5,8,13
3,BAH,P009601,P011201,0 days 00:06:22,-5,13,18
3,BAH,P011201,P011823,0 days 00:05:53,4,9,5
3,BAH,P011192,P011201,0 days 00:05:31,-4,2,6
3,BAH,P011201,P011821,0 days 00:04:22,-6,7,13
3,BAH,P009601,P012405,0 days 00:03:34,-3,8,11
3,BAH,P004172,P011192,0 days 00:02:55,-4,0,4
3,BAH,P009601,P012711,0 days 00:01:28,-3,3,6
3,BAH,P003840,P008278,0 days 00:00:07,-3,0,3
3,BAH,P008278,P009601,0 days 00:00:07,-3,0,3
3,BAH,P008278,P011201,0 days 00:00:07,-3,0,3
3,BAH,P008278,P012711,0 days 00:00:07,-3,0,3
4,BES,P011927,P013255,0 days 00:20:04,0,39,39
4,BES,P011924,P013255,0 days 00:20:02,5,44,39
4,BES,P011924,P011927,0 days 00:18:06,2,39,37
4,BES,P008945,P010652,0 days 00:17:10,16,49,33
4,BES,P003783,P010652,0 days 00:15:14,16,40,24
4,BES,P003783,P007914,0 days 00:15:08,16,44,28
4,BES,P007914,P009680,0 days 00:14:01,9,40,31
4,BES,P010652,P011927,0 days 00:13:57,5,26,21
4,BES,P007914,P010652,0 days 00:13:09,18,40,22
4,BES,P008945,P013255,0 days 00:12:40,2,30,28
4,BES,P008945,P011927,0 days 00:12:19,6,30,24
4,BES,P010652,P013255,0 days 00:12:09,3,24,21
4,BES,P003783,P009680,0 days 00:12:09,12,38,26
4,BES,P008945,P011924,0 days 00:11:47,0,26,26
4,BES,P009680,P010652,0 days 00:11:21,16,38,22
4,BES,P011927,P011936,0 days 00:11:05,-3,16,19
4,BES,P011936,P013255,0 days 00:11:02,5,22,17
4,BES,P008945,P009680,0 days 00:11:01,3,30,27
4,BES,P007914,P008945,0 days 00:10:46,7,30,23
4,BES,P009680,P011936,0 days 00:09:43,9,27,18
4,BES,P011379,P013255,0 days 00:09:29,3,22,19
4,BES,P011379,P011924,0 days 00:09:29,3,22,19
4,BES,P010652,P011924,0 days 00:09:18,3,20,17
4,BES,P011379,P011936,0 days 00:09:02,3,18,15
4,BES,P010652,P011936,0 days 00:08:54,7,19,12
4,BES,P003783,P008945,0 days 00:08:51,10,28,18
4,BES,P007914,P011936,0 days 00:08:26,3,18,15
4,BES,P003783,P011936,0 days 00:08:22,4,16,12
4,BES,P011924,P011936,0 days 00:08:18,5,18,13
4,BES,P011379,P011927,0 days 00:08:01,0,17,17
4,BES,P008945,P011379,0 days 00:06:10,-7,11,18
4,BES,P003783,P011927,0 days 00:05:18,1,7,6
4,BES,P009680,P011379,0 days 00:05:12,-1,10,11
4,BES,P009680,P013255,0 days 00:03:58,4,11,7
4,BES,P007914,P011379,0 days 00:03:44,-4,5,9
4,BES,P007914,P011927,0 days 00:03:20,3,7,4
4,BES,P009680,P011924,0 days 00:03:05,2,7,5
4,BES,P008945,P011936,0 days 00:02:48,-1,6,7
4,BES,P003783,P013255,0 days 00:02:05,-2,0,2
4,BES,P003783,P011379,0 days 00:01:45,-1,3,4
4,BES,P009680,P011927,0 days 00:01:26,-2,3,5
4,BES,P007914,P011924,0 days 00:00:03,0,0,0
4,BES,P007914,P013255,0 days 00:00:03,0,0,0
4,BUD,P008325,P011150,0 days 00:26:43,-5,57,62
4,BUD,P011150,P013256,0 days 00:21:44,-1,44,45
4,BUD,P008325,P013256,0 days 00:18:47,0,40,40
4,BUD,P011150,P011281,0 days 00:16:37,-7,34,41
4,BUD,P008325,P011281,0 days 00:16:03,-9,34,43
4,BUD,P006566,P008325,0 days 00:15:39,-6,22,28
4,BUD,P008325,P012606,0 days 00:14:25,-1,29,30
4,BUD,P012606,P012630,0 days 00:13:26,2,28,26
4,BUD,P011150,P012606,0 days 00:13:25,1,27,26
4,BUD,P005637,P012630,0 days 00:13:23,-9,24,33
4,BUD,P006566,P011150,0 days 00:12:45,-6,16,22
4,BUD,P008325,P012630,0 days 00:12:37,-2,30,32
4,BUD,P011150,P012630,0 days 00:12:20,0,28,28
4,BUD,P005637,P008325,0 days 00:11:41,-10,23,33
4,BUD,P012606,P013256,0 days 00:11:40,0,23,23
4,BUD,P005637,P011281,0 days 00:10:24,-19,15,34
4,BUD,P006566,P013256,0 days 00:10:18,1,16,15
4,BUD,P011281,P013256,0 days 00:10:04,-1,21,22
4,BUD,P012630,P013256,0 days 00:08:46,-1,19,20
4,BUD,P011281,P012630,0 days 00:08:43,-12,15,27
4,BUD,P006566,P012606,0 days 00:08:39,0,16,16
4,BUD,P005637,P011150,0 days 00:08:18,-5,17,22
4,BUD,P005637,P012606,0 days 00:07:52,2,17,15
4,BUD,P006561,P012630,0 days 00:07:35,-10,9,19
4,BUD,P006566,P011281,0 days 00:07:03,-6,6,12
4,BUD,P005637,P013258,0 days 00:07:01,-12,9,21
4,BUD,P012630,P013258,0 days 00:06:52,-10,9,19
4,BUD,P005637,P006561,0 days 00:06:32,-7,9,16
4,BUD,P006561,P013258,0 days 00:06:10,-7,9,16
4,BUD,P005637,P006566,0 days 00:05:24,-7,6,13
4,BUD,P011281,P013258,0 days 00:05:17,-13,7,20
4,BUD,P006561,P011281,0 days 00:04:25,-11,2,13
4,BUD,P012606,P013258,0 days 00:03:34,1,9,8
4,BUD,P008325,P010307,0 days 00:03:16,-2,10,12
4,BUD,P010307,P011281,0 days 00:03:16,-2,10,12
4,BUD,P006561,P012606,0 days 00:03:10,1,7,6
4,BUD,P010307,P011150,0 days 00:03:07,0,10,10
4,BUD,P006566,P012630,0 days 00:02:57,0,6,6
4,BUD,P008325,P013258,0 days 00:02:41,-5,7,12
4,BUD,P005637,P010307,0 days 00:02:29,-1,8,9
4,BUD,P013256,P013259,0 days 00:01:54,2,4,2
4,BUD,P012606,P013259,0 days 00:01:54,2,4,2
4,BUD,P012630,P013259,0 days 00:01:54,2,4,2
4,BUD,P011150,P013259,0 days 00:01:54,2,4,2
4,BUD,P011150,P013258,0 days 00:01:50,0,7,7
4,BUD,P013256,P013258,0 days 00:01:50,0,7,7
4,BUD,P006561,P011150,0 days 00:01:25,-3,0,3
4,BUD,P006561,P013256,0 days 00:01:03,-3,0,3
4,BUD,P010307,P013256,0 days 00:00:50,-1,2,3
4,BUD,P010307,P013258,0 days 00:00:09,-2,0,2
4,BUD,P006566,P010307,0 days 00:00:03,0,0,0
4,BUD,P010307,P012606,0 days 00:00:03,0,0,0
4,BUD,P010307,P012630,0 days 00:00:03,0,0,0
5,CAN,P003425,P008121,0 days 00:24:02,4,49,45
5,CAN,P003425,P008966,0 days 00:23:48,6,52,46
5,CAN,P008121,P008966,0 days 00:22:43,7,51,44
5,CAN,P003425,P006588,0 days 00:22:25,8,48,40
5,CAN,P003425,P012095,0 days 00:21:57,7,48,41
5,CAN,P008966,P012095,0 days 00:21:57,7,48,41
5,CAN,P006588,P008121,0 days 00:20:42,9,45,36
5,CAN,P006588,P008966,0 days 00:20:28,11,48,37
5,CAN,P008121,P012095,0 days 00:20:14,8,45,37
5,CAN,P006588,P012095,0 days 00:20:07,9,46,37
5,CAN,P010452,P011251,0 days 00:15:45,-3,34,37
5,CAN,P011251,P012016,0 days 00:15:34,-3,30,33
5,CAN,P010623,P011251,0 days 00:13:48,-2,30,32
5,CAN,P010452,P010623,0 days 00:13:48,-2,30,32
5,CAN,P010452,P012016,0 days 00:13:37,0,30,30
5,CAN,P010623,P012016,0 days 00:13:10,-2,28,30
5,CAN,P008121,P011251,0 days 00:07:49,-1,14,15
5,CAN,P008121,P010452,0 days 00:07:21,-2,14,16
5,CAN,P007560,P012016,0 days 00:05:27,-3,13,16
5,CAN,P007560,P011251,0 days 00:05:27,-3,13,16
5,CAN,P007560,P010452,0 days 00:05:27,-3,13,16
5,CAN,P008121,P012016,0 days 00:05:20,0,8,8
5,CAN,P007560,P010623,0 days 00:05:00,-5,11,16
5,CAN,P005005,P010452,0 days 00:04:47,0,9,9
5,CAN,P005005,P012016,0 days 00:04:47,0,9,9
5,CAN,P005005,P011251,0 days 00:04:47,0,9,9
5,CAN,P005005,P010623,0 days 00:04:47,0,9,9
5,CAN,P003425,P011251,0 days 00:04:15,-2,6,8
5,CAN,P008121,P010623,0 days 00:04:01,3,10,7
5,CAN,P008966,P010452,0 days 00:03:58,-5,6,11
5,CAN,P003425,P010452,0 days 00:03:47,-3,6,9
5,CAN,P008966,P011251,0 days 00:02:29,-1,6,7
5,CAN,P003425,P012016,0 days 00:02:24,-1,2,3
5,CAN,P006588,P011251,0 days 00:02:18,-1,2,3
5,CAN,P003425,P007560,0 days 00:02:10,1,5,4
5,CAN,P006588,P012016,0 days 00:01:57,-3,0,3
5,CAN,P010452,P012095,0 days 00:01:50,-2,2,4
5,CAN,P006588,P007560,0 days 00:01:43,-1,3,4
5,CAN,P007560,P008966,0 days 00:01:43,-1,3,4
5,CAN,P007560,P012095,0 days 00:01:43,-1,3,4
5,CAN,P008966,P010623,0 days 00:00:38,0,2,2
5,TRN,P005438,P013270,0 days 00:22:01,1,49,48
5,TRN,P012593,P013271,0 days 00:21:56,-1,44,45
5,TRN,P005438,P006724,0 days 00:21:34,2,48,46
5,TRN,P012593,P013272,0 days 00:20:09,-1,42,43
5,TRN,P013269,P013272,0 days 00:18:56,-9,30,39
5,TRN,P006724,P013270,0 days 00:18:38,0,42,42
5,TRN,P012593,P013269,0 days 00:16:54,-5,28,33
5,TRN,P013269,P013271,0 days 00:16:33,2,30,28
5,TRN,P013270,P013271,0 days 00:16:29,5,38,33
5,TRN,P013270,P013272,0 days 00:16:12,4,38,34
5,TRN,P013271,P013272,0 days 00:15:59,0,26,26
5,TRN,P012593,P013270,0 days 00:15:43,3,44,41
5,TRN,P005438,P012593,0 days 00:14:48,-1,34,35
5,TRN,P005438,P013272,0 days 00:14:48,1,28,27
5,TRN,P006724,P013272,0 days 00:12:21,-2,28,30
5,TRN,P005438,P013271,0 days 00:12:09,0,22,22
5,TRN,P006724,P012593,0 days 00:11:20,-2,27,29
5,TRN,P013269,P013270,0 days 00:09:14,1,22,21
5,TRN,P006382,P013272,0 days 00:08:58,2,14,12
5,TRN,P005438,P006382,0 days 00:08:53,4,19,15
5,TRN,P006382,P013270,0 days 00:08:46,1,15,14
5,TRN,P012593,P012687,0 days 00:08:14,-5,17,22
5,TRN,P012687,P013271,0 days 00:08:14,-5,17,22
5,TRN,P006382,P006724,0 days 00:07:37,4,19,15
5,TRN,P006724,P013271,0 days 00:07:15,2,15,13
5,TRN,P005438,P013269,0 days 00:07:14,-4,8,12
5,TRN,P006724,P013269,0 days 00:06:03,-7,8,15
5,TRN,P012687,P013272,0 days 00:05:57,-3,10,13
5,TRN,P012687,P013269,0 days 00:05:57,-3,10,13
5,TRN,P005438,P012687,0 days 00:04:25,-3,12,15
5,TRN,P012687,P013270,0 days 00:04:25,-3,12,15
5,TRN,P006382,P013271,0 days 00:03:29,-3,0,3
5,TRN,P006382,P012593,0 days 00:02:20,0,4,4
5,TRN,P006382,P013269,0 days 00:02:13,-3,0,3
5,TRN,P006382,P012687,0 days 00:02:08,-1,5,6
5,TRN,P006724,P012687,0 days 00:02:08,-1,5,6
6,JER,P006625,P010587,0 days 00:24:11,-7,39,46
6,JER,P011970,P013278,0 days 00:20:01,-1,40,41
6,JER,P010587,P013278,0 days 00:19:52,-2,36,38
6,JER,P006625,P011970,0 days 00:19:11,-5,37,42
6,JER,P010587,P011970,0 days 00:17:54,-7,35,42
6,JER,P006625,P013277,0 days 00:17:47,-6,28,34
6,JER,P010587,P013277,0 days 00:17:27,-7,28,35
6,JER,P006625,P013278,0 days 00:17:08,-3,30,33
6,JER,P011970,P013277,0 days 00:15:01,-5,28,33
6,JER,P013277,P013278,0 days 00:14:44,-1,26,27
6,JER,P011970,P013279,0 days 00:13:18,1,31,30
6,JER,P010587,P013279,0 days 00:12:31,-4,21,25
6,JER,P009879,P010587,0 days 00:10:24,-5,9,14
6,JER,P013276,P013279,0 days 00:10:01,-10,11,21
6,JER,P006625,P013276,0 days 00:09:25,-8,10,18
6,JER,P006625,P013279,0 days 00:09:25,1,21,20
6,JER,P010587,P013276,0 days 00:09:23,-15,4,19
6,JER,P009879,P013276,0 days 00:09:19,-9,7,16
6,JER,P006625,P009879,0 days 00:08:49,-4,9,13
6,JER,P013278,P013279,0 days 00:08:41,3,19,16
6,JER,P010431,P011970,0 days 00:08:20,-3,17,20
6,JER,P009879,P013279,0 days 00:08:06,-5,7,12
6,JER,P010431,P013279,0 days 00:08:00,-2,14,16
6,JER,P010431,P013278,0 days 00:07:35,5,17,12
6,JER,P013279,P013281,0 days 00:07:08,-5,11,16
6,JER,P013276,P013281,0 days 00:06:53,-10,6,16
6,JER,P009879,P013277,0 days 00:06:52,-1,10,11
6,JER,P009879,P013278,0 days 00:06:45,1,10,9
6,JER,P011970,P013276,0 days 00:06:34,-9,9,18
6,JER,P009879,P011970,0 days 00:05:44,-3,8,11
6,JER,P009879,P010431,0 days 00:05:10,0,8,8
6,JER,P010587,P013281,0 days 00:05:10,-10,1,11
6,JER,P010431,P010587,0 days 00:04:24,-3,7,10
6,JER,P011970,P013281,0 days 00:04:17,0,11,11
6,JER,P013276,P013277,0 days 00:04:13,-8,2,10
6,JER,P006625,P013281,0 days 00:03:59,-5,5,10
6,JER,P010431,P013281,0 days 00:03:28,2,8,6
6,JER,P009879,P013281,0 days 00:03:23,-6,0,6
6,JER,P010431,P013276,0 days 00:03:00,-7,3,10
6,JER,P013278,P013281,0 days 00:02:10,2,6,4
6,JER,P010431,P013277,0 days 00:02:06,-1,5,6
6,JER,P013277,P013279,0 days 00:01:38,1,5,4
6,JER,P006625,P010431,0 days 00:00:33,1,1,0
6,PAM,P010042,P010393,0 days 00:18:11,14,39,25
6,PAM,P007527,P011982,0 days 00:16:49,-11,28,39
6,PAM,P006643,P010444,0 days 00:14:57,20,36,16
6,PAM,P006643,P010042,0 days 00:13:57,16,32,16
6,PAM,P011980,P011982,0 days 00:13:38,-1,25,26
6,PAM,P004863,P010042,0 days 00:13:19,19,30,11
6,PAM,P005356,P011980,0 days 00:13:16,-9,19,28
6,PAM,P006643,P010393,0 days 00:13:05,16,32,16
6,PAM,P005356,P011982,0 days 00:12:46,-14,19,33
6,PAM,P004863,P006643,0 days 00:12:22,11,26,15
6,PAM,P011982,P012738,0 days 00:12:06,4,25,21
6,PAM,P004863,P010393,0 days 00:11:53,11,24,13
6,PAM,P005356,P007527,0 days 00:11:51,-9,19,28
6,PAM,P007527,P011980,0 days 00:11:42,-4,19,23
6,PAM,P010042,P012738,0 days 00:11:39,10,25,15
6,PAM,P010042,P010444,0 days 00:11:37,16,28,12
6,PAM,P010393,P010444,0 days 00:11:18,14,28,14
6,PAM,P010042,P011982,0 days 00:11:00,14,25,11
6,PAM,P004863,P010444,0 days 00:10:35,9,22,13
6,PAM,P010393,P012738,0 days 00:10:21,-1,19,20
6,PAM,P007527,P010042,0 days 00:09:57,7,23,16
6,PAM,P007527,P010393,0 days 00:09:53,2,23,21
6,PAM,P010393,P011982,0 days 00:08:34,-3,15,18
6,PAM,P007527,P009864,0 days 00:08:26,-5,13,18
6,PAM,P009864,P011980,0 days 00:08:26,-5,13,18
6,PAM,P005356,P009864,0 days 00:08:26,-5,13,18
6,PAM,P009864,P011982,0 days 00:08:26,-5,13,18
6,PAM,P004863,P012738,0 days 00:07:37,9,16,7
6,PAM,P004863,P011982,0 days 00:07:11,11,16,5
6,PAM,P007527,P012738,0 days 00:07:11,-5,13,18
6,PAM,P007527,P010444,0 days 00:06:18,8,16,8
6,PAM,P006643,P007527,0 days 00:05:26,9,14,5
6,PAM,P005356,P010444,0 days 00:05:16,1,10,9
6,PAM,P004863,P011980,0 days 00:04:58,3,10,7
6,PAM,P004863,P005356,0 days 00:04:46,-1,8,9
6,PAM,P010444,P011980,0 days 00:04:10,-1,6,7
6,PAM,P011980,P012738,0 days 00:04:04,5,10,5
6,PAM,P005356,P006643,0 days 00:03:51,4,8,4
6,PAM,P010042,P011980,0 days 00:03:24,8,10,2
6,PAM,P005356,P010393,0 days 00:03:21,-1,8,9
6,PAM,P010444,P011982,0 days 00:03:21,1,6,5
6,PAM,P006643,P011980,0 days 00:03:02,0,4,4
6,PAM,P005356,P012738,0 days 00:02:55,-6,4,10
6,PAM,P006643,P012738,0 days 00:02:51,0,4,4
6,PAM,P006643,P011982,0 days 00:01:41,4,4,0
6,PAM,P004863,P007527,0 days 00:00:07,0,0,0
7,HAM,P003242,P013308,0 days 00:22:08,-9,45,54
7,HAM,P013308,P013312,0 days 00:15:08,-10,28,38
7,HAM,P011256,P013308,0 days 00:13:27,-14,20,34
7,HAM,P003242,P013312,0 days 00:12:42,-6,23,29
7,HAM,P003242,P006006,0 days 00:12:33,-4,26,30
7,HAM,P006006,P013309,0 days 00:12:10,-8,27,35
7,HAM,P003242,P011256,0 days 00:12:07,-12,18,30
7,HAM,P006006,P013311,0 days 00:11:52,2,27,25
7,HAM,P008103,P013311,0 days 00:11:34,-4,27,31
7,HAM,P003242,P013313,0 days 00:10:40,-6,21,27
7,HAM,P013308,P013313,0 days 00:10:40,-6,21,27
7,HAM,P011256,P013312,0 days 00:10:34,-11,16,27
7,HAM,P008103,P013309,0 days 00:10:04,-5,21,26
7,HAM,P006006,P013308,0 days 00:09:37,-4,20,24
7,HAM,P011256,P013313,0 days 00:09:29,-14,10,24
7,HAM,P006420,P013311,0 days 00:09:24,-1,24,25
7,HAM,P012695,P013311,0 days 00:09:17,1,23,22
7,HAM,P006006,P008103,0 days 00:08:46,-3,21,24
7,HAM,P006420,P013308,0 days 00:08:20,0,20,20
7,HAM,P003242,P006420,0 days 00:07:49,-3,17,20
7,HAM,P008103,P012695,0 days 00:07:41,-1,19,20
7,HAM,P006420,P013313,0 days 00:07:38,-2,13,15
7,HAM,P013312,P013313,0 days 00:07:25,-7,13,20
7,HAM,P006006,P012695,0 days 00:07:13,4,17,13
7,HAM,P006420,P008103,0 days 00:07:07,-6,13,19
7,HAM,P003242,P013311,0 days 00:06:58,3,17,14
7,HAM,P013309,P013311,0 days 00:06:52,0,16,16
7,HAM,P010070,P013311,0 days 00:06:01,-5,11,16
7,HAM,P003242,P013309,0 days 00:05:59,0,16,16
7,HAM,P013308,P013309,0 days 00:05:59,0,16,16
7,HAM,P006006,P006420,0 days 00:05:41,-5,12,17
7,HAM,P013308,P013311,0 days 00:05:39,4,17,13
7,HAM,P006006,P013312,0 days 00:05:11,-6,8,14
7,HAM,P013309,P013312,0 days 00:04:51,-5,9,14
7,HAM,P012695,P013308,0 days 00:04:48,0,12,12
7,HAM,P003242,P012695,0 days 00:04:47,1,10,9
7,HAM,P013311,P013313,0 days 00:04:36,0,11,11
7,HAM,P006420,P013309,0 days 00:04:35,-4,7,11
7,HAM,P008103,P013308,0 days 00:04:34,-1,13,14
7,HAM,P006420,P011256,0 days 00:04:28,-8,4,12
7,HAM,P008103,P013313,0 days 00:04:23,-3,5,8
7,HAM,P012695,P013309,0 days 00:04:17,4,11,7
7,HAM,P008103,P011256,0 days 00:03:49,-7,2,9
7,HAM,P012695,P013312,0 days 00:03:38,-2,7,9
7,HAM,P008103,P013312,0 days 00:03:32,-9,5,14
7,HAM,P010070,P012695,0 days 00:03:23,-4,6,10
7,HAM,P011256,P012695,0 days 00:03:11,-1,6,7
7,HAM,P006420,P010070,0 days 00:03:05,-5,5,10
7,HAM,P008103,P010070,0 days 00:03:05,-5,5,10
7,HAM,P003242,P010070,0 days 00:02:56,0,6,6
7,HAM,P006006,P010070,0 days 00:02:56,0,6,6
7,HAM,P006006,P011256,0 days 00:02:49,-4,4,8
7,HAM,P013309,P013313,0 days 00:02:43,3,5,2
7,HAM,P010070,P013313,0 days 00:02:38,-1,5,6
7,HAM,P011256,P013309,0 days 00:02:02,-5,0,5
7,HAM,P013311,P013312,0 days 00:01:55,-4,3,7
7,HAM,P003242,P008103,0 days 00:01:37,0,5,5
7,HAM,P006420,P012695,0 days 00:01:37,-2,5,7
7,BOU,P013265,P013266,0 days 00:23:09,12,58,46
7,BOU,P004525,P013266,0 days 00:21:27,14,53,39
7,BOU,P004525,P013265,0 days 00:21:08,14,53,39
7,BOU,P011837,P013266,0 days 00:17:02,12,42,30
7,BOU,P011837,P013265,0 days 00:16:43,12,42,30
7,BOU,P009552,P013264,0 days 00:16:17,7,42,35
7,BOU,P010449,P013265,0 days 00:16:03,19,47,28
7,BOU,P004525,P011837,0 days 00:15:53,13,39,26
7,BOU,P009556,P013264,0 days 00:14:51,7,38,31
7,BOU,P010449,P013266,0 days 00:13:52,18,41,23
7,BOU,P009552,P009556,0 days 00:13:44,7,36,29
7,BOU,P004945,P013264,0 days 00:13:33,9,35,26
7,BOU,P004525,P010449,0 days 00:13:20,20,41,21
7,BOU,P004945,P009552,0 days 00:12:26,9,33,24
7,BOU,P004945,P009556,0 days 00:11:52,8,31,23
7,BOU,P006904,P013264,0 days 00:11:34,-2,30,32
7,BOU,P006904,P009552,0 days 00:11:26,-5,27,32
7,BOU,P006904,P013266,0 days 00:11:17,-5,21,26
7,BOU,P006904,P013265,0 days 00:10:05,-8,18,26
7,BOU,P010449,P011837,0 days 00:09:54,15,29,14
7,BOU,P010449,P013264,0 days 00:09:40,8,24,16
7,BOU,P004945,P006904,0 days 00:09:36,0,24,24
7,BOU,P006904,P009556,0 days 00:08:24,-3,21,24
7,BOU,P006904,P011837,0 days 00:08:15,-3,15,18
7,BOU,P004525,P006904,0 days 00:08:07,-6,12,18
7,BOU,P009552,P010449,0 days 00:07:44,13,22,9
7,BOU,P013264,P013265,0 days 00:07:41,-3,19,22
7,BOU,P009552,P013265,0 days 00:06:44,-1,16,17
7,BOU,P009556,P010449,0 days 00:06:27,10,17,7
7,BOU,P013264,P013266,0 days 00:06:23,-1,16,17
7,BOU,P009552,P013266,0 days 00:05:26,1,13,12
7,BOU,P004945,P010449,0 days 00:04:16,9,11,2
7,BOU,P009556,P013265,0 days 00:02:59,-1,7,8
7,BOU,P004525,P009552,0 days 00:02:53,1,7,6
7,BOU,P004525,P013264,0 days 00:02:41,0,7,7
7,BOU,P011837,P013264,0 days 00:02:16,-1,5,6
7,BOU,P004945,P013266,0 days 00:02:00,1,4,3
7,BOU,P004945,P011837,0 days 00:01:26,0,2,2
7,BOU,P009556,P011837,0 days 00:01:07,0,2,2
7,BOU,P004525,P004945,0 days 00:00:19,0,0,0
8,CLU,P010651,P013302,0 days 00:30:06,0,66,66
8,CLU,P010651,P013304,0 days 00:25:28,3,56,53
8,CLU,P013302,P013304,0 days 00:24:23,-1,52,53
8,CLU,P002820,P013304,0 days 00:20:36,-5,42,47
8,CLU,P002820,P010651,0 days 00:20:21,-4,42,46
8,CLU,P002820,P013302,0 days 00:19:03,-5,38,43
8,CLU,P010651,P012698,0 days 00:19:02,-10,36,46
8,CLU,P012698,P013302,0 days 00:17:10,-1,34,35
8,CLU,P002820,P012698,0 days 00:16:08,0,33,33
8,CLU,P012698,P013304,0 days 00:12:54,-4,25,29
8,CLU,P005714,P011801,0 days 00:11:32,2,25,23
8,CLU,P006618,P012698,0 days 00:11:29,-1,27,28
8,CLU,P004862,P012698,0 days 00:11:02,-6,25,31
8,CLU,P005714,P012698,0 days 00:10:27,-13,16,29
8,CLU,P004862,P006618,0 days 00:10:02,0,25,25
8,CLU,P002820,P012620,0 days 00:08:53,-2,18,20
8,CLU,P012620,P013304,0 days 00:08:53,-2,18,20
8,CLU,P010651,P012620,0 days 00:08:25,2,18,16
8,CLU,P010651,P011801,0 days 00:08:17,0,20,20
8,CLU,P005714,P010651,0 days 00:08:16,-6,17,23
8,CLU,P005714,P006618,0 days 00:07:52,-4,16,20
8,CLU,P011801,P013302,0 days 00:07:48,3,20,17
8,CLU,P005714,P013302,0 days 00:07:29,7,19,12
8,CLU,P004862,P005714,0 days 00:07:22,-6,17,23
8,CLU,P012620,P013302,0 days 00:07:20,-2,14,16
8,CLU,P011801,P012698,0 days 00:06:15,-5,8,13
8,CLU,P004862,P010651,0 days 00:05:44,-8,14,22
8,CLU,P011801,P013304,0 days 00:05:42,5,17,12
8,CLU,P005714,P013304,0 days 00:05:17,3,14,11
8,CLU,P004862,P013302,0 days 00:05:10,2,16,14
8,CLU,P006618,P010651,0 days 00:04:29,-5,11,16
8,CLU,P002820,P005714,0 days 00:04:13,-3,8,11
8,CLU,P006618,P013302,0 days 00:04:11,5,13,8
8,CLU,P006618,P011801,0 days 00:04:08,0,8,8
8,CLU,P004862,P011801,0 days 00:03:51,-5,9,14
8,CLU,P002820,P006618,0 days 00:03:45,1,8,7
8,CLU,P002820,P004862,0 days 00:02:18,2,6,4
8,CLU,P002820,P011801,0 days 00:02:07,0,5,5
8,CLU,P012620,P012698,0 days 00:01:33,0,4,4
8,CLU,P004862,P013304,0 days 00:00:31,-3,0,3
8,CLU,P005714,P012620,0 days 00:00:28,-4,0,4
8,LJU,P012042,P012700,0 days 00:22:22,2,49,47
8,LJU,P012042,P013260,0 days 00:19:11,4,46,42
8,LJU,P003452,P012042,0 days 00:19:08,-3,39,42
8,LJU,P012996,P013261,0 days 00:18:12,2,44,42
8,LJU,P012700,P013260,0 days 00:18:00,0,37,37
8,LJU,P012042,P012996,0 days 00:17:20,0,38,38
8,LJU,P012700,P012996,0 days 00:17:13,4,43,39
8,LJU,P012042,P013261,0 days 00:15:11,8,42,34
8,LJU,P012700,P013261,0 days 00:14:17,8,40,32
8,LJU,P003452,P012700,0 days 00:14:16,-7,26,33
8,LJU,P003703,P013261,0 days 00:13:37,12,36,24
8,LJU,P003452,P013260,0 days 00:13:17,-4,25,29
8,LJU,P012996,P013260,0 days 00:13:14,-7,24,31
8,LJU,P013260,P013261,0 days 00:12:20,5,34,29
8,LJU,P003452,P012996,0 days 00:10:56,-3,22,25
8,LJU,P003703,P012996,0 days 00:10:45,9,32,23
8,LJU,P003703,P012700,0 days 00:10:33,1,29,28
8,LJU,P013261,P013262,0 days 00:10:33,6,25,19
8,LJU,P003703,P012042,0 days 00:09:43,4,25,21
8,LJU,P009753,P012042,0 days 00:08:30,8,23,15
8,LJU,P009753,P012700,0 days 00:08:29,0,16,16
8,LJU,P003703,P013262,0 days 00:08:21,4,20,16
8,LJU,P009753,P013261,0 days 00:07:32,12,23,11
8,LJU,P003703,P009753,0 days 00:07:19,-1,13,14
8,LJU,P012996,P013262,0 days 00:06:39,2,18,16
8,LJU,P003452,P003703,0 days 00:06:37,-3,14,17
8,LJU,P012700,P013262,0 days 00:06:11,-1,17,18
8,LJU,P003452,P009753,0 days 00:06:07,-1,10,11
8,LJU,P009753,P013260,0 days 00:06:04,12,20,8
8,LJU,P003452,P013261,0 days 00:05:38,0,13,13
8,LJU,P009392,P013261,0 days 00:05:36,3,11,8
8,LJU,P009392,P013262,0 days 00:05:08,3,8,5
8,LJU,P003703,P009392,0 days 00:05:08,3,8,5
8,LJU,P009753,P013262,0 days 00:04:40,0,7,7
8,LJU,P009392,P009753,0 days 00:03:59,2,8,6
8,LJU,P013260,P013262,0 days 00:02:58,-2,5,7
8,LJU,P012042,P013263,0 days 00:02:51,-3,7,10
8,LJU,P012700,P013263,0 days 00:02:51,-3,7,10
8,LJU,P013260,P013263,0 days 00:02:51,-3,7,10
8,LJU,P003452,P013263,0 days 00:02:51,-3,7,10
8,LJU,P009392,P012996,0 days 00:01:37,1,3,2
8,LJU,P003452,P013262,0 days 00:00:46,-4,0,4
8,LJU,P009392,P012042,0 days 00:00:28,0,3,3
8,LJU,P009392,P013260,0 days 00:00:28,0,3,3
8,LJU,P003703,P013260,0 days 00:00:13,3,3,0
9,VNC,P007759,P008858,0 days 00:24:06,18,60,42
9,VNC,P007759,P011909,0 days 00:22:53,22,60,38
9,VNC,P008858,P011909,0 days 00:22:43,21,58,37
9,VNC,P008858,P011928,0 days 00:21:56,17,54,37
9,VNC,P007759,P011928,0 days 00:19:50,18,51,33
9,VNC,P008858,P012796,0 days 00:19:47,3,42,39
9,VNC,P011909,P011928,0 days 00:19:05,14,45,31
9,VNC,P011909,P012796,0 days 00:17:40,-1,39,40
9,VNC,P011928,P012796,0 days 00:17:31,7,40,33
9,VNC,P007759,P012796,0 days 00:17:00,2,37,35
9,VNC,P007759,P013305,0 days 00:13:04,9,31,22
9,VNC,P003759,P007759,0 days 00:12:03,22,35,13
9,VNC,P012796,P013305,0 days 00:11:04,-7,20,27
9,VNC,P003759,P011909,0 days 00:10:52,18,31,13
9,VNC,P008858,P013305,0 days 00:10:46,5,22,17
9,VNC,P003759,P013305,0 days 00:09:21,11,28,17
9,VNC,P011909,P013305,0 days 00:08:57,1,23,22
9,VNC,P005404,P013305,0 days 00:08:54,-4,23,27
9,VNC,P003759,P008858,0 days 00:08:50,17,25,8
9,VNC,P005404,P012796,0 days 00:08:30,0,18,18
9,VNC,P003759,P011928,0 days 00:08:29,10,21,11
9,VNC,P009400,P013305,0 days 00:08:06,-2,20,22
9,VNC,P005404,P011909,0 days 00:07:42,-2,18,20
9,VNC,P005404,P009400,0 days 00:06:56,-4,18,22
9,VNC,P011928,P013305,0 days 00:06:55,3,16,13
9,VNC,P005404,P011928,0 days 00:06:10,-1,10,11
9,VNC,P009400,P012796,0 days 00:05:13,-3,11,14
9,VNC,P003759,P009400,0 days 00:04:37,2,11,9
9,VNC,P006571,P013305,0 days 00:04:33,0,9,9
9,VNC,P005404,P008858,0 days 00:04:31,2,7,5
9,VNC,P003759,P005404,0 days 00:04:30,-1,13,14
9,VNC,P009400,P011909,0 days 00:04:16,-5,6,11
9,VNC,P009400,P011928,0 days 00:04:04,0,7,7
9,VNC,P007759,P009400,0 days 00:03:24,5,6,1
9,VNC,P006571,P012796,0 days 00:03:15,-1,5,6
9,VNC,P005404,P006571,0 days 00:02:44,3,9,6
9,VNC,P006571,P009400,0 days 00:02:44,3,9,6
9,VNC,P005404,P007759,0 days 00:02:03,3,8,5
9,VNC,P006571,P007759,0 days 00:01:49,-3,0,3
9,VNC,P006571,P008858,0 days 00:01:49,-3,0,3
9,VNC,P003759,P006571,0 days 00:01:18,1,4,3
9,ARI,P004292,P008084,0 days 00:17:50,-10,28,38
9,ARI,P008084,P013356,0 days 00:17:12,-9,34,43
9,ARI,P008084,P013250,0 days 00:16:03,-2,39,41
9,ARI,P008084,P013249,0 days 00:15:52,-20,21,41
9,ARI,P013249,P013356,0 days 00:15:17,-10,27,37
9,ARI,P008084,P013248,0 days 00:14:17,-5,30,35
9,ARI,P013250,P013356,0 days 00:13:00,1,32,31
9,ARI,P013249,P013250,0 days 00:12:46,-11,22,33
9,ARI,P004292,P013251,0 days 00:12:11,-8,23,31
9,ARI,P003240,P013249,0 days 00:12:10,-7,15,22
9,ARI,P013248,P013356,0 days 00:11:56,-5,27,32
9,ARI,P003240,P013250,0 days 00:10:44,-8,22,30
9,ARI,P013248,P013250,0 days 00:10:32,2,32,30
9,ARI,P003240,P013251,0 days 00:10:30,-4,21,25
9,ARI,P004292,P013252,0 days 00:10:25,-2,19,21
9,ARI,P013248,P013249,0 days 00:10:10,-11,17,28
9,ARI,P003240,P008084,0 days 00:10:03,-9,13,22
9,ARI,P013251,P013360,0 days 00:09:49,-9,20,29
9,ARI,P003240,P013252,0 days 00:09:49,4,21,17
9,ARI,P004292,P013356,0 days 00:09:35,-3,15,18
9,ARI,P008084,P013251,0 days 00:09:08,-7,16,23
9,ARI,P004292,P013248,0 days 00:08:37,0,16,16
9,ARI,P003240,P004292,0 days 00:08:30,-4,10,14
9,ARI,P004292,P013249,0 days 00:07:56,-9,5,14
9,ARI,P008084,P013252,0 days 00:07:54,1,16,15
9,ARI,P003240,P013360,0 days 00:07:06,-5,17,22
9,ARI,P003240,P013356,0 days 00:06:59,2,16,14
9,ARI,P013249,P013252,0 days 00:06:50,1,10,9
9,ARI,P004292,P013360,0 days 00:06:50,-6,12,18
9,ARI,P013252,P013356,0 days 00:06:35,3,12,9
9,ARI,P013250,P013251,0 days 00:06:22,-3,15,18
9,ARI,P013251,P013252,0 days 00:06:10,-1,17,18
9,ARI,P013252,P013360,0 days 00:05:56,-1,17,18
9,ARI,P013248,P013251,0 days 00:05:53,1,15,14
9,ARI,P004292,P013250,0 days 00:05:39,8,18,10
9,ARI,P003240,P013248,0 days 00:05:25,-4,12,16
9,ARI,P013250,P013252,0 days 00:04:25,3,12,9
9,ARI,P013251,P013355,0 days 00:03:51,-7,3,10
9,ARI,P008084,P013360,0 days 00:03:47,-5,5,10
9,ARI,P003240,P013355,0 days 00:03:28,-5,1,6
9,ARI,P013250,P013355,0 days 00:03:26,-7,3,10
9,ARI,P008084,P013355,0 days 00:03:22,-10,2,12
9,ARI,P013249,P013251,0 days 00:03:04,1,5,4
9,ARI,P013249,P013355,0 days 00:02:59,-5,1,6
9,ARI,P013250,P013360,0 days 00:02:07,-3,5,8
9,ARI,P004292,P013355,0 days 00:02:07,-6,2,8
9,ARI,P013251,P013356,0 days 00:01:42,1,5,4
9,ARI,P013248,P013360,0 days 00:01:26,-2,3,5
9,ARI,P013355,P013360,0 days 00:01:11,-4,0,4
9,ARI,P013249,P013360,0 days 00:01:04,-1,1,2
10,TTK,P009025,P011973,0 days 00:25:17,2,46,44
10,TTK,P009025,P012259,0 days 00:23:46,0,42,42
10,TTK,P011973,P012259,0 days 00:21:39,-4,39,43
10,TTK,P009025,P011935,0 days 00:20:47,2,35,33
10,TTK,P011935,P011973,0 days 00:15:18,-6,25,31
10,TTK,P006598,P009025,0 days 00:15:01,4,25,21
10,TTK,P011935,P012259,0 days 00:14:44,-6,23,29
10,TTK,P006598,P011973,0 days 00:13:55,-4,20,24
10,TTK,P004056,P009025,0 days 00:13:37,4,28,24
10,TTK,P004056,P011973,0 days 00:13:37,4,28,24
10,TTK,P011935,P013300,0 days 00:12:55,6,23,17
10,TTK,P004218,P009025,0 days 00:12:54,-3,19,22
10,TTK,P006598,P011935,0 days 00:12:52,-5,18,23
10,TTK,P006598,P013300,0 days 00:12:42,10,28,18
10,TTK,P004218,P012259,0 days 00:11:59,-3,19,22
10,TTK,P004056,P012259,0 days 00:11:55,3,25,22
10,TTK,P004218,P011973,0 days 00:11:13,-1,20,21
10,TTK,P004218,P006598,0 days 00:10:51,3,21,18
10,TTK,P009025,P013300,0 days 00:10:16,8,17,9
10,TTK,P012415,P013300,0 days 00:10:06,8,23,15
10,TTK,P006598,P012415,0 days 00:10:06,8,23,15
10,TTK,P006598,P012259,0 days 00:09:17,-3,14,17
10,TTK,P004056,P011935,0 days 00:09:04,3,20,17
10,TTK,P004218,P013300,0 days 00:07:14,1,12,11
10,TTK,P011935,P012415,0 days 00:06:58,4,15,11
10,TTK,P004218,P011935,0 days 00:05:49,-5,6,11
10,TTK,P011973,P013300,0 days 00:04:53,5,10,5
10,TTK,P007917,P011973,0 days 00:04:19,-1,5,6
10,TTK,P004218,P012415,0 days 00:04:12,2,10,8
10,TTK,P004619,P006598,0 days 00:03:56,5,9,4
10,TTK,P004619,P012415,0 days 00:03:56,5,9,4
10,TTK,P004619,P013300,0 days 00:03:56,5,9,4
10,TTK,P009025,P012415,0 days 00:03:22,4,7,3
10,TTK,P012259,P013300,0 days 00:03:22,0,3,3
10,TTK,P007917,P012259,0 days 00:03:22,-3,3,6
10,TTK,P007917,P009025,0 days 00:03:04,3,5,2
10,TTK,P006598,P007917,0 days 00:02:35,-2,4,6
10,TTK,P004056,P004218,0 days 00:02:25,-1,4,5
10,TTK,P004619,P011935,0 days 00:02:21,2,6,4
10,TTK,P004056,P007917,0 days 00:01:49,0,2,2
10,TTK,P007917,P011935,0 days 00:01:44,-3,1,4
10,TTK,P004218,P004619,0 days 00:01:35,3,3,0
10,TTK,P011973,P012415,0 days 00:01:21,1,3,2
10,TTK,P007917,P013300,0 days 00:01:20,2,4,2
10,TTK,P004056,P013300,0 days 00:01:16,3,3,0
10,TTK,P004056,P006598,0 days 00:00:45,0,2,2
10,TTK,P007917,P012415,0 days 00:00:23,0,2,2
10,TTK,P004218,P007917,0 days 00:00:12,0,2,2
10,LKB,P005521,P006586,0 days 00:21:57,6,42,36
10,LKB,P005521,P013247,0 days 00:21:06,0,38,38
10,LKB,P006586,P013247,0 days 00:20:57,10,44,34
10,LKB,P005656,P006586,0 days 00:20:38,8,42,34
10,LKB,P005521,P005656,0 days 00:18:55,5,38,33
10,LKB,P005656,P013247,0 days 00:18:34,1,34,33
10,LKB,P006586,P010461,0 days 00:17:04,3,33,30
10,LKB,P009299,PLXI,0 days 00:16:01,-10,24,34
10,LKB,P006586,PLXI,0 days 00:15:11,4,23,19
10,LKB,P009898,PLXI,0 days 00:14:53,-14,16,30
10,LKB,P005521,P010461,0 days 00:13:29,-1,22,23
10,LKB,P009299,P009898,0 days 00:13:10,-12,14,26
10,LKB,P006586,P009299,0 days 00:12:47,7,25,18
10,LKB,P010461,P013247,0 days 00:12:40,3,24,21
10,LKB,P006860,P009299,0 days 00:11:56,-15,9,24
10,LKB,P006860,PLXI,0 days 00:10:51,-15,9,24
10,LKB,P006586,P009898,0 days 00:10:34,0,14,14
10,LKB,P005521,PLXI,0 days 00:10:04,-8,11,19
10,LKB,P006860,P009898,0 days 00:09:55,-11,7,18
10,LKB,P013247,PLXI,0 days 00:09:44,0,15,15
10,LKB,P005656,P009299,0 days 00:09:40,-1,17,18
10,LKB,P005656,P010461,0 days 00:09:30,0,18,18
10,LKB,P005656,PLXI,0 days 00:09:02,-5,11,16
10,LKB,P010461,PLXI,0 days 00:08:54,0,15,15
10,LKB,P005656,P009898,0 days 00:07:45,-2,12,14
10,LKB,P005656,P006860,0 days 00:07:24,-2,12,14
10,LKB,P009299,P013247,0 days 00:07:09,5,19,14
10,LKB,P006586,P006860,0 days 00:06:56,2,9,7
10,LKB,P009898,P010461,0 days 00:05:44,-3,9,12
10,LKB,P005521,P009299,0 days 00:05:38,-3,13,16
10,LKB,P005521,P009898,0 days 00:05:10,-4,8,12
10,LKB,P005521,P006860,0 days 00:04:57,-3,12,15
10,LKB,P009299,P010461,0 days 00:04:55,1,11,10
10,LKB,P006860,P013247,0 days 00:04:33,-1,10,11
10,LKB,P006860,P010461,0 days 00:01:20,-3,0,3
10,LKB,P009898,P013247,0 days 00:00:57,-2,0,2
11,TRN,P012593,P013272,0 days 00:20:40,6,44,38
11,TRN,P013270,P013272,0 days 00:20:37,4,44,40
11,TRN,P012593,P013269,0 days 00:19:31,1,40,39
11,TRN,P013269,P013272,0 days 00:18:52,9,42,33
11,TRN,P006724,P013270,0 days 00:17:54,15,42,27
11,TRN,P012593,P013271,0 days 00:16:38,-6,36,42
11,TRN,P006724,P013272,0 days 00:15:53,17,38,21
11,TRN,P012593,P013270,0 days 00:15:14,0,32,32
11,TRN,P005438,P013270,0 days 00:15:13,12,38,26
11,TRN,P013271,P013272,0 days 00:13:13,-5,27,32
11,TRN,P012593,P012687,0 days 00:12:48,-3,25,28
11,TRN,P012687,P013272,0 days 00:12:28,9,29,20
11,TRN,P013269,P013271,0 days 00:11:44,-6,23,29
11,TRN,P012687,P013271,0 days 00:11:43,-4,23,27
11,TRN,P005438,P006382,0 days 00:11:21,0,21,21
11,TRN,P013269,P013270,0 days 00:10:59,0,21,21
11,TRN,P013270,P013271,0 days 00:10:58,-6,21,27
11,TRN,P006382,P013270,0 days 00:10:21,3,21,18
11,TRN,P005438,P006724,0 days 00:10:07,6,25,19
11,TRN,P012687,P013269,0 days 00:10:06,5,23,18
11,TRN,P006724,P012593,0 days 00:09:44,3,17,14
11,TRN,P002387,P005438,0 days 00:09:23,2,19,17
11,TRN,P006724,P013269,0 days 00:08:34,9,19,10
11,TRN,P002387,P013270,0 days 00:08:15,5,19,14
11,TRN,P006382,P006724,0 days 00:08:13,2,17,15
11,TRN,P005438,P013272,0 days 00:07:39,4,19,15
11,TRN,P002387,P013271,0 days 00:07:09,-3,13,16
11,TRN,P006382,P013272,0 days 00:07:02,4,17,13
11,TRN,P005438,P013271,0 days 00:06:55,0,13,13
11,TRN,P012687,P013270,0 days 00:05:57,3,14,11
11,TRN,P002387,P012593,0 days 00:05:42,-9,9,18
11,TRN,P006724,P012687,0 days 00:04:22,7,12,5
11,TRN,P002387,P006382,0 days 00:04:19,-4,4,8
11,TRN,P005438,P012593,0 days 00:04:11,-1,9,10
11,TRN,P002387,P006724,0 days 00:03:45,-3,6,9
11,TRN,P002387,P012687,0 days 00:03:37,-6,6,12
11,TRN,P005438,P012687,0 days 00:03:19,1,8,7
11,TRN,P006382,P013271,0 days 00:03:08,-2,4,6
11,TRN,P002387,P013269,0 days 00:01:26,-6,0,6
11,TRN,P006382,P012593,0 days 00:01:00,-3,0,3
11,TSO,P009649,P012019,0 days 00:26:43,-2,54,56
11,TSO,P012019,P013297,0 days 00:22:06,-1,45,46
11,TSO,P012019,P013298,0 days 00:21:48,12,49,37
11,TSO,P012019,P013295,0 days 00:20:01,-5,36,41
11,TSO,P009649,P013297,0 days 00:19:32,-5,38,43
11,TSO,P009649,P013295,0 days 00:18:30,-8,33,41
11,TSO,P009649,P013298,0 days 00:16:43,13,40,27
11,TSO,P012019,P013293,0 days 00:16:35,-11,27,38
11,TSO,P008790,P012019,0 days 00:16:12,-3,32,35
11,TSO,P013297,P013298,0 days 00:16:09,16,41,25
11,TSO,P013295,P013298,0 days 00:15:53,6,30,24
11,TSO,P013293,P013295,0 days 00:14:52,-3,28,31
11,TSO,P009649,P013293,0 days 00:14:31,-17,21,38
11,TSO,P013293,P013297,0 days 00:14:17,-4,25,29
11,TSO,P008790,P009649,0 days 00:13:41,-4,27,31
11,TSO,P008790,P013298,0 days 00:12:29,3,27,24
11,TSO,P008790,P013293,0 days 00:11:30,-13,18,31
11,TSO,P009649,P013296,0 days 00:10:47,-1,22,23
11,TSO,P013295,P013297,0 days 00:10:23,2,20,18
11,TSO,P013293,P013298,0 days 00:10:16,3,21,18
11,TSO,P008790,P013297,0 days 00:09:46,-6,18,24
11,TSO,P008790,P013295,0 days 00:09:04,-1,18,19
11,TSO,P012019,P013296,0 days 00:08:19,3,19,16
11,TSO,P013296,P013298,0 days 00:06:25,7,18,11
11,TSO,P013293,P013296,0 days 00:05:53,-8,7,15
11,TSO,P013296,P013297,0 days 00:05:36,5,15,10
11,TSO,P013292,P013297,0 days 00:05:11,-3,10,13
11,TSO,P013295,P013296,0 days 00:05:11,-6,7,13
11,TSO,P013292,P013293,0 days 00:05:10,-3,9,12
11,TSO,P013292,P013295,0 days 00:04:38,-5,8,13
11,TSO,P009649,P013292,0 days 00:04:33,-12,5,17
11,TSO,P008790,P013292,0 days 00:02:38,-4,4,8
11,TSO,P013292,P013298,0 days 00:02:09,4,6,2
11,TSO,P012019,P013292,0 days 00:01:32,-5,2,7
11,TSO,P013292,P013296,0 days 00:00:57,-4,0,4
12,BUD,P008325,P013256,0 days 00:34:31,23,77,54
12,BUD,P011150,P011281,0 days 00:33:43,14,70,56
12,BUD,P011150,P013256,0 days 00:33:36,18,71,53
12,BUD,P011281,P013256,0 days 00:32:58,22,74,52
12,BUD,P008325,P011281,0 days 00:32:58,22,74,52
12,BUD,P008325,P011150,0 days 00:32:24,21,70,49
12,BUD,P006566,P013256,0 days 00:18:35,12,45,33
12,BUD,P006566,P011150,0 days 00:17:28,11,42,31
12,BUD,P006566,P008325,0 days 00:17:23,15,44,29
12,BUD,P006566,P011281,0 days 00:15:50,14,41,27
12,BUD,P011281,P012630,0 days 00:11:25,6,26,20
12,BUD,P011150,P012630,0 days 00:10:26,0,18,18
12,BUD,P011281,P013258,0 days 00:10:20,-4,19,23
12,BUD,P008325,P012630,0 days 00:10:11,6,22,16
12,BUD,P012630,P013256,0 days 00:10:11,6,22,16
12,BUD,P013256,P013258,0 days 00:09:06,4,18,14
12,BUD,P008325,P013258,0 days 00:09:06,4,18,14
12,BUD,P005637,P013259,0 days 00:08:59,-23,8,31
12,BUD,P011150,P013258,0 days 00:08:26,-5,11,16
12,BUD,P012606,P013259,0 days 00:08:06,-19,5,24
12,BUD,P005637,P013258,0 days 00:07:11,-13,8,21
12,BUD,P013258,P013259,0 days 00:07:11,-13,8,21
12,BUD,P012630,P013259,0 days 00:06:58,-12,8,20
12,BUD,P005637,P012630,0 days 00:06:40,-12,8,20
12,BUD,P005637,P012606,0 days 00:06:36,-16,4,20
12,BUD,P012606,P012630,0 days 00:06:02,-12,4,16
12,BUD,P012606,P013258,0 days 00:05:55,-5,7,12
12,BUD,P012630,P013258,0 days 00:05:52,-1,12,13
12,BUD,P006566,P012606,0 days 00:04:26,-11,4,15
12,BUD,P011150,P013259,0 days 00:03:54,-15,1,16
12,BUD,P006566,P013259,0 days 00:02:55,-12,1,13
12,BUD,P011150,P012606,0 days 00:02:51,-8,1,9
12,BUD,P012606,P013256,0 days 00:02:43,-2,4,6
12,BUD,P011281,P013259,0 days 00:02:41,-7,4,11
12,BUD,P005637,P011150,0 days 00:02:24,-12,0,12
12,BUD,P005637,P011281,0 days 00:02:23,-7,4,11
12,BUD,P006566,P013258,0 days 00:02:01,-3,3,6
12,BUD,P005637,P006566,0 days 00:01:43,-9,0,9
12,BUD,P008325,P012606,0 days 00:01:31,1,3,2
12,BUD,P013256,P013259,0 days 00:01:12,-3,1,4
12,BUD,P006566,P012630,0 days 00:00:51,-5,0,5
12,BUD,P011281,P012606,0 days 00:00:18,0,0,0
12,CAN,P008121,P011251,0 days 00:26:55,-9,55,64
12,CAN,P008121,P010623,0 days 00:21:43,-3,42,45
12,CAN,P010623,P011251,0 days 00:19:25,1,40,39
12,CAN,P008121,P010452,0 days 00:18:12,-3,32,35
12,CAN,P008121,P012016,0 days 00:18:04,-4,40,44
12,CAN,P003425,P006588,0 days 00:18:02,2,38,36
12,CAN,P008121,P008966,0 days 00:17:49,-6,27,33
12,CAN,P010452,P010623,0 days 00:17:38,2,34,32
12,CAN,P006588,P008121,0 days 00:17:29,-7,35,42
12,CAN,P003425,P008966,0 days 00:15:33,2,31,29
12,CAN,P003425,P008121,0 days 00:15:27,-10,25,35
12,CAN,P003425,P012095,0 days 00:14:46,14,30,16
12,CAN,P010452,P011251,0 days 00:14:36,4,30,26
12,CAN,P011251,P012016,0 days 00:13:43,-6,31,37
12,CAN,P008966,P011251,0 days 00:13:12,-3,24,27
12,CAN,P010623,P012016,0 days 00:12:51,-5,28,33
12,CAN,P008966,P010452,0 days 00:12:41,5,21,16
12,CAN,P006588,P011251,0 days 00:12:07,-13,25,38
12,CAN,P006588,P008966,0 days 00:12:03,1,26,25
12,CAN,P008966,P012095,0 days 00:12:02,9,23,14
12,CAN,P006588,P012016,0 days 00:10:36,-2,22,24
12,CAN,P006588,P012095,0 days 00:10:15,12,23,11
12,CAN,P008966,P010623,0 days 00:09:53,4,16,12
12,CAN,P010452,P012016,0 days 00:09:10,-1,20,21
12,CAN,P005005,P012095,0 days 00:09:07,13,22,9
12,CAN,P003425,P005005,0 days 00:08:06,11,20,9
12,CAN,P003425,P012016,0 days 00:08:00,-1,14,15
12,CAN,P008121,P012095,0 days 00:07:53,2,12,10
12,CAN,P003425,P011251,0 days 00:07:42,-10,15,25
12,CAN,P005005,P008966,0 days 00:07:25,12,20,8
12,CAN,P010452,P012095,0 days 00:06:27,3,11,8
12,CAN,P005005,P006588,0 days 00:05:10,6,13,7
12,CAN,P003425,P010452,0 days 00:05:01,-1,7,8
12,CAN,P012016,P012095,0 days 00:04:58,6,11,5
12,CAN,P006588,P010623,0 days 00:04:54,-3,10,13
12,CAN,P005005,P010452,0 days 00:03:39,7,9,2
12,CAN,P010623,P012095,0 days 00:02:14,1,4,3
12,CAN,P005005,P012016,0 days 00:01:42,1,2,1
12,CAN,P003425,P010623,0 days 00:01:17,-3,0,3
12,CAN,P005005,P010623,0 days 00:01:01,2,2,0
12,CAN,P003425,P007560,0 days 00:00:18,0,0,0
12,CAN,P005005,P007560,0 days 00:00:18,0,0,0
12,CAN,P007560,P008966,0 days 00:00:18,0,0,0
12,CAN,P007560,P012095,0 days 00:00:18,0,0,0
13,BAH,P009601,P011192,0 days 00:20:26,11,47,36
13,BAH,P003840,P011192,0 days 00:18:14,13,41,28
13,BAH,P009601,P011821,0 days 00:17:21,8,40,32
13,BAH,P003840,P011823,0 days 00:16:07,15,36,21
13,BAH,P011192,P011821,0 days 00:15:44,6,35,29
13,BAH,P004172,P012711,0 days 00:15:22,4,31,27
13,BAH,P003840,P011821,0 days 00:15:02,7,33,26
13,BAH,P004172,P011821,0 days 00:14:55,11,36,25
13,BAH,P011192,P011823,0 days 00:14:41,22,41,19
13,BAH,P011821,P012711,0 days 00:14:00,6,29,23
13,BAH,P003840,P009601,0 days 00:13:41,6,29,23
13,BAH,P009601,P011201,0 days 00:13:24,6,27,21
13,BAH,P003840,P012711,0 days 00:13:23,15,32,17
13,BAH,P011201,P011823,0 days 00:12:59,5,26,21
13,BAH,P011192,P011201,0 days 00:12:48,11,30,19
13,BAH,P009601,P011823,0 days 00:12:03,19,32,13
13,BAH,P011201,P012711,0 days 00:11:51,3,23,20
13,BAH,P011821,P011823,0 days 00:11:22,12,28,16
13,BAH,P003840,P011201,0 days 00:11:13,10,24,14
13,BAH,P004172,P009601,0 days 00:11:05,11,31,20
13,BAH,P011821,P012405,0 days 00:10:31,-6,17,23
13,BAH,P004172,P011201,0 days 00:10:18,-3,16,19
13,BAH,P011192,P012711,0 days 00:10:09,8,26,18
13,BAH,P011823,P012711,0 days 00:09:19,1,18,17
13,BAH,P003840,P012405,0 days 00:09:19,-2,17,19
13,BAH,P004172,P011823,0 days 00:08:57,6,19,13
13,BAH,P003840,P004172,0 days 00:08:01,4,16,12
13,BAH,P011192,P012405,0 days 00:07:42,-3,12,15
13,BAH,P011201,P011821,0 days 00:07:33,-4,10,14
13,BAH,P009601,P012711,0 days 00:06:54,5,18,13
13,BAH,P009601,P012405,0 days 00:06:22,-10,8,18
13,BAH,P004172,P011192,0 days 00:06:12,8,20,12
13,BAH,P012405,P012711,0 days 00:05:22,6,11,5
13,BAH,P004172,P012405,0 days 00:04:02,-1,7,8
13,BAH,P011201,P012405,0 days 00:03:38,0,4,4
13,BES,P008945,P013255,0 days 00:17:45,-16,32,48
13,BES,P011927,P013255,0 days 00:16:07,-4,25,29
13,BES,P003783,P010652,0 days 00:15:30,-4,29,33
13,BES,P003783,P007914,0 days 00:14:58,1,30,29
13,BES,P009680,P010652,0 days 00:14:24,-11,22,33
13,BES,P011924,P013255,0 days 00:14:06,-10,23,33
13,BES,P007914,P010652,0 days 00:14:01,-1,28,29
13,BES,P010652,P011936,0 days 00:13:33,-5,19,24
13,BES,P011379,P013255,0 days 00:13:13,-5,23,28
13,BES,P011379,P011927,0 days 00:12:43,-3,23,26
13,BES,P009680,P011936,0 days 00:12:16,-15,19,34
13,BES,P007914,P009680,0 days 00:12:08,-8,22,30
13,BES,P011936,P013255,0 days 00:11:31,-14,13,27
13,BES,P008945,P009680,0 days 00:11:14,-10,19,29
13,BES,P003783,P009680,0 days 00:11:13,-8,18,26
13,BES,P003783,P008945,0 days 00:11:01,-4,17,21
13,BES,P007914,P011936,0 days 00:10:59,-5,22,27
13,BES,P003783,P013255,0 days 00:10:39,-7,13,20
13,BES,P011924,P011927,0 days 00:10:33,-4,18,22
13,BES,P010652,P013255,0 days 00:10:02,-11,10,21
13,BES,P009680,P013255,0 days 00:09:52,-16,13,29
13,BES,P008945,P011927,0 days 00:09:13,-3,18,21
13,BES,P011924,P011936,0 days 00:09:02,-5,10,15
13,BES,P008945,P010652,0 days 00:08:56,-5,16,21
13,BES,P008945,P011379,0 days 00:08:47,-4,16,20
13,BES,P003783,P011927,0 days 00:08:41,4,15,11
13,BES,P007914,P008945,0 days 00:08:38,-6,16,22
13,BES,P008945,P011924,0 days 00:08:12,-6,18,24
13,BES,P003783,P011936,0 days 00:07:52,-4,15,19
13,BES,P011927,P011936,0 days 00:07:26,1,11,10
13,BES,P011379,P011924,0 days 00:07:15,-3,16,19
13,BES,P010652,P011924,0 days 00:06:59,-6,6,12
13,BES,P007914,P013255,0 days 00:06:57,-5,12,17
13,BES,P010652,P011927,0 days 00:06:31,3,10,7
13,BES,P003783,P011379,0 days 00:05:58,-2,7,9
13,BES,P007914,P011927,0 days 00:05:42,6,12,6
13,BES,P009680,P011924,0 days 00:05:11,-6,7,13
13,BES,P008945,P011936,0 days 00:04:18,-6,8,14
13,BES,P007914,P011379,0 days 00:02:35,2,4,2
13,BES,P011379,P011936,0 days 00:01:51,-3,3,6
13,BES,P007914,P011924,0 days 00:01:38,0,2,2
13,BES,P009680,P011379,0 days 00:00:30,-2,0,2
14,HTA,P011157,P013284,0 days 00:27:26,12,65,53
14,HTA,P010550,P013284,0 days 00:27:13,8,61,53
14,HTA,P001927,P011157,0 days 00:26:30,6,57,51
14,HTA,P010550,P011157,0 days 00:26:26,9,60,51
14,HTA,P001927,P013284,0 days 00:24:55,8,57,49
14,HTA,P001927,P010550,0 days 00:24:36,6,55,49
14,HTA,P004846,P011157,0 days 00:22:32,3,51,48
14,HTA,P004846,P013284,0 days 00:19:31,8,48,40
14,HTA,P001927,P004846,0 days 00:18:35,2,40,38
14,HTA,P004846,P010550,0 days 00:18:31,5,43,38
14,HTA,P005181,P011157,0 days 00:14:07,8,33,25
14,HTA,P005181,P012096,0 days 00:13:08,-7,26,33
14,HTA,P005181,P010550,0 days 00:12:10,6,27,21
14,HTA,P005181,P013284,0 days 00:11:46,11,30,19
14,HTA,P001927,P005181,0 days 00:10:10,7,22,15
14,HTA,P012096,P013283,0 days 00:10:05,-5,22,27
14,HTA,P005181,P013283,0 days 00:10:05,-5,22,27
14,HTA,P005181,P010386,0 days 00:09:19,-4,19,23
14,HTA,P010386,P012096,0 days 00:09:19,-4,19,23
14,HTA,P010386,P013283,0 days 00:08:39,-2,19,21
14,HTA,P009818,P010386,0 days 00:07:15,0,17,17
14,HTA,P009818,P012096,0 days 00:07:15,0,17,17
14,HTA,P009818,P013283,0 days 00:07:15,0,17,17
14,HTA,P005181,P009818,0 days 00:07:15,0,17,17
14,HTA,P004846,P005181,0 days 00:06:12,4,16,12
14,HTA,P011157,P012096,0 days 00:03:49,-3,7,10
14,HTA,P004846,P012096,0 days 00:03:49,-3,7,10
14,HTA,P010386,P010550,0 days 00:02:04,-4,2,6
14,HTA,P010550,P012096,0 days 00:02:04,-4,2,6
14,HTA,P001927,P012096,0 days 00:01:42,-1,1,2
14,HTA,P004846,P013283,0 days 00:01:26,-3,3,6
14,HTA,P011157,P013283,0 days 00:01:26,-3,3,6
14,HTA,P010550,P013283,0 days 00:01:24,-2,2,4
14,HTA,P012096,P013284,0 days 00:01:21,-1,3,4
14,HTA,P010386,P013284,0 days 00:00:40,-2,0,2
14,WOL,P012003,P012789,0 days 00:26:24,-6,54,60
14,WOL,P011248,P012003,0 days 00:24:35,-4,48,52
14,WOL,P004645,P012003,0 days 00:22:21,-4,43,47
14,WOL,P004645,P012789,0 days 00:21:14,-5,41,46
14,WOL,P011248,P012789,0 days 00:20:20,-8,40,48
14,WOL,P012003,P012577,0 days 00:19:04,9,43,34
14,WOL,P004645,P011248,0 days 00:17:53,1,39,38
14,WOL,P006853,P012577,0 days 00:16:15,5,39,34
14,WOL,P011248,P012577,0 days 00:14:51,3,32,29
14,WOL,P012577,P012789,0 days 00:14:28,6,35,29
14,WOL,P006853,P012003,0 days 00:13:19,0,25,25
14,WOL,P006853,P008186,0 days 00:11:45,1,28,27
14,WOL,P005516,P008186,0 days 00:11:45,1,28,27
14,WOL,P005516,P006853,0 days 00:11:40,0,28,28
14,WOL,P008186,P012577,0 days 00:10:52,0,24,24
14,WOL,P009306,P012789,0 days 00:10:35,-12,19,31
14,WOL,P009306,P011248,0 days 00:10:35,-12,19,31
14,WOL,P009306,P012003,0 days 00:10:25,-10,19,29
14,WOL,P004645,P012577,0 days 00:09:53,8,24,16
14,WOL,P006853,P012789,0 days 00:09:43,-1,19,20
14,WOL,P005516,P012577,0 days 00:09:23,0,24,24
14,WOL,P004645,P009306,0 days 00:08:58,-7,17,24
14,WOL,P004645,P006853,0 days 00:07:26,-2,12,14
14,WOL,P006853,P011248,0 days 00:07:13,3,16,13
14,WOL,P005516,P012003,0 days 00:06:41,-2,12,14
14,WOL,P008186,P012003,0 days 00:06:39,1,12,11
14,WOL,P008186,P011248,0 days 00:05:57,5,15,10
14,WOL,P003212,P006853,0 days 00:05:47,-2,13,15
14,WOL,P003212,P005516,0 days 00:05:47,-2,13,15
14,WOL,P003212,P008186,0 days 00:05:33,-2,13,15
14,WOL,P003212,P012577,0 days 00:05:33,-2,13,15
14,WOL,P005516,P011248,0 days 00:04:20,0,11,11
14,WOL,P004645,P005516,0 days 00:04:06,-2,6,8
14,WOL,P005516,P012789,0 days 00:03:24,-5,6,11
14,WOL,P004645,P008186,0 days 00:02:11,3,6,3
14,WOL,P009306,P012577,0 days 00:01:37,-5,2,7
14,WOL,P008186,P012789,0 days 00:00:50,-1,2,3
14,WOL,P003212,P004645,0 days 00:00:14,0,0,0
14,WOL,P003212,P012789,0 days 00:00:14,0,0,0
14,WOL,P005516,P009306,0 days 00:00:10,-2,0,2
15,ULM,P011437,P013290,0 days 00:23:53,2,53,51
15,ULM,P006245,P013290,0 days 00:23:35,0,55,55
15,ULM,P006997,P013291,0 days 00:21:42,0,46,46
15,ULM,P013290,P013291,0 days 00:20:39,-1,45,46
15,ULM,P006997,P013290,0 days 00:20:00,-2,44,46
15,ULM,P011437,P013291,0 days 00:19:52,-1,42,43
15,ULM,P006997,P011437,0 days 00:18:49,0,41,41
15,ULM,P006245,P011437,0 days 00:18:36,0,44,44
15,ULM,P006245,P006997,0 days 00:15:22,-3,36,39
15,ULM,P006245,P013291,0 days 00:15:22,-3,36,39
15,ULM,P011391,P012077,0 days 00:11:44,2,26,24
15,ULM,P010726,P011391,0 days 00:11:11,3,25,22
15,ULM,P012077,P012602,0 days 00:11:08,2,23,21
15,ULM,P007952,P011391,0 days 00:10:46,3,27,24
15,ULM,P010726,P012077,0 days 00:10:44,4,23,19
15,ULM,P010726,P012602,0 days 00:10:44,4,23,19
15,ULM,P011391,P012602,0 days 00:09:26,0,21,21
15,ULM,P011391,P013290,0 days 00:08:52,4,20,16
15,ULM,P006245,P011391,0 days 00:08:13,3,19,16
15,ULM,P012077,P013291,0 days 00:07:54,0,11,11
15,ULM,P007952,P010726,0 days 00:07:40,2,19,17
15,ULM,P012077,P013290,0 days 00:06:46,3,13,10
15,ULM,P006997,P012077,0 days 00:06:10,3,10,7
15,ULM,P007952,P012077,0 days 00:06:01,3,17,14
15,ULM,P011391,P013289,0 days 00:05:48,4,13,9
15,ULM,P007952,P012602,0 days 00:05:31,1,15,14
15,ULM,P011437,P012077,0 days 00:05:31,0,9,9
15,ULM,P011391,P011437,0 days 00:05:28,0,12,12
15,ULM,P006245,P007952,0 days 00:05:15,2,12,10
15,ULM,P007952,P013290,0 days 00:05:15,2,12,10
15,ULM,P012077,P013289,0 days 00:03:59,2,8,6
15,ULM,P010726,P013291,0 days 00:03:44,-2,5,7
15,ULM,P010726,P013290,0 days 00:03:30,-1,7,8
15,ULM,P006245,P010726,0 days 00:03:20,-1,7,8
15,ULM,P006997,P010726,0 days 00:03:03,0,5,5
15,ULM,P006245,P013289,0 days 00:02:58,1,7,6
15,ULM,P013289,P013290,0 days 00:02:58,1,7,6
15,ULM,P010726,P013289,0 days 00:02:50,3,6,3
15,ULM,P012602,P013289,0 days 00:02:50,3,6,3
15,ULM,P012602,P013291,0 days 00:02:47,-2,2,4
15,ULM,P007952,P011437,0 days 00:02:36,-1,6,7
15,ULM,P011437,P013289,0 days 00:01:49,2,5,3
15,ULM,P011391,P013291,0 days 00:01:44,-3,1,4
15,ULM,P006997,P012602,0 days 00:01:42,2,2,0
15,ULM,P006245,P012077,0 days 00:01:39,1,4,3
15,ULM,P011437,P012602,0 days 00:00:24,-2,0,2
15,ULM,P010726,P011437,0 days 00:00:10,0,0,0
15,JOV,P002507,P013287,0 days 00:20:22,4,47,43
15,JOV,P013285,P013287,0 days 00:20:09,6,43,37
15,JOV,P012740,P013287,0 days 00:18:06,5,45,40
15,JOV,P010161,P013287,0 days 00:16:39,2,27,25
15,JOV,P002507,P013285,0 days 00:15:32,0,32,32
15,JOV,P013285,PJUG,0 days 00:14:43,7,38,31
15,JOV,P012740,P013285,0 days 00:14:02,1,30,29
15,JOV,P004834,P012349,0 days 00:13:37,-8,25,33
15,JOV,P004834,P012740,0 days 00:13:04,-8,24,32
15,JOV,P010161,P013285,0 days 00:12:44,1,21,20
15,JOV,P002507,P012740,0 days 00:12:40,2,34,32
15,JOV,P002507,PJUG,0 days 00:12:02,2,35,33
15,JOV,P002507,P010161,0 days 00:11:44,-1,16,17
15,JOV,P013287,PJUG,0 days 00:11:41,5,35,30
15,JOV,P004834,P013285,0 days 00:11:12,5,23,18
15,JOV,P010161,P012740,0 days 00:10:36,-1,19,20
15,JOV,P002361,P013287,0 days 00:10:32,3,24,21
15,JOV,P002361,P002507,0 days 00:10:18,3,24,21
15,JOV,P006771,P012349,0 days 00:09:53,-15,13,28
15,JOV,P004834,P006771,0 days 00:09:49,-12,13,25
15,JOV,P002361,P013285,0 days 00:08:34,8,19,11
15,JOV,P002361,P010161,0 days 00:08:25,0,14,14
15,JOV,P002361,PJUG,0 days 00:08:00,5,22,17
15,JOV,P002361,P012740,0 days 00:07:57,-2,21,23
15,JOV,P012349,P012740,0 days 00:07:52,-11,13,24
15,JOV,P012740,PJUG,0 days 00:07:51,4,28,24
15,JOV,P006771,P012740,0 days 00:07:45,-9,11,20
15,JOV,P002361,P004834,0 days 00:07:19,1,16,15
15,JOV,P002361,P012349,0 days 00:07:19,1,16,15
15,JOV,P012349,P013285,0 days 00:06:35,-1,12,13
15,JOV,P012349,PJUG,0 days 00:06:20,0,12,12
15,JOV,P004834,PJUG,0 days 00:05:45,3,12,9
15,JOV,P004834,P010161,0 days 00:05:19,1,13,12
15,JOV,P004834,P013287,0 days 00:05:12,3,11,8
15,JOV,P012349,P013286,0 days 00:03:59,-5,7,12
15,JOV,P012740,P013286,0 days 00:03:59,-5,7,12
15,JOV,P004834,P013286,0 days 00:03:59,-5,7,12
15,JOV,P006771,P013286,0 days 00:03:59,-5,7,12
15,JOV,P006771,P013285,0 days 00:03:25,-7,2,9
15,JOV,P010161,PJUG,0 days 00:03:03,0,4,4
15,JOV,P002361,P006771,0 days 00:03:00,-3,4,7
15,JOV,P006771,PJUG,0 days 00:02:39,-6,2,8
15,JOV,P010161,P012349,0 days 00:00:38,-2,2,4
15,JOV,P002507,P006771,0 days 00:00:35,-3,0,3
15,JOV,P002507,P012349,0 days 00:00:35,-3,0,3
15,JOV,P006771,P013287,0 days 00:00:31,0,0,0
16,LKB,P005521,P013247,0 days 00:18:18,0,35,35
16,LKB,P005521,P005656,0 days 00:18:03,6,38,32
16,LKB,P009898,PLXI,0 days 00:16:27,-15,28,43
16,LKB,P005656,P013247,0 days 00:15:43,10,35,25
16,LKB,P005113,P005656,0 days 00:14:45,8,37,29
16,LKB,P006586,P009898,0 days 00:14:24,-20,20,40
16,LKB,P009299,P013247,0 days 00:13:59,-2,29,31
16,LKB,P005113,P005521,0 days 00:13:59,-1,28,29
16,LKB,P006586,PLXI,0 days 00:13:54,-24,21,45
16,LKB,P006586,P010461,0 days 00:13:52,-24,16,40
16,LKB,P005113,P009299,0 days 00:13:41,-1,26,27
16,LKB,P005113,P013247,0 days 00:13:10,5,29,24
16,LKB,P005521,P009299,0 days 00:12:21,1,25,24
16,LKB,P010461,PLXI,0 days 00:11:44,-24,18,42
16,LKB,P005656,P006586,0 days 00:11:36,4,24,20
16,LKB,P009299,PLXI,0 days 00:10:46,-12,19,31
16,LKB,P006586,P013247,0 days 00:10:19,-3,20,23
16,LKB,P006860,P010461,0 days 00:10:17,-12,16,28
16,LKB,P006860,P009898,0 days 00:10:15,-12,15,27
16,LKB,P009898,P010461,0 days 00:09:54,-16,14,30
16,LKB,P006860,PLXI,0 days 00:09:39,-11,15,26
16,LKB,P005113,P009898,0 days 00:09:39,-2,19,21
16,LKB,P005656,P009299,0 days 00:09:21,6,23,17
16,LKB,P010461,P013247,0 days 00:09:09,-6,16,22
16,LKB,P005521,P006586,0 days 00:09:03,-4,15,19
16,LKB,P005113,P006586,0 days 00:08:59,0,20,20
16,LKB,P005113,PLXI,0 days 00:08:45,-1,16,17
16,LKB,P009299,P010461,0 days 00:07:39,-6,18,24
16,LKB,P005521,P010461,0 days 00:07:25,-2,12,14
16,LKB,P009299,P009898,0 days 00:07:21,-5,15,20
16,LKB,P005656,P010461,0 days 00:06:12,2,10,8
16,LKB,P006860,P009299,0 days 00:06:01,2,15,13
16,LKB,P013247,PLXI,0 days 00:05:54,-9,10,19
16,LKB,P005656,P009898,0 days 00:05:14,0,12,12
16,LKB,P006586,P006860,0 days 00:05:06,-14,2,16
16,LKB,P006586,P009299,0 days 00:04:11,-11,6,17
16,LKB,P005521,P009898,0 days 00:03:06,-3,5,8
16,LKB,P005656,PLXI,0 days 00:02:54,4,9,5
16,LKB,P005521,PLXI,0 days 00:01:53,-8,0,8
16,LKB,P009898,P013247,0 days 00:01:52,1,4,3
16,LKB,P005521,P006860,0 days 00:01:28,-1,2,3
16,LKB,P006860,P013247,0 days 00:00:52,0,2,2
16,LKB,P005113,P006860,0 days 00:00:50,0,1,1
16,JER,P006625,P011970,0 days 00:23:40,26,65,39
16,JER,P006625,P010587,0 days 00:21:03,17,60,43
16,JER,P010587,P011970,0 days 00:18:41,17,52,35
16,JER,P011970,P013276,0 days 00:18:12,15,46,31
16,JER,P006625,P013276,0 days 00:17:58,23,49,26
16,JER,P008912,P013277,0 days 00:15:58,-7,31,38
16,JER,P006625,P013277,0 days 00:15:33,-4,32,36
16,JER,P006625,P010431,0 days 00:15:25,31,50,19
16,JER,P011970,P013277,0 days 00:15:10,-2,28,30
16,JER,P010431,P010587,0 days 00:13:41,28,47,19
16,JER,P010431,P011970,0 days 00:13:35,21,40,19
16,JER,P006625,P008912,0 days 00:13:07,-9,24,33
16,JER,P010431,P013276,0 days 00:13:04,17,36,19
16,JER,P010587,P013278,0 days 00:12:34,-14,21,35
16,JER,P008912,P011970,0 days 00:12:05,1,23,22
16,JER,P010587,P013277,0 days 00:12:02,-6,26,32
16,JER,P008912,P010587,0 days 00:11:50,-11,21,32
16,JER,P010587,P013276,0 days 00:09:45,18,33,15
16,JER,P013276,P013277,0 days 00:09:35,-2,15,17
16,JER,P010587,P013279,0 days 00:09:33,4,18,14
16,JER,P008912,P013276,0 days 00:09:24,4,18,14
16,JER,P006625,P013279,0 days 00:08:25,11,20,9
16,JER,P011970,P013279,0 days 00:07:48,7,16,9
16,JER,P013277,P013278,0 days 00:07:40,-5,16,21
16,JER,P006625,P013278,0 days 00:06:44,-10,13,23
16,JER,P013276,P013279,0 days 00:06:26,17,19,2
16,JER,P008912,P013278,0 days 00:06:09,-10,11,21
16,JER,P010431,P013277,0 days 00:06:04,-4,6,10
16,JER,P010431,P013279,0 days 00:06:01,14,18,4
16,JER,P011970,P013278,0 days 00:05:30,-4,8,12
16,JER,P011970,P013281,0 days 00:05:27,7,14,7
16,JER,P010587,P013281,0 days 00:05:27,7,14,7
16,JER,P013278,P013279,0 days 00:04:54,-9,5,14
16,JER,P008912,P010431,0 days 00:03:58,-2,5,7
16,JER,P010431,P013278,0 days 00:03:31,0,7,7
16,JER,P013279,P013281,0 days 00:03:14,-4,3,7
16,JER,P013278,P013281,0 days 00:03:14,-4,3,7
16,JER,P008912,P013279,0 days 00:02:53,-2,3,5
16,JER,P006625,P013281,0 days 00:02:13,11,11,0
16,JER,P010431,P013281,0 days 00:02:13,11,11,0
16,JER,P013277,P013279,0 days 00:00:14,2,2,0
17,ARI,P008084,P013250,0 days 00:22:13,-4,43,47
17,ARI,P008084,P013249,0 days 00:21:55,3,41,38
17,ARI,P013249,P013250,0 days 00:19:31,-7,34,41
17,ARI,P004292,P008084,0 days 00:18:43,-2,28,30
17,ARI,P013250,P013252,0 days 00:16:09,-6,22,28
17,ARI,P013250,P013251,0 days 00:15:11,1,26,25
17,ARI,P004292,P013252,0 days 00:14:46,-3,23,26
17,ARI,P008084,P013251,0 days 00:14:45,-2,25,27
17,ARI,P008084,P013252,0 days 00:14:29,-4,21,25
17,ARI,P013249,P013252,0 days 00:13:49,-8,17,25
17,ARI,P003240,P004292,0 days 00:13:25,0,21,21
17,ARI,P003240,P013252,0 days 00:12:44,-7,15,22
17,ARI,P004292,P013249,0 days 00:12:40,3,24,21
17,ARI,P013251,P013252,0 days 00:12:21,4,17,13
17,ARI,P008084,P013248,0 days 00:12:04,5,27,22
17,ARI,P013248,P013249,0 days 00:12:04,5,27,22
17,ARI,P004292,P013250,0 days 00:11:35,-3,19,22
17,ARI,P013249,P013251,0 days 00:11:02,-3,18,21
17,ARI,P003240,P008084,0 days 00:10:17,-2,17,19
17,ARI,P013248,P013250,0 days 00:09:59,-2,20,22
17,ARI,P003240,P013356,0 days 00:09:50,-1,13,14
17,ARI,P003240,P013249,0 days 00:09:47,1,18,17
17,ARI,P003240,P013250,0 days 00:09:07,-9,9,18
17,ARI,P004292,P013356,0 days 00:07:46,-2,12,14
17,ARI,P004292,P013251,0 days 00:07:38,4,12,8
17,ARI,P013248,P013251,0 days 00:06:53,-2,14,16
17,ARI,P013252,P013356,0 days 00:06:31,3,11,8
17,ARI,P003240,P013251,0 days 00:04:48,2,6,4
17,ARI,P004292,P013248,0 days 00:04:40,7,11,4
17,ARI,P013251,P013356,0 days 00:04:26,4,6,2
17,ARI,P004292,P013355,0 days 00:04:15,-4,2,6
17,ARI,P003240,P013355,0 days 00:04:15,-4,2,6
17,ARI,P008084,P013356,0 days 00:03:19,-4,2,6
17,ARI,P013355,P013356,0 days 00:03:19,-4,2,6
17,ARI,P008084,P013355,0 days 00:03:19,-4,2,6
17,ARI,P003240,P013360,0 days 00:03:07,-5,0,5
17,ARI,P013250,P013360,0 days 00:03:07,-5,0,5
17,ARI,P003240,P013248,0 days 00:02:36,7,9,2
17,ARI,P013249,P013360,0 days 00:02:11,-5,0,5
17,ARI,P013252,P013360,0 days 00:02:11,-5,0,5
17,ARI,P013249,P013356,0 days 00:02:05,-1,5,6
17,ARI,P013250,P013356,0 days 00:02:04,1,1,0
17,ARI,P004292,P013360,0 days 00:00:56,0,0,0
17,ARI,P013250,P013355,0 days 00:00:56,0,0,0
17,ARI,P013355,P013360,0 days 00:00:56,0,0,0
17,ARI,P003240,P013049,0 days 00:00:04,2,2,0
17,ARI,P008084,P013049,0 days 00:00:04,2,2,0
17,ARI,P013049,P013250,0 days 00:00:04,2,2,0
17,ARI,P013049,P013252,0 days 00:00:04,2,2,0
17,TTK,P009025,P011973,0 days 00:32:29,2,57,55
17,TTK,P006598,P009025,0 days 00:27:22,19,54,35
17,TTK,P006598,P011973,0 days 00:25:11,14,49,35
17,TTK,P009025,P013300,0 days 00:22:19,3,37,34
17,TTK,P011973,P013300,0 days 00:20:56,-2,32,34
17,TTK,P006598,P013300,0 days 00:20:14,7,33,26
17,TTK,P004218,P009025,0 days 00:16:48,5,32,27
17,TTK,P011973,P012259,0 days 00:15:42,-7,26,33
17,TTK,P004218,P011973,0 days 00:15:25,0,27,27
17,TTK,P009025,P012259,0 days 00:14:54,-7,26,33
17,TTK,P004218,P006598,0 days 00:14:35,11,28,17
17,TTK,P004218,P012259,0 days 00:13:03,-4,22,26
17,TTK,P004056,P011973,0 days 00:12:02,-1,21,22
17,TTK,P004056,P009025,0 days 00:11:14,-1,21,22
17,TTK,P011935,P013300,0 days 00:11:13,7,17,10
17,TTK,P004056,P013300,0 days 00:10:04,3,20,17
17,TTK,P006598,P011935,0 days 00:08:22,6,11,5
17,TTK,P006598,P012259,0 days 00:08:10,3,18,15
17,TTK,P004056,P006598,0 days 00:07:57,4,17,13
17,TTK,P012259,P013300,0 days 00:07:33,-10,10,20
17,TTK,P004218,P013300,0 days 00:07:11,-2,7,9
17,TTK,P007917,P009025,0 days 00:06:53,-2,10,12
17,TTK,P007917,P011973,0 days 00:06:53,-2,10,12
17,TTK,P007917,P013300,0 days 00:06:53,-2,10,12
17,TTK,P009025,P011935,0 days 00:06:41,9,11,2
17,TTK,P004056,P012259,0 days 00:06:41,-4,10,14
17,TTK,P004056,P004218,0 days 00:05:22,-3,7,10
17,TTK,P011935,P011973,0 days 00:04:30,4,6,2
17,TTK,P004218,P011935,0 days 00:04:07,2,5,3
17,TTK,P006598,P007917,0 days 00:03:44,1,6,5
17,TTK,P011935,P012259,0 days 00:02:55,-1,6,7
17,TTK,P007917,P012259,0 days 00:02:54,-3,4,7
17,TTK,P004056,P011935,0 days 00:02:36,1,6,5
17,TTK,P004619,P011935,0 days 00:02:36,1,6,5
17,TTK,P004619,P012259,0 days 00:02:36,1,6,5
17,TTK,P004619,P013300,0 days 00:02:36,1,6,5
17,TTK,P004056,P004619,0 days 00:02:36,1,6,5
17,TTK,P004218,P012415,0 days 00:01:37,-1,0,1
17,TTK,P006598,P012415,0 days 00:01:37,-1,0,1
17,TTK,P011935,P012415,0 days 00:01:37,-1,0,1
17,TTK,P012415,P013300,0 days 00:01:37,-1,0,1
17,TTK,P007917,P011935,0 days 00:00:15,0,0,0
18,LJU,P003452,P012042,0 days 00:23:48,0,53,53
18,LJU,P003703,P012042,0 days 00:22:58,1,47,46
18,LJU,P003452,P003703,0 days 00:19:48,0,42,42
18,LJU,P012042,P012700,0 days 00:17:24,-9,32,41
18,LJU,P009753,P012042,0 days 00:17:15,-1,33,34
18,LJU,P003703,P012700,0 days 00:15:52,-7,27,34
18,LJU,P003703,P009753,0 days 00:15:49,3,33,30
18,LJU,P003452,P012700,0 days 00:15:46,-11,27,38
18,LJU,P003452,P009753,0 days 00:15:01,0,29,29
18,LJU,P009753,P012700,0 days 00:14:42,-8,21,29
18,LJU,P009392,P013263,0 days 00:14:23,16,35,19
18,LJU,P009392,P013260,0 days 00:12:25,5,28,23
18,LJU,P009392,P012042,0 days 00:11:51,10,30,20
18,LJU,P003703,P009392,0 days 00:11:12,9,26,17
18,LJU,P013260,P013263,0 days 00:10:44,9,28,19
18,LJU,P012042,P013263,0 days 00:09:48,5,25,20
18,LJU,P003452,P009392,0 days 00:09:24,11,28,17
18,LJU,P003703,P013263,0 days 00:09:21,4,18,14
18,LJU,P013260,P013262,0 days 00:08:48,1,18,17
18,LJU,P009392,P013261,0 days 00:08:38,2,19,17
18,LJU,P009392,P013262,0 days 00:08:36,7,22,15
18,LJU,P003452,P013263,0 days 00:08:11,5,24,19
18,LJU,P013262,P013263,0 days 00:07:25,7,17,10
18,LJU,P013260,P013261,0 days 00:07:13,-4,14,18
18,LJU,P009392,P009753,0 days 00:06:22,-3,15,18
18,LJU,P012042,P013260,0 days 00:06:15,4,19,15
18,LJU,P013261,P013263,0 days 00:06:10,6,14,8
18,LJU,P013261,P013262,0 days 00:06:05,1,15,14
18,LJU,P009753,P013261,0 days 00:05:35,-6,10,16
18,LJU,P003452,P013260,0 days 00:05:34,6,19,13
18,LJU,P012042,P013261,0 days 00:05:26,3,11,8
18,LJU,P009753,P013260,0 days 00:04:55,-6,9,15
18,LJU,P003703,P013261,0 days 00:04:32,4,10,6
18,LJU,P003703,P013262,0 days 00:04:14,4,9,5
18,LJU,P012700,P013261,0 days 00:03:57,-2,7,9
18,LJU,P012700,P013260,0 days 00:03:42,-7,6,13
18,LJU,P003703,P013260,0 days 00:03:00,4,7,3
18,LJU,P012700,P013263,0 days 00:02:50,-4,7,11
18,LJU,P009753,P013262,0 days 00:02:45,-3,6,9
18,LJU,P003703,P012996,0 days 00:02:02,-2,5,7
18,LJU,P012700,P012996,0 days 00:02:02,-2,5,7
18,LJU,P012042,P012996,0 days 00:02:02,-2,5,7
18,LJU,P003452,P012996,0 days 00:02:02,-2,5,7
18,LJU,P012700,P013262,0 days 00:01:52,-1,3,4
18,LJU,P003452,P013262,0 days 00:01:22,3,5,2
18,LJU,P009392,P012700,0 days 00:00:45,-1,1,2
18,LJU,P012042,P013262,0 days 00:00:09,1,1,0
18,VNC,P008858,P012796,0 days 00:24:43,2,51,49
18,VNC,P005404,P008858,0 days 00:23:35,-3,52,55
18,VNC,P005404,P012796,0 days 00:22:26,8,52,44
18,VNC,P011909,P012796,0 days 00:22:06,9,48,39
18,VNC,P005404,P011909,0 days 00:19:53,9,46,37
18,VNC,P011909,P011928,0 days 00:19:47,9,44,35
18,VNC,P011928,P012796,0 days 00:18:07,8,39,31
18,VNC,P005404,P011928,0 days 00:17:53,9,46,37
18,VNC,P008858,P011928,0 days 00:17:51,3,39,36
18,VNC,P008858,P011909,0 days 00:17:25,3,36,33
18,VNC,P008052,P008858,0 days 00:16:14,-12,33,45
18,VNC,P005404,P008052,0 days 00:15:49,-8,34,42
18,VNC,P008052,P013305,0 days 00:14:01,-16,20,36
18,VNC,P008858,P013305,0 days 00:12:28,-13,18,31
18,VNC,P009400,P012796,0 days 00:11:41,4,23,19
18,VNC,P008052,P012796,0 days 00:11:18,-1,24,25
18,VNC,P008858,P009400,0 days 00:10:31,-5,20,25
18,VNC,P008052,P009400,0 days 00:10:29,-9,18,27
18,VNC,P009400,P011909,0 days 00:10:29,8,24,16
18,VNC,P009400,P011928,0 days 00:10:09,9,30,21
18,VNC,P005404,P009400,0 days 00:10:08,5,28,23
18,VNC,P005404,P013305,0 days 00:09:37,-9,16,25
18,VNC,P012796,P013305,0 days 00:07:19,-2,15,17
18,VNC,P003759,P005404,0 days 00:06:00,-4,10,14
18,VNC,P009400,P013305,0 days 00:05:57,-10,6,16
18,VNC,P003759,P008052,0 days 00:05:46,-11,5,16
18,VNC,P003759,P013305,0 days 00:05:39,-11,5,16
18,VNC,P003759,P009400,0 days 00:04:44,-6,7,13
18,VNC,P008052,P011909,0 days 00:04:06,0,9,9
18,VNC,P003759,P008858,0 days 00:04:06,-8,3,11
18,VNC,P008052,P011928,0 days 00:02:06,0,9,9
18,VNC,P003759,P011909,0 days 00:01:46,2,5,3
18,VNC,P003759,P011928,0 days 00:01:39,2,5,3
18,VNC,P005404,P006571,0 days 00:01:03,-3,0,3
18,VNC,P006571,P008052,0 days 00:01:03,-3,0,3
18,VNC,P006571,P008858,0 days 00:01:03,-3,0,3
18,VNC,P006571,P013305,0 days 00:01:03,-3,0,3
19,BOU,P004525,P010449,0 days 00:20:10,11,46,35
19,BOU,P013265,P013266,0 days 00:19:58,5,43,38
19,BOU,P010449,P013266,0 days 00:19:46,12,47,35
19,BOU,P004525,P013266,0 days 00:19:26,10,45,35
19,BOU,P011837,P013266,0 days 00:19:09,5,44,39
19,BOU,P006904,P013264,0 days 00:19:08,-2,36,38
19,BOU,P004525,P013265,0 days 00:19:04,13,44,31
19,BOU,P010449,P013265,0 days 00:18:53,13,44,31
19,BOU,P011837,P013265,0 days 00:18:06,10,42,32
19,BOU,P010449,P011837,0 days 00:17:19,9,40,31
19,BOU,P004525,P011837,0 days 00:16:59,7,38,31
19,BOU,P010450,P013264,0 days 00:16:04,6,33,27
19,BOU,P006904,P010450,0 days 00:15:15,3,30,27
19,BOU,P006904,P009552,0 days 00:14:34,1,26,25
19,BOU,P009552,P013264,0 days 00:14:34,1,26,25
19,BOU,P009552,P010450,0 days 00:13:05,7,26,19
19,BOU,P009556,P013264,0 days 00:09:12,9,21,12
19,BOU,P006904,P009556,0 days 00:09:12,9,21,12
19,BOU,P009552,P009556,0 days 00:07:34,5,15,10
19,BOU,P009556,P010450,0 days 00:07:08,7,15,8
19,BOU,P013264,P013266,0 days 00:05:59,-7,10,17
19,BOU,P004945,P010450,0 days 00:05:21,-2,9,11
19,BOU,P004945,P013264,0 days 00:05:21,-2,9,11
19,BOU,P004945,P006904,0 days 00:05:21,-2,9,11
19,BOU,P011837,P013264,0 days 00:05:05,-1,12,13
19,BOU,P013264,P013265,0 days 00:05:04,-4,9,13
19,BOU,P006904,P013266,0 days 00:04:46,-9,6,15
19,BOU,P006904,P011837,0 days 00:04:45,-3,10,13
19,BOU,P004945,P009552,0 days 00:04:41,1,9,8
19,BOU,P010450,P013266,0 days 00:04:34,-2,10,12
19,BOU,P009552,P013266,0 days 00:04:30,-2,7,9
19,BOU,P006904,P013265,0 days 00:04:04,-5,6,11
19,BOU,P010450,P011837,0 days 00:03:58,-4,8,12
19,BOU,P009552,P013265,0 days 00:03:40,-3,5,8
19,BOU,P009556,P013265,0 days 00:02:41,2,6,4
19,BOU,P009556,P011837,0 days 00:02:15,4,6,2
19,BOU,P004525,P009552,0 days 00:02:11,3,5,2
19,BOU,P009552,P010449,0 days 00:02:11,3,5,2
19,BOU,P010449,P010450,0 days 00:02:06,1,5,4
19,BOU,P010449,P013264,0 days 00:01:42,3,5,2
19,BOU,P004525,P010450,0 days 00:01:35,-1,3,4
19,BOU,P004525,P013264,0 days 00:01:11,1,3,2
19,BOU,P004945,P011837,0 days 00:00:40,-3,0,3
19,BOU,P004525,P009556,0 days 00:00:37,0,0,0
19,BOU,P009556,P010449,0 days 00:00:37,0,0,0
19,BOU,P010450,P013265,0 days 00:00:18,1,1,0
19,BOU,P004525,P006904,0 days 00:00:11,0,0,0
19,CLU,P013302,P013304,0 days 00:23:11,15,52,37
19,CLU,P002820,P013302,0 days 00:22:31,0,46,46
19,CLU,P006618,P012698,0 days 00:19:04,-7,35,42
19,CLU,P002820,P013304,0 days 00:18:13,7,39,32
19,CLU,P012698,P013302,0 days 00:14:28,22,41,19
19,CLU,P010651,P013302,0 days 00:14:03,-1,28,29
19,CLU,P012620,P012698,0 days 00:12:34,-4,23,27
19,CLU,P006618,P013302,0 days 00:12:12,5,28,23
19,CLU,P012698,P013304,0 days 00:12:03,17,33,16
19,CLU,P002820,P010651,0 days 00:10:51,-10,16,26
19,CLU,P005714,P013302,0 days 00:10:47,-3,18,21
19,CLU,P002820,P006618,0 days 00:10:42,6,25,19
19,CLU,P004862,P005714,0 days 00:10:39,-15,14,29
19,CLU,P010651,P013304,0 days 00:10:20,4,21,17
19,CLU,P006618,P012620,0 days 00:09:34,-18,11,29
19,CLU,P002820,P011801,0 days 00:08:57,-10,10,20
19,CLU,P011801,P013304,0 days 00:08:57,-15,8,23
19,CLU,P004862,P006618,0 days 00:08:53,-15,10,25
19,CLU,P006618,P011801,0 days 00:08:48,-14,9,23
19,CLU,P004862,P012698,0 days 00:08:45,-12,11,23
19,CLU,P002820,P012698,0 days 00:08:19,14,25,11
19,CLU,P011801,P013302,0 days 00:08:16,-10,10,20
19,CLU,P002820,P005714,0 days 00:08:09,-3,14,17
19,CLU,P005714,P006618,0 days 00:08:07,-13,11,24
19,CLU,P005714,P013304,0 days 00:08:01,0,15,15
19,CLU,P010651,P012698,0 days 00:08:00,10,21,11
19,CLU,P011801,P012698,0 days 00:08:00,-14,7,21
19,CLU,P005714,P012698,0 days 00:07:59,-10,12,22
19,CLU,P006618,P013304,0 days 00:07:12,8,18,10
19,CLU,P004862,P013302,0 days 00:07:02,-5,10,15
19,CLU,P005714,P011801,0 days 00:06:27,-3,12,15
19,CLU,P012620,P013304,0 days 00:06:27,6,15,9
19,CLU,P012620,P013302,0 days 00:06:10,5,15,10
19,CLU,P010651,P012620,0 days 00:06:10,5,15,10
19,CLU,P011801,P012620,0 days 00:05:43,-7,7,14
19,CLU,P006618,P010651,0 days 00:05:36,-4,9,13
19,CLU,P010651,P011801,0 days 00:05:12,-12,2,14
19,CLU,P004862,P012620,0 days 00:05:09,-7,7,14
19,CLU,P002820,P004862,0 days 00:04:24,-5,6,11
19,CLU,P005714,P012620,0 days 00:04:23,-5,8,13
19,CLU,P004862,P013304,0 days 00:04:16,-2,7,9
19,CLU,P004862,P011801,0 days 00:03:28,-7,3,10
19,CLU,P002820,P012620,0 days 00:01:58,-3,3,6
20,PAM,P010042,P010393,0 days 00:16:48,-7,37,44
20,PAM,P007527,P011982,0 days 00:15:32,11,42,31
20,PAM,P006643,P010042,0 days 00:14:24,12,39,27
20,PAM,P007527,P011980,0 days 00:13:19,13,36,23
20,PAM,P005356,P010393,0 days 00:13:14,14,38,24
20,PAM,P011980,P011982,0 days 00:10:54,10,31,21
20,PAM,P009864,P010393,0 days 00:10:44,-7,21,28
20,PAM,P006643,P010393,0 days 00:10:33,11,35,24
20,PAM,P010042,P010444,0 days 00:10:03,8,25,17
20,PAM,P010444,P011980,0 days 00:09:22,15,29,14
20,PAM,P004863,P011982,0 days 00:09:17,9,28,19
20,PAM,P004863,P011980,0 days 00:09:17,10,27,17
20,PAM,P005356,P010042,0 days 00:08:56,1,21,20
20,PAM,P010393,P011982,0 days 00:08:52,-3,17,20
20,PAM,P009864,P010042,0 days 00:08:50,-10,16,26
20,PAM,P004863,P007527,0 days 00:08:43,9,28,19
20,PAM,P006643,P010444,0 days 00:08:26,8,22,14
20,PAM,P007527,P009864,0 days 00:07:50,3,21,18
20,PAM,P009864,P011982,0 days 00:07:46,-5,12,17
20,PAM,P011982,P012738,0 days 00:07:41,9,21,12
20,PAM,P010393,P012738,0 days 00:07:29,17,27,10
20,PAM,P004548,P012738,0 days 00:06:57,8,18,10
20,PAM,P007527,P010393,0 days 00:06:56,0,19,19
20,PAM,P010042,P011980,0 days 00:06:47,11,18,7
20,PAM,P004863,P010444,0 days 00:06:35,15,22,7
20,PAM,P004863,P010393,0 days 00:06:35,8,18,10
20,PAM,P005356,P006643,0 days 00:06:33,16,25,9
20,PAM,P006643,P011980,0 days 00:06:28,8,15,7
20,PAM,P007527,P012738,0 days 00:06:14,5,15,10
20,PAM,P007527,P010444,0 days 00:06:11,5,19,14
20,PAM,P005356,P009864,0 days 00:06:11,-5,10,15
20,PAM,P007527,P010042,0 days 00:06:10,-1,16,17
20,PAM,P010042,P011982,0 days 00:05:58,-9,9,18
20,PAM,P004863,P010042,0 days 00:05:53,5,11,6
20,PAM,P004548,P010042,0 days 00:05:49,0,14,14
20,PAM,P011980,P012738,0 days 00:05:47,3,13,10
20,PAM,P006643,P012738,0 days 00:05:35,11,19,8
20,PAM,P004548,P006643,0 days 00:05:00,0,13,13
20,PAM,P004548,P011980,0 days 00:04:58,2,11,9
20,PAM,P004548,P010393,0 days 00:04:56,4,13,9
20,PAM,P004548,P011982,0 days 00:04:54,6,11,5
20,PAM,P004863,P012738,0 days 00:04:46,6,16,10
20,PAM,P006643,P007527,0 days 00:04:43,2,13,11
20,PAM,P010042,P012738,0 days 00:04:42,6,14,8
20,PAM,P004863,P009864,0 days 00:04:31,-3,7,10
20,PAM,P004863,P005356,0 days 00:04:29,5,13,8
20,PAM,P010393,P010444,0 days 00:04:25,-1,11,12
20,PAM,P010444,P011982,0 days 00:04:19,3,15,12
20,PAM,P005356,P012738,0 days 00:03:53,15,17,2
20,PAM,P005356,P011982,0 days 00:03:51,-3,6,9
20,PAM,P005356,P010444,0 days 00:03:33,4,11,7
20,PAM,P004863,P006643,0 days 00:03:22,8,10,2
20,PAM,P004548,P007527,0 days 00:03:01,1,5,4
20,PAM,P006643,P009864,0 days 00:03:00,0,9,9
20,PAM,P005356,P007527,0 days 00:02:21,4,6,2
20,PAM,P004548,P010444,0 days 00:02:14,-1,6,7
20,PAM,P009864,P011980,0 days 00:02:13,0,4,4
20,PAM,P004548,P005356,0 days 00:01:04,5,5,0
20,PAM,P004548,P009864,0 days 00:00:43,-1,0,1
20,PAM,P005356,P011980,0 days 00:00:23,0,0,0
20,HAM,P003242,P013312,0 days 00:22:15,0,51,51
20,HAM,P013312,P013313,0 days 00:19:40,5,50,45
20,HAM,P013309,P013311,0 days 00:17:56,-13,34,47
20,HAM,P013308,P013313,0 days 00:17:26,-9,36,45
20,HAM,P013308,P013312,0 days 00:16:39,-5,36,41
20,HAM,P013309,P013312,0 days 00:16:09,4,37,33
20,HAM,P003242,P013313,0 days 00:16:04,6,44,38
20,HAM,P011256,P013312,0 days 00:15:46,-8,36,44
20,HAM,P011256,P013308,0 days 00:14:44,-17,28,45
20,HAM,P011256,P013313,0 days 00:14:14,-13,28,41
20,HAM,P003242,P013309,0 days 00:13:46,1,29,28
20,HAM,P003242,P013308,0 days 00:13:12,-5,30,35
20,HAM,P006006,P013309,0 days 00:11:42,-6,23,29
20,HAM,P010070,P013309,0 days 00:11:39,-11,21,32
20,HAM,P006006,P010070,0 days 00:11:07,-6,21,27
20,HAM,P006420,P010070,0 days 00:09:42,-16,13,29
20,HAM,P003242,P013311,0 days 00:09:36,-2,21,23
20,HAM,P003242,P011256,0 days 00:09:36,-8,22,30
20,HAM,P013311,P013312,0 days 00:09:14,1,21,20
20,HAM,P006420,P013311,0 days 00:09:07,-14,13,27
20,HAM,P006006,P013311,0 days 00:08:58,-7,15,22
20,HAM,P010070,P013311,0 days 00:08:45,-11,13,24
20,HAM,P006420,P013309,0 days 00:08:42,-14,13,27
20,HAM,P006006,P006420,0 days 00:08:20,-10,13,23
20,HAM,P010070,P011256,0 days 00:07:52,-9,14,23
20,HAM,P010070,P013312,0 days 00:07:30,-4,14,18
20,HAM,P013309,P013313,0 days 00:06:38,13,22,9
20,HAM,P012695,P013309,0 days 00:06:31,-17,5,22
20,HAM,P012695,P013311,0 days 00:06:15,-17,5,22
20,HAM,P010070,P013308,0 days 00:05:34,-9,6,15
20,HAM,P003242,P012695,0 days 00:05:23,-10,5,15
20,HAM,P012695,P013312,0 days 00:05:05,-8,5,13
20,HAM,P010070,P013313,0 days 00:04:39,-5,6,11
20,HAM,P006006,P013312,0 days 00:04:26,-1,10,11
20,HAM,P013308,P013309,0 days 00:03:37,3,8,5
20,HAM,P006006,P011256,0 days 00:03:14,-4,8,12
20,HAM,P013311,P013313,0 days 00:03:08,11,14,3
20,HAM,P011256,P013309,0 days 00:02:44,0,8,8
20,HAM,P003242,P006006,0 days 00:02:13,-5,2,7
20,HAM,P006420,P013308,0 days 00:01:49,-7,0,7
20,HAM,P006420,P012695,0 days 00:01:26,-9,0,9
20,HAM,P010070,P012695,0 days 00:01:26,-9,0,9
20,HAM,P006420,P011256,0 days 00:01:24,-7,0,7
20,HAM,P006006,P013308,0 days 00:01:04,-5,0,5
20,HAM,P003242,P006420,0 days 00:00:49,-5,0,5
20,HAM,P006420,P013313,0 days 00:00:45,-2,0,2
20,HAM,P003242,P010070,0 days 00:00:34,0,0,0
20,HAM,P012695,P013308,0 days 00:00:34,-2,0,2
20,HAM,P013308,P013311,0 days 00:00:25,0,0,0
20,HAM,P011256,P012695,0 days 00:00:18,-2,0,2
20,HAM,P012695,P013313,0 days 00:00:18,-2,0,2
22,WOL,P011248,P012577,0 days 00:22:07,-4,47,51
22,WOL,P005516,P006546,0 days 00:21:54,-4,45,49
22,WOL,P005516,P012577,0 days 00:20:54,-1,45,46
22,WOL,P005516,P012789,0 days 00:20:44,-8,40,48
22,WOL,P006546,P012789,0 days 00:20:09,-9,41,50
22,WOL,P005516,P011248,0 days 00:19:36,-8,36,44
22,WOL,P006546,P012003,0 days 00:18:43,-5,39,44
22,WOL,P012003,P012789,0 days 00:17:44,-4,35,39
22,WOL,P005516,P012003,0 days 00:17:10,2,35,33
22,WOL,P006546,P011248,0 days 00:16:04,-10,31,41
22,WOL,P004645,P006546,0 days 00:15:27,-9,26,35
22,WOL,P004645,P005516,0 days 00:14:32,-10,26,36
22,WOL,P012577,P012789,0 days 00:14:30,-6,32,38
22,WOL,P008186,P011248,0 days 00:14:12,-12,19,31
22,WOL,P006546,P012577,0 days 00:14:03,1,36,35
22,WOL,P012003,P012577,0 days 00:13:25,-4,30,34
22,WOL,P011248,P012003,0 days 00:13:06,-6,25,31
22,WOL,P004645,P012003,0 days 00:12:54,-3,21,24
22,WOL,P004645,P012789,0 days 00:12:40,-10,21,31
22,WOL,P011248,P012789,0 days 00:12:17,-11,23,34
22,WOL,P004645,P011248,0 days 00:10:14,-15,15,30
22,WOL,P008186,P012577,0 days 00:09:58,-6,15,21
22,WOL,P005516,P008186,0 days 00:09:49,-7,12,19
22,WOL,P008186,P012003,0 days 00:07:31,-6,12,18
22,WOL,P006546,P008186,0 days 00:06:52,-8,6,14
22,WOL,P004645,P008186,0 days 00:04:58,-7,4,11
22,WOL,P004645,P012577,0 days 00:04:35,-2,11,13
22,WOL,P008186,P009306,0 days 00:03:28,-2,8,10
22,WOL,P009306,P011248,0 days 00:03:28,-2,8,10
22,WOL,P009306,P012577,0 days 00:03:28,-2,8,10
22,WOL,P005516,P009306,0 days 00:02:41,0,5,5
22,WOL,P009306,P012003,0 days 00:00:47,-2,3,5
22,ULM,P011391,P013290,0 days 00:28:15,23,75,52
22,ULM,P006245,P013290,0 days 00:24:25,10,60,50
22,ULM,P006997,P013290,0 days 00:24:23,4,51,47
22,ULM,P006245,P011391,0 days 00:20:08,21,54,33
22,ULM,P006997,P011391,0 days 00:18:34,8,42,34
22,ULM,P006245,P006997,0 days 00:18:18,-6,37,43
22,ULM,P011437,P013290,0 days 00:18:12,6,36,30
22,ULM,P011391,P012077,0 days 00:17:44,3,41,38
22,ULM,P012077,P013290,0 days 00:15:42,7,41,34
22,ULM,P010726,P011391,0 days 00:14:37,7,37,30
22,ULM,P006997,P011437,0 days 00:13:06,4,24,20
22,ULM,P010726,P013290,0 days 00:12:08,8,34,26
22,ULM,P006245,P010726,0 days 00:11:32,11,30,19
22,ULM,P011391,P011437,0 days 00:10:44,15,27,12
22,ULM,P013290,P013291,0 days 00:10:37,2,22,20
22,ULM,P006245,P013291,0 days 00:09:50,4,22,18
22,ULM,P011437,P013291,0 days 00:09:42,1,19,18
22,ULM,P006245,P011437,0 days 00:09:27,4,20,16
22,ULM,P006997,P010726,0 days 00:09:10,2,23,21
22,ULM,P007952,P013290,0 days 00:08:57,0,22,22
22,ULM,P007952,P012077,0 days 00:08:36,7,26,19
22,ULM,P006245,P012077,0 days 00:08:14,9,24,15
22,ULM,P006997,P012077,0 days 00:08:14,-1,15,16
22,ULM,P007952,P011391,0 days 00:07:42,0,19,19
22,ULM,P011437,P012077,0 days 00:06:38,1,13,12
22,ULM,P010726,P012077,0 days 00:06:36,6,18,12
22,ULM,P006997,P013291,0 days 00:06:19,-7,9,16
22,ULM,P007952,P010726,0 days 00:05:10,6,15,9
22,ULM,P006245,P007952,0 days 00:04:31,8,13,5
22,ULM,P012602,P013290,0 days 00:03:53,0,7,7
22,ULM,P011391,P013291,0 days 00:03:24,13,13,0
22,ULM,P012602,P013291,0 days 00:03:03,-1,3,4
22,ULM,P007952,P011437,0 days 00:02:52,-8,2,10
22,ULM,P006245,P012602,0 days 00:02:43,3,8,5
22,ULM,P007952,P012602,0 days 00:02:34,0,4,4
22,ULM,P012077,P012602,0 days 00:02:17,2,8,6
22,ULM,P007952,P013291,0 days 00:02:14,-1,3,4
22,ULM,P011437,P012602,0 days 00:02:07,1,3,2
22,ULM,P011391,P012602,0 days 00:01:48,-2,4,6
22,ULM,P006997,P012602,0 days 00:01:28,0,3,3
22,ULM,P010726,P012602,0 days 00:01:27,1,4,3
22,ULM,P010726,P013291,0 days 00:01:20,3,3,0
22,ULM,P012077,P013291,0 days 00:01:19,6,6,0
23,BES,P007914,P011927,0 days 00:20:36,7,51,44
23,BES,P011379,P011924,0 days 00:18:42,-18,34,52
23,BES,P011924,P011927,0 days 00:18:13,2,45,43
23,BES,P011927,P013255,0 days 00:17:54,-25,31,56
23,BES,P007914,P011924,0 days 00:17:21,1,43,42
23,BES,P008945,P013255,0 days 00:17:12,-9,37,46
23,BES,P011924,P013255,0 days 00:16:54,-27,28,55
23,BES,P007914,P008945,0 days 00:16:46,4,42,38
23,BES,P008945,P011927,0 days 00:16:24,4,42,38
23,BES,P008945,P011924,0 days 00:16:01,-3,38,41
23,BES,P007914,P013255,0 days 00:15:16,-15,27,42
23,BES,P009680,P013255,0 days 00:14:43,-6,26,32
23,BES,P008945,P011379,0 days 00:14:21,-11,31,42
23,BES,P008945,P009680,0 days 00:13:40,-6,26,32
23,BES,P010652,P011927,0 days 00:12:53,6,35,29
23,BES,P011379,P013255,0 days 00:12:45,-22,22,44
23,BES,P003783,P011927,0 days 00:11:11,0,26,26
23,BES,P007914,P009680,0 days 00:11:09,-5,20,25
23,BES,P007914,P011379,0 days 00:10:56,-8,23,31
23,BES,P007914,P010652,0 days 00:10:47,13,32,19
23,BES,P010652,P013255,0 days 00:09:50,-6,19,25
23,BES,P010652,P011924,0 days 00:09:48,5,28,23
23,BES,P011379,P011927,0 days 00:09:44,-7,21,28
23,BES,P009680,P011379,0 days 00:09:21,-12,15,27
23,BES,P009680,P011924,0 days 00:09:21,-12,15,27
23,BES,P003783,P013255,0 days 00:07:42,-14,10,24
23,BES,P003783,P011924,0 days 00:07:40,0,17,17
23,BES,P003783,P010652,0 days 00:07:24,9,20,11
23,BES,P003783,P007914,0 days 00:05:57,11,18,7
23,BES,P008945,P010652,0 days 00:05:41,12,21,9
23,BES,P009680,P011927,0 days 00:05:29,-3,9,12
23,BES,P003783,P011379,0 days 00:04:15,-10,6,16
23,BES,P003783,P008945,0 days 00:01:59,1,7,6
23,BES,P009680,P010652,0 days 00:01:37,5,5,0
23,BES,P003783,P009680,0 days 00:00:28,-1,0,1
23,HTA,P004846,P013284,0 days 00:26:41,25,75,50
23,HTA,P004846,P011157,0 days 00:25:46,37,77,40
23,HTA,P001927,P004846,0 days 00:24:43,33,76,43
23,HTA,P001927,P013284,0 days 00:24:13,32,73,41
23,HTA,P011157,P013284,0 days 00:24:07,29,71,42
23,HTA,P004846,P010386,0 days 00:23:30,9,61,52
23,HTA,P001927,P011157,0 days 00:22:52,32,69,37
23,HTA,P010386,P013284,0 days 00:20:17,7,52,45
23,HTA,P001927,P010386,0 days 00:19:56,20,58,38
23,HTA,P010386,P011157,0 days 00:19:03,21,54,33
23,HTA,P004846,P010550,0 days 00:14:49,12,40,28
23,HTA,P010550,P013284,0 days 00:12:50,12,33,21
23,HTA,P001927,P010550,0 days 00:12:38,22,39,17
23,HTA,P010550,P012096,0 days 00:12:12,-20,18,38
23,HTA,P010550,P011157,0 days 00:11:21,22,36,14
23,HTA,P010386,P010550,0 days 00:10:37,-4,23,27
23,HTA,P010550,P011386,0 days 00:10:36,-17,16,33
23,HTA,P011386,P012096,0 days 00:10:36,-17,16,33
23,HTA,P005181,P010550,0 days 00:06:47,-8,12,20
23,HTA,P010386,P012096,0 days 00:06:27,-13,12,25
23,HTA,P005181,P012096,0 days 00:05:39,-14,7,21
23,HTA,P010465,P010550,0 days 00:05:30,-11,7,18
23,HTA,P010465,P012096,0 days 00:05:30,-11,7,18
23,HTA,P010465,P011386,0 days 00:05:30,-11,7,18
23,HTA,P005181,P011386,0 days 00:05:30,-11,7,18
23,HTA,P005181,P010465,0 days 00:05:30,-11,7,18
23,HTA,P001927,P012096,0 days 00:04:48,5,13,8
23,HTA,P004846,P012096,0 days 00:03:56,-13,6,19
23,HTA,P010386,P011386,0 days 00:03:52,-8,7,15
23,HTA,P012096,P013284,0 days 00:03:36,-5,5,10
23,HTA,P001927,P011386,0 days 00:03:26,4,8,4
23,HTA,P011386,P013284,0 days 00:01:33,0,2,2
23,HTA,P005181,P010386,0 days 00:01:26,0,5,5
23,HTA,P004846,P011386,0 days 00:01:21,-8,1,9
23,HTA,P004846,P005181,0 days 00:01:10,1,4,3
23,HTA,P005181,P011157,0 days 00:00:59,3,5,2
23,HTA,P005181,P013284,0 days 00:00:43,-4,1,5
28,VNC,P005404,P013305,0 days 00:30:22,-13,53,66
28,VNC,P005404,P012796,0 days 00:23:41,7,47,40
28,VNC,P012796,P013305,0 days 00:23:04,3,45,42
28,VNC,P009400,P013305,0 days 00:21:12,-7,32,39
28,VNC,P005404,P011928,0 days 00:21:11,4,36,32
28,VNC,P008052,P013305,0 days 00:20:13,-24,33,57
28,VNC,P005404,P009400,0 days 00:19:27,1,29,28
28,VNC,P009400,P012796,0 days 00:19:09,5,31,26
28,VNC,P005177,P008052,0 days 00:18:56,-25,33,58
28,VNC,P011928,P012796,0 days 00:18:53,7,33,26
28,VNC,P011928,P013305,0 days 00:18:41,0,32,32
28,VNC,P009400,P011928,0 days 00:18:10,0,29,29
28,VNC,P005177,P013305,0 days 00:17:40,-14,35,49
28,VNC,P005404,P008052,0 days 00:15:58,-20,26,46
28,VNC,P005177,P005404,0 days 00:15:55,-6,32,38
28,VNC,P005177,P012796,0 days 00:14:46,-2,28,30
28,VNC,P008052,P009400,0 days 00:11:18,-21,11,32
28,VNC,P005177,P011928,0 days 00:11:17,-10,15,25
28,VNC,P008052,P012796,0 days 00:10:39,-8,20,28
28,VNC,P005177,P009400,0 days 00:09:38,-9,13,22
28,VNC,P006571,P008052,0 days 00:08:10,-18,10,28
28,VNC,P006571,P009400,0 days 00:07:26,-17,7,24
28,VNC,P006571,P013305,0 days 00:07:16,-13,10,23
28,VNC,P008052,P011928,0 days 00:07:10,-16,7,23
28,VNC,P005404,P006571,0 days 00:04:54,-9,5,14
28,VNC,P005177,P006571,0 days 00:04:00,-10,8,18
28,VNC,P006571,P011928,0 days 00:00:54,-5,0,5
28,BOU,P004525,P013265,0 days 00:21:13,9,45,36
28,BOU,P010449,P013265,0 days 00:21:10,8,45,37
28,BOU,P004525,P010449,0 days 00:19:42,8,46,38
28,BOU,P010449,P011837,0 days 00:17:41,8,36,28
28,BOU,P010449,P013266,0 days 00:17:05,-2,32,34
28,BOU,P011837,P013265,0 days 00:16:28,6,34,28
28,BOU,P010450,P013264,0 days 00:16:02,17,41,24
28,BOU,P006904,P009552,0 days 00:15:42,13,36,23
28,BOU,P013265,P013266,0 days 00:15:04,-1,27,28
28,BOU,P009552,P013264,0 days 00:14:30,13,36,23
28,BOU,P004525,P011837,0 days 00:14:12,7,32,25
28,BOU,P009552,P010450,0 days 00:14:01,16,36,20
28,BOU,P004525,P013266,0 days 00:13:36,-1,28,29
28,BOU,P006904,P013264,0 days 00:13:23,13,34,21
28,BOU,P006904,P010450,0 days 00:12:54,16,34,18
28,BOU,P011837,P013266,0 days 00:10:28,-3,16,19
28,BOU,P004525,P009556,0 days 00:08:25,9,20,11
28,BOU,P009556,P013265,0 days 00:08:25,9,20,11
28,BOU,P009556,P011837,0 days 00:07:13,11,20,9
28,BOU,P009556,P010449,0 days 00:07:13,11,20,9
28,BOU,P004945,P013264,0 days 00:07:11,10,20,10
28,BOU,P004945,P009552,0 days 00:07:11,10,20,10
28,BOU,P004945,P006904,0 days 00:07:11,10,20,10
28,BOU,P006904,P009556,0 days 00:07:03,3,14,11
28,BOU,P009552,P009556,0 days 00:07:03,3,14,11
28,BOU,P004945,P010450,0 days 00:06:42,13,20,7
28,BOU,P009556,P010450,0 days 00:05:51,5,14,9
28,BOU,P009556,P013264,0 days 00:05:51,5,14,9
28,BOU,P009552,P013265,0 days 00:05:49,-4,10,14
28,BOU,P013264,P013266,0 days 00:05:45,-2,9,11
28,BOU,P009552,P013266,0 days 00:05:36,-1,12,13
28,BOU,P010449,P013264,0 days 00:05:24,0,9,9
28,BOU,P004525,P009552,0 days 00:05:20,-1,10,11
28,BOU,P010450,P013266,0 days 00:05:10,2,10,8
28,BOU,P010449,P010450,0 days 00:04:49,4,10,6
28,BOU,P009552,P010449,0 days 00:04:08,-1,10,11
28,BOU,P011837,P013264,0 days 00:03:29,1,4,3
28,BOU,P006904,P013265,0 days 00:02:48,-3,2,5
28,BOU,P013264,P013265,0 days 00:02:45,-4,2,6
28,BOU,P004525,P010450,0 days 00:02:29,2,6,4
28,BOU,P004525,P006904,0 days 00:02:19,0,2,2
28,BOU,P010450,P013265,0 days 00:01:41,3,3,0
28,BOU,P006904,P013266,0 days 00:01:28,0,2,2
28,BOU,P010450,P011837,0 days 00:01:13,2,2,0
28,BOU,P004525,P013264,0 days 00:00:48,-1,3,4
28,BOU,P004945,P013265,0 days 00:00:29,-3,0,3
29,TTK,P009025,P011973,0 days 00:31:15,13,64,51
29,TTK,P009025,P011935,0 days 00:28:12,7,58,51
29,TTK,P006598,P011973,0 days 00:27:25,9,57,48
29,TTK,P011935,P011973,0 days 00:26:37,9,55,46
29,TTK,P006598,P009025,0 days 00:25:06,9,52,43
29,TTK,P006598,P011935,0 days 00:23:17,3,46,43
29,TTK,P011935,P013300,0 days 00:21:56,1,43,42
29,TTK,P011973,P013300,0 days 00:21:04,7,42,35
29,TTK,P009025,P013300,0 days 00:20:29,4,42,38
29,TTK,P006598,P013300,0 days 00:16:44,-1,32,33
29,TTK,P004056,P011973,0 days 00:11:03,6,24,18
29,TTK,P004056,P006598,0 days 00:10:34,6,24,18
29,TTK,P009025,P012415,0 days 00:10:05,7,14,7
29,TTK,P004056,P009025,0 days 00:10:01,4,23,19
29,TTK,P011935,P012415,0 days 00:09:38,5,13,8
29,TTK,P011973,P012415,0 days 00:09:18,7,14,7
29,TTK,P009025,P012259,0 days 00:08:42,0,20,20
29,TTK,P006598,P012415,0 days 00:06:55,2,10,8
29,TTK,P011973,P012259,0 days 00:05:27,3,13,10
29,TTK,P012415,P013300,0 days 00:05:25,3,8,5
29,TTK,P004056,P012259,0 days 00:05:11,1,10,9
29,TTK,P004056,P011935,0 days 00:05:01,0,11,11
29,TTK,P006598,P007917,0 days 00:04:48,-1,7,8
29,TTK,P007917,P011973,0 days 00:04:35,-1,6,7
29,TTK,P007917,P012415,0 days 00:04:26,-4,3,7
29,TTK,P007917,P013300,0 days 00:04:13,0,7,7
29,TTK,P011935,P012259,0 days 00:04:10,-3,10,13
29,TTK,P007917,P009025,0 days 00:04:03,-1,4,5
29,TTK,P007917,P011935,0 days 00:04:03,-5,3,8
29,TTK,P006598,P012259,0 days 00:03:47,2,7,5
29,TTK,P012259,P013300,0 days 00:03:31,-1,10,11
29,TTK,P004619,P009025,0 days 00:03:15,-3,7,10
29,TTK,P004619,P012259,0 days 00:03:15,-3,7,10
29,TTK,P004056,P013300,0 days 00:02:55,1,4,3
29,TTK,P004056,P007917,0 days 00:02:38,3,7,4
29,TTK,P004619,P011935,0 days 00:02:30,-4,4,8
29,TTK,P004619,P013300,0 days 00:01:51,-2,4,6
29,TTK,P004056,P004619,0 days 00:01:24,-1,3,4
29,TTK,P004056,P012415,0 days 00:01:01,0,2,2
29,TTK,P004619,P007917,0 days 00:00:45,1,3,2
29,TTK,P007917,P012259,0 days 00:00:45,1,3,2
29,TTK,P006598,P010811,0 days 00:00:40,-1,1,2
29,TTK,P007917,P010811,0 days 00:00:40,-1,1,2
29,TTK,P010811,P011935,0 days 00:00:40,-1,1,2
29,TTK,P010811,P011973,0 days 00:00:40,-1,1,2
29,LJU,P003703,P012042,0 days 00:23:07,-10,38,48
29,LJU,P003452,P012042,0 days 00:22:15,-15,38,53
29,LJU,P003452,P003703,0 days 00:22:05,-14,38,52
29,LJU,P003703,P012700,0 days 00:17:46,-7,28,35
29,LJU,P012042,P012700,0 days 00:16:01,-6,25,31
29,LJU,P003703,P012996,0 days 00:15:22,-7,24,31
29,LJU,P003452,P012700,0 days 00:13:04,-11,22,33
29,LJU,P012700,P012996,0 days 00:12:32,-4,18,22
29,LJU,P012042,P013260,0 days 00:11:45,3,22,19
29,LJU,P003703,P013260,0 days 00:10:59,-3,19,22
29,LJU,P009431,P011261,0 days 00:10:50,1,22,21
29,LJU,P012042,P012996,0 days 00:09:57,-6,14,20
29,LJU,P003452,P013260,0 days 00:09:22,-6,17,23
29,LJU,P003452,P012996,0 days 00:09:12,-6,14,20
29,LJU,P009753,P013260,0 days 00:09:05,-3,15,18
29,LJU,P009753,P012042,0 days 00:08:57,-4,13,17
29,LJU,P003703,P013263,0 days 00:08:10,1,17,16
29,LJU,P011261,P013260,0 days 00:08:07,4,18,14
29,LJU,P012042,P013263,0 days 00:07:56,2,18,16
29,LJU,P009431,P013260,0 days 00:07:42,-1,15,16
29,LJU,P009392,P013260,0 days 00:07:37,6,16,10
29,LJU,P011261,P012700,0 days 00:07:32,6,14,8
29,LJU,P003452,P013263,0 days 00:07:26,1,17,16
29,LJU,P013260,P013263,0 days 00:07:15,5,14,9
29,LJU,P003703,P009753,0 days 00:07:01,-7,9,16
29,LJU,P003452,P009753,0 days 00:06:54,-12,9,21
29,LJU,P009392,P009431,0 days 00:06:28,3,13,10
29,LJU,P003703,P009431,0 days 00:06:27,-3,10,13
29,LJU,P003703,P011261,0 days 00:06:20,-1,10,11
29,LJU,P012700,P013260,0 days 00:06:08,4,12,8
29,LJU,P009753,P012700,0 days 00:06:08,-2,9,11
29,LJU,P011261,P012996,0 days 00:05:34,1,12,11
29,LJU,P009431,P012996,0 days 00:05:34,1,12,11
29,LJU,P009392,P013263,0 days 00:05:30,4,8,4
29,LJU,P009392,P011261,0 days 00:05:25,2,12,10
29,LJU,P009753,P011261,0 days 00:05:19,1,8,7
29,LJU,P009431,P012700,0 days 00:05:10,3,11,8
29,LJU,P009392,P009753,0 days 00:05:08,-4,9,13
29,LJU,P003703,P009392,0 days 00:04:55,-1,7,8
29,LJU,P009392,P012042,0 days 00:04:41,0,8,8
29,LJU,P012996,P013260,0 days 00:03:44,-1,8,9
29,LJU,P003452,P009392,0 days 00:03:32,-3,5,8
29,LJU,P009431,P013263,0 days 00:03:19,3,5,2
29,LJU,P012700,P013263,0 days 00:03:08,2,9,7
29,LJU,P009431,P009753,0 days 00:02:56,-5,4,9
29,LJU,P011261,P012042,0 days 00:02:41,4,4,0
29,LJU,P011261,P013263,0 days 00:02:16,2,4,2
29,LJU,P009392,P012700,0 days 00:01:11,3,4,1
29,LJU,P003452,P009431,0 days 00:00:18,-2,0,2
29,LJU,P009392,P012996,0 days 00:00:09,2,2,0
30,LKB,P005656,P009299,0 days 00:22:18,-8,39,47
30,LKB,P005656,P013247,0 days 00:18:38,-2,34,36
30,LKB,P005656,P010461,0 days 00:18:10,-7,33,40
30,LKB,P009299,P013247,0 days 00:17:24,0,34,34
30,LKB,P010461,P013247,0 days 00:17:05,-10,32,42
30,LKB,P009299,P010461,0 days 00:16:56,-5,33,38
30,LKB,P009898,PLXI,0 days 00:16:43,-4,35,39
30,LKB,P006586,P009898,0 days 00:16:01,-12,30,42
30,LKB,P009299,PLXI,0 days 00:15:38,-3,31,34
30,LKB,P005521,PLXI,0 days 00:15:15,-3,33,36
30,LKB,P006586,PLXI,0 days 00:14:30,-12,29,41
30,LKB,P005521,P010461,0 days 00:13:54,-12,23,35
30,LKB,P005521,P009898,0 days 00:13:41,3,31,28
30,LKB,P005521,P006586,0 days 00:13:13,-7,27,34
30,LKB,P006212,PLXI,0 days 00:12:56,4,31,27
30,LKB,P010461,PLXI,0 days 00:12:51,-8,27,35
30,LKB,P005656,PLXI,0 days 00:11:41,-2,23,25
30,LKB,P006212,P009898,0 days 00:11:16,-1,27,28
30,LKB,P013247,PLXI,0 days 00:10:54,-4,23,27
30,LKB,P005521,P009299,0 days 00:10:19,0,19,19
30,LKB,P005521,P005656,0 days 00:10:07,-8,13,21
30,LKB,P005521,P013247,0 days 00:09:51,-10,15,25
30,LKB,P006212,P006586,0 days 00:09:48,-5,19,24
30,LKB,P006586,P010461,0 days 00:09:30,-13,13,26
30,LKB,P009299,P009898,0 days 00:09:23,-11,13,24
30,LKB,P006212,P009299,0 days 00:08:33,-4,14,18
30,LKB,P005521,P006212,0 days 00:07:48,9,23,14
30,LKB,P009898,P010461,0 days 00:06:42,-5,11,16
30,LKB,P006586,P009299,0 days 00:06:37,-13,5,18
30,LKB,P005656,P006586,0 days 00:05:52,-10,3,13
30,LKB,P005656,P009898,0 days 00:05:26,-10,5,15
30,LKB,P005656,P006212,0 days 00:04:04,-1,6,7
30,LKB,P006586,P013247,0 days 00:03:49,-8,2,10
30,LKB,P006212,P013247,0 days 00:03:07,2,4,2
30,ARI,P003240,P013250,0 days 00:16:54,9,38,29
30,ARI,P004292,P013356,0 days 00:15:13,5,39,34
30,ARI,P004292,P013355,0 days 00:14:19,6,37,31
30,ARI,P013355,P013356,0 days 00:14:12,6,38,32
30,ARI,P008084,P013250,0 days 00:14:04,8,29,21
30,ARI,P003240,P013355,0 days 00:13:45,9,34,25
30,ARI,P003240,P013356,0 days 00:13:29,7,37,30
30,ARI,P004292,P013249,0 days 00:13:13,5,31,26
30,ARI,P008084,P013251,0 days 00:13:01,-1,22,23
30,ARI,P003240,P008084,0 days 00:12:39,5,23,18
30,ARI,P013248,P013251,0 days 00:12:11,-2,18,20
30,ARI,P008084,P013248,0 days 00:11:59,-5,15,20
30,ARI,P003240,P013251,0 days 00:11:37,4,29,25
30,ARI,P013250,P013251,0 days 00:11:26,8,30,22
30,ARI,P004292,P013251,0 days 00:10:57,10,27,17
30,ARI,P003240,P004292,0 days 00:10:25,3,24,21
30,ARI,P013250,P013355,0 days 00:09:40,7,24,17
30,ARI,P013249,P013356,0 days 00:09:22,7,27,20
30,ARI,P013251,P013356,0 days 00:09:11,14,31,17
30,ARI,P013249,P013251,0 days 00:08:36,5,17,12
30,ARI,P013249,P013355,0 days 00:07:45,2,20,18
30,ARI,P003240,P013375,0 days 00:07:33,7,17,10
30,ARI,P008084,P013249,0 days 00:07:21,-4,10,14
30,ARI,P008084,P013375,0 days 00:07:17,9,17,8
30,ARI,P013248,P013250,0 days 00:07:12,1,11,10
30,ARI,P013250,P013356,0 days 00:07:03,5,20,15
30,ARI,P004292,P008084,0 days 00:06:50,4,13,9
30,ARI,P003240,P013248,0 days 00:06:46,0,10,10
30,ARI,P013251,P013355,0 days 00:06:27,9,22,13
30,ARI,P013248,P013249,0 days 00:06:22,-2,8,10
30,ARI,P003240,P013252,0 days 00:05:37,3,16,13
30,ARI,P013355,P013375,0 days 00:05:07,-3,10,13
30,ARI,P004292,P013250,0 days 00:04:58,3,12,9
30,ARI,P003240,P013249,0 days 00:04:50,1,12,11
30,ARI,P008084,P013355,0 days 00:04:49,4,11,7
30,ARI,P004292,P013375,0 days 00:04:33,-3,10,13
30,ARI,P013250,P013375,0 days 00:04:29,8,12,4
30,ARI,P013250,P013252,0 days 00:04:15,5,14,9
30,ARI,P004292,P013248,0 days 00:04:08,-2,4,6
30,ARI,P013252,P013356,0 days 00:03:56,2,13,11
30,ARI,P013252,P013375,0 days 00:03:55,8,12,4
30,ARI,P008084,P013252,0 days 00:03:55,8,12,4
30,ARI,P004292,P013252,0 days 00:03:36,5,11,6
30,ARI,P013251,P013252,0 days 00:03:34,6,13,7
30,ARI,P013356,P013375,0 days 00:03:33,-5,8,13
30,ARI,P013249,P013250,0 days 00:03:30,-2,6,8
30,ARI,P013249,P013375,0 days 00:03:17,-3,8,11
30,ARI,P013249,P013252,0 days 00:02:36,3,9,6
30,ARI,P013248,P013375,0 days 00:01:48,-1,3,4
30,ARI,P013251,P013375,0 days 00:01:48,-1,3,4
30,ARI,P013248,P013356,0 days 00:01:09,3,3,0
30,ARI,P003240,P013360,0 days 00:00:57,0,0,0
30,ARI,P008084,P013360,0 days 00:00:57,0,0,0
30,ARI,P013248,P013360,0 days 00:00:57,0,0,0
30,ARI,P013250,P013360,0 days 00:00:57,0,0,0
