GAMECODE,CODETEAM,joueur_1,TIME,DELTA_SCORE,OFF,DEF
1,TSO,P009649,0 days 00:40:54,-9,83,92
1,TSO,P012019,0 days 00:34:18,-7,64,71
1,TSO,P013293,0 days 00:32:28,5,72,67
1,TSO,P013295,0 days 00:31:21,-9,67,76
1,TSO,P013296,0 days 00:28:54,-11,53,64
1,TSO,P013298,0 days 00:27:20,2,60,58
1,TSO,P008790,0 days 00:16:06,8,40,32
1,TSO,P013297,0 days 00:13:39,6,26,20
1,ULM,P013290,0 days 00:39:55,6,85,79
1,ULM,P011437,0 days 00:35:18,5,78,73
1,ULM,P011391,0 days 00:27:04,-1,63,64
1,ULM,P006997,0 days 00:24:43,11,51,40
1,ULM,P012077,0 days 00:23:52,-10,50,60
1,ULM,P013291,0 days 00:21:33,9,46,37
1,ULM,P006245,0 days 00:14:43,12,33,21
1,ULM,P012602,0 days 00:12:56,1,24,23
1,ULM,P013289,0 days 00:09:51,1,21,20
1,ULM,P010726,0 days 00:08:16,-5,18,23
1,ULM,P007952,0 days 00:06:49,-14,11,25
2,JOV,P013287,0 days 00:27:09,15,62,47
2,JOV,P013285,0 days 00:26:35,8,55,47
2,JOV,P002507,0 days 00:23:00,12,49,37
2,JOV,P010161,0 days 00:20:14,18,48,30
2,JOV,P005099,0 days 00:19:31,-16,29,45
2,JOV,P002361,0 days 00:18:54,-3,41,44
2,JOV,P012740,0 days 00:17:26,-8,25,33
2,JOV,P004834,0 days 00:16:58,-7,29,36
2,JOV,P012349,0 days 00:12:34,-14,16,30
2,JOV,P013286,0 days 00:09:53,-2,14,16
2,JOV,PJUG,0 days 00:07:46,12,22,10
2,HTA,P001927,0 days 00:33:47,-1,65,66
2,HTA,P005181,0 days 00:31:47,7,68,61
2,HTA,P013284,0 days 00:29:04,-3,58,61
2,HTA,P012096,0 days 00:25:15,10,54,44
2,HTA,P011157,0 days 00:19:57,-13,29,42
2,HTA,P010386,0 days 00:18:24,-15,29,44
2,HTA,P009818,0 days 00:15:36,-10,23,33
2,HTA,P013283,0 days 00:14:18,12,34,22
2,HTA,P010550,0 days 00:08:42,-2,12,14
2,HTA,P011386,0 days 00:03:10,0,3,3
3,WOL,P012003,0 days 00:32:32,-3,60,63
3,WOL,P011248,0 days 00:30:14,-19,54,73
3,WOL,P006546,0 days 00:26:47,-7,54,61
3,WOL,P012577,0 days 00:26:45,-22,43,65
3,WOL,P012789,0 days 00:20:05,-18,27,45
3,WOL,P005516,0 days 00:17:49,-1,25,26
3,WOL,P008186,0 days 00:17:00,8,33,25
3,WOL,P004645,0 days 00:15:56,7,32,25
3,WOL,P006853,0 days 00:09:36,-1,11,12
3,WOL,P003212,0 days 00:03:16,1,6,5
3,BAH,P003840,0 days 00:34:30,18,76,58
3,BAH,P011821,0 days 00:29:35,12,67,55
3,BAH,P011823,0 days 00:25:57,19,57,38
3,BAH,P009601,0 days 00:22:42,3,52,49
3,BAH,P011192,0 days 00:22:21,6,41,35
3,BAH,P004172,0 days 00:18:47,7,36,29
3,BAH,P012711,0 days 00:18:46,5,31,26
3,BAH,P011201,0 days 00:14:47,-7,20,27
3,BAH,P012405,0 days 00:12:28,-5,20,25
3,BAH,P008278,0 days 00:00:07,-3,0,3
4,BES,P010652,0 days 00:25:18,21,64,43
4,BES,P011927,0 days 00:23:24,3,46,43
4,BES,P008945,0 days 00:23:23,9,60,51
4,BES,P013255,0 days 00:22:53,5,48,43
4,BES,P011924,0 days 00:20:02,5,44,39
4,BES,P011936,0 days 00:19:25,8,40,32
4,BES,P009680,0 days 00:17:59,13,51,38
4,BES,P003783,0 days 00:17:13,14,44,30
4,BES,P007914,0 days 00:17:10,13,46,33
4,BES,P011379,0 days 00:13:13,-1,27,28
4,BUD,P008325,0 days 00:30:28,-10,63,73
4,BUD,P011150,0 days 00:30:02,-6,61,67
4,BUD,P012630,0 days 00:22:09,-10,43,53
4,BUD,P013256,0 days 00:21:44,-1,44,45
4,BUD,P011281,0 days 00:20:28,-20,36,56
4,BUD,P012606,0 days 00:19:32,2,40,38
4,BUD,P005637,0 days 00:18:16,-17,32,49
4,BUD,P006566,0 days 00:15:42,-6,22,28
4,BUD,P013258,0 days 00:08:51,-12,16,28
4,BUD,P006561,0 days 00:07:35,-10,9,19
4,BUD,P010307,0 days 00:03:19,-2,10,12
4,BUD,P013259,0 days 00:01:54,2,4,2
5,CAN,P008121,0 days 00:28:03,7,59,52
5,CAN,P003425,0 days 00:26:12,5,54,49
5,CAN,P008966,0 days 00:24:26,6,54,48
5,CAN,P006588,0 days 00:22:25,8,48,40
5,CAN,P012095,0 days 00:21:57,7,48,41
5,CAN,P011251,0 days 00:18:03,-4,36,40
5,CAN,P010452,0 days 00:17:35,-5,36,41
5,CAN,P012016,0 days 00:15:34,-3,30,33
5,CAN,P010623,0 days 00:13:48,-2,30,32
5,CAN,P007560,0 days 00:07:10,-4,16,20
5,CAN,P005005,0 days 00:04:47,0,9,9
5,TRN,P013272,0 days 00:28:20,-2,54,56
5,TRN,P013270,0 days 00:27:52,3,65,62
5,TRN,P012593,0 days 00:27:51,-3,60,63
5,TRN,P005438,0 days 00:26:28,0,55,55
5,TRN,P013271,0 days 00:25:31,0,48,48
5,TRN,P006724,0 days 00:21:44,-1,48,49
5,TRN,P013269,0 days 00:20:46,-7,34,41
5,TRN,P006382,0 days 00:11:06,1,19,18
5,TRN,P012687,0 days 00:10:22,-6,22,28
6,JER,P010587,0 days 00:30:19,-15,45,60
6,JER,P006625,0 days 00:27:37,-9,45,54
6,JER,P011970,0 days 00:27:35,-8,54,62
6,JER,P013278,0 days 00:24:14,1,46,45
6,JER,P013277,0 days 00:19:57,-7,33,40
6,JER,P013279,0 days 00:19:42,-5,35,40
6,JER,P009879,0 days 00:16:08,-8,17,25
6,JER,P013276,0 days 00:14:42,-19,13,32
6,JER,P010431,0 days 00:10:39,-2,20,22
6,JER,P013281,0 days 00:09:07,-8,12,20
6,PAM,P011982,0 days 00:23:53,0,44,44
6,PAM,P010042,0 days 00:23:16,26,53,27
6,PAM,P007527,0 days 00:21:55,-2,42,44
6,PAM,P010393,0 days 00:21:39,13,47,34
6,PAM,P004863,0 days 00:18:12,18,38,20
6,PAM,P006643,0 days 00:17:48,20,40,20
6,PAM,P010444,0 days 00:16:53,17,38,21
6,PAM,P011980,0 days 00:16:40,-1,29,30
6,PAM,P005356,0 days 00:16:37,-10,27,37
6,PAM,P012738,0 days 00:14:41,4,29,25
6,PAM,P009864,0 days 00:08:26,-5,13,18
7,HAM,P013308,0 days 00:25:05,-10,53,63
7,HAM,P003242,0 days 00:25:04,-9,51,60
7,HAM,P006006,0 days 00:19:42,-7,42,49
7,HAM,P013311,0 days 00:18:32,-1,44,45
7,HAM,P008103,0 days 00:16:33,-11,34,45
7,HAM,P013312,0 days 00:16:14,-15,28,43
7,HAM,P011256,0 days 00:15:29,-19,20,39
7,HAM,P013313,0 days 00:15:03,-9,26,35
7,HAM,P006420,0 days 00:14:56,-9,30,39
7,HAM,P013309,0 days 00:14:53,-5,32,37
7,HAM,P012695,0 days 00:12:28,0,29,29
7,HAM,P010070,0 days 00:06:01,-5,11,16
7,BOU,P013265,0 days 00:26:08,11,65,54
7,BOU,P013266,0 days 00:25:09,13,62,49
7,BOU,P004525,0 days 00:21:27,14,53,39
7,BOU,P013264,0 days 00:21:14,6,54,48
7,BOU,P010449,0 days 00:20:19,28,58,30
7,BOU,P006904,0 days 00:19:41,-8,42,50
7,BOU,P009552,0 days 00:19:10,8,49,41
7,BOU,P011837,0 days 00:18:09,12,44,32
7,BOU,P009556,0 days 00:14:51,7,38,31
7,BOU,P004945,0 days 00:13:52,9,35,26
8,CLU,P010651,0 days 00:32:32,-7,70,77
8,CLU,P013302,0 days 00:30:40,2,68,66
8,CLU,P012698,0 days 00:26:30,-10,52,62
8,CLU,P013304,0 days 00:25:56,-1,56,57
8,CLU,P002820,0 days 00:24:21,-4,50,54
8,CLU,P005714,0 days 00:15:44,-6,33,39
8,CLU,P011801,0 days 00:12:25,0,28,28
8,CLU,P004862,0 days 00:11:30,-6,28,34
8,CLU,P006618,0 days 00:11:29,-1,27,28
8,CLU,P012620,0 days 00:08:53,-2,18,20
8,LJU,P012042,0 days 00:28:41,5,68,63
8,LJU,P012700,0 days 00:28:33,1,66,65
8,LJU,P013261,0 days 00:25:44,14,67,53
8,LJU,P012996,0 days 00:23:59,2,56,54
8,LJU,P013260,0 days 00:22:09,2,51,49
8,LJU,P003452,0 days 00:19:54,-7,39,46
8,LJU,P003703,0 days 00:18:04,8,45,37
8,LJU,P009753,0 days 00:13:10,8,30,22
8,LJU,P013262,0 days 00:11:19,2,25,23
8,LJU,P009392,0 days 00:05:36,3,11,8
8,LJU,P013263,0 days 00:02:51,-3,7,10
9,VNC,P007759,0 days 00:29:03,24,72,48
9,VNC,P008858,0 days 00:28:37,20,67,47
9,VNC,P011909,0 days 00:28:32,17,70,53
9,VNC,P011928,0 days 00:26:00,17,61,44
9,VNC,P012796,0 days 00:25:00,0,53,53
9,VNC,P013305,0 days 00:20:25,4,48,44
9,VNC,P003759,0 days 00:15:00,20,42,22
9,VNC,P005404,0 days 00:13:00,-1,31,32
9,VNC,P009400,0 days 00:09:50,-1,22,23
9,VNC,P006571,0 days 00:04:33,0,9,9
9,ARI,P008084,0 days 00:28:52,-19,51,70
9,ARI,P004292,0 days 00:22:25,-10,37,47
9,ARI,P013249,0 days 00:22:02,-18,31,49
9,ARI,P013250,0 days 00:21:16,-5,50,55
9,ARI,P003240,0 days 00:21:11,-10,37,47
9,ARI,P013356,0 days 00:20:34,-5,42,47
9,ARI,P013251,0 days 00:17:10,-9,35,44
9,ARI,P013248,0 days 00:17:04,-6,38,44
9,ARI,P013252,0 days 00:14:31,2,31,29
9,ARI,P013360,0 days 00:09:49,-9,20,29
9,ARI,P013355,0 days 00:05:06,-11,3,14
10,TTK,P009025,0 days 00:32:01,6,56,50
10,TTK,P011973,0 days 00:27:53,-1,49,50
10,TTK,P011935,0 days 00:25:38,-2,43,45
10,TTK,P012259,0 days 00:25:01,-4,42,46
10,TTK,P006598,0 days 00:23:00,4,41,37
10,TTK,P004218,0 days 00:17:06,-1,29,30
10,TTK,P013300,0 days 00:17:00,12,33,21
10,TTK,P004056,0 days 00:13:37,4,28,24
10,TTK,P012415,0 days 00:10:06,8,23,15
10,TTK,P007917,0 days 00:04:42,-1,7,8
10,TTK,P004619,0 days 00:03:56,5,9,4
10,LKB,P006586,0 days 00:31:31,10,58,48
10,LKB,P005656,0 days 00:25:22,1,46,45
10,LKB,P005521,0 days 00:25:19,-2,46,48
10,LKB,P013247,0 days 00:23:55,4,46,42
10,LKB,PLXI,0 days 00:23:40,-12,31,43
10,LKB,P009299,0 days 00:20:19,-7,33,40
10,LKB,P010461,0 days 00:18:24,0,33,33
10,LKB,P009898,0 days 00:17:02,-12,20,32
10,LKB,P006860,0 days 00:14:28,-12,17,29
11,TRN,P013272,0 days 00:29:06,12,65,53
11,TRN,P013270,0 days 00:28:52,9,63,54
11,TRN,P012593,0 days 00:26:22,-3,53,56
11,TRN,P013271,0 days 00:20:22,-8,40,48
11,TRN,P013269,0 days 00:20:18,3,42,39
11,TRN,P006724,0 days 00:19:38,14,44,30
11,TRN,P005438,0 days 00:17:02,6,38,32
11,TRN,P012687,0 days 00:16:05,3,35,32
11,TRN,P006382,0 days 00:11:21,0,21,21
11,TRN,P002387,0 days 00:10:54,-6,19,25
11,TSO,P012019,0 days 00:33:19,-3,66,69
11,TSO,P009649,0 days 00:31:15,-9,60,69
11,TSO,P013297,0 days 00:25:45,1,53,52
11,TSO,P013298,0 days 00:25:28,16,58,42
11,TSO,P013295,0 days 00:24:38,-5,45,50
11,TSO,P013293,0 days 00:23:16,-14,39,53
11,TSO,P008790,0 days 00:18:50,-7,36,43
11,TSO,P013296,0 days 00:10:47,-1,22,23
11,TSO,P013292,0 days 00:06:42,-8,11,19
12,BUD,P011150,0 days 00:36:18,6,71,65
12,BUD,P013256,0 days 00:35:43,20,78,58
12,BUD,P011281,0 days 00:35:39,15,78,63
12,BUD,P008325,0 days 00:34:31,23,77,54
12,BUD,P006566,0 days 00:20:18,3,45,42
12,BUD,P012630,0 days 00:17:09,-6,30,36
12,BUD,P013258,0 days 00:16:17,-9,26,35
12,BUD,P013259,0 days 00:10:29,-26,9,35
12,BUD,P012606,0 days 00:09:37,-18,8,26
12,BUD,P005637,0 days 00:08:59,-23,8,31
12,CAN,P008121,0 days 00:35:53,-10,67,77
12,CAN,P011251,0 days 00:26:55,-9,55,64
12,CAN,P008966,0 days 00:25:14,6,47,41
12,CAN,P003425,0 days 00:23:33,1,45,44
12,CAN,P010623,0 days 00:22:44,-1,44,45
12,CAN,P006588,0 days 00:22:39,-1,48,49
12,CAN,P010452,0 days 00:21:51,4,41,37
12,CAN,P012016,0 days 00:19:46,-3,42,45
12,CAN,P012095,0 days 00:17:00,15,34,19
12,CAN,P005005,0 days 00:09:07,13,22,9
12,CAN,P007560,0 days 00:00:18,0,0,0
13,BAH,P011821,0 days 00:26:37,10,57,47
13,BAH,P011192,0 days 00:26:29,19,63,44
13,BAH,P003840,0 days 00:26:15,17,57,40
13,BAH,P009601,0 days 00:25:19,14,58,44
13,BAH,P012711,0 days 00:21:35,12,47,35
13,BAH,P011823,0 days 00:21:22,20,50,30
13,BAH,P011201,0 days 00:20:56,7,40,33
13,BAH,P004172,0 days 00:19:43,10,44,34
13,BAH,P012405,0 days 00:11:44,-4,19,23
13,BES,P013255,0 days 00:27:33,-22,41,63
13,BES,P010652,0 days 00:22:29,-10,35,45
13,BES,P008945,0 days 00:22:01,-15,40,55
13,BES,P003783,0 days 00:21:28,-6,36,42
13,BES,P011936,0 days 00:19:42,-14,30,44
13,BES,P007914,0 days 00:19:24,-4,37,41
13,BES,P011927,0 days 00:19:14,0,33,33
13,BES,P009680,0 days 00:19:12,-19,30,49
13,BES,P011924,0 days 00:15:44,-10,25,35
13,BES,P011379,0 days 00:13:13,-5,23,28
14,HTA,P011157,0 days 00:30:34,8,69,61
14,HTA,P010550,0 days 00:28:37,6,63,57
14,HTA,P013284,0 days 00:28:13,11,66,55
14,HTA,P001927,0 days 00:26:37,7,58,51
14,HTA,P005181,0 days 00:23:33,5,53,48
14,HTA,P004846,0 days 00:22:39,4,52,48
14,HTA,P012096,0 days 00:13:08,-7,26,33
14,HTA,P013283,0 days 00:10:05,-5,22,27
14,HTA,P010386,0 days 00:09:19,-4,19,23
14,HTA,P009818,0 days 00:07:15,0,17,17
14,WOL,P012003,0 days 00:32:22,-4,64,68
14,WOL,P012789,0 days 00:26:48,-8,54,62
14,WOL,P011248,0 days 00:26:26,-3,55,58
14,WOL,P012577,0 days 00:25:29,6,59,53
14,WOL,P004645,0 days 00:23:34,-2,47,49
14,WOL,P006853,0 days 00:20:47,1,45,44
14,WOL,P005516,0 days 00:14:19,-3,32,35
14,WOL,P008186,0 days 00:13:53,2,32,30
14,WOL,P009306,0 days 00:10:35,-12,19,31
14,WOL,P003212,0 days 00:05:47,-2,13,15
15,ULM,P013290,0 days 00:28:52,2,64,62
15,ULM,P011437,0 days 00:24:17,0,53,53
15,ULM,P006245,0 days 00:23:35,0,55,55
15,ULM,P013291,0 days 00:23:26,-3,47,50
15,ULM,P006997,0 days 00:21:42,0,46,46
15,ULM,P011391,0 days 00:18:18,4,41,37
15,ULM,P012077,0 days 00:17:54,5,36,31
15,ULM,P010726,0 days 00:14:14,3,30,27
15,ULM,P012602,0 days 00:11:08,2,23,21
15,ULM,P007952,0 days 00:10:46,3,27,24
15,ULM,P013289,0 days 00:05:48,4,13,9
15,JOV,P013285,0 days 00:26:44,5,55,50
15,JOV,P012740,0 days 00:25:58,-6,58,64
15,JOV,P013287,0 days 00:25:48,7,58,51
15,JOV,P002507,0 days 00:20:57,1,47,46
15,JOV,P004834,0 days 00:18:49,-5,36,41
15,JOV,PJUG,0 days 00:18:01,5,47,42
15,JOV,P002361,0 days 00:17:51,4,40,36
15,JOV,P010161,0 days 00:17:17,0,29,29
15,JOV,P012349,0 days 00:14:12,-11,25,36
15,JOV,P006771,0 days 00:10:24,-15,13,28
15,JOV,P013286,0 days 00:03:59,-5,7,12
16,LKB,P006586,0 days 00:22:51,-24,36,60
16,LKB,P013247,0 days 00:22:19,-1,45,46
16,LKB,P005521,0 days 00:21:24,-3,40,43
16,LKB,P009299,0 days 00:21:20,-7,44,51
16,LKB,P005113,0 days 00:20:57,2,44,42
16,LKB,P005656,0 days 00:20:57,10,47,37
16,LKB,PLXI,0 days 00:20:29,-25,34,59
16,LKB,P009898,0 days 00:19:33,-18,33,51
16,LKB,P010461,0 days 00:19:03,-22,30,52
16,LKB,P006860,0 days 00:11:07,-12,17,29
16,JER,P006625,0 days 00:31:02,24,81,57
16,JER,P011970,0 days 00:30:02,22,73,51
16,JER,P010587,0 days 00:28:39,15,73,58
16,JER,P013276,0 days 00:21:06,23,54,31
16,JER,P013277,0 days 00:20:34,-7,39,46
16,JER,P010431,0 days 00:19:23,29,55,26
16,JER,P008912,0 days 00:18:51,-9,34,43
16,JER,P013278,0 days 00:12:34,-14,21,35
16,JER,P013279,0 days 00:12:22,10,26,16
16,JER,P013281,0 days 00:05:27,7,14,7
17,ARI,P008084,0 days 00:30:17,-3,52,55
17,ARI,P013250,0 days 00:27:29,-8,44,52
17,ARI,P013249,0 days 00:26:16,-3,46,49
17,ARI,P004292,0 days 00:24:06,0,38,38
17,ARI,P013252,0 days 00:23:16,-6,32,38
17,ARI,P003240,0 days 00:20:00,-4,28,32
17,ARI,P013251,0 days 00:19:16,2,31,29
17,ARI,P013248,0 days 00:12:04,5,27,22
17,ARI,P013356,0 days 00:09:50,-1,13,14
17,ARI,P013355,0 days 00:04:15,-4,2,6
17,ARI,P013360,0 days 00:03:07,-5,0,5
17,ARI,P013049,0 days 00:00:04,2,2,0
17,TTK,P009025,0 days 00:34:40,7,62,55
17,TTK,P011973,0 days 00:33:17,2,57,55
17,TTK,P006598,0 days 00:29:18,16,54,38
17,TTK,P013300,0 days 00:27:39,1,43,42
17,TTK,P004218,0 days 00:19:32,2,32,30
17,TTK,P012259,0 days 00:18:37,-8,32,40
17,TTK,P004056,0 days 00:14:38,0,27,27
17,TTK,P011935,0 days 00:11:13,7,17,10
17,TTK,P007917,0 days 00:06:53,-2,10,12
17,TTK,P004619,0 days 00:02:36,1,6,5
17,TTK,P012415,0 days 00:01:37,-1,0,1
18,LJU,P012042,0 days 00:29:14,3,64,61
18,LJU,P003703,0 days 00:27:12,5,56,51
18,LJU,P003452,0 days 00:25:14,3,58,55
18,LJU,P009392,0 days 00:20:54,14,51,37
18,LJU,P009753,0 days 00:20:36,-6,39,45
18,LJU,P012700,0 days 00:19:43,-13,34,47
18,LJU,P013263,0 days 00:17:13,12,42,30
18,LJU,P013260,0 days 00:15:39,3,37,34
18,LJU,P013261,0 days 00:11:54,1,25,24
18,LJU,P013262,0 days 00:10:19,5,24,19
18,LJU,P012996,0 days 00:02:02,-2,5,7
18,VNC,P008858,0 days 00:31:59,-9,63,72
18,VNC,P005404,0 days 00:31:36,1,71,70
18,VNC,P012796,0 days 00:29:25,7,63,56
18,VNC,P011909,0 days 00:23:53,10,53,43
18,VNC,P011928,0 days 00:21:53,10,53,43
18,VNC,P008052,0 days 00:20:13,-15,38,53
18,VNC,P009400,0 days 00:18:32,-1,39,40
18,VNC,P013305,0 days 00:14:01,-16,20,36
18,VNC,P003759,0 days 00:07:25,-9,10,19
18,VNC,P006571,0 days 00:01:03,-3,0,3
19,BOU,P013266,0 days 00:24:32,3,53,50
19,BOU,P013265,0 days 00:22:57,8,50,42
19,BOU,P011837,0 days 00:22:04,6,50,44
19,BOU,P013264,0 days 00:20:50,1,41,40
19,BOU,P010449,0 days 00:20:41,13,48,35
19,BOU,P004525,0 days 00:20:21,11,46,35
19,BOU,P006904,0 days 00:19:19,-2,36,38
19,BOU,P010450,0 days 00:17:21,4,35,31
19,BOU,P009552,0 days 00:16:45,4,31,27
19,BOU,P009556,0 days 00:09:49,9,21,12
19,BOU,P004945,0 days 00:05:21,-2,9,11
19,CLU,P013302,0 days 00:29:40,7,62,55
19,CLU,P012698,0 days 00:24:48,4,52,48
19,CLU,P013304,0 days 00:24:40,10,52,42
19,CLU,P002820,0 days 00:23:31,-1,46,47
19,CLU,P006618,0 days 00:22:32,-13,39,52
19,CLU,P005714,0 days 00:16:08,-13,26,39
19,CLU,P011801,0 days 00:15:57,-23,17,40
19,CLU,P010651,0 days 00:15:03,-2,28,30
19,CLU,P012620,0 days 00:14:32,-7,26,33
19,CLU,P004862,0 days 00:13:09,-17,17,34
20,PAM,P010042,0 days 00:23:35,4,55,51
20,PAM,P010393,0 days 00:22:38,9,59,50
20,PAM,P007527,0 days 00:20:15,13,55,42
20,PAM,P011982,0 days 00:19:46,7,48,41
20,PAM,P011980,0 days 00:17:22,18,46,28
20,PAM,P006643,0 days 00:17:01,19,50,31
20,PAM,P004863,0 days 00:15:52,18,45,27
20,PAM,P010444,0 days 00:13:47,14,40,26
20,PAM,P005356,0 days 00:13:37,14,38,24
20,PAM,P012738,0 days 00:13:16,20,40,20
20,PAM,P009864,0 days 00:12:57,-7,25,32
20,PAM,P004548,0 days 00:09:54,6,24,18
20,HAM,P013312,0 days 00:29:11,-4,65,69
20,HAM,P013309,0 days 00:24:51,-10,50,60
20,HAM,P003242,0 days 00:23:22,-7,51,58
20,HAM,P013313,0 days 00:20:43,1,50,49
20,HAM,P013308,0 days 00:18:46,-14,36,50
20,HAM,P013311,0 days 00:18:21,-13,34,47
20,HAM,P011256,0 days 00:17:28,-17,36,53
20,HAM,P010070,0 days 00:17:12,-20,27,47
20,HAM,P006006,0 days 00:12:46,-11,23,34
20,HAM,P006420,0 days 00:10:31,-21,13,34
20,HAM,P012695,0 days 00:06:49,-19,5,24
21,TSO,P009649,0 days 00:33:03,5,66,61
21,TSO,P012019,0 days 00:29:00,-9,48,57
21,TSO,P013295,0 days 00:26:06,10,48,38
21,TSO,P013297,0 days 00:23:34,-13,34,47
21,TSO,P003885,0 days 00:19:22,5,44,39
21,TSO,P013298,0 days 00:19:09,-10,38,48
21,TSO,P013296,0 days 00:18:46,1,33,32
21,TSO,P008790,0 days 00:18:18,-3,35,38
21,TSO,P013293,0 days 00:10:18,-5,16,21
21,TSO,P013292,0 days 00:02:24,-6,3,9
21,JOV,P013287,0 days 00:31:31,10,62,52
21,JOV,P012740,0 days 00:27:30,6,62,56
21,JOV,P013285,0 days 00:27:12,13,53,40
21,JOV,P002507,0 days 00:23:31,-1,37,38
21,JOV,P005099,0 days 00:21:42,1,50,49
21,JOV,P002361,0 days 00:18:36,9,42,33
21,JOV,P004834,0 days 00:16:29,6,41,35
21,JOV,P010161,0 days 00:15:43,-3,22,25
21,JOV,P012349,0 days 00:08:27,-8,13,21
21,JOV,P013286,0 days 00:06:12,-7,3,10
21,JOV,P006771,0 days 00:03:07,-1,5,6
22,WOL,P005516,0 days 00:31:50,-9,61,70
22,WOL,P006546,0 days 00:28:18,-11,56,67
22,WOL,P011248,0 days 00:27:46,-17,51,68
22,WOL,P012577,0 days 00:25:45,-6,56,62
22,WOL,P012003,0 days 00:25:20,-7,50,57
22,WOL,P012789,0 days 00:24:31,-12,48,60
22,WOL,P004645,0 days 00:18:50,-14,31,45
22,WOL,P008186,0 days 00:14:12,-12,19,31
22,WOL,P009306,0 days 00:03:28,-2,8,10
22,ULM,P013290,0 days 00:36:38,15,87,72
22,ULM,P011391,0 days 00:30:44,22,78,56
22,ULM,P006245,0 days 00:27:17,16,67,51
22,ULM,P006997,0 days 00:24:53,1,51,50
22,ULM,P012077,0 days 00:18:50,10,48,38
22,ULM,P011437,0 days 00:18:12,6,36,30
22,ULM,P010726,0 days 00:15:30,11,41,30
22,ULM,P013291,0 days 00:11:57,5,25,20
22,ULM,P007952,0 days 00:10:39,3,26,23
22,ULM,P012602,0 days 00:05:20,1,11,10
23,BES,P011924,0 days 00:28:30,-13,62,75
23,BES,P011927,0 days 00:28:06,-4,65,69
23,BES,P013255,0 days 00:28:04,-31,50,81
23,BES,P007914,0 days 00:27:12,2,64,62
23,BES,P008945,0 days 00:25:31,-2,61,63
23,BES,P011379,0 days 00:20:01,-22,38,60
23,BES,P009680,0 days 00:16:27,-10,29,39
23,BES,P010652,0 days 00:14:30,11,40,29
23,BES,P003783,0 days 00:11:39,-1,26,27
23,HTA,P004846,0 days 00:30:29,24,85,61
23,HTA,P013284,0 days 00:28:30,24,78,54
23,HTA,P001927,0 days 00:28:09,37,84,47
23,HTA,P010386,0 days 00:26:17,8,68,60
23,HTA,P011157,0 days 00:26:02,36,78,42
23,HTA,P010550,0 days 00:24:20,2,56,54
23,HTA,P012096,0 days 00:13:11,-22,21,43
23,HTA,P011386,0 days 00:10:36,-17,16,33
23,HTA,P005181,0 days 00:06:56,-11,12,23
23,HTA,P010465,0 days 00:05:30,-11,7,18
24,CAN,P008121,0 days 00:29:26,16,60,44
24,CAN,P011251,0 days 00:24:54,13,50,37
24,CAN,P006588,0 days 00:24:01,-14,34,48
24,CAN,P003425,0 days 00:23:58,17,52,35
24,CAN,P008966,0 days 00:20:07,21,43,22
24,CAN,P010452,0 days 00:19:24,13,38,25
24,CAN,P012095,0 days 00:17:11,-14,15,29
24,CAN,P010623,0 days 00:16:13,-14,14,28
24,CAN,P012016,0 days 00:16:06,-14,17,31
24,CAN,P005005,0 days 00:05:04,-6,0,6
24,CAN,P007560,0 days 00:03:36,-3,7,10
24,BAH,P011192,0 days 00:34:06,-2,60,62
24,BAH,P012711,0 days 00:28:03,-10,46,56
24,BAH,P011823,0 days 00:23:29,-5,39,44
24,BAH,P011201,0 days 00:23:20,1,38,37
24,BAH,P004172,0 days 00:22:45,1,32,31
24,BAH,P011821,0 days 00:21:29,-3,28,31
24,BAH,P003840,0 days 00:18:31,-6,31,37
24,BAH,P009601,0 days 00:17:49,1,27,26
24,BAH,P012405,0 days 00:10:28,8,14,6
25,TRN,P013271,0 days 00:29:56,-9,54,63
25,TRN,P012593,0 days 00:29:43,-19,49,68
25,TRN,P013272,0 days 00:26:07,-15,42,57
25,TRN,P013269,0 days 00:24:17,-10,40,50
25,TRN,P012687,0 days 00:21:18,-34,22,56
25,TRN,P013270,0 days 00:20:06,-2,38,40
25,TRN,P006724,0 days 00:19:34,-9,32,41
25,TRN,P005438,0 days 00:16:11,-5,27,32
25,TRN,P006382,0 days 00:12:48,-2,16,18
25,BUD,P011281,0 days 00:26:08,16,57,41
25,BUD,P011150,0 days 00:25:55,24,60,36
25,BUD,P005637,0 days 00:25:21,22,58,36
25,BUD,P008325,0 days 00:20:44,2,44,42
25,BUD,P012606,0 days 00:18:12,4,34,30
25,BUD,P006566,0 days 00:15:44,7,32,25
25,BUD,P006561,0 days 00:14:48,1,26,25
25,BUD,P013258,0 days 00:14:00,5,28,23
25,BUD,P012630,0 days 00:13:03,4,27,23
25,BUD,P004222,0 days 00:11:45,10,24,14
25,BUD,P010307,0 days 00:07:12,2,19,17
25,BUD,P013259,0 days 00:07:08,8,16,8
26,JER,P011970,0 days 00:27:49,8,66,58
26,JER,P010587,0 days 00:26:55,21,67,46
26,JER,P013277,0 days 00:24:17,14,58,44
26,JER,P013278,0 days 00:23:16,14,53,39
26,JER,P006625,0 days 00:21:47,15,51,36
26,JER,P010431,0 days 00:19:04,5,35,30
26,JER,P013276,0 days 00:18:08,-4,38,42
26,JER,P009879,0 days 00:13:32,-5,25,30
26,JER,P013279,0 days 00:13:15,3,26,23
26,JER,P013281,0 days 00:11:57,4,26,22
26,HAM,P013309,0 days 00:26:36,-2,55,57
26,HAM,P011256,0 days 00:26:09,-10,52,62
26,HAM,P013308,0 days 00:24:38,-21,33,54
26,HAM,P013312,0 days 00:24:33,-8,54,62
26,HAM,P003242,0 days 00:23:58,-12,43,55
26,HAM,P012695,0 days 00:22:55,-6,49,55
26,HAM,P006006,0 days 00:17:47,-14,25,39
26,HAM,P006420,0 days 00:15:27,-7,20,27
26,HAM,P010070,0 days 00:11:06,4,21,17
26,HAM,P013310,0 days 00:06:51,1,18,17
27,CLU,P002820,0 days 00:24:34,-9,54,63
27,CLU,P004862,0 days 00:23:23,-8,49,57
27,CLU,P006618,0 days 00:23:21,2,62,60
27,CLU,P013302,0 days 00:23:12,-8,51,59
27,CLU,P012698,0 days 00:22:40,-8,57,65
27,CLU,P005714,0 days 00:18:58,0,43,43
27,CLU,P011801,0 days 00:18:28,-2,48,50
27,CLU,P013304,0 days 00:16:30,-11,34,45
27,CLU,P011797,0 days 00:15:01,5,47,42
27,CLU,P010651,0 days 00:13:53,-6,35,41
27,PAM,P011982,0 days 00:25:42,11,66,55
27,PAM,P007527,0 days 00:23:15,-5,52,57
27,PAM,P010393,0 days 00:23:08,-4,53,57
27,PAM,P010042,0 days 00:22:53,0,49,49
27,PAM,P005356,0 days 00:21:50,28,79,51
27,PAM,P004863,0 days 00:20:26,7,62,55
27,PAM,P010444,0 days 00:14:27,5,40,35
27,PAM,P011980,0 days 00:14:21,8,43,35
27,PAM,P009864,0 days 00:11:39,5,31,26
27,PAM,P012738,0 days 00:09:58,-5,22,27
27,PAM,P006643,0 days 00:08:01,-4,21,25
27,PAM,P010750,0 days 00:04:20,-1,7,8
28,VNC,P013305,0 days 00:34:37,-17,60,77
28,VNC,P005404,0 days 00:32:52,-9,57,66
28,VNC,P012796,0 days 00:27:33,3,51,48
28,VNC,P009400,0 days 00:26:35,-12,38,50
28,VNC,P011928,0 days 00:24:04,-5,38,43
28,VNC,P008052,0 days 00:23:06,-33,35,68
28,VNC,P005177,0 days 00:23:03,-19,41,60
28,VNC,P006571,0 days 00:08:10,-18,10,28
28,BOU,P010449,0 days 00:24:18,9,52,43
28,BOU,P013265,0 days 00:23:58,5,47,42
28,BOU,P004525,0 days 00:22:01,8,48,40
28,BOU,P009552,0 days 00:19:50,12,46,34
28,BOU,P013264,0 days 00:18:47,13,43,30
28,BOU,P013266,0 days 00:18:33,-2,34,36
28,BOU,P010450,0 days 00:17:43,20,44,24
28,BOU,P011837,0 days 00:17:41,8,36,28
28,BOU,P006904,0 days 00:15:42,13,36,23
28,BOU,P009556,0 days 00:14:16,14,34,20
28,BOU,P004945,0 days 00:07:11,10,20,10
29,TTK,P009025,0 days 00:35:17,10,71,61
29,TTK,P011973,0 days 00:34:21,13,69,56
29,TTK,P011935,0 days 00:31:31,3,61,58
29,TTK,P006598,0 days 00:29:49,7,59,52
29,TTK,P013300,0 days 00:24:32,3,48,45
29,TTK,P004056,0 days 00:12:27,5,27,22
29,TTK,P012415,0 days 00:11:42,5,16,11
29,TTK,P012259,0 days 00:08:42,0,20,20
29,TTK,P007917,0 days 00:07:44,-2,11,13
29,TTK,P004619,0 days 00:03:15,-3,7,10
29,TTK,P010811,0 days 00:00:40,-1,1,2
29,LJU,P003703,0 days 00:30:33,-13,50,63
29,LJU,P012042,0 days 00:26:50,-8,45,53
29,LJU,P003452,0 days 00:23:32,-17,40,57
29,LJU,P012700,0 days 00:22:10,-3,38,41
29,LJU,P013260,0 days 00:20:26,2,39,37
29,LJU,P012996,0 days 00:15:31,-5,26,31
29,LJU,P011261,0 days 00:13:31,5,26,21
29,LJU,P009753,0 days 00:12:52,-9,19,28
29,LJU,P009431,0 days 00:12:11,0,23,23
29,LJU,P013263,0 days 00:11:15,5,23,18
29,LJU,P009392,0 days 00:11:09,3,21,18
30,LKB,PLXI,0 days 00:27:37,-8,58,66
30,LKB,P009299,0 days 00:26:47,-11,47,58
30,LKB,P005656,0 days 00:24:04,-12,39,51
30,LKB,P010461,0 days 00:23:47,-15,43,58
30,LKB,P005521,0 days 00:23:32,-7,46,53
30,LKB,P013247,0 days 00:20:12,-8,36,44
30,LKB,P006586,0 days 00:19:50,-20,32,52
30,LKB,P009898,0 days 00:19:48,-10,38,48
30,LKB,P006212,0 days 00:14:23,1,31,30
30,ARI,P003240,0 days 00:26:08,12,60,48
30,ARI,P013251,0 days 00:22:12,13,53,40
30,ARI,P004292,0 days 00:22:03,9,52,43
30,ARI,P013250,0 days 00:21:07,13,49,36
30,ARI,P008084,0 days 00:20:43,7,38,31
30,ARI,P013356,0 days 00:19:17,11,54,43
30,ARI,P013355,0 days 00:19:01,10,49,39
30,ARI,P013249,0 days 00:16:43,3,37,34
30,ARI,P013248,0 days 00:13:08,-2,18,20
30,ARI,P013375,0 days 00:10:50,4,25,21
30,ARI,P013252,0 days 00:07:51,10,25,15
30,ARI,P013360,0 days 00:00:57,0,0,0
