Gamecode,CODETEAM,J1,J2,TIME,DELTA_SCORE,OFF,DEF
1,ASV,P002100,P004194,22.65,-17,45,62
1,ASV,P002100,P006568,5.433,-4,11,15
1,ASV,P002100,P011225,21.6,-21,40,61
1,ASV,P002100,P012080,24.017,-22,47,69
1,ASV,P002100,P012729,7.984,-10,14,24
1,ASV,P002100,P012730,15.167,-19,28,47
1,ASV,P002100,P012731,4.017,-4,9,13
1,ASV,P002100,P012732,1.6,-3,2,5
1,ASV,P004194,P006568,3.833,-1,9,10
1,ASV,P004194,P011225,21.033,-16,40,56
1,ASV,P004194,P012080,22.65,-17,45,62
1,ASV,P004194,P012729,5.017,-2,10,12
1,ASV,P004194,P012730,13.8,-14,26,40
1,ASV,P004194,P012731,1.617,-1,5,6
1,ASV,P006568,P011225,5.516,-1,11,12
1,ASV,P006568,P011386,3.3,-1,2,3
1,ASV,P006568,P012080,5.516,-1,11,12
1,ASV,P006568,P012729,6.583,-4,6,10
1,ASV,P006568,P012731,4.9,-4,4,8
1,ASV,P006568,P012732,6.583,-4,6,10
1,ASV,P011225,P012080,27.05,-17,51,68
1,ASV,P011225,P012729,13.684,0,27,27
1,ASV,P011225,P012730,19.167,-11,36,47
1,ASV,P011225,P012731,2.65,3,6,3
1,ASV,P011225,P012732,8.1,7,17,10
1,ASV,P011386,P012080,0.483,-2,0,2
1,ASV,P011386,P012729,6.283,-3,7,10
1,ASV,P011386,P012730,2.983,-2,5,7
1,ASV,P011386,P012731,5.8,-1,7,8
1,ASV,P011386,P012732,6.283,-3,7,10
1,ASV,P012080,P012729,12.317,-5,23,28
1,ASV,P012080,P012730,19.417,-17,37,54
1,ASV,P012080,P012731,2.417,-1,7,8
1,ASV,P012080,P012732,5.933,2,11,9
1,ASV,P012729,P012730,10.767,0,22,22
1,ASV,P012729,P012731,10.85,-1,17,18
1,ASV,P012729,P012732,15.983,1,26,25
1,ASV,P012730,P012731,7.567,2,18,16
1,ASV,P012730,P012732,9.4,5,20,15
1,ASV,P012731,P012732,10.05,-1,15,16
1,RED,P000848,P002553,6.751,12,21,9
1,RED,P000848,P003479,5.634,2,15,13
1,RED,P000848,P004720,3.55,-4,5,9
1,RED,P000848,P005099,9.717,-3,13,16
1,RED,P000848,P006436,6.318,9,18,9
1,RED,P000848,P008966,8.584,0,11,11
1,RED,P000848,P011224,5.351,7,14,7
1,RED,P000848,P011964,7.583,-5,8,13
1,RED,P000848,P012711,5.083,-3,7,10
1,RED,P000848,PJDR,6.883,1,10,9
1,RED,P000848,PLUO,2.35,-4,2,6
1,RED,P002553,P003479,3.284,6,13,7
1,RED,P002553,P004720,1.517,3,4,1
1,RED,P002553,P005099,11.65,10,30,20
1,RED,P002553,P006436,19.317,14,51,37
1,RED,P002553,P008966,4.417,6,10,4
1,RED,P002553,P011224,13.817,10,34,24
1,RED,P002553,P011964,6.967,4,17,13
1,RED,P002553,P012711,6.866,4,18,14
1,RED,P002553,PJDR,7.717,10,24,14
1,RED,P002553,PLUO,3.833,1,10,9
1,RED,P003479,P005099,1.867,2,5,3
1,RED,P003479,P006436,9.167,13,34,21
1,RED,P003479,P011224,8.2,11,30,19
1,RED,P003479,P012711,8.933,6,26,20
1,RED,P003479,PJDR,2.85,2,7,5
1,RED,P003479,PLUO,8.933,6,26,20
1,RED,P004720,P005099,5.067,-1,9,10
1,RED,P004720,P008966,2.667,-2,5,7
1,RED,P004720,P011964,5.067,-1,9,10
1,RED,P004720,P012711,0.883,-2,0,2
1,RED,P004720,PJDR,1.517,3,4,1
1,RED,P005099,P006436,11.383,4,25,21
1,RED,P005099,P008966,11.45,0,17,17
1,RED,P005099,P011224,5.167,2,10,8
1,RED,P005099,P011964,14.55,-1,25,26
1,RED,P005099,P012711,4.916,-3,7,10
1,RED,P005099,PJDR,12.466,7,25,18
1,RED,P005099,PLUO,1.167,-1,2,3
1,RED,P006436,P008966,6.367,6,12,6
1,RED,P006436,P011224,20.667,20,58,38
1,RED,P006436,P011964,5.45,1,13,12
1,RED,P006436,P012711,15.132,14,44,30
1,RED,P006436,PJDR,7.183,4,19,15
1,RED,P006436,PLUO,10.416,11,34,23
1,RED,P008966,P011224,4.684,6,10,4
1,RED,P008966,P011964,6.7,-3,8,11
1,RED,P008966,P012711,1.683,0,2,2
1,RED,P008966,PJDR,5.716,-1,5,6
1,RED,P011224,P011964,0.917,-1,0,1
1,RED,P011224,P012711,13.449,14,42,28
1,RED,P011224,PLUO,10.416,11,34,23
1,RED,P011964,P012711,0.883,-2,0,2
1,RED,P011964,PJDR,10.083,4,20,16
1,RED,P012711,PJDR,2.866,-3,2,5
1,RED,P012711,PLUO,12.766,7,36,29
1,RED,PJDR,PLUO,1.183,-3,0,3
2,BAR,P000925,P002939,12.233,5,24,19
2,BAR,P000925,P003478,12.683,13,27,14
2,BAR,P000925,P004866,11.65,3,22,19
2,BAR,P000925,P006435,13.516,5,24,19
2,BAR,P000925,P007464,0.933,0,2,2
2,BAR,P000925,P007519,9.733,9,23,14
2,BAR,P000925,P009992,7.517,9,21,12
2,BAR,P000925,P011244,10.25,1,23,22
2,BAR,P000925,P012745,9.349,11,22,11
2,BAR,P002939,P003196,9.25,0,24,24
2,BAR,P002939,P003478,5.85,9,14,5
2,BAR,P002939,P004866,21.5,6,48,42
2,BAR,P002939,P006435,23.433,7,54,47
2,BAR,P002939,P011244,18.45,1,46,45
2,BAR,P002939,P012745,3.016,0,6,6
2,BAR,P003196,P003478,1.7,-4,4,8
2,BAR,P003196,P004866,7.9,1,20,19
2,BAR,P003196,P006435,9.25,0,24,24
2,BAR,P003196,P007464,6.834,1,14,13
2,BAR,P003196,P007519,6.834,1,14,13
2,BAR,P003196,P009992,6.484,4,14,10
2,BAR,P003196,P011244,7.934,0,22,22
2,BAR,P003196,P012745,8.15,1,16,15
2,BAR,P003478,P004866,3.917,8,8,0
2,BAR,P003478,P006435,7.133,9,14,5
2,BAR,P003478,P007464,1.283,-3,2,5
2,BAR,P003478,P007519,10.083,6,23,17
2,BAR,P003478,P009992,7.517,9,21,12
2,BAR,P003478,P011244,3.867,5,13,8
2,BAR,P003478,P012745,9.699,8,22,14
2,BAR,P004866,P006435,21.5,6,48,42
2,BAR,P004866,P011244,17.1,2,42,40
2,BAR,P004866,P012745,2.433,-2,4,6
2,BAR,P006435,P007519,1.283,0,0,0
2,BAR,P006435,P011244,18.45,1,46,45
2,BAR,P006435,P012745,4.299,0,6,6
2,BAR,P007464,P007519,7.767,1,16,15
2,BAR,P007464,P009992,6.484,4,14,10
2,BAR,P007464,P011244,0.717,2,2,0
2,BAR,P007464,P012745,7.05,-1,14,15
2,BAR,P007519,P009992,14.001,13,35,22
2,BAR,P007519,P011244,1.684,2,5,3
2,BAR,P007519,P012745,14.883,8,32,24
2,BAR,P009992,P011244,1.684,2,5,3
2,BAR,P009992,P012745,12.317,11,30,19
2,BAR,P011244,P012745,0.4,-4,0,4
2,IST,P004554,P004888,7.9,2,20,18
2,IST,P004554,P006372,9.283,-1,19,20
2,IST,P004554,P006590,5.933,-5,9,14
2,IST,P004554,P007200,16.916,0,34,34
2,IST,P004554,P009664,15.716,2,32,30
2,IST,P004554,P009846,1.917,4,8,4
2,IST,P004554,P011078,16.199,2,34,32
2,IST,P004888,P006372,0.75,-2,2,4
2,IST,P004888,P006590,14.216,-15,21,36
2,IST,P004888,P007200,20.017,-7,38,45
2,IST,P004888,P009513,3.2,-7,2,9
2,IST,P004888,P009664,14.5,-10,24,34
2,IST,P004888,P009846,14.534,-11,27,38
2,IST,P004888,P011078,13.85,1,35,34
2,IST,P004888,P011981,17.55,-14,29,43
2,IST,P004888,PLHK,3.683,7,14,7
2,IST,P006372,P007200,9.283,-1,19,20
2,IST,P006372,P009664,10.033,-3,21,24
2,IST,P006372,P009846,0.75,-2,2,4
2,IST,P006372,P011078,9.283,-1,19,20
2,IST,P006372,P011981,0.75,-2,2,4
2,IST,P006590,P007200,8.716,-10,8,18
2,IST,P006590,P009513,3.2,-7,2,9
2,IST,P006590,P009664,7.816,-2,11,13
2,IST,P006590,P009846,8.883,-7,17,24
2,IST,P006590,P011078,5.766,-6,8,14
2,IST,P006590,P011981,7.466,-8,8,16
2,IST,P007200,P009664,22.616,-13,32,45
2,IST,P007200,P009846,8.884,-6,14,20
2,IST,P007200,P011078,26.299,-2,56,58
2,IST,P007200,P011981,13.45,-8,21,29
2,IST,P007200,PLHK,3.683,7,14,7
2,IST,P009513,P009846,3.2,-7,2,9
2,IST,P009513,P011981,3.2,-7,2,9
2,IST,P009664,P009846,9.433,-6,18,24
2,IST,P009664,P011078,16.449,-5,29,34
2,IST,P009664,P011981,11.233,-15,13,28
2,IST,P009846,P011078,5.667,-2,11,13
2,IST,P009846,P011981,12.4,-15,17,32
2,IST,P011078,P011981,8.0,-2,18,20
2,IST,P011078,PLHK,3.683,7,14,7
2,IST,P011981,PLHK,3.683,7,14,7
3,BER,P003958,P006819,0.817,0,2,2
3,BER,P003958,P006919,22.466,-2,35,37
3,BER,P003958,P007025,6.3,1,9,8
3,BER,P003958,P007550,16.483,-10,23,33
3,BER,P003958,P008173,4.166,-2,5,7
3,BER,P003958,P008211,4.967,7,11,4
3,BER,P003958,P008384,4.934,5,11,6
3,BER,P003958,P008967,19.749,-8,28,36
3,BER,P003958,P012720,20.249,-8,30,38
3,BER,P003958,P012721,2.333,-3,2,5
3,BER,P006819,P007025,3.234,-7,2,9
3,BER,P006819,P008173,6.668,-12,8,20
3,BER,P006819,P008211,3.717,-5,4,9
3,BER,P006819,P008384,6.901,-12,8,20
3,BER,P006819,P012720,1.134,0,2,2
3,BER,P006819,P012721,6.401,-12,6,18
3,BER,P006919,P007025,4.9,1,7,6
3,BER,P006919,P007550,16.883,-7,26,33
3,BER,P006919,P008173,5.149,8,15,7
3,BER,P006919,P008211,3.984,9,11,2
3,BER,P006919,P008384,3.134,7,9,2
3,BER,P006919,P008967,22.366,7,45,38
3,BER,P006919,P012720,22.049,7,45,38
3,BER,P006919,P012721,3.133,10,15,5
3,BER,P007025,P007550,3.15,-1,3,4
3,BER,P007025,P008173,3.617,-9,2,11
3,BER,P007025,P008211,2.767,4,6,2
3,BER,P007025,P008384,7.034,-2,11,13
3,BER,P007025,P008967,1.25,-2,0,2
3,BER,P007025,P012720,1.25,-2,0,2
3,BER,P007025,P012721,4.634,-7,4,11
3,BER,P007550,P008384,1.9,1,3,2
3,BER,P007550,P008967,14.983,-8,23,31
3,BER,P007550,P012720,13.733,-6,23,29
3,BER,P007550,P012721,0.4,3,3,0
3,BER,P008173,P008211,7.6,-12,10,22
3,BER,P008173,P008384,10.784,-19,14,33
3,BER,P008173,P008967,5.149,7,15,8
3,BER,P008173,P012720,11.649,-2,23,25
3,BER,P008173,P012721,13.95,-15,24,39
3,BER,P008211,P008384,10.784,-6,18,24
3,BER,P008211,P008967,3.167,5,7,2
3,BER,P008211,P012720,7.6,-2,13,15
3,BER,P008211,P012721,9.55,-12,12,24
3,BER,P008384,P008967,0.417,2,2,0
3,BER,P008384,P012720,5.667,-5,10,15
3,BER,P008384,P012721,11.917,-19,14,33
3,BER,P008967,P012720,22.049,6,45,39
3,BER,P008967,P012721,4.066,7,15,8
3,BER,P012720,P012721,8.816,0,21,21
3,MUN,P003583,P004508,3.25,2,8,6
3,MUN,P003583,P005478,0.433,0,2,2
3,MUN,P003583,P006760,17.518,6,32,26
3,MUN,P003583,P007056,14.701,4,26,22
3,MUN,P003583,P007975,3.417,-6,3,9
3,MUN,P003583,P008985,14.534,12,31,19
3,MUN,P003583,P010391,14.001,10,26,16
3,MUN,P003583,P011987,3.95,-4,8,12
3,MUN,P004508,P005478,7.666,7,19,12
3,MUN,P004508,P006760,9.067,-7,13,20
3,MUN,P004508,P007056,11.267,6,21,15
3,MUN,P004508,P007639,2.333,-3,5,8
3,MUN,P004508,P007975,9.967,4,22,18
3,MUN,P004508,P008985,9.683,3,19,16
3,MUN,P004508,P010391,8.934,16,24,8
3,MUN,P004508,P011941,5.717,9,16,7
3,MUN,P004508,P011987,10.716,-9,17,26
3,MUN,P005478,P006760,0.667,3,3,0
3,MUN,P005478,P007056,7.983,3,18,15
3,MUN,P005478,P007975,10.167,10,28,18
3,MUN,P005478,P008985,1.716,-2,2,4
3,MUN,P005478,P010391,7.983,5,21,16
3,MUN,P005478,P011941,3.467,5,10,5
3,MUN,P005478,P011987,7.45,1,17,16
3,MUN,P006760,P007056,20.052,-2,30,32
3,MUN,P006760,P007639,2.333,-3,5,8
3,MUN,P006760,P007975,8.668,-8,13,21
3,MUN,P006760,P008985,17.201,8,31,23
3,MUN,P006760,P010391,14.685,10,26,16
3,MUN,P006760,P011941,2.101,3,5,2
3,MUN,P006760,P011987,11.184,-10,18,28
3,MUN,P007056,P007975,14.201,-5,23,28
3,MUN,P007056,P008985,16.751,13,34,21
3,MUN,P007056,P010391,23.268,20,51,31
3,MUN,P007056,P011941,4.351,7,11,4
3,MUN,P007056,P011987,11.234,-14,14,28
3,MUN,P007639,P007975,2.333,-3,5,8
3,MUN,P007639,P011987,2.333,-3,5,8
3,MUN,P007975,P010391,12.317,-1,24,25
3,MUN,P007975,P011941,3.851,7,12,5
3,MUN,P007975,P011987,9.951,-2,22,24
3,MUN,P008985,P010391,13.268,23,32,9
3,MUN,P008985,P011941,3.967,5,9,4
3,MUN,P008985,P011987,8.016,-10,10,20
3,MUN,P010391,P011941,4.334,7,12,5
3,MUN,P010391,P011987,3.55,-2,8,10
3,MUN,P011941,P011987,3.484,5,9,4
4,PAR,P000956,P003983,5.616,5,16,11
4,PAR,P000956,P007400,5.616,5,16,11
4,PAR,P000956,P008987,2.833,5,9,4
4,PAR,P000956,P011051,3.716,2,9,7
4,PAR,P000956,P012743,4.683,3,14,11
4,PAR,P003983,P004058,3.25,-5,4,9
4,PAR,P003983,P004172,0.767,-3,2,5
4,PAR,P003983,P007400,23.816,-5,54,59
4,PAR,P003983,P007673,8.133,9,23,14
4,PAR,P003983,P008987,13.75,-13,24,37
4,PAR,P003983,P009862,10.383,-13,13,26
4,PAR,P003983,P011050,4.617,-6,8,14
4,PAR,P003983,P011051,17.716,4,40,36
4,PAR,P003983,P012742,9.1,4,25,21
4,PAR,P003983,P012743,6.316,-5,15,20
4,PAR,P004058,P007400,2.733,-3,4,7
4,PAR,P004058,P007673,1.817,-3,3,6
4,PAR,P004058,P008987,8.683,-1,15,16
4,PAR,P004058,P009862,9.983,-2,18,20
4,PAR,P004058,P011050,5.633,-4,9,13
4,PAR,P004058,P011051,7.6,-3,13,16
4,PAR,P004058,P012742,13.233,-7,22,29
4,PAR,P004172,P007400,0.767,-3,2,5
4,PAR,P004172,P007673,4.15,-6,7,13
4,PAR,P004172,P008987,4.917,-9,9,18
4,PAR,P004172,P009862,4.15,-6,7,13
4,PAR,P004172,P011050,4.917,-9,9,18
4,PAR,P007400,P007673,6.6,9,21,12
4,PAR,P007400,P008987,11.7,-11,22,33
4,PAR,P007400,P009862,8.85,-13,11,24
4,PAR,P007400,P011050,3.5,-6,6,12
4,PAR,P007400,P011051,16.783,6,40,34
4,PAR,P007400,P012742,8.583,6,25,19
4,PAR,P007400,P012743,6.316,-5,15,20
4,PAR,P007673,P008987,5.683,-6,9,15
4,PAR,P007673,P009862,8.25,-9,12,21
4,PAR,P007673,P011050,4.75,-4,9,13
4,PAR,P007673,P011051,9.35,4,24,20
4,PAR,P007673,P012742,7.667,6,24,18
4,PAR,P008987,P009862,21.949,-18,35,53
4,PAR,P008987,P011050,8.417,-8,16,24
4,PAR,P008987,P011051,14.116,-5,22,27
4,PAR,P008987,P012742,8.683,-1,15,16
4,PAR,P008987,P012743,3.533,-5,8,13
4,PAR,P009862,P011050,7.133,-3,14,17
4,PAR,P009862,P011051,15.75,-10,23,33
4,PAR,P009862,P012742,9.983,-2,18,20
4,PAR,P009862,P012743,1.633,-8,1,9
4,PAR,P011050,P012742,5.633,-4,9,13
4,PAR,P011051,P012742,13.45,6,34,28
4,PAR,P011051,P012743,2.783,0,7,7
4,TEL,P004233,P007990,5.267,-7,12,19
4,TEL,P004233,P009622,0.75,0,0,0
4,TEL,P004233,P011193,2.65,-5,5,10
4,TEL,P004233,P011214,5.267,-7,12,19
4,TEL,P004233,P011219,4.25,-7,5,12
4,TEL,P004233,P011971,3.683,-4,7,11
4,TEL,P004233,P012744,4.533,-6,7,13
4,TEL,P005145,P007990,3.95,9,14,5
4,TEL,P005145,P009622,15.183,14,39,25
4,TEL,P005145,P009783,11.95,12,29,17
4,TEL,P005145,P011193,3.233,3,10,7
4,TEL,P005145,P011199,8.0,2,15,13
4,TEL,P005145,P011214,1.3,2,4,2
4,TEL,P005145,P011219,5.883,10,20,10
4,TEL,P005145,P011971,1.933,1,6,5
4,TEL,P005145,P012744,9.3,3,19,16
4,TEL,P007990,P009622,8.05,13,26,13
4,TEL,P007990,P009783,10.283,13,29,16
4,TEL,P007990,P011193,11.466,9,30,21
4,TEL,P007990,P011199,5.633,6,16,10
4,TEL,P007990,P011214,9.483,-3,23,26
4,TEL,P007990,P011219,14.533,12,38,26
4,TEL,P007990,P011971,11.033,9,29,20
4,TEL,P007990,P012744,10.366,3,27,24
4,TEL,P009622,P009783,17.149,13,42,29
4,TEL,P009622,P011193,8.348,1,22,21
4,TEL,P009622,P011199,12.916,6,30,24
4,TEL,P009622,P011214,4.449,-5,8,13
4,TEL,P009622,P011219,11.165,3,27,24
4,TEL,P009622,P011971,5.066,2,13,11
4,TEL,P009622,P012744,16.716,9,37,28
4,TEL,P009783,P011193,8.232,10,22,12
4,TEL,P009783,P011199,15.199,9,35,26
4,TEL,P009783,P011214,1.783,1,4,3
4,TEL,P009783,P011219,5.766,5,15,10
4,TEL,P009783,P011971,4.0,6,10,4
4,TEL,P009783,P012744,12.966,7,30,23
4,TEL,P011193,P011199,4.449,10,15,5
4,TEL,P011193,P011214,10.732,-4,24,28
4,TEL,P011193,P011219,14.881,-9,31,40
4,TEL,P011193,P011971,11.482,3,27,24
4,TEL,P011193,P012744,5.315,6,14,8
4,TEL,P011199,P011219,0.433,-3,0,3
4,TEL,P011199,P011971,2.683,7,9,2
4,TEL,P011199,P012744,12.283,7,28,21
4,TEL,P011214,P011219,10.282,-8,20,28
4,TEL,P011214,P011971,6.816,-6,16,22
4,TEL,P011214,P012744,5.616,-2,13,15
4,TEL,P011219,P011971,10.499,-1,21,22
4,TEL,P011219,P012744,7.832,2,15,13
4,TEL,P011971,P012744,4.933,-1,10,11
5,VIR,P001133,P001844,24.233,-22,38,60
5,VIR,P001133,P002084,1.683,-6,0,6
5,VIR,P001133,P003048,7.7,-3,10,13
5,VIR,P001133,P004007,18.816,10,47,37
5,VIR,P001133,P006739,6.783,21,28,7
5,VIR,P001133,P008847,19.467,14,51,37
5,VIR,P001133,P009549,28.883,-7,58,65
5,VIR,P001133,P011192,2.783,2,8,6
5,VIR,P001133,P012714,2.116,-5,5,10
5,VIR,P001133,PBCN,11.6,-8,19,27
5,VIR,P001844,P002084,6.083,-3,8,11
5,VIR,P001844,P003048,7.7,-3,10,13
5,VIR,P001844,P004007,13.366,-7,23,30
5,VIR,P001844,P008847,16.434,-11,27,38
5,VIR,P001844,P009549,22.933,-25,33,58
5,VIR,P001844,P011192,6.35,2,13,11
5,VIR,P001844,P012714,2.766,2,9,7
5,VIR,P001844,PBCN,14.667,-9,23,32
5,VIR,P002084,P004007,6.699,-4,9,13
5,VIR,P002084,P006739,4.583,-5,5,10
5,VIR,P002084,P008847,5.767,-3,7,10
5,VIR,P002084,P009549,1.383,-6,0,6
5,VIR,P002084,P011192,9.883,-5,13,18
5,VIR,P002084,P012714,3.216,1,6,5
5,VIR,P002084,PBCN,3.367,-1,4,5
5,VIR,P003048,P004007,1.8,2,5,3
5,VIR,P003048,P009549,7.7,-3,10,13
5,VIR,P003048,PBCN,5.9,-5,5,10
5,VIR,P004007,P006739,11.366,16,33,17
5,VIR,P004007,P008847,17.767,18,45,27
5,VIR,P004007,P009549,17.983,7,44,37
5,VIR,P004007,P011192,6.799,1,12,11
5,VIR,P004007,P012714,4.332,-7,6,13
5,VIR,P006739,P008847,8.8,22,31,9
5,VIR,P006739,P009549,5.95,18,25,7
5,VIR,P006739,P011192,5.416,-2,8,10
5,VIR,P006739,P012714,2.566,-6,2,8
5,VIR,P008847,P009549,18.634,11,48,37
5,VIR,P008847,P011192,6.6,0,10,10
5,VIR,P008847,PBCN,7.467,-7,13,20
5,VIR,P009549,P011192,0.65,-4,0,4
5,VIR,P009549,P012714,1.116,-8,0,8
5,VIR,P009549,PBCN,10.3,-11,14,25
5,VIR,P011192,P012714,4.216,4,11,7
5,VIR,P011192,PBCN,4.367,2,9,7
5,VIR,P012714,PBCN,1.0,3,5,2
5,ZAL,P002329,P002676,8.383,-5,13,18
5,ZAL,P002329,P003210,3.7,-7,6,13
5,ZAL,P002329,P003211,21.35,22,53,31
5,ZAL,P002329,P005504,4.283,-18,2,20
5,ZAL,P002329,P007109,23.6,4,47,43
5,ZAL,P002329,P007513,0.15,-3,0,3
5,ZAL,P002329,P010390,20.35,18,47,29
5,ZAL,P002329,P011218,19.766,8,43,35
5,ZAL,P002329,P011965,5.533,-2,12,14
5,ZAL,P002329,P012715,6.149,-1,13,14
5,ZAL,P002676,P003210,5.166,-9,7,16
5,ZAL,P002676,P003211,10.683,6,23,17
5,ZAL,P002676,P005504,5.849,-12,7,19
5,ZAL,P002676,P007109,7.066,3,12,9
5,ZAL,P002676,P010390,11.783,3,22,19
5,ZAL,P002676,P011218,10.532,-1,21,22
5,ZAL,P002676,P011965,7.549,1,16,15
5,ZAL,P002676,P012715,13.249,-10,23,33
5,ZAL,P003210,P003211,0.067,1,1,0
5,ZAL,P003210,P005504,7.033,-14,9,23
5,ZAL,P003210,P007109,2.617,-1,6,7
5,ZAL,P003210,P010390,0.683,3,3,0
5,ZAL,P003210,P011218,0.75,4,4,0
5,ZAL,P003210,P011965,5.95,-8,9,17
5,ZAL,P003210,P012715,5.166,-9,7,16
5,ZAL,P003211,P007109,17.967,14,41,27
5,ZAL,P003211,P007513,0.15,-3,0,3
5,ZAL,P003211,P010390,23.85,17,55,38
5,ZAL,P003211,P011218,21.033,15,50,35
5,ZAL,P003211,P011965,2.233,8,10,2
5,ZAL,P003211,P012715,9.199,8,23,15
5,ZAL,P005504,P007109,3.383,-11,2,13
5,ZAL,P005504,P011218,1.766,-8,0,8
5,ZAL,P005504,P011965,7.466,-14,9,23
5,ZAL,P005504,P012715,5.416,-11,7,18
5,ZAL,P007109,P007513,0.15,-3,0,3
5,ZAL,P007109,P010390,18.85,13,40,27
5,ZAL,P007109,P011218,21.132,12,46,34
5,ZAL,P007109,P011965,5.616,-8,7,15
5,ZAL,P007109,P012715,3.283,1,7,6
5,ZAL,P007513,P010390,0.15,-3,0,3
5,ZAL,P010390,P011218,23.466,16,53,37
5,ZAL,P010390,P011965,4.116,11,15,4
5,ZAL,P010390,P012715,6.816,6,17,11
5,ZAL,P011218,P011965,3.749,-3,5,8
5,ZAL,P011218,P012715,7.266,-3,14,17
5,ZAL,P011965,P012715,5.516,3,13,10
6,MIL,P000796,P001518,0.117,-2,0,2
6,MIL,P000796,P002812,7.184,-5,14,19
6,MIL,P000796,P002849,24.0,-1,43,44
6,MIL,P000796,P005670,15.883,-1,33,34
6,MIL,P000796,P006433,18.25,-8,29,37
6,MIL,P000796,P006509,8.233,-10,13,23
6,MIL,P000796,P006701,0.183,-2,0,2
6,MIL,P000796,P007201,32.75,-2,63,65
6,MIL,P000796,P007831,30.368,-4,57,61
6,MIL,P000796,P009960,5.9,-9,8,17
6,MIL,P001518,P002812,0.017,0,0,0
6,MIL,P001518,P002849,0.017,0,0,0
6,MIL,P001518,P006509,0.134,-2,0,2
6,MIL,P001518,P007831,0.134,-2,0,2
6,MIL,P001518,P009960,0.117,-2,0,2
6,MIL,P002812,P002849,2.651,4,8,4
6,MIL,P002812,P006433,12.934,1,26,25
6,MIL,P002812,P006509,8.867,6,18,12
6,MIL,P002812,P006701,2.333,-1,3,4
6,MIL,P002812,P007201,5.817,-1,14,15
6,MIL,P002812,P007831,12.168,2,26,24
6,MIL,P002812,P009960,6.033,-2,7,9
6,MIL,P002849,P005670,15.883,-1,33,34
6,MIL,P002849,P006433,12.134,7,20,13
6,MIL,P002849,P006509,6.184,3,12,9
6,MIL,P002849,P007201,23.583,0,43,43
6,MIL,P002849,P007831,26.385,10,51,41
6,MIL,P002849,P009960,1.967,2,2,0
6,MIL,P005670,P006433,0.683,2,2,0
6,MIL,P005670,P006509,1.133,-6,0,6
6,MIL,P005670,P007201,15.883,-1,33,34
6,MIL,P005670,P007831,14.067,3,31,28
6,MIL,P006433,P006509,14.1,4,25,21
6,MIL,P006433,P006701,2.516,-3,3,6
6,MIL,P006433,P007201,15.65,-1,27,28
6,MIL,P006433,P007831,20.968,2,35,33
6,MIL,P006433,P009960,12.833,-4,17,21
6,MIL,P006509,P006701,2.516,-3,3,6
6,MIL,P006509,P007201,6.383,-5,11,16
6,MIL,P006509,P007831,10.518,8,21,13
6,MIL,P006509,P009960,12.0,-3,17,20
6,MIL,P006701,P009960,2.516,-3,3,6
6,MIL,P007201,P007831,27.584,3,55,52
6,MIL,P007201,P009960,3.35,-1,6,7
6,MIL,P007831,P009960,7.084,-2,8,10
6,ULK,P001932,P002968,6.033,4,11,7
6,ULK,P001932,P002969,0.117,2,2,0
6,ULK,P001932,P004004,6.483,6,13,7
6,ULK,P001932,P005844,7.816,5,14,9
6,ULK,P001932,P006661,7.649,5,14,9
6,ULK,P001932,P008962,1.9,3,5,2
6,ULK,P001932,P010560,1.45,1,3,2
6,ULK,P001932,P011980,0.284,2,2,0
6,ULK,P002968,P004004,6.033,4,11,7
6,ULK,P002968,P005844,6.033,4,11,7
6,ULK,P002968,P006661,6.033,4,11,7
6,ULK,P002969,P004004,0.117,2,2,0
6,ULK,P002969,P008962,0.117,2,2,0
6,ULK,P002969,P011980,0.117,2,2,0
6,ULK,P004004,P005844,14.066,-2,24,26
6,ULK,P004004,P006661,18.516,-1,32,33
6,ULK,P004004,P008962,7.7,-3,16,19
6,ULK,P004004,P009849,5.5,0,11,11
6,ULK,P004004,P010560,6.65,-5,10,15
6,ULK,P004004,P011052,0.017,1,1,0
6,ULK,P004004,P011157,4.433,0,7,7
6,ULK,P004004,P011980,5.017,2,9,7
6,ULK,P005844,P006661,26.665,5,50,45
6,ULK,P005844,P008962,23.732,2,49,47
6,ULK,P005844,P009849,21.532,6,45,39
6,ULK,P005844,P010560,19.716,3,41,38
6,ULK,P005844,P011052,4.733,1,12,11
6,ULK,P005844,P011980,1.967,0,2,2
6,ULK,P006661,P008962,18.849,2,38,36
6,ULK,P006661,P009849,16.816,6,34,28
6,ULK,P006661,P010560,19.249,2,36,34
6,ULK,P006661,P011052,0.017,1,1,0
6,ULK,P006661,P011157,4.433,0,7,7
6,ULK,P006661,P011980,6.233,0,9,9
6,ULK,P008962,P009849,27.049,3,55,52
6,ULK,P008962,P010560,24.749,-1,50,51
6,ULK,P008962,P011052,11.583,-2,24,26
6,ULK,P008962,P011157,6.833,-4,11,15
6,ULK,P008962,P011980,0.284,2,2,0
6,ULK,P009849,P010560,24.915,1,48,47
6,ULK,P009849,P011052,13.616,-4,26,30
6,ULK,P009849,P011157,8.866,-6,13,19
6,ULK,P009849,P011980,3.366,-2,4,6
6,ULK,P010560,P011052,13.599,-5,25,30
6,ULK,P010560,P011157,13.299,-6,20,26
6,ULK,P010560,P011980,8.433,-2,11,13
6,ULK,P011052,P011157,8.866,-6,13,19
6,ULK,P011052,P011980,2.033,-2,2,4
6,ULK,P011157,P011980,6.466,-2,9,11
7,OLY,P001255,P003941,18.7,3,41,38
7,OLY,P001255,P006589,7.6,-11,10,21
7,OLY,P001255,P007853,5.683,-10,6,16
7,OLY,P001255,P007982,8.517,-13,12,25
7,OLY,P001255,P008829,18.7,3,41,38
7,OLY,P001255,P008855,20.617,2,45,43
7,OLY,P001255,P010392,5.683,-10,6,16
7,OLY,P001255,P010612,19.7,4,43,39
7,OLY,P003941,P006589,0.567,0,0,0
7,OLY,P003941,P007853,0.567,0,0,0
7,OLY,P003941,P007982,17.784,13,36,23
7,OLY,P003941,P008829,35.0,18,75,57
7,OLY,P003941,P008855,35.0,18,75,57
7,OLY,P003941,P010392,6.234,4,11,7
7,OLY,P003941,P010612,28.416,16,62,46
7,OLY,P006302,P006589,0.35,0,0,0
7,OLY,P006302,P007982,0.35,0,0,0
7,OLY,P006302,P008829,0.35,0,0,0
7,OLY,P006302,P008855,0.35,0,0,0
7,OLY,P006589,P007853,6.25,-10,6,16
7,OLY,P006589,P007982,10.0,-8,13,21
7,OLY,P006589,P008829,1.833,3,3,0
7,OLY,P006589,P008855,3.75,2,7,5
7,OLY,P006589,P010392,6.25,-10,6,16
7,OLY,P006589,P010612,3.4,2,7,5
7,OLY,P007853,P007982,6.25,-10,6,16
7,OLY,P007853,P010392,6.25,-10,6,16
7,OLY,P007982,P008829,19.05,16,39,23
7,OLY,P007982,P008855,20.967,15,43,28
7,OLY,P007982,P010392,11.917,-6,17,23
7,OLY,P007982,P010612,14.033,13,30,17
7,OLY,P008829,P008855,36.833,21,78,57
7,OLY,P008829,P010392,5.667,4,11,7
7,OLY,P008829,P010612,29.899,19,65,46
7,OLY,P008855,P010392,5.667,4,11,7
7,OLY,P008855,P010612,31.816,18,69,51
7,PAN,P001926,P002328,18.816,-4,32,36
7,PAN,P001926,P003842,28.266,-3,50,53
7,PAN,P001926,P007553,4.483,-3,5,8
7,PAN,P001926,P007947,7.416,-8,4,12
7,PAN,P001926,P008084,6.25,13,17,4
7,PAN,P001926,P011204,18.7,2,34,32
7,PAN,P001926,P011826,11.466,5,28,23
7,PAN,P001926,P012712,29.399,-6,50,56
7,PAN,P002328,P003842,19.483,-6,35,41
7,PAN,P002328,P007553,10.9,-4,20,24
7,PAN,P002328,P007947,15.05,-13,23,36
7,PAN,P002328,P008084,1.8,5,5,0
7,PAN,P002328,P011204,19.767,-3,38,41
7,PAN,P002328,P011826,7.133,0,17,17
7,PAN,P002328,P012712,28.583,-15,50,65
7,PAN,P003842,P007553,1.55,-5,0,5
7,PAN,P003842,P007947,12.816,-11,12,23
7,PAN,P003842,P008084,8.05,10,17,7
7,PAN,P003842,P011204,21.167,-3,37,40
7,PAN,P003842,P011826,11.466,5,28,23
7,PAN,P003842,P012712,31.866,-11,53,64
7,PAN,P007553,P007947,7.967,-6,15,21
7,PAN,P007553,P011204,12.45,-9,20,29
7,PAN,P007553,P012712,12.45,-9,20,29
7,PAN,P007947,P008084,3.683,1,4,3
7,PAN,P007947,P011204,15.85,-14,23,37
7,PAN,P007947,P011209,0.433,0,0,0
7,PAN,P007947,P011221,0.433,0,0,0
7,PAN,P007947,P012712,21.216,-17,27,44
7,PAN,P008084,P011204,6.167,6,13,7
7,PAN,P008084,P012712,6.25,5,12,7
7,PAN,P011204,P011209,0.433,0,0,0
7,PAN,P011204,P011221,0.433,0,0,0
7,PAN,P011204,P011826,4.333,5,11,6
7,PAN,P011204,P012712,30.7,-12,52,64
7,PAN,P011209,P011221,0.433,0,0,0
7,PAN,P011209,P012712,0.433,0,0,0
7,PAN,P011221,P012712,0.433,0,0,0
7,PAN,P011826,P012712,11.466,5,28,23
8,BAS,P004603,P004761,2.7,-5,5,10
8,BAS,P004603,P007230,9.95,-8,17,25
8,BAS,P004603,P009048,11.233,-5,22,27
8,BAS,P004603,P010444,9.15,-6,17,23
8,BAS,P004603,P011085,1.283,3,5,2
8,BAS,P004603,P011948,8.533,0,17,17
8,BAS,P004603,P012201,2.083,1,5,4
8,BAS,P004761,P007230,13.283,-5,22,27
8,BAS,P004761,P008072,11.55,0,24,24
8,BAS,P004761,P008850,1.217,-6,0,6
8,BAS,P004761,P009048,8.6,-2,18,20
8,BAS,P004761,P010444,10.8,-2,20,22
8,BAS,P004761,P011064,6.417,1,11,10
8,BAS,P004761,P011085,2.834,-2,7,9
8,BAS,P004761,P011948,0.117,0,0,0
8,BAS,P004761,P012201,7.418,-7,9,16
8,BAS,P007230,P008072,14.699,8,29,21
8,BAS,P007230,P008850,0.467,0,0,0
8,BAS,P007230,P009048,18.501,-5,34,39
8,BAS,P007230,P010444,19.05,3,38,35
8,BAS,P007230,P011064,8.799,5,14,9
8,BAS,P007230,P011948,13.55,5,26,21
8,BAS,P007230,P012201,10.901,-3,12,15
8,BAS,P008072,P008850,1.217,-6,0,6
8,BAS,P008072,P009048,7.767,1,15,14
8,BAS,P008072,P010444,7.249,9,19,10
8,BAS,P008072,P011064,14.949,12,36,24
8,BAS,P008072,P011085,9.234,-1,22,23
8,BAS,P008072,P011948,12.383,7,27,20
8,BAS,P008072,P012201,16.684,-2,32,34
8,BAS,P008850,P009048,0.467,0,0,0
8,BAS,P008850,P010444,0.467,0,0,0
8,BAS,P008850,P011085,1.217,-6,0,6
8,BAS,P008850,P012201,1.684,-6,0,6
8,BAS,P009048,P010444,14.317,2,32,30
8,BAS,P009048,P011085,1.283,3,5,2
8,BAS,P009048,P011948,10.717,0,21,21
8,BAS,P009048,P012201,6.251,-2,9,11
8,BAS,P010444,P011064,6.917,-3,8,11
8,BAS,P010444,P011085,2.067,-4,2,6
8,BAS,P010444,P011948,10.084,1,20,19
8,BAS,P010444,P012201,4.835,-4,4,8
8,BAS,P011064,P011085,10.084,1,24,23
8,BAS,P011064,P011948,12.7,5,27,22
8,BAS,P011064,P012201,16.134,3,32,29
8,BAS,P011085,P011948,9.75,0,22,22
8,BAS,P011085,P012201,12.584,-2,29,31
8,BAS,P011948,P012201,15.834,2,32,30
8,MAD,P001392,P003108,2.184,1,3,2
8,MAD,P001392,P003733,2.217,-4,4,8
8,MAD,P001392,P004887,9.766,11,23,12
8,MAD,P001392,P005928,12.751,3,24,21
8,MAD,P001392,P006540,10.551,0,21,21
8,MAD,P001392,P010357,17.734,7,33,26
8,MAD,P001392,P010868,6.151,-2,9,11
8,MAD,P001392,PBMT,10.384,5,18,13
8,MAD,P001392,PCVM,7.067,3,13,10
8,MAD,P001392,PTGB,0.467,0,0,0
8,MAD,P003108,P004887,3.083,-6,5,11
8,MAD,P003108,P005928,1.45,1,5,4
8,MAD,P003108,P006540,3.533,-9,5,14
8,MAD,P003108,P010357,7.034,5,21,16
8,MAD,P003108,P010868,0.167,0,0,0
8,MAD,P003108,PBMT,6.751,8,21,13
8,MAD,P003108,PCVM,8.834,-2,21,23
8,MAD,P003108,PTGB,8.1,-2,23,25
8,MAD,P003733,P005928,2.217,-4,4,8
8,MAD,P003733,P006540,2.217,-4,4,8
8,MAD,P003733,P010357,1.417,-4,2,6
8,MAD,P003733,P010868,0.8,0,2,2
8,MAD,P004887,P005928,14.699,10,33,23
8,MAD,P004887,P006540,15.166,-1,31,32
8,MAD,P004887,P010357,21.849,9,42,33
8,MAD,P004887,PBMT,9.766,4,16,12
8,MAD,P004887,PCVM,10.233,-7,14,21
8,MAD,P004887,PTGB,15.166,-8,24,32
8,MAD,P005928,P006540,19.601,1,39,38
8,MAD,P005928,P010357,19.367,4,35,31
8,MAD,P005928,P010868,6.151,-2,9,11
8,MAD,P005928,PBMT,4.25,2,7,5
8,MAD,P005928,PTGB,10.45,1,20,19
8,MAD,P006540,P010357,18.484,-3,33,36
8,MAD,P006540,P010868,5.984,-2,9,11
8,MAD,P006540,PBMT,1.117,-1,2,3
8,MAD,P006540,PCVM,3.883,-11,3,14
8,MAD,P006540,PTGB,13.4,-10,21,31
8,MAD,P010357,P010868,4.067,-1,5,6
8,MAD,P010357,PBMT,16.35,12,37,25
8,MAD,P010357,PCVM,15.467,5,35,30
8,MAD,P010357,PTGB,17.567,2,37,35
8,MAD,P010868,PBMT,1.284,-1,2,3
8,MAD,PBMT,PCVM,13.384,9,32,23
8,MAD,PBMT,PTGB,7.25,6,21,15
8,MAD,PCVM,PTGB,10.2,-5,22,27
9,MCO,P004790,P005985,3.817,-5,8,13
9,MCO,P004790,P008099,5.234,-6,5,11
9,MCO,P004790,P010588,2.5,0,8,8
9,MCO,P004790,P011196,5.234,-6,5,11
9,MCO,P004790,P011212,6.417,-1,13,14
9,MCO,P004790,P011226,1.317,-5,0,5
9,MCO,P004790,P011231,6.417,-1,13,14
9,MCO,P005985,P008099,3.65,-6,5,11
9,MCO,P005985,P010588,32.249,11,60,49
9,MCO,P005985,P011196,3.667,-2,5,7
9,MCO,P005985,P011212,23.016,12,46,34
9,MCO,P005985,P011226,21.65,-3,33,36
9,MCO,P005985,P011231,11.566,-2,21,23
9,MCO,P005985,P012515,11.083,1,17,16
9,MCO,P005985,PLCZ,23.566,18,45,27
9,MCO,P008099,P010588,2.333,-1,5,6
9,MCO,P008099,P011196,7.751,-16,5,21
9,MCO,P008099,P011212,6.434,-11,5,16
9,MCO,P008099,P011226,6.167,-16,5,21
9,MCO,P008099,P011231,6.434,-11,5,16
9,MCO,P008099,PLCZ,2.333,-1,5,6
9,MCO,P010588,P011196,2.35,3,5,2
9,MCO,P010588,P011212,23.016,12,46,34
9,MCO,P010588,P011226,20.333,2,33,31
9,MCO,P010588,P011231,11.566,-2,21,23
9,MCO,P010588,P012515,11.083,1,17,16
9,MCO,P010588,PLCZ,23.566,18,45,27
9,MCO,P011196,P011212,8.784,-8,10,18
9,MCO,P011196,P011226,6.184,-12,5,17
9,MCO,P011196,P011231,6.434,-11,5,16
9,MCO,P011212,P011226,13.617,-7,19,26
9,MCO,P011212,P011231,16.85,-8,26,34
9,MCO,P011212,P012515,4.183,1,8,7
9,MCO,P011212,PLCZ,15.483,14,31,17
9,MCO,P011226,P011231,6.15,-20,2,22
9,MCO,P011226,P012515,6.9,0,9,9
9,MCO,P011226,PLCZ,14.35,9,26,17
9,MCO,P011231,P012515,1.35,-5,0,5
9,MCO,P011231,PLCZ,5.233,8,11,3
9,MCO,P012515,PLCZ,9.733,6,17,11
9,PAM,P000556,P004863,3.683,1,5,4
9,PAM,P000556,P010393,0.6,0,0,0
9,PAM,P000556,P010568,0.6,0,0,0
9,PAM,P000556,P012738,4.283,1,5,4
9,PAM,P000556,P012739,3.683,1,5,4
9,PAM,P000556,P012740,4.283,1,5,4
9,PAM,P003960,P004863,6.95,3,10,7
9,PAM,P003960,P006643,12.533,-7,17,24
9,PAM,P003960,P007870,12.15,-3,17,20
9,PAM,P003960,P010393,3.25,2,9,7
9,PAM,P003960,P010568,17.65,-4,24,28
9,PAM,P003960,P011970,0.267,0,0,0
9,PAM,P003960,P011982,7.501,-4,9,13
9,PAM,P003960,P012738,0.2,0,0,0
9,PAM,P003960,P012739,5.034,-10,0,10
9,PAM,P003960,P012740,15.333,-13,18,31
9,PAM,P004863,P006643,2.1,8,8,0
9,PAM,P004863,P007870,3.7,3,6,3
9,PAM,P004863,P010393,3.65,10,12,2
9,PAM,P004863,P010568,4.55,8,10,2
9,PAM,P004863,P011970,7.034,3,16,13
9,PAM,P004863,P011982,13.417,7,27,20
9,PAM,P004863,P012738,12.5,11,28,17
9,PAM,P004863,P012739,12.25,3,22,19
9,PAM,P004863,P012740,7.766,7,16,9
9,PAM,P006643,P007870,8.25,-7,10,17
9,PAM,P006643,P010393,5.267,2,13,11
9,PAM,P006643,P010568,14.766,-6,22,28
9,PAM,P006643,P011970,0.617,2,2,0
9,PAM,P006643,P011982,1.617,-4,2,6
9,PAM,P006643,P012738,1.267,3,5,2
9,PAM,P006643,P012739,3.5,-5,3,8
9,PAM,P006643,P012740,11.683,-10,14,24
9,PAM,P007870,P010393,2.834,-3,3,6
9,PAM,P007870,P010568,14.467,-1,20,21
9,PAM,P007870,P011982,8.484,1,14,13
9,PAM,P007870,P012740,10.583,2,18,16
9,PAM,P010393,P010568,7.3,6,15,9
9,PAM,P010393,P011970,1.967,4,6,2
9,PAM,P010393,P011982,5.034,2,10,8
9,PAM,P010393,P012738,3.617,7,9,2
9,PAM,P010393,P012739,0.2,0,0,0
9,PAM,P010393,P012740,4.217,2,7,5
9,PAM,P010568,P011970,1.367,-4,1,5
9,PAM,P010568,P011982,11.368,3,20,17
9,PAM,P010568,P012738,4.517,2,11,9
9,PAM,P010568,P012739,6.184,-7,8,15
9,PAM,P010568,P012740,17.767,-1,29,30
9,PAM,P011970,P011982,7.784,-3,15,18
9,PAM,P011970,P012738,8.134,-1,17,18
9,PAM,P011970,P012739,6.434,-5,11,16
9,PAM,P011982,P012738,11.267,9,29,20
9,PAM,P011982,P012739,11.051,0,22,22
9,PAM,P011982,P012740,9.417,13,24,11
9,PAM,P012738,P012739,13.6,6,30,24
9,PAM,P012738,P012740,8.683,14,22,8
9,PAM,P012739,P012740,11.8,1,19,18
10,BAS,P004603,P004761,15.333,-6,35,41
10,BAS,P004603,P007230,8.033,3,23,20
10,BAS,P004603,P009048,10.45,-6,19,25
10,BAS,P004603,P010444,4.45,0,10,10
10,BAS,P004603,P011064,10.767,-2,30,32
10,BAS,P004603,P011085,4.85,1,15,14
10,BAS,P004603,P011948,5.483,-7,8,15
10,BAS,P004603,P012201,13.366,-7,32,39
10,BAS,P004761,P007230,11.533,9,30,21
10,BAS,P004761,P008072,2.9,5,9,4
10,BAS,P004761,P009048,10.667,-4,18,22
10,BAS,P004761,P010444,7.95,6,17,11
10,BAS,P004761,P011064,14.95,4,42,38
10,BAS,P004761,P011085,4.85,1,15,14
10,BAS,P004761,P011948,3.533,-5,4,9
10,BAS,P004761,P012201,18.616,-2,46,48
10,BAS,P007230,P008072,13.416,13,29,16
10,BAS,P007230,P009048,21.55,11,48,37
10,BAS,P007230,P010444,24.416,11,52,41
10,BAS,P007230,P011064,7.766,2,20,18
10,BAS,P007230,P011948,17.416,3,37,34
10,BAS,P007230,P012201,11.666,-4,29,33
10,BAS,P008072,P009048,10.183,12,22,10
10,BAS,P008072,P010444,12.566,15,27,12
10,BAS,P008072,P011064,4.133,3,11,8
10,BAS,P008072,P011948,12.316,12,28,16
10,BAS,P008072,P012201,1.75,0,6,6
10,BAS,P009048,P010444,20.85,7,44,37
10,BAS,P009048,P011064,3.034,-2,6,8
10,BAS,P009048,P011948,18.816,-2,35,37
10,BAS,P009048,P012201,11.85,-12,20,32
10,BAS,P010444,P011064,3.766,4,8,4
10,BAS,P010444,P011948,16.566,5,35,30
10,BAS,P010444,P012201,7.5,-4,15,19
10,BAS,P011064,P011085,4.85,1,15,14
10,BAS,P011064,P011948,2.133,0,6,6
10,BAS,P011064,P012201,13.333,-2,38,40
10,BAS,P011085,P012201,4.85,1,15,14
10,BAS,P011948,P012201,7.533,-14,11,25
10,BER,P003958,P006251,2.083,4,9,5
10,BER,P003958,P006819,4.033,-3,6,9
10,BER,P003958,P006919,22.683,-11,38,49
10,BER,P003958,P007550,17.049,-8,30,38
10,BER,P003958,P008173,7.717,1,17,16
10,BER,P003958,P008211,4.9,0,10,10
10,BER,P003958,P008384,7.85,7,25,18
10,BER,P003958,P008967,15.583,-4,27,31
10,BER,P003958,P012720,17.166,-14,26,40
10,BER,P006251,P006919,1.283,-1,2,3
10,BER,P006251,P007550,2.083,4,9,5
10,BER,P006251,P008173,15.234,2,39,37
10,BER,P006251,P008211,6.95,7,17,10
10,BER,P006251,P008384,13.7,5,36,31
10,BER,P006251,P008967,10.367,-1,31,32
10,BER,P006251,P012720,3.617,1,12,11
10,BER,P006251,P012721,13.951,3,37,34
10,BER,P006819,P006919,4.033,-3,6,9
10,BER,P006819,P007550,4.033,-3,6,9
10,BER,P006819,P012720,4.033,-3,6,9
10,BER,P006919,P007550,14.966,-12,21,33
10,BER,P006919,P008173,9.0,0,19,19
10,BER,P006919,P008211,6.183,-1,12,13
10,BER,P006919,P008384,7.05,2,18,16
10,BER,P006919,P008967,13.5,-8,18,26
10,BER,P006919,P012720,17.166,-14,26,40
10,BER,P007550,P008211,2.3,3,5,2
10,BER,P007550,P008384,3.833,4,15,11
10,BER,P007550,P008967,8.966,-8,13,21
10,BER,P007550,P012720,14.966,-12,21,33
10,BER,P008173,P008211,9.55,4,22,18
10,BER,P008173,P008384,15.634,4,37,33
10,BER,P008173,P008967,14.901,-1,36,37
10,BER,P008173,P012720,5.817,-1,17,18
10,BER,P008173,P012721,13.951,3,37,34
10,BER,P008211,P008384,6.95,7,17,10
10,BER,P008211,P008967,1.5,0,2,2
10,BER,P008211,P012720,3.4,0,8,8
10,BER,P008211,P012721,5.667,8,15,7
10,BER,P008384,P008967,10.767,1,29,28
10,BER,P008384,P012720,1.75,0,6,6
10,BER,P008384,P012721,10.334,2,25,23
10,BER,P008967,P012720,11.6,-10,18,28
10,BER,P008967,P012721,8.284,-5,22,27
10,BER,P012720,P012721,3.617,1,12,11
11,IST,P004554,P004888,5.816,-13,9,22
11,IST,P004554,P006372,14.55,9,38,29
11,IST,P004554,P006590,16.167,14,43,29
11,IST,P004554,P007200,11.133,-23,15,38
11,IST,P004554,P009513,6.117,2,14,12
11,IST,P004554,P009664,13.483,8,35,27
11,IST,P004554,P011078,21.366,4,50,46
11,IST,P004554,P011981,3.9,-1,8,9
11,IST,P004888,P006372,4.382,-7,7,14
11,IST,P004888,P006590,2.683,-3,5,8
11,IST,P004888,P007200,16.416,-29,25,54
11,IST,P004888,P009664,7.366,-17,10,27
11,IST,P004888,P011078,15.299,-26,22,48
11,IST,P004888,P011981,11.266,-17,17,34
11,IST,P004888,PLHK,5.7,-8,9,17
11,IST,P006372,P006590,15.05,11,39,28
11,IST,P006372,P007200,10.3,-20,12,32
11,IST,P006372,P009513,5.517,3,14,11
11,IST,P006372,P009664,13.85,10,36,26
11,IST,P006372,P011078,16.932,12,43,31
11,IST,P006372,P011981,3.249,-2,5,7
11,IST,P006372,P012415,1.517,0,2,2
11,IST,P006372,PLHK,4.717,-4,8,12
11,IST,P006590,P007200,7.617,-20,8,28
11,IST,P006590,P009513,7.9,2,20,18
11,IST,P006590,P009664,12.616,6,36,30
11,IST,P006590,P011078,15.883,17,43,26
11,IST,P006590,P011981,5.533,-5,10,15
11,IST,P006590,PLHK,4.083,-6,8,14
11,IST,P007200,P009664,12.1,-26,16,42
11,IST,P007200,P011078,19.666,-32,29,61
11,IST,P007200,P011981,10.45,-16,16,32
11,IST,P007200,PLHK,7.85,-14,11,25
11,IST,P009513,P009664,3.3,0,8,8
11,IST,P009513,P011078,6.117,2,14,12
11,IST,P009513,P011981,3.9,-1,8,9
11,IST,P009513,P012415,1.517,0,2,2
11,IST,P009513,PLHK,3.3,0,8,8
11,IST,P009664,P011078,14.099,6,36,30
11,IST,P009664,P011981,2.683,-9,3,12
11,IST,P009664,P012415,1.517,0,2,2
11,IST,P009664,PLHK,5.45,-6,10,16
11,IST,P011078,P011981,14.133,-13,24,37
11,IST,P011078,PLHK,6.433,-10,11,21
11,IST,P011981,PLHK,5.55,-8,9,17
11,IST,P012415,PLHK,1.517,0,2,2
11,MAD,P001392,P003108,9.866,9,29,20
11,MAD,P001392,P004887,8.482,9,26,17
11,MAD,P001392,P005791,15.983,23,47,24
11,MAD,P001392,P005928,21.883,32,67,35
11,MAD,P001392,P006540,17.933,23,50,27
11,MAD,P001392,P009005,7.199,5,20,15
11,MAD,P001392,P010357,18.933,27,56,29
11,MAD,P001392,PCVM,4.249,0,9,9
11,MAD,P003108,P004887,18.749,1,45,44
11,MAD,P003108,P005928,12.033,19,40,21
11,MAD,P003108,P006540,4.0,4,9,5
11,MAD,P003108,P009005,13.399,1,29,28
11,MAD,P003108,P009213,1.517,2,4,2
11,MAD,P003108,P010357,8.85,4,25,21
11,MAD,P003108,PCVM,8.25,-16,10,26
11,MAD,P003108,PTGB,12.4,-4,25,29
11,MAD,P004887,P005928,10.033,17,35,18
11,MAD,P004887,P006540,0.766,0,0,0
11,MAD,P004887,P009005,12.165,-1,25,26
11,MAD,P004887,P010357,6.85,2,20,18
11,MAD,P004887,PCVM,8.533,-16,10,26
11,MAD,P004887,PTGB,10.55,-8,19,27
11,MAD,P005791,P005928,14.55,21,43,22
11,MAD,P005791,P006540,17.45,18,49,31
11,MAD,P005791,P010357,17.45,18,49,31
11,MAD,P005791,PCVM,2.9,-3,6,9
11,MAD,P005791,PTGB,1.467,-5,2,7
11,MAD,P005928,P006540,16.55,23,48,25
11,MAD,P005928,P009005,4.616,7,15,8
11,MAD,P005928,P010357,21.95,33,68,35
11,MAD,P005928,PCVM,0.017,0,0,0
11,MAD,P005928,PTGB,4.7,8,16,8
11,MAD,P006540,P009005,2.283,2,4,2
11,MAD,P006540,P009213,1.517,2,4,2
11,MAD,P006540,P010357,19.45,20,54,34
11,MAD,P006540,PCVM,3.183,-3,6,9
11,MAD,P006540,PTGB,3.8,-1,8,9
11,MAD,P009005,P009213,1.517,2,4,2
11,MAD,P009005,PCVM,7.066,-8,10,18
11,MAD,P009005,PTGB,6.483,-4,9,13
11,MAD,P009213,PTGB,1.517,2,4,2
11,MAD,P010357,PCVM,4.35,-11,6,17
11,MAD,P010357,PTGB,7.367,-5,18,23
11,MAD,PCVM,PTGB,7.184,-19,7,26
12,MIL,P000796,P001518,2.767,1,4,3
12,MIL,P000796,P002812,4.0,-2,4,6
12,MIL,P000796,P002849,21.083,-10,53,63
12,MIL,P000796,P006433,11.067,-1,24,25
12,MIL,P000796,P006509,3.217,-7,4,11
12,MIL,P000796,P007032,20.149,-5,50,55
12,MIL,P000796,P007201,27.149,-2,68,70
12,MIL,P000796,P007831,28.099,-6,70,76
12,MIL,P000796,P009960,6.133,6,17,11
12,MIL,P000796,P011205,1.2,2,2,0
12,MIL,P001518,P002812,4.3,-3,4,7
12,MIL,P001518,P006433,5.417,0,7,7
12,MIL,P001518,P006509,1.733,-3,2,5
12,MIL,P001518,P007831,2.55,-3,3,6
12,MIL,P001518,P009960,1.15,1,3,2
12,MIL,P001518,P011205,3.883,-1,5,6
12,MIL,P002812,P006433,4.267,-1,4,5
12,MIL,P002812,P006509,1.95,-4,2,6
12,MIL,P002812,P007032,1.233,-3,0,3
12,MIL,P002812,P007201,1.233,-3,0,3
12,MIL,P002812,P007831,2.416,-6,0,6
12,MIL,P002812,P011205,2.733,-2,2,4
12,MIL,P002849,P006433,9.65,-2,21,23
12,MIL,P002849,P006509,3.883,-4,5,9
12,MIL,P002849,P007032,14.016,-7,35,42
12,MIL,P002849,P007201,19.783,-5,51,56
12,MIL,P002849,P007831,21.083,-10,53,63
12,MIL,P002849,P009960,2.583,1,3,2
12,MIL,P002849,P011205,2.583,1,3,2
12,MIL,P006433,P006509,6.0,0,10,10
12,MIL,P006433,P007201,10.75,1,28,27
12,MIL,P006433,P007831,13.684,-6,30,36
12,MIL,P006433,P009960,8.483,3,18,15
12,MIL,P006433,P011205,9.95,2,18,16
12,MIL,P006509,P007032,0.583,-3,0,3
12,MIL,P006509,P007201,1.0,2,3,1
12,MIL,P006509,P007831,1.333,-7,2,9
12,MIL,P006509,P009960,3.366,4,6,2
12,MIL,P006509,P011205,3.399,2,6,4
12,MIL,P007032,P007201,19.916,-3,50,53
12,MIL,P007032,P007831,19.799,-4,50,54
12,MIL,P007032,P009960,4.9,5,15,10
12,MIL,P007201,P007831,29.666,-4,75,79
12,MIL,P007201,P009960,9.65,6,27,21
12,MIL,P007201,P011205,3.517,0,10,10
12,MIL,P007831,P009960,10.017,4,27,23
12,MIL,P007831,P011205,5.417,-6,10,16
12,MIL,P009960,P011205,7.25,2,16,14
12,TEL,P004233,P005145,4.233,0,8,8
12,TEL,P004233,P009622,3.2,5,10,5
12,TEL,P004233,P009783,1.767,-1,2,3
12,TEL,P004233,P011193,5.116,0,8,8
12,TEL,P004233,P011199,4.15,4,12,8
12,TEL,P004233,P011214,7.533,6,16,10
12,TEL,P004233,P011219,0.883,0,0,0
12,TEL,P004233,P011971,2.9,2,4,2
12,TEL,P004233,P012744,4.15,4,12,8
12,TEL,P005145,P007990,2.35,-3,5,8
12,TEL,P005145,P009622,4.433,-5,3,8
12,TEL,P005145,P009783,7.267,-8,10,18
12,TEL,P005145,P011193,9.616,-6,15,21
12,TEL,P005145,P011199,3.283,-9,2,11
12,TEL,P005145,P011214,5.633,2,9,7
12,TEL,P005145,P011219,2.217,-3,5,8
12,TEL,P005145,P011971,3.216,-1,4,5
12,TEL,P005145,P012744,2.816,-7,3,10
12,TEL,P007990,P009622,0.133,0,0,0
12,TEL,P007990,P009783,1.867,0,5,5
12,TEL,P007990,P011193,2.35,-3,5,8
12,TEL,P007990,P011219,2.217,-3,5,8
12,TEL,P007990,P011971,0.483,-3,0,3
12,TEL,P009622,P009783,25.682,2,66,64
12,TEL,P009622,P011193,10.532,5,21,16
12,TEL,P009622,P011199,22.083,4,60,56
12,TEL,P009622,P011214,13.149,6,30,24
12,TEL,P009622,P011219,2.083,-3,0,3
12,TEL,P009622,P011971,20.932,9,59,50
12,TEL,P009622,P012744,20.033,1,55,54
12,TEL,P009783,P011193,14.249,10,37,27
12,TEL,P009783,P011199,19.05,-1,50,51
12,TEL,P009783,P011214,11.932,6,31,25
12,TEL,P009783,P011219,4.216,2,11,9
12,TEL,P009783,P011971,20.033,13,62,49
12,TEL,P009783,P012744,18.933,1,54,53
12,TEL,P011193,P011199,6.833,5,19,14
12,TEL,P011193,P011214,12.215,4,23,19
12,TEL,P011193,P011219,6.116,-2,11,13
12,TEL,P011193,P011971,9.449,11,22,11
12,TEL,P011193,P012744,2.716,4,11,7
12,TEL,P011199,P011214,4.8,4,14,10
12,TEL,P011199,P011971,14.95,8,46,38
12,TEL,P011199,P012744,16.983,-3,45,48
12,TEL,P011214,P011219,3.899,1,6,5
12,TEL,P011214,P011971,9.366,6,20,14
12,TEL,P011214,P012744,9.133,13,31,18
12,TEL,P011219,P011971,1.9,-4,0,4
12,TEL,P011219,P012744,0.933,4,6,2
12,TEL,P011971,P012744,15.967,3,47,44
13,MUN,P001557,P003583,7.951,4,13,9
13,MUN,P001557,P004508,5.75,5,15,10
13,MUN,P001557,P006760,10.917,7,25,18
13,MUN,P001557,P007056,9.517,3,21,18
13,MUN,P001557,P007975,13.068,-2,20,22
13,MUN,P001557,P008985,10.001,15,25,10
13,MUN,P001557,P010391,8.318,0,12,12
13,MUN,P001557,P011941,1.767,0,3,3
13,MUN,P001557,P011987,9.651,-4,14,18
13,MUN,P003583,P004508,12.084,-7,21,28
13,MUN,P003583,P006760,16.25,-4,31,35
13,MUN,P003583,P007056,12.0,-8,22,30
13,MUN,P003583,P007975,8.151,8,16,8
13,MUN,P003583,P008985,18.084,-2,35,37
13,MUN,P003583,P010391,3.334,-2,2,4
13,MUN,P003583,P011941,0.083,-3,0,3
13,MUN,P003583,P011987,1.867,-2,0,2
13,MUN,P004508,P006760,17.517,-5,33,38
13,MUN,P004508,P007056,15.634,-3,30,33
13,MUN,P004508,P007975,0.7,-1,2,3
13,MUN,P004508,P008985,17.551,0,35,35
13,MUN,P004508,P011941,2.3,-1,4,5
13,MUN,P006760,P007056,24.633,-13,44,57
13,MUN,P006760,P007975,9.8,-3,18,21
13,MUN,P006760,P008985,23.9,4,49,45
13,MUN,P006760,P010391,2.967,-3,4,7
13,MUN,P006760,P011941,3.816,-4,6,10
13,MUN,P006760,P011987,7.2,-7,10,17
13,MUN,P007056,P007975,11.434,-7,21,28
13,MUN,P007056,P008985,21.3,0,42,42
13,MUN,P007056,P010391,8.251,-3,13,16
13,MUN,P007056,P011941,5.883,-6,8,14
13,MUN,P007056,P011987,12.484,-7,19,26
13,MUN,P007975,P008985,6.284,10,16,6
13,MUN,P007975,P010391,11.702,-5,16,21
13,MUN,P007975,P011941,2.184,-2,3,5
13,MUN,P007975,P011987,12.285,-10,16,26
13,MUN,P008985,P010391,3.117,0,4,4
13,MUN,P008985,P011941,5.466,-4,8,12
13,MUN,P008985,P011987,3.833,1,6,5
13,MUN,P010391,P011941,3.834,-2,5,7
13,MUN,P010391,P011987,11.885,-5,16,21
13,MUN,P011941,P011987,5.267,-2,7,9
13,PAN,P002328,P003842,22.834,10,52,42
13,PAN,P002328,P005161,8.35,4,22,18
13,PAN,P002328,P007947,17.117,9,40,31
13,PAN,P002328,P008084,9.917,2,25,23
13,PAN,P002328,P011204,19.818,19,50,31
13,PAN,P002328,P011221,0.75,1,1,0
13,PAN,P002328,P011826,2.083,-2,4,6
13,PAN,P002328,P012712,13.867,17,38,21
13,PAN,P003842,P005161,18.067,1,37,36
13,PAN,P003842,P007947,27.05,3,51,48
13,PAN,P003842,P008084,10.834,-5,22,27
13,PAN,P003842,P011204,27.402,8,55,47
13,PAN,P003842,P011221,0.367,-2,0,2
13,PAN,P003842,P011826,4.266,0,9,9
13,PAN,P003842,P012712,22.984,9,46,37
13,PAN,P005161,P006544,1.467,-2,2,4
13,PAN,P005161,P007553,5.7,-4,4,8
13,PAN,P005161,P007947,14.483,-8,20,28
13,PAN,P005161,P008084,13.25,2,27,25
13,PAN,P005161,P011204,19.917,-2,33,35
13,PAN,P005161,P011221,0.533,1,1,0
13,PAN,P005161,P011826,4.383,4,7,3
13,PAN,P005161,P012712,11.05,-4,15,19
13,PAN,P006544,P007553,1.467,-2,2,4
13,PAN,P006544,P008084,1.467,-2,2,4
13,PAN,P006544,P011204,1.467,-2,2,4
13,PAN,P007553,P007947,2.45,-4,0,4
13,PAN,P007553,P008084,3.667,0,4,4
13,PAN,P007553,P011204,5.283,-4,4,8
13,PAN,P007553,P011826,2.2,2,2,0
13,PAN,P007553,P012712,2.033,-4,0,4
13,PAN,P007947,P008084,5.334,-2,12,14
13,PAN,P007947,P011204,23.351,5,43,38
13,PAN,P007947,P011221,0.217,0,0,0
13,PAN,P007947,P011826,4.683,0,9,9
13,PAN,P007947,P012712,24.583,9,49,40
13,PAN,P008084,P011204,11.751,2,25,23
13,PAN,P008084,P011221,1.117,-1,1,2
13,PAN,P008084,P011826,3.6,2,5,3
13,PAN,P008084,P012712,0.467,2,5,3
13,PAN,P011204,P011221,1.117,-1,1,2
13,PAN,P011204,P011826,1.783,2,2,0
13,PAN,P011204,P012712,22.251,9,45,36
13,PAN,P011221,P012712,0.367,-2,0,2
13,PAN,P011826,P012712,2.866,0,6,6
14,ASV,P000229,P002100,5.95,5,14,9
14,ASV,P000229,P004194,6.517,-3,8,11
14,ASV,P000229,P011225,6.784,-3,8,11
14,ASV,P000229,P012080,10.117,1,19,18
14,ASV,P000229,P012729,5.734,-1,8,9
14,ASV,P000229,P012730,6.217,5,14,9
14,ASV,P000229,P012731,2.617,1,3,2
14,ASV,P000229,PKIR,7.0,3,14,11
14,ASV,P002100,P004194,6.016,-8,7,15
14,ASV,P002100,P011225,6.75,-8,5,13
14,ASV,P002100,P012080,13.183,-3,25,28
14,ASV,P002100,P012729,8.416,-14,9,23
14,ASV,P002100,P012730,13.3,-4,21,25
14,ASV,P002100,P012731,5.066,-1,6,7
14,ASV,P002100,P012732,7.683,-17,6,23
14,ASV,P002100,PKIR,10.9,2,19,17
14,ASV,P004194,P011225,15.95,-13,23,36
14,ASV,P004194,P012080,15.783,-18,27,45
14,ASV,P004194,P012729,17.617,-15,30,45
14,ASV,P004194,P012731,4.1,0,4,4
14,ASV,P004194,P012732,12.183,-15,21,36
14,ASV,P004194,PKIR,2.566,-4,0,4
14,ASV,P011225,P012080,18.301,-13,32,45
14,ASV,P011225,P012729,22.401,-21,33,54
14,ASV,P011225,P012730,11.101,-8,15,23
14,ASV,P011225,P012731,4.867,2,6,4
14,ASV,P011225,P012732,17.4,-20,25,45
14,ASV,P011225,PKIR,4.65,0,5,5
14,ASV,P012080,P012729,22.283,-17,40,57
14,ASV,P012080,P012730,15.084,1,28,27
14,ASV,P012080,P012731,3.199,-3,4,7
14,ASV,P012080,P012732,17.7,-18,32,50
14,ASV,P012080,PKIR,9.35,-2,17,19
14,ASV,P012729,P012730,10.05,-10,12,22
14,ASV,P012729,P012731,4.466,3,7,4
14,ASV,P012729,P012732,20.85,-28,32,60
14,ASV,P012729,PKIR,0.383,-1,1,2
14,ASV,P012730,P012731,3.583,0,5,5
14,ASV,P012730,P012732,9.017,-12,10,22
14,ASV,P012730,PKIR,9.384,4,19,15
14,ASV,P012731,P012732,0.383,-1,1,2
14,ASV,P012731,PKIR,3.983,-5,4,9
14,ASV,P012732,PKIR,1.116,-1,1,2
14,PAR,P000956,P003983,9.883,15,27,12
14,PAR,P000956,P004172,0.534,-4,0,4
14,PAR,P000956,P007400,9.0,12,24,12
14,PAR,P000956,P007673,5.016,4,13,9
14,PAR,P000956,P008987,11.817,17,32,15
14,PAR,P000956,P009862,5.599,-1,9,10
14,PAR,P000956,P011050,0.067,-2,0,2
14,PAR,P000956,P011051,10.716,14,26,12
14,PAR,P000956,P012742,5.299,5,12,7
14,PAR,P000956,P012743,4.933,4,13,9
14,PAR,P003983,P007400,18.699,20,50,30
14,PAR,P003983,P007673,3.316,-1,6,7
14,PAR,P003983,P008987,21.882,26,58,32
14,PAR,P003983,P009862,12.832,8,27,19
14,PAR,P003983,P011051,10.216,13,29,16
14,PAR,P003983,P012742,1.983,1,6,5
14,PAR,P003983,P012743,12.649,10,29,19
14,PAR,P004172,P007400,7.851,1,14,13
14,PAR,P004172,P007673,8.117,1,14,13
14,PAR,P004172,P008987,0.967,-2,2,4
14,PAR,P004172,P009862,4.35,0,9,9
14,PAR,P004172,P011050,8.617,1,16,15
14,PAR,P004172,P012742,5.433,1,9,8
14,PAR,P004172,P012743,0.467,-2,0,2
14,PAR,P007400,P007673,8.167,1,14,13
14,PAR,P007400,P008987,24.299,20,57,37
14,PAR,P007400,P009862,16.516,9,34,25
14,PAR,P007400,P011050,7.384,3,14,11
14,PAR,P007400,P011051,12.666,16,34,18
14,PAR,P007400,P012742,11.816,3,20,17
14,PAR,P007400,P012743,12.066,3,23,20
14,PAR,P007673,P008987,2.333,2,6,4
14,PAR,P007673,P009862,7.316,0,14,14
14,PAR,P007673,P011050,8.117,1,14,13
14,PAR,P007673,P011051,0.983,-3,0,3
14,PAR,P007673,P012742,7.483,2,14,12
14,PAR,P007673,P012743,4.816,5,13,8
14,PAR,P008987,P009862,15.099,10,31,21
14,PAR,P008987,P011050,0.5,0,2,2
14,PAR,P008987,P011051,14.299,18,36,18
14,PAR,P008987,P012742,7.549,5,15,10
14,PAR,P008987,P012743,13.183,8,29,21
14,PAR,P009862,P011050,4.35,0,9,9
14,PAR,P009862,P011051,7.182,0,12,12
14,PAR,P009862,P012742,6.832,1,11,10
14,PAR,P009862,P012743,11.316,9,24,15
14,PAR,P011050,P012742,5.433,1,9,8
14,PAR,P011051,P012742,5.066,2,7,5
14,PAR,P012742,P012743,4.966,3,13,10
15,MCO,P004197,P004790,11.366,-5,19,24
15,MCO,P004197,P005985,18.5,-11,28,39
15,MCO,P004197,P008099,3.417,3,7,4
15,MCO,P004197,P010588,7.134,-6,9,15
15,MCO,P004197,P011196,1.05,0,0,0
15,MCO,P004197,P011212,9.933,-9,14,23
15,MCO,P004197,P011226,5.15,-5,7,12
15,MCO,P004197,P011231,4.467,1,7,6
15,MCO,P004197,PLCZ,12.983,-12,21,33
15,MCO,P004790,P005985,15.699,-6,26,32
15,MCO,P004790,P008099,8.533,0,15,15
15,MCO,P004790,P010588,1.35,0,2,2
15,MCO,P004790,P011196,4.016,-1,8,9
15,MCO,P004790,P011212,9.149,-1,16,17
15,MCO,P004790,P011226,10.632,-8,15,23
15,MCO,P004790,P011231,3.417,3,7,4
15,MCO,P004790,P012515,0.217,2,2,0
15,MCO,P004790,PLCZ,9.749,-8,14,22
15,MCO,P005985,P008099,7.217,1,13,12
15,MCO,P005985,P010588,10.667,-9,11,20
15,MCO,P005985,P011196,8.233,-6,11,17
15,MCO,P005985,P011212,17.483,-17,22,39
15,MCO,P005985,P011226,13.483,-12,15,27
15,MCO,P005985,P011231,9.868,-8,12,20
15,MCO,P005985,P012515,3.017,-3,6,9
15,MCO,P005985,PLCZ,15.233,-13,24,37
15,MCO,P008099,P010588,4.45,2,6,4
15,MCO,P008099,P011196,9.916,-4,18,22
15,MCO,P008099,P011212,10.15,-3,17,20
15,MCO,P008099,P011226,10.517,-2,19,21
15,MCO,P008099,P011231,11.418,-1,20,21
15,MCO,P008099,P012515,3.433,-3,4,7
15,MCO,P008099,PLCZ,0.417,-1,1,2
15,MCO,P010588,P011196,2.633,0,2,2
15,MCO,P010588,P011212,11.984,-11,11,22
15,MCO,P010588,P011226,8.617,-3,8,11
15,MCO,P010588,P011231,5.234,-5,2,7
15,MCO,P010588,PLCZ,5.067,-4,9,13
15,MCO,P011196,P011212,11.383,-8,19,27
15,MCO,P011196,P011226,7.266,-3,14,17
15,MCO,P011196,P011231,8.117,-8,14,22
15,MCO,P011196,P012515,6.45,-6,10,16
15,MCO,P011212,P011226,11.25,-5,15,20
15,MCO,P011212,P011231,13.084,-13,16,29
15,MCO,P011212,P012515,6.45,-6,10,16
15,MCO,P011212,PLCZ,9.666,-7,16,23
15,MCO,P011226,P011231,6.485,-4,9,13
15,MCO,P011226,PLCZ,7.4,-6,10,16
15,MCO,P011231,P012515,6.233,-8,8,16
15,MCO,P011231,PLCZ,0.417,-1,1,2
15,VIR,P001133,P001844,13.817,12,31,19
15,VIR,P001133,P003048,16.217,13,36,23
15,VIR,P001133,P004007,6.983,8,16,8
15,VIR,P001133,P006739,5.117,5,11,6
15,VIR,P001133,P008847,9.75,6,20,14
15,VIR,P001133,P009549,15.417,13,35,22
15,VIR,P001133,P010781,10.733,2,21,19
15,VIR,P001133,P011192,6.85,6,14,8
15,VIR,P001133,PBCN,18.984,11,40,29
15,VIR,P001844,P003048,17.516,12,40,28
15,VIR,P001844,P004007,3.883,3,12,9
15,VIR,P001844,P008847,3.699,0,9,9
15,VIR,P001844,P009549,11.483,12,28,16
15,VIR,P001844,P010781,2.716,-2,3,5
15,VIR,P001844,P011192,3.317,2,9,7
15,VIR,P001844,PBCN,13.633,9,28,19
15,VIR,P003048,P004007,7.666,8,19,11
15,VIR,P003048,P006739,0.633,0,0,0
15,VIR,P003048,P008847,7.482,5,16,11
15,VIR,P003048,P009549,13.733,11,31,20
15,VIR,P003048,P010781,8.266,4,15,11
15,VIR,P003048,P011192,7.25,9,18,9
15,VIR,P003048,PBCN,16.033,10,33,23
15,VIR,P003527,P004007,3.416,-3,4,7
15,VIR,P003527,P006739,3.416,-3,4,7
15,VIR,P003527,P008847,0.483,-2,0,2
15,VIR,P003527,P010781,3.416,-3,4,7
15,VIR,P003527,P012714,2.933,-1,4,5
15,VIR,P004007,P006739,8.332,1,12,11
15,VIR,P004007,P008847,17.431,11,36,25
15,VIR,P004007,P009549,2.433,2,2,0
15,VIR,P004007,P010781,16.048,9,32,23
15,VIR,P004007,P011192,10.866,11,28,17
15,VIR,P004007,P012714,5.633,0,9,9
15,VIR,P004007,PBCN,0.433,2,2,0
15,VIR,P006739,P008847,7.983,3,15,12
15,VIR,P006739,P009549,2.95,2,4,2
15,VIR,P006739,P010781,7.966,0,15,15
15,VIR,P006739,P012714,4.25,-3,6,9
15,VIR,P006739,PBCN,3.017,3,9,6
15,VIR,P008847,P009549,2.95,2,4,2
15,VIR,P008847,P010781,16.015,11,33,22
15,VIR,P008847,P011192,11.049,8,25,17
15,VIR,P008847,P012714,2.7,1,5,4
15,VIR,P008847,PBCN,3.85,3,9,6
15,VIR,P009549,P010781,1.617,-1,3,4
15,VIR,P009549,PBCN,13.617,11,33,22
15,VIR,P010781,P011192,9.949,11,21,10
15,VIR,P010781,P012714,5.633,0,9,9
15,VIR,P010781,PBCN,6.633,1,12,11
15,VIR,P011192,P012714,1.383,3,3,0
15,VIR,P011192,PBCN,2.4,2,2,0
16,BAR,P000925,P002939,18.833,10,40,30
16,BAR,P000925,P003478,9.05,8,20,12
16,BAR,P000925,P004866,21.417,17,49,32
16,BAR,P000925,P006435,19.933,17,47,30
16,BAR,P000925,P007519,3.417,4,9,5
16,BAR,P000925,P011244,15.517,3,31,28
16,BAR,P000925,P012745,0.833,-3,0,3
16,BAR,P002939,P003196,1.433,-2,0,2
16,BAR,P002939,P003478,9.233,8,20,12
16,BAR,P002939,P004866,18.183,13,40,27
16,BAR,P002939,P006435,16.516,13,38,25
16,BAR,P002939,P007464,1.25,-2,0,2
16,BAR,P002939,P007519,1.25,-2,0,2
16,BAR,P002939,P011244,12.1,-1,22,23
16,BAR,P002939,P012745,2.266,-5,0,5
16,BAR,P003196,P003478,5.933,5,14,9
16,BAR,P003196,P004866,5.516,-7,7,14
16,BAR,P003196,P006435,8.066,-7,11,18
16,BAR,P003196,P007464,12.166,2,21,19
16,BAR,P003196,P007519,17.249,-4,28,32
16,BAR,P003196,P009992,2.683,-2,3,5
16,BAR,P003196,P011244,5.183,-4,8,12
16,BAR,P003196,P012745,12.499,-1,20,21
16,BAR,P003478,P004866,10.95,12,25,13
16,BAR,P003478,P006435,6.983,10,18,8
16,BAR,P003478,P007464,3.2,4,9,5
16,BAR,P003478,P007519,5.5,6,14,8
16,BAR,P003478,P011244,2.317,-3,2,5
16,BAR,P003478,P012745,6.766,2,14,12
16,BAR,P004866,P006435,21.883,12,49,37
16,BAR,P004866,P007519,8.75,-3,16,19
16,BAR,P004866,P011244,18.3,-5,33,38
16,BAR,P004866,P012745,2.733,1,5,4
16,BAR,P006435,P007464,5.283,1,9,8
16,BAR,P006435,P007519,11.233,-2,20,22
16,BAR,P006435,P011244,18.383,2,37,35
16,BAR,P006435,P012745,3.716,-6,3,9
16,BAR,P007464,P007519,11.983,3,21,18
16,BAR,P007464,P009992,2.75,-2,3,5
16,BAR,P007464,P010641,0.067,0,0,0
16,BAR,P007464,P011244,2.4,4,6,2
16,BAR,P007464,P012745,9.833,-2,15,17
16,BAR,P007519,P009992,2.75,-2,3,5
16,BAR,P007519,P010641,0.067,0,0,0
16,BAR,P007519,P011244,8.6,0,17,17
16,BAR,P007519,P012745,12.133,0,20,20
16,BAR,P009992,P010641,0.067,0,0,0
16,BAR,P009992,P012745,2.75,-2,3,5
16,BAR,P010641,P012745,0.067,0,0,0
16,OLY,P001255,P003941,23.783,-9,40,49
16,OLY,P001255,P006302,6.083,1,9,8
16,OLY,P001255,P008811,5.816,-3,9,12
16,OLY,P001255,P008829,21.849,-10,37,47
16,OLY,P001255,P008855,27.649,-12,47,59
16,OLY,P001255,P010392,7.816,-2,12,14
16,OLY,P001255,P010612,17.633,-10,31,41
16,OLY,P001255,P011983,7.899,-3,11,14
16,OLY,P003941,P006302,8.25,5,16,11
16,OLY,P003941,P008829,25.199,-11,44,55
16,OLY,P003941,P008855,23.016,-14,38,52
16,OLY,P003941,P010392,5.35,0,10,10
16,OLY,P003941,P010612,17.633,-10,31,41
16,OLY,P003941,P011983,5.433,-1,9,10
16,OLY,P006302,P008811,0.233,0,0,0
16,OLY,P006302,P008829,6.566,5,14,9
16,OLY,P006302,P008855,4.1,1,7,6
16,OLY,P006302,P010392,4.416,4,9,5
16,OLY,P006302,P011983,4.416,4,9,5
16,OLY,P008811,P008829,6.983,4,12,8
16,OLY,P008811,P008855,12.566,1,21,20
16,OLY,P008811,P010392,12.799,1,21,20
16,OLY,P008811,P011983,12.799,1,21,20
16,OLY,P008829,P008855,29.749,-11,49,60
16,OLY,P008829,P010392,10.399,3,19,16
16,OLY,P008829,P010612,17.383,-11,30,41
16,OLY,P008829,P011983,10.732,3,19,16
16,OLY,P008855,P010392,13.766,-3,22,25
16,OLY,P008855,P010612,17.633,-10,31,41
16,OLY,P008855,P011983,13.849,-4,21,25
16,OLY,P010392,P010612,0.25,1,1,0
16,OLY,P010392,P011983,17.932,0,30,30
17,PAM,P000556,P003960,16.366,3,36,33
17,PAM,P000556,P004863,3.583,5,10,5
17,PAM,P000556,P006643,8.483,3,21,18
17,PAM,P000556,P007870,16.366,3,36,33
17,PAM,P000556,P009101,5.783,-1,12,13
17,PAM,P000556,P010568,8.133,1,16,15
17,PAM,P000556,P011982,0.584,0,3,3
17,PAM,P000556,P012738,0.384,1,1,0
17,PAM,P000556,P012739,0.317,1,1,0
17,PAM,P000556,P012740,6.733,0,12,12
17,PAM,P003960,P004863,3.583,5,10,5
17,PAM,P003960,P006643,8.416,5,23,18
17,PAM,P003960,P007870,20.416,9,45,36
17,PAM,P003960,P009101,6.6,4,17,13
17,PAM,P003960,P010568,11.566,1,20,19
17,PAM,P003960,P011982,4.517,4,11,7
17,PAM,P003960,P012738,0.067,0,0,0
17,PAM,P003960,P012739,0.2,-1,0,1
17,PAM,P003960,P012740,10.733,2,18,16
17,PAM,P004863,P006643,2.383,3,8,5
17,PAM,P004863,P007870,3.583,5,10,5
17,PAM,P004863,P010568,3.133,5,7,2
17,PAM,P004863,P011982,1.933,3,5,2
17,PAM,P004863,P012738,1.933,3,5,2
17,PAM,P004863,P012739,1.933,3,5,2
17,PAM,P006643,P007870,8.683,5,23,18
17,PAM,P006643,P009101,9.367,-3,18,21
17,PAM,P006643,P011982,3.901,-1,7,8
17,PAM,P006643,P012738,3.651,-4,4,8
17,PAM,P006643,P012739,3.384,-4,4,8
17,PAM,P007870,P009101,6.867,4,17,13
17,PAM,P007870,P010393,0.567,0,0,0
17,PAM,P007870,P010568,11.966,3,21,18
17,PAM,P007870,P011982,5.184,6,12,6
17,PAM,P007870,P012738,0.367,1,1,0
17,PAM,P007870,P012740,11.133,4,19,15
17,PAM,P009101,P011982,4.184,0,8,8
17,PAM,P009101,P012738,3.367,-5,3,8
17,PAM,P009101,P012739,3.1,-5,3,8
17,PAM,P009101,P012740,0.6,2,2,0
17,PAM,P010393,P010568,5.367,-7,8,15
17,PAM,P010393,P011982,5.367,-7,8,15
17,PAM,P010393,P012738,2.65,1,5,4
17,PAM,P010393,P012739,2.15,-8,3,11
17,PAM,P010393,P012740,5.367,-7,8,15
17,PAM,P010568,P011982,19.333,-2,34,36
17,PAM,P010568,P012738,12.983,7,25,18
17,PAM,P010568,P012739,12.65,-4,22,26
17,PAM,P010568,P012740,23.933,-4,39,43
17,PAM,P011982,P012738,16.734,3,29,26
17,PAM,P011982,P012739,16.067,-8,26,34
17,PAM,P011982,P012740,17.8,-2,29,31
17,PAM,P012738,P012739,13.717,1,23,22
17,PAM,P012738,P012740,11.083,4,20,16
17,PAM,P012739,P012740,10.75,-7,17,24
17,ULK,P001932,P004004,1.266,-3,0,3
17,ULK,P001932,P005844,3.516,-6,2,8
17,ULK,P001932,P006661,0.533,-1,0,1
17,ULK,P001932,P008962,2.817,-3,2,5
17,ULK,P001932,P009849,3.55,-5,2,7
17,ULK,P001932,P010560,2.817,-3,2,5
17,ULK,P001932,P011157,0.567,0,0,0
17,ULK,P001932,P011980,1.266,-3,0,3
17,ULK,P002968,P004004,5.384,-5,9,14
17,ULK,P002968,P005844,2.5,-3,4,7
17,ULK,P002968,P006661,6.201,-10,9,19
17,ULK,P002968,P008962,10.651,4,24,20
17,ULK,P002968,P009849,10.384,4,24,20
17,ULK,P002968,P011052,14.684,4,33,29
17,ULK,P002968,P011157,2.617,-2,5,7
17,ULK,P002968,P011980,10.651,4,24,20
17,ULK,P002969,P004004,0.067,-2,0,2
17,ULK,P002969,P006661,0.067,-2,0,2
17,ULK,P002969,P008962,0.067,-2,0,2
17,ULK,P002969,P011980,0.067,-2,0,2
17,ULK,P004004,P005844,17.133,0,30,30
17,ULK,P004004,P006661,20.285,2,38,36
17,ULK,P004004,P008962,14.785,6,29,23
17,ULK,P004004,P009849,5.967,5,14,9
17,ULK,P004004,P010560,7.067,-1,12,13
17,ULK,P004004,P011052,7.084,-5,12,17
17,ULK,P004004,P011157,3.717,-2,5,7
17,ULK,P004004,P011980,2.917,-3,3,6
17,ULK,P005844,P006661,16.017,4,30,26
17,ULK,P005844,P008962,18.784,0,32,32
17,ULK,P005844,P009849,11.517,-3,18,21
17,ULK,P005844,P010560,12.7,-6,18,24
17,ULK,P005844,P011052,6.55,-8,8,16
17,ULK,P005844,P011980,2.483,-2,2,4
17,ULK,P006661,P008962,15.469,4,31,27
17,ULK,P006661,P009849,6.301,3,16,13
17,ULK,P006661,P010560,6.667,1,12,11
17,ULK,P006661,P011052,6.951,-2,14,16
17,ULK,P006661,P011157,3.984,-1,7,8
17,ULK,P006661,P011980,3.001,-6,3,9
17,ULK,P008962,P009849,23.819,6,50,44
17,ULK,P008962,P010560,14.468,-6,21,27
17,ULK,P008962,P011052,16.668,7,37,30
17,ULK,P008962,P011157,3.634,1,6,5
17,ULK,P008962,P011980,12.318,3,28,25
17,ULK,P009849,P010560,7.418,-5,9,14
17,ULK,P009849,P011052,15.068,9,36,27
17,ULK,P009849,P011157,2.534,1,6,5
17,ULK,P009849,P011980,11.65,1,25,24
17,ULK,P010560,P011052,5.001,-5,7,12
17,ULK,P010560,P011157,1.734,1,3,2
17,ULK,P011052,P011157,5.684,-1,11,12
17,ULK,P011052,P011980,10.45,9,26,17
17,ULK,P011157,P011980,0.533,-1,1,2
18,RED,P000848,P002553,13.601,9,30,21
18,RED,P000848,P005099,8.001,12,19,7
18,RED,P000848,P006436,15.351,-6,33,39
18,RED,P000848,P007960,13.867,5,36,31
18,RED,P000848,P008966,2.367,-1,5,6
18,RED,P000848,P009035,7.367,-3,16,19
18,RED,P000848,P011224,0.517,3,3,0
18,RED,P000848,P011964,9.201,-2,13,15
18,RED,P000848,PJDR,23.068,3,49,46
18,RED,P002553,P005099,14.851,8,25,17
18,RED,P002553,P006436,16.467,-6,28,34
18,RED,P002553,P007960,11.15,-3,22,25
18,RED,P002553,P009035,2.0,2,4,2
18,RED,P002553,P011224,7.7,-5,10,15
18,RED,P002553,P011964,9.034,4,13,9
18,RED,P002553,PJDR,15.001,11,32,21
18,RED,P005099,P006436,12.383,0,20,20
18,RED,P005099,P007960,10.483,0,21,21
18,RED,P005099,P008966,1.317,3,5,2
18,RED,P005099,P009035,6.166,2,12,10
18,RED,P005099,P011224,10.733,-1,17,18
18,RED,P005099,P011964,7.617,7,11,4
18,RED,P005099,PJDR,9.917,13,22,9
18,RED,P006436,P007960,24.633,-5,50,55
18,RED,P006436,P008966,6.834,-2,14,16
18,RED,P006436,P009035,10.683,-6,18,24
18,RED,P006436,P011224,14.549,-8,20,28
18,RED,P006436,P011964,6.534,-18,2,20
18,RED,P006436,P012711,3.15,-4,4,8
18,RED,P006436,PJDR,17.484,-9,35,44
18,RED,P007960,P008966,6.234,0,14,14
18,RED,P007960,P009035,9.216,-2,19,21
18,RED,P007960,P011224,12.316,-4,20,24
18,RED,P007960,P011964,1.15,-5,0,5
18,RED,P007960,P012711,3.15,-4,4,8
18,RED,P007960,PJDR,14.333,-2,34,36
18,RED,P008966,P011224,4.467,-1,9,10
18,RED,P008966,P011964,0.6,-2,0,2
18,RED,P008966,P012711,3.15,-4,4,8
18,RED,P008966,PJDR,2.367,-1,5,6
18,RED,P009035,P011224,2.949,-2,3,5
18,RED,P009035,P011964,2.617,-11,0,11
18,RED,P009035,PJDR,9.734,-4,20,24
18,RED,P011224,P011964,2.583,-4,0,4
18,RED,P011224,P012711,3.15,-4,4,8
18,RED,P011224,PJDR,0.3,2,2,0
18,RED,P011964,PJDR,9.668,-5,13,18
18,ZAL,P002329,P002676,13.917,1,31,30
18,ZAL,P002329,P003210,3.016,3,6,3
18,ZAL,P002329,P003211,26.584,25,65,40
18,ZAL,P002329,P005504,5.983,1,10,9
18,ZAL,P002329,P007109,22.651,19,54,35
18,ZAL,P002329,P007513,0.3,-2,0,2
18,ZAL,P002329,P010390,22.35,-1,43,44
18,ZAL,P002329,P011218,23.401,6,48,42
18,ZAL,P002329,P011965,5.384,-6,9,15
18,ZAL,P002329,P012715,12.55,6,30,24
18,ZAL,P002676,P003210,3.016,3,6,3
18,ZAL,P002676,P003211,9.084,11,22,11
18,ZAL,P002676,P005504,9.549,-7,13,20
18,ZAL,P002676,P007109,8.118,5,20,15
18,ZAL,P002676,P007513,1.75,-7,0,7
18,ZAL,P002676,P010390,6.2,-9,10,19
18,ZAL,P002676,P011218,8.701,-8,16,24
18,ZAL,P002676,P011965,7.834,-13,8,21
18,ZAL,P002676,P012715,11.367,-4,18,22
18,ZAL,P003210,P003211,1.35,5,5,0
18,ZAL,P003210,P005504,2.233,3,6,3
18,ZAL,P003210,P010390,0.783,0,0,0
18,ZAL,P003210,P012715,1.666,-2,1,3
18,ZAL,P003211,P005504,5.034,3,7,4
18,ZAL,P003211,P007109,20.685,21,49,28
18,ZAL,P003211,P007513,0.033,0,0,0
18,ZAL,P003211,P010390,19.3,8,42,34
18,ZAL,P003211,P011218,18.6,13,42,29
18,ZAL,P003211,P011965,6.134,-3,6,9
18,ZAL,P003211,P012715,10.0,9,22,13
18,ZAL,P005504,P007109,5.634,-5,7,12
18,ZAL,P005504,P007513,1.45,-5,0,5
18,ZAL,P005504,P011218,4.5,-5,7,12
18,ZAL,P005504,P011965,6.45,-6,7,13
18,ZAL,P005504,P012715,4.299,-7,3,10
18,ZAL,P007109,P010390,13.667,9,31,22
18,ZAL,P007109,P011218,18.95,11,43,32
18,ZAL,P007109,P011965,6.501,-2,11,13
18,ZAL,P007109,P012715,6.334,14,21,7
18,ZAL,P007513,P010390,0.283,-2,0,2
18,ZAL,P007513,P011965,1.717,-7,0,7
18,ZAL,P007513,P012715,1.467,-5,0,5
18,ZAL,P010390,P011218,17.084,5,33,28
18,ZAL,P010390,P011965,4.2,-7,7,14
18,ZAL,P010390,P012715,5.533,-7,6,13
18,ZAL,P011218,P011965,2.784,-3,6,9
18,ZAL,P011218,P012715,7.184,1,17,16
18,ZAL,P011965,P012715,4.4,-9,2,11
19,ASV,P000229,P004194,3.4,-8,2,10
19,ASV,P000229,P006568,3.4,-8,2,10
19,ASV,P000229,P011225,3.4,-8,2,10
19,ASV,P000229,P012080,3.4,-8,2,10
19,ASV,P002100,P004194,13.299,10,37,27
19,ASV,P002100,P006568,8.4,5,20,15
19,ASV,P002100,P011225,19.85,14,57,43
19,ASV,P002100,P011386,6.733,5,13,8
19,ASV,P002100,P012080,5.834,2,14,12
19,ASV,P002100,P012729,19.2,17,56,39
19,ASV,P002100,P012730,12.267,6,27,21
19,ASV,P002100,P012731,12.216,15,39,24
19,ASV,P002100,P012732,8.533,2,17,15
19,ASV,P004194,P006568,15.249,-13,23,36
19,ASV,P004194,P011225,23.265,-5,49,54
19,ASV,P004194,P011386,0.233,-1,0,1
19,ASV,P004194,P012080,11.483,-11,15,26
19,ASV,P004194,P012729,7.349,9,26,17
19,ASV,P004194,P012730,1.633,-4,2,6
19,ASV,P004194,P012731,7.349,9,26,17
19,ASV,P004194,P012732,10.732,-10,16,26
19,ASV,P006568,P011225,16.266,-10,29,39
19,ASV,P006568,P012080,11.6,-6,21,27
19,ASV,P006568,P012729,1.017,3,6,3
19,ASV,P006568,P012730,0.733,-2,2,4
19,ASV,P006568,P012732,8.399,-9,13,22
19,ASV,P011225,P012080,15.2,-14,23,37
19,ASV,P011225,P012729,15.233,12,48,36
19,ASV,P011225,P012730,8.733,-5,18,23
19,ASV,P011225,P012731,8.483,13,31,18
19,ASV,P011225,P012732,15.098,-9,27,36
19,ASV,P011386,P012729,8.616,-2,13,15
19,ASV,P011386,P012730,8.383,-1,13,14
19,ASV,P011386,P012731,7.049,-4,11,15
19,ASV,P011386,P012732,3.45,-5,2,7
19,ASV,P012080,P012729,3.717,-3,8,11
19,ASV,P012080,P012730,3.6,-8,2,10
19,ASV,P012080,P012732,5.966,-8,7,15
19,ASV,P012729,P012730,15.483,-2,29,31
19,ASV,P012729,P012731,15.532,9,42,33
19,ASV,P012729,P012732,9.249,-3,16,19
19,ASV,P012730,P012731,8.183,0,16,16
19,ASV,P012730,P012732,9.449,-8,15,23
19,ASV,P012731,P012732,3.316,-6,3,9
19,IST,P004554,P004888,21.534,10,53,43
19,IST,P004554,P006372,2.95,0,2,2
19,IST,P004554,P006590,14.784,8,35,27
19,IST,P004554,P007200,19.867,16,50,34
19,IST,P004554,P009664,18.234,4,40,36
19,IST,P004554,P011078,13.65,-3,26,29
19,IST,P004554,P012710,5.717,5,14,9
19,IST,P004888,P006372,3.283,-5,4,9
19,IST,P004888,P006590,20.834,11,55,44
19,IST,P004888,P007200,24.651,20,61,41
19,IST,P004888,P009513,1.9,-7,2,9
19,IST,P004888,P009664,25.501,8,56,48
19,IST,P004888,P011078,12.15,4,31,27
19,IST,P004888,P011981,6.3,4,18,14
19,IST,P004888,P012415,1.367,-3,2,5
19,IST,P004888,P012710,5.717,5,14,9
19,IST,P004888,PLHK,3.967,-3,4,7
19,IST,P006372,P006590,6.366,-9,14,23
19,IST,P006372,P007200,5.417,-4,12,16
19,IST,P006372,P009513,0.633,-7,2,9
19,IST,P006372,P009664,6.383,-4,9,13
19,IST,P006372,P011078,3.7,-2,5,7
19,IST,P006372,P011981,5.883,-11,14,25
19,IST,P006372,P012415,0.717,-2,2,4
19,IST,P006590,P007200,23.084,18,57,39
19,IST,P006590,P009513,0.633,-7,2,9
19,IST,P006590,P009664,20.45,6,45,39
19,IST,P006590,P011078,7.6,0,16,16
19,IST,P006590,P011981,10.116,2,30,28
19,IST,P006590,P012415,1.917,-3,4,7
19,IST,P006590,P012710,5.717,5,14,9
19,IST,P006590,PLHK,3.967,-3,4,7
19,IST,P007200,P009513,1.567,-2,0,2
19,IST,P007200,P009664,24.234,10,53,43
19,IST,P007200,P011078,11.567,3,26,23
19,IST,P007200,P011981,8.484,3,21,18
19,IST,P007200,P012415,0.717,-2,2,4
19,IST,P007200,P012710,5.717,5,14,9
19,IST,P007200,PLHK,3.967,-3,4,7
19,IST,P009513,P009664,1.867,-4,0,4
19,IST,P009513,P011981,2.2,-9,2,11
19,IST,P009664,P011078,14.783,1,30,29
19,IST,P009664,P011981,9.383,3,21,18
19,IST,P009664,P012415,1.534,-5,2,7
19,IST,P009664,PLHK,3.967,-3,4,7
19,IST,P011078,P011981,2.95,5,10,5
19,IST,P011981,P012415,2.084,-5,4,9
20,MIL,P000796,P002812,1.367,2,2,0
20,MIL,P000796,P002849,21.15,13,44,31
20,MIL,P000796,P005670,2.117,3,5,2
20,MIL,P000796,P006433,28.284,13,55,42
20,MIL,P000796,P006509,1.533,-1,5,6
20,MIL,P000796,P007201,25.667,15,47,32
20,MIL,P000796,P007831,29.401,12,56,44
20,MIL,P000796,P009960,6.683,-3,10,13
20,MIL,P000796,P011205,2.067,-6,0,6
20,MIL,P000796,P011926,1.067,0,0,0
20,MIL,P002812,P002849,4.533,5,5,0
20,MIL,P002812,P005670,4.333,5,5,0
20,MIL,P002812,P006433,2.384,0,2,2
20,MIL,P002812,P006509,4.533,5,5,0
20,MIL,P002812,P007201,1.367,2,2,0
20,MIL,P002812,P007831,2.584,0,2,2
20,MIL,P002812,P009960,1.017,-2,0,2
20,MIL,P002812,P011205,5.55,3,5,2
20,MIL,P002849,P005670,9.366,6,13,7
20,MIL,P002849,P006433,21.3,13,44,31
20,MIL,P002849,P006509,10.099,1,14,13
20,MIL,P002849,P007201,20.633,8,35,27
20,MIL,P002849,P007831,21.5,13,44,31
20,MIL,P002849,P009960,1.55,-3,0,3
20,MIL,P002849,P011205,9.149,2,9,7
20,MIL,P002849,P011926,1.916,2,4,2
20,MIL,P005670,P006433,0.567,4,4,0
20,MIL,P005670,P006509,8.799,2,9,7
20,MIL,P005670,P007201,2.7,-3,1,4
20,MIL,P005670,P007831,1.684,3,5,2
20,MIL,P005670,P009960,2.667,-4,1,5
20,MIL,P005670,P011205,8.366,2,9,7
20,MIL,P005670,P011926,1.333,2,4,2
20,MIL,P006433,P006509,1.1,-1,5,6
20,MIL,P006433,P007201,24.55,16,46,30
20,MIL,P006433,P007831,29.884,11,55,44
20,MIL,P006433,P009960,6.15,-4,9,13
20,MIL,P006433,P011205,3.667,-8,0,8
20,MIL,P006433,P011926,1.65,0,0,0
20,MIL,P006509,P007201,1.583,-2,0,2
20,MIL,P006509,P007831,1.3,-1,5,6
20,MIL,P006509,P009960,1.55,-3,0,3
20,MIL,P006509,P011205,8.566,2,9,7
20,MIL,P006509,P011926,1.333,2,4,2
20,MIL,P007201,P007831,25.667,15,47,32
20,MIL,P007201,P009960,5.25,3,10,7
20,MIL,P007201,P011205,1.583,-2,0,2
20,MIL,P007831,P009960,7.267,-5,10,15
20,MIL,P007831,P011205,3.867,-8,0,8
20,MIL,P007831,P011926,1.65,0,0,0
20,MIL,P009960,P011205,3.134,-11,0,11
20,MIL,P011205,P011926,2.983,2,4,2
20,OLY,P001255,P003941,26.866,-8,41,49
20,OLY,P001255,P006302,13.05,-10,15,25
20,OLY,P001255,P006589,7.166,-1,5,6
20,OLY,P001255,P008811,6.15,-5,4,9
20,OLY,P001255,P008829,18.416,-12,28,40
20,OLY,P001255,P008855,25.416,-7,38,45
20,OLY,P001255,P010392,8.184,-3,11,14
20,OLY,P001255,P010612,4.833,1,11,10
20,OLY,P001255,P011983,17.15,-3,19,22
20,OLY,P001255,P012023,4.833,-4,8,12
20,OLY,P003941,P006302,8.5,-5,11,16
20,OLY,P003941,P006589,5.566,-1,5,6
20,OLY,P003941,P008829,17.6,-3,28,31
20,OLY,P003941,P008855,25.333,-7,38,45
20,OLY,P003941,P010392,5.151,2,7,5
20,OLY,P003941,P010612,6.35,1,11,10
20,OLY,P003941,P011983,13.333,-7,15,22
20,OLY,P003941,P012023,4.833,-4,8,12
20,OLY,P006302,P006589,4.799,-6,3,9
20,OLY,P006302,P008811,8.866,-10,6,16
20,OLY,P006302,P008829,4.9,-9,2,11
20,OLY,P006302,P008855,8.283,-6,10,16
20,OLY,P006302,P010392,10.8,-10,8,18
20,OLY,P006302,P011983,5.433,0,5,5
20,OLY,P006302,P012023,4.833,-4,8,12
20,OLY,P006589,P008811,4.666,-5,2,7
20,OLY,P006589,P008829,0.233,0,0,0
20,OLY,P006589,P008855,7.016,-2,6,8
20,OLY,P006589,P010392,3.066,-5,2,7
20,OLY,P006589,P011983,8.416,-4,5,9
20,OLY,P008811,P008829,4.733,-3,6,9
20,OLY,P008811,P008855,5.583,4,8,4
20,OLY,P008811,P010392,10.016,-4,12,16
20,OLY,P008811,P010612,1.15,6,6,0
20,OLY,P008811,P011983,5.3,1,4,3
20,OLY,P008829,P008855,18.683,3,32,29
20,OLY,P008829,P010392,9.267,-1,13,14
20,OLY,P008829,P010612,7.5,7,17,10
20,OLY,P008829,P011983,8.0,-6,10,16
20,OLY,P008855,P010392,7.817,6,13,7
20,OLY,P008855,P010612,7.5,7,17,10
20,OLY,P008855,P011983,13.2,-6,14,20
20,OLY,P008855,P012023,4.833,-4,8,12
20,OLY,P010392,P010612,2.667,6,6,0
20,OLY,P010392,P011983,3.7,1,4,3
21,PAN,P001926,P002328,18.768,-23,25,48
21,PAN,P001926,P003842,14.334,-19,19,38
21,PAN,P001926,P007947,6.234,-16,5,21
21,PAN,P001926,P008084,8.184,-7,13,20
21,PAN,P001926,P011204,9.167,-5,14,19
21,PAN,P001926,P011209,3.534,-2,3,5
21,PAN,P001926,P011221,7.968,-6,9,15
21,PAN,P001926,P011826,6.901,-4,9,13
21,PAN,P001926,P012712,14.118,-18,15,33
21,PAN,P002328,P003842,16.967,-18,27,45
21,PAN,P002328,P007947,8.867,-15,13,28
21,PAN,P002328,P008084,10.034,-7,19,26
21,PAN,P002328,P011204,12.467,-5,23,28
21,PAN,P002328,P011221,5.101,-5,7,12
21,PAN,P002328,P011826,4.034,-3,7,10
21,PAN,P002328,P012712,12.034,-16,15,31
21,PAN,P003842,P007947,18.801,-7,34,41
21,PAN,P003842,P008084,16.617,4,36,32
21,PAN,P003842,P011204,20.667,6,43,37
21,PAN,P003842,P011209,3.234,0,6,6
21,PAN,P003842,P011826,6.7,8,15,7
21,PAN,P003842,P012712,10.284,-14,12,26
21,PAN,P007553,P007947,0.767,-2,0,2
21,PAN,P007553,P011204,3.4,0,8,8
21,PAN,P007553,P011209,4.167,-2,8,10
21,PAN,P007553,P011826,4.167,-2,8,10
21,PAN,P007553,P012712,4.167,-2,8,10
21,PAN,P007947,P008084,12.667,7,28,21
21,PAN,P007947,P011204,12.567,9,29,20
21,PAN,P007947,P011209,4.001,-2,6,8
21,PAN,P007947,P011826,7.467,6,15,9
21,PAN,P007947,P012712,6.901,-16,6,22
21,PAN,P008084,P011204,16.134,4,34,30
21,PAN,P008084,P011209,2.567,1,5,4
21,PAN,P008084,P011221,2.684,-2,3,5
21,PAN,P008084,P011826,8.317,8,18,10
21,PAN,P011204,P011209,6.934,5,17,12
21,PAN,P011204,P011221,2.034,2,4,2
21,PAN,P011204,P011826,11.067,12,27,15
21,PAN,P011204,P012712,9.967,4,21,17
21,PAN,P011209,P011221,3.834,3,6,3
21,PAN,P011209,P011826,8.001,1,14,13
21,PAN,P011209,P012712,8.668,0,15,15
21,PAN,P011221,P011826,7.868,0,13,13
21,PAN,P011221,P012712,6.251,0,10,10
21,PAN,P011826,P012712,10.418,-2,18,20
21,ULK,P001932,P004004,13.817,17,37,20
21,ULK,P001932,P005844,11.267,-1,20,21
21,ULK,P001932,P006661,15.467,5,32,27
21,ULK,P001932,P006961,4.367,-4,8,12
21,ULK,P001932,P008962,24.75,26,61,35
21,ULK,P001932,P010560,21.617,26,52,26
21,ULK,P001932,P011052,3.3,0,9,9
21,ULK,P001932,P011157,18.017,23,49,26
21,ULK,P001932,P011980,4.534,-4,8,12
21,ULK,P004004,P005844,8.466,-9,9,18
21,ULK,P004004,P006661,3.6,-9,2,11
21,ULK,P004004,P006961,6.833,-4,7,11
21,ULK,P004004,P008962,16.35,12,41,29
21,ULK,P004004,P010560,19.583,17,46,29
21,ULK,P004004,P011052,9.366,-9,11,20
21,ULK,P004004,P011157,14.717,17,39,22
21,ULK,P005844,P006661,15.317,-9,23,32
21,ULK,P005844,P006961,12.55,-7,18,25
21,ULK,P005844,P008962,8.366,-2,14,16
21,ULK,P005844,P010560,12.566,4,21,17
21,ULK,P005844,P011052,11.266,-8,15,23
21,ULK,P005844,P011980,4.534,-4,8,12
21,ULK,P006661,P006961,7.817,-10,11,21
21,ULK,P006661,P008962,12.433,7,26,19
21,ULK,P006661,P010560,9.15,10,18,8
21,ULK,P006661,P011052,8.25,-8,14,22
21,ULK,P006661,P011157,5.1,6,14,8
21,ULK,P006661,P011980,4.534,-4,8,12
21,ULK,P006961,P010560,6.083,4,10,6
21,ULK,P006961,P011052,8.183,-3,10,13
21,ULK,P006961,P011980,4.367,-4,8,12
21,ULK,P008962,P010560,22.483,23,54,31
21,ULK,P008962,P011052,5.833,-5,13,18
21,ULK,P008962,P011157,18.917,23,51,28
21,ULK,P010560,P011052,7.116,1,12,11
21,ULK,P010560,P011157,16.167,23,43,20
21,ULK,P010560,P011980,0.167,0,0,0
21,ULK,P011052,P011157,2.75,0,8,8
22,BAR,P000925,P002939,15.616,6,35,29
22,BAR,P000925,P003478,8.566,4,20,16
22,BAR,P000925,P004866,13.966,9,33,24
22,BAR,P000925,P006435,15.1,10,38,28
22,BAR,P000925,P007464,4.15,2,9,7
22,BAR,P000925,P007519,7.633,8,22,14
22,BAR,P000925,P009992,1.866,0,2,2
22,BAR,P000925,P011244,14.6,12,35,23
22,BAR,P000925,P012745,7.699,1,18,17
22,BAR,P002939,P003196,9.316,0,29,29
22,BAR,P002939,P003478,7.149,1,21,20
22,BAR,P002939,P004866,18.016,5,43,38
22,BAR,P002939,P006435,20.85,8,56,48
22,BAR,P002939,P007519,0.95,1,4,3
22,BAR,P002939,P009992,2.899,-3,4,7
22,BAR,P002939,P011244,17.6,10,45,35
22,BAR,P002939,P012745,7.332,-4,19,23
22,BAR,P003196,P003478,10.184,-5,20,25
22,BAR,P003196,P004866,7.383,1,19,18
22,BAR,P003196,P006435,12.85,1,35,34
22,BAR,P003196,P007464,0.517,0,0,0
22,BAR,P003196,P007519,8.251,-4,10,14
22,BAR,P003196,P009992,4.2,-5,4,9
22,BAR,P003196,P011244,6.6,1,19,18
22,BAR,P003196,P012745,10.967,-5,20,25
22,BAR,P003478,P004866,0.233,0,0,0
22,BAR,P003478,P006435,7.351,2,23,21
22,BAR,P003478,P007464,4.667,2,9,7
22,BAR,P003478,P007519,12.167,-2,21,23
22,BAR,P003478,P009992,6.199,-5,6,11
22,BAR,P003478,P010641,0.133,0,0,0
22,BAR,P003478,P011244,2.967,0,7,7
22,BAR,P003478,P012745,15.916,-1,33,34
22,BAR,P004866,P006435,20.599,9,50,41
22,BAR,P004866,P007519,3.85,6,11,5
22,BAR,P004866,P011244,18.233,13,47,34
22,BAR,P004866,P012745,3.116,-3,5,8
22,BAR,P006435,P007519,7.1,3,17,14
22,BAR,P006435,P011244,19.6,10,50,40
22,BAR,P006435,P012745,8.35,1,23,22
22,BAR,P007464,P007519,4.667,2,9,7
22,BAR,P007464,P012745,4.667,2,9,7
22,BAR,P007519,P009992,3.3,-2,2,4
22,BAR,P007519,P010641,0.133,0,0,0
22,BAR,P007519,P011244,4.117,4,11,7
22,BAR,P007519,P012745,11.9,0,21,21
22,BAR,P009992,P010641,0.133,0,0,0
22,BAR,P009992,P011244,1.083,2,2,0
22,BAR,P009992,P012745,5.116,-7,4,11
22,BAR,P010641,P012745,0.133,0,0,0
22,PAR,P000956,P003983,9.117,5,18,13
22,PAR,P000956,P007673,6.2,7,13,6
22,PAR,P000956,P008987,6.05,0,9,9
22,PAR,P000956,P009862,1.617,-2,3,5
22,PAR,P000956,P011051,4.684,3,12,9
22,PAR,P000956,P012742,1.3,0,2,2
22,PAR,P000956,P012743,7.5,7,15,8
22,PAR,P003983,P004058,3.966,-2,5,7
22,PAR,P003983,P007400,6.55,2,14,12
22,PAR,P003983,P007673,10.633,5,20,15
22,PAR,P003983,P008987,17.633,-3,28,31
22,PAR,P003983,P009862,8.033,-5,13,18
22,PAR,P003983,P011050,0.167,0,0,0
22,PAR,P003983,P011051,11.367,0,24,24
22,PAR,P003983,P012742,3.233,-1,4,5
22,PAR,P003983,P012743,12.233,7,22,15
22,PAR,P004058,P007400,1.166,-4,0,4
22,PAR,P004058,P007673,4.549,0,7,7
22,PAR,P004058,P008987,4.066,0,7,7
22,PAR,P004058,P009862,1.299,-2,2,4
22,PAR,P004058,P011051,1.133,-4,0,4
22,PAR,P004058,P012742,0.683,-4,0,4
22,PAR,P004058,P012743,4.066,0,7,7
22,PAR,P007400,P007673,5.783,1,18,17
22,PAR,P007400,P008987,19.417,-8,42,50
22,PAR,P007400,P009862,24.149,-13,54,67
22,PAR,P007400,P011050,9.65,1,24,23
22,PAR,P007400,P011051,13.4,-7,30,37
22,PAR,P007400,P012742,19.216,-11,46,57
22,PAR,P007400,P012743,2.333,-5,4,9
22,PAR,P007673,P008987,7.933,2,13,11
22,PAR,P007673,P009862,5.449,3,18,15
22,PAR,P007673,P011050,1.15,-3,2,5
22,PAR,P007673,P011051,8.201,9,25,16
22,PAR,P007673,P012742,5.1,1,16,15
22,PAR,P007673,P012743,10.266,7,20,13
22,PAR,P008987,P009862,21.033,-13,43,56
22,PAR,P008987,P011050,9.034,4,22,18
22,PAR,P008987,P011051,11.334,-12,19,31
22,PAR,P008987,P012742,16.4,-11,32,43
22,PAR,P008987,P012743,10.832,-3,17,20
22,PAR,P009862,P011050,9.65,1,24,23
22,PAR,P009862,P011051,15.683,-12,31,43
22,PAR,P009862,P012742,19.549,-16,44,60
22,PAR,P009862,P012743,1.666,-5,4,9
22,PAR,P011050,P011051,0.267,0,0,0
22,PAR,P011050,P012742,9.75,1,24,23
22,PAR,P011051,P012742,8.8,-10,18,28
22,PAR,P011051,P012743,3.067,5,9,4
22,PAR,P012742,P012743,3.633,-5,6,11
23,MAD,P001392,P003108,3.117,0,9,9
23,MAD,P001392,P004887,1.05,-3,2,5
23,MAD,P001392,P005791,9.5,-3,15,18
23,MAD,P001392,P005928,10.55,-6,17,23
23,MAD,P001392,P006540,3.95,-4,2,6
23,MAD,P001392,P009005,6.6,-2,15,17
23,MAD,P001392,P010357,7.433,-6,8,14
23,MAD,P003108,P004887,5.717,3,16,13
23,MAD,P003108,P005791,2.067,3,7,4
23,MAD,P003108,P005928,3.117,0,9,9
23,MAD,P003108,P009005,4.317,-3,10,13
23,MAD,P003108,PBMT,3.467,9,13,4
23,MAD,P003108,PCVM,4.667,6,14,8
23,MAD,P003108,PTGB,4.667,6,14,8
23,MAD,P004887,P005928,4.05,-1,12,13
23,MAD,P004887,P006540,1.283,2,5,3
23,MAD,P004887,P009005,11.167,2,29,27
23,MAD,P004887,P010357,7.584,-3,13,16
23,MAD,P004887,PBMT,17.034,14,48,34
23,MAD,P004887,PCVM,16.701,9,41,32
23,MAD,P004887,PTGB,18.418,9,46,37
23,MAD,P005791,P005928,19.25,6,40,34
23,MAD,P005791,P006540,12.1,-2,18,20
23,MAD,P005791,P009005,11.65,0,22,22
23,MAD,P005791,P010357,16.25,3,33,30
23,MAD,P005791,PBMT,4.583,10,16,6
23,MAD,P005791,PTGB,1.6,7,9,2
23,MAD,P005928,P006540,13.383,0,23,23
23,MAD,P005928,P009005,15.7,-1,34,35
23,MAD,P005928,P010357,16.25,3,33,30
23,MAD,P005928,PBMT,7.583,12,26,14
23,MAD,P005928,PTGB,3.317,7,14,7
23,MAD,P006540,P009005,7.383,1,14,13
23,MAD,P006540,P010357,11.167,-2,18,20
23,MAD,P006540,PBMT,4.266,5,12,7
23,MAD,P009005,P010357,10.117,-3,17,20
23,MAD,P009005,PBMT,8.383,8,24,16
23,MAD,P009005,PCVM,7.117,3,17,14
23,MAD,P009005,PTGB,8.834,3,22,19
23,MAD,P010357,PBMT,9.767,7,27,20
23,MAD,P010357,PCVM,7.584,-3,13,16
23,MAD,P010357,PTGB,9.184,4,22,18
23,MAD,PBMT,PCVM,14.034,12,38,26
23,MAD,PBMT,PTGB,17.351,19,52,33
23,MAD,PCVM,PTGB,16.701,9,41,32
23,ZAL,P002329,P003210,8.916,-8,21,29
23,ZAL,P002329,P003211,5.016,-4,9,13
23,ZAL,P002329,P005504,6.9,0,20,20
23,ZAL,P002329,P007109,21.182,-9,40,49
23,ZAL,P002329,P007513,14.716,-1,27,28
23,ZAL,P002329,P010390,16.266,-4,30,34
23,ZAL,P002329,P011218,19.299,-6,36,42
23,ZAL,P002329,P011965,8.483,-9,21,30
23,ZAL,P002329,P012715,12.082,-15,24,39
23,ZAL,P003210,P003211,1.1,3,3,0
23,ZAL,P003210,P005504,7.583,2,16,14
23,ZAL,P003210,P006860,4.95,2,10,8
23,ZAL,P003210,P007109,4.549,-4,8,12
23,ZAL,P003210,P007513,7.666,0,14,14
23,ZAL,P003210,P010390,3.467,1,10,9
23,ZAL,P003210,P011965,15.616,3,38,35
23,ZAL,P003210,P012715,12.749,-3,32,35
23,ZAL,P003211,P005504,4.317,6,12,6
23,ZAL,P003211,P007109,5.433,2,12,10
23,ZAL,P003211,P007513,0.233,0,0,0
23,ZAL,P003211,P010390,5.216,-17,2,19
23,ZAL,P003211,P011218,8.983,-11,14,25
23,ZAL,P003211,P011965,5.0,-4,8,12
23,ZAL,P003211,P012715,5.366,-7,8,15
23,ZAL,P005504,P006860,2.217,0,2,2
23,ZAL,P005504,P007109,6.0,5,17,12
23,ZAL,P005504,P007513,5.967,-1,10,11
23,ZAL,P005504,P011218,5.284,0,13,13
23,ZAL,P005504,P011965,8.55,-1,16,17
23,ZAL,P005504,P012715,4.65,-3,10,13
23,ZAL,P006860,P007513,4.95,2,10,8
23,ZAL,P006860,P011965,4.95,2,10,8
23,ZAL,P006860,P012715,2.733,2,8,6
23,ZAL,P007109,P007513,16.549,1,31,30
23,ZAL,P007109,P010390,12.583,-2,20,22
23,ZAL,P007109,P011218,19.716,0,39,39
23,ZAL,P007109,P011965,5.366,-2,11,13
23,ZAL,P007109,P012715,5.682,-7,10,17
23,ZAL,P007513,P010390,10.266,5,20,15
23,ZAL,P007513,P011218,13.833,3,27,24
23,ZAL,P007513,P011965,6.716,4,14,10
23,ZAL,P007513,P012715,5.432,-1,11,12
23,ZAL,P010390,P011218,15.166,-12,22,34
23,ZAL,P010390,P011965,5.767,-6,12,18
23,ZAL,P010390,P012715,6.133,-9,12,21
23,ZAL,P011218,P011965,4.417,-12,5,17
23,ZAL,P011218,P012715,6.366,-14,8,22
23,ZAL,P011965,P012715,15.599,-11,37,48
24,BAS,P004603,P004761,12.517,-4,21,25
24,BAS,P004603,P007230,18.684,-6,35,41
24,BAS,P004603,P009048,18.1,-8,33,41
24,BAS,P004603,P010444,21.45,-7,42,49
24,BAS,P004603,P011064,4.217,1,9,8
24,BAS,P004603,P011948,13.433,-4,28,32
24,BAS,P004603,P012201,0.867,0,0,0
24,BAS,P004761,P007230,13.484,-3,21,24
24,BAS,P004761,P008072,10.65,1,19,18
24,BAS,P004761,P008850,0.133,-2,0,2
24,BAS,P004761,P009048,12.883,-10,17,27
24,BAS,P004761,P010444,11.783,-6,21,27
24,BAS,P004761,P011064,10.417,5,23,18
24,BAS,P004761,P011085,6.05,1,12,11
24,BAS,P004761,P011948,3.633,-1,7,8
24,BAS,P004761,P012201,11.65,-1,19,20
24,BAS,P007230,P008072,10.3,-3,11,14
24,BAS,P007230,P009048,19.2,-11,32,43
24,BAS,P007230,P010444,17.817,-6,35,41
24,BAS,P007230,P011064,9.784,2,14,12
24,BAS,P007230,P011948,15.5,-6,25,31
24,BAS,P007230,P012201,11.167,-3,11,14
24,BAS,P008072,P009048,4.15,1,6,5
24,BAS,P008072,P011064,13.4,0,20,20
24,BAS,P008072,P011085,7.25,4,15,11
24,BAS,P008072,P011948,6.9,0,7,7
24,BAS,P008072,P012201,17.55,1,26,25
24,BAS,P008850,P009048,0.133,-2,0,2
24,BAS,P008850,P010444,0.133,-2,0,2
24,BAS,P008850,P012201,0.133,-2,0,2
24,BAS,P009048,P010444,17.366,-10,33,43
24,BAS,P009048,P011085,1.517,4,4,0
24,BAS,P009048,P011948,11.033,1,25,24
24,BAS,P009048,P012201,5.15,-1,6,7
24,BAS,P010444,P011064,4.217,1,9,8
24,BAS,P010444,P011948,13.433,-4,28,32
24,BAS,P010444,P012201,0.133,-2,0,2
24,BAS,P011064,P011085,5.733,0,11,11
24,BAS,P011064,P011948,9.3,-5,10,15
24,BAS,P011064,P012201,13.4,0,20,20
24,BAS,P011085,P011948,1.2,3,3,0
24,BAS,P011085,P012201,7.25,4,15,11
24,BAS,P011948,P012201,6.9,0,7,7
24,MUN,P001557,P004508,16.699,15,32,17
24,MUN,P001557,P006760,3.833,3,8,5
24,MUN,P001557,P007056,10.382,11,22,11
24,MUN,P001557,P007639,8.5,5,14,9
24,MUN,P001557,P007975,13.649,8,25,17
24,MUN,P001557,P008985,8.633,9,18,9
24,MUN,P001557,P010391,19.182,14,35,21
24,MUN,P001557,P011941,3.4,1,7,6
24,MUN,P001557,P011987,4.85,2,11,9
24,MUN,P004508,P005478,0.4,-3,0,3
24,MUN,P004508,P006245,0.4,-3,0,3
24,MUN,P004508,P007056,9.866,9,21,12
24,MUN,P004508,P007639,10.3,3,15,12
24,MUN,P004508,P007975,14.966,8,26,18
24,MUN,P004508,P008985,5.533,9,13,4
24,MUN,P004508,P010391,20.482,13,38,25
24,MUN,P004508,P011941,4.4,2,8,6
24,MUN,P004508,P011987,0.55,3,3,0
24,MUN,P005478,P006245,0.4,-3,0,3
24,MUN,P005478,P007056,4.117,-1,10,11
24,MUN,P005478,P007975,3.717,2,10,8
24,MUN,P005478,P010391,4.117,-1,10,11
24,MUN,P005478,P011987,3.717,2,10,8
24,MUN,P006245,P007056,0.4,-3,0,3
24,MUN,P006245,P010391,0.4,-3,0,3
24,MUN,P006760,P007056,12.883,-6,24,30
24,MUN,P006760,P007639,1.067,-6,0,6
24,MUN,P006760,P007975,2.233,2,7,5
24,MUN,P006760,P008985,10.967,-9,17,26
24,MUN,P006760,P010391,1.05,-1,0,1
24,MUN,P006760,P011941,8.3,-4,16,20
24,MUN,P006760,P011987,12.467,-7,24,31
24,MUN,P007056,P007639,3.734,-7,4,11
24,MUN,P007056,P007975,10.882,6,25,19
24,MUN,P007056,P008985,16.5,0,30,30
24,MUN,P007056,P010391,15.215,8,30,22
24,MUN,P007056,P011941,9.416,-2,17,19
24,MUN,P007056,P011987,17.733,-3,37,40
24,MUN,P007639,P007975,11.167,4,18,14
24,MUN,P007639,P008985,1.067,-6,0,6
24,MUN,P007639,P010391,11.167,4,18,14
24,MUN,P007639,P011987,1.934,-5,3,8
24,MUN,P007975,P010391,20.766,7,38,31
24,MUN,P007975,P011941,6.333,1,12,11
24,MUN,P007975,P011987,8.683,6,23,17
24,MUN,P008985,P010391,6.266,9,13,4
24,MUN,P008985,P011941,6.8,-3,12,15
24,MUN,P008985,P011987,10.234,-9,17,26
24,MUN,P010391,P011941,4.733,0,7,7
24,MUN,P010391,P011987,6.35,2,15,13
24,MUN,P011941,P011987,9.15,-3,17,20
25,MCO,P002581,P004197,2.3,-2,5,7
25,MCO,P002581,P004790,6.084,-12,8,20
25,MCO,P002581,P005985,5.384,-10,8,18
25,MCO,P002581,P011212,3.817,-4,8,12
25,MCO,P002581,P011226,3.784,-10,3,13
25,MCO,P002581,P012709,2.967,-10,0,10
25,MCO,P004197,P004790,3.267,-5,5,10
25,MCO,P004197,P005985,12.367,0,25,25
25,MCO,P004197,P010588,6.7,6,13,7
25,MCO,P004197,P011196,3.367,-4,7,11
25,MCO,P004197,P011212,9.933,-4,15,19
25,MCO,P004197,P011226,2.434,4,10,6
25,MCO,P004197,P011231,2.4,-1,7,8
25,MCO,P004197,PLCZ,6.7,6,13,7
25,MCO,P004790,P005985,9.368,-14,13,27
25,MCO,P004790,P010588,2.634,0,5,5
25,MCO,P004790,P011196,1.35,-4,0,4
25,MCO,P004790,P011212,7.801,-8,13,21
25,MCO,P004790,P011226,5.384,-12,5,17
25,MCO,P004790,P011231,1.417,1,3,2
25,MCO,P004790,P012709,2.967,-10,0,10
25,MCO,P005985,P010588,22.301,15,51,36
25,MCO,P005985,P011196,10.284,-3,23,26
25,MCO,P005985,P011212,27.251,11,58,47
25,MCO,P005985,P011226,16.385,0,40,40
25,MCO,P005985,P011231,16.151,15,42,27
25,MCO,P005985,P012709,6.067,-9,10,19
25,MCO,P005985,PLCZ,17.45,19,42,23
25,MCO,P010588,P011196,4.167,-2,6,8
25,MCO,P010588,P011212,18.634,17,38,21
25,MCO,P010588,P011226,9.934,2,22,20
25,MCO,P010588,P011231,9.434,10,23,13
25,MCO,P010588,P012709,5.75,1,12,11
25,MCO,P010588,PLCZ,17.45,19,42,23
25,MCO,P011196,P011212,11.567,0,18,18
25,MCO,P011196,P011226,11.084,6,25,19
25,MCO,P011196,P011231,8.317,5,21,16
25,MCO,P011196,P012709,5.2,-2,8,10
25,MCO,P011212,P011226,12.134,5,24,19
25,MCO,P011212,P011231,17.134,12,39,27
25,MCO,P011212,P012709,4.25,0,4,4
25,MCO,P011212,PLCZ,13.483,15,31,16
25,MCO,P011226,P011231,6.534,9,19,10
25,MCO,P011226,P012709,10.317,-9,14,23
25,MCO,P011226,PLCZ,4.55,5,14,9
25,MCO,P011231,P012709,1.6,0,2,2
25,MCO,P011231,PLCZ,8.017,9,20,11
25,MCO,P012709,PLCZ,2.15,3,6,3
25,RED,P000848,P002553,12.583,-7,19,26
25,RED,P000848,P004720,6.25,-6,8,14
25,RED,P000848,P005099,11.283,2,20,18
25,RED,P000848,P006436,15.016,2,38,36
25,RED,P000848,P007960,15.384,9,30,21
25,RED,P000848,P008966,1.733,3,6,3
25,RED,P000848,P009035,11.467,2,26,24
25,RED,P000848,P011224,12.233,0,21,21
25,RED,P000848,P011964,1.65,-1,4,5
25,RED,P000848,P012711,1.9,4,9,5
25,RED,P000848,PJDR,11.701,-4,23,27
25,RED,P002553,P004720,6.25,-6,8,14
25,RED,P002553,P005099,5.233,-8,6,14
25,RED,P002553,P006436,7.233,-3,13,16
25,RED,P002553,P007960,4.567,5,7,2
25,RED,P002553,P009035,0.483,-3,0,3
25,RED,P002553,P011224,6.833,-1,7,8
25,RED,P002553,P011964,1.65,-1,4,5
25,RED,P002553,PJDR,5.5,-4,12,16
25,RED,P004720,P005099,0.25,-2,0,2
25,RED,P004720,P006436,1.383,-5,2,7
25,RED,P004720,P007960,3.217,0,2,2
25,RED,P004720,P011224,2.65,0,2,2
25,RED,P004720,P011964,1.65,-1,4,5
25,RED,P004720,PJDR,3.35,-4,6,10
25,RED,P005099,P006436,19.516,-6,35,41
25,RED,P005099,P007960,9.717,3,17,14
25,RED,P005099,P008966,9.433,-9,13,22
25,RED,P005099,P009035,10.583,8,23,15
25,RED,P005099,P011224,13.666,-8,21,29
25,RED,P005099,P012711,9.816,-1,19,20
25,RED,P005099,PJDR,9.567,-3,14,17
25,RED,P006436,P007960,13.4,7,34,27
25,RED,P006436,P008966,12.383,-5,22,27
25,RED,P006436,P009035,10.1,3,28,25
25,RED,P006436,P011224,16.283,-6,31,37
25,RED,P006436,P012711,10.433,-4,21,25
25,RED,P006436,PJDR,13.117,-3,28,31
25,RED,P007960,P008966,6.65,2,16,14
25,RED,P007960,P009035,10.334,3,20,17
25,RED,P007960,P011224,11.617,9,25,16
25,RED,P007960,PJDR,11.318,2,21,19
25,RED,P008966,P011224,7.383,-3,15,18
25,RED,P008966,P012711,5.733,-7,6,13
25,RED,P008966,PJDR,6.217,-1,10,11
25,RED,P009035,P011224,8.2,-4,17,21
25,RED,P009035,P012711,4.7,3,15,12
25,RED,P009035,PJDR,6.201,0,11,11
25,RED,P011224,P012711,7.483,-8,14,22
25,RED,P011224,PJDR,1.384,1,3,2
25,RED,P011964,PJDR,1.65,-1,4,5
25,RED,P012711,PJDR,1.667,-3,0,3
26,PAM,P000556,P003960,9.533,-1,23,24
26,PAM,P000556,P004863,15.034,24,40,16
26,PAM,P000556,P006643,4.016,-2,9,11
26,PAM,P000556,P007870,6.884,0,17,17
26,PAM,P000556,P009101,3.983,7,11,4
26,PAM,P000556,P010393,9.3,12,20,8
26,PAM,P000556,P010568,11.149,0,21,21
26,PAM,P000556,P010754,2.434,4,5,1
26,PAM,P000556,P012738,13.267,13,25,12
26,PAM,P000556,P012739,6.616,0,11,11
26,PAM,P000556,P012740,8.984,-9,10,19
26,PAM,P003960,P004863,8.999,0,20,20
26,PAM,P003960,P006643,13.516,-7,23,30
26,PAM,P003960,P007870,15.65,-7,30,37
26,PAM,P003960,P010393,4.133,-1,7,8
26,PAM,P003960,P010568,13.5,-4,28,32
26,PAM,P003960,P012739,0.383,-1,1,2
26,PAM,P003960,P012740,14.95,-15,20,35
26,PAM,P004863,P006643,7.299,0,15,15
26,PAM,P004863,P007870,5.267,2,12,10
26,PAM,P004863,P009101,2.85,10,10,0
26,PAM,P004863,P010393,9.75,14,25,11
26,PAM,P004863,P010568,6.133,14,19,5
26,PAM,P004863,P010754,2.434,4,5,1
26,PAM,P004863,P012738,8.451,21,22,1
26,PAM,P004863,P012739,6.433,9,15,6
26,PAM,P004863,P012740,5.15,-6,5,11
26,PAM,P006643,P007870,11.734,-6,17,23
26,PAM,P006643,P009101,1.133,-3,1,4
26,PAM,P006643,P010393,7.116,5,14,9
26,PAM,P006643,P010568,14.401,3,25,22
26,PAM,P006643,P012738,3.35,-1,6,7
26,PAM,P006643,P012739,6.716,-1,12,13
26,PAM,P006643,P012740,15.583,-8,22,30
26,PAM,P007870,P010393,1.367,2,2,0
26,PAM,P007870,P010568,14.867,-2,30,32
26,PAM,P007870,P010754,0.567,0,0,0
26,PAM,P007870,P012738,0.784,0,0,0
26,PAM,P007870,P012740,14.084,-9,20,29
26,PAM,P009101,P010393,2.85,10,10,0
26,PAM,P009101,P012738,3.983,7,11,4
26,PAM,P009101,P012739,1.133,-3,1,4
26,PAM,P010393,P010568,6.6,5,9,4
26,PAM,P010393,P012738,6.25,12,15,3
26,PAM,P010393,P012739,2.983,1,5,4
26,PAM,P010393,P012740,8.583,-4,9,13
26,PAM,P010568,P012738,8.083,1,11,10
26,PAM,P010568,P012739,8.05,6,14,8
26,PAM,P010568,P012740,19.417,-11,27,38
26,PAM,P010754,P012738,2.434,4,5,1
26,PAM,P010754,P012739,1.867,4,5,1
26,PAM,P012738,P012739,8.45,3,15,12
26,PAM,P012738,P012740,6.884,0,10,10
26,PAM,P012739,P012740,4.633,-6,5,11
26,TEL,P005145,P007990,3.083,-2,5,7
26,TEL,P005145,P009622,13.283,8,35,27
26,TEL,P005145,P009783,10.783,10,32,22
26,TEL,P005145,P011193,4.183,7,16,9
26,TEL,P005145,P011199,9.1,1,19,18
26,TEL,P005145,P011214,4.183,7,16,9
26,TEL,P005145,P012744,8.517,1,17,16
26,TEL,P007990,P009622,13.95,-8,20,28
26,TEL,P007990,P009783,11.717,-8,16,24
26,TEL,P007990,P011193,7.234,-20,3,23
26,TEL,P007990,P011199,10.2,-5,12,17
26,TEL,P007990,P011214,9.184,-19,7,26
26,TEL,P007990,P011219,8.967,-19,3,22
26,TEL,P007990,P011971,10.251,-3,13,16
26,TEL,P007990,P012744,6.15,-12,5,17
26,TEL,P009622,P009783,30.466,9,60,51
26,TEL,P009622,P011193,14.799,8,33,25
26,TEL,P009622,P011199,19.517,6,34,28
26,TEL,P009622,P011214,16.416,2,33,31
26,TEL,P009622,P011219,5.016,4,9,5
26,TEL,P009622,P011971,12.3,-2,17,19
26,TEL,P009622,P012744,9.317,1,19,18
26,TEL,P009783,P011193,15.866,6,34,28
26,TEL,P009783,P011199,17.017,8,31,23
26,TEL,P009783,P011214,17.483,0,34,34
26,TEL,P009783,P011219,5.283,2,8,6
26,TEL,P009783,P011971,11.5,-2,15,17
26,TEL,P009783,P012744,6.017,3,14,11
26,TEL,P011193,P011199,6.8,2,8,6
26,TEL,P011193,P011214,17.2,-9,30,39
26,TEL,P011193,P011219,8.517,-9,8,17
26,TEL,P011193,P011971,6.683,-7,4,11
26,TEL,P011193,P012744,2.85,-10,0,10
26,TEL,P011199,P011214,2.967,1,4,3
26,TEL,P011199,P011219,1.75,-3,0,3
26,TEL,P011199,P011971,7.45,4,11,7
26,TEL,P011199,P012744,10.267,-2,17,19
26,TEL,P011214,P011219,8.7,-9,8,17
26,TEL,P011214,P011971,6.367,-10,4,14
26,TEL,P011214,P012744,1.1,-7,0,7
26,TEL,P011219,P011971,3.117,-4,2,6
26,TEL,P011219,P012744,3.65,-10,2,12
26,TEL,P011971,P012744,0.8,0,2,2
27,BER,P003958,P006251,2.683,1,4,3
27,BER,P003958,P006919,16.867,0,40,40
27,BER,P003958,P007025,3.8,2,8,6
27,BER,P003958,P007550,8.4,-8,10,18
27,BER,P003958,P008173,7.383,5,21,16
27,BER,P003958,P008211,11.034,11,29,18
27,BER,P003958,P008384,3.8,2,8,6
27,BER,P003958,P008967,23.017,6,52,46
27,BER,P003958,P012720,23.017,6,52,46
27,BER,P003958,P012721,7.267,7,16,9
27,BER,P006251,P006919,2.517,-4,3,7
27,BER,P006251,P007025,8.55,-11,11,22
27,BER,P006251,P007550,8.384,-9,11,20
27,BER,P006251,P008173,6.483,-9,7,16
27,BER,P006251,P008384,9.667,-15,11,26
27,BER,P006251,P008967,6.317,-7,7,14
27,BER,P006251,P012720,5.2,-3,7,10
27,BER,P006251,P012721,9.667,-15,11,26
27,BER,P006819,P006919,1.0,0,2,2
27,BER,P006819,P008173,1.0,0,2,2
27,BER,P006819,P008967,1.0,0,2,2
27,BER,P006819,P012720,1.0,0,2,2
27,BER,P006919,P007550,8.234,-13,9,22
27,BER,P006919,P008173,4.583,3,15,12
27,BER,P006919,P008211,7.567,6,21,15
27,BER,P006919,P008967,20.384,-4,45,49
27,BER,P006919,P012720,20.384,-4,45,49
27,BER,P007025,P007550,2.067,-2,4,6
27,BER,P007025,P008173,10.283,-7,15,22
27,BER,P007025,P008384,12.35,-9,19,28
27,BER,P007025,P012721,12.35,-9,19,28
27,BER,P007550,P008384,3.184,-6,4,10
27,BER,P007550,P008967,12.034,-16,13,29
27,BER,P007550,P012720,10.917,-12,13,25
27,BER,P007550,P012721,3.184,-6,4,10
27,BER,P008173,P008384,10.283,-7,15,22
27,BER,P008173,P008967,4.583,3,15,12
27,BER,P008173,P012720,4.583,3,15,12
27,BER,P008173,P012721,10.283,-7,15,22
27,BER,P008211,P008967,11.034,11,29,18
27,BER,P008211,P012720,11.034,11,29,18
27,BER,P008211,P012721,3.467,5,8,3
27,BER,P008384,P008967,1.117,-4,0,4
27,BER,P008384,P012721,13.467,-13,19,32
27,BER,P008967,P012720,26.534,2,57,55
27,BER,P008967,P012721,4.584,1,8,7
27,BER,P012720,P012721,3.467,5,8,3
27,VIR,P001133,P001844,16.033,-1,38,39
27,VIR,P001133,P003048,21.316,8,50,42
27,VIR,P001133,P004007,2.966,7,12,5
27,VIR,P001133,P006739,11.333,15,30,15
27,VIR,P001133,P008847,6.05,6,18,12
27,VIR,P001133,P009549,22.4,3,50,47
27,VIR,P001133,P010781,1.75,5,7,2
27,VIR,P001133,P011192,3.216,6,11,5
27,VIR,P001133,PBCN,24.4,7,56,49
27,VIR,P001844,P003048,12.533,-1,29,30
27,VIR,P001844,P003527,4.667,-7,4,11
27,VIR,P001844,P004007,4.217,-6,4,10
27,VIR,P001844,P008847,8.167,-7,13,20
27,VIR,P001844,P009549,19.15,-4,42,46
27,VIR,P001844,P011192,2.25,-5,0,5
27,VIR,P001844,PBCN,15.783,-1,38,39
27,VIR,P003048,P004007,0.633,1,3,2
27,VIR,P003048,P006739,8.783,9,21,12
27,VIR,P003048,P009549,18.433,3,41,38
27,VIR,P003048,P010781,1.75,5,7,2
27,VIR,P003048,P011192,1.133,0,2,2
27,VIR,P003048,PBCN,20.683,7,47,40
27,VIR,P003527,P004007,11.933,-2,19,21
27,VIR,P003527,P006739,7.966,4,15,11
27,VIR,P003527,P008847,12.633,-3,19,22
27,VIR,P003527,P009549,3.117,-3,4,7
27,VIR,P003527,P010781,4.433,1,7,6
27,VIR,P003527,P011192,5.783,-2,8,10
27,VIR,P004007,P006739,10.682,11,27,16
27,VIR,P004007,P008847,14.266,4,28,24
27,VIR,P004007,P009549,2.667,-2,4,6
27,VIR,P004007,P010781,5.066,2,10,8
27,VIR,P004007,P011192,7.166,5,17,12
27,VIR,P006739,P008847,10.516,10,24,14
27,VIR,P006739,P009549,6.367,4,12,8
27,VIR,P006739,P010781,6.183,6,14,8
27,VIR,P006739,P011192,6.749,9,19,10
27,VIR,P006739,PBCN,8.617,8,18,10
27,VIR,P008847,P009549,7.084,-3,13,16
27,VIR,P008847,P010781,4.433,1,7,6
27,VIR,P008847,P011192,7.866,4,17,13
27,VIR,P008847,PBCN,3.717,0,9,9
27,VIR,P009549,P011192,0.7,-1,0,1
27,VIR,P009549,PBCN,22.15,3,50,47
27,VIR,P010781,PBCN,1.117,4,4,0
27,VIR,P011192,PBCN,1.133,0,2,2
28,ASV,P000229,P002100,0.067,-2,0,2
28,ASV,P000229,P011386,0.167,0,0,0
28,ASV,P000229,P012729,0.567,-5,0,5
28,ASV,P000229,P012730,0.967,-2,1,3
28,ASV,P000229,P012731,0.8,-2,1,3
28,ASV,P000229,P012732,0.534,-1,1,2
28,ASV,P000229,PKIR,1.034,-4,1,5
28,ASV,P002100,P004194,11.049,-16,23,39
28,ASV,P002100,P006568,10.482,-13,15,28
28,ASV,P002100,P011225,6.016,3,16,13
28,ASV,P002100,P011386,5.099,-6,11,17
28,ASV,P002100,P012729,17.765,-10,37,47
28,ASV,P002100,P012730,10.265,3,27,24
28,ASV,P002100,P012731,10.015,1,24,23
28,ASV,P002100,P012732,13.699,-16,24,40
28,ASV,P002100,PKIR,14.799,-20,27,47
28,ASV,P004194,P006568,20.283,-3,45,48
28,ASV,P004194,P011225,15.2,6,37,31
28,ASV,P004194,P012729,4.0,-7,9,16
28,ASV,P004194,P012730,0.983,0,3,3
28,ASV,P004194,P012731,1.583,-2,5,7
28,ASV,P004194,P012732,24.283,-10,54,64
28,ASV,P004194,PKIR,23.683,-8,52,60
28,ASV,P006568,P011225,14.217,6,34,28
28,ASV,P006568,P011386,1.383,-4,2,6
28,ASV,P006568,P012729,4.416,-4,4,8
28,ASV,P006568,P012731,4.699,-8,7,15
28,ASV,P006568,P012732,23.316,-3,47,50
28,ASV,P006568,PKIR,20.0,1,42,41
28,ASV,P011225,P012729,5.033,3,13,10
28,ASV,P011225,P012730,6.016,3,16,13
28,ASV,P011225,P012731,4.383,2,11,9
28,ASV,P011225,P012732,14.217,6,34,28
28,ASV,P011225,PKIR,15.85,7,39,32
28,ASV,P011386,P012729,5.266,-6,11,17
28,ASV,P011386,P012730,3.883,-2,9,11
28,ASV,P011386,P012731,3.116,-7,6,13
28,ASV,P011386,PKIR,2.15,1,5,4
28,ASV,P012729,P012730,9.782,0,24,24
28,ASV,P012729,P012731,9.265,-4,19,23
28,ASV,P012729,P012732,7.633,-7,13,20
28,ASV,P012729,PKIR,9.333,-12,18,30
28,ASV,P012730,P012731,6.616,3,18,15
28,ASV,P012730,P012732,1.0,3,3,0
28,ASV,P012730,PKIR,5.416,-4,11,15
28,ASV,P012731,P012732,3.983,-1,8,9
28,ASV,P012731,PKIR,0.8,-2,1,3
28,ASV,P012732,PKIR,24.867,-7,52,59
28,ULK,P001932,P002968,4.367,-5,8,13
28,ULK,P001932,P004004,19.667,7,46,39
28,ULK,P001932,P005844,0.617,3,3,0
28,ULK,P001932,P006661,3.834,6,12,6
28,ULK,P001932,P006961,14.984,17,43,26
28,ULK,P001932,P008962,14.4,15,37,22
28,ULK,P001932,P010560,13.851,-1,34,35
28,ULK,P001932,P011157,23.084,10,57,47
28,ULK,P002968,P004004,5.6,-9,8,17
28,ULK,P002968,P005844,0.983,-2,3,5
28,ULK,P002968,P006661,2.816,-6,3,9
28,ULK,P002968,P008962,0.983,-2,3,5
28,ULK,P002968,P010560,6.2,-9,8,17
28,ULK,P002968,P011052,1.583,-2,3,5
28,ULK,P002968,P011157,6.2,-9,8,17
28,ULK,P004004,P005844,0.067,2,2,0
28,ULK,P004004,P006661,1.233,-4,0,4
28,ULK,P004004,P006961,11.017,13,31,18
28,ULK,P004004,P008962,13.533,13,33,20
28,ULK,P004004,P010560,11.784,-7,24,31
28,ULK,P004004,P011052,0.067,2,2,0
28,ULK,P004004,P011157,20.9,3,46,43
28,ULK,P005844,P006661,9.933,-1,25,26
28,ULK,P005844,P006961,2.784,5,10,5
28,ULK,P005844,P008962,8.399,-1,22,23
28,ULK,P005844,P010560,7.584,0,19,19
28,ULK,P005844,P011052,9.383,-2,24,26
28,ULK,P005844,P011980,0.25,0,0,0
28,ULK,P006661,P006961,11.017,14,34,20
28,ULK,P006661,P008962,14.149,9,41,32
28,ULK,P006661,P010560,11.9,-5,24,29
28,ULK,P006661,P011052,14.999,4,39,35
28,ULK,P006661,P011157,10.133,7,26,19
28,ULK,P006661,P011980,0.25,0,0,0
28,ULK,P006961,P008962,16.316,25,50,25
28,ULK,P006961,P010560,5.868,2,19,17
28,ULK,P006961,P011052,7.25,10,24,14
28,ULK,P006961,P011157,19.45,22,57,35
28,ULK,P006961,P011980,0.25,0,0,0
28,ULK,P008962,P010560,10.783,-1,25,26
28,ULK,P008962,P011052,13.482,7,39,32
28,ULK,P008962,P011157,19.483,23,54,31
28,ULK,P010560,P011052,7.567,-3,16,19
28,ULK,P010560,P011157,15.067,-8,31,39
28,ULK,P011052,P011157,5.683,8,17,9
28,ULK,P011052,P011980,0.25,0,0,0
29,OLY,P001255,P003941,21.0,19,57,38
29,OLY,P001255,P006302,2.684,-1,4,5
29,OLY,P001255,P007982,27.367,13,65,52
29,OLY,P001255,P008811,18.583,-10,31,41
29,OLY,P001255,P008829,14.749,-8,23,31
29,OLY,P001255,P008855,32.85,10,74,64
29,OLY,P001255,P010392,19.316,16,51,35
29,OLY,P001255,P010612,21.783,-3,47,50
29,OLY,P003941,P006302,3.983,1,8,7
29,OLY,P003941,P007982,23.45,15,61,46
29,OLY,P003941,P008829,9.199,-10,12,22
29,OLY,P003941,P008855,18.683,17,53,36
29,OLY,P003941,P010392,15.816,16,47,31
29,OLY,P003941,P010612,13.533,-2,30,32
29,OLY,P006302,P007982,3.867,-4,4,8
29,OLY,P006302,P008811,1.517,-5,0,5
29,OLY,P006302,P008829,2.733,-3,4,7
29,OLY,P006302,P008855,5.417,-4,8,12
29,OLY,P006302,P010392,0.083,0,0,0
29,OLY,P006302,P010612,1.716,0,4,4
29,OLY,P007982,P008811,7.7,-7,10,17
29,OLY,P007982,P008829,6.833,-10,8,18
29,OLY,P007982,P008855,23.417,11,57,46
29,OLY,P007982,P010392,21.399,15,55,40
29,OLY,P007982,P010612,10.567,-1,24,25
29,OLY,P008811,P008829,10.883,-3,21,24
29,OLY,P008811,P008855,18.583,-10,31,41
29,OLY,P008811,P010392,6.183,-2,10,12
29,OLY,P008811,P010612,10.883,-3,21,24
29,OLY,P008829,P008855,16.032,-6,31,37
29,OLY,P008829,P010392,2.983,-2,6,8
29,OLY,P008829,P010612,16.916,-10,27,37
29,OLY,P008855,P010392,17.016,12,45,33
29,OLY,P008855,P010612,17.066,-2,37,39
29,OLY,P010392,P010612,5.2,1,14,13
29,PAR,P000956,P003983,11.066,-2,19,21
29,PAR,P000956,P004058,3.217,-2,8,10
29,PAR,P000956,P007400,26.116,-2,54,56
29,PAR,P000956,P007673,3.183,-2,8,10
29,PAR,P000956,P008987,34.55,2,74,72
29,PAR,P000956,P009862,26.233,7,56,49
29,PAR,P000956,P011050,10.016,-11,21,32
29,PAR,P000956,P011051,9.216,5,17,12
29,PAR,P000956,P012742,5.933,-6,15,21
29,PAR,P000956,P012743,9.334,11,24,13
29,PAR,P003983,P007400,11.933,-11,17,28
29,PAR,P003983,P007673,0.133,0,0,0
29,PAR,P003983,P008987,16.067,-7,25,32
29,PAR,P003983,P009862,18.35,-4,33,37
29,PAR,P003983,P011050,0.083,-2,0,2
29,PAR,P003983,P011051,6.683,2,12,10
29,PAR,P003983,P012742,2.183,1,4,3
29,PAR,P003983,P012743,11.834,-1,22,23
29,PAR,P004058,P007400,0.217,0,0,0
29,PAR,P004058,P007673,3.0,-2,8,10
29,PAR,P004058,P008987,3.217,-2,8,10
29,PAR,P004058,P011050,3.217,-2,8,10
29,PAR,P007400,P008987,30.784,-8,62,70
29,PAR,P007400,P009862,28.817,-2,60,62
29,PAR,P007400,P011050,6.966,-9,13,22
29,PAR,P007400,P011051,13.683,8,28,20
29,PAR,P007400,P012742,7.7,-6,21,27
29,PAR,P007400,P012743,10.984,2,25,23
29,PAR,P007673,P008987,3.183,-2,8,10
29,PAR,P007673,P009862,0.183,0,0,0
29,PAR,P007673,P011050,3.05,-2,8,10
29,PAR,P008987,P009862,33.001,2,68,66
29,PAR,P008987,P011050,9.933,-9,21,30
29,PAR,P008987,P011051,12.433,6,24,18
29,PAR,P008987,P012742,9.717,-5,25,30
29,PAR,P008987,P012743,13.051,3,29,26
29,PAR,P009862,P011050,3.466,-6,6,12
29,PAR,P009862,P011051,14.55,11,32,21
29,PAR,P009862,P012742,5.767,-2,15,17
29,PAR,P009862,P012743,15.701,6,34,28
29,PAR,P011050,P012742,3.333,-3,7,10
29,PAR,P011051,P012742,3.217,1,7,6
29,PAR,P011051,P012743,3.35,3,8,5
29,PAR,P012742,P012743,1.35,0,6,6
30,MAD,P003108,P004887,12.967,11,27,16
30,MAD,P003108,P005928,5.501,-6,8,14
30,MAD,P003108,P006540,1.833,0,2,2
30,MAD,P003108,P009005,3.851,1,9,8
30,MAD,P003108,P009213,5.768,-7,8,15
30,MAD,P003108,P010357,6.65,4,12,8
30,MAD,P003108,PBMT,15.684,6,30,24
30,MAD,P003108,PCVM,15.6,14,33,19
30,MAD,P003108,PTGB,17.618,5,35,30
30,MAD,P004887,P005928,5.984,3,12,9
30,MAD,P004887,P006540,5.75,1,10,9
30,MAD,P004887,P009005,5.984,3,12,9
30,MAD,P004887,P009213,1.917,2,4,2
30,MAD,P004887,P010357,6.95,0,13,13
30,MAD,P004887,PBMT,10.267,8,24,16
30,MAD,P004887,PCVM,12.1,8,26,18
30,MAD,P004887,PTGB,10.417,8,24,16
30,MAD,P005791,P005928,9.567,4,25,21
30,MAD,P005791,P006540,11.017,3,27,24
30,MAD,P005791,P009005,11.017,3,27,24
30,MAD,P005791,P010357,11.017,3,27,24
30,MAD,P005791,PBMT,1.45,-1,2,3
30,MAD,P005928,P006540,12.767,7,33,26
30,MAD,P005928,P009005,17.851,11,44,33
30,MAD,P005928,P009213,6.217,1,13,12
30,MAD,P005928,P010357,14.35,12,38,26
30,MAD,P005928,PBMT,2.0,-5,2,7
30,MAD,P005928,PTGB,5.167,-3,9,12
30,MAD,P006540,P009005,15.133,8,39,31
30,MAD,P006540,P009213,0.233,-2,0,2
30,MAD,P006540,P010357,17.683,6,41,35
30,MAD,P006540,PBMT,2.167,-3,2,5
30,MAD,P006540,PCVM,3.233,2,6,4
30,MAD,P006540,PTGB,0.916,2,4,2
30,MAD,P009005,P009213,4.717,3,11,8
30,MAD,P009005,P010357,17.066,15,47,32
30,MAD,P009005,PBMT,1.45,-1,2,3
30,MAD,P009005,PCVM,0.766,7,7,0
30,MAD,P009005,PTGB,4.433,6,14,8
30,MAD,P009213,P010357,2.083,2,5,3
30,MAD,P009213,PBMT,2.867,-7,2,9
30,MAD,P009213,PCVM,0.867,-2,0,2
30,MAD,P009213,PTGB,5.667,-6,9,15
30,MAD,P010357,PBMT,7.834,-2,12,14
30,MAD,P010357,PCVM,8.983,6,19,13
30,MAD,P010357,PTGB,8.516,10,22,12
30,MAD,PBMT,PCVM,15.601,8,31,23
30,MAD,PBMT,PTGB,16.884,5,33,28
30,MAD,PCVM,PTGB,15.65,17,38,21
30,MIL,P000796,P001518,0.85,-1,2,3
30,MIL,P000796,P002812,2.017,-3,2,5
30,MIL,P000796,P002849,13.383,-5,26,31
30,MIL,P000796,P005670,10.75,-9,15,24
30,MIL,P000796,P006433,16.2,-3,34,37
30,MIL,P000796,P006509,6.017,-9,8,17
30,MIL,P000796,P007201,14.65,-8,28,36
30,MIL,P000796,P007831,22.516,-12,40,52
30,MIL,P000796,P009960,9.383,-2,18,20
30,MIL,P000796,P011205,10.966,0,19,19
30,MIL,P001518,P002812,0.083,-3,0,3
30,MIL,P001518,P005670,3.633,-1,6,7
30,MIL,P001518,P006433,1.683,-1,3,4
30,MIL,P001518,P007831,5.399,-5,9,14
30,MIL,P001518,P009960,2.616,-5,5,10
30,MIL,P001518,P011205,4.549,-4,7,11
30,MIL,P001518,P011926,2.783,0,4,4
30,MIL,P002812,P005670,3.967,1,9,8
30,MIL,P002812,P006509,3.167,1,9,8
30,MIL,P002812,P007831,0.883,-3,0,3
30,MIL,P002812,P009960,2.033,1,7,6
30,MIL,P002812,P011205,4.05,-2,9,11
30,MIL,P002849,P005670,4.8,-3,5,8
30,MIL,P002849,P006433,13.567,-4,28,32
30,MIL,P002849,P007201,16.684,-7,31,38
30,MIL,P002849,P007831,18.367,-7,33,40
30,MIL,P002849,P011205,6.667,-2,9,11
30,MIL,P005670,P006433,0.267,1,1,0
30,MIL,P005670,P006509,7.55,1,17,16
30,MIL,P005670,P007201,6.0,-5,7,12
30,MIL,P005670,P007831,11.233,-7,14,21
30,MIL,P005670,P009960,9.183,0,20,20
30,MIL,P005670,P011205,14.966,-2,26,28
30,MIL,P005670,P011926,2.783,0,4,4
30,MIL,P006433,P006509,1.867,-8,0,8
30,MIL,P006433,P007201,15.467,-7,30,37
30,MIL,P006433,P007831,21.383,-7,41,48
30,MIL,P006433,P009960,5.933,0,11,11
30,MIL,P006433,P011205,9.233,1,16,15
30,MIL,P006509,P007201,2.45,-5,2,7
30,MIL,P006509,P007831,1.85,-8,0,8
30,MIL,P006509,P009960,7.2,-1,15,16
30,MIL,P006509,P011205,7.567,1,17,16
30,MIL,P007201,P007831,19.634,-10,35,45
30,MIL,P007201,P009960,2.883,-2,4,6
30,MIL,P007201,P011205,8.1,-4,11,15
30,MIL,P007831,P009960,8.965,-8,15,23
30,MIL,P007831,P011205,16.715,-5,25,30
30,MIL,P007831,P011926,2.783,0,4,4
30,MIL,P009960,P011205,11.532,1,25,24
30,MIL,P011205,P011926,2.783,0,4,4
31,BAS,P003198,P004603,3.984,-11,2,13
31,BAS,P003198,P004761,3.984,-11,2,13
31,BAS,P003198,P007230,7.767,-5,14,19
31,BAS,P003198,P009048,5.45,-1,12,13
31,BAS,P003198,P010444,4.4,1,12,11
31,BAS,P003198,P011064,2.934,-9,2,11
31,BAS,P003198,P011085,0.617,-5,0,5
31,BAS,P003198,P011948,4.4,1,12,11
31,BAS,P004603,P004761,7.784,-11,13,24
31,BAS,P004603,P007230,6.367,-10,5,15
31,BAS,P004603,P009048,6.983,4,13,9
31,BAS,P004603,P011064,6.734,-9,13,22
31,BAS,P004603,P011085,7.35,5,21,16
31,BAS,P004603,P011948,5.933,6,13,7
31,BAS,P004603,P012201,9.733,6,24,18
31,BAS,P004761,P007230,12.217,-15,20,35
31,BAS,P004761,P009048,7.333,1,16,15
31,BAS,P004761,P010444,8.533,-10,14,24
31,BAS,P004761,P011064,9.801,-18,17,35
31,BAS,P004761,P011085,7.783,-11,13,24
31,BAS,P004761,P011948,3.9,-14,2,16
31,BAS,P004761,P012201,10.533,1,27,26
31,BAS,P007230,P009048,19.467,-9,40,49
31,BAS,P007230,P010444,18.734,-15,38,53
31,BAS,P007230,P011064,6.451,-12,9,21
31,BAS,P007230,P011085,2.65,-4,4,8
31,BAS,P007230,P011948,18.434,-25,29,54
31,BAS,P007230,P012201,14.917,-9,29,38
31,BAS,P009048,P010444,15.9,-3,36,39
31,BAS,P009048,P011064,1.2,1,4,3
31,BAS,P009048,P011085,5.233,11,15,4
31,BAS,P009048,P011948,16.75,1,37,36
31,BAS,P009048,P012201,18.016,3,39,36
31,BAS,P010444,P011064,6.701,-4,14,18
31,BAS,P010444,P011085,8.55,0,18,18
31,BAS,P010444,P011948,19.551,-13,40,53
31,BAS,P010444,P012201,16.167,0,36,36
31,BAS,P011064,P011085,8.634,-2,22,24
31,BAS,P011064,P011948,7.151,-6,14,20
31,BAS,P011064,P012201,10.734,3,29,26
31,BAS,P011085,P011948,10.15,12,28,16
31,BAS,P011085,P012201,12.633,14,35,21
31,BAS,P011948,P012201,17.467,2,37,35
31,ZAL,P002329,P002676,8.717,-1,21,22
31,ZAL,P002329,P003211,15.451,-4,30,34
31,ZAL,P002329,P005504,4.833,9,15,6
31,ZAL,P002329,P006860,0.533,1,1,0
31,ZAL,P002329,P007109,22.801,13,60,47
31,ZAL,P002329,P007513,17.966,17,54,37
31,ZAL,P002329,P010390,9.767,-6,17,23
31,ZAL,P002329,P011218,23.951,3,55,52
31,ZAL,P002329,P011965,7.249,5,21,16
31,ZAL,P002329,P012715,22.4,15,62,47
31,ZAL,P002676,P003211,8.434,-9,15,24
31,ZAL,P002676,P005504,3.367,5,8,3
31,ZAL,P002676,P007109,7.035,7,20,13
31,ZAL,P002676,P007513,6.868,12,21,9
31,ZAL,P002676,P010390,5.884,-9,10,19
31,ZAL,P002676,P011218,5.651,-11,8,19
31,ZAL,P002676,P011965,7.434,9,20,11
31,ZAL,P002676,P012715,7.818,9,21,12
31,ZAL,P003211,P005504,1.05,1,2,1
31,ZAL,P003211,P007109,10.568,6,22,16
31,ZAL,P003211,P010390,10.651,-10,17,27
31,ZAL,P003211,P011218,13.085,-11,23,34
31,ZAL,P003211,P011965,4.3,4,9,5
31,ZAL,P003211,P012715,6.001,-5,10,15
31,ZAL,P005504,P007513,7.15,13,21,8
31,ZAL,P005504,P011218,3.0,4,7,3
31,ZAL,P005504,P011965,5.2,10,16,6
31,ZAL,P005504,P012715,8.2,14,23,9
31,ZAL,P006860,P007513,0.533,1,1,0
31,ZAL,P006860,P011965,0.533,1,1,0
31,ZAL,P006860,P012715,0.533,1,1,0
31,ZAL,P007109,P007513,14.934,10,45,35
31,ZAL,P007109,P010390,5.501,4,11,7
31,ZAL,P007109,P011218,17.501,10,45,35
31,ZAL,P007109,P011965,5.784,1,14,13
31,ZAL,P007109,P012715,17.884,13,51,38
31,ZAL,P007513,P010390,0.617,0,2,2
31,ZAL,P007513,P011218,11.6,10,32,22
31,ZAL,P007513,P011965,8.8,9,27,18
31,ZAL,P007513,P012715,22.0,24,65,41
31,ZAL,P010390,P011218,8.701,-11,12,23
31,ZAL,P010390,P011965,2.567,1,7,6
31,ZAL,P010390,P012715,1.384,-9,0,9
31,ZAL,P011218,P012715,15.251,2,38,36
31,ZAL,P011965,P012715,10.533,12,29,17
32,IST,P004554,P004888,7.117,-11,7,18
32,IST,P004554,P006372,5.817,4,14,10
32,IST,P004554,P006590,7.284,1,16,15
32,IST,P004554,P007200,7.117,-11,7,18
32,IST,P004554,P009664,11.467,-4,19,23
32,IST,P004554,P011078,11.467,-4,19,23
32,IST,P004554,P012710,1.467,-3,2,5
32,IST,P004888,P006372,3.833,-6,7,13
32,IST,P004888,P006590,17.617,8,37,29
32,IST,P004888,P007200,32.133,2,59,57
32,IST,P004888,P009664,18.6,6,35,29
32,IST,P004888,P011078,22.483,-2,41,43
32,IST,P004888,P011981,26.899,9,54,45
32,IST,P004888,P012710,8.05,-6,12,18
32,IST,P006372,P006590,8.717,0,18,18
32,IST,P006372,P007200,3.716,-4,7,11
32,IST,P006372,P009664,5.817,4,14,10
32,IST,P006372,P011078,6.867,0,17,17
32,IST,P006372,P011981,3.833,-6,7,13
32,IST,P006590,P007200,15.567,10,33,23
32,IST,P006590,P009664,14.517,17,36,19
32,IST,P006590,P011078,11.734,10,29,19
32,IST,P006590,P011981,15.983,9,33,24
32,IST,P006590,P012710,2.317,-7,2,9
32,IST,P007200,P009664,16.667,6,31,25
32,IST,P007200,P011078,20.433,0,37,37
32,IST,P007200,P011981,24.849,11,50,39
32,IST,P007200,P012710,8.05,-6,12,18
32,IST,P009664,P011078,17.817,-1,33,34
32,IST,P009664,P011981,12.783,12,28,16
32,IST,P011078,P011981,16.666,4,34,30
32,IST,P011078,P012710,5.733,1,10,9
32,IST,P011981,P012710,6.583,-3,10,13
32,PAM,P000556,P003960,9.801,2,20,18
32,PAM,P000556,P004863,10.217,-9,15,24
32,PAM,P000556,P006643,0.017,0,0,0
32,PAM,P000556,P007870,10.117,-1,20,21
32,PAM,P000556,P009101,0.783,-7,0,7
32,PAM,P000556,P010393,10.316,-4,14,18
32,PAM,P000556,P010568,17.433,1,28,27
32,PAM,P000556,P012738,2.983,-2,2,4
32,PAM,P000556,P012739,8.017,-3,12,15
32,PAM,P000556,P012740,12.784,7,25,18
32,PAM,P003960,P004863,8.151,5,21,16
32,PAM,P003960,P006643,9.2,4,21,17
32,PAM,P003960,P007870,16.567,11,39,28
32,PAM,P003960,P009101,3.133,-2,7,9
32,PAM,P003960,P010393,2.767,1,7,6
32,PAM,P003960,P010568,14.9,7,35,28
32,PAM,P003960,P012739,0.934,0,2,2
32,PAM,P003960,P012740,13.151,12,32,20
32,PAM,P004863,P006643,11.318,-7,16,23
32,PAM,P004863,P007870,11.517,-3,24,27
32,PAM,P004863,P009101,2.733,-9,1,10
32,PAM,P004863,P010393,10.484,-10,12,22
32,PAM,P004863,P010568,9.217,-2,16,18
32,PAM,P004863,P012738,9.234,-7,11,18
32,PAM,P004863,P012739,5.601,-7,6,13
32,PAM,P004863,P012740,10.268,1,22,21
32,PAM,P006643,P007870,11.283,1,22,21
32,PAM,P006643,P009101,6.266,-3,11,14
32,PAM,P006643,P010393,7.451,-5,12,17
32,PAM,P006643,P010568,8.933,1,20,19
32,PAM,P006643,P012738,7.434,-4,12,16
32,PAM,P006643,P012739,2.717,-2,3,5
32,PAM,P006643,P012740,10.317,-1,19,20
32,PAM,P007870,P009101,4.949,-6,10,16
32,PAM,P007870,P010393,0.633,-5,0,5
32,PAM,P007870,P010568,13.933,9,33,24
32,PAM,P007870,P012738,4.85,-2,8,10
32,PAM,P007870,P012740,14.351,12,32,20
32,PAM,P009101,P010393,2.733,-9,1,10
32,PAM,P009101,P010568,4.316,-1,10,11
32,PAM,P009101,P012738,1.183,1,3,2
32,PAM,P009101,P012739,2.1,-4,1,5
32,PAM,P010393,P010568,13.1,-3,20,23
32,PAM,P010393,P012738,5.067,-2,6,8
32,PAM,P010393,P012739,9.917,-1,15,16
32,PAM,P010393,P012740,8.6,2,17,15
32,PAM,P010568,P012738,5.183,-1,7,8
32,PAM,P010568,P012739,6.95,0,11,11
32,PAM,P010568,P012740,14.167,13,32,19
32,PAM,P012738,P012739,0.5,-2,0,2
32,PAM,P012738,P012740,5.234,-5,7,12
32,PAM,P012739,P012740,6.2,-1,10,11
33,BER,P003958,P006251,5.1,-3,6,9
33,BER,P003958,P006819,7.233,0,12,12
33,BER,P003958,P006919,18.217,-10,25,35
33,BER,P003958,P007025,2.717,-2,6,8
33,BER,P003958,P008173,17.05,-15,25,40
33,BER,P003958,P008211,8.051,-6,12,18
33,BER,P003958,P008384,5.517,-6,11,17
33,BER,P003958,P008967,21.067,-16,29,45
33,BER,P003958,P012720,12.101,-14,19,33
33,BER,P003958,P012721,3.351,-12,3,15
33,BER,P006251,P006919,7.767,-4,11,15
33,BER,P006251,P007025,2.35,3,7,4
33,BER,P006251,P008173,7.767,-4,11,15
33,BER,P006251,P008211,7.6,2,19,17
33,BER,P006251,P008384,4.984,-2,10,12
33,BER,P006251,P008967,10.7,-4,18,22
33,BER,P006251,P012720,7.6,2,19,17
33,BER,P006251,P012721,7.6,2,19,17
33,BER,P006819,P006919,4.333,3,7,4
33,BER,P006819,P008173,7.383,0,12,12
33,BER,P006819,P008211,4.483,9,14,5
33,BER,P006819,P008384,8.166,10,23,13
33,BER,P006819,P008967,7.233,0,12,12
33,BER,P006819,P012720,4.633,9,14,5
33,BER,P006819,P012721,4.0,5,10,5
33,BER,P006919,P007025,2.7,-3,5,8
33,BER,P006919,P008173,14.75,-10,19,29
33,BER,P006919,P008211,6.767,3,15,12
33,BER,P006919,P008384,4.617,0,11,11
33,BER,P006919,P008967,16.867,-5,23,28
33,BER,P006919,P012720,10.05,-2,20,22
33,BER,P007025,P008173,0.4,-2,0,2
33,BER,P007025,P008211,4.667,3,13,10
33,BER,P007025,P012720,5.067,1,13,12
33,BER,P007025,P012721,2.367,4,8,4
33,BER,P008173,P008384,7.017,-4,14,18
33,BER,P008173,P008967,19.317,-14,30,44
33,BER,P008173,P012720,4.2,-8,7,15
33,BER,P008173,P012721,1.584,-7,2,9
33,BER,P008211,P008384,8.117,5,21,16
33,BER,P008211,P008967,7.35,-3,11,14
33,BER,P008211,P012720,20.134,5,45,40
33,BER,P008211,P012721,13.367,2,30,28
33,BER,P008384,P008967,6.867,-4,14,18
33,BER,P008384,P012720,8.267,5,21,16
33,BER,P008384,P012721,6.984,0,15,15
33,BER,P008967,P012720,11.0,-9,18,27
33,BER,P008967,P012721,6.267,-13,9,22
33,BER,P012720,P012721,14.284,-1,32,33
33,MCO,P002581,P004197,2.366,-4,4,8
33,MCO,P002581,P005985,2.15,-5,4,9
33,MCO,P002581,P011212,3.483,-7,6,13
33,MCO,P002581,P011226,1.117,-3,2,5
33,MCO,P002581,P011231,3.483,-7,6,13
33,MCO,P002581,P012709,1.333,-2,2,4
33,MCO,P004197,P004790,1.783,-5,2,7
33,MCO,P004197,P005985,7.516,-1,22,23
33,MCO,P004197,P008099,0.467,-3,1,4
33,MCO,P004197,P010588,2.85,2,11,9
33,MCO,P004197,P011196,8.617,3,26,23
33,MCO,P004197,P011212,7.366,1,20,19
33,MCO,P004197,P011226,6.467,0,21,21
33,MCO,P004197,P011231,9.2,4,28,24
33,MCO,P004197,P012709,5.85,5,18,13
33,MCO,P004197,PLCZ,2.85,2,11,9
33,MCO,P004790,P005985,7.75,-1,15,16
33,MCO,P004790,P008099,2.2,0,0,0
33,MCO,P004790,P010588,5.0,1,7,6
33,MCO,P004790,P011196,8.633,-5,15,20
33,MCO,P004790,P011212,12.333,-1,20,21
33,MCO,P004790,P011226,9.916,-5,16,21
33,MCO,P004790,P011231,0.067,0,0,0
33,MCO,P004790,P012709,6.85,0,13,13
33,MCO,P005985,P008099,11.617,12,21,9
33,MCO,P005985,P010588,17.167,20,40,20
33,MCO,P005985,P011196,8.484,-3,16,19
33,MCO,P005985,P011212,10.184,-3,19,22
33,MCO,P005985,P011226,23.051,13,52,39
33,MCO,P005985,P011231,5.751,-6,12,18
33,MCO,P005985,P012709,3.167,3,6,3
33,MCO,P005985,PLCZ,14.367,19,33,14
33,MCO,P008099,P010588,14.284,9,22,13
33,MCO,P008099,P011212,2.2,0,0,0
33,MCO,P008099,P011226,14.284,9,22,13
33,MCO,P008099,PLCZ,12.084,9,22,13
33,MCO,P010588,P011212,5.367,3,9,6
33,MCO,P010588,P011226,19.767,17,41,24
33,MCO,P010588,P011231,0.067,0,0,0
33,MCO,P010588,PLCZ,14.834,16,34,18
33,MCO,P011196,P011212,13.067,3,29,26
33,MCO,P011196,P011226,8.517,-7,17,24
33,MCO,P011196,P011231,8.051,6,24,18
33,MCO,P011196,P012709,11.367,7,29,22
33,MCO,P011212,P011226,11.317,-5,18,23
33,MCO,P011212,P011231,9.284,-2,22,24
33,MCO,P011212,P012709,12.7,5,31,26
33,MCO,P011212,PLCZ,0.367,2,2,0
33,MCO,P011226,P011231,4.651,-4,10,14
33,MCO,P011226,P012709,3.683,-3,7,10
33,MCO,P011226,PLCZ,14.834,16,34,18
33,MCO,P011231,P012709,5.85,5,18,13
34,BAR,P000925,P002939,10.717,10,27,17
34,BAR,P000925,P003478,1.25,4,4,0
34,BAR,P000925,P004866,11.967,14,31,17
34,BAR,P000925,P006435,10.717,10,27,17
34,BAR,P000925,P007519,1.25,4,4,0
34,BAR,P000925,P011244,10.717,10,27,17
34,BAR,P000925,P012745,1.25,4,4,0
34,BAR,P002939,P003196,3.6,3,8,5
34,BAR,P002939,P004866,14.117,11,33,22
34,BAR,P002939,P006435,12.134,10,29,19
34,BAR,P002939,P007464,4.333,3,8,5
34,BAR,P002939,P009992,6.316,4,12,8
34,BAR,P002939,P010641,4.133,1,6,5
34,BAR,P002939,P011244,14.85,11,33,22
34,BAR,P002939,P012745,3.6,3,8,5
34,BAR,P003196,P003478,4.033,1,9,8
34,BAR,P003196,P004866,1.833,8,8,0
34,BAR,P003196,P006435,1.833,8,8,0
34,BAR,P003196,P007464,15.816,12,32,20
34,BAR,P003196,P007519,14.049,17,32,15
34,BAR,P003196,P009992,11.783,11,23,12
34,BAR,P003196,P011244,1.833,8,8,0
34,BAR,P003196,P012745,15.816,12,32,20
34,BAR,P003478,P004866,1.25,4,4,0
34,BAR,P003478,P007464,4.033,1,9,8
34,BAR,P003478,P007519,5.283,5,13,8
34,BAR,P003478,P012745,5.283,5,13,8
34,BAR,P004866,P006435,13.967,18,37,19
34,BAR,P004866,P007519,3.083,12,12,0
34,BAR,P004866,P009992,1.983,1,4,3
34,BAR,P004866,P010641,3.4,1,6,5
34,BAR,P004866,P011244,15.95,19,41,22
34,BAR,P004866,P012745,1.25,4,4,0
34,BAR,P006435,P007519,1.833,8,8,0
34,BAR,P006435,P010641,1.417,0,2,2
34,BAR,P006435,P011244,13.967,18,37,19
34,BAR,P007464,P007519,18.466,13,45,32
34,BAR,P007464,P009992,18.766,15,44,29
34,BAR,P007464,P010641,6.983,4,21,17
34,BAR,P007464,P011244,0.733,0,0,0
34,BAR,P007464,P012745,22.066,16,53,37
34,BAR,P007519,P009992,14.433,12,36,24
34,BAR,P007519,P010641,6.25,4,21,17
34,BAR,P007519,P011244,1.833,8,8,0
34,BAR,P007519,P012745,19.716,17,49,32
34,BAR,P009992,P010641,8.966,5,25,20
34,BAR,P009992,P011244,2.716,1,4,3
34,BAR,P009992,P012745,18.033,15,44,29
34,BAR,P010641,P011244,4.133,1,6,5
34,BAR,P010641,P012745,6.25,4,21,17
34,MUN,P001557,P003583,13.7,-10,20,30
34,MUN,P001557,P004508,16.116,-9,25,34
34,MUN,P001557,P005460,7.666,-13,8,21
34,MUN,P001557,P007056,6.134,-4,11,15
34,MUN,P001557,P007975,12.75,-17,16,33
34,MUN,P001557,P008985,9.45,-1,14,15
34,MUN,P001557,P010391,12.7,-6,16,22
34,MUN,P001557,P011941,4.2,-3,5,8
34,MUN,P001557,P011987,6.084,-9,5,14
34,MUN,P003583,P004508,19.717,-12,32,44
34,MUN,P003583,P005460,7.35,-10,7,17
34,MUN,P003583,P006245,7.75,-2,19,21
34,MUN,P003583,P006760,8.817,-6,19,25
34,MUN,P003583,P007056,4.717,-4,9,13
34,MUN,P003583,P007975,11.583,-11,21,32
34,MUN,P003583,P008985,5.267,-3,6,9
34,MUN,P003583,P010391,10.45,-2,23,25
34,MUN,P003583,P011987,0.717,-4,0,4
34,MUN,P004508,P005460,6.633,-6,7,13
34,MUN,P004508,P006245,5.667,-2,12,14
34,MUN,P004508,P006760,7.984,-6,12,18
34,MUN,P004508,P007056,4.717,-4,9,13
34,MUN,P004508,P007975,10.033,-7,14,21
34,MUN,P004508,P008985,8.4,-6,11,17
34,MUN,P004508,P010391,12.75,-5,21,26
34,MUN,P004508,P011941,4.383,-3,5,8
34,MUN,P005460,P006245,1.5,2,2,0
34,MUN,P005460,P006760,2.567,-2,2,4
34,MUN,P005460,P007975,5.433,-11,5,16
34,MUN,P005460,P008985,3.3,-6,3,9
34,MUN,P005460,P010391,2.883,-5,3,8
34,MUN,P005460,P011987,3.6,-9,3,12
34,MUN,P006245,P006760,7.75,-2,19,21
34,MUN,P006245,P007975,2.083,0,7,7
34,MUN,P006245,P010391,6.25,-4,17,21
34,MUN,P006760,P007056,4.417,-8,4,12
34,MUN,P006760,P007975,4.8,-1,10,11
34,MUN,P006760,P008985,4.884,-14,2,16
34,MUN,P006760,P010391,8.967,-5,20,25
34,MUN,P006760,P011941,5.934,-13,3,16
34,MUN,P006760,P011987,5.284,-11,5,16
34,MUN,P007056,P007975,6.734,-2,13,15
34,MUN,P007056,P008985,6.267,-14,7,21
34,MUN,P007056,P010391,4.467,-2,9,11
34,MUN,P007056,P011941,6.267,-14,7,21
34,MUN,P007056,P011987,8.284,-12,11,23
34,MUN,P007975,P010391,9.233,-9,12,21
34,MUN,P007975,P011941,2.117,-3,1,4
34,MUN,P007975,P011987,5.434,-11,5,16
34,MUN,P008985,P010391,10.717,-2,19,21
34,MUN,P008985,P011941,10.467,-17,12,29
34,MUN,P008985,P011987,8.384,-13,10,23
34,MUN,P010391,P011941,8.767,-10,11,21
34,MUN,P010391,P011987,9.284,-10,13,23
34,MUN,P011941,P011987,8.201,-17,8,25
35,PAN,P001926,P002328,25.8,3,50,47
35,PAN,P001926,P003842,10.917,-1,16,17
35,PAN,P001926,P007553,8.484,-1,16,17
35,PAN,P001926,P007866,20.284,4,32,28
35,PAN,P001926,P007947,15.25,-11,23,34
35,PAN,P001926,P008084,4.983,-1,6,7
35,PAN,P001926,P011204,15.285,-2,25,27
35,PAN,P001926,P011209,3.567,2,5,3
35,PAN,P001926,P011221,12.733,-2,21,23
35,PAN,P001926,P011826,2.349,0,2,2
35,PAN,P001926,P012712,8.884,-7,16,23
35,PAN,P002328,P003842,15.751,7,32,25
35,PAN,P002328,P007553,8.484,-1,16,17
35,PAN,P002328,P007866,20.317,10,37,27
35,PAN,P002328,P007947,19.117,4,43,39
35,PAN,P002328,P008084,4.967,-2,8,10
35,PAN,P002328,P011204,15.118,7,29,22
35,PAN,P002328,P011209,6.718,2,19,17
35,PAN,P002328,P011221,10.2,-2,23,25
35,PAN,P002328,P011826,1.966,-3,1,4
35,PAN,P002328,P012712,9.234,-1,26,27
35,PAN,P003842,P007866,11.401,4,18,14
35,PAN,P003842,P007947,14.652,-10,27,37
35,PAN,P003842,P008084,7.083,-1,12,13
35,PAN,P003842,P011204,11.601,2,19,17
35,PAN,P003842,P011209,8.968,3,20,17
35,PAN,P003842,P011221,0.017,-2,0,2
35,PAN,P003842,P011826,5.483,-4,6,10
35,PAN,P003842,P012712,6.335,-6,14,20
35,PAN,P007553,P007866,1.6,1,1,0
35,PAN,P007553,P008084,0.917,-2,0,2
35,PAN,P007553,P011204,8.484,-1,16,17
35,PAN,P007553,P012712,5.967,0,15,15
35,PAN,P007866,P007947,20.001,0,32,32
35,PAN,P007866,P011204,8.384,5,12,7
35,PAN,P007866,P011209,3.567,10,10,0
35,PAN,P007866,P011221,13.067,3,24,21
35,PAN,P007866,P011826,2.167,-3,2,5
35,PAN,P007866,P012712,3.484,-2,4,6
35,PAN,P007947,P008084,3.15,-2,8,10
35,PAN,P007947,P011204,7.768,-4,10,14
35,PAN,P007947,P011209,6.368,4,18,14
35,PAN,P007947,P011221,13.167,-1,24,25
35,PAN,P007947,P011826,3.3,-8,4,12
35,PAN,P007947,P012712,8.435,-8,15,23
35,PAN,P008084,P011204,5.434,1,8,7
35,PAN,P008084,P011209,2.384,-7,2,9
35,PAN,P008084,P011221,0.317,-3,0,3
35,PAN,P008084,P011826,3.316,-1,4,5
35,PAN,P008084,P012712,0.717,-6,0,6
35,PAN,P011204,P011209,1.417,2,2,0
35,PAN,P011204,P011221,1.184,0,0,0
35,PAN,P011204,P011826,2.833,-1,4,5
35,PAN,P011204,P012712,7.568,-5,15,20
35,PAN,P011209,P011221,0.751,-2,3,5
35,PAN,P011209,P012712,5.068,-2,13,15
35,PAN,P011221,P011826,0.083,-2,0,2
35,PAN,P011221,P012712,2.417,-5,1,6
35,PAN,P011826,P012712,0.767,-2,1,3
35,TEL,P004233,P005145,0.434,0,2,2
35,TEL,P004233,P007990,2.817,-1,4,5
35,TEL,P004233,P009622,3.584,1,6,5
35,TEL,P004233,P009783,2.967,3,6,3
35,TEL,P004233,P011193,4.251,1,7,6
35,TEL,P004233,P011199,3.083,-1,4,5
35,TEL,P004233,P011214,0.133,-2,0,2
35,TEL,P004233,P011219,3.684,-1,5,6
35,TEL,P004233,P011971,3.4,-1,5,6
35,TEL,P004233,P012744,2.783,1,5,4
35,TEL,P005145,P007990,15.384,-3,27,30
35,TEL,P005145,P009622,17.617,4,34,30
35,TEL,P005145,P009783,16.8,-1,29,30
35,TEL,P005145,P011193,3.067,3,7,4
35,TEL,P005145,P011199,17.4,2,32,30
35,TEL,P005145,P011214,0.2,0,0,0
35,TEL,P005145,P011219,0.417,-2,0,2
35,TEL,P005145,P012744,0.817,5,5,0
35,TEL,P007990,P009622,20.3,3,37,34
35,TEL,P007990,P009783,20.417,-5,36,41
35,TEL,P007990,P011193,6.951,-1,18,19
35,TEL,P007990,P011199,19.483,-1,31,32
35,TEL,P007990,P011214,7.467,-1,15,16
35,TEL,P007990,P011219,6.368,-3,15,18
35,TEL,P007990,P011971,0.2,3,3,0
35,TEL,P007990,P012744,4.817,5,10,5
35,TEL,P009622,P009783,32.901,4,61,57
35,TEL,P009622,P011193,15.001,5,31,26
35,TEL,P009622,P011199,28.7,9,52,43
35,TEL,P009622,P011214,9.417,5,18,13
35,TEL,P009622,P011219,6.201,-7,9,16
35,TEL,P009622,P011971,1.984,4,8,4
35,TEL,P009622,P012744,10.167,4,20,16
35,TEL,P009783,P011193,17.051,4,35,31
35,TEL,P009783,P011199,26.15,4,47,43
35,TEL,P009783,P011214,10.351,2,22,20
35,TEL,P009783,P011219,8.251,-8,13,21
35,TEL,P009783,P011971,1.367,6,8,2
35,TEL,P009783,P012744,7.617,-1,15,16
35,TEL,P011193,P011199,8.133,5,15,10
35,TEL,P011193,P011214,10.651,0,23,23
35,TEL,P011193,P011219,13.685,-9,23,32
35,TEL,P011193,P011971,4.634,7,13,6
35,TEL,P011193,P012744,10.184,1,20,19
35,TEL,P011199,P011214,3.333,2,6,4
35,TEL,P011199,P011219,0.017,2,2,0
35,TEL,P011199,P011971,0.133,-2,0,2
35,TEL,P011199,P012744,8.9,8,19,11
35,TEL,P011214,P011219,10.201,-2,21,23
35,TEL,P011214,P011971,1.3,1,5,4
35,TEL,P011214,P012744,6.483,-1,10,11
35,TEL,P011219,P011971,3.267,1,5,4
35,TEL,P011219,P012744,6.317,-3,11,14
35,TEL,P011971,P012744,2.783,1,5,4
36,RED,P000848,P002553,4.149,-10,8,18
36,RED,P000848,P005099,3.899,-7,8,15
36,RED,P000848,P006436,4.667,-3,9,12
36,RED,P000848,P007960,6.083,-2,9,11
36,RED,P000848,P009035,5.267,-3,9,12
36,RED,P000848,P011224,2.617,2,5,3
36,RED,P000848,P012044,0.633,-5,0,5
36,RED,P000848,P012711,2.833,-5,8,13
36,RED,P000848,PJDR,4.416,-7,8,15
36,RED,P000848,PLUO,2.1,0,4,4
36,RED,P002553,P005099,18.382,-3,36,39
36,RED,P002553,P006436,7.616,-8,20,28
36,RED,P002553,P007960,4.95,3,7,4
36,RED,P002553,P009035,14.349,-3,32,35
36,RED,P002553,P011224,13.317,-4,33,37
36,RED,P002553,P012044,3.583,0,5,5
36,RED,P002553,P012711,2.833,-5,8,13
36,RED,P002553,PJDR,15.932,-3,38,41
36,RED,P002553,PLUO,5.217,1,9,8
36,RED,P005099,P006436,3.416,-3,7,10
36,RED,P005099,P007960,4.95,3,7,4
36,RED,P005099,P009035,10.149,2,19,17
36,RED,P005099,P011224,9.367,-2,20,22
36,RED,P005099,P012044,3.333,3,5,2
36,RED,P005099,P012711,2.833,-5,8,13
36,RED,P005099,PJDR,11.982,-1,25,26
36,RED,P005099,PLUO,5.217,1,9,8
36,RED,P006436,P007960,7.9,-6,11,17
36,RED,P006436,P009035,20.916,-6,41,47
36,RED,P006436,P011224,17.3,-5,36,41
36,RED,P006436,P012044,1.049,-5,2,7
36,RED,P006436,P012711,5.85,5,12,7
36,RED,P006436,PJDR,11.85,1,28,27
36,RED,P006436,PLUO,4.9,-6,6,12
36,RED,P007960,P009035,11.567,-3,18,21
36,RED,P007960,P011224,11.634,2,19,17
36,RED,P007960,P012044,1.8,0,2,2
36,RED,P007960,PJDR,6.067,3,9,6
36,RED,P007960,PLUO,11.117,0,18,18
36,RED,P009035,P011224,25.417,0,52,52
36,RED,P009035,P012044,2.732,-2,5,7
36,RED,P009035,P012711,5.85,5,12,7
36,RED,P009035,PJDR,19.583,11,43,32
36,RED,P009035,PLUO,11.234,-5,17,22
36,RED,P011224,P012044,0.183,2,2,0
36,RED,P011224,P012711,5.85,5,12,7
36,RED,P011224,PJDR,15.967,2,39,37
36,RED,P011224,PLUO,11.684,-2,18,20
36,RED,P012044,P012711,0.183,2,2,0
36,RED,P012044,PJDR,3.1,5,5,0
36,RED,P012711,PJDR,8.5,-2,18,20
36,RED,PJDR,PLUO,3.667,3,7,4
36,VIR,P001133,P001844,16.999,-1,33,34
36,VIR,P001133,P003048,12.783,13,32,19
36,VIR,P001133,P004007,7.599,-6,12,18
36,VIR,P001133,P006739,5.65,-7,8,15
36,VIR,P001133,P008847,16.765,-16,27,43
36,VIR,P001133,P009549,22.082,-2,47,49
36,VIR,P001133,P010781,10.132,-5,20,25
36,VIR,P001133,P011192,3.933,8,14,6
36,VIR,P001133,PBCN,22.249,4,43,39
36,VIR,P001844,P003048,9.55,5,18,13
36,VIR,P001844,P004007,6.749,-3,12,15
36,VIR,P001844,P006739,0.45,3,5,2
36,VIR,P001844,P008847,7.899,-3,20,23
36,VIR,P001844,P009549,11.633,3,28,25
36,VIR,P001844,P010781,1.233,-3,2,5
36,VIR,P001844,PBCN,15.283,7,34,27
36,VIR,P003048,P004007,7.016,10,16,6
36,VIR,P003048,P006739,5.3,4,11,7
36,VIR,P003048,P008847,6.533,4,11,7
36,VIR,P003048,P009549,10.983,4,24,20
36,VIR,P003048,P010781,9.766,12,25,13
36,VIR,P003048,P011192,5.55,9,15,6
36,VIR,P003048,PBCN,9.783,7,20,13
36,VIR,P004007,P006739,4.883,1,12,11
36,VIR,P004007,P008847,7.899,-8,14,22
36,VIR,P004007,P009549,1.316,-3,4,7
36,VIR,P004007,P010781,5.483,-1,10,11
36,VIR,P004007,PBCN,4.583,2,8,6
36,VIR,P006739,P008847,14.867,2,34,32
36,VIR,P006739,P009549,9.3,-3,23,26
36,VIR,P006739,P010781,9.75,-4,16,20
36,VIR,P006739,P011192,1.317,3,3,0
36,VIR,P006739,P012714,3.384,2,10,8
36,VIR,P006739,PBCN,4.567,7,14,7
36,VIR,P008847,P009549,18.382,-7,38,45
36,VIR,P008847,P010781,15.882,-10,22,32
36,VIR,P008847,P011192,3.483,5,5,0
36,VIR,P008847,P012714,3.384,2,10,8
36,VIR,P008847,PBCN,13.766,3,31,28
36,VIR,P009549,P010781,11.382,-6,21,27
36,VIR,P009549,P011192,4.233,6,12,6
36,VIR,P009549,P012714,3.384,2,10,8
36,VIR,P009549,PBCN,18.033,6,41,35
36,VIR,P010781,P011192,6.483,11,17,6
36,VIR,P010781,P012714,2.367,-1,5,6
36,VIR,P010781,PBCN,3.982,-1,6,7
36,VIR,P011192,PBCN,0.933,2,2,0
36,VIR,P012714,PBCN,1.017,3,5,2
37,BER,P003958,P006251,7.766,-3,16,19
37,BER,P003958,P006819,9.183,0,15,15
37,BER,P003958,P006919,25.4,14,62,48
37,BER,P003958,P008173,19.0,7,41,34
37,BER,P003958,P008211,10.766,8,29,21
37,BER,P003958,P008384,2.183,-1,3,4
37,BER,P003958,P008967,14.35,6,36,30
37,BER,P003958,P010791,7.833,7,20,13
37,BER,P003958,P012720,22.583,22,58,36
37,BER,P006251,P006919,6.967,1,16,15
37,BER,P006251,P007550,3.533,-11,2,13
37,BER,P006251,P008173,6.15,6,16,10
37,BER,P006251,P008211,6.833,-12,11,23
37,BER,P006251,P008384,9.549,-18,13,31
37,BER,P006251,P008967,7.183,-13,9,22
37,BER,P006251,P010791,4.583,-1,11,12
37,BER,P006251,P012720,9.333,-4,20,24
37,BER,P006251,P012721,4.167,-13,2,15
37,BER,P006819,P006919,8.066,-3,12,15
37,BER,P006819,P008173,9.183,0,15,15
37,BER,P006819,P008384,1.117,3,3,0
37,BER,P006819,P008967,3.283,-7,5,12
37,BER,P006819,P012720,5.9,7,10,3
37,BER,P006919,P008173,17.584,6,38,32
37,BER,P006919,P008211,8.083,8,24,16
37,BER,P006919,P008967,11.634,6,31,25
37,BER,P006919,P010791,5.65,5,15,10
37,BER,P006919,P012720,19.017,19,50,31
37,BER,P006919,P012721,0.267,0,0,0
37,BER,P007550,P008384,3.533,-11,2,13
37,BER,P007550,P008967,3.533,-11,2,13
37,BER,P007550,P012721,3.533,-11,2,13
37,BER,P008173,P008384,1.683,1,3,2
37,BER,P008173,P008967,8.65,-2,19,21
37,BER,P008173,P010791,1.667,0,3,3
37,BER,P008173,P012720,12.884,10,29,19
37,BER,P008173,P012721,0.267,0,0,0
37,BER,P008211,P008384,6.567,-3,13,16
37,BER,P008211,P008967,7.551,8,19,11
37,BER,P008211,P010791,12.233,8,30,22
37,BER,P008211,P012720,14.916,11,40,29
37,BER,P008211,P012721,1.851,0,2,2
37,BER,P008384,P008967,5.55,-13,4,17
37,BER,P008384,P010791,5.7,1,13,12
37,BER,P008384,P012720,6.233,0,14,14
37,BER,P008384,P012721,5.017,-11,4,15
37,BER,P008967,P010791,4.284,4,7,3
37,BER,P008967,P012720,7.534,13,24,11
37,BER,P008967,P012721,5.384,-11,4,15
37,BER,P010791,P012720,12.166,6,31,25
37,BER,P010791,P012721,1.484,2,2,0
37,BER,P012720,P012721,0.634,0,0,0
37,MIL,P000796,P002812,4.866,-6,13,19
37,MIL,P000796,P002849,10.501,2,20,18
37,MIL,P000796,P005670,2.383,-3,4,7
37,MIL,P000796,P006433,20.234,-2,41,43
37,MIL,P000796,P006509,5.317,1,8,7
37,MIL,P000796,P007032,10.901,9,31,22
37,MIL,P000796,P007201,11.551,6,24,18
37,MIL,P000796,P007831,26.184,-1,56,57
37,MIL,P000796,P009960,10.45,0,18,18
37,MIL,P000796,P011205,20.617,22,57,35
37,MIL,P002812,P002849,3.933,-3,7,10
37,MIL,P002812,P005670,0.7,-2,2,4
37,MIL,P002812,P006433,7.3,-12,11,23
37,MIL,P002812,P006509,3.933,-3,7,10
37,MIL,P002812,P007032,7.0,-4,18,22
37,MIL,P002812,P007201,2.684,-4,3,7
37,MIL,P002812,P007831,9.3,-11,20,31
37,MIL,P002812,P011205,6.216,-7,11,18
37,MIL,P002849,P006433,11.45,-2,19,21
37,MIL,P002849,P006509,5.633,-8,9,17
37,MIL,P002849,P007032,6.334,-1,15,16
37,MIL,P002849,P007201,3.75,-1,8,9
37,MIL,P002849,P007831,13.767,-4,24,28
37,MIL,P002849,P009960,5.5,-7,3,10
37,MIL,P002849,P011205,7.4,8,19,11
37,MIL,P005670,P007201,1.683,-1,2,3
37,MIL,P005670,P007831,2.383,-3,4,7
37,MIL,P005670,P011205,2.383,-3,4,7
37,MIL,P006433,P006509,4.6,-4,5,9
37,MIL,P006433,P007032,4.634,-5,11,16
37,MIL,P006433,P007201,6.468,-7,8,15
37,MIL,P006433,P007831,21.168,-6,42,48
37,MIL,P006433,P009960,10.233,0,18,18
37,MIL,P006433,P011205,14.717,6,33,27
37,MIL,P006509,P007032,6.35,-3,12,15
37,MIL,P006509,P007201,7.017,-4,10,14
37,MIL,P006509,P007831,5.317,-11,6,17
37,MIL,P006509,P011205,5.633,4,11,7
37,MIL,P007032,P007201,10.984,4,24,20
37,MIL,P007032,P007831,14.334,-5,32,37
37,MIL,P007032,P009960,0.217,0,0,0
37,MIL,P007032,P011205,7.45,17,25,8
37,MIL,P007201,P007831,12.301,-9,19,28
37,MIL,P007201,P011205,11.034,12,26,14
37,MIL,P007831,P009960,10.45,0,18,18
37,MIL,P007831,P011205,17.8,14,47,33
37,MIL,P009960,P011205,4.95,7,15,8
38,IST,P004554,P004888,9.433,-7,13,20
38,IST,P004554,P006372,6.633,-5,11,16
38,IST,P004554,P006590,3.999,0,6,6
38,IST,P004554,P007200,9.0,-12,11,23
38,IST,P004554,P009513,3.65,5,9,4
38,IST,P004554,P009664,16.066,-2,26,28
38,IST,P004554,P009846,8.549,-9,12,21
38,IST,P004554,P011078,9.166,5,16,11
38,IST,P004554,P011981,0.1,-3,0,3
38,IST,P004888,P006372,3.567,-2,3,5
38,IST,P004888,P006590,15.482,-9,24,33
38,IST,P004888,P007200,19.284,-7,32,39
38,IST,P004888,P009664,11.717,-2,18,20
38,IST,P004888,P009846,14.616,-11,19,30
38,IST,P004888,P011078,11.966,-5,12,17
38,IST,P004888,P011981,8.034,-4,8,12
38,IST,P004888,PLHK,9.233,-5,15,20
38,IST,P006372,P006590,0.1,-3,0,3
38,IST,P006372,P007200,5.35,-6,5,11
38,IST,P006372,P009513,3.65,5,9,4
38,IST,P006372,P009664,6.533,-2,11,13
38,IST,P006372,P009846,8.5,-6,9,15
38,IST,P006372,P011078,2.5,5,5,0
38,IST,P006372,P011981,3.567,-2,3,5
38,IST,P006590,P007200,16.883,-8,28,36
38,IST,P006590,P009664,9.983,-4,15,19
38,IST,P006590,P009846,12.732,-4,18,22
38,IST,P006590,P011078,11.948,-5,17,22
38,IST,P006590,P011981,5.917,-5,5,10
38,IST,P006590,PLHK,15.416,-10,23,33
38,IST,P007200,P009664,15.567,-21,20,41
38,IST,P007200,P009846,17.033,-8,25,33
38,IST,P007200,P011078,10.35,-7,16,23
38,IST,P007200,P011981,8.218,1,8,7
38,IST,P007200,PLHK,14.783,-8,23,31
38,IST,P009513,P009664,3.65,5,9,4
38,IST,P009513,P009846,2.15,0,4,4
38,IST,P009513,P011078,1.5,5,5,0
38,IST,P009664,P009846,8.066,-7,12,19
38,IST,P009664,P011078,12.383,-2,20,22
38,IST,P009664,P011981,2.867,0,5,5
38,IST,P009664,PLHK,3.7,-9,4,13
38,IST,P009846,P011078,5.532,0,6,6
38,IST,P009846,P011981,6.417,-1,3,4
38,IST,P009846,PLHK,10.733,-2,16,18
38,IST,P011078,P011981,2.6,-2,0,2
38,IST,P011078,PLHK,7.983,-6,11,17
38,IST,P011981,PLHK,2.884,0,0,0
38,OLY,P001255,P003941,16.984,13,43,30
38,OLY,P001255,P006302,1.334,-2,0,2
38,OLY,P001255,P007982,15.501,18,38,20
38,OLY,P001255,P008811,11.1,8,18,10
38,OLY,P001255,P008829,8.566,8,17,9
38,OLY,P001255,P008855,19.333,10,42,32
38,OLY,P001255,P010392,7.667,10,16,6
38,OLY,P001255,P010612,20.0,13,45,32
38,OLY,P001255,P011983,11.434,8,25,17
38,OLY,P001255,P012023,0.417,-2,0,2
38,OLY,P003941,P006302,1.85,-5,0,5
38,OLY,P003941,P007982,14.517,18,37,19
38,OLY,P003941,P008829,5.816,7,15,8
38,OLY,P003941,P008855,10.65,7,29,22
38,OLY,P003941,P010392,9.65,13,23,10
38,OLY,P003941,P010612,12.333,11,35,24
38,OLY,P003941,P010631,1.083,-3,0,3
38,OLY,P003941,P011983,12.817,4,26,22
38,OLY,P003941,P012023,1.5,-5,0,5
38,OLY,P006302,P007982,0.567,0,0,0
38,OLY,P006302,P008811,0.567,0,0,0
38,OLY,P006302,P010392,0.35,0,0,0
38,OLY,P006302,P010612,0.567,0,0,0
38,OLY,P006302,P010631,1.083,-3,0,3
38,OLY,P006302,P011983,1.85,-5,0,5
38,OLY,P006302,P012023,1.5,-5,0,5
38,OLY,P007982,P008811,9.334,2,12,10
38,OLY,P007982,P008829,8.45,5,14,9
38,OLY,P007982,P008855,7.517,5,19,14
38,OLY,P007982,P010392,15.667,12,27,15
38,OLY,P007982,P010612,11.934,10,28,18
38,OLY,P007982,P011983,11.917,10,21,11
38,OLY,P008811,P008829,13.583,1,16,15
38,OLY,P008811,P008855,11.166,1,16,15
38,OLY,P008811,P010392,8.85,-3,7,10
38,OLY,P008811,P010612,13.9,2,19,17
38,OLY,P008811,P011983,4.3,1,4,3
38,OLY,P008829,P008855,10.949,3,17,14
38,OLY,P008829,P010392,10.833,0,14,14
38,OLY,P008829,P010612,14.799,8,26,18
38,OLY,P008829,P011983,4.6,0,5,5
38,OLY,P008855,P010392,2.483,-2,3,5
38,OLY,P008855,P010612,21.816,8,45,37
38,OLY,P008855,P011983,3.35,0,9,9
38,OLY,P010392,P010612,6.233,0,9,9
38,OLY,P010392,P011983,12.267,10,21,11
38,OLY,P010612,P011983,3.35,0,9,9
38,OLY,P010631,P011983,1.083,-3,0,3
38,OLY,P010631,P012023,1.083,-3,0,3
38,OLY,P011983,P012023,1.5,-5,0,5
39,PAR,P000956,P003983,4.634,-7,8,15
39,PAR,P000956,P004058,6.634,-3,16,19
39,PAR,P000956,P007400,5.401,1,18,17
39,PAR,P000956,P008987,7.401,-8,14,22
39,PAR,P000956,P009862,8.484,-11,16,27
39,PAR,P000956,P011051,5.184,-7,7,14
39,PAR,P000956,P012742,1.267,0,2,2
39,PAR,P000956,P012743,6.067,-5,15,20
39,PAR,P003983,P004058,8.017,5,24,19
39,PAR,P003983,P007400,11.6,4,35,31
39,PAR,P003983,P007673,0.85,-2,0,2
39,PAR,P003983,P008987,17.4,-12,32,44
39,PAR,P003983,P009862,12.916,-9,21,30
39,PAR,P003983,P011051,15.433,6,40,34
39,PAR,P003983,P012742,12.05,12,38,26
39,PAR,P003983,P012743,5.9,-9,10,19
39,PAR,P004058,P007400,24.568,12,60,48
39,PAR,P004058,P008987,17.151,3,30,27
39,PAR,P004058,P009862,15.034,6,30,24
39,PAR,P004058,P011051,7.167,8,23,15
39,PAR,P004058,P012742,6.05,7,20,13
39,PAR,P004058,P012743,18.651,2,37,35
39,PAR,P007400,P008987,19.484,4,41,37
39,PAR,P007400,P009862,17.35,4,34,30
39,PAR,P007400,P011051,7.5,9,28,19
39,PAR,P007400,P012742,6.067,10,27,17
39,PAR,P007400,P012743,20.634,0,41,41
39,PAR,P007673,P008987,0.85,-2,0,2
39,PAR,P007673,P009862,0.85,-2,0,2
39,PAR,P007673,P012742,0.85,-2,0,2
39,PAR,P008987,P009862,24.083,-1,41,42
39,PAR,P008987,P011051,12.45,-4,23,27
39,PAR,P008987,P012742,8.5,1,18,17
39,PAR,P008987,P012743,18.017,-1,33,34
39,PAR,P009862,P011051,8.833,-2,15,17
39,PAR,P009862,P012742,5.983,2,11,9
39,PAR,P009862,P012743,18.267,1,36,35
39,PAR,P011051,P012742,12.433,10,36,26
39,RED,P002553,P005099,20.267,20,54,34
39,RED,P002553,P006436,4.116,0,11,11
39,RED,P002553,P007960,2.966,5,10,5
39,RED,P002553,P008966,6.15,6,16,10
39,RED,P002553,P009035,14.05,8,34,26
39,RED,P002553,P011224,16.416,12,40,28
39,RED,P002553,P012044,10.817,15,30,15
39,RED,P002553,PJDR,17.882,10,45,35
39,RED,P005099,P006436,6.834,-12,5,17
39,RED,P005099,P007960,9.417,-13,10,23
39,RED,P005099,P008966,7.267,4,16,12
39,RED,P005099,P009035,18.751,-5,34,39
39,RED,P005099,P011224,19.984,-2,37,39
39,RED,P005099,P012044,13.434,12,33,21
39,RED,P005099,PJDR,15.45,8,39,31
39,RED,P006436,P007960,17.032,-14,28,42
39,RED,P006436,P008966,4.599,0,5,5
39,RED,P006436,P009035,11.883,-22,18,40
39,RED,P006436,P011224,11.899,-15,21,36
39,RED,P006436,P012044,8.999,-6,13,19
39,RED,P006436,PJDR,9.898,-3,23,26
39,RED,P007960,P008966,3.933,1,6,5
39,RED,P007960,P009035,12.85,-21,19,40
39,RED,P007960,P011224,12.883,-16,22,38
39,RED,P007960,P012044,10.532,-3,19,22
39,RED,P007960,PJDR,9.315,-3,22,25
39,RED,P008966,P009035,0.084,1,3,2
39,RED,P008966,P011224,2.217,2,6,4
39,RED,P008966,P012044,10.0,7,24,17
39,RED,P008966,PJDR,6.35,7,20,13
39,RED,P009035,P011224,24.967,-7,55,62
39,RED,P009035,P012044,10.234,4,26,22
39,RED,P009035,PJDR,15.049,-10,31,41
39,RED,P011224,P012044,10.217,11,29,18
39,RED,P011224,PJDR,14.349,-5,34,39
39,RED,P012044,PJDR,8.899,4,22,18
40,BAR,P000925,P002939,23.467,14,43,29
40,BAR,P000925,P003478,21.733,15,44,29
40,BAR,P000925,P004866,21.733,15,46,31
40,BAR,P000925,P007464,2.567,-2,0,2
40,BAR,P000925,P007519,9.283,9,23,14
40,BAR,P000925,P009992,2.65,-1,5,6
40,BAR,P000925,P011244,13.867,4,23,19
40,BAR,P000925,P012745,1.9,-2,0,2
40,BAR,P002939,P003196,2.633,-6,0,6
40,BAR,P002939,P003478,22.85,14,41,27
40,BAR,P002939,P004866,23.2,12,43,31
40,BAR,P002939,P007464,2.9,-4,0,4
40,BAR,P002939,P007519,8.45,10,20,10
40,BAR,P002939,P009992,3.25,-6,2,8
40,BAR,P002939,P011244,15.417,2,23,21
40,BAR,P002939,P012745,2.233,-4,0,4
40,BAR,P003196,P003478,5.233,-6,5,11
40,BAR,P003196,P004866,6.9,-5,7,12
40,BAR,P003196,P007464,11.267,-8,13,21
40,BAR,P003196,P007519,13.0,-5,18,23
40,BAR,P003196,P009992,10.733,-7,13,20
40,BAR,P003196,P011244,4.366,-3,5,8
40,BAR,P003196,P012745,8.4,-4,11,15
40,BAR,P003478,P004866,24.816,13,49,36
40,BAR,P003478,P007464,1.884,-5,0,5
40,BAR,P003478,P007519,11.616,4,26,22
40,BAR,P003478,P009992,0.416,-1,3,4
40,BAR,P003478,P010641,0.067,-3,0,3
40,BAR,P003478,P011244,18.3,-2,28,30
40,BAR,P003478,P012745,1.217,-5,0,5
40,BAR,P004866,P007464,2.867,-4,2,6
40,BAR,P004866,P007519,13.95,5,30,25
40,BAR,P004866,P009992,3.967,-5,7,12
40,BAR,P004866,P010641,0.067,-3,0,3
40,BAR,P004866,P011244,17.3,0,28,28
40,BAR,P007464,P007519,10.934,-6,13,19
40,BAR,P007464,P009992,11.95,-5,13,18
40,BAR,P007464,P011244,0.667,0,0,0
40,BAR,P007464,P012745,10.3,-6,11,17
40,BAR,P007519,P009992,11.15,-4,18,22
40,BAR,P007519,P010641,0.067,-3,0,3
40,BAR,P007519,P011244,2.883,-4,5,9
40,BAR,P007519,P012745,8.067,-2,11,13
40,BAR,P009992,P011244,0.333,-2,0,2
40,BAR,P009992,P012745,9.083,-1,11,12
40,BAR,P010641,P011244,0.067,-3,0,3
40,MAD,P003108,P004887,13.05,7,25,18
40,MAD,P003108,P005791,4.467,-4,10,14
40,MAD,P003108,P005928,14.167,14,35,21
40,MAD,P003108,P006540,11.034,17,26,9
40,MAD,P003108,P009005,14.167,14,35,21
40,MAD,P003108,P009213,4.183,6,6,0
40,MAD,P003108,PBMT,7.067,-4,7,11
40,MAD,P003108,PCVM,7.117,-4,7,11
40,MAD,P003108,PTGB,9.684,-6,17,23
40,MAD,P003733,P005791,7.2,-8,6,14
40,MAD,P003733,P005928,7.2,-8,6,14
40,MAD,P003733,P006540,7.2,-8,6,14
40,MAD,P003733,P009005,7.2,-8,6,14
40,MAD,P004887,P005928,9.283,12,21,9
40,MAD,P004887,P006540,9.066,12,21,9
40,MAD,P004887,P009005,11.899,11,25,14
40,MAD,P004887,P009213,4.566,10,14,4
40,MAD,P004887,PBMT,10.366,2,20,18
40,MAD,P004887,PCVM,10.366,2,20,18
40,MAD,P004887,PTGB,10.0,0,18,18
40,MAD,P005791,P005928,11.7,-14,13,27
40,MAD,P005791,P006540,7.2,-8,6,14
40,MAD,P005791,P009005,14.283,-19,14,33
40,MAD,P005791,P009213,0.383,-2,0,2
40,MAD,P005791,PBMT,6.933,-7,4,11
40,MAD,P005791,PCVM,4.933,-6,4,10
40,MAD,P005791,PTGB,9.433,-12,11,23
40,MAD,P005928,P006540,18.234,9,32,23
40,MAD,P005928,P009005,23.367,5,41,36
40,MAD,P005928,P009213,2.85,6,6,0
40,MAD,P005928,PBMT,2.0,-1,0,1
40,MAD,P005928,PCVM,0.05,0,0,0
40,MAD,P005928,PTGB,4.617,-3,10,13
40,MAD,P006540,P009005,18.367,9,32,23
40,MAD,P006540,P009213,2.5,6,6,0
40,MAD,P006540,PBMT,0.366,2,2,0
40,MAD,P006540,PCVM,0.366,2,2,0
40,MAD,P006540,PTGB,0.067,3,3,0
40,MAD,P009005,P009213,2.85,6,6,0
40,MAD,P009005,PBMT,7.199,-7,5,12
40,MAD,P009005,PCVM,5.249,-6,5,11
40,MAD,P009005,PTGB,9.683,-9,15,24
40,MAD,P009213,PBMT,5.699,6,12,6
40,MAD,P009213,PCVM,5.699,6,12,6
40,MAD,P009213,PTGB,5.466,4,10,6
40,MAD,PBMT,PCVM,16.632,-4,24,28
40,MAD,PBMT,PTGB,18.266,-7,22,29
40,MAD,PCVM,PTGB,16.316,-6,22,28
41,MCO,P002581,P004197,1.45,1,4,3
41,MCO,P002581,P004790,6.35,-3,13,16
41,MCO,P002581,P011212,2.55,0,2,2
41,MCO,P002581,P011226,4.9,-4,9,13
41,MCO,P002581,P011231,0.683,0,0,0
41,MCO,P002581,P012515,5.667,-3,13,16
41,MCO,P002581,P012709,3.8,-3,11,14
41,MCO,P004197,P004790,1.45,1,4,3
41,MCO,P004197,P005985,12.9,16,34,18
41,MCO,P004197,P010588,12.9,16,34,18
41,MCO,P004197,P011212,3.317,-1,6,7
41,MCO,P004197,P011226,9.583,17,28,11
41,MCO,P004197,P012515,1.45,1,4,3
41,MCO,P004197,P012709,1.45,1,4,3
41,MCO,P004197,PLCZ,12.9,16,34,18
41,MCO,P004790,P005985,0.766,1,3,2
41,MCO,P004790,P010588,4.517,4,12,8
41,MCO,P004790,P011196,7.016,0,22,22
41,MCO,P004790,P011212,14.083,4,36,32
41,MCO,P004790,P011226,6.717,0,14,14
41,MCO,P004790,P011231,10.316,0,29,29
41,MCO,P004790,P012515,5.667,-3,13,16
41,MCO,P004790,P012709,14.65,0,42,42
41,MCO,P005985,P010588,19.217,22,50,28
41,MCO,P005985,P011196,4.366,2,12,10
41,MCO,P005985,P011212,10.983,5,28,23
41,MCO,P005985,P011226,17.3,24,49,25
41,MCO,P005985,P011231,2.083,2,8,6
41,MCO,P005985,P012709,0.983,4,4,0
41,MCO,P005985,PLCZ,16.934,20,44,24
41,MCO,P010588,P011196,2.2,0,4,4
41,MCO,P010588,P011212,14.084,8,34,26
41,MCO,P010588,P011226,16.65,24,46,22
41,MCO,P010588,P011231,4.517,4,12,8
41,MCO,P010588,P012709,6.167,9,18,9
41,MCO,P010588,PLCZ,17.684,21,46,25
41,MCO,P011196,P011212,11.366,4,34,30
41,MCO,P011196,P011226,6.167,8,17,9
41,MCO,P011196,P011231,7.266,0,25,25
41,MCO,P011196,P012709,7.083,2,22,20
41,MCO,P011212,P011226,12.767,13,31,18
41,MCO,P011212,P011231,12.466,4,37,33
41,MCO,P011212,P012515,1.867,0,2,2
41,MCO,P011212,P012709,12.433,9,38,29
41,MCO,P011212,PLCZ,7.284,2,16,14
41,MCO,P011226,P011231,2.833,4,8,4
41,MCO,P011226,P012515,4.217,-4,9,13
41,MCO,P011226,P012709,6.567,8,21,13
41,MCO,P011226,PLCZ,14.367,22,40,18
41,MCO,P011231,P012709,9.7,2,29,27
41,MCO,P012515,P012709,3.8,-3,11,14
41,MCO,P012709,PLCZ,1.567,3,4,1
41,TEL,P004233,P007990,0.083,-2,0,2
41,TEL,P004233,P009622,4.217,4,13,9
41,TEL,P004233,P011193,3.517,-1,10,11
41,TEL,P004233,P011199,3.45,1,10,9
41,TEL,P004233,P011214,0.2,0,0,0
41,TEL,P004233,P011219,5.7,-3,16,19
41,TEL,P004233,P011433,5.667,3,16,13
41,TEL,P004233,P011971,9.267,0,26,26
41,TEL,P004233,P012744,4.967,-2,13,15
41,TEL,P005145,P007990,10.3,-6,19,25
41,TEL,P005145,P009622,6.15,-5,6,11
41,TEL,P005145,P009783,6.9,-8,6,14
41,TEL,P005145,P011193,4.15,-1,13,14
41,TEL,P005145,P011199,8.933,-7,15,22
41,TEL,P005145,P011214,1.367,1,4,3
41,TEL,P005145,P012744,3.4,2,13,11
41,TEL,P007990,P009622,8.683,-6,8,14
41,TEL,P007990,P009783,8.483,-9,8,17
41,TEL,P007990,P011193,10.2,-2,28,30
41,TEL,P007990,P011199,13.949,-8,26,34
41,TEL,P007990,P011214,5.017,-2,10,12
41,TEL,P007990,P011219,7.083,-3,15,18
41,TEL,P007990,P011971,3.733,-5,6,11
41,TEL,P007990,P012744,8.333,3,24,21
41,TEL,P009622,P009783,18.9,-26,25,51
41,TEL,P009622,P011193,7.517,-7,15,22
41,TEL,P009622,P011199,17.2,-7,28,35
41,TEL,P009622,P011214,8.667,-20,6,26
41,TEL,P009622,P011219,8.3,-15,10,25
41,TEL,P009622,P011433,4.9,4,13,9
41,TEL,P009622,P011971,8.283,4,24,20
41,TEL,P009622,P012744,6.183,-14,4,18
41,TEL,P009783,P011193,8.267,-10,15,25
41,TEL,P009783,P011199,13.633,-13,18,31
41,TEL,P009783,P011214,7.784,-20,6,26
41,TEL,P009783,P011219,6.017,-16,7,23
41,TEL,P009783,P011971,3.383,0,11,11
41,TEL,P009783,P012744,5.233,-14,4,18
41,TEL,P011193,P011199,10.333,-4,28,32
41,TEL,P011193,P011214,9.151,-9,14,23
41,TEL,P011193,P011219,11.934,-5,30,35
41,TEL,P011193,P011971,10.55,-4,27,31
41,TEL,P011193,P012744,9.317,3,32,29
41,TEL,P011199,P011214,3.167,-5,3,8
41,TEL,P011199,P011219,3.433,0,9,9
41,TEL,P011199,P011433,3.367,3,10,7
41,TEL,P011199,P011971,5.433,2,17,15
41,TEL,P011199,P012744,6.966,2,20,18
41,TEL,P011214,P011219,8.95,-18,9,27
41,TEL,P011214,P011433,0.883,0,0,0
41,TEL,P011214,P011971,4.533,-3,6,9
41,TEL,P011214,P012744,5.017,-12,6,18
41,TEL,P011219,P011433,2.783,0,6,6
41,TEL,P011219,P011971,11.433,-7,26,33
41,TEL,P011219,P012744,11.967,-13,24,37
41,TEL,P011433,P011971,6.35,3,16,13
41,TEL,P011433,P012744,1.45,-1,3,4
41,TEL,P011971,P012744,4.967,-2,13,15
42,ASV,P000229,P003274,0.017,0,0,0
42,ASV,P000229,P004194,3.1,3,7,4
42,ASV,P000229,P006568,2.233,1,3,2
42,ASV,P000229,P011225,2.75,4,6,2
42,ASV,P000229,P011386,1.283,0,2,2
42,ASV,P000229,P012729,2.767,4,6,2
42,ASV,P000229,P012732,2.767,4,6,2
42,ASV,P000229,PKIR,1.283,0,2,2
42,ASV,P002100,P003526,0.483,-2,0,2
42,ASV,P002100,P004194,8.183,2,16,14
42,ASV,P002100,P006568,3.967,3,9,6
42,ASV,P002100,P011225,7.783,4,19,15
42,ASV,P002100,P011386,9.65,-10,16,26
42,ASV,P002100,P012729,15.283,-6,31,37
42,ASV,P002100,P012730,7.833,-11,14,25
42,ASV,P002100,PKIR,16.55,-4,35,39
42,ASV,P003274,P006568,3.617,-1,11,12
42,ASV,P003274,P011225,3.6,-1,11,12
42,ASV,P003274,P012729,3.617,-1,11,12
42,ASV,P003274,P012732,3.617,-1,11,12
42,ASV,P003526,P004194,9.45,-8,16,24
42,ASV,P003526,P006568,8.967,-6,16,22
42,ASV,P003526,P011225,9.45,-8,16,24
42,ASV,P003526,P012730,0.483,-2,0,2
42,ASV,P003526,P012732,8.967,-6,16,22
42,ASV,P004194,P006568,14.567,2,32,30
42,ASV,P004194,P011225,21.184,5,47,42
42,ASV,P004194,P011386,3.283,2,6,4
42,ASV,P004194,P012729,10.217,6,24,18
42,ASV,P004194,P012730,2.15,0,4,4
42,ASV,P004194,P012732,15.001,5,35,30
42,ASV,P004194,PKIR,10.733,11,25,14
42,ASV,P006568,P011225,20.467,5,47,42
42,ASV,P006568,P011386,3.933,-2,6,8
42,ASV,P006568,P012729,12.317,2,28,26
42,ASV,P006568,P012732,19.167,0,42,42
42,ASV,P006568,PKIR,8.433,8,18,10
42,ASV,P011225,P012729,17.033,6,41,35
42,ASV,P011225,P012730,1.883,-1,4,5
42,ASV,P011225,P012732,21.267,3,47,44
42,ASV,P011225,PKIR,10.783,11,26,15
42,ASV,P011386,P012729,8.7,-10,14,24
42,ASV,P011386,P012730,5.95,-10,10,20
42,ASV,P011386,PKIR,10.933,-10,18,28
42,ASV,P012729,P012730,5.683,-11,10,21
42,ASV,P012729,P012732,10.467,2,24,22
42,ASV,P012729,PKIR,16.916,-8,31,39
42,ASV,P012730,PKIR,7.35,-9,14,23
42,ASV,P012732,PKIR,3.883,5,7,2
42,VIR,P001133,P001844,22.317,5,52,47
42,VIR,P001133,P003048,13.75,3,34,31
42,VIR,P001133,P004007,9.666,5,20,15
42,VIR,P001133,P006739,11.982,6,27,21
42,VIR,P001133,P008847,17.699,9,41,32
42,VIR,P001133,P009549,26.616,8,64,56
42,VIR,P001133,P010781,7.683,3,15,12
42,VIR,P001133,P011192,0.65,0,0,0
42,VIR,P001133,P012714,2.85,-1,4,5
42,VIR,P001133,PBCN,23.983,6,59,53
42,VIR,P001844,P003048,14.434,-2,34,36
42,VIR,P001844,P003527,0.5,0,0,0
42,VIR,P001844,P004007,4.9,-4,8,12
42,VIR,P001844,P006739,0.183,0,0,0
42,VIR,P001844,P008847,10.4,-3,18,21
42,VIR,P001844,P009549,19.45,4,44,40
42,VIR,P001844,P010781,4.967,-4,8,12
42,VIR,P001844,P011192,1.15,0,0,0
42,VIR,P001844,P012714,0.5,0,0,0
42,VIR,P001844,PBCN,17.867,4,44,40
42,VIR,P003048,P004007,0.917,-5,0,5
42,VIR,P003048,P006739,2.233,2,6,4
42,VIR,P003048,P008847,2.917,-3,6,9
42,VIR,P003048,P009549,15.75,5,40,35
42,VIR,P003048,P010781,2.917,-3,6,9
42,VIR,P003048,P011192,0.65,0,0,0
42,VIR,P003048,PBCN,13.1,3,34,31
42,VIR,P003527,P004007,1.433,-7,0,7
42,VIR,P003527,P006739,2.1,-5,2,7
42,VIR,P003527,P009549,1.167,2,2,0
42,VIR,P003527,P010781,0.483,-2,0,2
42,VIR,P003527,P011192,2.117,-3,2,5
42,VIR,P003527,P012714,2.6,-5,2,7
42,VIR,P004007,P006739,7.482,-3,12,15
42,VIR,P004007,P008847,7.916,1,16,15
42,VIR,P004007,P009549,2.166,2,5,3
42,VIR,P004007,P010781,9.083,-4,15,19
42,VIR,P004007,P011192,0.95,-5,0,5
42,VIR,P004007,P012714,4.283,-8,4,12
42,VIR,P006739,P008847,10.582,9,29,20
42,VIR,P006739,P009549,10.699,8,28,20
42,VIR,P006739,P010781,6.116,2,13,11
42,VIR,P006739,P011192,1.617,-3,2,5
42,VIR,P006739,P012714,4.95,-6,6,12
42,VIR,P006739,PBCN,6.116,2,15,13
42,VIR,P008847,P009549,15.049,7,36,29
42,VIR,P008847,P010781,7.75,1,17,16
42,VIR,P008847,PBCN,10.883,3,25,22
42,VIR,P009549,P010781,2.0,2,6,4
42,VIR,P009549,P011192,1.817,2,2,0
42,VIR,P009549,P012714,1.167,2,2,0
42,VIR,P009549,PBCN,23.983,6,59,53
42,VIR,P010781,P012714,3.333,-3,4,7
42,VIR,P011192,P012714,2.117,-3,2,5
43,MUN,P001557,P007975,4.633,-9,8,17
43,MUN,P001557,P010391,4.633,-9,8,17
43,MUN,P001557,P011941,4.633,-9,8,17
43,MUN,P001557,P011987,4.633,-9,8,17
43,MUN,P003583,P004508,12.932,0,23,23
43,MUN,P003583,P006245,3.4,-5,2,7
43,MUN,P003583,P006760,15.049,-5,21,26
43,MUN,P003583,P007056,16.115,2,25,23
43,MUN,P003583,P007975,6.332,-3,8,11
43,MUN,P003583,P008985,12.948,4,26,22
43,MUN,P003583,P010391,8.081,-7,12,19
43,MUN,P003583,P011941,1.183,1,3,2
43,MUN,P003583,P011987,3.616,-7,4,11
43,MUN,P004508,P006245,3.4,-5,2,7
43,MUN,P004508,P006760,16.267,5,25,20
43,MUN,P004508,P007056,17.7,8,30,22
43,MUN,P004508,P007975,3.15,2,4,2
43,MUN,P004508,P008985,13.183,6,25,19
43,MUN,P004508,P010391,4.183,5,12,7
43,MUN,P004508,P011941,0.867,0,0,0
43,MUN,P004508,P011987,1.05,-1,3,4
43,MUN,P006245,P006760,3.4,-5,2,7
43,MUN,P006245,P007056,3.4,-5,2,7
43,MUN,P006760,P007056,18.133,-1,25,26
43,MUN,P006760,P007975,12.382,-5,20,25
43,MUN,P006760,P008985,14.983,9,26,17
43,MUN,P006760,P010391,13.582,-2,24,26
43,MUN,P006760,P011941,7.933,4,16,12
43,MUN,P006760,P011987,8.599,-8,13,21
43,MUN,P007056,P007975,7.433,-1,9,10
43,MUN,P007056,P008985,16.549,7,28,21
43,MUN,P007056,P010391,10.249,3,18,15
43,MUN,P007056,P011941,2.967,0,4,4
43,MUN,P007056,P011987,4.45,-1,7,8
43,MUN,P007975,P008985,5.949,2,10,8
43,MUN,P007975,P010391,21.148,-8,38,46
43,MUN,P007975,P011941,14.049,-4,29,33
43,MUN,P007975,P011987,15.716,-14,26,40
43,MUN,P008985,P010391,9.248,3,20,17
43,MUN,P008985,P011941,4.866,4,10,6
43,MUN,P008985,P011987,1.666,-3,3,6
43,MUN,P010391,P011941,15.482,-4,31,35
43,MUN,P010391,P011987,17.382,-17,29,46
43,MUN,P011941,P011987,12.416,-8,23,31
43,ULK,P001932,P004004,18.649,-5,25,30
43,ULK,P001932,P005844,0.433,-2,0,2
43,ULK,P001932,P006661,3.483,1,6,5
43,ULK,P001932,P006961,1.15,-6,0,6
43,ULK,P001932,P008962,19.316,-3,29,32
43,ULK,P001932,P010560,15.349,-5,23,28
43,ULK,P001932,P011157,19.116,-3,29,32
43,ULK,P001932,P011980,0.7,3,4,1
43,ULK,P004004,P005844,9.667,5,21,16
43,ULK,P004004,P006661,13.7,11,29,18
43,ULK,P004004,P006961,1.85,-3,3,6
43,ULK,P004004,P008962,28.833,4,48,44
43,ULK,P004004,P009849,5.967,5,14,9
43,ULK,P004004,P010560,18.199,-6,25,31
43,ULK,P004004,P011157,19.399,-3,27,30
43,ULK,P005844,P006661,19.267,14,45,31
43,ULK,P005844,P006961,8.733,13,25,12
43,ULK,P005844,P008962,11.667,2,23,21
43,ULK,P005844,P009849,16.0,12,38,26
43,ULK,P005844,P010560,5.0,-6,6,12
43,ULK,P005844,P011980,8.033,10,22,12
43,ULK,P006661,P006961,8.733,13,25,12
43,ULK,P006661,P008962,15.9,5,31,26
43,ULK,P006661,P009849,16.0,12,38,26
43,ULK,P006661,P010560,5.95,-7,8,15
43,ULK,P006661,P011157,4.666,1,8,7
43,ULK,P006661,P011980,8.033,10,22,12
43,ULK,P006961,P008962,1.617,-1,3,4
43,ULK,P006961,P009849,8.033,10,22,12
43,ULK,P006961,P010560,0.233,-2,0,2
43,ULK,P006961,P011157,1.15,-6,0,6
43,ULK,P006961,P011980,8.033,10,22,12
43,ULK,P008962,P009849,7.967,2,16,14
43,ULK,P008962,P010560,20.866,-7,31,38
43,ULK,P008962,P011157,20.066,-1,31,32
43,ULK,P008962,P011980,0.7,3,4,1
43,ULK,P009849,P010560,2.0,-3,2,5
43,ULK,P009849,P011980,8.033,10,22,12
43,ULK,P010560,P011157,16.099,-3,25,28
43,ULK,P010560,P011980,0.7,3,4,1
43,ULK,P011157,P011980,0.7,3,4,1
44,BAS,P004603,P004761,14.066,-11,25,36
44,BAS,P004603,P007230,18.516,-15,29,44
44,BAS,P004603,P008850,14.184,-12,28,40
44,BAS,P004603,P009048,20.184,-7,40,47
44,BAS,P004603,P010444,9.616,-3,17,20
44,BAS,P004603,P011064,18.2,-11,37,48
44,BAS,P004603,P011948,21.834,-9,44,53
44,BAS,P004761,P007230,17.85,-7,35,42
44,BAS,P004761,P008850,8.784,-7,17,24
44,BAS,P004761,P009048,12.301,-1,28,29
44,BAS,P004761,P010444,11.266,2,27,25
44,BAS,P004761,P011064,11.832,-5,24,29
44,BAS,P004761,P011948,15.501,-7,32,39
44,BAS,P007230,P008850,18.467,-9,33,42
44,BAS,P007230,P009048,19.951,-8,39,47
44,BAS,P007230,P010444,11.117,5,28,23
44,BAS,P007230,P011064,12.433,-9,21,30
44,BAS,P007230,P011948,19.134,-5,35,40
44,BAS,P008850,P009048,17.518,-11,37,48
44,BAS,P008850,P010444,5.517,-1,11,12
44,BAS,P008850,P011064,9.534,-4,21,25
44,BAS,P008850,P011948,14.668,0,33,33
44,BAS,P009048,P010444,9.034,-4,20,24
44,BAS,P009048,P011064,9.834,-2,24,26
44,BAS,P009048,P011948,23.118,1,52,51
44,BAS,P010444,P011064,13.266,0,25,25
44,BAS,P010444,P011948,9.984,1,20,19
44,BAS,P011064,P011948,12.301,-1,28,29
44,PAN,P001926,P002328,17.718,4,38,34
44,PAN,P001926,P003842,14.567,5,38,33
44,PAN,P001926,P007553,4.784,-1,7,8
44,PAN,P001926,P007866,15.134,-2,37,39
44,PAN,P001926,P007947,9.417,-6,15,21
44,PAN,P001926,P011204,14.201,10,36,26
44,PAN,P001926,P011209,1.267,-2,0,2
44,PAN,P001926,P011221,6.467,-4,11,15
44,PAN,P001926,P011826,6.833,-2,18,20
44,PAN,P001926,P012712,12.884,-2,24,26
44,PAN,P002328,P003842,21.567,16,56,40
44,PAN,P002328,P007553,3.517,1,7,6
44,PAN,P002328,P007866,21.651,13,55,42
44,PAN,P002328,P007947,9.3,-7,17,24
44,PAN,P002328,P011204,22.918,21,59,38
44,PAN,P002328,P011221,5.984,0,11,11
44,PAN,P002328,P011826,12.2,16,34,18
44,PAN,P002328,P012712,9.417,4,19,15
44,PAN,P003842,P007866,25.384,17,71,54
44,PAN,P003842,P007947,3.1,-7,6,13
44,PAN,P003842,P011204,24.284,27,68,41
44,PAN,P003842,P011209,0.217,-1,1,2
44,PAN,P003842,P011826,18.75,19,55,36
44,PAN,P003842,P012712,5.867,0,13,13
44,PAN,P007553,P007866,2.817,-1,5,6
44,PAN,P007553,P007947,1.8,-2,0,2
44,PAN,P007553,P011204,2.984,1,7,6
44,PAN,P007553,P011209,1.267,-2,0,2
44,PAN,P007553,P012712,1.967,0,2,2
44,PAN,P007866,P007947,1.867,-5,4,9
44,PAN,P007866,P011204,26.401,18,69,51
44,PAN,P007866,P011209,0.217,-1,1,2
44,PAN,P007866,P011221,1.117,-4,0,4
44,PAN,P007866,P011826,19.867,15,55,40
44,PAN,P007866,P012712,2.817,-2,7,9
44,PAN,P007947,P011204,1.15,-3,2,5
44,PAN,P007947,P011209,1.267,-2,0,2
44,PAN,P007947,P011221,5.667,0,11,11
44,PAN,P007947,P012712,8.7,-4,13,17
44,PAN,P011204,P011209,0.217,-1,1,2
44,PAN,P011204,P011221,1.117,-4,0,4
44,PAN,P011204,P011826,17.667,19,50,31
44,PAN,P011204,P012712,2.601,8,8,0
44,PAN,P011209,P011826,0.217,-1,1,2
44,PAN,P011209,P012712,1.267,-2,0,2
44,PAN,P011221,P011826,1.117,-4,0,4
44,PAN,P011221,P012712,5.667,0,11,11
44,PAN,P011826,P012712,2.817,-2,7,9
45,PAM,P000556,P003960,12.733,-1,22,23
45,PAM,P000556,P004863,3.633,0,8,8
45,PAM,P000556,P006643,0.283,1,3,2
45,PAM,P000556,P007870,17.85,4,33,29
45,PAM,P000556,P010393,3.367,5,7,2
45,PAM,P000556,P010568,15.067,3,27,24
45,PAM,P000556,P011970,0.784,0,0,0
45,PAM,P000556,P011982,0.067,0,0,0
45,PAM,P000556,P012738,1.817,0,4,4
45,PAM,P000556,P012740,16.067,4,28,24
45,PAM,P003960,P004863,5.832,-7,7,14
45,PAM,P003960,P006643,0.8,0,2,2
45,PAM,P003960,P007870,16.082,-7,26,33
45,PAM,P003960,P010568,12.949,-1,23,24
45,PAM,P003960,P011970,1.35,-6,0,6
45,PAM,P003960,P011982,1.966,-8,0,8
45,PAM,P003960,P012740,12.616,2,24,22
45,PAM,P004863,P006643,2.316,-4,3,7
45,PAM,P004863,P007870,6.115,-6,10,16
45,PAM,P004863,P010393,2.033,-5,0,5
45,PAM,P004863,P010568,2.699,-1,4,5
45,PAM,P004863,P011970,12.75,18,38,20
45,PAM,P004863,P011982,13.899,14,38,24
45,PAM,P004863,P012738,11.683,25,41,16
45,PAM,P004863,P012739,13.366,19,38,19
45,PAM,P004863,P012740,3.866,-1,5,6
45,PAM,P006643,P007870,3.133,0,11,11
45,PAM,P006643,P010393,4.799,-4,8,12
45,PAM,P006643,P010568,3.566,1,10,9
45,PAM,P006643,P011982,0.866,-2,0,2
45,PAM,P006643,P012738,0.283,1,3,2
45,PAM,P006643,P012739,2.749,-3,2,5
45,PAM,P006643,P012740,4.733,-2,10,12
45,PAM,P007870,P010393,5.417,4,13,9
45,PAM,P007870,P010568,19.833,2,37,35
45,PAM,P007870,P011970,1.35,-6,0,6
45,PAM,P007870,P011982,1.966,-8,0,8
45,PAM,P007870,P012738,1.75,0,4,4
45,PAM,P007870,P012740,19.5,5,38,33
45,PAM,P010393,P010568,6.133,6,15,9
45,PAM,P010393,P011982,0.866,-2,0,2
45,PAM,P010393,P012739,2.749,-3,2,5
45,PAM,P010393,P012740,7.3,3,15,12
45,PAM,P010568,P011970,1.133,-2,0,2
45,PAM,P010568,P011982,4.266,-5,4,9
45,PAM,P010568,P012738,4.067,-4,5,9
45,PAM,P010568,P012739,3.316,-1,6,7
45,PAM,P010568,P012740,19.567,6,41,35
45,PAM,P011970,P011982,13.166,16,38,22
45,PAM,P011970,P012738,12.533,22,38,16
45,PAM,P011970,P012739,12.466,22,38,16
45,PAM,P011982,P012738,14.0,21,42,21
45,PAM,P011982,P012739,14.799,19,42,23
45,PAM,P011982,P012740,1.467,-1,4,5
45,PAM,P012738,P012739,13.933,21,42,21
45,PAM,P012738,P012740,2.934,-2,5,7
45,PAM,P012739,P012740,3.35,-2,6,8
45,ZAL,P002329,P002676,7.818,-10,9,19
45,ZAL,P002329,P003210,4.25,-10,5,15
45,ZAL,P002329,P003211,7.884,1,15,14
45,ZAL,P002329,P005504,2.117,-3,3,6
45,ZAL,P002329,P007109,17.8,-12,27,39
45,ZAL,P002329,P007513,6.75,-3,12,15
45,ZAL,P002329,P010390,16.767,-9,29,38
45,ZAL,P002329,P011218,16.417,-4,27,31
45,ZAL,P002329,P011965,4.967,-10,5,15
45,ZAL,P002329,P012715,4.234,-8,4,12
45,ZAL,P002676,P003210,7.549,0,16,16
45,ZAL,P002676,P003211,12.933,-2,28,30
45,ZAL,P002676,P005504,9.949,-7,16,23
45,ZAL,P002676,P007109,11.966,-2,24,26
45,ZAL,P002676,P007513,1.4,-2,1,3
45,ZAL,P002676,P010390,4.233,4,12,8
45,ZAL,P002676,P011218,14.533,-3,24,27
45,ZAL,P002676,P011965,7.483,-7,15,22
45,ZAL,P002676,P012715,18.4,-15,31,46
45,ZAL,P003210,P003211,1.183,2,3,1
45,ZAL,P003210,P005504,8.516,1,17,16
45,ZAL,P003210,P007109,2.666,-5,4,9
45,ZAL,P003210,P007513,1.5,3,3,0
45,ZAL,P003210,P010184,1.5,3,3,0
45,ZAL,P003210,P010390,2.666,-5,4,9
45,ZAL,P003210,P011218,1.516,2,4,2
45,ZAL,P003210,P011965,6.983,-11,11,22
45,ZAL,P003210,P012715,6.399,4,14,10
45,ZAL,P003211,P005504,4.116,-3,5,8
45,ZAL,P003211,P007109,12.216,6,30,24
45,ZAL,P003211,P010390,9.25,5,21,16
45,ZAL,P003211,P011218,13.083,5,28,23
45,ZAL,P003211,P011965,3.35,-3,6,9
45,ZAL,P003211,P012715,9.917,-7,20,27
45,ZAL,P005504,P007109,0.183,0,0,0
45,ZAL,P005504,P007513,1.5,3,3,0
45,ZAL,P005504,P010184,1.5,3,3,0
45,ZAL,P005504,P011218,2.316,2,4,2
45,ZAL,P005504,P011965,6.45,-11,9,20
45,ZAL,P005504,P012715,9.149,-1,16,17
45,ZAL,P007109,P007513,8.15,-5,13,18
45,ZAL,P007109,P010390,16.332,-1,33,34
45,ZAL,P007109,P011218,22.516,-6,41,47
45,ZAL,P007109,P011965,3.883,-3,8,11
45,ZAL,P007109,P012715,9.884,-8,16,24
45,ZAL,P007513,P010184,1.5,3,3,0
45,ZAL,P007513,P010390,6.75,-3,12,15
45,ZAL,P007513,P011218,8.15,-5,13,18
45,ZAL,P007513,P012715,2.9,1,4,3
45,ZAL,P010184,P012715,1.5,3,3,0
45,ZAL,P010390,P011218,13.916,3,27,24
45,ZAL,P010390,P011965,3.883,-3,8,11
45,ZAL,P010390,P012715,0.867,-3,2,5
45,ZAL,P011218,P012715,12.017,-6,20,26
45,ZAL,P011965,P012715,4.333,-8,6,14
46,MCO,P002581,P004790,4.316,5,10,5
46,MCO,P002581,P005985,3.416,2,7,5
46,MCO,P002581,P008099,2.917,-1,5,6
46,MCO,P002581,P009754,1.533,4,7,3
46,MCO,P002581,P011212,4.55,-3,5,8
46,MCO,P002581,P011226,5.833,1,12,11
46,MCO,P002581,P011231,1.767,-4,2,6
46,MCO,P004790,P005985,3.166,2,7,5
46,MCO,P004790,P008099,1.15,3,3,0
46,MCO,P004790,P009754,1.533,4,7,3
46,MCO,P004790,P011212,2.783,1,3,2
46,MCO,P004790,P011226,4.316,5,10,5
46,MCO,P005985,P008099,2.4,5,5,0
46,MCO,P005985,P009754,13.483,7,31,24
46,MCO,P005985,P010588,17.783,-5,30,35
46,MCO,P005985,P011196,11.267,9,26,17
46,MCO,P005985,P011212,20.833,-2,35,37
46,MCO,P005985,P011226,21.866,7,44,37
46,MCO,P005985,P011231,15.95,-3,23,26
46,MCO,P005985,PLCZ,15.1,-14,16,30
46,MCO,P008099,P011196,2.15,5,5,0
46,MCO,P008099,P011212,5.067,4,10,6
46,MCO,P008099,P011226,2.667,-1,5,6
46,MCO,P008099,P011231,3.917,1,7,6
46,MCO,P009754,P010588,10.9,1,20,19
46,MCO,P009754,P011196,8.25,0,20,20
46,MCO,P009754,P011212,9.017,8,21,13
46,MCO,P009754,P011226,15.25,14,35,21
46,MCO,P009754,P011231,8.667,5,15,10
46,MCO,P009754,PLCZ,9.367,5,12,7
46,MCO,P010588,P011196,4.35,-1,11,12
46,MCO,P010588,P011212,14.417,-5,28,33
46,MCO,P010588,P011226,13.0,4,27,23
46,MCO,P010588,P011231,5.583,-8,4,12
46,MCO,P010588,PLCZ,14.167,-10,16,26
46,MCO,P011196,P011212,10.233,7,23,16
46,MCO,P011196,P011226,8.75,3,19,16
46,MCO,P011196,P011231,9.2,9,20,11
46,MCO,P011212,P011226,21.667,5,39,34
46,MCO,P011212,P011231,16.3,0,24,24
46,MCO,P011212,PLCZ,13.201,-7,16,23
46,MCO,P011226,P011231,14.417,4,27,23
46,MCO,P011226,PLCZ,14.434,2,22,20
46,MCO,P011231,PLCZ,9.067,-8,6,14
46,MIL,P000796,P001518,3.4,2,6,4
46,MIL,P000796,P002812,4.749,-5,5,10
46,MIL,P000796,P002849,17.333,4,32,28
46,MIL,P000796,P005670,4.667,0,6,6
46,MIL,P000796,P006509,18.85,0,31,31
46,MIL,P000796,P007032,22.749,2,39,37
46,MIL,P000796,P007831,24.299,2,41,39
46,MIL,P000796,P009960,8.034,6,13,7
46,MIL,P000796,P011205,11.783,-3,15,18
46,MIL,P001518,P002812,1.533,-2,0,2
46,MIL,P001518,P005670,3.4,2,6,4
46,MIL,P001518,P009960,1.867,4,6,2
46,MIL,P001518,P011205,3.4,2,6,4
46,MIL,P002812,P005670,1.533,-2,0,2
46,MIL,P002812,P006509,1.816,-2,4,6
46,MIL,P002812,P007032,3.399,-4,5,9
46,MIL,P002812,P007831,3.399,-4,5,9
46,MIL,P002812,P009960,0.183,-1,0,1
46,MIL,P002812,P011205,3.116,-4,1,5
46,MIL,P002849,P006509,16.0,2,27,25
46,MIL,P002849,P007032,15.783,4,30,26
46,MIL,P002849,P007831,18.133,1,32,31
46,MIL,P002849,P009960,1.95,0,3,3
46,MIL,P002849,P011205,3.333,-7,4,11
46,MIL,P005670,P006509,7.567,-5,12,17
46,MIL,P005670,P007201,6.3,-3,12,15
46,MIL,P005670,P007831,1.533,-2,3,5
46,MIL,P005670,P009960,9.434,-1,18,19
46,MIL,P005670,P011205,9.434,-1,15,16
46,MIL,P006509,P007032,16.833,1,31,30
46,MIL,P006509,P007201,10.05,-4,19,23
46,MIL,P006509,P007831,23.849,-5,41,46
46,MIL,P006509,P009960,13.05,-12,19,31
46,MIL,P006509,P011205,11.517,-7,16,23
46,MIL,P007032,P007201,0.617,0,2,2
46,MIL,P007032,P007831,23.549,1,41,40
46,MIL,P007032,P009960,5.7,3,9,6
46,MIL,P007032,P011205,5.566,-3,7,10
46,MIL,P007201,P007831,5.283,-3,10,13
46,MIL,P007201,P009960,10.05,-4,19,23
46,MIL,P007201,P011205,7.9,-2,14,16
46,MIL,P007831,P009960,11.166,-3,17,20
46,MIL,P007831,P011205,11.049,-7,14,21
46,MIL,P009960,P011205,14.834,0,24,24
47,MUN,P001557,P003583,0.033,2,2,0
47,MUN,P001557,P004508,1.317,-2,0,2
47,MUN,P001557,P005460,1.25,5,5,0
47,MUN,P001557,P006760,2.15,-5,0,5
47,MUN,P001557,P007975,3.4,0,5,5
47,MUN,P001557,P011941,3.367,-2,3,5
47,MUN,P001557,P011987,2.083,2,5,3
47,MUN,P003583,P004508,10.801,-9,17,26
47,MUN,P003583,P005460,3.484,-4,5,9
47,MUN,P003583,P006760,20.916,6,41,35
47,MUN,P003583,P007056,26.399,15,57,42
47,MUN,P003583,P007975,18.9,-1,33,34
47,MUN,P003583,P008985,14.783,11,31,20
47,MUN,P003583,P010391,13.867,-10,23,33
47,MUN,P003583,P011987,20.549,14,43,29
47,MUN,P004508,P005460,2.334,-7,0,7
47,MUN,P004508,P006760,4.884,-10,1,11
47,MUN,P004508,P007056,7.134,1,16,15
47,MUN,P004508,P007975,13.218,-10,17,27
47,MUN,P004508,P008985,0.317,-2,0,2
47,MUN,P004508,P010391,10.801,-9,17,26
47,MUN,P004508,P011941,2.217,-2,0,2
47,MUN,P004508,P011987,0.317,-2,0,2
47,MUN,P005460,P006760,1.851,-4,3,7
47,MUN,P005460,P007975,5.201,0,8,8
47,MUN,P005460,P010391,2.334,-7,0,7
47,MUN,P005460,P011941,1.834,1,3,2
47,MUN,P005460,P011987,2.984,4,8,4
47,MUN,P006760,P007056,20.399,7,39,32
47,MUN,P006760,P007975,11.05,-8,11,19
47,MUN,P006760,P008985,11.433,12,27,15
47,MUN,P006760,P010391,8.1,-15,9,24
47,MUN,P006760,P011941,6.034,-13,2,15
47,MUN,P006760,P011987,20.983,2,39,37
47,MUN,P007056,P007975,14.2,3,27,24
47,MUN,P007056,P008985,15.1,9,31,22
47,MUN,P007056,P010391,11.35,-4,24,28
47,MUN,P007056,P011941,3.267,-6,2,8
47,MUN,P007056,P011987,22.083,3,40,37
47,MUN,P007975,P008985,3.667,-3,4,7
47,MUN,P007975,P010391,11.767,-5,20,25
47,MUN,P007975,P011941,4.884,-4,3,7
47,MUN,P007975,P011987,10.117,0,16,16
47,MUN,P008985,P011987,15.1,9,31,22
47,MUN,P010391,P011941,2.367,-6,2,8
47,MUN,P010391,P011987,4.35,-8,5,13
47,MUN,P011941,P011987,5.034,-8,5,13
47,RED,P002553,P004720,0.417,0,0,0
47,RED,P002553,P005099,14.035,-12,18,30
47,RED,P002553,P006436,18.667,2,33,31
47,RED,P002553,P007960,4.551,-6,4,10
47,RED,P002553,P008966,3.083,4,4,0
47,RED,P002553,P009035,20.818,-17,29,46
47,RED,P002553,P011224,16.55,-14,23,37
47,RED,P002553,P012044,6.95,-2,9,11
47,RED,P002553,PJDR,11.001,5,24,19
47,RED,P004720,P005099,0.417,0,0,0
47,RED,P004720,P006436,0.417,0,0,0
47,RED,P004720,P009035,0.417,0,0,0
47,RED,P005099,P006436,10.218,-3,15,18
47,RED,P005099,P007960,4.701,-4,8,12
47,RED,P005099,P009035,15.602,-16,19,35
47,RED,P005099,P011224,12.601,-17,16,33
47,RED,P005099,P012044,0.584,-2,0,2
47,RED,P005099,PJDR,4.718,2,12,10
47,RED,P006436,P007960,8.983,18,27,9
47,RED,P006436,P008966,8.666,14,20,6
47,RED,P006436,P009035,18.8,1,35,34
47,RED,P006436,P011224,14.283,-5,25,30
47,RED,P006436,P012044,12.816,17,29,12
47,RED,P006436,PJDR,17.55,28,48,20
47,RED,P007960,P008966,10.9,12,23,11
47,RED,P007960,P009035,9.351,-2,19,21
47,RED,P007960,P011224,8.218,-5,13,18
47,RED,P007960,P012044,11.75,13,27,14
47,RED,P007960,P012711,5.634,1,9,8
47,RED,P007960,PJDR,16.984,13,38,25
47,RED,P008966,P011224,1.0,0,0,0
47,RED,P008966,P012044,13.366,16,27,11
47,RED,P008966,P012711,4.517,2,7,5
47,RED,P008966,PJDR,12.8,16,27,11
47,RED,P009035,P011224,20.167,-17,31,48
47,RED,P009035,P012044,4.817,-2,9,11
47,RED,P009035,P012711,1.117,-1,2,3
47,RED,P009035,PJDR,14.051,2,32,30
47,RED,P011224,P012044,2.033,0,2,2
47,RED,P011224,P012711,1.334,-1,2,3
47,RED,P011224,PJDR,9.018,3,24,21
47,RED,P012044,P012711,4.3,2,7,5
47,RED,P012044,PJDR,16.184,14,34,20
47,RED,P012711,PJDR,5.634,1,9,8
48,MAD,P003108,P003733,13.433,7,31,24
48,MAD,P003108,P004887,2.517,2,10,8
48,MAD,P003108,P005791,18.266,11,42,31
48,MAD,P003108,P005928,22.7,12,57,45
48,MAD,P003108,P006540,7.35,6,21,15
48,MAD,P003108,P009005,18.85,15,50,35
48,MAD,P003108,P009213,1.917,-1,5,6
48,MAD,P003108,PBMT,1.917,-1,5,6
48,MAD,P003108,PTGB,3.85,-3,7,10
48,MAD,P003733,P004887,3.75,2,7,5
48,MAD,P003733,P005791,13.433,7,31,24
48,MAD,P003733,P005928,13.433,7,31,24
48,MAD,P003733,P009005,13.433,7,31,24
48,MAD,P003733,P009213,3.75,2,7,5
48,MAD,P003733,P011649,3.75,2,7,5
48,MAD,P003733,PCVM,3.75,2,7,5
48,MAD,P004887,P005928,4.55,4,16,12
48,MAD,P004887,P006540,12.15,15,38,23
48,MAD,P004887,P009005,6.033,5,20,15
48,MAD,P004887,P009213,9.867,12,25,13
48,MAD,P004887,P011649,3.75,2,7,5
48,MAD,P004887,PBMT,9.633,13,28,15
48,MAD,P004887,PCVM,11.35,13,29,16
48,MAD,P005791,P005928,19.566,14,46,32
48,MAD,P005791,P006540,7.033,7,15,8
48,MAD,P005791,P009005,18.533,16,44,28
48,MAD,P005791,PBMT,2.2,3,4,1
48,MAD,P005791,PCVM,0.9,0,0,0
48,MAD,P005791,PTGB,1.933,-2,2,4
48,MAD,P005928,P006540,10.683,11,31,20
48,MAD,P005928,P009005,22.183,20,60,40
48,MAD,P005928,P009213,1.917,-1,5,6
48,MAD,P005928,PBMT,5.25,4,15,11
48,MAD,P005928,PTGB,3.85,-3,7,10
48,MAD,P006540,P009005,12.85,13,36,23
48,MAD,P006540,P009213,7.834,9,21,12
48,MAD,P006540,PBMT,13.55,15,35,20
48,MAD,P006540,PCVM,10.217,10,25,15
48,MAD,P006540,PTGB,1.933,-2,2,4
48,MAD,P009005,P009213,1.717,-1,3,4
48,MAD,P009005,PBMT,7.433,5,17,12
48,MAD,P009005,PCVM,4.1,0,7,7
48,MAD,P009213,P011649,3.75,2,7,5
48,MAD,P009213,PBMT,9.751,8,26,18
48,MAD,P009213,PCVM,11.584,11,28,17
48,MAD,P009213,PTGB,1.917,-1,5,6
48,MAD,P011649,PCVM,3.75,2,7,5
48,MAD,PBMT,PCVM,10.217,10,25,15
48,MAD,PBMT,PTGB,1.917,-1,5,6
48,TEL,P004233,P005145,3.75,-2,5,7
48,TEL,P004233,P009622,3.75,-2,5,7
48,TEL,P004233,P009783,2.2,-9,0,9
48,TEL,P004233,P009863,2.2,-9,0,9
48,TEL,P004233,P011199,2.2,-9,0,9
48,TEL,P004233,P011219,3.75,-2,5,7
48,TEL,P004233,P011433,2.617,-1,4,5
48,TEL,P004233,P011971,2.2,-9,0,9
48,TEL,P004233,P012744,1.133,-1,1,2
48,TEL,P005145,P009622,9.65,-8,17,25
48,TEL,P005145,P009783,5.9,-6,12,18
48,TEL,P005145,P009863,5.9,-6,12,18
48,TEL,P005145,P011199,5.9,-6,12,18
48,TEL,P005145,P011219,3.75,-2,5,7
48,TEL,P005145,P011433,2.617,-1,4,5
48,TEL,P005145,P012744,1.133,-1,1,2
48,TEL,P009622,P009783,21.45,-6,41,47
48,TEL,P009622,P009863,20.083,-6,34,40
48,TEL,P009622,P011193,9.349,2,22,20
48,TEL,P009622,P011199,21.466,-2,39,41
48,TEL,P009622,P011214,12.1,-1,26,27
48,TEL,P009622,P011219,5.067,-4,8,12
48,TEL,P009622,P011433,2.617,-1,4,5
48,TEL,P009622,P011971,14.066,7,36,29
48,TEL,P009622,P012744,14.666,-7,24,31
48,TEL,P009783,P009863,20.717,-15,34,49
48,TEL,P009783,P011193,0.983,1,4,3
48,TEL,P009783,P011199,20.383,-12,35,47
48,TEL,P009783,P011214,6.134,-1,12,13
48,TEL,P009783,P011219,1.317,-2,3,5
48,TEL,P009783,P011971,8.783,-3,18,21
48,TEL,P009783,P012744,6.733,-7,5,12
48,TEL,P009863,P011193,5.799,-13,6,19
48,TEL,P009863,P011199,20.966,-13,31,44
48,TEL,P009863,P011214,9.3,-13,15,28
48,TEL,P009863,P011219,3.517,-8,7,15
48,TEL,P009863,P011971,8.566,-10,13,23
48,TEL,P009863,P012744,9.016,-19,8,27
48,TEL,P011193,P011199,4.266,2,8,6
48,TEL,P011193,P011214,10.199,-13,20,33
48,TEL,P011193,P011219,2.2,-6,4,10
48,TEL,P011193,P011971,10.499,-5,24,29
48,TEL,P011193,P012744,11.033,-12,24,36
48,TEL,P011199,P011214,3.75,2,6,4
48,TEL,P011199,P011971,9.233,-1,19,20
48,TEL,P011199,P012744,6.5,-5,6,11
48,TEL,P011214,P011219,3.517,-8,7,15
48,TEL,P011214,P011971,9.066,-8,19,27
48,TEL,P011214,P012744,11.266,-14,23,37
48,TEL,P011219,P011433,2.617,-1,4,5
48,TEL,P011219,P012744,3.333,-7,5,12
48,TEL,P011971,P012744,10.783,-7,23,30
49,ASV,P000229,P002100,3.033,0,9,9
49,ASV,P000229,P004194,1.084,-2,0,2
49,ASV,P000229,P006568,3.35,0,9,9
49,ASV,P000229,P011225,3.267,2,9,7
49,ASV,P000229,P012080,0.85,-4,0,4
49,ASV,P000229,P012729,3.8,-2,9,11
49,ASV,P000229,P012731,1.084,-2,0,2
49,ASV,P002100,P003526,2.75,-3,6,9
49,ASV,P002100,P004194,16.6,5,42,37
49,ASV,P002100,P006568,11.849,-1,31,32
49,ASV,P002100,P011225,9.716,1,27,26
49,ASV,P002100,P012080,16.433,8,43,35
49,ASV,P002100,P012729,16.283,14,47,33
49,ASV,P002100,P012732,1.0,0,2,2
49,ASV,P002100,PKIR,11.8,12,33,21
49,ASV,P003526,P004194,9.9,-12,18,30
49,ASV,P003526,P006568,9.9,-12,18,30
49,ASV,P003526,P011225,9.9,-12,18,30
49,ASV,P003526,P012080,2.433,-1,4,5
49,ASV,P003526,P012732,4.717,-8,8,16
49,ASV,P004194,P006568,13.55,-14,25,39
49,ASV,P004194,P011225,18.05,-16,36,52
49,ASV,P004194,P012080,22.4,14,51,37
49,ASV,P004194,P012729,20.684,13,48,35
49,ASV,P004194,P012731,3.367,-4,6,10
49,ASV,P004194,P012732,15.117,-3,29,32
49,ASV,P004194,PKIR,16.184,15,37,22
49,ASV,P006568,P011225,15.733,-10,34,44
49,ASV,P006568,P012080,9.349,-3,20,23
49,ASV,P006568,P012729,5.766,4,18,14
49,ASV,P006568,P012731,0.317,0,0,0
49,ASV,P006568,P012732,4.717,-8,8,16
49,ASV,P006568,PKIR,2.733,4,9,5
49,ASV,P011225,P012080,7.216,-1,16,17
49,ASV,P011225,P012729,6.683,2,20,18
49,ASV,P011225,P012731,3.367,-4,6,10
49,ASV,P011225,P012732,7.0,-10,14,24
49,ASV,P012080,P012729,20.217,17,49,32
49,ASV,P012080,P012732,7.117,7,13,6
49,ASV,P012080,PKIR,17.917,19,44,25
49,ASV,P012729,P012731,3.05,-4,6,10
49,ASV,P012729,P012732,10.4,5,21,16
49,ASV,P012729,PKIR,18.917,19,46,27
49,ASV,P012731,P012732,2.283,-2,6,8
49,ASV,P012732,PKIR,8.117,7,15,8
49,ZAL,P002329,P002676,8.833,-9,8,17
49,ZAL,P002329,P003210,11.8,13,36,23
49,ZAL,P002329,P003211,12.716,-2,19,21
49,ZAL,P002329,P005504,4.933,-6,7,13
49,ZAL,P002329,P007109,14.35,4,36,32
49,ZAL,P002329,P007513,2.883,-3,3,6
49,ZAL,P002329,P010390,18.633,14,45,31
49,ZAL,P002329,P011218,21.9,-4,43,47
49,ZAL,P002329,P011965,4.933,-6,7,13
49,ZAL,P002329,P012715,7.483,-5,12,17
49,ZAL,P002676,P003210,2.8,5,7,2
49,ZAL,P002676,P003211,15.75,-4,30,34
49,ZAL,P002676,P005504,8.25,1,22,21
49,ZAL,P002676,P007109,7.517,-6,9,15
49,ZAL,P002676,P007513,2.5,-6,0,6
49,ZAL,P002676,P010390,5.283,0,6,6
49,ZAL,P002676,P011218,12.35,-14,12,26
49,ZAL,P002676,P011965,3.1,-1,11,12
49,ZAL,P002676,P012715,6.617,-6,15,21
49,ZAL,P003210,P003211,4.817,8,16,8
49,ZAL,P003210,P005504,3.367,4,10,6
49,ZAL,P003210,P007109,12.167,17,38,21
49,ZAL,P003210,P010390,11.8,13,36,23
49,ZAL,P003210,P011218,10.917,8,33,25
49,ZAL,P003210,P012715,3.0,0,8,8
49,ZAL,P003211,P005504,12.583,-1,30,31
49,ZAL,P003211,P007109,10.083,1,23,22
49,ZAL,P003211,P007513,2.9,0,9,9
49,ZAL,P003211,P010390,9.633,4,21,17
49,ZAL,P003211,P011218,13.317,-9,24,33
49,ZAL,P003211,P011965,6.866,-2,16,18
49,ZAL,P003211,P012715,9.067,-3,24,27
49,ZAL,P005504,P007109,4.233,6,10,4
49,ZAL,P005504,P011218,4.084,-9,9,18
49,ZAL,P005504,P011965,8.033,-7,18,25
49,ZAL,P005504,P012715,9.517,-12,22,34
49,ZAL,P007109,P007513,4.683,-10,5,15
49,ZAL,P007109,P010390,11.55,8,36,28
49,ZAL,P007109,P011218,14.817,-7,32,39
49,ZAL,P007109,P011965,1.433,1,3,2
49,ZAL,P007109,P012715,1.167,-2,0,2
49,ZAL,P007513,P010390,4.45,1,12,11
49,ZAL,P007513,P011218,6.95,-5,12,17
49,ZAL,P007513,P012715,3.434,3,7,4
49,ZAL,P010390,P011218,20.083,10,48,38
49,ZAL,P010390,P012715,4.7,6,12,6
49,ZAL,P011218,P011965,1.167,-5,2,7
49,ZAL,P011218,P012715,9.951,-5,21,26
49,ZAL,P011965,P012715,6.6,-8,15,23
50,OLY,P001255,P003941,14.6,-8,27,35
50,OLY,P001255,P007982,18.866,-9,31,40
50,OLY,P001255,P008811,20.466,1,39,38
50,OLY,P001255,P008829,27.033,0,57,57
50,OLY,P001255,P008855,19.116,-2,40,42
50,OLY,P001255,P010392,3.667,-2,5,7
50,OLY,P001255,P010612,28.816,-3,56,59
50,OLY,P001255,P011983,7.7,-5,9,14
50,OLY,P003941,P007982,18.033,-3,33,36
50,OLY,P003941,P008829,15.533,1,33,32
50,OLY,P003941,P008855,8.432,1,21,20
50,OLY,P003941,P010392,4.584,-2,5,7
50,OLY,P003941,P010612,9.133,-3,19,22
50,OLY,P003941,P011983,7.817,2,14,12
50,OLY,P007982,P008811,5.766,-1,9,10
50,OLY,P007982,P008829,15.766,3,33,30
50,OLY,P007982,P008855,6.932,1,16,15
50,OLY,P007982,P010392,4.584,-2,5,7
50,OLY,P007982,P010612,13.399,-4,23,27
50,OLY,P007982,P011983,11.85,-1,18,19
50,OLY,P008811,P008829,16.433,4,35,31
50,OLY,P008811,P008855,14.7,2,30,28
50,OLY,P008811,P010612,20.466,1,39,38
50,OLY,P008811,P011983,4.033,-3,4,7
50,OLY,P008829,P008855,22.799,5,51,46
50,OLY,P008829,P010392,0.917,0,0,0
50,OLY,P008829,P010612,25.233,3,54,51
50,OLY,P008829,P011983,4.15,4,9,5
50,OLY,P008855,P010612,17.316,1,37,36
50,OLY,P008855,P011983,3.233,4,9,5
50,OLY,P010392,P011983,4.584,-2,5,7
50,OLY,P010612,P011983,4.033,-3,4,7
50,ULK,P001932,P004004,15.316,7,34,27
50,ULK,P001932,P005844,19.85,2,38,36
50,ULK,P001932,P006661,4.75,-6,5,11
50,ULK,P001932,P008962,19.85,2,38,36
50,ULK,P001932,P009849,4.534,-5,4,9
50,ULK,P001932,P010560,8.333,14,27,13
50,ULK,P001932,P011052,0.283,0,0,0
50,ULK,P001932,P011980,6.484,-6,6,12
50,ULK,P004004,P005844,17.433,9,39,30
50,ULK,P004004,P006661,6.467,-2,13,15
50,ULK,P004004,P008962,20.5,7,44,37
50,ULK,P004004,P009849,3.067,-2,5,7
50,ULK,P004004,P010560,8.333,14,27,13
50,ULK,P004004,P011052,2.4,2,5,3
50,ULK,P004004,P011157,3.067,-2,5,7
50,ULK,P004004,P011980,5.417,-5,4,9
50,ULK,P005844,P006661,9.25,-7,15,22
50,ULK,P005844,P008962,24.35,1,48,47
50,ULK,P005844,P009849,6.917,-8,9,17
50,ULK,P005844,P010560,8.333,14,27,13
50,ULK,P005844,P011052,4.783,-1,10,11
50,ULK,P005844,P011980,6.484,-6,6,12
50,ULK,P006661,P008962,24.9,-6,46,52
50,ULK,P006661,P009849,21.5,-6,38,44
50,ULK,P006661,P011052,12.333,2,29,27
50,ULK,P006661,P011157,15.65,1,31,30
50,ULK,P006661,P011980,4.75,0,7,7
50,ULK,P008962,P009849,22.567,-7,40,47
50,ULK,P008962,P010560,8.333,14,27,13
50,ULK,P008962,P011052,12.616,2,29,27
50,ULK,P008962,P011157,15.65,1,31,30
50,ULK,P008962,P011980,11.234,-6,13,19
50,ULK,P009849,P011052,10.216,0,24,24
50,ULK,P009849,P011157,15.65,1,31,30
50,ULK,P009849,P011980,5.817,-1,9,10
50,ULK,P011052,P011157,7.833,3,19,16
50,ULK,P011157,P011980,4.75,0,7,7
51,BAR,P000925,P002939,14.45,21,34,13
51,BAR,P000925,P003204,2.533,2,8,6
51,BAR,P000925,P003478,9.133,6,19,13
51,BAR,P000925,P004866,12.883,19,32,13
51,BAR,P000925,P007464,4.1,4,10,6
51,BAR,P000925,P009992,7.85,17,23,6
51,BAR,P000925,P011244,5.25,6,13,7
51,BAR,P000925,P012745,11.733,17,29,12
51,BAR,P002939,P003196,4.017,-2,9,11
51,BAR,P002939,P003204,0.883,-1,2,3
51,BAR,P002939,P003478,6.6,4,11,7
51,BAR,P002939,P004866,16.9,17,41,24
51,BAR,P002939,P007464,2.45,1,4,3
51,BAR,P002939,P009992,11.867,15,32,17
51,BAR,P002939,P010641,0.883,-1,2,3
51,BAR,P002939,P011244,6.517,4,15,11
51,BAR,P002939,P012745,12.833,14,30,16
51,BAR,P003196,P003204,11.583,2,22,20
51,BAR,P003196,P003478,4.916,0,8,8
51,BAR,P003196,P004866,8.817,-2,20,22
51,BAR,P003196,P007464,6.783,2,11,9
51,BAR,P003196,P009992,10.767,-1,23,24
51,BAR,P003196,P011244,5.417,-1,9,10
51,BAR,P003196,P012745,10.1,2,22,20
51,BAR,P003204,P003478,7.449,2,16,14
51,BAR,P003204,P004866,7.634,-3,14,17
51,BAR,P003204,P007464,13.299,-5,21,26
51,BAR,P003204,P009992,11.917,-7,17,24
51,BAR,P003204,P010641,6.817,-12,5,17
51,BAR,P003204,P011244,7.25,-7,7,14
51,BAR,P003204,P011666,0.767,-3,0,3
51,BAR,P003204,P012745,13.6,0,28,28
51,BAR,P003478,P004866,8.883,3,15,12
51,BAR,P003478,P007464,5.166,3,12,9
51,BAR,P003478,P009992,0.083,-1,0,1
51,BAR,P003478,P011244,2.95,1,6,5
51,BAR,P003478,P012745,11.016,6,21,15
51,BAR,P004866,P009992,15.484,11,42,31
51,BAR,P004866,P010641,3.434,-6,5,11
51,BAR,P004866,P011244,6.517,4,15,11
51,BAR,P004866,P011666,1.367,-6,2,8
51,BAR,P004866,P012745,18.617,7,42,35
51,BAR,P007464,P009992,8.9,-6,9,15
51,BAR,P007464,P010641,3.983,-9,2,11
51,BAR,P007464,P011244,7.25,-7,7,14
51,BAR,P007464,P012745,7.533,5,16,11
51,BAR,P009992,P010641,5.767,-11,5,16
51,BAR,P009992,P011244,10.817,-4,16,20
51,BAR,P009992,P011666,0.6,-3,2,5
51,BAR,P009992,P012745,13.484,10,35,25
51,BAR,P010641,P011244,3.1,-8,0,8
51,BAR,P010641,P011666,1.367,-6,2,8
51,BAR,P010641,P012745,4.317,-7,7,14
51,BAR,P011666,P012745,1.367,-6,2,8
51,PAN,P002328,P003842,13.45,-7,21,28
51,PAN,P002328,P006544,2.233,-1,3,4
51,PAN,P002328,P007553,7.117,-5,14,19
51,PAN,P002328,P007866,16.45,-16,20,36
51,PAN,P002328,P008084,1.867,-4,4,8
51,PAN,P002328,P011204,21.834,-19,32,51
51,PAN,P002328,P011209,14.884,-16,25,41
51,PAN,P002328,P011826,7.483,-5,8,13
51,PAN,P002328,P012712,12.95,-7,21,28
51,PAN,P003842,P006544,0.5,1,1,0
51,PAN,P003842,P007866,17.883,-12,28,40
51,PAN,P003842,P008084,0.5,0,2,2
51,PAN,P003842,P011204,17.883,-12,28,40
51,PAN,P003842,P011209,6.05,-1,15,16
51,PAN,P003842,P011826,10.633,-11,12,23
51,PAN,P003842,P012712,8.633,-2,17,19
51,PAN,P006544,P007553,8.334,18,25,7
51,PAN,P006544,P007866,8.7,10,19,9
51,PAN,P006544,P008084,8.334,18,25,7
51,PAN,P006544,P011204,3.134,6,11,5
51,PAN,P006544,P011209,2.233,-1,3,4
51,PAN,P006544,P011442,1.367,6,8,2
51,PAN,P006544,P011826,5.2,12,14,2
51,PAN,P006544,P012712,2.233,-1,3,4
51,PAN,P007553,P007866,8.634,10,17,7
51,PAN,P007553,P008084,11.368,12,27,15
51,PAN,P007553,P011204,11.918,-1,25,26
51,PAN,P007553,P011209,4.834,-7,8,15
51,PAN,P007553,P011442,1.367,6,8,2
51,PAN,P007553,P011826,9.15,12,20,8
51,PAN,P007553,P012712,5.75,-1,12,13
51,PAN,P007866,P008084,8.634,10,17,7
51,PAN,P007866,P011204,23.584,-20,31,51
51,PAN,P007866,P011209,9.05,-10,14,24
51,PAN,P007866,P011826,17.5,-1,26,27
51,PAN,P007866,P012712,11.633,-11,16,27
51,PAN,P008084,P011204,6.168,0,13,13
51,PAN,P008084,P011209,1.867,-4,4,8
51,PAN,P008084,P011442,1.367,6,8,2
51,PAN,P008084,P011826,6.867,10,14,4
51,PAN,P008084,P012712,0.5,0,2,2
51,PAN,P011204,P011209,12.151,-15,20,35
51,PAN,P011204,P011442,1.367,6,8,2
51,PAN,P011204,P011826,14.583,-11,18,29
51,PAN,P011204,P012712,15.65,-10,26,36
51,PAN,P011209,P012712,8.467,-10,11,21
51,PAN,P011826,P012712,7.716,-2,16,18
52,BAS,P004603,P004761,17.434,5,35,30
52,BAS,P004603,P007230,17.817,0,37,37
52,BAS,P004603,P008850,7.517,-9,14,23
52,BAS,P004603,P009048,20.201,0,42,42
52,BAS,P004603,P011948,14.651,4,31,27
52,BAS,P004603,P012201,9.567,3,23,20
52,BAS,P004603,P012765,5.817,1,14,13
52,BAS,P004761,P007230,21.533,1,40,39
52,BAS,P004761,P008850,1.7,-5,0,5
52,BAS,P004761,P009048,20.017,7,42,35
52,BAS,P004761,P010444,11.599,-1,21,22
52,BAS,P004761,P011948,14.5,8,31,23
52,BAS,P004761,P012201,19.6,4,41,37
52,BAS,P004761,P012765,14.017,1,30,29
52,BAS,P007230,P008850,11.6,-9,24,33
52,BAS,P007230,P009048,23.3,-3,49,52
52,BAS,P007230,P010444,12.549,-4,23,27
52,BAS,P007230,P011948,20.5,1,47,46
52,BAS,P007230,P012201,11.033,0,21,21
52,BAS,P007230,P012765,7.4,2,15,13
52,BAS,P008850,P009048,11.6,-9,24,33
52,BAS,P008850,P010444,4.083,0,10,10
52,BAS,P008850,P011948,9.9,-4,24,28
52,BAS,P009048,P010444,8.649,2,20,18
52,BAS,P009048,P011948,19.767,5,45,40
52,BAS,P009048,P012201,10.3,6,25,19
52,BAS,P009048,P012765,5.834,4,17,13
52,BAS,P010444,P011948,8.682,-1,20,21
52,BAS,P010444,P012201,9.083,2,16,14
52,BAS,P010444,P012765,8.083,-2,14,16
52,BAS,P011948,P012201,6.75,3,15,12
52,BAS,P011948,P012765,2.85,0,7,7
52,BAS,P012201,P012765,12.067,-2,23,25
52,PAR,P000956,P003983,6.116,-2,11,13
52,PAR,P000956,P004058,14.233,3,29,26
52,PAR,P000956,P007400,15.883,3,36,33
52,PAR,P000956,P008987,14.933,4,34,30
52,PAR,P000956,P009212,3.183,-2,4,6
52,PAR,P000956,P011051,0.867,0,0,0
52,PAR,P000956,P012743,17.249,2,38,36
52,PAR,P003983,P004058,2.75,-3,2,5
52,PAR,P003983,P007400,11.55,-5,20,25
52,PAR,P003983,P007673,15.083,-1,29,30
52,PAR,P003983,P008987,7.766,-9,16,25
52,PAR,P003983,P009212,15.483,2,27,25
52,PAR,P003983,P011051,13.767,1,26,25
52,PAR,P003983,P012742,8.533,1,18,17
52,PAR,P003983,P012743,7.016,-4,11,15
52,PAR,P004058,P007400,17.866,5,43,38
52,PAR,P004058,P007673,5.983,0,16,16
52,PAR,P004058,P008987,14.733,6,35,29
52,PAR,P004058,P009212,6.0,-5,10,15
52,PAR,P004058,P011051,1.601,-4,1,5
52,PAR,P004058,P012742,0.634,-3,0,3
52,PAR,P004058,P012743,19.132,5,44,39
52,PAR,P007400,P007673,12.633,1,27,26
52,PAR,P007400,P008987,19.716,7,48,41
52,PAR,P007400,P009212,9.4,-5,15,20
52,PAR,P007400,P011051,7.734,-3,12,15
52,PAR,P007400,P012742,0.3,0,0,0
52,PAR,P007400,P012743,21.382,5,51,46
52,PAR,P007673,P008987,7.266,-7,17,24
52,PAR,P007673,P009212,15.033,4,31,27
52,PAR,P007673,P011051,13.767,-3,27,30
52,PAR,P007673,P012742,8.433,-2,18,20
52,PAR,P007673,P012743,6.066,4,15,11
52,PAR,P008987,P009212,1.233,-2,3,5
52,PAR,P008987,P011051,3.717,-7,5,12
52,PAR,P008987,P012742,3.083,-10,3,13
52,PAR,P008987,P012743,17.549,6,43,37
52,PAR,P009212,P011051,11.434,4,22,18
52,PAR,P009212,P012742,7.1,6,18,12
52,PAR,P009212,P012743,6.066,-2,10,12
52,PAR,P011051,P012742,7.717,0,15,15
53,BER,P003958,P006251,10.166,0,19,19
53,BER,P003958,P006819,5.117,1,9,8
53,BER,P003958,P006919,25.15,-11,39,50
53,BER,P003958,P008173,21.433,-4,37,41
53,BER,P003958,P008211,9.033,-8,13,21
53,BER,P003958,P008384,3.316,-4,4,8
53,BER,P003958,P008967,11.65,-10,21,31
53,BER,P003958,P010791,7.316,-5,9,14
53,BER,P003958,P012720,26.8,-8,45,53
53,BER,P003958,P012721,1.883,1,4,3
53,BER,P006251,P006919,8.05,-1,12,13
53,BER,P006251,P008173,10.166,0,19,19
53,BER,P006251,P008211,5.55,3,14,11
53,BER,P006251,P008384,6.233,-1,14,15
53,BER,P006251,P008967,7.666,4,21,17
53,BER,P006251,P012720,9.483,4,19,15
53,BER,P006251,P012721,5.55,3,14,11
53,BER,P006819,P006919,5.117,1,9,8
53,BER,P006819,P008173,5.117,1,9,8
53,BER,P006819,P012720,5.117,1,9,8
53,BER,P006919,P008173,18.667,-5,30,35
53,BER,P006919,P008211,6.483,-6,9,15
53,BER,P006919,P008967,8.217,-8,14,22
53,BER,P006919,P010791,5.999,-2,9,11
53,BER,P006919,P012720,22.917,-12,34,46
53,BER,P008173,P008384,1.333,-4,0,4
53,BER,P008173,P008967,4.783,-1,12,13
53,BER,P008173,P010791,2.833,-3,4,7
53,BER,P008173,P012720,20.75,0,37,37
53,BER,P008173,P012721,0.65,0,0,0
53,BER,P008211,P008384,11.516,4,25,21
53,BER,P008211,P008967,16.4,-5,30,35
53,BER,P008211,P010791,8.466,-1,12,13
53,BER,P008211,P012720,6.05,-8,8,16
53,BER,P008211,P012721,10.766,5,25,20
53,BER,P008384,P008967,10.966,-1,21,22
53,BER,P008384,P010791,4.733,0,7,7
53,BER,P008384,P012720,1.883,1,4,3
53,BER,P008384,P012721,11.416,5,25,20
53,BER,P008967,P010791,7.533,-1,12,13
53,BER,P008967,P012720,7.984,-6,16,22
53,BER,P008967,P012721,9.533,4,21,17
53,BER,P010791,P012720,4.333,-5,4,9
53,BER,P010791,P012721,3.983,1,7,6
53,BER,P012720,P012721,1.883,1,4,3
53,PAM,P003960,P004863,6.366,0,12,12
53,PAM,P003960,P006643,6.666,-2,12,14
53,PAM,P003960,P007870,16.233,5,39,34
53,PAM,P003960,P009101,4.633,-2,9,11
53,PAM,P003960,P010393,2.883,-1,5,6
53,PAM,P003960,P010568,13.134,11,28,17
53,PAM,P003960,P011970,15.949,9,35,26
53,PAM,P003960,P011982,13.467,9,28,19
53,PAM,P003960,P012738,1.35,0,0,0
53,PAM,P003960,P012739,1.383,0,0,0
53,PAM,P003960,P012740,4.8,-5,8,13
53,PAM,P004863,P006643,8.933,-1,14,15
53,PAM,P004863,P007870,6.167,6,18,12
53,PAM,P004863,P009101,0.2,0,0,0
53,PAM,P004863,P010393,3.967,-3,6,9
53,PAM,P004863,P010568,0.967,3,3,0
53,PAM,P004863,P011970,9.334,4,21,17
53,PAM,P004863,P011982,3.951,2,9,7
53,PAM,P004863,P012738,6.717,-6,9,15
53,PAM,P004863,P012739,5.533,-2,6,8
53,PAM,P004863,P012740,5.733,-3,10,13
53,PAM,P006643,P007870,4.433,-2,12,14
53,PAM,P006643,P009101,2.083,-3,4,7
53,PAM,P006643,P010393,0.333,-2,0,2
53,PAM,P006643,P010568,3.55,0,5,5
53,PAM,P006643,P011970,5.683,0,12,12
53,PAM,P006643,P012738,7.7,-2,11,13
53,PAM,P006643,P012739,8.433,-2,11,13
53,PAM,P006643,P012740,7.05,-2,11,13
53,PAM,P007870,P009101,1.883,-3,4,7
53,PAM,P007870,P010393,1.85,1,3,2
53,PAM,P007870,P010568,10.534,11,26,15
53,PAM,P007870,P011970,14.917,17,41,24
53,PAM,P007870,P011982,12.251,14,29,15
53,PAM,P007870,P012740,4.8,-5,8,13
53,PAM,P009101,P010393,4.317,2,10,8
53,PAM,P009101,P010568,3.134,4,10,6
53,PAM,P009101,P011970,3.183,-3,6,9
53,PAM,P009101,P011982,4.117,2,10,8
53,PAM,P009101,P012739,1.25,-1,3,4
53,PAM,P010393,P010568,3.134,4,10,6
53,PAM,P010393,P011970,4.934,-1,8,9
53,PAM,P010393,P011982,7.751,1,16,15
53,PAM,P010393,P012738,1.917,-4,3,7
53,PAM,P010393,P012739,1.25,-1,3,4
53,PAM,P010568,P011970,8.334,17,24,7
53,PAM,P010568,P011982,20.085,16,46,30
53,PAM,P010568,P012738,9.967,1,15,14
53,PAM,P010568,P012739,9.867,0,18,18
53,PAM,P010568,P012740,11.834,-3,19,22
53,PAM,P011970,P011982,12.951,14,30,16
53,PAM,P011970,P012738,2.617,-4,3,7
53,PAM,P011970,P012739,1.383,0,0,0
53,PAM,P011970,P012740,1.583,-1,4,5
53,PAM,P011982,P012738,8.334,-3,13,16
53,PAM,P011982,P012739,6.967,0,13,13
53,PAM,P011982,P012740,8.934,-3,14,17
53,PAM,P012738,P012739,12.767,-1,21,22
53,PAM,P012738,P012740,12.767,-1,21,22
53,PAM,P012739,P012740,12.767,-1,21,22
54,IST,P004554,P004888,10.767,-1,22,23
54,IST,P004554,P006590,15.633,0,36,36
54,IST,P004554,P007200,12.016,1,26,25
54,IST,P004554,P009664,10.6,-5,21,26
54,IST,P004554,P009846,9.383,2,20,18
54,IST,P004554,P011078,10.65,-1,23,24
54,IST,P004554,P011981,0.483,0,0,0
54,IST,P004888,P006590,20.551,-9,44,53
54,IST,P004888,P007200,17.484,-11,37,48
54,IST,P004888,P009664,8.567,-8,13,21
54,IST,P004888,P009846,15.251,-2,38,40
54,IST,P004888,P011078,13.951,-6,27,33
54,IST,P004888,P011981,14.501,-11,31,42
54,IST,P006590,P007200,25.983,-7,54,61
54,IST,P006590,P009664,19.55,-6,38,44
54,IST,P006590,P009846,15.367,-2,34,36
54,IST,P006590,P011078,19.367,0,40,40
54,IST,P006590,P011981,18.617,-8,34,42
54,IST,P007200,P009664,19.617,-2,36,38
54,IST,P007200,P009846,15.267,-10,33,43
54,IST,P007200,P011078,17.817,-3,35,38
54,IST,P007200,P011981,20.684,-12,39,51
54,IST,P009664,P009846,4.117,-3,6,9
54,IST,P009664,P011078,16.6,-5,30,35
54,IST,P009664,P011981,12.217,-3,20,23
54,IST,P009846,P011078,9.068,2,21,19
54,IST,P009846,P011981,10.951,-7,24,31
54,IST,P011078,P011981,14.951,-3,28,31
54,VIR,P001133,P003048,20.533,5,48,43
54,VIR,P001133,P003527,0.733,-4,0,4
54,VIR,P001133,P004007,10.167,6,20,14
54,VIR,P001133,P006739,24.95,12,62,50
54,VIR,P001133,P008847,8.35,6,24,18
54,VIR,P001133,P009549,22.617,14,55,41
54,VIR,P001133,P010781,6.233,0,12,12
54,VIR,P001133,P011192,10.533,3,26,23
54,VIR,P001133,P012714,2.3,1,2,1
54,VIR,P001133,PBCN,18.316,5,47,42
54,VIR,P003048,P003527,0.95,-6,0,6
54,VIR,P003048,P004007,6.667,0,12,12
54,VIR,P003048,P006739,18.017,9,44,35
54,VIR,P003048,P009549,14.95,4,33,29
54,VIR,P003048,P010781,2.733,-6,4,10
54,VIR,P003048,P011192,7.767,4,22,18
54,VIR,P003048,PBCN,11.383,2,29,27
54,VIR,P003527,P004007,4.617,-9,4,13
54,VIR,P003527,P006739,0.433,0,0,0
54,VIR,P003527,P008847,4.4,-7,4,11
54,VIR,P003527,P009549,0.433,0,0,0
54,VIR,P003527,P010781,4.917,-13,4,17
54,VIR,P003527,P011192,4.917,-13,4,17
54,VIR,P004007,P006739,6.567,8,16,8
54,VIR,P004007,P008847,8.034,0,18,18
54,VIR,P004007,P009549,12.217,11,27,16
54,VIR,P004007,P010781,10.768,-3,20,23
54,VIR,P004007,P011192,5.484,-5,10,15
54,VIR,P004007,P012714,3.384,3,6,3
54,VIR,P004007,PBCN,0.767,1,3,2
54,VIR,P006739,P008847,10.016,10,29,19
54,VIR,P006739,P009549,19.3,15,50,35
54,VIR,P006739,P010781,0.167,2,2,0
54,VIR,P006739,P011192,12.45,14,37,23
54,VIR,P006739,P012714,1.517,5,7,2
54,VIR,P006739,PBCN,19.383,9,53,44
54,VIR,P008847,P009549,8.767,12,27,15
54,VIR,P008847,P010781,6.768,-4,12,16
54,VIR,P008847,P011192,10.067,-3,19,22
54,VIR,P008847,P012714,2.734,3,7,4
54,VIR,P008847,PBCN,8.0,7,24,17
54,VIR,P009549,P010781,7.051,6,16,10
54,VIR,P009549,P011192,4.017,8,12,4
54,VIR,P009549,P012714,4.901,3,8,5
54,VIR,P009549,PBCN,10.483,3,28,25
54,VIR,P010781,P011192,5.384,-13,4,17
54,VIR,P010781,P012714,3.851,3,6,3
54,VIR,P011192,P012714,1.817,3,5,2
54,VIR,P011192,PBCN,8.9,6,25,19
54,VIR,P012714,PBCN,0.3,3,3,0
55,IST,P004554,P004888,18.25,9,43,34
55,IST,P004554,P006372,4.583,-6,4,10
55,IST,P004554,P006590,7.7,8,19,11
55,IST,P004554,P007200,21.866,3,47,44
55,IST,P004554,P009664,20.5,-4,40,44
55,IST,P004554,P011078,18.433,2,35,33
55,IST,P004888,P006590,24.233,7,45,38
55,IST,P004888,P007200,29.483,2,62,60
55,IST,P004888,P009513,0.567,0,0,0
55,IST,P004888,P009664,35.067,0,65,65
55,IST,P004888,P011078,29.084,21,67,46
55,IST,P004888,P011981,22.167,1,39,38
55,IST,P004888,P012710,2.817,0,7,7
55,IST,P006372,P007200,4.583,-6,4,10
55,IST,P006372,P009664,4.583,-6,4,10
55,IST,P006372,P011078,4.583,-6,4,10
55,IST,P006590,P007200,13.816,-1,25,26
55,IST,P006590,P009664,18.933,-3,28,31
55,IST,P006590,P011078,12.9,18,30,12
55,IST,P006590,P011981,16.533,-1,26,27
55,IST,P006590,P012710,2.817,0,7,7
55,IST,P007200,P009513,0.05,0,0,0
55,IST,P007200,P009664,29.583,-10,53,63
55,IST,P007200,P011078,22.733,7,51,44
55,IST,P007200,P011981,12.2,-7,19,26
55,IST,P007200,P012710,1.95,-4,3,7
55,IST,P009513,P009664,0.517,0,0,0
55,IST,P009513,P011078,0.567,0,0,0
55,IST,P009513,P011981,0.567,0,0,0
55,IST,P009664,P011078,30.267,1,57,56
55,IST,P009664,P011981,19.15,-2,29,31
55,IST,P011078,P011981,15.234,13,36,23
55,IST,P011078,P012710,0.867,4,4,0
55,IST,P011981,P012710,2.817,0,7,7
55,ZAL,P002329,P002676,7.766,-4,18,22
55,ZAL,P002329,P003210,0.933,0,2,2
55,ZAL,P002329,P003211,20.883,4,47,43
55,ZAL,P002329,P005504,4.05,4,10,6
55,ZAL,P002329,P007109,26.1,7,50,43
55,ZAL,P002329,P007513,16.267,2,24,22
55,ZAL,P002329,P010390,24.817,8,52,44
55,ZAL,P002329,P011218,23.834,6,50,44
55,ZAL,P002329,P011965,0.2,-3,0,3
55,ZAL,P002329,P012715,10.15,0,23,23
55,ZAL,P002676,P003210,3.717,-10,0,10
55,ZAL,P002676,P003211,12.582,-3,26,29
55,ZAL,P002676,P005504,6.133,-2,10,12
55,ZAL,P002676,P007109,8.466,-9,9,18
55,ZAL,P002676,P007513,1.7,-2,0,2
55,ZAL,P002676,P010390,9.333,-9,16,25
55,ZAL,P002676,P011218,8.816,-3,16,19
55,ZAL,P002676,P011965,4.75,-13,5,18
55,ZAL,P002676,P012715,10.733,-1,24,25
55,ZAL,P003210,P003211,2.75,-2,2,4
55,ZAL,P003210,P005504,3.033,-4,2,6
55,ZAL,P003210,P007109,1.9,-8,0,8
55,ZAL,P003210,P010390,1.617,-6,0,6
55,ZAL,P003210,P011965,1.95,-8,0,8
55,ZAL,P003210,P012715,2.7,-2,2,4
55,ZAL,P003211,P005504,6.6,-2,10,12
55,ZAL,P003211,P007109,13.666,5,28,23
55,ZAL,P003211,P007513,4.567,-5,2,7
55,ZAL,P003211,P010390,16.5,3,38,35
55,ZAL,P003211,P011218,14.033,8,36,28
55,ZAL,P003211,P011965,1.75,-9,0,9
55,ZAL,P003211,P012715,15.933,1,31,30
55,ZAL,P005504,P007109,1.383,0,2,2
55,ZAL,P005504,P007513,0.967,0,0,0
55,ZAL,P005504,P011218,1.05,2,2,0
55,ZAL,P005504,P011965,2.116,-4,2,6
55,ZAL,P005504,P012715,6.6,-2,10,12
55,ZAL,P007109,P007513,16.55,0,24,24
55,ZAL,P007109,P010390,24.034,5,43,38
55,ZAL,P007109,P011218,23.167,8,43,35
55,ZAL,P007109,P011965,2.95,-6,2,8
55,ZAL,P007109,P012715,4.716,-6,7,13
55,ZAL,P007513,P010390,14.334,3,22,19
55,ZAL,P007513,P011218,13.467,5,22,17
55,ZAL,P007513,P011965,0.517,0,0,0
55,ZAL,P007513,P012715,3.767,-3,2,5
55,ZAL,P010390,P011218,27.084,15,61,46
55,ZAL,P010390,P011965,3.201,-9,3,12
55,ZAL,P010390,P012715,5.884,6,17,11
55,ZAL,P011218,P011965,1.667,4,5,1
55,ZAL,P011218,P012715,6.15,3,17,14
55,ZAL,P011965,P012715,2.167,-4,3,7
56,MIL,P000796,P001518,2.667,0,5,5
56,MIL,P000796,P002812,1.4,-4,1,5
56,MIL,P000796,P002849,19.951,16,44,28
56,MIL,P000796,P005670,4.251,8,11,3
56,MIL,P000796,P006509,2.534,5,8,3
56,MIL,P000796,P007032,16.667,6,33,27
56,MIL,P000796,P007201,2.067,3,3,0
56,MIL,P000796,P007831,18.384,9,36,27
56,MIL,P000796,P009960,15.301,15,35,20
56,MIL,P000796,P011205,0.45,-2,0,2
56,MIL,P001518,P002849,2.667,0,5,5
56,MIL,P001518,P005670,1.833,3,5,2
56,MIL,P001518,P006701,4.983,5,11,6
56,MIL,P001518,P007032,5.817,2,11,9
56,MIL,P001518,P007831,2.667,0,5,5
56,MIL,P001518,P009960,4.983,5,11,6
56,MIL,P001518,P011205,4.983,5,11,6
56,MIL,P002812,P002849,1.4,-4,1,5
56,MIL,P002812,P005670,10.95,9,22,13
56,MIL,P002812,P006509,12.6,13,26,13
56,MIL,P002812,P007032,3.05,0,5,5
56,MIL,P002812,P007201,12.6,13,26,13
56,MIL,P002812,P007831,1.8,-2,3,5
56,MIL,P002812,P011205,12.2,11,24,13
56,MIL,P002849,P005670,3.734,8,11,3
56,MIL,P002849,P006509,2.017,5,8,3
56,MIL,P002849,P007032,16.217,8,33,25
56,MIL,P002849,P007201,1.55,3,3,0
56,MIL,P002849,P007831,17.934,11,36,25
56,MIL,P002849,P009960,14.334,17,35,18
56,MIL,P005670,P006509,13.317,14,30,16
56,MIL,P005670,P006701,1.833,3,5,2
56,MIL,P005670,P007201,12.85,12,25,13
56,MIL,P005670,P007831,1.717,3,3,0
56,MIL,P005670,P009960,4.367,8,13,5
56,MIL,P005670,P011205,12.616,12,27,15
56,MIL,P006509,P007032,1.817,4,4,0
56,MIL,P006509,P007201,13.117,13,26,13
56,MIL,P006509,P007831,0.4,2,2,0
56,MIL,P006509,P009960,2.534,5,8,3
56,MIL,P006509,P011205,12.2,11,24,13
56,MIL,P006701,P007032,4.65,1,8,7
56,MIL,P006701,P007201,1.5,-1,2,3
56,MIL,P006701,P009960,6.483,4,13,9
56,MIL,P006701,P011205,6.483,4,13,9
56,MIL,P007032,P007201,3.317,3,6,3
56,MIL,P007032,P007831,17.067,8,35,27
56,MIL,P007032,P009960,17.417,11,35,24
56,MIL,P007032,P011205,6.517,1,10,9
56,MIL,P007201,P007831,1.95,5,5,0
56,MIL,P007201,P009960,2.017,-1,2,3
56,MIL,P007201,P011205,13.7,10,26,16
56,MIL,P007831,P009960,12.767,10,27,17
56,MIL,P007831,P011205,0.45,-2,0,2
56,MIL,P009960,P011205,6.933,2,13,11
56,PAM,P000556,P005356,4.85,-12,2,14
56,PAM,P000556,P006643,3.867,-12,0,12
56,PAM,P000556,P007870,6.767,-14,5,19
56,PAM,P000556,P009101,1.9,-5,0,5
56,PAM,P000556,P010393,0.633,0,0,0
56,PAM,P000556,P011970,6.751,-16,5,21
56,PAM,P000556,P011982,6.05,-9,5,14
56,PAM,P000556,P012738,2.517,-7,0,7
56,PAM,P000556,P012740,3.801,-9,3,12
56,PAM,P003960,P004863,4.217,-3,5,8
56,PAM,P003960,P005356,11.0,-9,16,25
56,PAM,P003960,P006643,5.882,-3,6,9
56,PAM,P003960,P007870,12.55,2,24,22
56,PAM,P003960,P009101,4.983,-2,5,7
56,PAM,P003960,P011970,7.549,7,16,9
56,PAM,P003960,P011982,10.917,2,21,19
56,PAM,P003960,P012738,4.249,-3,3,6
56,PAM,P003960,P012740,5.849,5,12,7
56,PAM,P004863,P005356,4.217,-3,5,8
56,PAM,P004863,P007870,4.217,-3,5,8
56,PAM,P004863,P011982,4.217,-3,5,8
56,PAM,P005356,P006643,9.416,-6,15,21
56,PAM,P005356,P007870,15.684,-19,18,37
56,PAM,P005356,P009101,10.784,-14,14,28
56,PAM,P005356,P010393,8.284,-8,12,20
56,PAM,P005356,P011970,8.467,-13,10,23
56,PAM,P005356,P011982,13.184,-18,14,32
56,PAM,P005356,P012738,8.45,-10,12,22
56,PAM,P005356,P012740,2.2,-4,2,6
56,PAM,P006643,P007870,7.133,-4,10,14
56,PAM,P006643,P009101,13.883,-4,18,22
56,PAM,P006643,P010393,8.416,1,15,14
56,PAM,P006643,P011970,10.0,-11,10,21
56,PAM,P006643,P011982,0.633,0,0,0
56,PAM,P006643,P012738,17.433,-14,19,33
56,PAM,P006643,P012740,7.533,-11,7,18
56,PAM,P007870,P009101,7.184,-9,7,16
56,PAM,P007870,P010393,3.216,-1,4,5
56,PAM,P007870,P011970,16.9,-5,29,34
56,PAM,P007870,P011982,18.05,-10,26,36
56,PAM,P007870,P012738,3.517,-2,4,6
56,PAM,P007870,P012740,6.45,5,16,11
56,PAM,P009101,P010393,7.517,-6,12,18
56,PAM,P009101,P011970,4.867,-6,4,10
56,PAM,P009101,P011982,3.667,-7,3,10
56,PAM,P009101,P012738,14.25,-8,18,26
56,PAM,P009101,P012740,2.633,1,3,2
56,PAM,P010393,P011970,3.25,-5,4,9
56,PAM,P010393,P011982,1.716,-3,0,3
56,PAM,P010393,P012738,7.817,-6,12,18
56,PAM,P010393,P012740,3.283,0,5,5
56,PAM,P011970,P011982,9.533,0,18,18
56,PAM,P011970,P012738,7.684,-13,4,17
56,PAM,P011970,P012740,9.267,-2,16,18
56,PAM,P011982,P012740,4.233,8,12,4
56,PAM,P012738,P012740,6.483,-9,4,13
57,MUN,P001557,P003583,2.35,-1,5,6
57,MUN,P001557,P004508,3.733,-2,9,11
57,MUN,P001557,P005460,4.1,-2,11,13
57,MUN,P001557,P006760,2.1,4,6,2
57,MUN,P001557,P007056,2.15,1,4,3
57,MUN,P001557,P007639,6.683,-1,20,21
57,MUN,P001557,P007975,3.117,3,9,6
57,MUN,P001557,P008985,9.516,-1,25,26
57,MUN,P001557,P010391,7.517,-1,17,18
57,MUN,P001557,P011941,2.2,-1,3,4
57,MUN,P001557,P011987,10.466,1,27,26
57,MUN,P003583,P004508,16.001,-6,30,36
57,MUN,P003583,P006760,18.683,1,38,37
57,MUN,P003583,P007056,19.95,-12,37,49
57,MUN,P003583,P007975,7.283,-3,19,22
57,MUN,P003583,P008985,7.367,-5,16,21
57,MUN,P003583,P010391,16.051,-4,27,31
57,MUN,P003583,P011987,9.583,2,28,26
57,MUN,P004508,P005460,1.883,-3,5,8
57,MUN,P004508,P006760,15.05,6,31,25
57,MUN,P004508,P007056,18.35,-10,33,43
57,MUN,P004508,P007639,4.4,0,11,11
57,MUN,P004508,P007975,5.383,1,16,15
57,MUN,P004508,P008985,8.117,-5,19,24
57,MUN,P004508,P010391,15.051,-2,25,27
57,MUN,P004508,P011941,2.967,2,7,5
57,MUN,P004508,P011987,5.133,-1,14,15
57,MUN,P005460,P007639,3.483,0,11,11
57,MUN,P005460,P008985,4.1,-2,11,13
57,MUN,P005460,P011941,0.617,-2,0,2
57,MUN,P005460,P011987,2.217,1,6,5
57,MUN,P006760,P007056,21.333,0,42,42
57,MUN,P006760,P007639,2.517,3,6,3
57,MUN,P006760,P007975,10.666,4,27,23
57,MUN,P006760,P008985,2.95,3,8,5
57,MUN,P006760,P010391,12.851,0,19,19
57,MUN,P006760,P011987,6.982,11,23,12
57,MUN,P007056,P007639,2.517,3,6,3
57,MUN,P007056,P007975,10.983,0,25,25
57,MUN,P007056,P008985,6.0,-9,12,21
57,MUN,P007056,P010391,15.468,-3,25,28
57,MUN,P007056,P011941,1.567,2,5,3
57,MUN,P007056,P011987,8.282,-4,19,23
57,MUN,P007639,P007975,3.534,2,9,7
57,MUN,P007639,P008985,5.666,0,17,17
57,MUN,P007639,P010391,3.2,-1,9,10
57,MUN,P007639,P011987,4.8,2,15,13
57,MUN,P007975,P010391,4.368,-2,9,11
57,MUN,P007975,P011987,6.266,7,22,15
57,MUN,P008985,P010391,8.383,-1,20,21
57,MUN,P008985,P011941,2.917,3,8,5
57,MUN,P008985,P011987,11.316,-3,28,31
57,MUN,P010391,P011941,3.15,3,8,5
57,MUN,P010391,P011987,7.033,-5,17,22
57,MUN,P011941,P011987,1.65,-3,1,4
57,TEL,P005145,P009622,9.167,-5,14,19
57,TEL,P005145,P009783,9.167,-5,14,19
57,TEL,P005145,P009863,9.167,-5,14,19
57,TEL,P005145,P011199,9.167,-5,14,19
57,TEL,P007990,P009622,6.232,-3,13,16
57,TEL,P007990,P009783,4.649,-5,8,13
57,TEL,P007990,P009863,2.817,-4,5,9
57,TEL,P007990,P011193,5.134,-4,8,12
57,TEL,P007990,P011199,5.599,0,13,13
57,TEL,P007990,P011214,5.767,-7,8,15
57,TEL,P007990,P011219,5.533,-4,9,13
57,TEL,P007990,P011971,3.7,-1,7,8
57,TEL,P007990,P012744,6.033,0,13,13
57,TEL,P009622,P009783,28.883,6,66,60
57,TEL,P009622,P009863,20.334,3,44,41
57,TEL,P009622,P011193,6.85,6,19,13
57,TEL,P009622,P011199,26.6,12,65,53
57,TEL,P009622,P011214,4.033,-4,8,12
57,TEL,P009622,P011219,2.516,-3,3,6
57,TEL,P009622,P011971,12.016,13,34,21
57,TEL,P009622,P012744,5.233,7,18,11
57,TEL,P009783,P009863,24.75,2,58,56
57,TEL,P009783,P011193,11.033,9,33,24
57,TEL,P009783,P011199,25.25,6,60,54
57,TEL,P009783,P011214,8.449,-5,22,27
57,TEL,P009783,P011219,6.616,-1,16,17
57,TEL,P009783,P011971,10.649,10,30,20
57,TEL,P009783,P012744,3.75,3,13,10
57,TEL,P009863,P011193,5.684,1,14,13
57,TEL,P009863,P011199,20.05,-1,44,45
57,TEL,P009863,P011214,5.75,-3,16,19
57,TEL,P009863,P011219,4.717,0,13,13
57,TEL,P009863,P011971,6.516,5,16,11
57,TEL,P009863,P012744,1.883,2,8,6
57,TEL,P011193,P011199,3.617,7,13,6
57,TEL,P011193,P011214,12.55,-2,28,30
57,TEL,P011193,P011219,7.117,1,19,18
57,TEL,P011193,P011971,6.383,3,17,14
57,TEL,P011193,P012744,6.3,-1,13,14
57,TEL,P011199,P011214,0.383,-4,2,6
57,TEL,P011199,P011219,1.883,0,3,3
57,TEL,P011199,P011971,11.249,13,33,20
57,TEL,P011199,P012744,3.466,4,13,9
57,TEL,P011214,P011219,7.75,-2,19,21
57,TEL,P011214,P011971,3.199,-6,4,10
57,TEL,P011214,P012744,6.383,-3,13,16
57,TEL,P011219,P012744,2.4,1,6,5
57,TEL,P011971,P012744,3.616,-1,7,8
58,PAR,P000956,P003983,6.116,-1,17,18
58,PAR,P000956,P004058,1.049,1,3,2
58,PAR,P000956,P004172,5.216,4,13,9
58,PAR,P000956,P007400,8.483,8,16,8
58,PAR,P000956,P007673,7.099,0,20,20
58,PAR,P000956,P008987,15.383,13,39,26
58,PAR,P000956,P009212,4.299,-1,10,11
58,PAR,P000956,P011051,10.333,6,26,20
58,PAR,P000956,P012742,11.533,12,29,17
58,PAR,P000956,P012743,9.349,6,23,17
58,PAR,P003983,P004058,0.033,0,0,0
58,PAR,P003983,P007400,5.333,3,9,6
58,PAR,P003983,P007673,7.766,-6,17,23
58,PAR,P003983,P008987,9.783,-1,19,20
58,PAR,P003983,P009212,3.283,-2,7,9
58,PAR,P003983,P011051,13.066,-3,26,29
58,PAR,P003983,P012742,7.016,-2,9,11
58,PAR,P004058,P007400,13.333,-9,27,36
58,PAR,P004058,P007673,7.866,-4,15,19
58,PAR,P004058,P008987,9.733,-6,20,26
58,PAR,P004058,P009212,4.583,-2,10,12
58,PAR,P004058,P011051,3.966,1,8,7
58,PAR,P004058,P012742,6.483,-4,15,19
58,PAR,P004058,P012743,10.35,-9,22,31
58,PAR,P004172,P007400,1.083,0,0,0
58,PAR,P004172,P008987,5.216,4,13,9
58,PAR,P004172,P012742,4.133,4,13,9
58,PAR,P004172,P012743,5.216,4,13,9
58,PAR,P007400,P007673,6.85,-5,12,17
58,PAR,P007400,P008987,23.483,5,45,40
58,PAR,P007400,P009212,3.567,-3,7,10
58,PAR,P007400,P011051,12.15,5,20,15
58,PAR,P007400,P012742,19.15,7,40,33
58,PAR,P007400,P012743,14.9,-3,32,35
58,PAR,P007673,P008987,7.766,-6,15,21
58,PAR,P007673,P009212,7.866,-4,17,21
58,PAR,P007673,P011051,11.732,-5,25,30
58,PAR,P007673,P012742,1.683,-5,0,5
58,PAR,P007673,P012743,3.9,-5,7,12
58,PAR,P008987,P011051,16.633,1,30,29
58,PAR,P008987,P012742,24.933,6,53,47
58,PAR,P008987,P012743,15.466,4,38,34
58,PAR,P009212,P011051,3.966,1,10,9
58,PAR,P009212,P012743,3.9,-5,7,12
58,PAR,P011051,P012742,10.55,2,15,13
58,PAR,P012742,P012743,14.383,4,38,34
58,ULK,P002969,P006661,0.1,0,0,0
58,ULK,P002969,P006961,0.1,0,0,0
58,ULK,P002969,P008962,0.1,0,0,0
58,ULK,P002969,P009849,0.1,0,0,0
58,ULK,P005844,P006661,23.533,-7,47,54
58,ULK,P005844,P006961,17.549,-2,35,37
58,ULK,P005844,P008962,25.933,-12,47,59
58,ULK,P005844,P009849,14.45,-9,24,33
58,ULK,P005844,P011052,14.683,-17,15,32
58,ULK,P005844,P011980,7.716,-1,20,21
58,ULK,P006661,P006961,17.216,-2,39,41
58,ULK,P006661,P008962,25.867,-8,55,63
58,ULK,P006661,P009849,14.167,-3,32,35
58,ULK,P006661,P011052,13.65,-12,19,31
58,ULK,P006661,P011157,1.4,0,4,4
58,ULK,P006661,P011201,0.217,-2,0,2
58,ULK,P006661,P011980,7.45,2,24,22
58,ULK,P006961,P008962,18.483,-3,39,42
58,ULK,P006961,P009849,6.783,2,16,14
58,ULK,P006961,P011052,8.133,-8,8,16
58,ULK,P006961,P011201,0.217,-2,0,2
58,ULK,P006961,P011980,5.583,3,19,16
58,ULK,P008962,P009849,28.267,4,61,57
58,ULK,P008962,P011052,27.717,-5,48,53
58,ULK,P008962,P011157,13.067,12,33,21
58,ULK,P008962,P011201,0.217,-2,0,2
58,ULK,P008962,P011980,20.217,10,53,43
58,ULK,P009849,P011052,20.917,2,40,38
58,ULK,P009849,P011157,13.067,12,33,21
58,ULK,P009849,P011980,15.317,8,38,30
58,ULK,P011052,P011157,13.067,12,33,21
58,ULK,P011052,P011980,12.833,8,29,21
58,ULK,P011157,P011980,11.667,12,29,17
58,ULK,P011201,P011980,0.217,-2,0,2
59,MAD,P001392,P004887,9.05,4,25,21
59,MAD,P001392,P005791,9.017,0,19,19
59,MAD,P001392,P005928,13.9,8,41,33
59,MAD,P001392,P006540,7.2,2,19,17
59,MAD,P001392,P009005,7.2,2,19,17
59,MAD,P001392,P010357,10.867,2,25,23
59,MAD,P001392,PBMT,4.75,11,20,9
59,MAD,P001392,PCVM,4.167,-4,3,7
59,MAD,P001392,PTGB,6.117,-9,5,14
59,MAD,P003108,P004887,4.267,-2,5,7
59,MAD,P003108,P005791,10.266,8,29,21
59,MAD,P003108,P005928,8.883,5,26,21
59,MAD,P003108,P006540,7.066,3,19,16
59,MAD,P003108,P009005,5.0,9,16,7
59,MAD,P003108,P010357,9.0,-3,16,19
59,MAD,P003108,PBMT,0.533,0,2,2
59,MAD,P003108,PCVM,5.65,1,8,7
59,MAD,P003108,PTGB,7.467,3,15,12
59,MAD,P004887,P005928,6.7,6,22,16
59,MAD,P004887,P010357,15.017,4,32,28
59,MAD,P004887,PBMT,6.45,13,22,9
59,MAD,P004887,PCVM,8.317,-2,10,12
59,MAD,P004887,PTGB,10.267,-7,12,19
59,MAD,P005791,P005928,21.784,21,65,44
59,MAD,P005791,P006540,18.333,14,51,37
59,MAD,P005791,P009005,16.167,23,53,30
59,MAD,P005791,P010357,8.284,-1,13,14
59,MAD,P005791,PBMT,6.234,14,22,8
59,MAD,P005791,PCVM,3.2,1,3,2
59,MAD,P005791,PTGB,6.651,8,17,9
59,MAD,P005928,P006540,18.333,14,51,37
59,MAD,P005928,P009005,16.167,23,53,30
59,MAD,P005928,P010357,11.784,4,32,28
59,MAD,P005928,PBMT,10.984,25,42,17
59,MAD,P005928,PTGB,5.401,2,16,14
59,MAD,P006540,P009005,13.233,16,39,23
59,MAD,P006540,P010357,4.567,-2,10,12
59,MAD,P006540,PBMT,4.6,9,15,6
59,MAD,P009005,PBMT,3.967,12,18,6
59,MAD,P009005,PTGB,2.934,7,14,7
59,MAD,P010357,PBMT,8.184,15,24,9
59,MAD,P010357,PCVM,11.517,-1,13,14
59,MAD,P010357,PTGB,13.984,-6,15,21
59,MAD,PBMT,PCVM,1.7,2,2,0
59,MAD,PBMT,PTGB,3.334,7,9,2
59,MAD,PCVM,PTGB,11.517,-1,13,14
59,VIR,P001133,P001844,8.334,-9,14,23
59,VIR,P001133,P003048,14.501,-22,23,45
59,VIR,P001133,P003527,1.067,-2,0,2
59,VIR,P001133,P004007,12.366,-1,26,27
59,VIR,P001133,P006739,22.417,-20,39,59
59,VIR,P001133,P008847,16.25,-7,30,37
59,VIR,P001133,P009549,16.633,-11,32,43
59,VIR,P001133,P010781,5.051,-11,2,13
59,VIR,P001133,P011192,9.067,-7,19,26
59,VIR,P001133,PBCN,17.318,-26,27,53
59,VIR,P001844,P003048,8.683,0,15,15
59,VIR,P001844,P003527,-0.6,-2,0,2
59,VIR,P001844,P004007,4.133,7,12,5
59,VIR,P001844,P008847,10.483,9,25,16
59,VIR,P001844,P009549,2.333,-1,4,5
59,VIR,P001844,P010781,5.417,-2,11,13
59,VIR,P001844,P011192,5.7,2,12,10
59,VIR,P001844,PBCN,9.317,-8,15,23
59,VIR,P003048,P003527,1.467,-7,0,7
59,VIR,P003048,P004007,3.149,-1,4,5
59,VIR,P003048,P006739,15.067,-19,29,48
59,VIR,P003048,P008847,8.849,8,21,13
59,VIR,P003048,P009549,9.767,-7,25,32
59,VIR,P003048,P010781,8.583,-2,15,17
59,VIR,P003048,P011192,5.4,-10,4,14
59,VIR,P003048,PBCN,19.534,-16,40,56
59,VIR,P003527,P004007,1.0,-3,0,3
59,VIR,P003527,P006739,2.067,-5,0,5
59,VIR,P003527,P009549,-0.6,-2,0,2
59,VIR,P003527,P010781,1.55,-4,0,4
59,VIR,P003527,P011192,0.517,-1,0,1
59,VIR,P003527,PBCN,-0.6,-2,0,2
59,VIR,P004007,P006739,10.949,-11,16,27
59,VIR,P004007,P008847,13.649,-3,26,29
59,VIR,P004007,P009549,6.033,-5,7,12
59,VIR,P004007,P010781,0.483,-2,0,2
59,VIR,P004007,P011192,8.566,3,21,18
59,VIR,P006739,P008847,14.616,-8,26,34
59,VIR,P006739,P009549,15.817,-9,32,41
59,VIR,P006739,P010781,5.133,-6,6,12
59,VIR,P006739,P011192,5.6,-10,9,19
59,VIR,P006739,PBCN,14.534,-12,31,43
59,VIR,P008847,P009549,10.5,0,15,15
59,VIR,P008847,P010781,6.983,-1,17,18
59,VIR,P008847,P011192,7.616,2,19,17
59,VIR,P008847,PBCN,11.45,4,25,21
59,VIR,P009549,PBCN,12.117,-5,29,34
59,VIR,P010781,PBCN,9.0,-4,17,21
59,VIR,P011192,PBCN,2.734,-11,0,11
60,BAS,P004603,P004761,14.416,10,35,25
60,BAS,P004603,P007230,16.783,10,42,32
60,BAS,P004603,P008850,2.367,0,7,7
60,BAS,P004603,P009048,8.4,7,20,13
60,BAS,P004603,P011948,7.8,-7,13,20
60,BAS,P004603,P012201,8.983,17,29,12
60,BAS,P004603,P012765,8.383,3,22,19
60,BAS,P004761,P007230,21.316,12,43,31
60,BAS,P004761,P008850,0.317,-3,0,3
60,BAS,P004761,P009048,10.734,3,22,19
60,BAS,P004761,P010444,6.967,-5,4,9
60,BAS,P004761,P011948,6.149,-3,10,13
60,BAS,P004761,P012201,16.433,16,37,21
60,BAS,P004761,P012765,11.132,6,21,15
60,BAS,P007230,P008850,7.201,-10,10,20
60,BAS,P007230,P009048,21.118,2,36,34
60,BAS,P007230,P010444,17.585,-6,18,24
60,BAS,P007230,P011948,19.234,-8,30,38
60,BAS,P007230,P012201,22.434,26,49,23
60,BAS,P007230,P012765,13.733,6,28,22
60,BAS,P008850,P009048,5.601,-15,3,18
60,BAS,P008850,P010444,9.751,-17,14,31
60,BAS,P008850,P011948,11.584,-15,20,35
60,BAS,P008850,P012201,5.134,-6,12,18
60,BAS,P008850,P012765,6.517,-2,18,20
60,BAS,P009048,P010444,13.135,-12,14,26
60,BAS,P009048,P011948,15.084,-6,21,27
60,BAS,P009048,P012201,13.468,9,28,19
60,BAS,P010444,P011948,15.784,-9,24,33
60,BAS,P010444,P012201,18.118,-2,27,29
60,BAS,P010444,P012765,9.6,-1,15,16
60,BAS,P011948,P012201,11.65,6,26,20
60,BAS,P011948,P012765,8.983,-6,20,26
60,BAS,P012201,P012765,14.116,10,32,22
60,OLY,P001255,P003941,3.016,-5,6,11
60,OLY,P001255,P006302,2.699,-9,0,9
60,OLY,P001255,P007982,16.349,4,29,25
60,OLY,P001255,P008811,25.816,14,54,40
60,OLY,P001255,P008829,20.449,16,52,36
60,OLY,P001255,P008855,11.4,10,31,21
60,OLY,P001255,P010392,5.367,4,8,4
60,OLY,P001255,P010612,27.349,11,60,49
60,OLY,P001255,P011983,2.883,-9,0,9
60,OLY,P003941,P006302,0.133,-2,0,2
60,OLY,P003941,P007982,3.016,-5,6,11
60,OLY,P003941,P008829,2.883,-3,6,9
60,OLY,P003941,P010612,3.016,-5,6,11
60,OLY,P006302,P007982,1.866,-4,0,4
60,OLY,P006302,P008811,2.816,-7,0,7
60,OLY,P006302,P008829,0.483,0,0,0
60,OLY,P006302,P010612,1.216,-7,0,7
60,OLY,P006302,P011983,2.583,-7,0,7
60,OLY,P007982,P008811,19.683,-5,29,34
60,OLY,P007982,P008829,15.716,-10,27,37
60,OLY,P007982,P010392,11.467,-10,14,24
60,OLY,P007982,P010612,14.866,6,29,23
60,OLY,P007982,P011983,7.833,-16,6,22
60,OLY,P008811,P008829,28.733,9,60,51
60,OLY,P008811,P008855,16.217,14,39,25
60,OLY,P008811,P010392,16.284,-6,22,28
60,OLY,P008811,P010612,29.15,20,62,42
60,OLY,P008811,P011983,9.233,-23,6,29
60,OLY,P008829,P008855,15.667,16,39,23
60,OLY,P008829,P010392,10.917,-10,14,24
60,OLY,P008829,P010612,25.266,20,60,40
60,OLY,P008829,P011983,6.35,-14,6,20
60,OLY,P008855,P010392,4.817,4,8,4
60,OLY,P008855,P010612,16.217,14,39,25
60,OLY,P008855,P011983,0.55,-2,0,2
60,OLY,P010392,P010612,10.184,8,16,8
60,OLY,P010392,P011983,6.1,-14,6,20
60,OLY,P010612,P011983,1.4,-7,0,7
61,BER,P003958,P006251,3.8,7,15,8
61,BER,P003958,P006919,14.783,-4,25,29
61,BER,P003958,P007025,1.283,1,5,4
61,BER,P003958,P007550,0.917,0,3,3
61,BER,P003958,P008211,17.483,-7,37,44
61,BER,P003958,P008384,10.916,4,27,23
61,BER,P003958,P008967,12.783,-13,22,35
61,BER,P003958,P010791,7.533,-7,13,20
61,BER,P003958,P011934,10.55,-7,19,26
61,BER,P003958,P012720,22.816,-14,42,56
61,BER,P006251,P006919,6.967,4,18,14
61,BER,P006251,P007025,3.2,-5,7,12
61,BER,P006251,P007550,4.8,-9,6,15
61,BER,P006251,P008211,4.467,7,16,9
61,BER,P006251,P008384,12.7,-2,30,32
61,BER,P006251,P008967,3.467,-1,5,6
61,BER,P006251,P010791,7.667,2,18,16
61,BER,P006251,P011934,1.917,-6,2,8
61,BER,P006251,P012720,7.95,9,23,14
61,BER,P006251,P012721,1.133,-2,0,2
61,BER,P006919,P007550,1.933,-1,4,5
61,BER,P006919,P008211,12.717,0,26,26
61,BER,P006919,P008384,11.116,2,25,23
61,BER,P006919,P008967,3.833,-3,5,8
61,BER,P006919,P010791,12.483,-3,26,29
61,BER,P006919,P011934,1.8,0,2,2
61,BER,P006919,P012720,14.1,-7,21,28
61,BER,P007025,P007550,1.917,-6,2,8
61,BER,P007025,P008384,3.2,-5,7,12
61,BER,P007025,P011934,1.917,-6,2,8
61,BER,P007025,P012720,1.283,1,5,4
61,BER,P007550,P008384,9.134,-7,22,29
61,BER,P007550,P008967,5.434,0,16,16
61,BER,P007550,P010791,1.933,-1,4,5
61,BER,P007550,P011934,6.401,-4,18,22
61,BER,P007550,P012720,0.15,0,0,0
61,BER,P007550,P012721,4.517,0,13,13
61,BER,P008211,P008384,4.783,8,18,10
61,BER,P008211,P008967,5.833,-9,12,21
61,BER,P008211,P010791,9.3,-6,19,25
61,BER,P008211,P011934,7.433,-6,14,20
61,BER,P008211,P012720,15.533,-11,30,41
61,BER,P008211,P012721,0.183,0,0,0
61,BER,P008384,P008967,13.834,-3,28,31
61,BER,P008384,P010791,9.8,6,25,19
61,BER,P008384,P011934,8.451,-5,20,25
61,BER,P008384,P012720,12.166,2,25,23
61,BER,P008384,P012721,4.7,0,13,13
61,BER,P008967,P010791,2.717,-2,5,7
61,BER,P008967,P011934,12.317,-5,30,35
61,BER,P008967,P012720,14.533,-12,24,36
61,BER,P008967,P012721,4.517,0,13,13
61,BER,P010791,P012720,9.367,-9,14,23
61,BER,P011934,P012720,9.783,-7,16,23
61,BER,P011934,P012721,3.567,2,13,11
61,BER,P012720,P012721,0.183,0,0,0
61,PAN,P001926,P002328,27.183,14,63,49
61,PAN,P001926,P003842,17.4,9,35,26
61,PAN,P001926,P007553,12.983,10,40,30
61,PAN,P001926,P007866,27.583,17,66,49
61,PAN,P001926,P007947,10.45,14,34,20
61,PAN,P001926,P008084,3.2,5,12,7
61,PAN,P001926,P011204,23.933,16,59,43
61,PAN,P001926,P012774,0.4,3,3,0
61,PAN,P002328,P003842,20.683,2,41,39
61,PAN,P002328,P007553,13.566,8,39,31
61,PAN,P002328,P007866,34.249,10,80,70
61,PAN,P002328,P007947,11.383,6,32,26
61,PAN,P002328,P011204,24.733,6,57,51
61,PAN,P002328,P012774,5.199,-6,8,14
61,PAN,P003842,P007553,0.7,-3,2,5
61,PAN,P003842,P007866,22.133,1,43,42
61,PAN,P003842,P007947,5.6,-7,13,20
61,PAN,P003842,P008084,0.7,-3,2,5
61,PAN,P003842,P011204,18.833,4,36,32
61,PAN,P003842,P012774,5.283,-11,8,19
61,PAN,P007553,P007866,13.566,8,39,31
61,PAN,P007553,P007947,11.833,11,37,26
61,PAN,P007553,P008084,3.9,2,14,12
61,PAN,P007553,P011204,10.55,6,35,29
61,PAN,P007553,P012774,2.766,-2,6,8
61,PAN,P007866,P007947,13.233,8,37,29
61,PAN,P007866,P011204,26.583,8,62,54
61,PAN,P007866,P012774,7.049,-4,13,17
61,PAN,P007947,P008084,3.9,2,14,12
61,PAN,P007947,P011204,6.917,9,26,17
61,PAN,P007947,P012774,5.216,-3,11,14
61,PAN,P008084,P011204,3.2,5,12,7
61,PAN,P008084,P012774,0.7,-3,2,5
61,PAN,P011204,P012774,4.383,-2,9,11
62,ASV,P002100,P003526,3.067,1,3,2
62,ASV,P002100,P004194,16.75,6,36,30
62,ASV,P002100,P006568,3.967,1,7,6
62,ASV,P002100,P011225,14.85,3,29,26
62,ASV,P002100,P011386,4.5,-3,9,12
62,ASV,P002100,P012080,18.617,-3,35,38
62,ASV,P002100,P012729,20.15,-5,34,39
62,ASV,P002100,P012730,7.367,-10,5,15
62,ASV,P002100,PKIR,7.2,-6,6,12
62,ASV,P003526,P004194,18.95,-5,32,37
62,ASV,P003526,P006568,14.783,-4,29,33
62,ASV,P003526,P011225,18.2,-5,32,37
62,ASV,P003526,P012080,16.633,-6,29,35
62,ASV,P003526,P012729,4.167,-1,3,4
62,ASV,P004194,P006568,18.75,-3,36,39
62,ASV,P004194,P011225,27.383,3,56,53
62,ASV,P004194,P011386,4.5,-3,9,12
62,ASV,P004194,P012080,29.333,-4,59,63
62,ASV,P004194,P012729,13.883,3,29,26
62,ASV,P004194,PKIR,0.983,3,3,0
62,ASV,P006568,P011225,16.883,-1,34,35
62,ASV,P006568,P011386,1.867,-2,2,4
62,ASV,P006568,P012080,18.75,-3,36,39
62,ASV,P011225,P012080,25.233,-2,52,54
62,ASV,P011225,P012729,13.85,-2,24,26
62,ASV,P011225,P012730,3.35,-6,2,8
62,ASV,P011225,PKIR,3.183,-2,3,5
62,ASV,P011386,P012080,4.5,-3,9,12
62,ASV,P011386,P012729,2.633,-1,7,8
62,ASV,P012080,P012729,15.75,-6,28,34
62,ASV,P012080,P012730,5.167,-5,5,10
62,ASV,P012080,PKIR,4.017,-4,3,7
62,ASV,P012729,P012730,7.367,-10,5,15
62,ASV,P012729,PKIR,7.2,-6,6,12
62,ASV,P012730,PKIR,6.217,-9,3,12
62,MCO,P002581,P004197,4.817,-2,10,12
62,MCO,P002581,P005985,4.817,-2,10,12
62,MCO,P002581,P009754,4.817,-2,10,12
62,MCO,P002581,P010588,4.817,-2,10,12
62,MCO,P004197,P005985,11.967,-2,24,26
62,MCO,P004197,P009754,11.967,-2,24,26
62,MCO,P004197,P010588,11.967,-2,24,26
62,MCO,P004197,PLCZ,7.15,0,14,14
62,MCO,P005985,P009754,19.034,14,47,33
62,MCO,P005985,P010588,22.201,11,53,42
62,MCO,P005985,P011196,9.451,0,15,15
62,MCO,P005985,P011212,9.401,-10,10,20
62,MCO,P005985,P011226,14.934,-2,25,27
62,MCO,P005985,P011231,9.217,-3,12,15
62,MCO,P005985,PLCZ,9.65,-6,16,22
62,MCO,P009754,P010588,19.034,14,47,33
62,MCO,P009754,P011196,7.584,16,22,6
62,MCO,P009754,P011212,7.201,11,17,6
62,MCO,P009754,P011226,12.734,19,32,13
62,MCO,P009754,P011231,10.184,15,25,10
62,MCO,P009754,PLCZ,9.317,-1,16,17
62,MCO,P010588,P011196,7.384,1,15,14
62,MCO,P010588,P011212,5.034,-1,10,11
62,MCO,P010588,P011226,10.567,7,25,18
62,MCO,P010588,P011231,3.75,8,12,4
62,MCO,P010588,P012709,1.1,-2,0,2
62,MCO,P010588,PLCZ,7.35,2,16,14
62,MCO,P011196,P011212,17.068,7,33,26
62,MCO,P011196,P011226,18.851,7,36,29
62,MCO,P011196,P011231,12.234,10,25,15
62,MCO,P011196,P012709,5.9,3,14,11
62,MCO,P011212,P011226,20.968,-4,33,37
62,MCO,P011212,P011231,16.701,1,27,26
62,MCO,P011212,P012709,5.9,3,14,11
62,MCO,P011212,PLCZ,4.667,-7,4,11
62,MCO,P011226,P011231,20.451,9,39,30
62,MCO,P011226,P012709,5.9,3,14,11
62,MCO,P011226,PLCZ,4.667,-7,4,11
62,MCO,P011231,P012709,4.8,5,14,9
62,MCO,P011231,PLCZ,4.467,-9,2,11
63,BAR,P000925,P002939,21.433,5,43,38
63,BAR,P000925,P003478,11.716,-1,23,24
63,BAR,P000925,P004866,16.1,10,36,26
63,BAR,P000925,P006435,9.85,0,20,20
63,BAR,P000925,P007519,6.066,-4,7,11
63,BAR,P000925,P009992,1.933,-4,0,4
63,BAR,P000925,P011244,14.5,-5,24,29
63,BAR,P000925,P012745,7.866,7,19,12
63,BAR,P002939,P003196,5.083,-1,11,12
63,BAR,P002939,P003478,13.7,3,29,26
63,BAR,P002939,P004866,18.266,8,41,33
63,BAR,P002939,P006435,12.016,-2,25,27
63,BAR,P002939,P007519,8.05,0,13,13
63,BAR,P002939,P009992,1.0,-1,0,1
63,BAR,P002939,P011244,15.65,-3,31,34
63,BAR,P002939,P012745,10.866,7,23,16
63,BAR,P003196,P003478,9.234,1,22,21
63,BAR,P003196,P004866,10.867,-3,25,28
63,BAR,P003196,P006435,8.183,4,21,17
63,BAR,P003196,P007519,15.468,5,38,33
63,BAR,P003196,P009992,4.067,3,12,9
63,BAR,P003196,P011244,2.816,-3,7,10
63,BAR,P003196,P012745,14.818,6,36,30
63,BAR,P003478,P004866,7.917,2,20,18
63,BAR,P003478,P006435,2.65,-4,4,8
63,BAR,P003478,P007519,11.85,-2,25,27
63,BAR,P003478,P009992,5.783,1,12,11
63,BAR,P003478,P011244,12.966,-2,24,26
63,BAR,P003478,P012745,7.984,2,21,19
63,BAR,P004866,P006435,15.383,8,37,29
63,BAR,P004866,P007519,12.151,-2,24,26
63,BAR,P004866,P009992,0.217,-2,0,2
63,BAR,P004866,P011244,8.817,1,20,19
63,BAR,P004866,P012745,18.15,6,41,35
63,BAR,P006435,P007519,6.017,6,16,10
63,BAR,P006435,P011244,3.55,-9,7,16
63,BAR,P006435,P012745,14.483,13,34,21
63,BAR,P007519,P009992,5.0,0,12,12
63,BAR,P007519,P011244,8.299,-5,11,16
63,BAR,P007519,P012745,13.235,6,34,28
63,BAR,P009992,P011244,2.666,-6,0,6
63,BAR,P009992,P012745,3.334,5,12,7
63,RED,P000848,P002553,21.649,-10,35,45
63,RED,P000848,P003479,1.183,-2,2,4
63,RED,P000848,P006436,7.483,8,23,15
63,RED,P000848,P007960,18.1,-4,32,36
63,RED,P000848,P008966,0.2,0,0,0
63,RED,P000848,P009035,21.85,-1,40,41
63,RED,P000848,P011224,17.599,-10,27,37
63,RED,P000848,PJDR,7.2,7,21,14
63,RED,P002553,P003479,2.85,-6,5,11
63,RED,P002553,P006436,12.833,-12,26,38
63,RED,P002553,P007960,18.683,-7,28,35
63,RED,P002553,P008966,3.683,-6,5,11
63,RED,P002553,P009035,24.2,-7,41,48
63,RED,P002553,P011224,24.183,-17,41,58
63,RED,P002553,P012044,3.083,-2,5,7
63,RED,P002553,PJDR,14.9,-9,30,39
63,RED,P003479,P006436,2.85,-6,5,11
63,RED,P003479,P011224,2.85,-6,5,11
63,RED,P003479,PJDR,1.667,-4,3,7
63,RED,P006436,P007960,4.4,9,16,7
63,RED,P006436,P008966,9.999,1,22,21
63,RED,P006436,P009035,7.484,7,23,16
63,RED,P006436,P011224,10.4,-9,23,32
63,RED,P006436,P011964,3.883,5,11,6
63,RED,P006436,P012044,8.749,4,20,16
63,RED,P006436,PJDR,16.383,1,43,42
63,RED,P007960,P008966,2.433,2,6,4
63,RED,P007960,P009035,20.65,0,38,38
63,RED,P007960,P011224,15.083,-6,22,28
63,RED,P007960,P012044,1.783,1,4,3
63,RED,P007960,PJDR,11.2,13,30,17
63,RED,P008966,P009035,0.2,0,0,0
63,RED,P008966,P011224,1.45,-3,2,5
63,RED,P008966,P011964,3.883,5,11,6
63,RED,P008966,P012044,8.749,4,20,16
63,RED,P008966,PJDR,10.199,1,22,21
63,RED,P009035,P011224,20.15,-7,33,40
63,RED,P009035,PJDR,10.934,8,29,21
63,RED,P011224,PJDR,8.417,-6,19,25
63,RED,P011964,P012044,3.883,5,11,6
63,RED,P011964,PJDR,3.883,5,11,6
63,RED,P012044,PJDR,8.749,4,20,16
64,IST,P004554,P004888,6.017,5,20,15
64,IST,P004554,P006372,2.833,3,8,5
64,IST,P004554,P006590,20.983,10,57,47
64,IST,P004554,P007200,21.233,18,62,44
64,IST,P004554,P009513,1.55,-2,4,6
64,IST,P004554,P009664,18.6,11,54,43
64,IST,P004554,P011078,19.916,19,59,40
64,IST,P004888,P006372,7.184,1,13,12
64,IST,P004888,P006590,12.818,-9,20,29
64,IST,P004888,P007200,17.619,4,39,35
64,IST,P004888,P009513,3.467,-2,9,11
64,IST,P004888,P009664,13.918,-9,22,31
64,IST,P004888,P011078,14.501,8,29,21
64,IST,P004888,P011981,6.284,-3,9,12
64,IST,P004888,PLHK,6.068,1,11,10
64,IST,P006372,P006590,3.933,-5,2,7
64,IST,P006372,P007200,9.567,-2,15,17
64,IST,P006372,P009664,4.167,-2,3,5
64,IST,P006372,P011078,9.367,0,15,15
64,IST,P006372,P011981,1.25,-3,0,3
64,IST,P006372,PLHK,1.767,0,4,4
64,IST,P006590,P007200,26.501,4,62,58
64,IST,P006590,P009513,1.55,-2,4,6
64,IST,P006590,P009664,25.001,2,60,58
64,IST,P006590,P011078,25.3,8,57,49
64,IST,P006590,P011981,5.034,-8,2,10
64,IST,P006590,PLHK,2.284,-4,0,4
64,IST,P007200,P009513,1.917,0,5,5
64,IST,P007200,P009664,26.435,5,62,57
64,IST,P007200,P011078,29.734,19,75,56
64,IST,P007200,P011981,5.201,-3,9,12
64,IST,P007200,PLHK,4.401,3,11,8
64,IST,P009513,P009664,1.6,-5,4,9
64,IST,P009513,P011981,1.917,0,5,5
64,IST,P009513,PLHK,1.867,3,5,2
64,IST,P009664,P011078,23.517,14,57,43
64,IST,P009664,P011981,2.617,-6,2,8
64,IST,P009664,PLHK,0.617,-2,0,2
64,IST,P011078,P011981,4.217,-4,2,6
64,IST,P011078,PLHK,3.584,0,6,6
64,IST,P011981,PLHK,3.684,3,7,4
64,MCO,P004197,P005985,7.483,-1,20,21
64,MCO,P004197,P009754,7.483,-1,20,21
64,MCO,P004197,P010588,7.483,-1,20,21
64,MCO,P004197,PLCZ,7.483,-1,20,21
64,MCO,P004790,P005985,1.55,2,6,4
64,MCO,P004790,P009754,2.833,3,5,2
64,MCO,P004790,P010588,4.383,5,11,6
64,MCO,P004790,P011212,4.383,5,11,6
64,MCO,P004790,P011226,2.833,3,5,2
64,MCO,P004790,P011231,1.55,2,6,4
64,MCO,P005985,P009754,28.166,-8,60,68
64,MCO,P005985,P010588,30.132,-6,66,72
64,MCO,P005985,P011196,1.983,-3,2,5
64,MCO,P005985,P011212,11.066,5,21,16
64,MCO,P005985,P011226,16.016,-16,31,47
64,MCO,P005985,P011231,11.017,0,21,21
64,MCO,P005985,PLCZ,18.983,-9,45,54
64,MCO,P009754,P010588,30.132,-4,63,67
64,MCO,P009754,P011196,0.1,0,0,0
64,MCO,P009754,P011212,10.466,9,18,9
64,MCO,P009754,P011226,16.966,-10,34,44
64,MCO,P009754,P011231,8.867,0,15,15
64,MCO,P009754,PLCZ,18.983,-9,45,54
64,MCO,P010588,P011196,1.466,-3,2,5
64,MCO,P010588,P011212,13.382,8,26,18
64,MCO,P010588,P011226,17.465,-12,34,46
64,MCO,P010588,P011231,9.55,3,19,16
64,MCO,P010588,P012709,0.083,-2,0,2
64,MCO,P010588,PLCZ,18.116,-8,43,51
64,MCO,P011196,P011212,7.449,-4,11,15
64,MCO,P011196,P011226,7.549,-4,11,15
64,MCO,P011196,P011231,6.083,-1,9,10
64,MCO,P011196,P012709,5.566,-1,9,10
64,MCO,P011212,P011226,11.365,-1,18,19
64,MCO,P011212,P011231,11.8,3,20,17
64,MCO,P011212,P012709,5.566,-1,9,10
64,MCO,P011212,PLCZ,2.383,4,6,2
64,MCO,P011226,P011231,10.783,-3,19,22
64,MCO,P011226,P012709,5.566,-1,9,10
64,MCO,P011226,PLCZ,9.117,-12,19,31
64,MCO,P011231,P012709,5.483,1,9,8
64,MCO,P011231,PLCZ,0.867,-1,2,3
65,RED,P000848,P002553,14.583,2,25,23
65,RED,P000848,P003479,1.633,-2,3,5
65,RED,P000848,P004720,6.15,10,18,8
65,RED,P000848,P006436,19.249,9,40,31
65,RED,P000848,P007960,9.999,13,29,16
65,RED,P000848,P008966,7.05,13,21,8
65,RED,P000848,P009035,16.049,6,32,26
65,RED,P000848,P011224,1.133,4,4,0
65,RED,P000848,P012044,14.549,-2,27,29
65,RED,P000848,PJDR,8.533,15,25,10
65,RED,P002553,P004720,5.334,5,9,4
65,RED,P002553,P006436,16.217,5,28,23
65,RED,P002553,P007960,0.184,0,0,0
65,RED,P002553,P008966,6.35,8,12,4
65,RED,P002553,P009035,15.017,2,25,23
65,RED,P002553,P011224,1.133,4,4,0
65,RED,P002553,P012044,18.333,4,29,25
65,RED,P002553,PJDR,8.317,10,16,6
65,RED,P003479,P004720,3.383,1,9,8
65,RED,P003479,P006436,5.466,2,15,13
65,RED,P003479,P007960,5.466,2,15,13
65,RED,P003479,P011964,3.383,1,9,8
65,RED,P003479,P012044,2.083,1,6,5
65,RED,P003479,PJDR,0.45,3,3,0
65,RED,P004720,P006436,4.701,3,11,8
65,RED,P004720,P007960,14.084,15,34,19
65,RED,P004720,P008966,15.784,19,34,15
65,RED,P004720,P009035,0.067,0,0,0
65,RED,P004720,P011964,3.85,1,9,8
65,RED,P004720,P012044,9.05,9,16,7
65,RED,P004720,PJDR,14.533,17,32,15
65,RED,P006436,P007960,9.283,7,25,18
65,RED,P006436,P008966,3.517,6,8,2
65,RED,P006436,P009035,16.483,6,32,26
65,RED,P006436,P011224,1.133,4,4,0
65,RED,P006436,P011964,3.85,1,9,8
65,RED,P006436,P012044,16.732,2,33,31
65,RED,P006436,PJDR,5.233,11,15,4
65,RED,P007960,P008966,11.817,15,28,13
65,RED,P007960,P009035,1.383,2,5,3
65,RED,P007960,P011964,3.85,1,9,8
65,RED,P007960,P012044,7.299,5,18,13
65,RED,P007960,PJDR,11.299,16,29,13
65,RED,P008966,P011964,0.467,0,0,0
65,RED,P008966,P012044,10.416,10,19,9
65,RED,P008966,PJDR,16.799,21,38,17
65,RED,P009035,P011224,1.133,4,4,0
65,RED,P009035,P012044,13.283,0,24,24
65,RED,P009035,PJDR,2.517,4,6,2
65,RED,P012044,PJDR,11.383,15,24,9
65,ULK,P002969,P005844,7.317,-7,12,19
65,ULK,P002969,P006961,7.317,-7,12,19
65,ULK,P002969,P009849,0.65,0,0,0
65,ULK,P002969,P011052,7.317,-7,12,19
65,ULK,P002969,P011201,6.667,-7,12,19
65,ULK,P005844,P006661,13.467,-18,14,32
65,ULK,P005844,P006961,14.417,-15,22,37
65,ULK,P005844,P008962,10.15,-16,12,28
65,ULK,P005844,P009849,12.116,-13,11,24
65,ULK,P005844,P011052,8.933,-8,14,22
65,ULK,P005844,P011157,4.4,-5,2,7
65,ULK,P005844,P011201,13.451,-13,19,32
65,ULK,P005844,P011980,5.349,-9,6,15
65,ULK,P006661,P006961,7.6,-12,8,20
65,ULK,P006661,P008962,19.45,-12,29,41
65,ULK,P006661,P009849,12.816,-13,14,27
65,ULK,P006661,P011052,8.867,3,17,14
65,ULK,P006661,P011157,14.783,-4,19,23
65,ULK,P006661,P011201,7.234,-8,7,15
65,ULK,P006661,P011980,11.183,-4,16,20
65,ULK,P006961,P008962,6.367,-7,8,15
65,ULK,P006961,P009849,4.716,-2,5,7
65,ULK,P006961,P011052,7.85,-5,14,19
65,ULK,P006961,P011157,2.266,-7,0,7
65,ULK,P006961,P011201,10.734,-15,17,32
65,ULK,P006961,P011980,0.533,2,2,0
65,ULK,P008962,P009849,16.716,-17,23,40
65,ULK,P008962,P011052,17.167,-6,28,34
65,ULK,P008962,P011157,17.6,-5,28,33
65,ULK,P008962,P011201,4.067,-8,5,13
65,ULK,P008962,P011980,19.483,-13,27,40
65,ULK,P009849,P011052,11.383,-8,18,26
65,ULK,P009849,P011157,14.583,-12,18,30
65,ULK,P009849,P011201,3.167,0,2,2
65,ULK,P009849,P011980,13.049,-15,17,32
65,ULK,P011052,P011157,16.084,-3,28,31
65,ULK,P011052,P011201,6.667,-7,12,19
65,ULK,P011052,P011980,15.8,-3,25,28
65,ULK,P011157,P011201,3.617,-2,2,4
65,ULK,P011157,P011980,14.667,-2,23,25
66,OLY,P001255,P006302,4.8,5,9,4
66,OLY,P001255,P006589,5.083,-2,6,8
66,OLY,P001255,P008811,26.034,-4,39,43
66,OLY,P001255,P008829,10.767,2,18,16
66,OLY,P001255,P008855,26.151,-6,37,43
66,OLY,P001255,P010392,9.551,4,16,12
66,OLY,P001255,P010612,16.668,-3,28,31
66,OLY,P001255,P011983,6.35,-8,7,15
66,OLY,P006302,P006589,3.766,-2,9,11
66,OLY,P006302,P007982,5.3,3,16,13
66,OLY,P006302,P008811,10.05,10,23,13
66,OLY,P006302,P008829,7.25,3,19,16
66,OLY,P006302,P008855,7.433,2,11,9
66,OLY,P006302,P010392,9.917,8,21,13
66,OLY,P006302,P010612,0.2,3,3,0
66,OLY,P006302,P011983,3.016,0,9,9
66,OLY,P006589,P007982,4.133,-3,10,13
66,OLY,P006589,P008811,5.966,-2,8,10
66,OLY,P006589,P008829,4.683,-1,14,15
66,OLY,P006589,P008855,6.516,0,12,12
66,OLY,P006589,P010392,3.583,2,6,4
66,OLY,P006589,P010612,1.8,1,7,6
66,OLY,P006589,P011983,7.066,-5,16,21
66,OLY,P007982,P008811,2.417,5,9,4
66,OLY,P007982,P008829,6.55,2,19,17
66,OLY,P007982,P010392,2.417,5,9,4
66,OLY,P007982,P010612,1.25,-1,3,4
66,OLY,P007982,P011983,4.133,-3,10,13
66,OLY,P008811,P008829,18.851,11,41,30
66,OLY,P008811,P008855,32.384,-3,52,55
66,OLY,P008811,P010392,14.484,8,29,21
66,OLY,P008811,P010612,20.068,0,38,38
66,OLY,P008811,P011983,9.75,-5,17,22
66,OLY,P008829,P008855,16.984,8,36,28
66,OLY,P008829,P010392,4.367,5,12,7
66,OLY,P008829,P010612,16.284,7,36,29
66,OLY,P008829,P011983,8.4,3,25,22
66,OLY,P008855,P010392,12.317,3,20,17
66,OLY,P008855,P010612,20.735,0,40,40
66,OLY,P008855,P011983,10.484,-4,20,24
66,OLY,P010392,P010612,2.251,0,6,6
66,OLY,P010392,P011983,0.317,1,1,0
66,OLY,P010612,P011983,9.484,1,23,22
66,TEL,P004233,P005145,2.633,4,11,7
66,TEL,P004233,P009622,2.917,3,8,5
66,TEL,P004233,P009783,3.134,1,11,10
66,TEL,P004233,P011193,8.066,4,25,21
66,TEL,P004233,P011199,1.75,3,3,0
66,TEL,P004233,P011214,5.433,1,17,16
66,TEL,P004233,P011219,3.833,-3,11,14
66,TEL,P004233,P012744,5.366,3,14,11
66,TEL,P005145,P009622,0.9,-5,0,5
66,TEL,P005145,P009783,3.533,-1,11,12
66,TEL,P005145,P011193,3.533,-1,11,12
66,TEL,P005145,P011214,3.533,-1,11,12
66,TEL,P007990,P009622,13.816,2,24,22
66,TEL,P007990,P009783,14.266,2,24,22
66,TEL,P007990,P011193,3.399,0,6,6
66,TEL,P007990,P011199,9.533,-7,13,20
66,TEL,P007990,P011214,7.732,7,17,10
66,TEL,P007990,P011219,7.599,7,17,10
66,TEL,P007990,P011971,7.333,0,13,13
66,TEL,P007990,P012744,4.65,-3,6,9
66,TEL,P009622,P009783,26.317,-14,37,51
66,TEL,P009622,P011193,17.466,-8,27,35
66,TEL,P009622,P011199,21.1,0,31,31
66,TEL,P009622,P011214,7.533,2,13,11
66,TEL,P009622,P011219,8.799,-1,18,19
66,TEL,P009622,P011971,16.75,0,26,26
66,TEL,P009622,P012744,9.866,-3,20,23
66,TEL,P009783,P011193,20.766,-8,36,44
66,TEL,P009783,P011199,19.567,-3,28,31
66,TEL,P009783,P011214,10.616,6,24,18
66,TEL,P009783,P011219,8.366,-4,13,17
66,TEL,P009783,P011971,15.75,0,24,24
66,TEL,P009783,P012744,5.817,-11,8,19
66,TEL,P011193,P011199,11.716,3,18,15
66,TEL,P011193,P011214,11.832,-4,25,29
66,TEL,P011193,P011219,10.465,-11,19,30
66,TEL,P011193,P011971,9.417,0,13,13
66,TEL,P011193,P012744,7.732,-3,20,23
66,TEL,P011199,P011214,0.183,-2,0,2
66,TEL,P011199,P011219,1.916,-2,0,2
66,TEL,P011199,P011971,13.65,0,22,22
66,TEL,P011199,P012744,5.717,0,9,9
66,TEL,P011214,P011219,10.332,4,23,19
66,TEL,P011214,P011971,3.1,0,4,4
66,TEL,P011214,P012744,4.366,-1,10,11
66,TEL,P011219,P011971,1.0,0,2,2
66,TEL,P011219,P012744,6.882,-6,17,23
67,MAD,P001392,P003108,0.617,-2,0,2
67,MAD,P001392,P005791,8.95,6,17,11
67,MAD,P001392,P005928,8.95,6,17,11
67,MAD,P001392,P006540,8.333,8,17,9
67,MAD,P001392,P009005,8.333,8,17,9
67,MAD,P001392,P010357,0.617,-2,0,2
67,MAD,P003108,P003733,5.767,-10,5,15
67,MAD,P003108,P004887,10.1,-6,14,20
67,MAD,P003108,P005791,10.367,-1,17,18
67,MAD,P003108,P005928,10.317,2,19,17
67,MAD,P003108,P006540,0.617,0,3,3
67,MAD,P003108,P009005,6.284,-3,9,12
67,MAD,P003108,P010357,7.684,-2,10,12
67,MAD,P003108,PBMT,6.716,-4,12,16
67,MAD,P003108,PCVM,11.55,-6,15,21
67,MAD,P003108,PTGB,11.849,4,20,16
67,MAD,P003733,P004887,5.767,-10,5,15
67,MAD,P003733,P005928,0.85,0,0,0
67,MAD,P003733,P009005,1.467,-4,0,4
67,MAD,P003733,P010357,0.217,-2,0,2
67,MAD,P003733,PBMT,4.3,-6,5,11
67,MAD,P003733,PCVM,4.7,-8,5,13
67,MAD,P004887,P005928,4.016,4,9,5
67,MAD,P004887,P006540,0.617,0,3,3
67,MAD,P004887,P009005,3.117,-4,3,7
67,MAD,P004887,P010357,2.85,0,6,6
67,MAD,P004887,PBMT,5.816,-2,11,13
67,MAD,P004887,PCVM,6.6,-7,8,15
67,MAD,P004887,PTGB,4.449,5,9,4
67,MAD,P005791,P005928,25.833,8,55,47
67,MAD,P005791,P006540,16.716,8,38,30
67,MAD,P005791,P009005,19.883,9,44,35
67,MAD,P005791,P010357,16.033,0,32,32
67,MAD,P005791,PBMT,3.716,0,8,8
67,MAD,P005791,PCVM,4.95,1,7,6
67,MAD,P005791,PTGB,10.216,1,18,17
67,MAD,P005928,P006540,17.333,8,41,33
67,MAD,P005928,P009005,21.866,9,47,38
67,MAD,P005928,P010357,13.433,1,31,30
67,MAD,P005928,PBMT,5.749,4,14,10
67,MAD,P005928,PCVM,1.617,1,3,2
67,MAD,P005928,PTGB,9.432,5,20,15
67,MAD,P006540,P009005,17.333,8,41,33
67,MAD,P006540,P010357,8.383,0,21,21
67,MAD,P009005,P010357,8.6,-2,21,23
67,MAD,P009005,PCVM,0.917,-2,0,2
67,MAD,P009005,PTGB,4.2,1,6,5
67,MAD,P010357,PBMT,2.816,2,7,5
67,MAD,P010357,PCVM,6.85,2,10,8
67,MAD,P010357,PTGB,8.049,3,14,11
67,MAD,PBMT,PCVM,3.783,-6,5,11
67,MAD,PBMT,PTGB,5.232,4,14,10
67,MAD,PCVM,PTGB,5.233,1,7,6
67,PAM,P000556,P003960,13.416,-11,25,36
67,PAM,P000556,P004863,0.833,2,2,0
67,PAM,P000556,P005356,12.583,-13,23,36
67,PAM,P000556,P007870,13.416,-11,25,36
67,PAM,P000556,P010568,13.416,-11,25,36
67,PAM,P003960,P004863,3.866,4,8,4
67,PAM,P003960,P005356,20.7,-11,38,49
67,PAM,P003960,P006643,4.417,6,11,5
67,PAM,P003960,P007870,23.666,-5,46,51
67,PAM,P003960,P010568,23.982,-11,43,54
67,PAM,P003960,P011982,7.549,-4,11,15
67,PAM,P003960,P012739,1.749,-3,2,5
67,PAM,P003960,P012740,2.183,-1,4,5
67,PAM,P004863,P006643,6.101,6,15,9
67,PAM,P004863,P007870,6.1,7,15,8
67,PAM,P004863,P010393,1.017,-1,2,3
67,PAM,P004863,P010568,3.616,4,8,4
67,PAM,P004863,P011982,10.734,4,18,14
67,PAM,P004863,P012738,11.067,6,19,13
67,PAM,P004863,P012739,10.067,4,16,12
67,PAM,P004863,P012740,11.267,8,21,13
67,PAM,P005356,P006643,2.317,3,6,3
67,PAM,P005356,P007870,21.767,-11,41,52
67,PAM,P005356,P010393,1.067,0,3,3
67,PAM,P005356,P010568,21.767,-11,41,52
67,PAM,P005356,P011982,6.867,-1,12,13
67,PAM,P006643,P007870,7.384,7,17,10
67,PAM,P006643,P010393,1.75,-2,2,4
67,PAM,P006643,P010568,4.75,6,10,4
67,PAM,P006643,P011982,2.234,0,4,4
67,PAM,P006643,P012738,2.767,2,6,4
67,PAM,P006643,P012739,1.767,1,4,3
67,PAM,P006643,P012740,3.117,3,9,6
67,PAM,P007870,P010393,2.817,-2,5,7
67,PAM,P007870,P010568,25.999,-5,50,55
67,PAM,P007870,P011982,9.8,0,19,19
67,PAM,P007870,P012738,1.933,1,4,3
67,PAM,P007870,P012739,0.033,1,1,0
67,PAM,P007870,P012740,1.617,2,5,3
67,PAM,P010393,P010568,1.8,-1,3,4
67,PAM,P010393,P011982,2.817,-2,5,7
67,PAM,P010568,P011982,10.233,-4,17,21
67,PAM,P010568,P012738,1.45,0,2,2
67,PAM,P010568,P012739,1.483,-4,1,5
67,PAM,P010568,P012740,1.3,-3,0,3
67,PAM,P011982,P012738,9.084,4,13,9
67,PAM,P011982,P012739,9.9,1,13,12
67,PAM,P011982,P012740,9.45,2,12,10
67,PAM,P012738,P012739,9.651,5,15,10
67,PAM,P012738,P012740,10.384,6,17,11
67,PAM,P012739,P012740,10.95,3,16,13
68,MIL,P000796,P001518,2.2,-2,4,6
68,MIL,P000796,P002812,6.934,-1,12,13
68,MIL,P000796,P002849,23.184,6,58,52
68,MIL,P000796,P005670,2.384,-2,4,6
68,MIL,P000796,P006509,5.666,-7,9,16
68,MIL,P000796,P007032,27.116,5,63,58
68,MIL,P000796,P007201,17.433,9,45,36
68,MIL,P000796,P007831,27.117,6,63,57
68,MIL,P000796,P009960,2.516,1,5,4
68,MIL,P000796,P011205,3.65,-3,5,8
68,MIL,P001518,P002812,7.217,-8,6,14
68,MIL,P001518,P005670,7.167,-8,6,14
68,MIL,P001518,P006509,6.217,-6,5,11
68,MIL,P001518,P007032,0.183,0,0,0
68,MIL,P001518,P007831,1.183,-2,1,3
68,MIL,P001518,P009960,0.183,0,0,0
68,MIL,P001518,P011205,5.25,-6,2,8
68,MIL,P002812,P002849,4.367,5,13,8
68,MIL,P002812,P005670,9.667,-8,11,19
68,MIL,P002812,P006509,7.684,-10,5,15
68,MIL,P002812,P007032,5.35,-1,8,9
68,MIL,P002812,P007201,3.483,-6,0,6
68,MIL,P002812,P007831,7.383,1,14,13
68,MIL,P002812,P011205,8.183,-8,7,15
68,MIL,P002849,P005670,1.7,2,5,3
68,MIL,P002849,P006509,1.183,-6,0,6
68,MIL,P002849,P007032,22.767,6,58,52
68,MIL,P002849,P007201,15.6,11,45,34
68,MIL,P002849,P007831,24.184,9,63,54
68,MIL,P002849,P011205,4.883,-1,10,11
68,MIL,P005670,P006509,6.834,-8,5,13
68,MIL,P005670,P007201,0.8,-2,0,2
68,MIL,P005670,P007831,2.833,0,6,6
68,MIL,P005670,P011205,7.283,-6,7,13
68,MIL,P006509,P007032,6.866,-9,10,19
68,MIL,P006509,P007201,3.967,-6,5,11
68,MIL,P006509,P007831,5.55,-6,10,16
68,MIL,P006509,P009960,4.833,-1,10,11
68,MIL,P006509,P011205,6.0,-9,1,10
68,MIL,P007032,P007201,20.6,5,50,45
68,MIL,P007032,P007831,28.967,4,68,64
68,MIL,P007032,P009960,4.833,-1,10,11
68,MIL,P007032,P011205,4.45,-5,5,10
68,MIL,P007201,P007831,19.75,7,50,43
68,MIL,P007201,P009960,2.317,-2,5,7
68,MIL,P007201,P011205,1.65,-4,0,4
68,MIL,P007831,P009960,4.65,-1,10,11
68,MIL,P007831,P011205,5.783,-2,11,13
68,VIR,P001133,P001844,20.184,-9,45,54
68,VIR,P001133,P003048,19.684,-15,38,53
68,VIR,P001133,P003527,10.117,18,26,8
68,VIR,P001133,P004007,10.451,10,26,16
68,VIR,P001133,P006739,5.133,5,7,2
68,VIR,P001133,P009549,19.367,-5,44,49
68,VIR,P001133,P010781,9.084,9,27,18
68,VIR,P001133,P011192,2.883,4,5,1
68,VIR,P001133,PBCN,16.633,-5,38,43
68,VIR,P001844,P003048,20.451,-13,44,57
68,VIR,P001844,P003527,7.817,7,17,10
68,VIR,P001844,P004007,8.201,-1,17,18
68,VIR,P001844,P009549,14.467,-13,30,43
68,VIR,P001844,P010781,10.084,2,23,21
68,VIR,P001844,P012714,1.05,-3,0,3
68,VIR,P001844,PBCN,14.75,-6,36,42
68,VIR,P003048,P003527,6.1,5,10,5
68,VIR,P003048,P004007,7.767,2,15,13
68,VIR,P003048,P006739,2.683,1,2,1
68,VIR,P003048,P009549,16.3,-12,32,44
68,VIR,P003048,P010781,7.517,0,16,16
68,VIR,P003048,P011192,1.666,2,2,0
68,VIR,P003048,PBCN,15.3,-10,33,43
68,VIR,P003527,P004007,17.934,19,39,20
68,VIR,P003527,P006739,8.867,6,17,11
68,VIR,P003527,P009549,5.084,7,16,9
68,VIR,P003527,P010781,12.867,16,31,15
68,VIR,P003527,P011192,8.766,8,16,8
68,VIR,P003527,P012714,6.934,-1,12,13
68,VIR,P003527,PBCN,2.45,3,8,5
68,VIR,P004007,P006739,7.4,8,13,5
68,VIR,P004007,P009549,6.434,4,17,13
68,VIR,P004007,P010781,10.534,11,26,15
68,VIR,P004007,P011192,8.216,10,15,5
68,VIR,P004007,P012714,5.467,1,8,7
68,VIR,P006739,P009549,3.1,1,6,5
68,VIR,P006739,P011192,7.533,6,14,8
68,VIR,P006739,P012714,5.134,2,12,10
68,VIR,P006739,PBCN,2.95,-1,5,6
68,VIR,P009549,P010781,4.117,5,12,7
68,VIR,P009549,P011192,0.35,0,1,1
68,VIR,P009549,P012714,2.017,0,4,4
68,VIR,P009549,PBCN,14.3,-7,30,37
68,VIR,P010781,P011192,1.233,2,2,0
68,VIR,P010781,P012714,1.8,-3,0,3
68,VIR,P010781,PBCN,3.3,2,11,9
68,VIR,P011192,P012714,4.217,2,9,7
68,VIR,P011192,PBCN,0.2,-2,0,2
68,VIR,P012714,PBCN,1.117,-2,3,5
69,ASV,P002100,P003526,9.083,-3,17,20
69,ASV,P002100,P004194,10.066,-1,21,22
69,ASV,P002100,P006568,5.65,0,13,13
69,ASV,P002100,P011225,8.166,-7,9,16
69,ASV,P002100,P012080,11.649,-7,20,27
69,ASV,P002100,P012729,11.699,-10,14,24
69,ASV,P002100,P012730,7.283,-9,6,15
69,ASV,P002100,PKIR,5.8,-3,8,11
69,ASV,P003526,P004194,18.15,6,39,33
69,ASV,P003526,P006568,14.016,3,29,26
69,ASV,P003526,P011225,14.7,0,25,25
69,ASV,P003526,P012080,19.1,5,40,35
69,ASV,P003526,P012729,7.584,-1,13,14
69,ASV,P003526,P012730,3.45,-4,3,7
69,ASV,P003526,PKIR,0.317,2,2,0
69,ASV,P004194,P006568,20.65,0,38,38
69,ASV,P004194,P011225,21.4,-4,34,38
69,ASV,P004194,P012080,24.15,-1,45,46
69,ASV,P004194,P012729,6.7,-1,12,13
69,ASV,P004194,PKIR,8.284,-3,11,14
69,ASV,P006568,P011225,22.234,17,47,30
69,ASV,P006568,P012080,24.15,13,50,37
69,ASV,P006568,P012729,5.367,15,17,2
69,ASV,P006568,PKIR,12.001,12,26,14
69,ASV,P011225,P012080,24.8,9,46,37
69,ASV,P011225,P012729,13.633,4,23,19
69,ASV,P011225,P012730,3.733,-5,2,7
69,ASV,P011225,PKIR,13.334,10,26,16
69,ASV,P012080,P012729,15.517,10,33,23
69,ASV,P012080,P012730,4.783,-6,4,10
69,ASV,P012080,PKIR,13.051,9,26,17
69,ASV,P012729,P012730,7.283,-9,6,15
69,ASV,P012729,PKIR,9.617,12,22,10
69,ASV,P012730,PKIR,2.6,-3,3,6
69,BER,P003958,P006251,5.284,3,11,8
69,BER,P003958,P006919,20.418,8,41,33
69,BER,P003958,P007550,0.033,0,0,0
69,BER,P003958,P008173,10.084,-5,18,23
69,BER,P003958,P008211,15.668,7,30,23
69,BER,P003958,P008384,4.067,-2,5,7
69,BER,P003958,P008967,3.301,-9,5,14
69,BER,P003958,P010791,5.9,-6,8,14
69,BER,P003958,P011934,13.385,1,27,26
69,BER,P003958,P012720,23.985,1,45,44
69,BER,P003958,P012721,1.283,2,2,0
69,BER,P006251,P006919,6.401,2,13,11
69,BER,P006251,P007550,4.9,5,10,5
69,BER,P006251,P008173,7.05,-9,8,17
69,BER,P006251,P008211,7.417,4,13,9
69,BER,P006251,P008384,13.033,-4,18,22
69,BER,P006251,P008967,13.134,-8,17,25
69,BER,P006251,P010791,3.617,3,6,3
69,BER,P006251,P011934,3.883,-12,2,14
69,BER,P006251,P012720,6.367,4,14,10
69,BER,P006251,P012721,6.65,4,12,8
69,BER,P006919,P008173,9.501,-8,18,26
69,BER,P006919,P008211,11.967,17,25,8
69,BER,P006919,P008384,0.05,0,0,0
69,BER,P006919,P008967,1.184,-3,2,5
69,BER,P006919,P010791,7.017,-7,10,17
69,BER,P006919,P011934,9.234,11,22,11
69,BER,P006919,P012720,20.368,8,41,33
69,BER,P007550,P008384,4.933,5,10,5
69,BER,P007550,P008967,3.817,4,7,3
69,BER,P007550,P012720,1.116,1,3,2
69,BER,P007550,P012721,4.933,5,10,5
69,BER,P008173,P008384,7.683,-6,8,14
69,BER,P008173,P008967,7.05,-9,8,17
69,BER,P008173,P010791,8.284,-5,12,17
69,BER,P008173,P011934,7.6,-11,12,23
69,BER,P008173,P012720,10.034,-5,18,23
69,BER,P008173,P012721,1.25,2,2,0
69,BER,P008211,P008384,4.484,-5,5,10
69,BER,P008211,P008967,5.434,-8,7,15
69,BER,P008211,P010791,1.233,2,2,0
69,BER,P008211,P011934,9.668,0,17,17
69,BER,P008211,P012720,13.851,8,27,19
69,BER,P008211,P012721,1.75,-1,2,3
69,BER,P008384,P008967,13.767,-6,18,24
69,BER,P008384,P010791,2.5,4,4,0
69,BER,P008384,P011934,6.667,-16,5,21
69,BER,P008384,P012720,3.283,0,5,5
69,BER,P008384,P012721,7.933,6,14,8
69,BER,P008967,P010791,3.617,3,6,3
69,BER,P008967,P011934,7.117,-19,7,26
69,BER,P008967,P012720,1.484,-8,2,10
69,BER,P008967,P012721,5.567,3,9,6
69,BER,P010791,P012720,5.9,-6,8,14
69,BER,P011934,P012720,11.518,2,24,22
69,BER,P012720,P012721,2.366,3,5,2
70,MUN,P001557,P003583,13.983,3,30,27
70,MUN,P001557,P005478,2.583,0,2,2
70,MUN,P001557,P007056,18.783,13,47,34
70,MUN,P001557,P007639,0.433,2,2,0
70,MUN,P001557,P007975,11.75,4,32,28
70,MUN,P001557,P008985,12.716,17,29,12
70,MUN,P001557,P010391,8.4,6,19,13
70,MUN,P001557,P011941,3.633,1,5,4
70,MUN,P001557,P011987,13.183,6,30,24
70,MUN,P003583,P007056,15.966,-3,30,33
70,MUN,P003583,P007975,6.783,-10,15,25
70,MUN,P003583,P008985,9.183,7,15,8
70,MUN,P003583,P010391,3.0,-10,0,10
70,MUN,P003583,P011987,14.949,1,30,29
70,MUN,P005478,P007639,1.6,2,4,2
70,MUN,P005478,P007975,7.801,-1,14,15
70,MUN,P005478,P008985,7.267,12,25,13
70,MUN,P005478,P010391,8.134,7,15,8
70,MUN,P005478,P011941,10.001,7,23,16
70,MUN,P005478,P011987,7.501,12,25,13
70,MUN,P005478,P012123,1.517,-3,0,3
70,MUN,P007056,P007639,4.417,-4,10,14
70,MUN,P007056,P007975,19.216,-7,52,59
70,MUN,P007056,P008985,12.316,15,27,12
70,MUN,P007056,P010391,15.433,-7,37,44
70,MUN,P007056,P011941,4.666,0,15,15
70,MUN,P007056,P011987,19.782,-5,42,47
70,MUN,P007056,P012123,3.017,-2,8,10
70,MUN,P007639,P007975,5.584,-4,12,16
70,MUN,P007639,P008985,1.6,2,4,2
70,MUN,P007639,P010391,4.85,-2,12,14
70,MUN,P007639,P011987,2.567,-2,4,6
70,MUN,P007639,P012123,3.017,-2,8,10
70,MUN,P007975,P008985,6.6,10,24,14
70,MUN,P007975,P010391,19.767,-10,39,49
70,MUN,P007975,P011941,11.3,-1,27,28
70,MUN,P007975,P011987,14.733,-8,41,49
70,MUN,P007975,P012123,4.534,-5,8,13
70,MUN,P008985,P010391,6.933,18,25,7
70,MUN,P008985,P011941,5.667,10,21,11
70,MUN,P008985,P011987,16.05,17,38,21
70,MUN,P010391,P011941,12.367,5,28,23
70,MUN,P010391,P011987,10.85,-2,25,27
70,MUN,P010391,P012123,4.534,-5,8,13
70,MUN,P011941,P011987,9.517,9,33,24
70,MUN,P011941,P012123,1.517,-3,0,3
70,PAR,P000956,P003983,3.45,-4,2,6
70,PAR,P000956,P007400,9.75,1,14,13
70,PAR,P000956,P008987,9.75,1,14,13
70,PAR,P000956,P012096,9.75,1,14,13
70,PAR,P000956,P012742,6.3,5,12,7
70,PAR,P003983,P004172,0.033,0,0,0
70,PAR,P003983,P007400,8.716,-4,16,20
70,PAR,P003983,P007673,7.683,-3,21,24
70,PAR,P003983,P008987,11.616,-3,27,30
70,PAR,P003983,P011051,2.733,-2,7,9
70,PAR,P003983,P012096,8.0,-2,17,19
70,PAR,P003983,P012742,3.383,5,15,10
70,PAR,P003983,P012743,0.85,1,3,2
70,PAR,P004058,P004172,2.95,-7,3,10
70,PAR,P004058,P007400,11.017,4,27,23
70,PAR,P004058,P007673,11.017,4,27,23
70,PAR,P004058,P008987,13.284,3,30,27
70,PAR,P004058,P011051,0.683,-6,0,6
70,PAR,P004058,P012096,0.683,-6,0,6
70,PAR,P004058,P012742,2.95,-7,3,10
70,PAR,P004058,P012743,13.284,3,30,27
70,PAR,P004172,P007400,0.766,-4,0,4
70,PAR,P004172,P007673,1.716,-4,0,4
70,PAR,P004172,P008987,3.033,-5,3,8
70,PAR,P004172,P011051,1.633,-6,0,6
70,PAR,P004172,P012096,1.633,-6,0,6
70,PAR,P004172,P012742,3.9,-7,3,10
70,PAR,P004172,P012743,3.0,-5,3,8
70,PAR,P007400,P007673,22.967,-8,53,61
70,PAR,P007400,P008987,30.083,-6,60,66
70,PAR,P007400,P011051,7.0,3,22,19
70,PAR,P007400,P012096,15.317,-4,25,29
70,PAR,P007400,P012742,13.217,5,32,27
70,PAR,P007400,P012743,13.967,1,35,34
70,PAR,P007673,P008987,22.75,-10,53,63
70,PAR,P007673,P011051,7.95,3,22,19
70,PAR,P007673,P012096,8.934,-8,18,26
70,PAR,P007673,P012742,10.284,-3,27,30
70,PAR,P007673,P012743,13.967,1,35,34
70,PAR,P008987,P011051,3.883,0,11,11
70,PAR,P008987,P012096,16.467,-6,30,36
70,PAR,P008987,P012742,15.267,2,35,33
70,PAR,P008987,P012743,14.867,0,33,33
70,PAR,P011051,P012096,3.383,-3,6,9
70,PAR,P011051,P012742,5.9,-1,15,16
70,PAR,P011051,P012743,1.367,0,5,5
70,PAR,P012096,P012742,15.233,-2,34,36
70,PAR,P012742,P012743,3.634,-1,8,9
71,PAN,P001926,P002328,27.983,10,59,49
71,PAN,P001926,P003842,22.283,8,50,42
71,PAN,P001926,P007553,3.867,0,9,9
71,PAN,P001926,P007866,27.366,2,52,50
71,PAN,P001926,P007947,5.684,-2,13,15
71,PAN,P001926,P008084,1.967,4,7,3
71,PAN,P001926,P011204,23.466,10,46,36
71,PAN,P001926,P011221,3.183,-2,0,2
71,PAN,P001926,P011826,1.35,-4,0,4
71,PAN,P001926,P012774,0.183,-2,0,2
71,PAN,P002328,P003842,28.033,10,58,48
71,PAN,P002328,P007553,3.867,0,9,9
71,PAN,P002328,P007866,33.116,4,60,56
71,PAN,P002328,P007947,11.567,-4,18,22
71,PAN,P002328,P008084,1.967,4,7,3
71,PAN,P002328,P011204,27.133,12,52,40
71,PAN,P002328,P011209,1.217,0,3,3
71,PAN,P002328,P011221,3.183,-2,0,2
71,PAN,P002328,P012774,2.266,-2,2,4
71,PAN,P003842,P007866,29.883,7,59,52
71,PAN,P003842,P007947,8.2,-3,10,13
71,PAN,P003842,P008084,0.5,1,1,0
71,PAN,P003842,P011204,25.3,10,52,42
71,PAN,P003842,P011209,1.217,0,3,3
71,PAN,P003842,P011826,1.35,-4,0,4
71,PAN,P003842,P012774,2.766,-1,3,4
71,PAN,P007553,P007866,4.967,-7,7,14
71,PAN,P007553,P007947,6.934,-3,14,17
71,PAN,P007553,P008084,5.034,1,12,11
71,PAN,P007553,P012774,3.067,-3,5,8
71,PAN,P007866,P007947,13.167,-10,17,27
71,PAN,P007866,P008084,3.567,-2,6,8
71,PAN,P007866,P011204,28.483,8,52,44
71,PAN,P007866,P011209,1.217,0,3,3
71,PAN,P007866,P011221,3.183,-2,0,2
71,PAN,P007866,P011826,1.35,-4,0,4
71,PAN,P007866,P012774,5.833,-4,8,12
71,PAN,P007947,P008084,5.534,2,13,11
71,PAN,P007947,P011204,3.8,-2,3,5
71,PAN,P007947,P012774,5.65,-2,8,10
71,PAN,P008084,P012774,3.567,-2,6,8
71,PAN,P011204,P011209,1.217,0,3,3
71,PAN,P011204,P011221,3.183,-2,0,2
71,PAN,P011204,P011826,1.35,-4,0,4
71,ZAL,P002329,P002676,20.0,0,38,38
71,ZAL,P002329,P003210,2.966,1,6,5
71,ZAL,P002329,P003211,12.416,3,25,22
71,ZAL,P002329,P005504,6.933,1,14,13
71,ZAL,P002329,P007109,11.699,2,19,17
71,ZAL,P002329,P010390,15.682,0,25,25
71,ZAL,P002329,P011218,21.149,2,41,39
71,ZAL,P002329,P011965,4.916,0,8,8
71,ZAL,P002329,P012715,11.099,3,24,21
71,ZAL,P002676,P003210,2.017,-2,4,6
71,ZAL,P002676,P003211,19.683,-2,36,38
71,ZAL,P002676,P005504,10.1,-1,18,19
71,ZAL,P002676,P007109,16.867,-5,27,32
71,ZAL,P002676,P010390,16.633,-8,23,31
71,ZAL,P002676,P011218,27.15,-9,46,55
71,ZAL,P002676,P011965,5.366,6,15,9
71,ZAL,P002676,P012715,14.316,1,29,28
71,ZAL,P003210,P005504,4.15,-1,10,11
71,ZAL,P003210,P007109,2.85,-2,4,6
71,ZAL,P003210,P011218,4.983,-1,10,11
71,ZAL,P003210,P012715,2.966,1,6,5
71,ZAL,P003211,P005504,7.899,1,11,10
71,ZAL,P003211,P007109,9.616,2,17,15
71,ZAL,P003211,P010390,9.133,-7,11,18
71,ZAL,P003211,P011218,14.833,-2,27,29
71,ZAL,P003211,P011965,8.582,4,17,13
71,ZAL,P003211,P012715,12.566,1,24,23
71,ZAL,P005504,P007109,5.817,-4,9,13
71,ZAL,P005504,P011218,8.95,-1,18,19
71,ZAL,P005504,P011965,4.666,0,6,6
71,ZAL,P005504,P012715,5.949,1,10,9
71,ZAL,P007109,P010390,10.316,-1,16,17
71,ZAL,P007109,P011218,16.183,-1,28,29
71,ZAL,P007109,P011965,3.733,-2,4,6
71,ZAL,P007109,P012715,4.183,3,8,5
71,ZAL,P010390,P011218,16.666,-7,24,31
71,ZAL,P010390,P011965,1.583,-1,2,3
71,ZAL,P010390,P012715,5.583,-4,7,11
71,ZAL,P011218,P011965,0.383,3,3,0
71,ZAL,P011218,P012715,14.299,0,27,27
71,ZAL,P011965,P012715,5.099,6,13,7
72,BAR,P000925,P002939,16.2,-15,28,43
72,BAR,P000925,P003478,4.25,4,9,5
72,BAR,P000925,P004866,10.4,-15,17,32
72,BAR,P000925,P006435,14.65,-11,26,37
72,BAR,P000925,P007464,1.55,-4,2,6
72,BAR,P000925,P009992,1.55,-4,2,6
72,BAR,P000925,P011244,10.85,-19,16,35
72,BAR,P000925,P012745,5.35,4,12,8
72,BAR,P002939,P003196,6.616,1,13,12
72,BAR,P002939,P003478,5.133,10,15,5
72,BAR,P002939,P004866,13.833,-17,24,41
72,BAR,P002939,P006435,17.366,-7,34,41
72,BAR,P002939,P007464,6.4,-6,10,16
72,BAR,P002939,P009992,6.4,-6,10,16
72,BAR,P002939,P010641,0.95,1,3,2
72,BAR,P002939,P011244,14.1,-21,19,40
72,BAR,P002939,P012745,8.066,8,20,12
72,BAR,P003196,P003478,8.633,-5,15,20
72,BAR,P003196,P004866,11.984,-8,20,28
72,BAR,P003196,P006435,5.283,5,15,10
72,BAR,P003196,P007464,15.034,-17,22,39
72,BAR,P003196,P007519,13.501,-14,20,34
72,BAR,P003196,P009992,6.717,-7,9,16
72,BAR,P003196,P011244,2.3,-3,0,3
72,BAR,P003196,P012745,10.4,-4,18,22
72,BAR,P003478,P004866,4.917,-5,6,11
72,BAR,P003478,P006435,5.133,10,15,5
72,BAR,P003478,P007464,5.6,-12,6,18
72,BAR,P003478,P007519,7.75,-11,9,20
72,BAR,P003478,P012745,10.116,5,21,16
72,BAR,P004866,P006435,14.8,-16,26,42
72,BAR,P004866,P007464,7.784,-6,15,21
72,BAR,P004866,P007519,8.551,-6,13,19
72,BAR,P004866,P009992,2.3,-2,5,7
72,BAR,P004866,P011244,9.3,-15,14,29
72,BAR,P004866,P012745,5.667,-2,8,10
72,BAR,P006435,P007464,2.35,2,7,5
72,BAR,P006435,P007519,2.567,1,7,6
72,BAR,P006435,P011244,9.3,-15,14,29
72,BAR,P006435,P012745,8.283,7,20,13
72,BAR,P007464,P007519,13.867,-10,24,34
72,BAR,P007464,P009992,11.95,-6,21,27
72,BAR,P007464,P010641,3.683,5,10,5
72,BAR,P007464,P011244,7.533,-2,12,14
72,BAR,P007464,P012745,5.317,-8,7,15
72,BAR,P007519,P009992,5.55,0,11,11
72,BAR,P007519,P010641,2.733,4,7,3
72,BAR,P007519,P011244,2.733,4,7,3
72,BAR,P007519,P012745,7.684,-8,10,18
72,BAR,P009992,P010641,3.683,5,10,5
72,BAR,P009992,P011244,7.533,-2,12,14
72,BAR,P009992,P012745,2.117,-2,4,6
72,BAR,P010641,P011244,3.683,5,10,5
72,BAS,P003198,P004603,10.75,12,28,16
72,BAS,P003198,P007230,18.633,12,42,30
72,BAS,P003198,P008072,2.283,-4,3,7
72,BAS,P003198,P008850,2.783,-8,1,9
72,BAS,P003198,P009048,24.083,20,61,41
72,BAS,P003198,P010444,15.767,7,36,29
72,BAS,P003198,P011948,19.567,13,50,37
72,BAS,P003198,P012201,13.784,7,32,25
72,BAS,P003198,P012765,7.55,1,15,14
72,BAS,P004603,P007230,9.033,-2,16,18
72,BAS,P004603,P008850,5.4,-1,10,11
72,BAS,P004603,P009048,9.916,7,25,18
72,BAS,P004603,P011948,7.384,8,19,11
72,BAS,P004603,P012201,13.217,4,32,28
72,BAS,P004603,P012765,10.3,0,22,22
72,BAS,P007230,P008072,0.5,2,2,0
72,BAS,P007230,P008850,6.233,1,12,11
72,BAS,P007230,P009048,21.215,10,48,38
72,BAS,P007230,P010444,20.299,20,51,31
72,BAS,P007230,P011948,19.099,21,50,29
72,BAS,P007230,P012201,14.816,12,34,22
72,BAS,P007230,P012765,9.5,4,21,17
72,BAS,P008072,P008850,1.783,-6,1,7
72,BAS,P008072,P012201,2.283,-4,3,7
72,BAS,P008072,P012765,2.283,-4,3,7
72,BAS,P008850,P009048,1.833,0,2,2
72,BAS,P008850,P010444,0.833,2,2,0
72,BAS,P008850,P012201,7.016,-3,13,16
72,BAS,P008850,P012765,6.183,-5,11,16
72,BAS,P009048,P010444,17.966,13,44,31
72,BAS,P009048,P011948,19.933,18,53,35
72,BAS,P009048,P012201,12.866,12,34,22
72,BAS,P009048,P012765,3.716,0,9,9
72,BAS,P010444,P011948,17.266,16,46,30
72,BAS,P010444,P012201,9.483,15,24,9
72,BAS,P010444,P012765,3.25,7,9,2
72,BAS,P011948,P012201,10.634,14,30,16
72,BAS,P011948,P012765,4.717,6,12,6
72,BAS,P012201,P012765,15.833,3,34,31
73,IST,P004554,P004888,12.899,0,22,22
73,IST,P004554,P006372,3.167,-2,7,9
73,IST,P004554,P006590,4.533,-1,8,9
73,IST,P004554,P007200,14.933,-4,27,31
73,IST,P004554,P009664,12.966,2,23,21
73,IST,P004554,P011078,14.533,0,29,29
73,IST,P004554,P011981,1.233,-3,0,3
73,IST,P004888,P006372,3.75,-6,5,11
73,IST,P004888,P006590,13.55,1,27,26
73,IST,P004888,P007200,30.416,-11,61,72
73,IST,P004888,P009664,25.283,-13,44,57
73,IST,P004888,P011078,29.633,-6,61,67
73,IST,P004888,P011981,15.734,-2,38,40
73,IST,P004888,P012710,8.067,-3,14,17
73,IST,P006372,P006590,1.45,-5,2,7
73,IST,P006372,P007200,6.917,-8,12,20
73,IST,P006372,P009664,4.134,-1,8,9
73,IST,P006372,P011078,6.917,-8,12,20
73,IST,P006372,P012710,1.333,-2,2,4
73,IST,P006590,P007200,12.583,-9,23,32
73,IST,P006590,P009664,8.566,-11,6,17
73,IST,P006590,P011078,11.8,-4,23,27
73,IST,P006590,P011981,9.234,-2,19,21
73,IST,P006590,P012710,6.284,-1,12,13
73,IST,P007200,P009664,26.7,-14,48,62
73,IST,P007200,P011078,30.383,-13,62,75
73,IST,P007200,P011981,14.95,-5,34,39
73,IST,P007200,P012710,5.45,-4,9,13
73,IST,P009664,P011078,26.767,-12,50,62
73,IST,P009664,P011981,9.934,-7,21,28
73,IST,P009664,P012710,1.65,0,0,0
73,IST,P011078,P011981,14.767,-4,32,36
73,IST,P011078,P012710,4.4,-1,7,8
73,IST,P011981,P012710,5.084,-1,12,13
73,MIL,P000796,P001518,2.4,4,6,2
73,MIL,P000796,P002812,3.967,0,9,9
73,MIL,P000796,P002849,17.816,3,43,40
73,MIL,P000796,P005670,0.15,0,0,0
73,MIL,P000796,P006509,8.366,6,21,15
73,MIL,P000796,P006701,0.633,2,5,3
73,MIL,P000796,P007032,19.433,-8,39,47
73,MIL,P000796,P007201,15.8,-6,31,37
73,MIL,P000796,P007831,20.749,5,50,45
73,MIL,P000796,P009960,4.583,-1,6,7
73,MIL,P000796,P011205,9.499,3,22,19
73,MIL,P001518,P002812,1.117,0,2,2
73,MIL,P001518,P005670,2.983,2,4,2
73,MIL,P001518,P006509,5.8,4,10,6
73,MIL,P001518,P007032,0.417,-2,0,2
73,MIL,P001518,P009960,4.683,4,8,4
73,MIL,P001518,P011205,5.8,4,10,6
73,MIL,P002812,P006509,1.717,-3,2,5
73,MIL,P002812,P007032,2.25,3,7,4
73,MIL,P002812,P007201,2.85,0,7,7
73,MIL,P002812,P007831,2.25,3,7,4
73,MIL,P002812,P011205,1.717,-3,2,5
73,MIL,P002849,P006509,14.016,23,43,20
73,MIL,P002849,P006701,0.483,2,5,3
73,MIL,P002849,P007032,17.1,-2,39,41
73,MIL,P002849,P007201,12.95,-6,24,30
73,MIL,P002849,P007831,28.566,17,73,56
73,MIL,P002849,P009960,11.267,14,30,16
73,MIL,P002849,P011205,12.066,17,35,18
73,MIL,P005670,P006509,3.133,2,4,2
73,MIL,P005670,P006701,0.15,0,0,0
73,MIL,P005670,P009960,3.133,2,4,2
73,MIL,P005670,P011205,2.983,2,4,2
73,MIL,P006509,P006701,0.633,2,5,3
73,MIL,P006509,P007032,4.917,-2,11,13
73,MIL,P006509,P007201,0.6,-3,0,3
73,MIL,P006509,P007831,14.016,23,43,20
73,MIL,P006509,P009960,17.533,14,40,26
73,MIL,P006509,P011205,19.333,14,41,27
73,MIL,P006701,P007831,0.483,2,5,3
73,MIL,P006701,P009960,0.15,0,0,0
73,MIL,P007032,P007201,15.2,-3,31,34
73,MIL,P007032,P007831,20.033,0,46,46
73,MIL,P007032,P009960,6.117,-3,11,14
73,MIL,P007032,P011205,4.133,-7,8,15
73,MIL,P007201,P007831,15.2,-3,31,34
73,MIL,P007201,P011205,0.6,-3,0,3
73,MIL,P007831,P009960,11.95,13,30,17
73,MIL,P007831,P011205,12.749,16,35,19
73,MIL,P009960,P011205,15.516,9,31,22
74,TEL,P005145,P009622,7.85,-4,18,22
74,TEL,P005145,P009783,7.85,-4,18,22
74,TEL,P005145,P009863,7.85,-4,18,22
74,TEL,P005145,P011199,5.583,-3,12,15
74,TEL,P005145,P011214,2.267,-1,6,7
74,TEL,P007990,P009622,2.533,-3,0,3
74,TEL,P007990,P009783,2.533,-3,0,3
74,TEL,P007990,P009863,0.033,0,0,0
74,TEL,P007990,P011199,2.5,-3,0,3
74,TEL,P007990,P011214,0.033,0,0,0
74,TEL,P007990,P011219,0.933,-1,0,1
74,TEL,P007990,P011971,1.567,-2,0,2
74,TEL,P009622,P009783,22.618,-5,40,45
74,TEL,P009622,P009863,21.035,5,48,43
74,TEL,P009622,P011193,6.017,-4,9,13
74,TEL,P009622,P011199,13.501,-1,20,21
74,TEL,P009622,P011214,13.834,3,33,30
74,TEL,P009622,P011219,7.484,-1,15,16
74,TEL,P009622,P011971,9.185,3,19,16
74,TEL,P009622,P012744,9.751,7,18,11
74,TEL,P009783,P009863,24.034,4,48,44
74,TEL,P009783,P011193,7.816,-2,12,14
74,TEL,P009783,P011199,13.467,-5,20,25
74,TEL,P009783,P011214,13.55,6,28,22
74,TEL,P009783,P011219,6.867,2,10,8
74,TEL,P009783,P011971,5.884,-2,8,10
74,TEL,P009783,P012744,7.917,5,16,11
74,TEL,P009863,P011193,12.249,1,23,22
74,TEL,P009863,P011199,10.967,-2,20,22
74,TEL,P009863,P011214,20.433,12,47,35
74,TEL,P009863,P011219,14.35,5,29,24
74,TEL,P009863,P011971,11.2,6,27,21
74,TEL,P009863,P012744,7.917,5,16,11
74,TEL,P011193,P011199,4.3,0,4,4
74,TEL,P011193,P011214,11.833,3,26,23
74,TEL,P011193,P011219,11.4,5,28,23
74,TEL,P011193,P011971,13.15,-1,24,25
74,TEL,P011193,P012744,2.167,2,2,0
74,TEL,P011199,P011219,1.4,-1,0,1
74,TEL,P011199,P011971,5.984,0,6,6
74,TEL,P011199,P012744,4.834,3,6,3
74,TEL,P011214,P011219,14.05,9,34,25
74,TEL,P011214,P011971,11.75,4,30,26
74,TEL,P011214,P012744,5.25,4,12,8
74,TEL,P011219,P011971,9.784,6,28,22
74,TEL,P011971,P012744,2.5,2,2,0
74,ULK,P005844,P006661,7.317,-7,4,11
74,ULK,P005844,P006961,9.784,-7,10,17
74,ULK,P005844,P008962,17.684,-5,24,29
74,ULK,P005844,P009849,12.834,2,20,18
74,ULK,P005844,P011052,13.551,2,22,20
74,ULK,P005844,P011157,5.234,4,10,6
74,ULK,P005844,P011201,3.2,-7,2,9
74,ULK,P005844,P011980,4.2,-2,4,6
74,ULK,P006661,P006961,23.984,-4,46,50
74,ULK,P006661,P008962,28.867,-7,53,60
74,ULK,P006661,P009849,2.95,-2,0,2
74,ULK,P006661,P011052,6.417,-4,12,16
74,ULK,P006661,P011157,21.383,0,49,49
74,ULK,P006661,P011201,6.5,1,15,14
74,ULK,P006661,P011980,18.05,-5,33,38
74,ULK,P006961,P008962,27.384,-4,52,56
74,ULK,P006961,P009849,4.334,0,6,6
74,ULK,P006961,P011052,8.484,-3,11,14
74,ULK,P006961,P011157,18.967,3,42,39
74,ULK,P006961,P011201,6.5,1,15,14
74,ULK,P006961,P011980,13.167,-2,26,28
74,ULK,P008962,P009849,13.317,0,20,20
74,ULK,P008962,P011052,16.784,-2,32,34
74,ULK,P008962,P011157,25.85,4,59,55
74,ULK,P008962,P011201,6.5,1,15,14
74,ULK,P008962,P011980,20.55,-7,37,44
74,ULK,P009849,P011052,11.301,2,20,18
74,ULK,P009849,P011157,6.317,2,10,8
74,ULK,P009849,P011980,5.283,-4,4,8
74,ULK,P011052,P011157,9.067,0,20,20
74,ULK,P011052,P011980,4.6,-3,11,14
74,ULK,P011157,P011201,3.3,8,13,5
74,ULK,P011157,P011980,16.35,-5,33,38
75,OLY,P001255,P006302,6.1,3,16,13
75,OLY,P001255,P006589,2.667,3,9,6
75,OLY,P001255,P008811,27.983,0,56,56
75,OLY,P001255,P008829,29.884,1,63,62
75,OLY,P001255,P008855,25.55,2,51,49
75,OLY,P001255,P010392,1.45,2,7,5
75,OLY,P001255,P010612,29.434,1,58,57
75,OLY,P006302,P006589,3.65,0,6,6
75,OLY,P006302,P008811,11.567,5,33,28
75,OLY,P006302,P008829,14.334,3,37,34
75,OLY,P006302,P008855,3.55,-2,8,10
75,OLY,P006302,P010392,9.133,4,25,21
75,OLY,P006302,P010612,5.217,1,14,13
75,OLY,P006302,P011983,7.317,6,17,11
75,OLY,P006589,P008829,6.317,3,15,12
75,OLY,P006589,P008855,2.667,3,9,6
75,OLY,P006589,P010392,3.65,0,6,6
75,OLY,P006589,P010612,2.667,3,9,6
75,OLY,P006589,P011983,3.65,0,6,6
75,OLY,P008811,P008829,32.684,0,71,71
75,OLY,P008811,P008855,25.55,-5,48,53
75,OLY,P008811,P010392,6.05,4,24,20
75,OLY,P008811,P010612,26.767,-2,49,51
75,OLY,P008811,P011983,3.667,6,11,5
75,OLY,P008829,P008855,27.451,-4,55,59
75,OLY,P008829,P010392,8.934,2,28,26
75,OLY,P008829,P010612,29.551,1,58,57
75,OLY,P008829,P011983,7.317,6,17,11
75,OLY,P008855,P010392,3.367,-2,13,15
75,OLY,P008855,P010612,24.334,0,44,44
75,OLY,P008855,P011983,0.867,0,0,0
75,OLY,P010392,P010612,0.234,0,0,0
75,OLY,P010392,P011983,6.45,6,17,11
75,RED,P000848,P002553,14.133,-1,33,34
75,RED,P000848,P004720,13.667,-12,18,30
75,RED,P000848,P006436,17.799,1,46,45
75,RED,P000848,P007960,17.15,-8,31,39
75,RED,P000848,P008966,8.05,-8,14,22
75,RED,P000848,P009035,20.566,-12,35,47
75,RED,P000848,P012044,17.699,1,37,36
75,RED,P000848,PJDR,16.8,-5,42,47
75,RED,P002553,P004720,6.5,-4,8,12
75,RED,P002553,P006436,14.833,9,44,35
75,RED,P002553,P008966,6.733,2,18,16
75,RED,P002553,P009035,11.75,-6,19,25
75,RED,P002553,P012044,18.166,10,46,36
75,RED,P002553,PJDR,13.217,10,40,30
75,RED,P004720,P006436,0.333,0,0,0
75,RED,P004720,P007960,10.567,-7,13,20
75,RED,P004720,P008966,4.95,-9,3,12
75,RED,P004720,P009035,12.117,-2,18,20
75,RED,P004720,P011964,0.333,0,0,0
75,RED,P004720,P012044,13.117,-2,18,20
75,RED,P004720,PJDR,6.684,-8,6,14
75,RED,P006436,P007960,8.249,-1,18,19
75,RED,P006436,P008966,9.899,6,27,21
75,RED,P006436,P009035,10.516,-9,20,29
75,RED,P006436,P011964,0.333,0,0,0
75,RED,P006436,P012044,12.782,9,38,29
75,RED,P006436,PJDR,18.316,9,55,46
75,RED,P007960,P008966,7.783,-5,12,17
75,RED,P007960,P009035,10.7,-3,19,22
75,RED,P007960,P011964,0.333,0,0,0
75,RED,P007960,P012044,7.55,-1,10,11
75,RED,P007960,PJDR,11.6,-7,21,28
75,RED,P008966,P011964,0.333,0,0,0
75,RED,P008966,P012044,7.733,2,18,16
75,RED,P008966,PJDR,12.583,0,28,28
75,RED,P009035,P012044,15.316,-4,23,27
75,RED,P009035,PJDR,9.567,-8,18,26
75,RED,P012044,PJDR,11.233,13,34,21
76,MAD,P001392,P003108,1.767,-1,4,5
76,MAD,P001392,P004887,5.334,5,14,9
76,MAD,P001392,P005791,11.933,15,36,21
76,MAD,P001392,P005928,15.5,21,46,25
76,MAD,P001392,P006540,13.8,20,41,21
76,MAD,P001392,P009005,15.5,21,46,25
76,MAD,P001392,PBMT,3.467,0,9,9
76,MAD,P001392,PTGB,1.767,-1,4,5
76,MAD,P003108,P004887,8.3,-13,6,19
76,MAD,P003108,P005791,0.65,-2,0,2
76,MAD,P003108,P005928,2.567,-6,3,9
76,MAD,P003108,P006540,2.65,-6,5,11
76,MAD,P003108,P010357,3.3,-8,5,13
76,MAD,P003108,PBMT,11.6,-21,11,32
76,MAD,P003108,PCVM,7.266,-14,4,18
76,MAD,P003108,PTGB,8.3,-13,6,19
76,MAD,P004887,P005928,3.984,8,12,4
76,MAD,P004887,P006540,6.05,7,12,5
76,MAD,P004887,P009005,6.117,11,15,4
76,MAD,P004887,P010357,7.483,4,18,14
76,MAD,P004887,PBMT,15.85,-5,27,32
76,MAD,P004887,PCVM,16.149,-5,23,28
76,MAD,P004887,PTGB,18.333,-4,29,33
76,MAD,P005791,P005928,14.6,22,47,25
76,MAD,P005791,P006540,13.6,22,45,23
76,MAD,P005791,P009005,13.15,22,45,23
76,MAD,P005791,P010357,2.3,0,2,2
76,MAD,P005791,PBMT,1.85,0,2,2
76,MAD,P005791,PCVM,0.85,0,0,0
76,MAD,P005791,PTGB,2.867,9,11,2
76,MAD,P005928,P006540,17.351,25,55,30
76,MAD,P005928,P009005,17.134,30,57,27
76,MAD,P005928,P010357,3.367,-4,5,9
76,MAD,P005928,PBMT,5.067,-3,10,13
76,MAD,P005928,PTGB,2.434,11,13,2
76,MAD,P006540,P009005,17.567,32,55,23
76,MAD,P006540,P010357,4.733,-9,7,16
76,MAD,P006540,PBMT,2.65,-6,5,11
76,MAD,P006540,PCVM,4.949,-2,7,9
76,MAD,P006540,PTGB,5.85,9,16,7
76,MAD,P009005,PBMT,1.7,1,5,4
76,MAD,P009005,PCVM,2.133,3,3,0
76,MAD,P009005,PTGB,3.767,12,14,2
76,MAD,P010357,PBMT,10.35,1,23,22
76,MAD,P010357,PCVM,9.066,2,20,18
76,MAD,P010357,PTGB,9.133,6,20,14
76,MAD,PBMT,PCVM,13.516,-7,20,27
76,MAD,PBMT,PTGB,15.35,-4,24,28
76,MAD,PCVM,PTGB,16.999,-5,23,28
76,MCO,P004790,P005985,5.983,2,14,12
76,MCO,P004790,P009754,1.9,-1,2,3
76,MCO,P004790,P010588,4.083,3,12,9
76,MCO,P004790,P011196,6.433,-5,12,17
76,MCO,P004790,P011212,8.816,-1,20,21
76,MCO,P004790,P011226,5.983,2,14,12
76,MCO,P004790,P011231,6.433,-5,12,17
76,MCO,P004790,P012515,1.7,-1,4,5
76,MCO,P004790,P012709,6.433,-5,12,17
76,MCO,P004790,PLCZ,1.9,-1,2,3
76,MCO,P005985,P009754,16.683,7,36,29
76,MCO,P005985,P010588,18.866,-9,41,50
76,MCO,P005985,P011196,8.067,0,13,13
76,MCO,P005985,P011212,12.55,2,23,21
76,MCO,P005985,P011226,18.583,-8,37,45
76,MCO,P005985,P011231,5.917,9,11,2
76,MCO,P005985,P012515,5.55,-3,12,15
76,MCO,P005985,PLCZ,14.533,-4,29,33
76,MCO,P009754,P010588,10.533,-1,25,26
76,MCO,P009754,P011196,4.25,9,9,0
76,MCO,P009754,P011212,4.25,9,9,0
76,MCO,P009754,P011226,10.233,0,21,21
76,MCO,P009754,P011231,4.25,9,9,0
76,MCO,P009754,P012515,2.2,-2,6,8
76,MCO,P009754,PLCZ,12.433,-2,27,29
76,MCO,P010588,P011196,6.167,-18,7,25
76,MCO,P010588,P011212,11.383,-16,19,35
76,MCO,P010588,P011226,18.549,-11,38,49
76,MCO,P010588,P011231,1.217,-5,2,7
76,MCO,P010588,P012515,6.283,-3,14,17
76,MCO,P010588,P012709,4.017,-9,5,14
76,MCO,P010588,PLCZ,13.366,-3,29,32
76,MCO,P011196,P011212,20.65,-17,30,47
76,MCO,P011196,P011226,8.75,-16,7,23
76,MCO,P011196,P011231,15.7,-4,25,29
76,MCO,P011196,P012709,12.583,-17,17,34
76,MCO,P011212,P011226,12.316,-14,17,31
76,MCO,P011212,P011231,15.7,-4,25,29
76,MCO,P011212,P012515,2.383,0,4,4
76,MCO,P011212,P012709,12.583,-17,17,34
76,MCO,P011212,PLCZ,2.833,-2,4,6
76,MCO,P011226,P011231,3.8,-3,2,5
76,MCO,P011226,P012515,2.433,-1,6,7
76,MCO,P011226,P012709,4.933,-7,3,10
76,MCO,P011226,PLCZ,11.416,-2,23,25
76,MCO,P011231,P012709,9.783,-13,14,27
76,MCO,P012515,PLCZ,4.583,-2,10,12
77,BAR,P000925,P002939,20.3,11,45,34
77,BAR,P000925,P003196,2.967,-2,3,5
77,BAR,P000925,P003478,9.033,4,24,20
77,BAR,P000925,P004866,18.667,3,37,34
77,BAR,P000925,P006435,16.234,11,35,24
77,BAR,P000925,P007519,1.667,-2,3,5
77,BAR,P000925,P011244,8.45,6,19,13
77,BAR,P000925,P012745,10.55,5,26,21
77,BAR,P002939,P003196,6.216,6,12,6
77,BAR,P002939,P003478,14.699,0,30,30
77,BAR,P002939,P004866,21.916,11,46,35
77,BAR,P002939,P006435,19.583,11,38,27
77,BAR,P002939,P010641,2.883,-6,0,6
77,BAR,P002939,P011244,11.333,0,19,19
77,BAR,P002939,P012745,15.466,11,38,27
77,BAR,P003196,P003478,9.2,1,18,17
77,BAR,P003196,P004866,10.5,2,17,15
77,BAR,P003196,P006435,11.434,1,19,18
77,BAR,P003196,P007464,2.7,-2,4,6
77,BAR,P003196,P007519,10.701,-5,17,22
77,BAR,P003196,P012745,13.95,3,26,23
77,BAR,P003478,P004866,8.516,0,19,19
77,BAR,P003478,P006435,9.9,1,19,18
77,BAR,P003478,P007464,3.9,-4,4,8
77,BAR,P003478,P007519,7.617,-3,12,15
77,BAR,P003478,P010641,4.083,-8,0,8
77,BAR,P003478,P011244,3.2,-6,0,6
77,BAR,P003478,P012745,19.116,3,42,39
77,BAR,P004866,P006435,17.684,7,32,25
77,BAR,P004866,P007519,4.284,-4,5,9
77,BAR,P004866,P011244,8.45,6,19,13
77,BAR,P004866,P012745,14.783,3,29,26
77,BAR,P006435,P007519,8.001,-3,13,16
77,BAR,P006435,P010641,2.883,-6,0,6
77,BAR,P006435,P011244,11.333,0,19,19
77,BAR,P006435,P012745,13.284,10,29,19
77,BAR,P007464,P007519,3.9,-4,4,8
77,BAR,P007464,P010641,1.2,-2,0,2
77,BAR,P007464,P011244,0.317,0,0,0
77,BAR,P007464,P012745,3.583,-4,4,8
77,BAR,P007519,P010641,1.2,-2,0,2
77,BAR,P007519,P011244,0.317,0,0,0
77,BAR,P007519,P012745,9.917,-5,14,19
77,BAR,P010641,P011244,3.2,-6,0,6
77,BAR,P010641,P012745,0.883,-2,0,2
77,PAM,P000556,P003960,7.2,0,12,12
77,PAM,P000556,P004863,12.617,-2,18,20
77,PAM,P000556,P005356,13.751,-8,20,28
77,PAM,P000556,P007870,11.867,-4,18,22
77,PAM,P000556,P009101,0.733,2,2,0
77,PAM,P000556,P010393,9.5,5,17,12
77,PAM,P000556,P010568,6.183,4,10,6
77,PAM,P000556,P011982,0.45,0,2,2
77,PAM,P000556,P012738,3.567,-7,3,10
77,PAM,P000556,P012739,1.6,2,2,0
77,PAM,P003960,P004863,4.133,2,9,7
77,PAM,P003960,P005356,15.25,-10,24,34
77,PAM,P003960,P007870,6.834,-1,13,14
77,PAM,P003960,P009101,2.883,6,6,0
77,PAM,P003960,P010393,3.25,4,9,5
77,PAM,P003960,P010568,14.0,-6,21,27
77,PAM,P003960,P011982,10.383,-6,15,21
77,PAM,P003960,P012738,1.233,-5,0,5
77,PAM,P003960,P012739,7.366,0,11,11
77,PAM,P004863,P005356,12.133,-6,17,23
77,PAM,P004863,P006643,0.233,0,2,2
77,PAM,P004863,P007870,11.166,-2,17,19
77,PAM,P004863,P009101,0.233,0,2,2
77,PAM,P004863,P010393,10.633,7,20,13
77,PAM,P004863,P010568,2.383,4,4,0
77,PAM,P004863,P011982,1.349,-2,0,2
77,PAM,P004863,P012738,4.116,-9,3,12
77,PAM,P005356,P007870,15.384,-5,27,32
77,PAM,P005356,P010393,8.25,3,16,13
77,PAM,P005356,P010568,15.634,-2,31,33
77,PAM,P005356,P011982,14.366,-2,29,31
77,PAM,P005356,P012738,9.2,-2,19,21
77,PAM,P005356,P012739,8.9,0,17,17
77,PAM,P006643,P007870,2.233,-2,4,6
77,PAM,P006643,P009101,1.266,-2,2,4
77,PAM,P006643,P010568,6.283,-6,8,14
77,PAM,P006643,P011982,5.25,-4,8,12
77,PAM,P006643,P012738,6.516,-6,10,16
77,PAM,P006643,P012739,4.283,-4,6,10
77,PAM,P007870,P009101,3.233,2,6,4
77,PAM,P007870,P010393,7.933,5,14,9
77,PAM,P007870,P010568,12.734,7,24,17
77,PAM,P007870,P011982,8.734,5,18,13
77,PAM,P007870,P012738,7.75,-1,15,16
77,PAM,P009101,P010568,3.916,4,6,2
77,PAM,P009101,P011982,2.15,4,4,0
77,PAM,P009101,P012738,1.266,-2,2,4
77,PAM,P009101,P012739,0.916,2,2,0
77,PAM,P010393,P010568,2.383,4,4,0
77,PAM,P010393,P011982,0.583,0,0,0
77,PAM,P010568,P011982,19.967,0,39,39
77,PAM,P010568,P012738,11.15,1,24,23
77,PAM,P010568,P012739,14.099,-2,25,27
77,PAM,P011982,P012738,11.333,1,26,25
77,PAM,P011982,P012739,12.499,-4,23,27
77,PAM,P012738,P012739,6.733,-2,14,16
78,ASV,P000229,P003526,3.933,-4,7,11
78,ASV,P000229,P004194,6.016,-8,9,17
78,ASV,P000229,P006568,2.633,-2,4,6
78,ASV,P000229,P011225,7.182,-1,13,14
78,ASV,P000229,P012080,2.45,-8,3,11
78,ASV,P000229,P012729,4.916,-3,10,13
78,ASV,P000229,P012730,5.699,-5,9,14
78,ASV,P000229,PKIR,5.699,-5,9,14
78,ASV,P003526,P004194,24.45,-8,52,60
78,ASV,P003526,P006568,10.816,-5,22,27
78,ASV,P003526,P011225,23.183,-6,49,55
78,ASV,P003526,P012080,17.551,-7,40,47
78,ASV,P003526,P012729,9.3,0,22,22
78,ASV,P003526,P012730,1.917,-5,4,9
78,ASV,P003526,PKIR,6.65,3,12,9
78,ASV,P004194,P006568,10.816,-5,22,27
78,ASV,P004194,P011225,30.499,-7,59,66
78,ASV,P004194,P012080,22.784,-4,48,52
78,ASV,P004194,P012729,14.533,3,30,27
78,ASV,P004194,P012730,4.0,-9,6,15
78,ASV,P004194,PKIR,13.966,2,22,20
78,ASV,P006568,P011225,10.816,-5,22,27
78,ASV,P006568,P012080,8.183,-3,18,21
78,ASV,P011225,P012080,22.484,3,50,47
78,ASV,P011225,P012729,16.666,15,39,24
78,ASV,P011225,P012730,7.4,1,18,17
78,ASV,P011225,PKIR,17.366,12,34,22
78,ASV,P011386,P012080,3.65,-2,7,9
78,ASV,P011386,P012729,3.65,-2,7,9
78,ASV,P011386,P012730,3.65,-2,7,9
78,ASV,P011386,PKIR,3.65,-2,7,9
78,ASV,P012080,P012729,16.067,-1,34,35
78,ASV,P012080,P012730,7.717,-8,16,24
78,ASV,P012080,PKIR,13.45,2,24,22
78,ASV,P012729,P012730,8.233,2,19,17
78,ASV,P012729,PKIR,17.699,6,35,29
78,ASV,P012730,PKIR,10.316,-2,21,23
78,BAS,P003198,P004603,11.416,-8,20,28
78,BAS,P003198,P008850,3.383,1,8,7
78,BAS,P003198,P009048,14.566,-12,20,32
78,BAS,P003198,P010444,19.016,7,38,31
78,BAS,P003198,P011064,2.067,-2,2,4
78,BAS,P003198,P011948,17.266,11,40,29
78,BAS,P003198,P012201,24.266,5,46,41
78,BAS,P003198,P012765,17.416,6,34,28
78,BAS,P004603,P008850,5.867,3,15,12
78,BAS,P004603,P009048,10.733,-8,20,28
78,BAS,P004603,P010444,3.083,-3,6,9
78,BAS,P004603,P011948,9.05,-2,21,23
78,BAS,P004603,P012201,11.3,-3,23,26
78,BAS,P004603,P012765,6.083,-3,11,14
78,BAS,P008850,P009048,7.284,-5,18,23
78,BAS,P008850,P010444,5.817,-6,14,20
78,BAS,P008850,P011948,8.301,-4,21,25
78,BAS,P008850,P012201,11.684,-3,29,32
78,BAS,P008850,P012765,4.4,2,11,9
78,BAS,P009048,P010444,18.55,-3,39,42
78,BAS,P009048,P011064,5.067,5,13,8
78,BAS,P009048,P011948,19.5,2,49,47
78,BAS,P009048,P012201,23.117,-5,47,52
78,BAS,P009048,P012765,5.983,-6,6,12
78,BAS,P010444,P011064,5.067,5,13,8
78,BAS,P010444,P011948,23.95,15,61,46
78,BAS,P010444,P012201,25.617,13,59,46
78,BAS,P010444,P012765,13.7,12,30,18
78,BAS,P011064,P011948,3.0,7,11,4
78,BAS,P011064,P012201,5.067,5,13,8
78,BAS,P011948,P012201,26.834,19,70,51
78,BAS,P011948,P012765,11.767,16,31,15
78,BAS,P012201,P012765,19.783,9,41,32
79,PAN,P001926,P002328,7.799,18,24,6
79,PAN,P001926,P003842,17.466,19,39,20
79,PAN,P001926,P007553,6.783,-4,14,18
79,PAN,P001926,P007866,19.882,18,49,31
79,PAN,P001926,P007947,15.916,-4,26,30
79,PAN,P001926,P008084,2.25,-2,2,4
79,PAN,P001926,P011204,17.017,16,38,22
79,PAN,P001926,P011221,2.117,-1,2,3
79,PAN,P001926,P012774,7.766,0,18,18
79,PAN,P002328,P003842,11.199,17,32,15
79,PAN,P002328,P007553,12.016,0,27,27
79,PAN,P002328,P007866,22.998,16,58,42
79,PAN,P002328,P007947,3.866,-5,5,10
79,PAN,P002328,P011204,20.599,20,58,38
79,PAN,P002328,P011209,0.533,2,4,2
79,PAN,P002328,P011221,0.55,1,3,2
79,PAN,P002328,P012774,14.632,-1,33,34
79,PAN,P003842,P007866,16.232,20,40,20
79,PAN,P003842,P007947,12.399,-2,18,20
79,PAN,P003842,P008084,2.25,-2,2,4
79,PAN,P003842,P011204,15.05,21,38,17
79,PAN,P003842,P011221,2.667,0,5,5
79,PAN,P003842,P012774,7.333,-1,14,15
79,PAN,P007553,P007866,18.516,-4,41,45
79,PAN,P007553,P007947,6.75,-7,13,20
79,PAN,P007553,P011204,15.35,-3,32,35
79,PAN,P007553,P011209,0.2,2,2,0
79,PAN,P007553,P012774,14.449,0,35,35
79,PAN,P007866,P007947,14.232,-7,24,31
79,PAN,P007866,P011204,28.616,19,70,51
79,PAN,P007866,P011209,0.533,2,4,2
79,PAN,P007866,P012774,19.315,0,46,46
79,PAN,P007947,P008084,2.25,-2,2,4
79,PAN,P007947,P011204,10.167,-5,13,18
79,PAN,P007947,P011221,2.667,0,5,5
79,PAN,P007947,P012774,8.349,-4,18,22
79,PAN,P008084,P012774,2.25,-2,2,4
79,PAN,P011204,P011209,0.533,2,4,2
79,PAN,P011204,P011221,2.117,-1,2,3
79,PAN,P011204,P012774,13.483,3,33,30
79,PAN,P011209,P012774,0.333,0,2,2
79,PAN,P011221,P012774,0.55,1,3,2
79,VIR,P001133,P001844,15.032,-9,30,39
79,VIR,P001133,P003048,23.616,1,52,51
79,VIR,P001133,P003527,4.049,-5,9,14
79,VIR,P001133,P004007,4.5,-2,8,10
79,VIR,P001133,P006739,16.366,4,32,28
79,VIR,P001133,P009549,14.682,-5,29,34
79,VIR,P001133,P010781,8.415,-9,19,28
79,VIR,P001133,P011192,12.032,-3,20,23
79,VIR,P001133,P012714,4.532,-3,4,7
79,VIR,P001133,PBCN,25.564,3,57,54
79,VIR,P001844,P003048,11.2,-8,23,31
79,VIR,P001844,P003527,3.783,-2,10,12
79,VIR,P001844,P004007,3.167,-4,6,10
79,VIR,P001844,P006739,2.967,-2,6,8
79,VIR,P001844,P009549,6.183,-5,11,16
79,VIR,P001844,P010781,6.066,-8,13,21
79,VIR,P001844,P011192,2.016,1,3,2
79,VIR,P001844,P012714,2.883,-5,3,8
79,VIR,P001844,PBCN,12.499,-6,27,33
79,VIR,P003048,P003527,1.1,-3,0,3
79,VIR,P003048,P004007,3.167,-4,6,10
79,VIR,P003048,P006739,13.3,5,28,23
79,VIR,P003048,P009549,12.083,2,27,25
79,VIR,P003048,P010781,5.466,-7,10,17
79,VIR,P003048,P011192,7.383,4,16,12
79,VIR,P003048,PBCN,21.549,2,46,44
79,VIR,P003527,P004007,4.9,-3,6,9
79,VIR,P003527,P006739,4.15,-2,4,6
79,VIR,P003527,P009549,3.566,-11,2,13
79,VIR,P003527,P010781,7.699,-10,16,26
79,VIR,P003527,P011192,6.633,-7,8,15
79,VIR,P003527,P012714,6.7,-4,11,15
79,VIR,P003527,PBCN,4.816,-1,14,15
79,VIR,P004007,P006739,8.45,-2,12,14
79,VIR,P004007,P010781,0.95,-3,2,5
79,VIR,P004007,P011192,6.233,-1,8,9
79,VIR,P004007,P012714,6.233,-1,8,9
79,VIR,P006739,P009549,4.733,4,9,5
79,VIR,P006739,P011192,12.816,0,21,21
79,VIR,P006739,P012714,7.216,-3,8,11
79,VIR,P006739,PBCN,12.066,4,24,20
79,VIR,P009549,P010781,5.649,-9,9,18
79,VIR,P009549,P011192,1.35,-6,0,6
79,VIR,P009549,P012714,1.233,-2,0,2
79,VIR,P009549,PBCN,13.649,0,29,29
79,VIR,P010781,P011192,2.483,-5,4,9
79,VIR,P010781,P012714,2.55,-2,7,9
79,VIR,P010781,PBCN,8.982,-3,24,27
79,VIR,P011192,P012714,8.582,-2,12,14
79,VIR,P011192,PBCN,9.732,3,20,17
79,VIR,P012714,PBCN,4.999,-6,7,13
80,BER,P003958,P006251,5.801,-3,10,13
80,BER,P003958,P006919,21.8,8,49,41
80,BER,P003958,P007550,6.284,2,10,8
80,BER,P003958,P008211,21.233,3,49,46
80,BER,P003958,P008384,1.684,-2,4,6
80,BER,P003958,P008967,5.717,-3,10,13
80,BER,P003958,P010791,12.2,3,30,27
80,BER,P003958,P011934,9.516,5,19,14
80,BER,P003958,P012720,25.833,7,55,48
80,BER,P006251,P006819,0.967,-5,0,5
80,BER,P006251,P006919,5.701,-7,7,14
80,BER,P006251,P007025,2.767,-9,3,12
80,BER,P006251,P007550,7.251,-7,9,16
80,BER,P006251,P008211,9.018,-12,13,25
80,BER,P006251,P008384,12.185,-17,17,34
80,BER,P006251,P008967,9.651,-9,14,23
80,BER,P006251,P010791,4.734,-9,7,16
80,BER,P006251,P011934,6.784,-6,8,14
80,BER,P006251,P012720,8.285,-8,12,20
80,BER,P006819,P006919,0.9,-3,0,3
80,BER,P006819,P007025,0.75,-5,0,5
80,BER,P006819,P007550,0.967,-5,0,5
80,BER,P006819,P008384,0.067,-2,0,2
80,BER,P006819,P012720,0.217,0,0,0
80,BER,P006919,P007025,0.683,-3,0,3
80,BER,P006919,P007550,7.767,-1,10,11
80,BER,P006919,P008211,18.817,2,44,42
80,BER,P006919,P008384,4.134,-6,7,13
80,BER,P006919,P010791,14.067,-1,33,34
80,BER,P006919,P011934,10.7,5,19,14
80,BER,P006919,P012720,21.767,10,47,37
80,BER,P007025,P007550,0.75,-5,0,5
80,BER,P007025,P008384,2.084,-6,3,9
80,BER,P007025,P008967,2.017,-4,3,7
80,BER,P007025,P011934,2.017,-4,3,7
80,BER,P007550,P008384,5.434,-4,7,11
80,BER,P007550,P008967,3.767,-2,5,7
80,BER,P007550,P011934,8.7,0,11,11
80,BER,P007550,P012720,5.484,2,8,6
80,BER,P008211,P008384,5.401,-11,9,20
80,BER,P008211,P008967,4.7,-3,8,11
80,BER,P008211,P010791,16.934,-6,37,43
80,BER,P008211,P011934,5.583,3,13,10
80,BER,P008211,P012720,23.85,0,51,51
80,BER,P008384,P008967,5.784,-6,8,14
80,BER,P008384,P010791,5.401,-11,9,20
80,BER,P008384,P011934,6.367,-6,8,14
80,BER,P008384,P012720,2.867,-5,4,9
80,BER,P008967,P011934,5.6,-6,8,14
80,BER,P008967,P012720,4.7,-3,8,11
80,BER,P010791,P012720,14.4,0,32,32
80,BER,P011934,P012720,9.933,5,19,14
80,PAR,P000956,P003983,19.751,20,52,32
80,PAR,P000956,P004058,3.633,-4,2,6
80,PAR,P000956,P004172,3.2,1,5,4
80,PAR,P000956,P007400,7.884,2,19,17
80,PAR,P000956,P008987,16.0,6,33,27
80,PAR,P000956,P009212,4.717,4,12,8
80,PAR,P000956,P012096,13.834,10,33,23
80,PAR,P000956,P012742,22.3,14,47,33
80,PAR,P000956,P012743,15.817,11,37,26
80,PAR,P003983,P004172,7.633,2,18,16
80,PAR,P003983,P007400,9.634,3,26,23
80,PAR,P003983,P008987,14.151,9,36,27
80,PAR,P003983,P009212,4.717,4,12,8
80,PAR,P003983,P012096,15.584,11,40,29
80,PAR,P003983,P012742,15.95,20,41,21
80,PAR,P003983,P012743,12.184,15,35,20
80,PAR,P004058,P007400,7.4,-2,14,16
80,PAR,P004058,P007673,7.4,-2,14,16
80,PAR,P004058,P008987,11.033,-6,16,22
80,PAR,P004058,P012742,3.633,-4,2,6
80,PAR,P004058,P012743,11.033,-6,16,22
80,PAR,P004172,P007400,7.067,0,16,16
80,PAR,P004172,P007673,0.667,0,2,2
80,PAR,P004172,P008987,5.134,-1,13,14
80,PAR,P004172,P012096,9.017,2,20,18
80,PAR,P004172,P012742,3.35,4,6,2
80,PAR,P007400,P007673,7.4,-2,14,16
80,PAR,P007400,P008987,14.967,-5,31,36
80,PAR,P007400,P012096,12.617,5,32,27
80,PAR,P007400,P012742,4.083,2,8,6
80,PAR,P007400,P012743,10.684,1,24,23
80,PAR,P007673,P008987,8.067,-2,16,18
80,PAR,P007673,P012096,0.667,0,2,2
80,PAR,P007673,P012742,0.667,0,2,2
80,PAR,P007673,P012743,7.4,-2,14,16
80,PAR,P008987,P012096,8.184,-1,19,20
80,PAR,P008987,P012742,16.25,8,35,27
80,PAR,P008987,P012743,20.35,4,41,37
80,PAR,P009212,P012096,4.717,4,12,8
80,PAR,P009212,P012742,4.717,4,12,8
80,PAR,P012096,P012742,11.117,8,24,16
80,PAR,P012096,P012743,2.867,5,10,5
80,PAR,P012742,P012743,12.533,8,27,19
81,MUN,P001557,P003583,18.617,-9,30,39
81,MUN,P001557,P005478,5.167,-7,7,14
81,MUN,P001557,P007056,18.033,0,31,31
81,MUN,P001557,P007975,9.284,-7,17,24
81,MUN,P001557,P008985,12.333,-3,18,21
81,MUN,P001557,P010391,3.45,-1,3,4
81,MUN,P001557,P011941,1.417,-4,2,6
81,MUN,P001557,P011987,18.167,-9,32,41
81,MUN,P003583,P005478,3.817,-7,8,15
81,MUN,P003583,P007056,19.75,0,29,29
81,MUN,P003583,P007975,8.517,-3,17,20
81,MUN,P003583,P008985,15.35,-4,20,24
81,MUN,P003583,P010391,6.967,-2,7,9
81,MUN,P003583,P011987,21.467,-3,37,40
81,MUN,P003583,P012123,0.383,0,0,0
81,MUN,P005478,P007056,4.566,1,9,8
81,MUN,P005478,P007639,2.133,4,4,0
81,MUN,P005478,P007975,4.734,-13,4,17
81,MUN,P005478,P008985,8.933,4,20,16
81,MUN,P005478,P010391,10.083,1,20,19
81,MUN,P005478,P011941,3.151,-7,3,10
81,MUN,P005478,P011987,10.584,-16,17,33
81,MUN,P005478,P012123,1.5,4,4,0
81,MUN,P007056,P007639,5.933,8,18,10
81,MUN,P007056,P007975,5.7,3,13,10
81,MUN,P007056,P008985,25.049,6,45,39
81,MUN,P007056,P010391,16.166,8,30,22
81,MUN,P007056,P011941,0.5,0,2,2
81,MUN,P007056,P011987,20.983,2,37,35
81,MUN,P007056,P012123,6.316,8,18,10
81,MUN,P007639,P007975,0.633,0,0,0
81,MUN,P007639,P008985,7.433,12,22,10
81,MUN,P007639,P010391,8.066,12,22,10
81,MUN,P007639,P011987,0.633,0,0,0
81,MUN,P007639,P012123,7.433,12,22,10
81,MUN,P007975,P008985,0.15,0,0,0
81,MUN,P007975,P010391,1.3,-3,0,3
81,MUN,P007975,P011941,1.434,-7,0,7
81,MUN,P007975,P011987,10.584,-10,17,27
81,MUN,P008985,P010391,20.683,11,41,30
81,MUN,P008985,P011941,2.217,0,5,5
81,MUN,P008985,P011987,18.3,-2,31,33
81,MUN,P008985,P012123,7.816,12,22,10
81,MUN,P010391,P011941,2.234,-3,3,6
81,MUN,P010391,P011987,10.567,-3,16,19
81,MUN,P010391,P012123,7.816,12,22,10
81,MUN,P011941,P011987,3.651,-7,5,12
81,ZAL,P002329,P002676,2.933,-2,2,4
81,ZAL,P002329,P003210,12.799,10,32,22
81,ZAL,P002329,P003211,13.817,12,34,22
81,ZAL,P002329,P005504,12.65,14,35,21
81,ZAL,P002329,P007109,9.932,-7,13,20
81,ZAL,P002329,P007513,4.183,-1,5,6
81,ZAL,P002329,P010390,1.867,2,2,0
81,ZAL,P002329,P011218,7.117,0,13,13
81,ZAL,P002329,P011965,2.516,0,6,6
81,ZAL,P002329,P012715,14.05,12,38,26
81,ZAL,P002676,P003210,9.415,-11,9,20
81,ZAL,P002676,P003211,8.7,-5,13,18
81,ZAL,P002676,P005504,11.533,-5,15,20
81,ZAL,P002676,P007109,22.316,-11,31,42
81,ZAL,P002676,P007513,11.75,-5,18,23
81,ZAL,P002676,P010390,6.283,2,13,11
81,ZAL,P002676,P011218,13.317,-1,19,20
81,ZAL,P002676,P011965,1.217,1,3,2
81,ZAL,P002676,P012715,2.4,-7,1,8
81,ZAL,P003210,P003211,13.583,7,36,29
81,ZAL,P003210,P005504,15.749,13,40,27
81,ZAL,P003210,P007109,11.431,-12,11,23
81,ZAL,P003210,P007513,4.349,-3,5,8
81,ZAL,P003210,P010390,0.333,0,0,0
81,ZAL,P003210,P011218,1.633,0,0,0
81,ZAL,P003210,P011965,0.033,0,0,0
81,ZAL,P003210,P012715,11.067,8,31,23
81,ZAL,P003211,P005504,12.517,19,40,21
81,ZAL,P003211,P007109,9.633,-9,13,22
81,ZAL,P003211,P007513,0.15,0,0,0
81,ZAL,P003211,P010390,2.4,0,2,2
81,ZAL,P003211,P011218,5.167,0,6,6
81,ZAL,P003211,P011965,1.25,1,3,2
81,ZAL,P003211,P012715,13.251,7,33,26
81,ZAL,P005504,P007109,15.516,-6,20,26
81,ZAL,P005504,P007513,10.033,-10,10,20
81,ZAL,P005504,P011218,9.2,-5,7,12
81,ZAL,P005504,P011965,0.867,1,3,2
81,ZAL,P005504,P012715,8.667,15,30,15
81,ZAL,P007109,P007513,15.583,-6,23,29
81,ZAL,P007109,P010390,6.133,2,13,11
81,ZAL,P007109,P011218,18.45,-5,28,33
81,ZAL,P007109,P011965,3.333,1,9,8
81,ZAL,P007109,P012715,5.533,-11,7,18
81,ZAL,P007513,P010390,5.75,4,13,9
81,ZAL,P007513,P011218,11.234,-3,18,21
81,ZAL,P007513,P011965,0.05,0,0,0
81,ZAL,P007513,P012715,0.05,0,0,0
81,ZAL,P010390,P011218,7.467,4,15,11
81,ZAL,P010390,P011965,0.05,0,0,0
81,ZAL,P010390,P012715,1.717,2,2,0
81,ZAL,P011218,P011965,2.083,0,6,6
81,ZAL,P011218,P012715,4.8,-2,8,10
81,ZAL,P011965,P012715,2.133,0,6,6
82,ASV,P000229,P003526,1.367,-3,2,5
82,ASV,P000229,P004194,11.584,3,25,22
82,ASV,P000229,P006568,0.033,-2,0,2
82,ASV,P000229,P011225,12.684,2,25,23
82,ASV,P000229,P011386,3.483,-2,5,7
82,ASV,P000229,P012080,6.9,-10,10,20
82,ASV,P000229,P012729,19.317,-4,34,38
82,ASV,P000229,P012730,7.7,-5,9,14
82,ASV,P000229,PKIR,14.2,5,26,21
82,ASV,P003526,P004194,21.851,-5,56,61
82,ASV,P003526,P006568,14.301,2,32,30
82,ASV,P003526,P011225,22.285,4,63,59
82,ASV,P003526,P011386,0.567,0,2,2
82,ASV,P003526,P012080,23.852,-1,65,66
82,ASV,P003526,P012729,11.202,2,40,38
82,ASV,P003526,P012730,0.917,-2,0,2
82,ASV,P003526,PKIR,0.334,-1,0,1
82,ASV,P004194,P006568,12.967,-3,25,28
82,ASV,P004194,P011225,32.168,0,77,77
82,ASV,P004194,P012080,25.518,-9,62,71
82,ASV,P004194,P012729,20.018,2,54,52
82,ASV,P004194,PKIR,7.834,8,17,9
82,ASV,P006568,P011225,17.067,3,35,32
82,ASV,P006568,P011386,2.4,-1,3,4
82,ASV,P006568,P012080,16.9,1,35,34
82,ASV,P006568,P012729,4.25,4,10,6
82,ASV,P006568,PKIR,0.95,0,0,0
82,ASV,P011225,P011386,2.35,3,5,2
82,ASV,P011225,P012080,28.601,-1,72,73
82,ASV,P011225,P012729,24.885,10,66,56
82,ASV,P011225,P012730,1.517,0,2,2
82,ASV,P011225,PKIR,9.851,7,19,12
82,ASV,P011386,P012080,2.183,1,5,4
82,ASV,P011386,P012729,5.983,-1,10,11
82,ASV,P011386,P012730,3.483,-2,5,7
82,ASV,P011386,PKIR,3.483,-2,5,7
82,ASV,P012080,P012729,19.301,-4,51,55
82,ASV,P012080,P012730,2.75,-3,2,5
82,ASV,P012080,PKIR,3.067,-2,2,4
82,ASV,P012729,P012730,7.7,-5,9,14
82,ASV,P012729,PKIR,15.484,4,26,22
82,ASV,P012730,PKIR,6.733,-3,9,12
82,MUN,P001557,P003583,9.849,2,33,31
82,MUN,P001557,P004508,17.633,-1,27,28
82,MUN,P001557,P005478,0.1,-2,0,2
82,MUN,P001557,P006760,2.816,0,17,17
82,MUN,P001557,P007056,17.248,10,53,43
82,MUN,P001557,P007639,0.033,0,0,0
82,MUN,P001557,P007975,12.883,-4,23,27
82,MUN,P001557,P008985,9.799,7,22,15
82,MUN,P001557,P010391,22.849,-4,55,59
82,MUN,P001557,P011941,12.15,1,17,16
82,MUN,P001557,P011987,1.5,-1,5,6
82,MUN,P003583,P004508,6.3,1,13,12
82,MUN,P003583,P006760,4.333,2,20,18
82,MUN,P003583,P007056,23.533,13,66,53
82,MUN,P003583,P007975,5.317,-2,7,9
82,MUN,P003583,P008985,22.45,12,50,38
82,MUN,P003583,P010391,14.283,-1,40,41
82,MUN,P003583,P011987,16.467,1,35,34
82,MUN,P004508,P006760,2.717,-1,4,5
82,MUN,P004508,P007056,9.416,5,20,15
82,MUN,P004508,P007975,9.083,-9,11,20
82,MUN,P004508,P008985,2.316,4,4,0
82,MUN,P004508,P010391,15.484,-7,24,31
82,MUN,P004508,P011941,12.583,-4,17,21
82,MUN,P005478,P007056,0.1,-2,0,2
82,MUN,P005478,P008985,0.1,-2,0,2
82,MUN,P005478,P010391,0.1,-2,0,2
82,MUN,P006760,P007056,11.016,2,38,36
82,MUN,P006760,P007639,0.033,0,0,0
82,MUN,P006760,P007975,8.583,-1,20,21
82,MUN,P006760,P008985,6.917,3,18,15
82,MUN,P006760,P010391,2.816,0,17,17
82,MUN,P006760,P011941,4.784,-2,9,11
82,MUN,P006760,P011987,10.917,1,25,24
82,MUN,P007056,P007639,0.033,0,0,0
82,MUN,P007056,P007975,11.383,-1,27,28
82,MUN,P007056,P008985,22.833,10,50,40
82,MUN,P007056,P010391,20.749,2,58,56
82,MUN,P007056,P011941,7.283,-3,12,15
82,MUN,P007056,P011987,18.534,0,40,40
82,MUN,P007639,P010391,0.033,0,0,0
82,MUN,P007975,P010391,12.583,-8,22,30
82,MUN,P007975,P011941,8.233,-7,13,20
82,MUN,P007975,P011987,4.467,0,9,9
82,MUN,P008985,P010391,13.6,3,28,25
82,MUN,P008985,P011941,0.283,0,0,0
82,MUN,P008985,P011987,13.034,3,28,25
82,MUN,P010391,P011941,11.217,-4,15,19
82,MUN,P010391,P011987,7.15,-3,13,16
82,MUN,P011941,P011987,2.067,-1,5,6
83,BAR,P002939,P003196,9.566,-10,20,30
83,BAR,P002939,P003478,13.8,4,28,24
83,BAR,P002939,P004866,19.466,4,41,37
83,BAR,P002939,P006435,12.517,-12,22,34
83,BAR,P002939,P007464,8.034,-6,12,18
83,BAR,P002939,P009992,4.8,2,10,8
83,BAR,P002939,P010641,13.35,10,28,18
83,BAR,P002939,P011244,7.367,1,16,15
83,BAR,P002939,P012745,15.232,11,35,24
83,BAR,P003196,P003204,9.082,-1,25,26
83,BAR,P003196,P003478,8.249,-1,23,24
83,BAR,P003196,P004866,12.215,-12,27,39
83,BAR,P003196,P006435,13.915,-14,31,45
83,BAR,P003196,P007464,7.9,-2,18,20
83,BAR,P003196,P009992,4.0,2,11,9
83,BAR,P003196,P011244,5.033,0,14,14
83,BAR,P003196,P012745,4.632,-6,11,17
83,BAR,P003204,P003478,9.666,6,28,22
83,BAR,P003204,P004866,6.949,-4,19,23
83,BAR,P003204,P006435,8.482,-1,24,25
83,BAR,P003204,P007464,7.166,5,20,15
83,BAR,P003204,P009992,5.333,2,15,13
83,BAR,P003204,P010641,1.333,0,4,4
83,BAR,P003204,P011244,4.333,2,13,11
83,BAR,P003204,P012745,3.516,-5,8,13
83,BAR,P003478,P004866,15.283,10,36,26
83,BAR,P003478,P006435,11.2,-3,26,29
83,BAR,P003478,P007464,7.8,2,20,18
83,BAR,P003478,P009992,3.4,2,9,7
83,BAR,P003478,P010641,8.55,8,18,10
83,BAR,P003478,P011244,6.667,3,15,12
83,BAR,P003478,P012745,9.249,9,21,12
83,BAR,P004866,P006435,16.216,-11,35,46
83,BAR,P004866,P007464,2.15,-5,0,5
83,BAR,P004866,P009992,1.333,0,4,4
83,BAR,P004866,P010641,9.316,10,22,12
83,BAR,P004866,P011244,9.917,2,25,23
83,BAR,P004866,P012745,12.815,6,31,25
83,BAR,P006435,P007464,6.25,-5,11,16
83,BAR,P006435,P010641,0.567,-2,0,2
83,BAR,P006435,P011244,11.55,3,29,26
83,BAR,P006435,P012745,3.299,-7,6,13
83,BAR,P007464,P009992,8.8,4,21,17
83,BAR,P007464,P010641,5.367,0,10,10
83,BAR,P007464,P011244,1.933,1,4,3
83,BAR,P007464,P012745,5.4,2,12,10
83,BAR,P009992,P010641,6.133,2,14,12
83,BAR,P009992,P012745,6.733,2,16,14
83,BAR,P010641,P012745,14.116,12,32,20
83,TEL,P004233,P005145,1.5,0,2,2
83,TEL,P004233,P009622,3.733,-2,9,11
83,TEL,P004233,P009783,1.683,-2,3,5
83,TEL,P004233,P009863,2.267,-2,2,4
83,TEL,P004233,P011199,0.15,0,0,0
83,TEL,P004233,P011214,2.317,-3,2,5
83,TEL,P004233,P011219,4.2,-4,9,13
83,TEL,P004233,P011971,4.0,-3,9,12
83,TEL,P004233,P012744,3.55,0,8,8
83,TEL,P005145,P009622,12.867,-3,31,34
83,TEL,P005145,P009783,11.35,-4,24,28
83,TEL,P005145,P009863,15.6,-3,35,38
83,TEL,P005145,P011199,12.867,-3,31,34
83,TEL,P005145,P011214,2.733,0,4,4
83,TEL,P005145,P012744,5.483,1,13,12
83,TEL,P009622,P009783,27.6,0,61,61
83,TEL,P009622,P009863,22.817,-2,55,57
83,TEL,P009622,P011199,16.617,-8,37,45
83,TEL,P009622,P011214,13.767,10,34,24
83,TEL,P009622,P011219,16.55,10,42,32
83,TEL,P009622,P011971,7.133,-5,16,21
83,TEL,P009622,P012744,13.984,4,35,31
83,TEL,P009783,P009863,22.816,-4,50,54
83,TEL,P009783,P011199,13.867,-9,28,37
83,TEL,P009783,P011214,16.516,9,38,29
83,TEL,P009783,P011219,16.016,9,38,29
83,TEL,P009783,P011971,5.083,-5,10,15
83,TEL,P009783,P012744,11.933,2,24,22
83,TEL,P009863,P011199,16.617,-8,37,45
83,TEL,P009863,P011214,12.433,3,28,25
83,TEL,P009863,P011219,9.1,4,23,19
83,TEL,P009863,P011971,4.367,-6,7,13
83,TEL,P009863,P012744,10.183,-2,23,25
83,TEL,P011199,P011971,3.6,-5,6,11
83,TEL,P011199,P012744,2.75,1,9,8
83,TEL,P011214,P011219,16.667,8,39,31
83,TEL,P011214,P011971,0.767,-1,1,2
83,TEL,P011214,P012744,14.8,2,30,28
83,TEL,P011219,P011971,4.0,-3,9,12
83,TEL,P011219,P012744,13.667,4,32,28
83,TEL,P011971,P012744,2.05,0,6,6
84,PAM,P000556,P005356,8.3,-3,16,19
84,PAM,P000556,P006643,1.95,-2,3,5
84,PAM,P000556,P007870,3.533,1,10,9
84,PAM,P000556,P010393,1.367,1,3,2
84,PAM,P000556,P010568,7.3,1,18,17
84,PAM,P000556,P011970,7.516,-8,13,21
84,PAM,P000556,P011982,6.416,-3,14,17
84,PAM,P000556,P012738,9.0,-7,15,22
84,PAM,P000556,P012739,4.75,-4,8,12
84,PAM,P003960,P005356,3.201,-8,3,11
84,PAM,P003960,P006643,6.567,-11,10,21
84,PAM,P003960,P007870,10.017,-16,13,29
84,PAM,P003960,P010568,9.834,-19,13,32
84,PAM,P003960,P011970,2.133,-1,3,4
84,PAM,P003960,P011982,5.334,-9,6,15
84,PAM,P003960,P012739,1.567,-4,3,7
84,PAM,P003960,P012740,7.683,-12,13,25
84,PAM,P005356,P006643,2.267,-2,3,5
84,PAM,P005356,P007870,4.017,-1,8,9
84,PAM,P005356,P010393,1.367,1,3,2
84,PAM,P005356,P010568,12.651,-1,26,27
84,PAM,P005356,P011970,3.283,-5,4,9
84,PAM,P005356,P011982,12.084,-5,22,27
84,PAM,P005356,P012738,13.4,-3,25,28
84,PAM,P005356,P012739,12.234,-5,22,27
84,PAM,P006643,P007870,8.067,-9,14,23
84,PAM,P006643,P010393,7.217,9,18,9
84,PAM,P006643,P010568,8.584,-9,14,23
84,PAM,P006643,P011970,5.333,8,14,6
84,PAM,P006643,P011982,0.9,-3,0,3
84,PAM,P006643,P012738,7.8,6,17,11
84,PAM,P006643,P012739,2.134,2,3,1
84,PAM,P006643,P012740,13.917,-1,28,29
84,PAM,P007870,P010393,1.817,2,4,2
84,PAM,P007870,P010568,14.717,-12,27,39
84,PAM,P007870,P011970,3.283,-3,5,8
84,PAM,P007870,P011982,7.3,-4,13,17
84,PAM,P007870,P012740,8.717,-10,14,24
84,PAM,P010393,P010568,2.617,-1,4,5
84,PAM,P010393,P011970,4.833,3,11,8
84,PAM,P010393,P011982,0.8,-3,0,3
84,PAM,P010393,P012738,6.2,4,14,10
84,PAM,P010393,P012740,5.85,8,15,7
84,PAM,P010568,P011970,5.733,-6,9,15
84,PAM,P010568,P011982,16.917,-8,31,39
84,PAM,P010568,P012738,11.784,0,22,22
84,PAM,P010568,P012739,9.151,0,18,18
84,PAM,P010568,P012740,8.584,-9,14,23
84,PAM,P011970,P011982,7.883,-8,12,20
84,PAM,P011970,P012738,12.433,-2,22,24
84,PAM,P011970,P012739,6.083,-4,10,14
84,PAM,P011970,P012740,7.483,6,17,11
84,PAM,P011982,P012738,11.1,-5,18,23
84,PAM,P011982,P012739,8.984,-2,17,19
84,PAM,P011982,P012740,2.15,-2,3,5
84,PAM,P012738,P012739,13.984,0,25,25
84,PAM,P012738,P012740,6.567,7,14,7
84,PAM,P012739,P012740,3.317,1,6,5
84,PAN,P001926,P002328,20.433,19,57,38
84,PAN,P001926,P003842,23.399,23,65,42
84,PAN,P001926,P007553,1.6,-3,2,5
84,PAN,P001926,P007866,25.316,19,67,48
84,PAN,P001926,P007947,8.15,-3,16,19
84,PAN,P001926,P008084,1.85,0,6,6
84,PAN,P001926,P011204,19.333,19,51,32
84,PAN,P001926,P012774,1.183,2,4,2
84,PAN,P002328,P003842,24.033,15,62,47
84,PAN,P002328,P007553,8.35,4,15,11
84,PAN,P002328,P007866,26.2,13,65,52
84,PAN,P002328,P007947,13.167,-3,22,25
84,PAN,P002328,P008084,6.5,5,12,7
84,PAN,P002328,P011204,20.034,19,52,33
84,PAN,P002328,P011209,1.617,-1,2,3
84,PAN,P002328,P012774,10.466,1,21,20
84,PAN,P003842,P007866,27.316,18,70,52
84,PAN,P003842,P007947,8.65,-3,17,20
84,PAN,P003842,P008084,1.45,-1,4,5
84,PAN,P003842,P011204,20.05,23,53,30
84,PAN,P003842,P011209,1.984,-1,2,3
84,PAN,P003842,P012774,3.85,-2,7,9
84,PAN,P007553,P007866,3.45,-4,5,9
84,PAN,P007553,P007947,10.85,-1,17,18
84,PAN,P007553,P008084,9.317,5,17,12
84,PAN,P007553,P011204,2.7,-3,3,6
84,PAN,P007553,P011209,2.05,-1,3,4
84,PAN,P007553,P012774,9.683,3,18,15
84,PAN,P007866,P007947,10.9,-9,19,28
84,PAN,P007866,P008084,1.85,0,6,6
84,PAN,P007866,P011204,22.35,19,56,37
84,PAN,P007866,P011209,1.617,-1,2,3
84,PAN,P007866,P012774,5.333,-3,10,13
84,PAN,P007947,P008084,10.767,4,21,17
84,PAN,P007947,P011204,3.417,-2,3,5
84,PAN,P007947,P011209,2.417,-1,3,4
84,PAN,P007947,P012774,10.95,-2,18,20
84,PAN,P008084,P011204,0.717,0,0,0
84,PAN,P008084,P011209,2.417,-1,3,4
84,PAN,P008084,P012774,8.2,4,15,11
84,PAN,P011204,P011209,1.617,-1,2,3
84,PAN,P011204,P012774,2.05,2,4,2
84,PAN,P011209,P012774,2.417,-1,3,4
85,BER,P003958,P007025,4.651,-2,14,16
85,BER,P003958,P007550,1.034,-1,3,4
85,BER,P003958,P008173,17.584,-7,36,43
85,BER,P003958,P008211,16.251,-6,32,38
85,BER,P003958,P008384,16.334,-8,32,40
85,BER,P003958,P010791,14.234,-9,32,41
85,BER,P003958,P011934,4.384,1,7,6
85,BER,P006251,P006819,7.766,2,17,15
85,BER,P006251,P007025,16.433,-7,27,34
85,BER,P006251,P007550,15.783,-7,27,34
85,BER,P006251,P008173,0.65,0,0,0
85,BER,P006251,P008211,7.4,-6,15,21
85,BER,P006251,P008384,6.5,3,8,5
85,BER,P006251,P010791,3.833,-5,4,9
85,BER,P006251,P011934,7.367,-8,10,18
85,BER,P006819,P007025,7.766,2,17,15
85,BER,P006819,P007550,7.766,2,17,15
85,BER,P006819,P008211,4.533,2,15,13
85,BER,P006819,P008384,3.233,0,2,2
85,BER,P007025,P007550,16.817,-8,30,38
85,BER,P007025,P008173,5.367,-3,11,14
85,BER,P007025,P008211,9.684,-6,22,28
85,BER,P007025,P008384,9.967,-1,15,16
85,BER,P007025,P010791,9.517,-9,18,27
85,BER,P007025,P011934,8.534,-10,10,20
85,BER,P007550,P008211,10.601,-10,23,33
85,BER,P007550,P008384,8.017,0,13,13
85,BER,P007550,P010791,6.317,-9,12,21
85,BER,P007550,P011934,9.601,-11,15,26
85,BER,P008173,P008211,16.9,-9,33,42
85,BER,P008173,P008384,19.767,-14,36,50
85,BER,P008173,P010791,16.7,-14,33,47
85,BER,P008173,P011934,7.1,-5,11,16
85,BER,P008211,P008384,17.817,-13,34,47
85,BER,P008211,P010791,16.367,-15,34,49
85,BER,P008211,P011934,10.451,-13,16,29
85,BER,P008384,P010791,17.617,-18,34,52
85,BER,P008384,P011934,11.884,-5,22,27
85,BER,P010791,P011934,7.483,-13,13,26
85,MAD,P001392,P003108,9.934,17,32,15
85,MAD,P001392,P005791,18.118,17,49,32
85,MAD,P001392,P005928,17.501,20,48,28
85,MAD,P001392,P006540,8.784,7,22,15
85,MAD,P001392,P009005,2.834,4,8,4
85,MAD,P001392,P009213,14.067,9,35,26
85,MAD,P001392,PBMT,0.617,-3,1,4
85,MAD,P001392,PCVM,0.617,-3,1,4
85,MAD,P003108,P003733,3.017,5,10,5
85,MAD,P003108,P004887,9.701,6,30,24
85,MAD,P003108,P005791,13.201,15,40,25
85,MAD,P003108,P005928,14.385,13,40,27
85,MAD,P003108,P006540,6.401,3,20,17
85,MAD,P003108,P009005,2.284,7,7,0
85,MAD,P003108,P009213,12.534,13,38,25
85,MAD,P003108,PBMT,1.817,-2,5,7
85,MAD,P003108,PCVM,8.584,8,30,22
85,MAD,P003108,PTGB,10.018,-1,28,29
85,MAD,P003733,P004887,10.4,6,17,11
85,MAD,P003733,P009005,7.383,1,7,6
85,MAD,P003733,P009213,3.017,5,10,5
85,MAD,P003733,PBMT,7.383,1,7,6
85,MAD,P003733,PCVM,10.4,6,17,11
85,MAD,P004887,P005928,1.117,-2,0,2
85,MAD,P004887,P006540,3.667,-1,11,12
85,MAD,P004887,P009005,7.383,1,7,6
85,MAD,P004887,P009213,6.034,7,19,12
85,MAD,P004887,PBMT,7.383,1,7,6
85,MAD,P004887,PCVM,15.967,9,37,28
85,MAD,P004887,PTGB,6.684,1,20,19
85,MAD,P005791,P005928,22.235,20,61,41
85,MAD,P005791,P006540,10.301,7,25,18
85,MAD,P005791,P009005,4.301,6,13,7
85,MAD,P005791,P009213,14.067,9,35,26
85,MAD,P005791,PBMT,3.834,-3,11,14
85,MAD,P005791,PCVM,0.617,-3,1,4
85,MAD,P005791,PTGB,4.734,0,13,13
85,MAD,P005928,P006540,11.418,5,25,20
85,MAD,P005928,P009005,3.751,9,12,3
85,MAD,P005928,P009213,14.067,9,35,26
85,MAD,P005928,PBMT,3.284,0,10,10
85,MAD,P005928,PTGB,5.918,-2,13,15
85,MAD,P006540,P009213,7.567,3,16,13
85,MAD,P006540,PCVM,2.55,1,11,10
85,MAD,P006540,PTGB,5.184,-1,14,15
85,MAD,P009005,PBMT,9.534,0,13,13
85,MAD,P009005,PCVM,8.0,-2,8,10
85,MAD,P009005,PTGB,1.534,2,5,3
85,MAD,P009213,PCVM,6.034,7,19,12
85,MAD,P009213,PTGB,3.017,2,9,7
85,MAD,PBMT,PCVM,8.0,-2,8,10
85,MAD,PBMT,PTGB,3.284,0,10,10
85,MAD,PCVM,PTGB,5.567,3,20,17
86,ULK,P001932,P002968,12.75,-4,22,26
86,ULK,P001932,P002969,9.0,-4,11,15
86,ULK,P001932,P004004,3.35,0,6,6
86,ULK,P001932,P005844,7.0,-12,10,22
86,ULK,P001932,P006661,10.766,-6,19,25
86,ULK,P001932,P008962,14.833,-12,23,35
86,ULK,P001932,P011052,10.517,-6,13,19
86,ULK,P001932,P011157,11.966,-10,21,31
86,ULK,P001932,P011980,6.95,-2,11,13
86,ULK,P002968,P002969,6.95,-2,11,13
86,ULK,P002968,P004004,3.967,-5,5,10
86,ULK,P002968,P005844,0.417,-2,0,2
86,ULK,P002968,P006661,4.75,-5,8,13
86,ULK,P002968,P008962,7.467,-7,12,19
86,ULK,P002968,P011052,7.367,-4,11,15
86,ULK,P002968,P011157,5.383,0,11,11
86,ULK,P002968,P011980,8.617,-7,12,19
86,ULK,P002969,P004004,1.2,-2,0,2
86,ULK,P002969,P006661,2.6,-2,0,2
86,ULK,P002969,P008962,2.6,-2,0,2
86,ULK,P002969,P011052,8.45,-2,11,13
86,ULK,P002969,P011157,0.45,0,0,0
86,ULK,P002969,P011980,6.95,-2,11,13
86,ULK,P004004,P005844,16.0,11,44,33
86,ULK,P004004,P006661,19.267,6,47,41
86,ULK,P004004,P008962,21.567,6,51,45
86,ULK,P004004,P011052,3.317,5,10,5
86,ULK,P004004,P011157,15.933,8,40,32
86,ULK,P004004,P011980,1.667,-5,1,6
86,ULK,P005844,P006661,21.233,5,54,49
86,ULK,P005844,P008962,23.0,-1,54,55
86,ULK,P005844,P011052,4.584,-3,8,11
86,ULK,P005844,P011157,19.766,-2,46,48
86,ULK,P006661,P008962,28.983,0,64,64
86,ULK,P006661,P011052,4.717,5,10,5
86,ULK,P006661,P011157,21.949,2,53,51
86,ULK,P006661,P011980,1.667,-5,1,6
86,ULK,P008962,P011052,6.484,-1,10,11
86,ULK,P008962,P011157,25.599,-2,57,59
86,ULK,P008962,P011980,1.667,-5,1,6
86,ULK,P011052,P011157,1.35,-4,0,4
86,ULK,P011052,P011980,6.95,-2,11,13
86,VIR,P001133,P001844,23.066,5,54,49
86,VIR,P001133,P003048,17.016,-1,35,36
86,VIR,P001133,P003527,1.767,3,4,1
86,VIR,P001133,P004007,8.533,13,21,8
86,VIR,P001133,P006739,5.883,8,17,9
86,VIR,P001133,P010781,14.032,8,40,32
86,VIR,P001133,P011192,15.6,4,34,30
86,VIR,P001133,P012714,9.966,13,32,19
86,VIR,P001133,PBCN,19.933,-1,47,48
86,VIR,P001844,P003048,16.049,-3,31,34
86,VIR,P001844,P003527,7.334,2,13,11
86,VIR,P001844,P004007,12.333,11,26,15
86,VIR,P001844,P006739,0.45,0,0,0
86,VIR,P001844,P010781,9.633,1,27,26
86,VIR,P001844,P011192,16.783,-3,30,33
86,VIR,P001844,P012714,11.033,8,30,22
86,VIR,P001844,PBCN,18.183,-5,41,46
86,VIR,P003048,P003527,0.45,0,0,0
86,VIR,P003048,P004007,6.416,6,13,7
86,VIR,P003048,P006739,1.95,2,4,2
86,VIR,P003048,P010781,5.333,0,13,13
86,VIR,P003048,P011192,6.716,-7,9,16
86,VIR,P003048,PBCN,16.266,-1,35,36
86,VIR,P003527,P004007,9.917,-5,14,19
86,VIR,P003527,P006739,5.85,-4,7,11
86,VIR,P003527,P010781,6.884,-3,11,14
86,VIR,P003527,P011192,7.017,0,11,11
86,VIR,P003527,P012714,11.717,-1,20,21
86,VIR,P004007,P006739,5.633,-2,9,11
86,VIR,P004007,P010781,6.583,2,13,11
86,VIR,P004007,P011192,6.516,3,11,8
86,VIR,P004007,P012714,10.333,2,20,18
86,VIR,P004007,PBCN,5.6,6,13,7
86,VIR,P006739,P010781,11.283,4,24,20
86,VIR,P006739,P011192,4.6,4,11,7
86,VIR,P006739,P012714,9.45,0,18,18
86,VIR,P006739,PBCN,1.833,4,6,2
86,VIR,P010781,P011192,7.35,4,18,14
86,VIR,P010781,P012714,14.2,3,34,31
86,VIR,P010781,PBCN,8.366,1,24,23
86,VIR,P011192,P012714,12.25,7,28,21
86,VIR,P011192,PBCN,6.9,-8,12,20
86,VIR,P012714,PBCN,2.983,0,10,10
87,IST,P004554,P004888,18.583,1,39,38
87,IST,P004554,P006372,1.533,0,2,2
87,IST,P004554,P006590,16.083,3,35,32
87,IST,P004554,P007200,14.916,5,35,30
87,IST,P004554,P009664,8.267,-5,16,21
87,IST,P004554,P011078,18.85,0,41,41
87,IST,P004554,P012710,3.3,-4,4,8
87,IST,P004888,P006372,2.3,-4,5,9
87,IST,P004888,P006590,24.333,11,67,56
87,IST,P004888,P007200,29.616,12,77,65
87,IST,P004888,P009664,14.166,12,37,25
87,IST,P004888,P010516,2.184,-5,2,7
87,IST,P004888,P011078,30.183,1,73,72
87,IST,P004888,P011981,17.767,8,51,43
87,IST,P004888,P012710,6.4,-8,9,17
87,IST,P006372,P006590,2.3,-4,5,9
87,IST,P006372,P007200,1.8,-2,2,4
87,IST,P006372,P011078,0.5,-2,3,5
87,IST,P006372,P011981,0.767,-4,3,7
87,IST,P006590,P007200,21.183,15,64,49
87,IST,P006590,P009664,13.3,2,33,31
87,IST,P006590,P010516,1.017,0,2,2
87,IST,P006590,P011078,21.75,4,60,56
87,IST,P006590,P011981,11.834,9,42,33
87,IST,P007200,P009664,11.516,14,37,23
87,IST,P007200,P010516,2.184,-5,2,7
87,IST,P007200,P011078,27.033,5,70,65
87,IST,P007200,P011981,18.284,8,52,44
87,IST,P007200,P012710,6.4,-8,9,17
87,IST,P009664,P011078,14.4,3,34,31
87,IST,P009664,P011981,9.483,18,31,13
87,IST,P010516,P011078,1.167,-5,0,5
87,IST,P010516,P011981,2.184,-5,2,7
87,IST,P011078,P011981,14.917,2,42,40
87,IST,P011078,P012710,6.4,-8,9,17
87,IST,P011981,P012710,3.1,-4,5,9
87,PAR,P000956,P004058,8.134,-12,11,23
87,PAR,P000956,P004172,1.967,-9,2,11
87,PAR,P000956,P007400,4.6,-6,11,17
87,PAR,P000956,P008987,10.584,-15,18,33
87,PAR,P000956,P011051,5.734,-3,10,13
87,PAR,P000956,P012096,2.067,-4,2,6
87,PAR,P000956,P012742,1.383,1,5,4
87,PAR,P000956,P012743,7.867,-12,13,25
87,PAR,P004058,P004172,5.6,0,12,12
87,PAR,P004058,P007400,7.517,0,18,18
87,PAR,P004058,P008987,15.834,-7,28,35
87,PAR,P004058,P011051,10.068,-6,18,24
87,PAR,P004058,P012096,5.467,1,13,12
87,PAR,P004058,P012742,10.067,8,26,18
87,PAR,P004058,P012743,10.117,0,22,22
87,PAR,P004172,P007400,20.416,-3,52,55
87,PAR,P004172,P008987,14.666,-12,37,49
87,PAR,P004172,P011051,3.833,-5,3,8
87,PAR,P004172,P012096,16.083,-1,34,35
87,PAR,P004172,P012742,25.549,2,62,60
87,PAR,P004172,P012743,18.95,8,54,46
87,PAR,P007400,P008987,15.799,-10,41,51
87,PAR,P007400,P011051,2.7,2,11,9
87,PAR,P007400,P012096,17.133,7,43,36
87,PAR,P007400,P012742,24.599,9,69,60
87,PAR,P007400,P012743,21.5,1,55,54
87,PAR,P008987,P011051,8.717,-8,12,20
87,PAR,P008987,P012096,6.683,-7,11,18
87,PAR,P008987,P012742,17.182,0,46,46
87,PAR,P008987,P012743,16.067,-5,43,48
87,PAR,P011051,P012096,3.534,4,11,7
87,PAR,P011051,P012742,5.833,1,14,13
87,PAR,P011051,P012743,3.917,-5,5,10
87,PAR,P012096,P012742,18.983,5,44,39
87,PAR,P012096,P012743,11.25,7,26,19
87,PAR,P012742,P012743,19.6,14,58,44
88,MIL,P000796,P002812,0.7,-2,1,3
88,MIL,P000796,P002849,21.183,30,58,28
88,MIL,P000796,P006509,10.5,0,20,20
88,MIL,P000796,P006701,6.117,8,15,7
88,MIL,P000796,P007032,24.25,21,59,38
88,MIL,P000796,P007201,14.983,21,42,21
88,MIL,P000796,P007831,19.4,20,48,28
88,MIL,P000796,P009960,7.567,-1,13,14
88,MIL,P000796,P011205,13.1,11,32,21
88,MIL,P001518,P006509,0.683,-1,1,2
88,MIL,P001518,P006701,0.683,-1,1,2
88,MIL,P001518,P011205,0.683,-1,1,2
88,MIL,P001518,P011926,0.683,-1,1,2
88,MIL,P002812,P006509,0.7,-2,1,3
88,MIL,P002812,P007032,4.467,-5,8,13
88,MIL,P002812,P007201,3.767,-3,7,10
88,MIL,P002812,P007831,4.467,-5,8,13
88,MIL,P002812,P011205,3.767,-3,7,10
88,MIL,P002849,P006509,4.5,0,10,10
88,MIL,P002849,P006701,5.517,10,15,5
88,MIL,P002849,P007032,21.883,27,56,29
88,MIL,P002849,P007201,19.733,26,53,27
88,MIL,P002849,P007831,23.133,24,58,34
88,MIL,P002849,P009960,1.25,-3,2,5
88,MIL,P002849,P011205,11.533,14,32,18
88,MIL,P006509,P006701,4.633,-3,9,12
88,MIL,P006509,P007032,6.1,-1,12,13
88,MIL,P006509,P007831,2.6,-8,3,11
88,MIL,P006509,P009960,7.9,-7,13,20
88,MIL,P006509,P011205,11.833,-5,22,27
88,MIL,P006509,P011926,0.683,-1,1,2
88,MIL,P006701,P007032,1.467,2,2,0
88,MIL,P006701,P007201,0.8,5,5,0
88,MIL,P006701,P007831,1.567,-1,2,3
88,MIL,P006701,P009960,0.7,-5,0,5
88,MIL,P006701,P011205,5.433,2,14,12
88,MIL,P006701,P011926,0.683,-1,1,2
88,MIL,P007032,P007201,22.7,18,55,37
88,MIL,P007032,P007831,27.367,22,66,44
88,MIL,P007032,P009960,6.417,1,13,12
88,MIL,P007032,P011205,16.417,7,37,30
88,MIL,P007201,P007831,22.7,18,55,37
88,MIL,P007201,P011205,9.317,7,23,16
88,MIL,P007831,P009960,2.917,-6,4,10
88,MIL,P007831,P011205,12.917,0,28,28
88,MIL,P009960,P011205,8.917,-7,15,22
88,MIL,P011205,P011926,0.683,-1,1,2
88,RED,P000848,P002553,15.683,-19,27,46
88,RED,P000848,P004720,4.916,-4,10,14
88,RED,P000848,P006436,14.633,-11,25,36
88,RED,P000848,P007960,17.266,-7,35,42
88,RED,P000848,P008966,8.966,0,19,19
88,RED,P000848,P009035,13.167,-5,26,31
88,RED,P000848,P012044,16.417,-11,30,41
88,RED,P000848,P012711,3.3,-5,2,7
88,RED,P000848,PJDR,9.316,-2,22,24
88,RED,P002553,P004720,6.6,-4,12,16
88,RED,P002553,P006436,17.101,-13,26,39
88,RED,P002553,P007960,19.5,-15,33,48
88,RED,P002553,P008966,9.7,0,17,17
88,RED,P002553,P009035,14.801,-10,26,36
88,RED,P002553,P011224,3.534,1,5,4
88,RED,P002553,P012044,12.9,-9,25,34
88,RED,P002553,PJDR,13.317,-15,17,32
88,RED,P004720,P006436,3.833,-1,7,8
88,RED,P004720,P007960,0.283,0,0,0
88,RED,P004720,P008966,3.95,2,10,8
88,RED,P004720,P009035,4.516,-7,7,14
88,RED,P004720,P011224,2.067,3,5,2
88,RED,P004720,P012044,6.116,-8,12,20
88,RED,P004720,P012711,1.483,-4,2,6
88,RED,P004720,PJDR,0.1,3,3,0
88,RED,P006436,P007960,19.683,-9,36,45
88,RED,P006436,P008966,6.784,-3,9,12
88,RED,P006436,P009035,18.15,-3,34,37
88,RED,P006436,P011224,3.534,1,5,4
88,RED,P006436,P012044,6.617,-10,8,18
88,RED,P006436,P012711,4.783,-9,4,13
88,RED,P006436,PJDR,19.75,-10,34,44
88,RED,P007960,P008966,6.533,3,14,11
88,RED,P007960,P009035,16.017,-2,32,34
88,RED,P007960,P012044,8.817,-4,16,20
88,RED,P007960,PJDR,17.233,-6,34,40
88,RED,P008966,P011224,3.534,1,5,4
88,RED,P008966,P012044,6.333,4,15,11
88,RED,P008966,PJDR,4.2,-3,7,10
88,RED,P009035,P012044,10.017,-16,15,31
88,RED,P009035,P012711,4.783,-9,4,13
88,RED,P009035,PJDR,13.417,4,28,24
88,RED,P011224,PJDR,1.467,-2,0,2
88,RED,P012044,P012711,4.283,-9,4,13
88,RED,P012044,PJDR,0.1,3,3,0
88,RED,P012711,PJDR,0.5,0,0,0
89,OLY,P001255,P003941,3.267,4,10,6
89,OLY,P001255,P006302,2.867,0,6,6
89,OLY,P001255,P008811,12.55,-1,21,22
89,OLY,P001255,P008829,18.334,2,36,34
89,OLY,P001255,P008855,15.467,2,30,28
89,OLY,P001255,P010392,4.734,-1,9,10
89,OLY,P001255,P010612,16.117,2,32,30
89,OLY,P003941,P006302,11.533,4,25,21
89,OLY,P003941,P006589,5.416,-5,6,11
89,OLY,P003941,P008829,8.783,12,26,14
89,OLY,P003941,P008855,2.666,3,7,4
89,OLY,P003941,P010392,10.633,0,18,18
89,OLY,P003941,P010612,3.566,7,14,7
89,OLY,P003941,P011983,10.932,3,22,19
89,OLY,P006302,P006589,3.466,-6,3,9
89,OLY,P006302,P008811,2.966,-1,10,11
89,OLY,P006302,P008829,11.033,9,32,23
89,OLY,P006302,P010392,8.5,1,15,14
89,OLY,P006302,P010612,5.999,2,20,18
89,OLY,P006302,P011983,11.632,3,29,26
89,OLY,P006589,P008811,4.383,9,15,6
89,OLY,P006589,P008855,6.333,10,18,8
89,OLY,P006589,P010392,7.083,-5,8,13
89,OLY,P006589,P010612,2.966,9,13,4
89,OLY,P006589,P011983,9.549,4,21,17
89,OLY,P008811,P008829,18.899,2,37,35
89,OLY,P008811,P008855,20.316,12,42,30
89,OLY,P008811,P010392,4.0,4,8,4
89,OLY,P008811,P010612,21.865,11,50,39
89,OLY,P008811,P011983,8.149,8,25,17
89,OLY,P008829,P008855,19.166,4,36,32
89,OLY,P008829,P010392,10.067,8,23,15
89,OLY,P008829,P010612,24.982,8,56,48
89,OLY,P008829,P011983,9.532,7,26,19
89,OLY,P008855,P010392,8.65,2,16,14
89,OLY,P008855,P010612,21.949,15,49,34
89,OLY,P008855,P011983,7.449,8,18,10
89,OLY,P010392,P010612,5.1,3,11,8
89,OLY,P010392,P011983,9.833,0,16,16
89,OLY,P010612,P011983,9.248,11,31,20
89,ZAL,P002329,P002676,12.815,-13,20,33
89,ZAL,P002329,P003210,16.465,-17,28,45
89,ZAL,P002329,P003211,6.433,-9,9,18
89,ZAL,P002329,P005504,5.8,-15,8,23
89,ZAL,P002329,P006860,3.183,-3,7,10
89,ZAL,P002329,P007109,11.8,-8,23,31
89,ZAL,P002329,P007513,3.583,1,9,8
89,ZAL,P002329,P010390,15.665,-3,28,31
89,ZAL,P002329,P011218,13.466,1,28,27
89,ZAL,P002329,P012715,11.782,-2,24,26
89,ZAL,P002676,P003210,12.015,-6,24,30
89,ZAL,P002676,P003211,8.266,-3,10,13
89,ZAL,P002676,P005504,0.983,-3,0,3
89,ZAL,P002676,P006860,3.782,-5,6,11
89,ZAL,P002676,P007109,17.234,-5,27,32
89,ZAL,P002676,P007513,6.116,-2,10,12
89,ZAL,P002676,P010390,21.133,-8,34,42
89,ZAL,P002676,P011218,17.284,-7,26,33
89,ZAL,P002676,P012715,9.599,-2,23,25
89,ZAL,P002676,P012784,1.033,2,4,2
89,ZAL,P003210,P003211,8.416,-6,16,22
89,ZAL,P003210,P005504,5.8,-15,8,23
89,ZAL,P003210,P006860,2.916,-7,4,11
89,ZAL,P003210,P007109,6.983,-4,17,21
89,ZAL,P003210,P007513,2.283,-3,4,7
89,ZAL,P003210,P010390,14.799,4,33,29
89,ZAL,P003210,P011218,7.583,3,18,15
89,ZAL,P003210,P012715,13.532,-1,28,29
89,ZAL,P003211,P005504,4.817,-12,6,18
89,ZAL,P003211,P007109,8.967,-7,12,19
89,ZAL,P003211,P010390,8.516,3,13,10
89,ZAL,P003211,P011218,4.917,-3,3,6
89,ZAL,P003211,P012715,3.0,1,7,6
89,ZAL,P005504,P007109,3.05,-10,4,14
89,ZAL,P005504,P007513,0.8,-2,2,4
89,ZAL,P005504,P011218,0.183,-1,0,1
89,ZAL,P005504,P012715,1.767,-2,4,6
89,ZAL,P006860,P007109,0.8,2,2,0
89,ZAL,P006860,P007513,4.266,4,11,7
89,ZAL,P006860,P010390,2.083,-2,5,7
89,ZAL,P006860,P011218,1.784,3,7,4
89,ZAL,P006860,P012715,2.949,-2,6,8
89,ZAL,P006860,P012784,1.033,2,4,2
89,ZAL,P007109,P007513,4.167,-3,6,9
89,ZAL,P007109,P010390,14.867,-5,21,26
89,ZAL,P007109,P011218,14.517,-6,20,26
89,ZAL,P007109,P012715,2.683,2,8,6
89,ZAL,P007513,P010390,4.683,-2,7,9
89,ZAL,P007513,P011218,5.217,0,9,9
89,ZAL,P007513,P012715,2.516,1,6,5
89,ZAL,P007513,P012784,1.033,2,4,2
89,ZAL,P010390,P011218,20.184,-6,31,37
89,ZAL,P010390,P012715,9.666,3,20,17
89,ZAL,P011218,P012715,9.733,4,22,18
89,ZAL,P012715,P012784,1.033,2,4,2
90,BAS,P003198,P004603,3.817,-7,5,12
90,BAS,P003198,P004761,7.366,3,15,12
90,BAS,P003198,P007230,15.566,7,35,28
90,BAS,P003198,P008850,0.866,2,4,2
90,BAS,P003198,P009048,7.216,3,15,12
90,BAS,P003198,P010444,11.483,10,26,16
90,BAS,P003198,P011948,7.517,4,18,14
90,BAS,P003198,P012201,0.083,2,2,0
90,BAS,P003198,P012765,8.35,4,20,16
90,BAS,P004603,P004761,1.133,-2,0,2
90,BAS,P004603,P007230,8.5,-12,11,23
90,BAS,P004603,P008850,0.033,0,0,0
90,BAS,P004603,P011948,7.334,-10,11,21
90,BAS,P004603,P012201,4.683,-5,6,11
90,BAS,P004603,P012765,8.5,-12,11,23
90,BAS,P004761,P007230,21.582,-4,38,42
90,BAS,P004761,P009048,24.249,-3,43,46
90,BAS,P004761,P010444,25.049,-5,43,48
90,BAS,P004761,P011948,7.766,7,17,10
90,BAS,P004761,P012201,16.199,-14,22,36
90,BAS,P004761,P012765,2.116,-2,2,4
90,BAS,P007230,P008850,1.432,4,6,2
90,BAS,P007230,P009048,22.182,0,42,42
90,BAS,P007230,P010444,26.449,7,53,46
90,BAS,P007230,P011948,15.184,7,34,27
90,BAS,P007230,P012201,16.932,-12,27,39
90,BAS,P007230,P012765,13.033,-1,26,27
90,BAS,P008850,P009048,1.366,2,4,2
90,BAS,P008850,P010444,1.366,2,4,2
90,BAS,P008850,P012201,0.599,4,4,0
90,BAS,P008850,P012765,0.066,2,2,0
90,BAS,P009048,P010444,26.782,-3,47,50
90,BAS,P009048,P011948,9.116,7,19,12
90,BAS,P009048,P012201,16.949,-10,26,36
90,BAS,P010444,P011948,12.4,14,28,14
90,BAS,P010444,P012201,16.949,-10,26,36
90,BAS,P010444,P012765,4.45,9,13,4
90,BAS,P011948,P012201,9.7,-4,15,19
90,BAS,P011948,P012765,10.851,-1,22,23
90,BAS,P012201,P012765,4.766,-3,8,11
90,MCO,P004197,P004790,6.2,-1,10,11
90,MCO,P004197,P005985,13.299,4,31,27
90,MCO,P004197,P010588,6.266,5,19,14
90,MCO,P004197,P011212,11.383,8,29,21
90,MCO,P004197,P011226,1.916,-4,2,6
90,MCO,P004197,P011231,1.383,-2,2,4
90,MCO,P004197,PLCZ,12.749,6,31,25
90,MCO,P004790,P005985,7.183,-1,12,13
90,MCO,P004790,P011196,0.983,0,2,2
90,MCO,P004790,P011212,6.2,-1,10,11
90,MCO,P004790,P011226,0.983,0,2,2
90,MCO,P004790,P012709,0.983,0,2,2
90,MCO,P004790,PLCZ,6.2,-1,10,11
90,MCO,P005985,P010588,23.833,1,42,41
90,MCO,P005985,P011196,5.766,2,12,10
90,MCO,P005985,P011212,23.65,1,41,40
90,MCO,P005985,P011226,22.816,-3,37,40
90,MCO,P005985,P011231,13.8,-5,20,25
90,MCO,P005985,P012709,8.633,8,23,15
90,MCO,P005985,PLCZ,17.816,13,46,33
90,MCO,P010588,P011196,6.166,0,11,11
90,MCO,P010588,P011212,22.15,0,40,40
90,MCO,P010588,P011226,23.45,-8,34,42
90,MCO,P010588,P011231,11.784,-11,10,21
90,MCO,P010588,P012709,10.2,5,24,19
90,MCO,P010588,PLCZ,10.683,12,32,20
90,MCO,P011196,P011212,6.033,-5,9,14
90,MCO,P011196,P011226,10.399,0,21,21
90,MCO,P011196,P011231,3.25,0,8,8
90,MCO,P011196,P012709,8.999,3,21,18
90,MCO,P011212,P011226,18.067,-10,23,33
90,MCO,P011212,P011231,12.167,-8,12,20
90,MCO,P011212,P012709,5.8,-3,11,14
90,MCO,P011212,PLCZ,12.35,10,33,23
90,MCO,P011226,P011231,15.967,-9,22,31
90,MCO,P011226,P012709,14.433,5,34,29
90,MCO,P011226,PLCZ,6.433,5,17,12
90,MCO,P011231,P012709,4.584,-3,10,13
90,MCO,P011231,PLCZ,0.933,2,4,2
90,MCO,P012709,PLCZ,4.1,5,11,6
91,MCO,P002581,P004197,3.95,-3,7,10
91,MCO,P002581,P005985,3.95,-3,7,10
91,MCO,P002581,P010588,3.95,-3,7,10
91,MCO,P002581,P011226,3.95,-3,7,10
91,MCO,P004197,P004790,0.25,0,0,0
91,MCO,P004197,P005985,14.95,0,29,29
91,MCO,P004197,P010588,14.95,0,29,29
91,MCO,P004197,P011196,3.65,-2,4,6
91,MCO,P004197,P011212,0.25,0,0,0
91,MCO,P004197,P011226,14.7,0,29,29
91,MCO,P004197,P011231,0.133,-3,0,3
91,MCO,P004197,PLCZ,6.967,8,18,10
91,MCO,P004790,P005985,4.133,4,10,6
91,MCO,P004790,P010588,2.483,5,7,2
91,MCO,P004790,P011196,5.867,-7,5,12
91,MCO,P004790,P011212,12.5,-2,21,23
91,MCO,P004790,P011226,2.233,5,7,2
91,MCO,P004790,P011231,8.367,-6,11,17
91,MCO,P004790,P012709,10.017,-7,14,21
91,MCO,P004790,PLCZ,4.15,0,9,9
91,MCO,P005985,P010588,24.699,11,59,48
91,MCO,P005985,P011196,10.383,3,25,22
91,MCO,P005985,P011212,14.349,7,31,24
91,MCO,P005985,P011226,28.132,13,66,53
91,MCO,P005985,P011231,4.799,4,16,12
91,MCO,P005985,P012709,1.65,-1,3,4
91,MCO,P005985,PLCZ,13.083,10,30,20
91,MCO,P010588,P011196,10.333,6,27,21
91,MCO,P010588,P011212,10.616,8,26,18
91,MCO,P010588,P011226,24.449,11,59,48
91,MCO,P010588,P011231,2.716,4,14,10
91,MCO,P010588,P012709,1.6,2,5,3
91,MCO,P010588,PLCZ,9.4,8,23,15
91,MCO,P011196,P011212,11.567,-4,19,23
91,MCO,P011196,P011226,8.733,4,22,18
91,MCO,P011196,P011231,6.8,1,16,15
91,MCO,P011196,P012709,7.467,-5,10,15
91,MCO,P011212,P011226,12.449,8,28,20
91,MCO,P011212,P011231,13.65,-2,23,25
91,MCO,P011212,P012709,11.617,-5,19,24
91,MCO,P011212,PLCZ,10.266,2,21,19
91,MCO,P011226,P011231,4.799,4,16,12
91,MCO,P011226,PLCZ,13.083,10,30,20
91,MCO,P011231,P012709,9.967,-4,16,20
91,MCO,P011231,PLCZ,7.833,2,16,14
91,MCO,P012709,PLCZ,4.15,0,9,9
91,OLY,P001255,P003941,6.534,-4,8,12
91,OLY,P001255,P006302,0.25,0,0,0
91,OLY,P001255,P007853,0.383,3,3,0
91,OLY,P001255,P008811,17.116,3,38,35
91,OLY,P001255,P008829,23.7,-1,46,47
91,OLY,P001255,P008855,23.317,-4,43,47
91,OLY,P001255,P010612,14.85,-5,28,33
91,OLY,P001255,P011983,8.65,4,18,14
91,OLY,P003941,P006302,0.483,-3,0,3
91,OLY,P003941,P006589,4.633,-3,9,12
91,OLY,P003941,P008829,13.217,-14,20,34
91,OLY,P003941,P008855,17.367,-14,29,43
91,OLY,P003941,P010392,4.633,-3,9,12
91,OLY,P003941,P010612,14.583,-18,23,41
91,OLY,P003941,P011983,9.95,-9,18,27
91,OLY,P006302,P006589,4.766,-1,6,7
91,OLY,P006302,P007853,3.9,2,6,4
91,OLY,P006302,P008811,5.233,6,10,4
91,OLY,P006302,P008829,0.567,4,4,0
91,OLY,P006302,P010392,2.199,1,4,3
91,OLY,P006302,P010612,5.466,3,10,7
91,OLY,P006589,P007853,2.95,-2,2,4
91,OLY,P006589,P008811,4.283,2,6,4
91,OLY,P006589,P008855,4.15,0,9,9
91,OLY,P006589,P010392,5.966,1,13,12
91,OLY,P006589,P010612,8.916,-1,15,16
91,OLY,P007853,P008811,4.033,5,9,4
91,OLY,P007853,P008829,0.7,7,7,0
91,OLY,P007853,P010392,0.383,0,0,0
91,OLY,P007853,P010612,3.783,5,9,4
91,OLY,P008811,P008829,17.433,7,42,35
91,OLY,P008811,P008855,16.733,0,35,35
91,OLY,P008811,P010392,1.716,4,4,0
91,OLY,P008811,P010612,16.516,6,36,30
91,OLY,P008811,P011983,5.333,3,12,9
91,OLY,P008829,P008855,30.0,-14,55,69
91,OLY,P008829,P010612,21.85,-11,44,55
91,OLY,P008829,P011983,15.333,-6,30,36
91,OLY,P008855,P010392,4.15,0,9,9
91,OLY,P008855,P010612,25.55,-18,46,64
91,OLY,P008855,P011983,15.333,-6,30,36
91,OLY,P010392,P010612,6.349,1,13,12
91,OLY,P010612,P011983,6.733,-10,12,22
92,MUN,P001557,P003583,3.567,-3,6,9
92,MUN,P001557,P005478,7.4,-3,12,15
92,MUN,P001557,P006760,1.784,3,6,3
92,MUN,P001557,P007056,3.751,-4,10,14
92,MUN,P001557,P007639,10.935,9,28,19
92,MUN,P001557,P007975,16.285,2,36,34
92,MUN,P001557,P010391,8.317,1,15,14
92,MUN,P001557,P011941,1.783,-4,2,6
92,MUN,P001557,P011987,11.318,7,29,22
92,MUN,P003583,P005478,1.383,0,2,2
92,MUN,P003583,P006245,3.55,-3,6,9
92,MUN,P003583,P006760,17.267,9,40,31
92,MUN,P003583,P007056,18.368,3,39,36
92,MUN,P003583,P007639,3.5,7,9,2
92,MUN,P003583,P007975,9.201,-2,14,16
92,MUN,P003583,P010391,15.984,16,39,23
92,MUN,P003583,P011987,20.184,13,45,32
92,MUN,P005478,P006760,0.467,2,2,0
92,MUN,P005478,P007639,4.234,1,8,7
92,MUN,P005478,P007975,7.4,-3,12,15
92,MUN,P005478,P010391,4.183,-6,4,10
92,MUN,P005478,P011941,1.783,-4,2,6
92,MUN,P005478,P011987,2.75,1,6,5
92,MUN,P006245,P006760,3.55,-3,6,9
92,MUN,P006245,P007056,3.55,-3,6,9
92,MUN,P006245,P011987,3.55,-3,6,9
92,MUN,P006760,P007056,17.067,3,41,38
92,MUN,P006760,P007639,5.284,10,15,5
92,MUN,P006760,P007975,8.301,1,20,19
92,MUN,P006760,P010391,15.167,14,42,28
92,MUN,P006760,P011941,3.3,1,10,9
92,MUN,P006760,P011987,17.217,12,42,30
92,MUN,P007056,P007639,2.3,-3,6,9
92,MUN,P007056,P007975,13.418,-4,28,32
92,MUN,P007056,P010391,15.134,8,38,30
92,MUN,P007056,P011941,3.3,1,10,9
92,MUN,P007056,P011987,18.984,3,42,39
92,MUN,P007639,P007975,11.668,7,28,21
92,MUN,P007639,P010391,9.067,11,19,8
92,MUN,P007639,P011987,13.684,14,35,21
92,MUN,P007975,P010391,16.134,2,31,29
92,MUN,P007975,P011941,5.083,-3,12,15
92,MUN,P007975,P011987,16.318,8,35,27
92,MUN,P010391,P011941,5.083,-3,12,15
92,MUN,P010391,P011987,17.467,25,44,19
92,VIR,P001133,P001844,23.75,-5,41,46
92,VIR,P001133,P003048,15.45,-6,35,41
92,VIR,P001133,P004007,7.6,2,13,11
92,VIR,P001133,P006739,8.85,1,24,23
92,VIR,P001133,P008847,12.933,3,22,19
92,VIR,P001133,P009549,14.45,-2,29,31
92,VIR,P001133,P010781,12.399,-4,24,28
92,VIR,P001133,P011192,6.966,-4,16,20
92,VIR,P001133,P012714,5.483,-4,10,14
92,VIR,P001133,PBCN,27.583,-9,54,63
92,VIR,P001844,P003048,12.684,-7,25,32
92,VIR,P001844,P004007,6.7,-4,8,12
92,VIR,P001844,P006739,2.65,-6,2,8
92,VIR,P001844,P008847,11.466,-7,15,22
92,VIR,P001844,P009549,11.65,-3,21,24
92,VIR,P001844,P010781,6.433,-3,11,14
92,VIR,P001844,P011192,3.55,3,9,6
92,VIR,P001844,P012714,3.0,-3,5,8
92,VIR,P001844,PBCN,19.917,-9,35,44
92,VIR,P003048,P004007,5.533,-8,7,15
92,VIR,P003048,P006739,9.316,-9,19,28
92,VIR,P003048,P008847,6.133,-7,9,16
92,VIR,P003048,P009549,9.517,-3,21,24
92,VIR,P003048,P010781,3.666,-3,5,8
92,VIR,P003048,P011192,7.416,-2,18,20
92,VIR,P003048,PBCN,16.617,-7,37,44
92,VIR,P004007,P006739,7.016,-4,14,18
92,VIR,P004007,P008847,9.949,1,19,18
92,VIR,P004007,P010781,7.516,4,16,12
92,VIR,P004007,P011192,1.316,-2,2,4
92,VIR,P004007,P012714,1.35,-3,1,4
92,VIR,P004007,PBCN,1.884,-2,0,2
92,VIR,P006739,P008847,7.583,1,18,17
92,VIR,P006739,P009549,4.317,0,10,10
92,VIR,P006739,P010781,5.216,4,14,10
92,VIR,P006739,P011192,2.233,-2,7,9
92,VIR,P006739,P012714,3.083,-1,5,6
92,VIR,P006739,PBCN,7.4,0,19,19
92,VIR,P008847,P009549,7.967,-1,12,13
92,VIR,P008847,P010781,7.916,3,15,12
92,VIR,P008847,P011192,1.316,-2,2,4
92,VIR,P008847,PBCN,11.001,-7,12,19
92,VIR,P009549,PBCN,15.967,-3,31,34
92,VIR,P010781,P011192,2.066,-5,2,7
92,VIR,P010781,P012714,4.883,-4,10,14
92,VIR,P010781,PBCN,7.633,-8,11,19
92,VIR,P011192,PBCN,6.533,-2,16,18
92,VIR,P012714,PBCN,4.133,-1,9,10
93,MAD,P003108,P003733,3.267,-3,2,5
93,MAD,P003108,P004887,6.517,-13,8,21
93,MAD,P003108,P005791,9.383,0,16,16
93,MAD,P003108,P005928,10.367,-5,19,24
93,MAD,P003108,P006540,3.8,-5,5,10
93,MAD,P003108,P009005,9.034,-3,19,22
93,MAD,P003108,PBMT,7.0,-9,6,15
93,MAD,P003108,PCVM,5.533,-7,6,13
93,MAD,P003108,PTGB,8.967,-3,19,22
93,MAD,P003733,P004887,2.25,-3,2,5
93,MAD,P003733,P005791,1.017,0,0,0
93,MAD,P003733,P009005,0.067,0,0,0
93,MAD,P003733,PBMT,3.267,-3,2,5
93,MAD,P003733,PCVM,3.2,-3,2,5
93,MAD,P004887,P005928,18.1,-3,39,42
93,MAD,P004887,P006540,14.133,-7,28,35
93,MAD,P004887,P009005,18.266,-9,39,48
93,MAD,P004887,PBMT,18.299,-16,33,49
93,MAD,P004887,PCVM,5.016,-10,6,16
93,MAD,P004887,PTGB,12.483,-11,25,36
93,MAD,P005791,P005928,18.916,15,50,35
93,MAD,P005791,P006540,3.066,6,11,5
93,MAD,P005791,P009005,19.733,16,53,37
93,MAD,P005791,P009213,7.967,9,23,14
93,MAD,P005791,PBMT,3.633,3,7,4
93,MAD,P005791,PCVM,2.183,1,3,2
93,MAD,P005791,PTGB,18.766,14,49,35
93,MAD,P005928,P006540,14.283,9,36,27
93,MAD,P005928,P009005,35.683,15,90,75
93,MAD,P005928,P009213,7.967,9,23,14
93,MAD,P005928,PBMT,14.016,1,31,30
93,MAD,P005928,PTGB,29.0,11,72,61
93,MAD,P006540,P009005,13.533,6,36,30
93,MAD,P006540,PBMT,11.066,-7,22,29
93,MAD,P006540,PCVM,2.333,-4,4,8
93,MAD,P006540,PTGB,6.85,2,18,16
93,MAD,P009005,P009213,7.967,9,23,14
93,MAD,P009005,PBMT,14.999,-4,34,38
93,MAD,P009005,PCVM,1.666,-2,3,5
93,MAD,P009005,PTGB,31.316,4,75,71
93,MAD,P009213,PTGB,7.967,9,23,14
93,MAD,PBMT,PCVM,7.199,-9,9,18
93,MAD,PBMT,PTGB,8.249,-8,16,24
93,MAD,PCVM,PTGB,1.666,-2,3,5
93,ULK,P001932,P002968,0.2,1,1,0
93,ULK,P001932,P004004,19.55,5,52,47
93,ULK,P001932,P005844,9.167,-13,16,29
93,ULK,P001932,P006661,12.567,11,35,24
93,ULK,P001932,P008962,20.7,3,53,50
93,ULK,P001932,P009849,1.033,-3,3,6
93,ULK,P001932,P010560,8.25,-7,16,23
93,ULK,P001932,P011052,0.1,2,2,0
93,ULK,P001932,P011157,11.233,13,34,21
93,ULK,P002968,P004004,5.933,1,13,12
93,ULK,P002968,P006661,6.949,-2,12,14
93,ULK,P002968,P008962,6.316,-8,11,19
93,ULK,P002968,P009849,12.266,1,24,23
93,ULK,P002968,P010560,3.533,-2,7,9
93,ULK,P002968,P011052,11.916,2,25,23
93,ULK,P002968,P011157,9.483,3,19,16
93,ULK,P004004,P005844,8.217,-10,16,26
93,ULK,P004004,P006661,18.467,15,50,35
93,ULK,P004004,P008962,28.9,5,73,68
93,ULK,P004004,P009849,7.033,0,17,17
93,ULK,P004004,P010560,7.65,-6,16,22
93,ULK,P004004,P011052,13.7,6,33,27
93,ULK,P004004,P011157,23.15,20,62,42
93,ULK,P005844,P006661,1.317,-3,0,3
93,ULK,P005844,P008962,11.434,-16,18,34
93,ULK,P005844,P009849,3.3,-6,5,11
93,ULK,P005844,P010560,10.034,-13,15,28
93,ULK,P005844,P011052,2.267,-3,2,5
93,ULK,P006661,P008962,21.65,9,53,44
93,ULK,P006661,P009849,5.616,-1,9,10
93,ULK,P006661,P010560,1.533,-2,1,3
93,ULK,P006661,P011052,10.633,5,23,18
93,ULK,P006661,P011157,22.2,16,57,41
93,ULK,P008962,P009849,9.9,-13,16,29
93,ULK,P008962,P010560,14.267,-13,24,37
93,ULK,P008962,P011052,14.534,-3,30,33
93,ULK,P008962,P011157,20.967,12,54,42
93,ULK,P009849,P010560,5.467,-5,7,12
93,ULK,P009849,P011052,14.667,1,28,27
93,ULK,P009849,P011157,11.65,2,23,21
93,ULK,P010560,P011052,5.734,-4,10,14
93,ULK,P010560,P011157,0.6,0,0,0
93,ULK,P011052,P011157,15.917,10,35,25
94,BER,P003958,P006251,9.916,-13,15,28
94,BER,P003958,P007025,0.783,2,3,1
94,BER,P003958,P008173,10.083,-7,25,32
94,BER,P003958,P008211,13.633,0,32,32
94,BER,P003958,P008384,17.267,5,46,41
94,BER,P003958,P010791,10.5,5,26,21
94,BER,P003958,P011631,7.25,7,25,18
94,BER,P003958,P011934,7.25,0,21,21
94,BER,P003958,P012721,6.85,1,19,18
94,BER,P006251,P007025,6.533,-4,8,12
94,BER,P006251,P008173,3.233,-8,6,14
94,BER,P006251,P008211,16.049,-16,21,37
94,BER,P006251,P008384,7.083,-6,11,17
94,BER,P006251,P010791,12.916,-11,15,26
94,BER,P006251,P011631,6.183,-11,7,18
94,BER,P006251,P011934,0.4,-1,2,3
94,BER,P006251,P012721,3.483,2,7,5
94,BER,P006819,P007025,4.1,-12,5,17
94,BER,P006819,P008173,8.65,-11,17,28
94,BER,P006819,P008384,4.55,1,12,11
94,BER,P006819,P011934,8.65,-11,17,28
94,BER,P006819,P012721,8.65,-11,17,28
94,BER,P007025,P008173,5.966,-15,8,23
94,BER,P007025,P008211,7.883,-6,8,14
94,BER,P007025,P010791,6.533,-4,8,12
94,BER,P007025,P011631,5.483,-13,1,14
94,BER,P007025,P011934,7.316,-17,8,25
94,BER,P007025,P012721,10.799,-15,15,30
94,BER,P008173,P008211,2.833,-7,4,11
94,BER,P008173,P008384,12.517,0,33,33
94,BER,P008173,P011631,5.416,-11,7,18
94,BER,P008173,P011934,18.483,-15,41,56
94,BER,P008173,P012721,18.083,-14,39,53
94,BER,P008211,P008384,10.8,7,28,21
94,BER,P008211,P010791,17.033,1,34,33
94,BER,P008211,P011631,11.65,-1,26,27
94,BER,P008211,P011934,1.35,-2,0,2
94,BER,P008211,P012721,4.833,0,7,7
94,BER,P008384,P010791,10.5,5,26,21
94,BER,P008384,P011631,5.917,15,24,9
94,BER,P008384,P011934,12.517,0,33,33
94,BER,P008384,P012721,12.117,1,31,30
94,BER,P010791,P011631,7.167,6,20,14
94,BER,P010791,P012721,3.483,2,7,5
94,BER,P011631,P011934,3.933,-6,3,9
94,BER,P011631,P012721,3.933,-6,3,9
94,BER,P011934,P012721,19.433,-16,39,55
94,TEL,P004233,P005145,3.05,5,11,6
94,TEL,P004233,P009622,4.117,12,19,7
94,TEL,P004233,P009783,6.584,7,14,7
94,TEL,P004233,P009863,9.151,16,30,14
94,TEL,P004233,P011193,18.667,14,50,36
94,TEL,P004233,P011214,2.066,3,5,2
94,TEL,P004233,P011219,20.119,20,57,37
94,TEL,P004233,P011433,4.633,-3,9,12
94,TEL,P004233,P011971,9.417,14,30,16
94,TEL,P004233,P012744,11.268,4,23,19
94,TEL,P005145,P009622,12.25,-1,29,30
94,TEL,P005145,P009783,12.25,-1,29,30
94,TEL,P005145,P009863,14.1,5,38,33
94,TEL,P005145,P011193,4.25,4,13,9
94,TEL,P005145,P011214,12.25,-1,29,30
94,TEL,P005145,P011219,3.05,5,11,6
94,TEL,P009622,P009783,14.3,-3,33,36
94,TEL,P009622,P009863,13.1,-2,31,33
94,TEL,P009622,P011193,6.9,12,26,14
94,TEL,P009622,P011214,15.183,3,39,36
94,TEL,P009622,P011219,4.817,7,18,11
94,TEL,P009622,P011971,7.133,11,26,15
94,TEL,P009622,P012744,2.2,1,7,6
94,TEL,P009783,P009863,16.517,6,39,33
94,TEL,P009783,P011193,4.867,-2,6,8
94,TEL,P009783,P011214,12.767,-1,29,30
94,TEL,P009783,P011219,8.451,5,16,11
94,TEL,P009783,P011433,0.083,0,0,0
94,TEL,P009783,P011971,1.433,-2,2,4
94,TEL,P009783,P012744,5.884,7,12,5
94,TEL,P009863,P011193,6.067,7,18,11
94,TEL,P009863,P011214,12.9,0,29,29
94,TEL,P009863,P011219,11.018,14,32,18
94,TEL,P009863,P011433,1.416,0,2,2
94,TEL,P009863,P011971,5.35,1,13,12
94,TEL,P009863,P012744,4.317,9,12,3
94,TEL,P011193,P011214,5.983,3,14,11
94,TEL,P011193,P011219,17.035,11,45,34
94,TEL,P011193,P011433,4.633,-3,9,12
94,TEL,P011193,P011971,11.45,14,35,21
94,TEL,P011193,P012744,10.484,-4,20,24
94,TEL,P011214,P011219,0.517,0,0,0
94,TEL,P011214,P011433,2.666,0,4,4
94,TEL,P011214,P011971,5.599,4,14,10
94,TEL,P011214,P012744,3.533,1,9,8
94,TEL,P011219,P011433,3.217,-3,7,10
94,TEL,P011219,P011971,8.784,9,27,18
94,TEL,P011219,P012744,11.268,4,23,19
94,TEL,P011433,P011971,2.666,0,4,4
94,TEL,P011433,P012744,4.55,-3,9,12
94,TEL,P011971,P012744,5.7,1,13,12
95,PAN,P001926,P002328,21.317,-4,39,43
95,PAN,P001926,P003842,19.384,-6,35,41
95,PAN,P001926,P007553,3.45,-3,4,7
95,PAN,P001926,P007866,18.9,-5,32,37
95,PAN,P001926,P007947,2.55,-5,2,7
95,PAN,P001926,P008084,1.517,-5,0,5
95,PAN,P001926,P011204,20.134,-5,35,40
95,PAN,P001926,P012774,4.084,-3,9,12
95,PAN,P002328,P003842,31.65,0,66,66
95,PAN,P002328,P007553,7.783,0,13,13
95,PAN,P002328,P007866,37.016,-1,72,73
95,PAN,P002328,P007947,4.516,3,9,6
95,PAN,P002328,P011204,33.25,1,68,67
95,PAN,P002328,P012774,22.2,1,49,48
95,PAN,P003842,P007866,29.233,-1,59,60
95,PAN,P003842,P007947,2.55,-5,2,7
95,PAN,P003842,P008084,1.517,-5,0,5
95,PAN,P003842,P011204,30.467,-1,62,63
95,PAN,P003842,P012774,17.867,-2,40,42
95,PAN,P007553,P007866,11.833,0,21,21
95,PAN,P007553,P007947,7.533,3,15,12
95,PAN,P007553,P011204,8.35,-3,14,17
95,PAN,P007553,P012774,8.383,3,17,14
95,PAN,P007866,P007947,8.566,3,17,14
95,PAN,P007866,P011204,34.883,0,69,69
95,PAN,P007866,P012774,23.833,0,50,50
95,PAN,P007947,P008084,1.517,-5,0,5
95,PAN,P007947,P011204,5.567,-5,8,13
95,PAN,P007947,P012774,7.533,3,15,12
95,PAN,P008084,P011204,1.517,-5,0,5
95,PAN,P011204,P012774,21.1,2,48,46
95,PAR,P000956,P003983,1.833,-1,2,3
95,PAR,P000956,P004172,0.033,0,0,0
95,PAR,P000956,P007400,12.299,11,26,15
95,PAR,P000956,P008987,25.032,26,64,38
95,PAR,P000956,P009862,12.766,15,38,23
95,PAR,P000956,P011051,9.633,12,24,12
95,PAR,P000956,P012096,12.766,15,38,23
95,PAR,P000956,P012742,23.232,27,62,35
95,PAR,P000956,P012743,2.666,-1,2,3
95,PAR,P003983,P004172,0.717,0,2,2
95,PAR,P003983,P007400,8.983,-1,13,14
95,PAR,P003983,P008987,5.283,2,9,7
95,PAR,P003983,P009212,4.417,-3,6,9
95,PAR,P003983,P009862,7.15,0,11,11
95,PAR,P003983,P011051,0.717,0,2,2
95,PAR,P003983,P012096,7.15,0,11,11
95,PAR,P003983,P012743,2.55,-1,4,5
95,PAR,P004058,P004172,0.467,0,0,0
95,PAR,P004058,P007400,3.667,-7,4,11
95,PAR,P004058,P008987,3.2,-7,4,11
95,PAR,P004058,P009862,3.667,-7,4,11
95,PAR,P004058,P011051,3.2,-5,4,9
95,PAR,P004058,P012743,0.467,-2,0,2
95,PAR,P004172,P007400,0.85,-2,0,2
95,PAR,P004172,P008987,6.717,-6,13,19
95,PAR,P004172,P009862,0.883,-2,0,2
95,PAR,P004172,P011051,7.184,-6,13,19
95,PAR,P004172,P012096,0.033,0,0,0
95,PAR,P004172,P012742,5.65,-4,11,15
95,PAR,P004172,P012743,6.334,-4,13,17
95,PAR,P007400,P008987,20.415,-1,35,36
95,PAR,P007400,P009212,5.017,-5,6,11
95,PAR,P007400,P009862,13.6,-17,15,32
95,PAR,P007400,P011051,14.266,1,28,27
95,PAR,P007400,P012096,7.15,0,11,11
95,PAR,P007400,P012742,12.866,4,24,20
95,PAR,P007400,P012743,4.483,-7,2,9
95,PAR,P008987,P009862,20.849,3,47,44
95,PAR,P008987,P011051,20.133,-3,41,44
95,PAR,P008987,P012096,15.466,18,43,25
95,PAR,P008987,P012742,30.616,17,73,56
95,PAR,P008987,P012743,10.217,-9,15,24
95,PAR,P009212,P009862,5.017,-5,6,11
95,PAR,P009212,P012096,4.417,-3,6,9
95,PAR,P009212,P012742,0.6,-2,0,2
95,PAR,P009212,P012743,0.6,-2,0,2
95,PAR,P009862,P011051,4.633,-11,4,15
95,PAR,P009862,P012096,19.916,15,49,34
95,PAR,P009862,P012742,15.166,7,38,31
95,PAR,P009862,P012743,1.817,-6,0,6
95,PAR,P011051,P012742,16.3,4,35,31
95,PAR,P011051,P012743,6.334,-4,13,17
95,PAR,P012096,P012742,12.766,15,38,23
95,PAR,P012742,P012743,7.8,-8,11,19
96,MIL,P000796,P002812,11.984,2,25,23
96,MIL,P000796,P002849,23.051,-7,41,48
96,MIL,P000796,P006509,5.967,-6,8,14
96,MIL,P000796,P006701,0.417,2,2,0
96,MIL,P000796,P007032,23.101,-17,38,55
96,MIL,P000796,P007201,13.651,-13,22,35
96,MIL,P000796,P007831,29.068,-15,50,65
96,MIL,P000796,P009960,2.784,-3,4,7
96,MIL,P000796,P011205,7.917,5,18,13
96,MIL,P001518,P006509,4.25,2,8,6
96,MIL,P001518,P006701,2.85,2,6,4
96,MIL,P001518,P007032,1.083,0,2,2
96,MIL,P001518,P007831,1.4,0,2,2
96,MIL,P001518,P009960,4.25,2,8,6
96,MIL,P001518,P011205,3.167,2,6,4
96,MIL,P002812,P002849,7.934,3,16,13
96,MIL,P002812,P006509,3.316,-3,6,9
96,MIL,P002812,P007032,6.017,0,13,13
96,MIL,P002812,P007201,3.4,-2,7,9
96,MIL,P002812,P007831,13.317,0,27,27
96,MIL,P002812,P011205,7.3,0,14,14
96,MIL,P002849,P006509,7.583,-3,12,15
96,MIL,P002849,P006701,1.317,2,2,0
96,MIL,P002849,P007032,24.75,-12,44,56
96,MIL,P002849,P007201,14.55,-10,23,33
96,MIL,P002849,P007831,22.634,-9,39,48
96,MIL,P002849,P009960,1.317,2,2,0
96,MIL,P002849,P011205,8.8,6,17,11
96,MIL,P006509,P006701,3.75,2,6,4
96,MIL,P006509,P007032,9.1,-5,14,19
96,MIL,P006509,P007201,5.383,-2,10,12
96,MIL,P006509,P007831,8.7,-8,12,20
96,MIL,P006509,P009960,6.467,0,8,8
96,MIL,P006509,P011205,11.416,-1,20,21
96,MIL,P006701,P009960,4.167,4,8,4
96,MIL,P006701,P011205,4.167,4,8,4
96,MIL,P007032,P007201,15.617,-13,25,38
96,MIL,P007032,P007831,24.184,-17,40,57
96,MIL,P007032,P009960,3.45,-5,4,9
96,MIL,P007032,P011205,5.566,1,12,11
96,MIL,P007201,P007831,14.984,-15,24,39
96,MIL,P007201,P009960,1.05,-3,2,5
96,MIL,P007201,P011205,7.433,-2,15,17
96,MIL,P007831,P009960,3.767,-5,4,9
96,MIL,P007831,P011205,9.15,1,18,17
96,MIL,P009960,P011205,4.484,4,8,4
96,ZAL,P002329,P002676,17.184,15,39,24
96,ZAL,P002329,P003210,2.833,0,6,6
96,ZAL,P002329,P003211,5.901,-3,15,18
96,ZAL,P002329,P005504,4.484,-6,9,15
96,ZAL,P002329,P006860,12.051,8,26,18
96,ZAL,P002329,P007109,18.617,8,40,32
96,ZAL,P002329,P007513,16.168,0,32,32
96,ZAL,P002329,P010390,31.785,18,69,51
96,ZAL,P002329,P011218,29.917,12,64,52
96,ZAL,P002676,P005504,1.517,-1,3,4
96,ZAL,P002676,P006860,9.45,14,26,12
96,ZAL,P002676,P007109,6.217,2,10,8
96,ZAL,P002676,P010390,17.184,15,39,24
96,ZAL,P002676,P011218,17.184,15,39,24
96,ZAL,P003210,P003211,6.649,-2,12,14
96,ZAL,P003210,P005504,4.033,0,9,9
96,ZAL,P003210,P006860,2.133,-2,2,4
96,ZAL,P003210,P007109,4.766,3,8,5
96,ZAL,P003210,P007513,6.716,2,10,8
96,ZAL,P003210,P010390,3.883,1,5,4
96,ZAL,P003210,P011218,1.383,-2,4,6
96,ZAL,P003211,P005504,5.617,-3,11,14
96,ZAL,P003211,P006860,2.317,-5,2,7
96,ZAL,P003211,P007109,6.483,3,15,12
96,ZAL,P003211,P007513,9.784,-1,19,20
96,ZAL,P003211,P010390,5.384,1,12,11
96,ZAL,P003211,P011218,2.533,-2,6,8
96,ZAL,P005504,P006860,2.117,-4,2,6
96,ZAL,P005504,P007109,0.95,3,3,0
96,ZAL,P005504,P007513,4.234,-1,7,8
96,ZAL,P005504,P010390,1.534,-1,3,4
96,ZAL,P005504,P011218,4.05,-3,9,12
96,ZAL,P006860,P007109,0.183,-1,0,1
96,ZAL,P006860,P007513,4.484,-8,2,10
96,ZAL,P006860,P010390,11.634,11,26,15
96,ZAL,P006860,P011218,11.367,11,26,15
96,ZAL,P007109,P007513,15.966,7,36,29
96,ZAL,P007109,P010390,21.05,7,43,36
96,ZAL,P007109,P011218,14.5,4,29,25
96,ZAL,P007513,P010390,17.034,2,33,31
96,ZAL,P007513,P011218,11.35,-1,21,22
96,ZAL,P010390,P011218,27.384,14,58,44
97,IST,P004888,P006372,10.716,-6,16,22
97,IST,P004888,P006590,25.366,-4,49,53
97,IST,P004888,P007200,31.482,-15,62,77
97,IST,P004888,P009513,0.1,-3,0,3
97,IST,P004888,P011078,25.799,-17,48,65
97,IST,P004888,P011981,26.733,0,57,57
97,IST,P004888,P012710,4.349,-7,8,15
97,IST,P004888,P012786,9.583,0,28,28
97,IST,P006372,P006590,13.267,-3,26,29
97,IST,P006372,P007200,11.366,-12,20,32
97,IST,P006372,P009513,0.1,-3,0,3
97,IST,P006372,P011078,11.216,2,21,19
97,IST,P006372,P011981,15.017,-5,26,31
97,IST,P006372,P012710,1.316,2,6,4
97,IST,P006372,P012786,5.734,-3,13,16
97,IST,P006590,P007200,26.116,-13,53,66
97,IST,P006590,P011078,22.333,-9,40,49
97,IST,P006590,P011981,25.517,8,56,48
97,IST,P006590,P012710,3.866,-7,7,14
97,IST,P006590,P012786,10.867,8,29,21
97,IST,P007200,P011078,24.682,-23,46,69
97,IST,P007200,P011981,26.55,-5,58,63
97,IST,P007200,P012710,5.182,-8,11,19
97,IST,P007200,P012786,11.35,0,34,34
97,IST,P009513,P011981,0.1,-3,0,3
97,IST,P009513,P012786,0.1,-3,0,3
97,IST,P011078,P011981,22.767,-1,45,46
97,IST,P011078,P012710,5.182,-8,11,19
97,IST,P011078,P012786,9.617,-4,21,25
97,IST,P011981,P012786,12.784,6,38,32
97,IST,P012710,P012786,0.833,-4,1,5
97,RED,P000848,P002553,19.7,3,49,46
97,RED,P000848,P004720,8.633,17,27,10
97,RED,P000848,P006436,7.117,-2,14,16
97,RED,P000848,P007960,5.933,6,18,12
97,RED,P000848,P008966,1.9,-2,2,4
97,RED,P000848,P009035,23.816,14,68,54
97,RED,P000848,P011224,3.883,-6,9,15
97,RED,P000848,P012044,20.1,18,59,41
97,RED,P000848,PJDR,5.883,-3,14,17
97,RED,P000848,PLUO,5.967,3,20,17
97,RED,P002553,P004720,5.0,3,11,8
97,RED,P002553,P006436,11.483,-6,22,28
97,RED,P002553,P008966,1.6,2,4,2
97,RED,P002553,P009035,24.6,3,61,58
97,RED,P002553,P011224,6.3,4,19,15
97,RED,P002553,P012044,19.283,3,48,45
97,RED,P002553,PJDR,9.034,8,25,17
97,RED,P002553,PLUO,7.8,0,21,21
97,RED,P004720,P006436,0.967,-1,2,3
97,RED,P004720,P007960,4.6,13,18,5
97,RED,P004720,P008966,1.117,2,2,0
97,RED,P004720,P009035,8.483,14,27,13
97,RED,P004720,P012044,6.883,17,25,8
97,RED,P004720,PJDR,2.667,-1,4,5
97,RED,P004720,PLUO,0.05,0,0,0
97,RED,P006436,P007960,4.484,1,6,5
97,RED,P006436,P008966,6.017,3,10,7
97,RED,P006436,P009035,9.933,-8,18,26
97,RED,P006436,P011224,5.1,-4,6,10
97,RED,P006436,P012044,8.983,-7,16,23
97,RED,P006436,PJDR,6.951,2,12,10
97,RED,P006436,PLUO,2.833,2,6,4
97,RED,P007960,P008966,9.317,-2,13,15
97,RED,P007960,P009035,4.066,8,16,8
97,RED,P007960,P011224,8.1,-9,9,18
97,RED,P007960,P012044,5.483,10,18,8
97,RED,P007960,PJDR,9.1,-7,11,18
97,RED,P007960,PLUO,3.717,4,7,3
97,RED,P008966,P011224,7.217,-6,9,15
97,RED,P008966,P012044,1.733,-1,2,3
97,RED,P008966,PJDR,9.8,-2,15,17
97,RED,P008966,PLUO,4.967,6,11,5
97,RED,P009035,P011224,6.883,1,19,18
97,RED,P009035,P012044,22.816,17,67,50
97,RED,P009035,PJDR,8.117,6,24,18
97,RED,P009035,PLUO,6.35,1,20,19
97,RED,P011224,P012044,4.433,0,10,10
97,RED,P011224,PJDR,12.867,-2,26,28
97,RED,P011224,PLUO,2.817,2,5,3
97,RED,P012044,PJDR,3.15,6,11,5
97,RED,P012044,PLUO,6.6,1,20,19
97,RED,PJDR,PLUO,5.367,9,14,5
98,ASV,P000229,P002100,15.266,13,44,31
98,ASV,P000229,P003526,8.701,3,24,21
98,ASV,P000229,P004194,12.917,7,36,29
98,ASV,P000229,P006568,4.617,3,13,10
98,ASV,P000229,P011225,4.234,1,10,9
98,ASV,P000229,P012080,10.966,8,30,22
98,ASV,P000229,P012729,18.5,9,50,41
98,ASV,P000229,P012730,3.3,3,9,6
98,ASV,P000229,P012731,0.167,-3,0,3
98,ASV,P002100,P003526,7.451,2,20,18
98,ASV,P002100,P004194,14.467,6,42,36
98,ASV,P002100,P006568,3.533,-2,10,12
98,ASV,P002100,P011225,3.817,-4,10,14
98,ASV,P002100,P011386,0.717,0,0,0
98,ASV,P002100,P012080,13.583,9,40,31
98,ASV,P002100,P012729,18.067,12,50,38
98,ASV,P002100,P012730,4.767,4,12,8
98,ASV,P003526,P004194,22.601,-17,47,64
98,ASV,P003526,P006568,16.601,-14,32,46
98,ASV,P003526,P011225,19.051,-22,32,54
98,ASV,P003526,P012080,15.8,-16,28,44
98,ASV,P003526,P012729,11.968,-5,25,30
98,ASV,P003526,P012731,0.167,-3,0,3
98,ASV,P004194,P006568,15.6,-13,34,47
98,ASV,P004194,P011225,18.05,-21,34,55
98,ASV,P004194,P012080,20.649,-11,48,59
98,ASV,P004194,P012729,14.017,0,35,35
98,ASV,P004194,P012731,0.167,-3,0,3
98,ASV,P006568,P011225,20.034,-13,42,55
98,ASV,P006568,P012080,18.866,-13,38,51
98,ASV,P006568,P012729,5.617,0,11,11
98,ASV,P011225,P012080,19.366,-15,38,53
98,ASV,P011225,P012729,7.634,-7,11,18
98,ASV,P011225,P012730,0.75,1,3,2
98,ASV,P011386,P012080,0.717,0,0,0
98,ASV,P011386,P012729,0.717,0,0,0
98,ASV,P011386,P012730,0.717,0,0,0
98,ASV,P012080,P012729,16.15,6,38,32
98,ASV,P012080,P012730,4.767,4,12,8
98,ASV,P012729,P012730,4.767,4,12,8
98,ASV,P012729,P012731,0.167,-3,0,3
98,BAR,P000925,P002939,20.25,17,53,36
98,BAR,P000925,P003478,4.533,-2,13,15
98,BAR,P000925,P004866,16.601,10,39,29
98,BAR,P000925,P006435,18.583,15,49,34
98,BAR,P000925,P007464,7.366,1,19,18
98,BAR,P000925,P007519,3.367,-2,8,10
98,BAR,P000925,P009992,5.35,0,11,11
98,BAR,P000925,P011244,9.784,3,22,19
98,BAR,P000925,P012745,15.566,10,42,32
98,BAR,P002939,P003196,7.15,2,24,22
98,BAR,P002939,P003204,0.983,-5,0,5
98,BAR,P002939,P003478,3.333,0,11,11
98,BAR,P002939,P004866,15.951,17,44,27
98,BAR,P002939,P006435,22.884,27,70,43
98,BAR,P002939,P007464,9.716,2,26,24
98,BAR,P002939,P009992,3.7,0,10,10
98,BAR,P002939,P011244,10.6,-2,23,25
98,BAR,P002939,P012745,18.233,18,55,37
98,BAR,P003196,P003204,1.983,-9,0,9
98,BAR,P003196,P003478,6.717,-11,9,20
98,BAR,P003196,P004866,9.35,1,25,24
98,BAR,P003196,P006435,7.167,13,29,16
98,BAR,P003196,P007464,2.35,1,7,6
98,BAR,P003196,P007519,6.7,-6,11,17
98,BAR,P003196,P009992,0.3,0,3,3
98,BAR,P003196,P011244,10.083,-13,18,31
98,BAR,P003196,P012745,3.6,6,14,8
98,BAR,P003204,P003478,1.983,-9,0,9
98,BAR,P003204,P007519,1.0,-4,0,4
98,BAR,P003204,P011244,1.983,-9,0,9
98,BAR,P003478,P004866,8.517,-9,15,24
98,BAR,P003478,P006435,3.283,3,12,9
98,BAR,P003478,P007519,6.984,-11,10,21
98,BAR,P003478,P009992,0.167,3,3,0
98,BAR,P003478,P011244,10.15,-14,18,32
98,BAR,P003478,P012745,2.533,-2,5,7
98,BAR,P004866,P006435,16.6,16,48,32
98,BAR,P004866,P007519,9.067,-4,19,23
98,BAR,P004866,P009992,3.367,2,6,4
98,BAR,P004866,P011244,17.301,-3,36,39
98,BAR,P004866,P012745,10.25,14,32,18
98,BAR,P006435,P007464,7.6,7,21,14
98,BAR,P006435,P007519,1.133,3,5,2
98,BAR,P006435,P009992,0.167,3,3,0
98,BAR,P006435,P011244,8.533,4,24,20
98,BAR,P006435,P012745,17.05,21,51,30
98,BAR,P007464,P009992,2.116,-5,5,10
98,BAR,P007464,P012745,9.716,2,26,24
98,BAR,P007519,P009992,1.95,0,4,4
98,BAR,P007519,P011244,10.067,-8,19,27
98,BAR,P009992,P011244,3.367,2,6,4
98,BAR,P009992,P012745,2.116,-5,5,10
98,BAR,P011244,P012745,0.8,0,2,2
99,BAS,P003198,P004603,4.9,-3,7,10
99,BAS,P003198,P004761,5.9,-8,8,16
99,BAS,P003198,P007230,6.483,-9,11,20
99,BAS,P003198,P008850,0.3,0,0,0
99,BAS,P003198,P009048,5.233,-4,8,12
99,BAS,P003198,P010444,3.367,-10,5,15
99,BAS,P003198,P011064,2.117,-5,2,7
99,BAS,P003198,P011948,2.4,-6,5,11
99,BAS,P003198,P012201,2.45,-6,3,9
99,BAS,P003198,P012765,1.25,-5,3,8
99,BAS,P004603,P004761,18.167,7,36,29
99,BAS,P004603,P007230,22.267,15,50,35
99,BAS,P004603,P009048,23.067,13,50,37
99,BAS,P004603,P011948,7.35,5,15,10
99,BAS,P004603,P012201,16.517,15,42,27
99,BAS,P004761,P007230,24.317,7,63,56
99,BAS,P004761,P008072,1.733,-1,5,6
99,BAS,P004761,P009048,22.167,7,52,45
99,BAS,P004761,P010444,5.217,-1,22,23
99,BAS,P004761,P011064,1.2,0,5,5
99,BAS,P004761,P011948,6.383,2,19,17
99,BAS,P004761,P012201,13.634,9,36,27
99,BAS,P004761,P012765,1.75,-2,6,8
99,BAS,P007230,P008072,1.75,-1,5,6
99,BAS,P007230,P008850,0.317,0,0,0
99,BAS,P007230,P009048,29.734,20,75,55
99,BAS,P007230,P010444,12.734,8,40,32
99,BAS,P007230,P011064,5.35,3,13,10
99,BAS,P007230,P011948,18.033,18,52,34
99,BAS,P007230,P012201,25.351,25,67,42
99,BAS,P007230,P012765,2.0,-2,8,10
99,BAS,P008072,P008850,0.017,0,0,0
99,BAS,P008072,P009048,1.75,-1,5,6
99,BAS,P008072,P011948,1.733,-1,5,6
99,BAS,P008072,P012201,0.017,0,0,0
99,BAS,P008850,P009048,0.317,0,0,0
99,BAS,P008850,P012201,0.317,0,0,0
99,BAS,P009048,P010444,5.384,7,19,12
99,BAS,P009048,P011948,13.683,10,37,27
99,BAS,P009048,P012201,20.801,20,54,34
99,BAS,P010444,P011064,7.467,-2,15,17
99,BAS,P010444,P011948,11.834,8,33,25
99,BAS,P010444,P012201,11.401,4,26,22
99,BAS,P010444,P012765,2.0,-2,8,10
99,BAS,P011064,P011948,6.267,-2,10,12
99,BAS,P011064,P012201,7.467,-2,15,17
99,BAS,P011948,P012201,15.117,7,33,26
99,BAS,P011948,P012765,1.0,3,7,4
99,PAM,P000556,P003960,6.283,6,15,9
99,PAM,P000556,P005356,2.55,2,9,7
99,PAM,P000556,P007870,7.666,5,21,16
99,PAM,P000556,P010568,4.783,0,13,13
99,PAM,P000556,P011970,3.55,6,10,4
99,PAM,P000556,P011982,1.817,-1,6,7
99,PAM,P000556,P012738,0.183,2,2,0
99,PAM,P000556,P012739,0.617,2,2,0
99,PAM,P000556,P012740,5.683,6,14,8
99,PAM,P003960,P005356,6.966,-10,13,23
99,PAM,P003960,P006643,2.35,-2,2,4
99,PAM,P003960,P007870,18.417,-8,30,38
99,PAM,P003960,P010568,10.199,-20,13,33
99,PAM,P003960,P011970,18.884,-7,30,37
99,PAM,P003960,P011982,14.7,-19,20,39
99,PAM,P003960,P012739,3.116,-6,2,8
99,PAM,P003960,P012740,12.417,6,23,17
99,PAM,P005356,P007870,6.616,-6,15,21
99,PAM,P005356,P010568,17.732,-8,42,50
99,PAM,P005356,P011970,6.5,-2,15,17
99,PAM,P005356,P011982,18.583,-10,40,50
99,PAM,P005356,P012738,9.466,0,21,21
99,PAM,P005356,P012739,11.283,-4,23,27
99,PAM,P005356,P012740,0.3,2,2,0
99,PAM,P006643,P007870,2.35,-2,2,4
99,PAM,P006643,P011970,2.35,-2,2,4
99,PAM,P006643,P012740,2.35,-2,2,4
99,PAM,P007870,P010568,8.799,-16,17,33
99,PAM,P007870,P011970,17.534,-7,30,37
99,PAM,P007870,P011982,13.117,-17,22,39
99,PAM,P007870,P012738,0.183,2,2,0
99,PAM,P007870,P012740,13.05,5,25,20
99,PAM,P010568,P011970,11.183,-11,26,37
99,PAM,P010568,P011982,23.899,-20,53,73
99,PAM,P010568,P012738,12.416,2,34,32
99,PAM,P010568,P012739,15.966,-4,36,40
99,PAM,P010568,P012740,2.483,1,6,5
99,PAM,P011970,P011982,18.467,-11,38,49
99,PAM,P011970,P012738,2.95,2,13,11
99,PAM,P011970,P012739,4.683,0,13,13
99,PAM,P011970,P012740,11.167,8,23,15
99,PAM,P011982,P012738,12.233,0,32,32
99,PAM,P011982,P012739,15.966,-4,36,40
99,PAM,P011982,P012740,5.95,2,13,11
99,PAM,P012738,P012739,12.233,0,32,32
100,BER,P003958,P006251,19.383,2,35,33
100,BER,P003958,P007025,22.867,3,39,36
100,BER,P003958,P008173,19.701,-2,30,32
100,BER,P003958,P008211,11.982,12,31,19
100,BER,P003958,P008384,9.883,8,25,17
100,BER,P003958,P010791,8.083,9,22,13
100,BER,P003958,P011934,20.75,0,38,38
100,BER,P003958,P012721,14.083,8,24,16
100,BER,P006251,P007025,15.6,1,26,25
100,BER,P006251,P008173,10.067,-4,12,16
100,BER,P006251,P008211,12.133,6,23,17
100,BER,P006251,P008384,6.6,1,9,8
100,BER,P006251,P010791,6.15,3,9,6
100,BER,P006251,P011934,16.017,-2,25,27
100,BER,P006251,P012721,2.85,1,1,0
100,BER,P007025,P008173,17.851,-4,25,29
100,BER,P007025,P008211,6.6,3,14,11
100,BER,P007025,P008384,2.651,-3,3,6
100,BER,P007025,P010791,2.417,-4,0,4
100,BER,P007025,P011934,20.768,-2,38,40
100,BER,P007025,P012721,9.05,2,11,9
100,BER,P008173,P008384,4.401,-1,8,9
100,BER,P008173,P010791,3.334,-2,5,7
100,BER,P008173,P011934,15.451,-5,24,29
100,BER,P008173,P012721,11.867,2,16,14
100,BER,P008211,P008384,13.8,1,20,19
100,BER,P008211,P010791,13.067,3,20,17
100,BER,P008211,P011934,13.617,-3,17,20
100,BER,P008211,P012721,6.133,2,11,9
100,BER,P008384,P010791,15.568,1,25,24
100,BER,P008384,P011934,10.951,-9,6,15
100,BER,P008384,P012721,8.95,2,16,14
100,BER,P010791,P011934,8.318,-8,3,11
100,BER,P010791,P012721,8.667,2,16,14
100,BER,P011934,P012721,10.4,-3,13,16
100,ZAL,P002329,P003210,5.484,-6,6,12
100,ZAL,P002329,P003211,10.85,-13,17,30
100,ZAL,P002329,P005504,3.95,-17,0,17
100,ZAL,P002329,P006860,10.734,-14,11,25
100,ZAL,P002329,P007109,20.9,6,35,29
100,ZAL,P002329,P007513,23.834,-1,35,36
100,ZAL,P002329,P010390,23.634,9,49,40
100,ZAL,P002329,P011218,22.284,0,43,43
100,ZAL,P002329,P012784,0.167,0,0,0
100,ZAL,P002329,P012787,0.167,0,0,0
100,ZAL,P003210,P003211,6.3,-4,7,11
100,ZAL,P003210,P005504,6.3,-4,7,11
100,ZAL,P003210,P006860,10.717,-2,13,15
100,ZAL,P003210,P007109,2.817,-1,0,1
100,ZAL,P003210,P007513,2.817,-1,0,1
100,ZAL,P003210,P010390,1.6,3,6,3
100,ZAL,P003210,P011218,1.6,3,6,3
100,ZAL,P003210,P012787,5.233,4,7,3
100,ZAL,P003211,P005504,7.366,-7,7,14
100,ZAL,P003211,P006860,9.682,-6,12,18
100,ZAL,P003211,P007109,8.983,2,15,13
100,ZAL,P003211,P007513,5.95,-2,9,11
100,ZAL,P003211,P010390,12.883,1,23,22
100,ZAL,P003211,P011218,9.65,-2,17,19
100,ZAL,P003211,P012784,0.233,0,0,0
100,ZAL,P003211,P012787,9.499,7,13,6
100,ZAL,P005504,P006860,9.466,-13,7,20
100,ZAL,P005504,P007109,0.033,0,0,0
100,ZAL,P005504,P007513,2.1,-6,0,6
100,ZAL,P005504,P011218,3.133,-9,0,9
100,ZAL,P005504,P012787,5.516,4,7,3
100,ZAL,P006860,P007109,2.85,-1,0,1
100,ZAL,P006860,P007513,5.784,-9,0,9
100,ZAL,P006860,P010390,4.2,4,11,7
100,ZAL,P006860,P011218,6.183,-3,11,14
100,ZAL,P006860,P012784,0.4,0,0,0
100,ZAL,P006860,P012787,5.916,4,7,3
100,ZAL,P007109,P007513,19.15,9,32,23
100,ZAL,P007109,P010390,21.7,10,41,31
100,ZAL,P007109,P011218,18.417,8,35,27
100,ZAL,P007109,P012787,3.75,3,6,3
100,ZAL,P007513,P010390,18.817,6,35,29
100,ZAL,P007513,P011218,16.884,0,29,29
100,ZAL,P010390,P011218,23.084,12,49,37
100,ZAL,P010390,P012784,0.4,0,0,0
100,ZAL,P010390,P012787,4.15,3,6,3
100,ZAL,P011218,P012787,4.033,3,6,3
100,ZAL,P012784,P012787,0.4,0,0,0
101,IST,P006372,P007200,9.933,10,21,11
101,IST,P006372,P009513,4.883,-1,7,8
101,IST,P006372,P010516,2.183,2,2,0
101,IST,P006372,P011078,8.233,9,20,11
101,IST,P006372,P011981,7.8,9,20,11
101,IST,P006372,P012710,5.583,1,7,6
101,IST,P006372,P012786,7.033,9,18,9
101,IST,P006372,P012788,4.816,1,5,4
101,IST,P007200,P009513,15.533,-1,27,28
101,IST,P007200,P010516,12.932,-6,21,27
101,IST,P007200,P011078,24.267,11,55,44
101,IST,P007200,P011981,27.767,14,62,48
101,IST,P007200,P012710,20.816,10,38,28
101,IST,P007200,P012786,17.883,-1,35,36
101,IST,P007200,P012788,8.733,-1,9,10
101,IST,P009513,P010516,4.033,-10,0,10
101,IST,P009513,P011078,12.667,-1,21,22
101,IST,P009513,P011981,14.516,4,28,24
101,IST,P009513,P012710,16.066,-2,26,28
101,IST,P009513,P012786,8.416,-7,9,16
101,IST,P009513,P012788,8.15,-10,6,16
101,IST,P010516,P011078,12.083,-10,19,29
101,IST,P010516,P011981,9.999,-8,19,27
101,IST,P010516,P012710,8.149,-1,11,12
101,IST,P010516,P012786,7.583,-9,10,19
101,IST,P010516,P012788,6.166,-6,2,8
101,IST,P011078,P011981,25.767,15,59,44
101,IST,P011078,P012710,12.784,10,28,18
101,IST,P011078,P012786,16.183,-2,30,32
101,IST,P011078,P012788,5.684,-4,4,8
101,IST,P011981,P012710,16.883,9,35,26
101,IST,P011981,P012786,18.183,3,37,34
101,IST,P011981,P012788,2.417,2,4,2
101,IST,P012710,P012786,5.5,1,9,8
101,IST,P012710,P012788,7.683,-4,6,10
101,IST,P012786,P012788,2.683,-6,0,6
101,PAN,P001926,P002328,10.466,-1,16,17
101,PAN,P001926,P003842,20.434,4,37,33
101,PAN,P001926,P007553,2.183,1,5,4
101,PAN,P001926,P007866,25.9,4,47,43
101,PAN,P001926,P007947,5.0,-1,6,7
101,PAN,P001926,P008084,1.733,-3,2,5
101,PAN,P001926,P011204,22.633,2,43,41
101,PAN,P001926,P011221,5.016,-4,7,11
101,PAN,P001926,P012774,17.167,2,33,31
101,PAN,P002328,P003842,12.568,-6,19,25
101,PAN,P002328,P007553,4.216,2,8,6
101,PAN,P002328,P007866,16.6,-3,26,29
101,PAN,P002328,P007947,6.417,-1,8,9
101,PAN,P002328,P008084,1.733,-3,2,5
101,PAN,P002328,P011204,14.483,-6,25,31
101,PAN,P002328,P011221,6.683,-4,11,15
101,PAN,P002328,P012774,10.434,-6,17,23
101,PAN,P003842,P007553,0.9,-1,1,2
101,PAN,P003842,P007866,27.168,-3,47,50
101,PAN,P003842,P007947,4.684,2,6,4
101,PAN,P003842,P011204,26.984,-4,48,52
101,PAN,P003842,P011221,3.6,2,6,4
101,PAN,P003842,P011826,1.933,2,2,0
101,PAN,P003842,P012774,28.401,-4,50,54
101,PAN,P007553,P007866,3.316,3,7,4
101,PAN,P007553,P011204,4.216,2,8,6
101,PAN,P007553,P012774,2.033,1,3,2
101,PAN,P007866,P007947,4.684,2,6,4
101,PAN,P007866,P011204,29.083,-3,53,56
101,PAN,P007866,P011221,3.283,-1,5,6
101,PAN,P007866,P012774,25.034,-3,45,48
101,PAN,P007947,P008084,1.733,-3,2,5
101,PAN,P007947,P011221,1.733,-3,2,5
101,PAN,P007947,P012774,1.417,0,2,2
101,PAN,P008084,P011221,1.733,-3,2,5
101,PAN,P011204,P011221,6.883,1,11,10
101,PAN,P011204,P011826,1.933,2,2,0
101,PAN,P011204,P012774,28.117,-2,50,52
101,PAN,P011221,P011826,1.933,2,2,0
101,PAN,P011221,P012774,3.6,2,6,4
101,PAN,P011826,P012774,1.933,2,2,0
102,MIL,P001518,P002812,0.317,2,2,0
102,MIL,P001518,P005670,0.317,2,2,0
102,MIL,P001518,P006701,0.317,2,2,0
102,MIL,P001518,P011205,0.317,2,2,0
102,MIL,P002812,P002849,3.65,-10,5,15
102,MIL,P002812,P005670,14.117,8,29,21
102,MIL,P002812,P006509,2.517,-5,5,10
102,MIL,P002812,P006701,2.984,1,6,5
102,MIL,P002812,P007032,9.184,6,18,12
102,MIL,P002812,P007201,13.867,11,27,16
102,MIL,P002812,P007831,8.333,-5,13,18
102,MIL,P002812,P011205,16.367,4,31,27
102,MIL,P002849,P005670,4.033,-14,2,16
102,MIL,P002849,P006509,24.55,-7,48,55
102,MIL,P002849,P007032,17.683,-2,34,36
102,MIL,P002849,P007201,10.45,-1,22,23
102,MIL,P002849,P007831,30.816,-20,55,75
102,MIL,P002849,P009960,16.716,-9,28,37
102,MIL,P002849,P011205,15.366,-17,26,43
102,MIL,P005670,P006509,0.933,-4,0,4
102,MIL,P005670,P006701,2.984,1,6,5
102,MIL,P005670,P007032,6.517,7,15,8
102,MIL,P005670,P007201,12.667,11,27,16
102,MIL,P005670,P007831,7.516,-9,10,19
102,MIL,P005670,P009960,2.9,-9,2,11
102,MIL,P005670,P011205,16.084,3,31,28
102,MIL,P006509,P007032,14.517,1,29,28
102,MIL,P006509,P007201,9.317,-4,17,21
102,MIL,P006509,P007831,24.55,-7,48,55
102,MIL,P006509,P009960,12.716,2,26,24
102,MIL,P006509,P011205,9.1,-4,19,23
102,MIL,P006701,P007201,2.667,-1,4,5
102,MIL,P006701,P011205,2.984,1,6,5
102,MIL,P007032,P007201,10.117,6,20,14
102,MIL,P007032,P007831,18.883,-2,34,36
102,MIL,P007032,P009960,13.816,0,26,26
102,MIL,P007032,P011205,10.883,4,20,16
102,MIL,P007201,P007831,15.133,4,30,26
102,MIL,P007201,P011205,23.05,14,49,35
102,MIL,P007831,P009960,16.716,-9,28,37
102,MIL,P007831,P011205,20.049,-12,34,46
102,MIL,P009960,P011205,4.0,-11,2,13
102,MUN,P001557,P003583,5.167,-3,6,9
102,MUN,P001557,P006543,3.267,1,5,4
102,MUN,P001557,P006760,2.767,-7,3,10
102,MUN,P001557,P007056,6.967,-7,6,13
102,MUN,P001557,P007639,5.017,-9,3,12
102,MUN,P001557,P007975,13.935,-15,14,29
102,MUN,P001557,P010391,9.119,-13,8,21
102,MUN,P001557,P011941,3.751,-3,5,8
102,MUN,P001557,P011987,5.75,-4,6,10
102,MUN,P003583,P006245,4.15,-2,11,13
102,MUN,P003583,P006543,2.033,6,6,0
102,MUN,P003583,P006760,28.2,20,68,48
102,MUN,P003583,P007056,32.117,15,74,59
102,MUN,P003583,P007975,10.734,16,29,13
102,MUN,P003583,P010391,22.817,10,46,36
102,MUN,P003583,P011987,33.85,22,80,58
102,MUN,P006245,P006760,4.15,-2,11,13
102,MUN,P006245,P007056,4.15,-2,11,13
102,MUN,P006245,P011987,4.15,-2,11,13
102,MUN,P006543,P006760,2.033,6,6,0
102,MUN,P006543,P007975,4.734,-1,8,9
102,MUN,P006543,P010391,6.767,5,14,9
102,MUN,P006543,P011941,4.734,-1,8,9
102,MUN,P006543,P011987,3.5,4,9,5
102,MUN,P006760,P007056,26.167,14,62,48
102,MUN,P006760,P007639,2.767,-7,3,10
102,MUN,P006760,P007975,6.934,8,20,12
102,MUN,P006760,P010391,22.65,0,43,43
102,MUN,P006760,P011987,28.2,20,68,48
102,MUN,P007056,P007639,2.25,-2,0,2
102,MUN,P007056,P007975,12.534,12,29,17
102,MUN,P007056,P010391,21.401,0,40,40
102,MUN,P007056,P011941,0.167,-2,0,2
102,MUN,P007056,P011987,32.383,16,74,58
102,MUN,P007639,P007975,5.017,-9,3,12
102,MUN,P007639,P010391,3.834,-9,3,12
102,MUN,P007639,P011987,1.183,0,0,0
102,MUN,P007975,P010391,11.986,-11,17,28
102,MUN,P007975,P011941,5.218,-5,8,13
102,MUN,P007975,P011987,12.784,13,32,19
102,MUN,P010391,P011941,5.218,-5,8,13
102,MUN,P010391,P011987,23.684,7,49,42
102,MUN,P011941,P011987,1.784,-4,3,7
103,MAD,P001392,P003108,1.817,3,8,5
103,MAD,P001392,P005791,11.467,2,26,24
103,MAD,P001392,P005928,11.467,2,26,24
103,MAD,P001392,P006540,11.467,2,26,24
103,MAD,P001392,P009213,9.65,-1,18,19
103,MAD,P003108,P004887,17.467,-5,29,34
103,MAD,P003108,P005791,11.383,10,26,16
103,MAD,P003108,P005928,16.533,12,36,24
103,MAD,P003108,P006540,14.433,4,32,28
103,MAD,P003108,P009005,25.583,4,47,43
103,MAD,P003108,P010623,7.117,-1,12,13
103,MAD,P003108,PTGB,21.067,-7,30,37
103,MAD,P004887,P005928,5.683,4,12,8
103,MAD,P004887,P006540,7.4,-4,11,15
103,MAD,P004887,P009005,16.017,-3,29,32
103,MAD,P004887,P010623,7.117,-1,12,13
103,MAD,P004887,PTGB,16.184,-11,23,34
103,MAD,P005791,P005928,22.0,9,46,37
103,MAD,P005791,P006540,18.183,9,43,34
103,MAD,P005791,P009005,11.066,9,22,13
103,MAD,P005791,P009213,10.433,-1,20,21
103,MAD,P005791,PTGB,5.6,6,9,3
103,MAD,P005928,P006540,20.383,11,47,36
103,MAD,P005928,P009005,14.766,13,32,19
103,MAD,P005928,P009213,10.433,-1,20,21
103,MAD,P005928,PTGB,9.467,2,13,11
103,MAD,P006540,P009005,12.666,5,28,23
103,MAD,P006540,P009213,10.433,-1,20,21
103,MAD,P006540,PTGB,7.367,-6,9,15
103,MAD,P009005,P009213,0.783,0,2,2
103,MAD,P009005,P010623,7.117,-1,12,13
103,MAD,P009005,PTGB,20.334,-3,32,35
103,MAD,P010623,PTGB,7.117,-1,12,13
103,OLY,P001255,P003941,7.517,-3,13,16
103,OLY,P001255,P006302,5.484,-6,11,17
103,OLY,P001255,P006589,0.717,-2,0,2
103,OLY,P001255,P007853,10.901,2,18,16
103,OLY,P001255,P008811,21.568,-1,39,40
103,OLY,P001255,P008829,21.151,-3,41,44
103,OLY,P001255,P008855,20.984,-1,36,37
103,OLY,P001255,P010392,10.834,2,16,14
103,OLY,P001255,P010612,14.534,-4,28,32
103,OLY,P001255,P011983,2.65,0,6,6
103,OLY,P003941,P006302,6.75,-4,11,15
103,OLY,P003941,P006589,3.95,-1,6,7
103,OLY,P003941,P007853,8.9,-1,16,17
103,OLY,P003941,P008829,7.083,-2,14,16
103,OLY,P003941,P008855,11.75,0,23,23
103,OLY,P003941,P010392,8.4,1,17,16
103,OLY,P003941,P010612,3.4,-3,5,8
103,OLY,P003941,P011983,2.85,1,7,6
103,OLY,P006302,P006589,5.85,-2,8,10
103,OLY,P006302,P007853,6.2,-2,10,12
103,OLY,P006302,P008811,3.867,-2,8,10
103,OLY,P006302,P008829,4.767,-4,11,15
103,OLY,P006302,P008855,5.133,0,8,8
103,OLY,P006302,P010612,4.417,-4,9,13
103,OLY,P006589,P007853,6.45,-2,8,10
103,OLY,P006589,P008811,2.5,-1,2,3
103,OLY,P006589,P008855,5.733,0,8,8
103,OLY,P006589,P010392,0.6,0,0,0
103,OLY,P007853,P008811,8.567,3,12,9
103,OLY,P007853,P008829,3.8,3,9,6
103,OLY,P007853,P008855,13.783,1,21,20
103,OLY,P007853,P010392,11.017,6,18,12
103,OLY,P007853,P010612,0.25,-2,0,2
103,OLY,P008811,P008829,19.251,-3,38,41
103,OLY,P008811,P008855,20.15,-3,32,35
103,OLY,P008811,P010392,8.217,-1,10,11
103,OLY,P008811,P010612,11.134,-1,23,24
103,OLY,P008811,P011983,4.15,-3,8,11
103,OLY,P008829,P008855,18.95,-4,36,40
103,OLY,P008829,P010392,8.8,-1,16,17
103,OLY,P008829,P010612,14.534,-4,28,32
103,OLY,P008829,P011983,7.0,-2,15,17
103,OLY,P008855,P010392,14.25,-5,22,27
103,OLY,P008855,P010612,9.867,2,19,17
103,OLY,P008855,P011983,7.0,-2,15,17
103,OLY,P010392,P011983,4.35,-2,9,11
104,MCO,P004197,P005985,3.9,-9,2,11
104,MCO,P004197,P009754,3.9,-9,2,11
104,MCO,P004197,P010588,3.9,-9,2,11
104,MCO,P004197,PLCZ,3.9,-9,2,11
104,MCO,P004790,P005985,1.717,4,5,1
104,MCO,P004790,P010588,2.7,3,6,3
104,MCO,P004790,P011212,2.7,3,6,3
104,MCO,P004790,P011226,2.7,3,6,3
104,MCO,P004790,P012709,0.983,-1,1,2
104,MCO,P005985,P009754,22.899,-4,42,46
104,MCO,P005985,P010588,33.133,-1,66,67
104,MCO,P005985,P011196,8.933,0,15,15
104,MCO,P005985,P011212,18.133,7,42,35
104,MCO,P005985,P011226,29.516,13,61,48
104,MCO,P005985,P011231,15.216,-3,24,27
104,MCO,P005985,PLCZ,22.217,-7,39,46
104,MCO,P009754,P010588,22.316,-6,42,48
104,MCO,P009754,P011196,2.45,-3,2,5
104,MCO,P009754,P011212,2.133,1,10,9
104,MCO,P009754,P011226,15.383,7,34,27
104,MCO,P009754,P011231,5.833,-4,8,12
104,MCO,P009754,PLCZ,16.75,-6,28,34
104,MCO,P010588,P011196,3.75,-3,7,10
104,MCO,P010588,P011212,14.55,1,35,34
104,MCO,P010588,P011226,25.333,7,54,47
104,MCO,P010588,P011231,9.433,-4,16,20
104,MCO,P010588,P012709,1.583,-3,1,4
104,MCO,P010588,PLCZ,22.234,-9,39,48
104,MCO,P011196,P011212,11.566,2,23,21
104,MCO,P011196,P011226,10.866,0,18,18
104,MCO,P011196,P011231,13.416,1,25,24
104,MCO,P011196,P012709,5.083,-1,10,11
104,MCO,P011212,P011226,20.566,4,44,40
104,MCO,P011212,P011231,13.866,2,26,24
104,MCO,P011212,P012709,6.066,-2,11,13
104,MCO,P011212,PLCZ,7.284,-6,15,21
104,MCO,P011226,P011231,15.982,1,27,26
104,MCO,P011226,P012709,6.066,-2,11,13
104,MCO,P011226,PLCZ,15.984,3,33,30
104,MCO,P011231,P012709,4.483,1,10,9
104,MCO,P011231,PLCZ,0.567,-2,0,2
104,PAR,P000956,P007400,8.716,2,15,13
104,PAR,P000956,P008987,3.133,-2,3,5
104,PAR,P000956,P009862,6.383,4,12,8
104,PAR,P000956,P011050,2.333,-2,3,5
104,PAR,P000956,P011051,2.433,-2,4,6
104,PAR,P000956,P012096,3.15,6,8,2
104,PAR,P000956,P012742,8.716,2,15,13
104,PAR,P003983,P004172,3.767,-4,6,10
104,PAR,P003983,P007400,7.25,-5,11,16
104,PAR,P003983,P008987,4.367,-4,6,10
104,PAR,P003983,P009212,6.65,-5,11,16
104,PAR,P003983,P009862,3.483,-1,5,6
104,PAR,P003983,P012096,3.483,-1,5,6
104,PAR,P004172,P007400,4.75,-3,8,11
104,PAR,P004172,P008987,4.75,-3,8,11
104,PAR,P004172,P009212,4.75,-3,8,11
104,PAR,P004172,P009862,0.983,1,2,1
104,PAR,P007400,P008987,31.05,-6,61,67
104,PAR,P007400,P009212,7.633,-4,13,17
104,PAR,P007400,P009862,33.416,3,69,66
104,PAR,P007400,P011050,5.883,2,12,10
104,PAR,P007400,P011051,15.583,-11,31,42
104,PAR,P007400,P012096,12.5,9,27,18
104,PAR,P007400,P012742,31.283,1,65,64
104,PAR,P008987,P009212,4.75,-3,8,11
104,PAR,P008987,P009862,30.433,7,63,56
104,PAR,P008987,P011050,5.883,2,12,10
104,PAR,P008987,P011051,18.633,-2,38,40
104,PAR,P008987,P012096,11.95,11,25,14
104,PAR,P008987,P012742,31.183,4,64,60
104,PAR,P009212,P009862,3.866,0,7,7
104,PAR,P009212,P012096,2.883,-1,5,6
104,PAR,P009862,P011050,3.55,4,9,5
104,PAR,P009862,P011051,21.066,-4,42,46
104,PAR,P009862,P012096,17.983,16,38,22
104,PAR,P009862,P012742,34.433,10,73,63
104,PAR,P011050,P012742,5.883,2,12,10
104,PAR,P011051,P012096,5.483,7,11,4
104,PAR,P011051,P012742,21.066,-4,42,46
104,PAR,P012096,P012742,14.5,17,33,16
105,ASV,P000229,P002100,17.915,2,46,44
105,ASV,P000229,P003526,0.217,0,0,0
105,ASV,P000229,P004194,11.816,10,30,20
105,ASV,P000229,P006568,2.833,3,12,9
105,ASV,P000229,P011225,12.333,17,39,22
105,ASV,P000229,P011386,1.316,-9,0,9
105,ASV,P000229,P012080,14.083,-2,33,35
105,ASV,P000229,P012729,22.932,4,59,55
105,ASV,P000229,P012730,8.283,-9,17,26
105,ASV,P002100,P004194,13.682,4,40,36
105,ASV,P002100,P006568,1.666,-2,3,5
105,ASV,P002100,P011225,12.566,9,40,31
105,ASV,P002100,P011386,1.316,-9,0,9
105,ASV,P002100,P012080,14.099,-10,34,44
105,ASV,P002100,P012729,22.265,-1,60,61
105,ASV,P002100,P012730,8.283,-9,17,26
105,ASV,P003526,P004194,12.25,-1,18,19
105,ASV,P003526,P006568,12.033,-1,18,19
105,ASV,P003526,P011225,12.033,-1,18,19
105,ASV,P003526,P012080,12.25,-1,18,19
105,ASV,P003526,P012729,0.217,0,0,0
105,ASV,P004194,P006568,12.716,-4,18,22
105,ASV,P004194,P011225,26.349,12,62,50
105,ASV,P004194,P011386,0.833,-5,0,5
105,ASV,P004194,P012080,19.916,-5,36,41
105,ASV,P004194,P012729,15.566,9,44,35
105,ASV,P006568,P011225,15.766,-6,27,33
105,ASV,P006568,P012080,16.149,-3,30,33
105,ASV,P006568,P012729,3.433,1,12,11
105,ASV,P011225,P012080,21.866,-5,45,50
105,ASV,P011225,P012729,16.683,14,53,39
105,ASV,P011386,P012729,1.316,-9,0,9
105,ASV,P011386,P012730,0.483,-4,0,4
105,ASV,P012080,P012729,18.433,-5,47,52
105,ASV,P012080,P012730,7.8,-5,17,22
105,ASV,P012729,P012730,8.283,-9,17,26
105,TEL,P004233,P005145,1.05,-2,3,5
105,TEL,P004233,P009783,0.05,0,0,0
105,TEL,P004233,P009863,2.417,-1,6,7
105,TEL,P004233,P011193,5.05,-1,11,12
105,TEL,P004233,P011199,1.1,-2,3,5
105,TEL,P004233,P011214,4.05,1,8,7
105,TEL,P004233,P011219,4.0,1,8,7
105,TEL,P004233,P012744,2.683,0,5,5
105,TEL,P005145,P009622,7.734,0,13,13
105,TEL,P005145,P009783,8.484,2,15,13
105,TEL,P005145,P009863,9.534,0,18,18
105,TEL,P005145,P011193,2.017,0,5,5
105,TEL,P005145,P011199,9.317,0,18,18
105,TEL,P009622,P009783,26.218,-4,60,64
105,TEL,P009622,P009863,25.751,0,60,60
105,TEL,P009622,P011193,3.451,-3,9,12
105,TEL,P009622,P011199,16.351,-7,38,45
105,TEL,P009622,P011214,11.95,3,27,24
105,TEL,P009622,P011219,16.133,2,40,38
105,TEL,P009622,P011971,4.184,-7,8,15
105,TEL,P009622,P012744,2.3,0,5,5
105,TEL,P009783,P009863,28.201,2,64,62
105,TEL,P009783,P011193,3.551,-1,8,9
105,TEL,P009783,P011199,14.851,-5,35,40
105,TEL,P009783,P011214,13.65,3,29,26
105,TEL,P009783,P011219,17.783,2,42,40
105,TEL,P009783,P011971,1.884,-7,3,10
105,TEL,P009863,P011193,9.434,8,28,20
105,TEL,P009863,P011199,15.434,-3,38,41
105,TEL,P009863,P011214,18.95,10,46,36
105,TEL,P009863,P011219,23.083,9,59,50
105,TEL,P009863,P011971,1.417,-3,3,6
105,TEL,P009863,P012744,3.983,6,14,8
105,TEL,P011193,P011199,5.034,-3,14,17
105,TEL,P011193,P011214,9.633,7,24,17
105,TEL,P011193,P011219,9.633,7,24,17
105,TEL,P011193,P011971,2.767,-4,5,9
105,TEL,P011193,P012744,8.966,6,24,18
105,TEL,P011199,P011214,0.05,0,0,0
105,TEL,P011199,P011219,4.183,-1,13,14
105,TEL,P011199,P011971,4.184,-7,8,15
105,TEL,P011199,P012744,2.3,0,5,5
105,TEL,P011214,P011219,21.583,10,51,41
105,TEL,P011214,P012744,6.666,6,19,13
105,TEL,P011219,P012744,6.666,6,19,13
105,TEL,P011971,P012744,2.3,0,5,5
106,BAS,P003198,P004603,5.567,-2,8,10
106,BAS,P003198,P004761,5.567,-2,8,10
106,BAS,P003198,P007230,5.567,-2,8,10
106,BAS,P003198,P009048,5.567,-2,8,10
106,BAS,P004603,P004761,20.25,7,42,35
106,BAS,P004603,P007230,16.483,-3,32,35
106,BAS,P004603,P009048,25.95,6,53,47
106,BAS,P004603,P011064,2.167,3,6,3
106,BAS,P004603,P011085,7.75,5,19,14
106,BAS,P004603,P011948,17.534,17,48,31
106,BAS,P004603,P012201,19.367,15,48,33
106,BAS,P004761,P007230,11.716,-3,19,22
106,BAS,P004761,P008072,2.65,-5,2,7
106,BAS,P004761,P009048,22.483,2,42,40
106,BAS,P004761,P011085,6.633,-3,13,16
106,BAS,P004761,P011948,10.7,13,31,18
106,BAS,P004761,P012201,12.533,11,31,20
106,BAS,P007230,P008072,3.333,-5,0,5
106,BAS,P007230,P009048,15.749,-6,29,35
106,BAS,P007230,P011064,4.3,1,6,5
106,BAS,P007230,P011085,7.166,-6,8,14
106,BAS,P007230,P011948,8.566,1,19,18
106,BAS,P007230,P012201,7.316,3,19,16
106,BAS,P008072,P009048,5.05,-6,5,11
106,BAS,P008072,P011064,5.95,-8,8,16
106,BAS,P008072,P011085,9.55,-12,11,23
106,BAS,P008072,P011948,9.8,-11,13,24
106,BAS,P008072,P012201,7.667,-9,13,22
106,BAS,P009048,P011085,10.7,-2,17,19
106,BAS,P009048,P011948,18.8,11,45,34
106,BAS,P009048,P012201,20.633,9,45,36
106,BAS,P011064,P011085,5.95,-8,8,16
106,BAS,P011064,P011948,8.117,-5,14,19
106,BAS,P011064,P012201,5.984,-3,14,17
106,BAS,P011085,P011948,11.317,-1,22,23
106,BAS,P011085,P012201,10.134,-1,22,23
106,BAS,P011948,P012201,25.434,11,64,53
106,ULK,P001932,P002968,0.933,-1,3,4
106,ULK,P001932,P004004,12.316,-6,18,24
106,ULK,P001932,P008962,12.317,1,21,20
106,ULK,P001932,P009849,2.267,0,6,6
106,ULK,P001932,P010560,13.65,-5,21,26
106,ULK,P001932,P011052,0.933,-1,3,4
106,ULK,P001932,P011157,13.65,-5,21,26
106,ULK,P001932,P011980,2.266,-7,3,10
106,ULK,P002968,P004004,7.934,-1,13,14
106,ULK,P002968,P006661,6.917,1,17,16
106,ULK,P002968,P008962,14.184,4,31,27
106,ULK,P002968,P009849,7.217,0,13,13
106,ULK,P002968,P010560,9.767,5,24,19
106,ULK,P002968,P011052,16.384,2,35,33
106,ULK,P002968,P011980,2.2,-2,4,6
106,ULK,P004004,P006661,1.267,-1,1,2
106,ULK,P004004,P008962,22.184,4,41,37
106,ULK,P004004,P009849,9.884,4,24,20
106,ULK,P004004,P010560,13.633,-6,17,23
106,ULK,P004004,P011052,14.334,1,30,29
106,ULK,P004004,P011157,17.783,-3,32,35
106,ULK,P004004,P011980,3.533,-8,4,12
106,ULK,P006661,P008962,9.217,2,22,20
106,ULK,P006661,P009849,3.567,0,6,6
106,ULK,P006661,P010560,9.217,2,22,20
106,ULK,P006661,P011052,6.917,1,17,16
106,ULK,P006661,P011157,3.567,0,6,6
106,ULK,P006661,P011980,1.267,-1,1,2
106,ULK,P008962,P009849,18.518,5,42,37
106,ULK,P008962,P010560,26.584,3,51,48
106,ULK,P008962,P011052,20.584,6,48,42
106,ULK,P008962,P011157,22.284,3,44,41
106,ULK,P009849,P010560,8.634,1,18,17
106,ULK,P009849,P011052,12.684,5,30,25
106,ULK,P009849,P011157,11.301,5,29,24
106,ULK,P010560,P011052,10.7,2,24,22
106,ULK,P010560,P011157,18.15,-8,27,35
106,ULK,P010560,P011980,1.333,-6,0,6
106,ULK,P011052,P011157,6.4,2,17,15
106,ULK,P011052,P011980,2.2,-2,4,6
106,ULK,P011157,P011980,1.333,-6,0,6
107,PAM,P000556,P004863,9.366,12,23,11
107,PAM,P000556,P005356,11.416,2,32,30
107,PAM,P000556,P006643,5.866,-5,6,11
107,PAM,P000556,P007870,14.083,1,32,31
107,PAM,P000556,P010568,18.133,-5,38,43
107,PAM,P000556,P011970,11.533,5,25,20
107,PAM,P000556,P011982,19.333,11,52,41
107,PAM,P000556,P012739,11.066,3,24,21
107,PAM,P003960,P004863,11.35,5,22,17
107,PAM,P003960,P005356,0.917,0,3,3
107,PAM,P003960,P006643,12.984,1,25,24
107,PAM,P003960,P007870,12.984,1,25,24
107,PAM,P003960,P010568,4.234,-2,10,12
107,PAM,P003960,P011970,9.467,-1,15,16
107,PAM,P004863,P005356,0.716,4,4,0
107,PAM,P004863,P006643,12.783,2,22,20
107,PAM,P004863,P007870,17.517,10,38,28
107,PAM,P004863,P010568,6.717,0,12,12
107,PAM,P004863,P011970,16.917,7,33,26
107,PAM,P004863,P011982,9.75,12,25,13
107,PAM,P004863,P012739,5.016,4,9,5
107,PAM,P005356,P006643,1.85,0,5,5
107,PAM,P005356,P007870,5.9,-1,16,17
107,PAM,P005356,P010568,11.617,-2,31,33
107,PAM,P005356,P011970,0.05,2,2,0
107,PAM,P005356,P011982,10.483,2,30,28
107,PAM,P005356,P012739,6.383,1,17,16
107,PAM,P006643,P007870,17.417,-1,31,32
107,PAM,P006643,P010568,8.667,-4,16,20
107,PAM,P006643,P011970,14.4,-6,19,25
107,PAM,P006643,P012739,1.433,-3,0,3
107,PAM,P007870,P010568,15.951,-12,30,42
107,PAM,P007870,P011970,20.217,-2,36,38
107,PAM,P007870,P011982,11.467,0,28,28
107,PAM,P010568,P011970,7.717,-9,11,20
107,PAM,P010568,P011982,15.517,-6,34,40
107,PAM,P010568,P012739,8.183,0,18,18
107,PAM,P011970,P011982,8.417,7,23,16
107,PAM,P011970,P012739,2.55,1,4,3
107,PAM,P011982,P012739,9.633,6,24,18
107,RED,P000848,P002553,8.634,-5,12,17
107,RED,P000848,P004720,1.067,-5,0,5
107,RED,P000848,P006436,14.451,-9,21,30
107,RED,P000848,P007960,9.684,-5,16,21
107,RED,P000848,P008966,4.567,-9,6,15
107,RED,P000848,P009035,13.751,-1,22,23
107,RED,P000848,P011224,7.901,1,14,13
107,RED,P000848,P012044,9.45,-14,11,25
107,RED,P000848,PJDR,3.767,7,10,3
107,RED,P002553,P004720,1.433,1,3,2
107,RED,P002553,P006436,15.151,-2,28,30
107,RED,P002553,P007960,9.283,9,23,14
107,RED,P002553,P008966,3.25,2,6,4
107,RED,P002553,P009035,18.534,6,38,32
107,RED,P002553,P011224,5.6,1,11,10
107,RED,P002553,P012044,6.667,-10,7,17
107,RED,P002553,PJDR,9.517,17,26,9
107,RED,P002553,PLUO,9.067,13,22,9
107,RED,P004720,P006436,0.65,-5,0,5
107,RED,P004720,P007960,6.633,-5,15,20
107,RED,P004720,P008966,4.8,-2,12,14
107,RED,P004720,P009035,2.383,-4,3,7
107,RED,P004720,P011224,5.383,-2,12,14
107,RED,P004720,P012711,0.65,-5,0,5
107,RED,P004720,PJDR,5.533,-1,15,16
107,RED,P004720,PLUO,0.4,-4,0,4
107,RED,P006436,P007960,9.3,-10,16,26
107,RED,P006436,P008966,6.75,-2,12,14
107,RED,P006436,P009035,15.601,-10,25,35
107,RED,P006436,P011224,6.684,1,14,13
107,RED,P006436,P012044,10.167,-14,13,27
107,RED,P006436,P012711,0.65,-5,0,5
107,RED,P006436,PJDR,5.5,1,10,9
107,RED,P006436,PLUO,4.7,-1,9,10
107,RED,P007960,P008966,11.583,-8,27,35
107,RED,P007960,P009035,15.266,10,33,23
107,RED,P007960,P011224,15.516,1,38,37
107,RED,P007960,P012044,3.5,-4,6,10
107,RED,P007960,P012711,0.05,-2,0,2
107,RED,P007960,PJDR,17.382,12,44,32
107,RED,P007960,PLUO,9.399,2,22,20
107,RED,P008966,P011224,8.083,-4,21,25
107,RED,P008966,P012044,3.5,-4,6,10
107,RED,P008966,PJDR,7.866,7,23,16
107,RED,P008966,PLUO,4.133,4,11,7
107,RED,P009035,P011224,9.8,7,21,14
107,RED,P009035,P012044,6.667,-10,7,17
107,RED,P009035,P012711,0.6,-3,0,3
107,RED,P009035,PJDR,13.583,9,31,22
107,RED,P009035,PLUO,9.083,4,20,16
107,RED,P011224,PJDR,9.549,7,28,21
107,RED,P011224,PLUO,3.016,0,9,9
107,RED,P012044,PLUO,0.717,0,2,2
107,RED,P012711,PJDR,0.6,-3,0,3
107,RED,P012711,PLUO,0.05,-2,0,2
107,RED,PJDR,PLUO,12.499,8,29,21
108,BAR,P000925,P002939,22.016,-2,36,38
108,BAR,P000925,P003204,0.367,2,2,0
108,BAR,P000925,P003478,9.133,-1,16,17
108,BAR,P000925,P004866,16.549,-1,28,29
108,BAR,P000925,P006435,22.099,-5,34,39
108,BAR,P000925,P007519,1.833,-1,3,4
108,BAR,P000925,P009992,1.4,2,5,3
108,BAR,P000925,P011244,17.683,-6,24,30
108,BAR,P000925,P012745,4.316,0,8,8
108,BAR,P002939,P003196,5.516,-1,15,16
108,BAR,P002939,P003204,0.367,2,2,0
108,BAR,P002939,P003478,11.466,0,25,25
108,BAR,P002939,P004866,17.899,-2,31,33
108,BAR,P002939,P006435,23.099,-7,38,45
108,BAR,P002939,P009992,4.083,4,13,9
108,BAR,P002939,P011244,19.333,-7,29,36
108,BAR,P002939,P012745,6.349,1,15,14
108,BAR,P003196,P003478,6.95,9,21,12
108,BAR,P003196,P004866,9.2,-11,15,26
108,BAR,P003196,P006435,3.983,-8,7,15
108,BAR,P003196,P007519,10.634,-1,21,22
108,BAR,P003196,P009992,12.167,6,29,23
108,BAR,P003196,P011244,1.65,-1,5,6
108,BAR,P003196,P012745,14.5,-1,31,32
108,BAR,P003204,P003478,0.367,2,2,0
108,BAR,P003204,P006435,0.367,2,2,0
108,BAR,P003478,P004866,1.833,1,5,4
108,BAR,P003478,P006435,10.433,-2,21,23
108,BAR,P003478,P007519,4.617,8,12,4
108,BAR,P003478,P009992,5.3,10,16,6
108,BAR,P003478,P011244,8.933,-5,14,19
108,BAR,P003478,P012745,5.3,10,16,6
108,BAR,P004866,P006435,17.132,-10,25,35
108,BAR,P004866,P007519,7.85,-10,12,22
108,BAR,P004866,P009992,8.267,-2,18,20
108,BAR,P004866,P011244,10.75,-2,15,17
108,BAR,P004866,P012745,13.516,-11,23,34
108,BAR,P006435,P007519,2.983,-6,3,9
108,BAR,P006435,P011244,18.983,-7,29,36
108,BAR,P006435,P012745,5.249,-9,5,14
108,BAR,P007519,P009992,9.484,4,21,17
108,BAR,P007519,P012745,12.467,-2,24,26
108,BAR,P009992,P012745,13.567,8,34,26
108,VIR,P001133,P001844,27.8,8,57,49
108,VIR,P001133,P003048,16.05,12,38,26
108,VIR,P001133,P004007,12.767,19,32,13
108,VIR,P001133,P008847,15.167,1,26,25
108,VIR,P001133,P009549,18.35,2,33,31
108,VIR,P001133,P010781,13.783,16,36,20
108,VIR,P001133,P012713,4.05,9,11,2
108,VIR,P001133,PBCN,19.433,1,39,38
108,VIR,P001844,P003048,16.45,1,33,32
108,VIR,P001844,P003527,2.434,0,4,4
108,VIR,P001844,P004007,12.584,8,27,19
108,VIR,P001844,P008847,16.367,-4,28,32
108,VIR,P001844,P009549,20.784,2,37,35
108,VIR,P001844,P010781,11.583,2,27,25
108,VIR,P001844,P012714,0.484,-3,0,3
108,VIR,P001844,PBCN,19.85,-2,39,41
108,VIR,P003048,P003527,2.067,2,4,2
108,VIR,P003048,P004007,9.6,15,26,11
108,VIR,P003048,P008847,1.733,-4,2,6
108,VIR,P003048,P009549,11.217,-1,17,18
108,VIR,P003048,P010781,8.633,11,27,16
108,VIR,P003048,P012713,3.4,9,11,2
108,VIR,P003048,PBCN,10.25,-5,18,23
108,VIR,P003527,P004007,2.434,0,4,4
108,VIR,P003527,P009549,2.434,0,4,4
108,VIR,P003527,P012714,0.367,-2,0,2
108,VIR,P004007,P008847,9.3,-6,12,18
108,VIR,P004007,P009549,6.867,3,14,11
108,VIR,P004007,P010781,11.883,11,27,16
108,VIR,P004007,P011192,1.833,-4,2,6
108,VIR,P004007,P012713,4.05,9,11,2
108,VIR,P004007,P012714,2.2,-6,2,8
108,VIR,P004007,PBCN,0.35,3,3,0
108,VIR,P008847,P009549,8.917,4,19,15
108,VIR,P008847,P010781,11.966,-15,15,30
108,VIR,P008847,P011192,3.866,-7,6,13
108,VIR,P008847,P012713,0.65,0,0,0
108,VIR,P008847,P012714,3.983,-8,6,14
108,VIR,P008847,PBCN,11.583,-5,22,27
108,VIR,P009549,P010781,0.283,1,1,0
108,VIR,P009549,P012714,0.367,-2,0,2
108,VIR,P009549,PBCN,13.917,-1,23,24
108,VIR,P010781,P011192,3.866,-7,6,13
108,VIR,P010781,P012713,4.05,9,11,2
108,VIR,P010781,P012714,3.983,-8,6,14
108,VIR,P010781,PBCN,7.966,-4,20,24
108,VIR,P011192,P012714,3.866,-7,6,13
108,VIR,P011192,PBCN,2.033,-3,4,7
108,VIR,P012714,PBCN,2.15,-4,4,8
109,BER,P003958,P006251,12.234,4,37,33
109,BER,P003958,P006819,5.35,0,8,8
109,BER,P003958,P007025,16.351,-9,34,43
109,BER,P003958,P008173,18.651,-2,40,42
109,BER,P003958,P008211,10.267,-2,25,27
109,BER,P003958,P008384,15.917,3,40,37
109,BER,P003958,P010791,3.984,-1,14,15
109,BER,P003958,P011934,12.584,-2,23,25
109,BER,P003958,P012721,20.334,-7,39,46
109,BER,P006251,P006819,5.217,1,16,15
109,BER,P006251,P007025,10.918,1,31,30
109,BER,P006251,P008173,9.884,-1,30,31
109,BER,P006251,P008211,15.201,3,38,35
109,BER,P006251,P008384,17.467,-2,44,46
109,BER,P006251,P010791,8.734,-5,18,23
109,BER,P006251,P011631,0.45,0,2,2
109,BER,P006251,P011934,3.867,3,5,2
109,BER,P006251,P012721,9.3,-4,23,27
109,BER,P006819,P008173,8.867,1,19,18
109,BER,P006819,P008211,1.767,2,7,5
109,BER,P006819,P008384,8.867,1,19,18
109,BER,P006819,P012721,5.4,-1,7,8
109,BER,P007025,P008173,7.734,-5,15,20
109,BER,P007025,P008211,12.651,-6,29,35
109,BER,P007025,P008384,5.067,-1,14,15
109,BER,P007025,P010791,6.918,-2,20,22
109,BER,P007025,P011631,0.45,0,2,2
109,BER,P007025,P011934,9.667,-7,13,20
109,BER,P007025,P012721,11.784,-15,18,33
109,BER,P008173,P008211,1.767,2,7,5
109,BER,P008173,P008384,14.434,4,36,32
109,BER,P008173,P010791,2.267,-1,9,10
109,BER,P008173,P011934,8.084,1,16,15
109,BER,P008173,P012721,16.984,-3,32,35
109,BER,P008211,P008384,12.017,0,30,30
109,BER,P008211,P010791,8.734,-5,16,21
109,BER,P008211,P011631,0.45,0,2,2
109,BER,P008211,P011934,6.55,-5,7,12
109,BER,P008211,P012721,9.0,-9,19,28
109,BER,P008384,P010791,5.35,-3,8,11
109,BER,P008384,P011631,0.45,0,2,2
109,BER,P008384,P011934,4.967,3,10,7
109,BER,P008384,P012721,14.2,3,33,30
109,BER,P010791,P011934,1.95,-2,0,2
109,BER,P010791,P012721,6.067,-5,15,20
109,BER,P011934,P012721,10.867,-7,18,25
109,IST,P007200,P009513,28.017,10,72,62
109,IST,P007200,P010516,8.733,-5,11,16
109,IST,P007200,P011078,27.55,9,69,60
109,IST,P007200,P011981,24.25,3,58,55
109,IST,P007200,P012710,14.45,1,26,25
109,IST,P007200,P012786,15.083,11,45,34
109,IST,P007200,P012788,10.517,-1,23,24
109,IST,P009513,P010516,9.917,-1,22,23
109,IST,P009513,P011078,31.267,13,86,73
109,IST,P009513,P011981,20.767,6,54,48
109,IST,P009513,P012710,16.183,2,31,29
109,IST,P009513,P012786,19.6,14,63,49
109,IST,P009513,P012788,17.717,0,44,44
109,IST,P010516,P011078,9.45,-2,19,21
109,IST,P010516,P011981,4.883,-5,4,9
109,IST,P010516,P012710,3.883,-1,3,4
109,IST,P010516,P012786,10.167,-3,23,26
109,IST,P010516,P012788,9.167,1,22,21
109,IST,P011078,P011981,22.85,5,58,53
109,IST,P011078,P012710,14.2,1,30,29
109,IST,P011078,P012786,21.116,14,61,47
109,IST,P011078,P012788,15.167,0,37,37
109,IST,P011981,P012710,12.967,-1,24,25
109,IST,P011981,P012786,8.666,9,29,20
109,IST,P011981,P012788,2.617,-5,5,10
109,IST,P012710,P012786,2.533,0,6,6
109,IST,P012710,P012788,4.116,2,8,6
109,IST,P012786,P012788,14.167,3,37,34
110,MAD,P001392,P003108,7.434,-8,11,19
110,MAD,P001392,P004887,3.867,-11,0,11
110,MAD,P001392,P005791,14.483,16,37,21
110,MAD,P001392,P005928,14.166,18,37,19
110,MAD,P001392,P006540,13.033,4,26,22
110,MAD,P001392,P009005,14.166,18,37,19
110,MAD,P001392,PBMT,2.067,-4,0,4
110,MAD,P001392,PTGB,4.184,-13,0,13
110,MAD,P003108,P004887,15.001,-2,29,31
110,MAD,P003108,P005791,7.35,0,21,21
110,MAD,P003108,P005928,15.284,9,45,36
110,MAD,P003108,P006540,3.1,-13,0,13
110,MAD,P003108,P009005,12.801,3,33,30
110,MAD,P003108,PBMT,15.501,8,41,33
110,MAD,P003108,PTGB,15.001,-5,28,33
110,MAD,P004887,P005928,9.417,1,22,21
110,MAD,P004887,P006540,2.217,-7,0,7
110,MAD,P004887,P009005,6.934,-5,10,15
110,MAD,P004887,PBMT,12.817,4,29,25
110,MAD,P004887,PTGB,13.951,0,26,26
110,MAD,P005791,P005928,22.483,22,59,37
110,MAD,P005791,P006540,18.016,8,38,30
110,MAD,P005791,P009005,22.483,22,59,37
110,MAD,P005791,P009213,5.8,1,12,11
110,MAD,P005791,PBMT,2.167,4,10,6
110,MAD,P005791,PTGB,0.95,-5,0,5
110,MAD,P005928,P006540,18.116,10,38,28
110,MAD,P005928,P009005,26.534,15,64,49
110,MAD,P005928,P009213,5.8,1,12,11
110,MAD,P005928,PBMT,10.034,10,34,24
110,MAD,P005928,PTGB,7.834,6,21,15
110,MAD,P006540,P009005,18.116,10,38,28
110,MAD,P006540,P009213,5.8,1,12,11
110,MAD,P006540,PTGB,2.534,-9,0,9
110,MAD,P009005,P009213,5.8,1,12,11
110,MAD,P009005,PBMT,7.551,4,22,18
110,MAD,P009005,PTGB,5.351,0,9,9
110,MAD,PBMT,PTGB,11.867,6,28,22
110,PAN,P001926,P002328,7.817,1,12,11
110,PAN,P001926,P003842,7.884,-14,8,22
110,PAN,P001926,P007553,4.717,5,8,3
110,PAN,P001926,P007866,8.084,1,12,11
110,PAN,P001926,P007947,5.067,5,8,3
110,PAN,P001926,P008084,4.517,-10,4,14
110,PAN,P001926,P011204,7.534,-14,8,22
110,PAN,P001926,P012774,4.784,-10,4,14
110,PAN,P002328,P003842,14.967,-6,30,36
110,PAN,P002328,P007553,9.6,1,15,14
110,PAN,P002328,P007866,24.567,-5,45,50
110,PAN,P002328,P007947,21.817,-1,41,42
110,PAN,P002328,P011204,2.75,-4,4,8
110,PAN,P002328,P012774,16.75,-6,33,39
110,PAN,P003842,P007866,18.451,-11,40,51
110,PAN,P003842,P007947,22.517,3,55,52
110,PAN,P003842,P008084,11.6,0,23,23
110,PAN,P003842,P011204,17.834,-9,37,46
110,PAN,P003842,P012774,26.951,-7,59,66
110,PAN,P007553,P007866,9.6,1,15,14
110,PAN,P007553,P007947,9.6,1,15,14
110,PAN,P007553,P012774,4.883,-4,7,11
110,PAN,P007866,P007947,25.384,-8,51,59
110,PAN,P007866,P008084,0.35,-2,0,2
110,PAN,P007866,P011204,6.584,-11,14,25
110,PAN,P007866,P012774,20.584,-13,43,56
110,PAN,P007947,P008084,7.433,8,19,11
110,PAN,P007947,P011204,10.65,3,29,26
110,PAN,P007947,P012774,27.4,-3,62,65
110,PAN,P008084,P011204,11.95,-2,23,25
110,PAN,P008084,P012774,11.95,-2,23,25
110,PAN,P011204,P012774,15.434,-7,33,40
111,MIL,P001518,P002812,3.3,3,8,5
111,MIL,P001518,P002849,0.133,0,0,0
111,MIL,P001518,P006509,2.166,-6,0,6
111,MIL,P001518,P007032,3.449,1,8,7
111,MIL,P001518,P007201,3.866,-1,8,9
111,MIL,P001518,P007831,3.483,1,8,7
111,MIL,P001518,P011205,0.867,-2,0,2
111,MIL,P002812,P002849,15.917,7,30,23
111,MIL,P002812,P005670,9.817,-4,15,19
111,MIL,P002812,P006509,12.05,-8,14,22
111,MIL,P002812,P007032,15.0,-2,25,27
111,MIL,P002812,P007201,8.817,-13,10,23
111,MIL,P002812,P007831,18.734,4,36,32
111,MIL,P002812,P011205,17.268,-11,22,33
111,MIL,P002812,P011926,0.233,0,0,0
111,MIL,P002849,P005670,10.4,5,23,18
111,MIL,P002849,P006509,16.1,-6,28,34
111,MIL,P002849,P007032,19.351,-1,36,37
111,MIL,P002849,P007201,8.8,-4,16,20
111,MIL,P002849,P007831,26.634,8,57,49
111,MIL,P002849,P009960,2.784,3,8,5
111,MIL,P002849,P011205,16.768,6,33,27
111,MIL,P002849,P011926,2.117,-2,5,7
111,MIL,P005670,P006509,10.217,-10,14,24
111,MIL,P005670,P007032,0.233,0,0,0
111,MIL,P005670,P007201,7.884,-13,12,25
111,MIL,P005670,P007831,8.45,2,21,19
111,MIL,P005670,P011205,9.434,-4,15,19
111,MIL,P005670,P011926,0.233,0,0,0
111,MIL,P006509,P007032,9.882,-4,16,20
111,MIL,P006509,P007201,11.949,-12,18,30
111,MIL,P006509,P007831,14.566,-6,26,32
111,MIL,P006509,P009960,0.567,-2,0,2
111,MIL,P006509,P011205,6.734,-10,4,14
111,MIL,P006509,P011926,0.233,0,0,0
111,MIL,P007032,P007201,9.683,-6,14,20
111,MIL,P007032,P007831,23.751,-3,44,47
111,MIL,P007032,P009960,2.784,3,8,5
111,MIL,P007032,P011205,12.785,-6,20,26
111,MIL,P007032,P011926,2.35,-2,5,7
111,MIL,P007201,P007831,15.3,-15,24,39
111,MIL,P007201,P011205,7.701,-20,2,22
111,MIL,P007831,P009960,2.784,3,8,5
111,MIL,P007831,P011205,17.985,-4,31,35
111,MIL,P007831,P011926,2.117,-2,5,7
111,MIL,P009960,P011205,2.217,5,8,3
111,MIL,P011205,P011926,2.117,-2,5,7
111,PAR,P000956,P004058,6.717,12,17,5
111,PAR,P000956,P004172,1.4,0,2,2
111,PAR,P000956,P007400,8.817,5,14,9
111,PAR,P000956,P008987,9.901,11,20,9
111,PAR,P000956,P009862,6.234,4,13,9
111,PAR,P000956,P011051,9.167,5,15,10
111,PAR,P000956,P012096,4.334,2,10,8
111,PAR,P000956,P012742,3.234,1,5,4
111,PAR,P003983,P004172,5.116,-3,10,13
111,PAR,P003983,P008987,4.333,-3,10,13
111,PAR,P003983,P009862,0.783,0,0,0
111,PAR,P003983,P011051,5.116,-3,10,13
111,PAR,P003983,P012096,5.116,-3,10,13
111,PAR,P004058,P007400,6.8,6,13,7
111,PAR,P004058,P008987,10.817,11,23,12
111,PAR,P004058,P009862,7.734,4,16,12
111,PAR,P004058,P011051,9.2,8,17,9
111,PAR,P004058,P012096,2.0,3,6,3
111,PAR,P004172,P007400,1.4,0,2,2
111,PAR,P004172,P008987,4.75,-3,10,13
111,PAR,P004172,P009862,2.166,1,3,2
111,PAR,P004172,P011051,7.899,-2,15,17
111,PAR,P004172,P012096,7.482,-2,15,17
111,PAR,P004172,P012742,1.383,1,3,2
111,PAR,P007400,P008987,26.934,11,55,44
111,PAR,P007400,P009862,23.267,4,48,44
111,PAR,P007400,P011051,16.067,8,30,22
111,PAR,P007400,P012096,14.467,-1,30,31
111,PAR,P007400,P012742,20.184,7,44,37
111,PAR,P008987,P009862,27.284,9,58,49
111,PAR,P008987,P011051,20.25,8,40,32
111,PAR,P008987,P012096,18.25,0,42,42
111,PAR,P008987,P012742,18.617,8,42,34
111,PAR,P009862,P011051,14.583,5,26,21
111,PAR,P009862,P012096,15.916,4,35,31
111,PAR,P009862,P012742,19.833,9,45,36
111,PAR,P011051,P012096,9.432,-3,17,20
111,PAR,P011051,P012742,8.15,6,18,12
111,PAR,P012096,P012742,14.867,0,31,31
112,MUN,P001557,P005460,5.783,1,11,10
112,MUN,P001557,P006245,0.6,-2,0,2
112,MUN,P001557,P006543,4.55,7,13,6
112,MUN,P001557,P006760,6.366,-8,2,10
112,MUN,P001557,P007056,9.883,-17,4,21
112,MUN,P001557,P007639,7.7,-14,4,18
112,MUN,P001557,P007975,5.6,5,13,8
112,MUN,P001557,P010391,5.067,-8,4,12
112,MUN,P001557,P011941,1.55,1,2,1
112,MUN,P001557,P011987,13.033,-13,15,28
112,MUN,P005460,P006245,4.933,5,13,8
112,MUN,P005460,P006543,3.0,6,11,5
112,MUN,P005460,P006760,11.566,8,23,15
112,MUN,P005460,P007056,13.066,8,25,17
112,MUN,P005460,P007975,5.1,4,13,9
112,MUN,P005460,P010391,6.55,4,12,8
112,MUN,P005460,P011987,12.333,5,23,18
112,MUN,P005460,P012123,4.333,7,13,6
112,MUN,P006245,P006543,2.817,-4,3,7
112,MUN,P006245,P006760,4.55,7,13,6
112,MUN,P006245,P007056,4.333,7,13,6
112,MUN,P006245,P007975,3.2,-6,3,9
112,MUN,P006245,P011941,2.817,-4,3,7
112,MUN,P006245,P011987,0.6,-2,0,2
112,MUN,P006245,P012123,7.15,3,16,13
112,MUN,P006543,P006760,4.384,0,9,9
112,MUN,P006543,P007639,7.667,-1,17,18
112,MUN,P006543,P007975,18.417,0,40,40
112,MUN,P006543,P010391,8.65,-2,17,19
112,MUN,P006543,P011941,7.967,-5,12,17
112,MUN,P006543,P011987,5.65,3,16,13
112,MUN,P006543,P012123,11.434,-4,22,26
112,MUN,P006760,P007056,15.749,3,25,22
112,MUN,P006760,P007639,8.35,-5,11,16
112,MUN,P006760,P007975,4.167,0,9,9
112,MUN,P006760,P010391,5.05,4,10,6
112,MUN,P006760,P011941,0.217,0,0,0
112,MUN,P006760,P011987,11.416,-4,12,16
112,MUN,P006760,P012123,8.717,7,22,15
112,MUN,P007056,P007639,7.7,-14,4,18
112,MUN,P007056,P007975,1.95,0,2,2
112,MUN,P007056,P010391,10.067,-5,14,19
112,MUN,P007056,P011987,15.983,-13,16,29
112,MUN,P007056,P012123,4.333,7,13,6
112,MUN,P007639,P007975,8.117,-1,17,18
112,MUN,P007639,P010391,7.017,-10,10,20
112,MUN,P007639,P011987,9.9,-17,9,26
112,MUN,P007639,P012123,5.017,2,12,10
112,MUN,P007975,P010391,10.6,-2,19,21
112,MUN,P007975,P011941,7.75,-5,12,17
112,MUN,P007975,P011987,7.75,1,18,17
112,MUN,P007975,P012123,11.217,-4,22,26
112,MUN,P010391,P011941,5.15,-1,9,10
112,MUN,P010391,P011987,12.267,-8,19,27
112,MUN,P010391,P012123,4.45,0,10,10
112,MUN,P011941,P012123,6.417,-6,10,16
112,OLY,P001255,P003941,12.267,4,26,22
112,OLY,P001255,P006302,2.85,-2,4,6
112,OLY,P001255,P006589,6.067,0,10,10
112,OLY,P001255,P007853,0.467,0,0,0
112,OLY,P001255,P008811,14.333,11,25,14
112,OLY,P001255,P008829,20.533,15,41,26
112,OLY,P001255,P008855,23.283,17,47,30
112,OLY,P001255,P010392,6.6,1,14,13
112,OLY,P001255,P010612,20.0,14,37,23
112,OLY,P003941,P006302,2.85,-2,4,6
112,OLY,P003941,P006589,7.95,5,17,12
112,OLY,P003941,P007853,2.8,5,7,2
112,OLY,P003941,P008829,10.45,1,24,23
112,OLY,P003941,P008855,12.75,3,30,27
112,OLY,P003941,P010392,12.733,3,29,26
112,OLY,P003941,P010612,5.667,3,12,9
112,OLY,P003941,P011983,6.133,2,15,13
112,OLY,P006302,P006589,2.85,-2,4,6
112,OLY,P006302,P010392,2.85,-2,4,6
112,OLY,P006589,P007853,2.8,5,7,2
112,OLY,P006589,P008811,0.45,0,0,0
112,OLY,P006589,P008855,2.75,2,6,4
112,OLY,P006589,P010392,5.65,3,11,8
112,OLY,P006589,P010612,2.75,2,6,4
112,OLY,P006589,P011983,2.333,5,7,2
112,OLY,P007853,P008811,3.283,-4,4,8
112,OLY,P007853,P008829,3.283,-4,4,8
112,OLY,P007853,P010392,6.083,1,11,10
112,OLY,P007853,P011983,5.616,1,11,10
112,OLY,P008811,P008829,21.15,2,36,34
112,OLY,P008811,P008855,17.25,9,30,21
112,OLY,P008811,P010392,7.267,-9,11,20
112,OLY,P008811,P010612,15.4,8,27,19
112,OLY,P008811,P011983,7.267,-9,11,20
112,OLY,P008829,P008855,27.25,10,54,44
112,OLY,P008829,P010392,14.35,-9,29,38
112,OLY,P008829,P010612,18.317,9,33,24
112,OLY,P008829,P011983,11.067,-12,19,31
112,OLY,P008855,P010392,10.0,-2,23,25
112,OLY,P008855,P010612,20.0,14,37,23
112,OLY,P008855,P011983,6.717,-5,13,18
112,OLY,P010392,P010612,1.067,-3,2,5
112,OLY,P010392,P011983,13.4,-7,26,33
112,OLY,P010612,P011983,1.067,-3,2,5
113,BAR,P000925,P002939,13.368,9,30,21
113,BAR,P000925,P003478,2.45,-2,6,8
113,BAR,P000925,P004866,8.151,12,22,10
113,BAR,P000925,P006435,15.668,23,35,12
113,BAR,P000925,P007464,9.95,3,17,14
113,BAR,P000925,P007519,5.683,5,10,5
113,BAR,P000925,P009992,1.883,-8,0,8
113,BAR,P000925,P011244,11.667,5,22,17
113,BAR,P000925,P012745,7.384,9,18,9
113,BAR,P002939,P003196,13.899,2,32,30
113,BAR,P002939,P003478,12.017,6,32,26
113,BAR,P002939,P004866,21.134,11,51,40
113,BAR,P002939,P006435,15.3,9,31,22
113,BAR,P002939,P007464,5.183,1,10,9
113,BAR,P002939,P009992,0.9,-5,0,5
113,BAR,P002939,P011244,12.35,0,23,23
113,BAR,P002939,P012745,14.917,11,39,28
113,BAR,P003196,P003478,14.634,-1,37,38
113,BAR,P003196,P004866,14.683,-4,31,35
113,BAR,P003196,P006435,4.682,-5,7,12
113,BAR,P003196,P007464,6.266,-2,18,20
113,BAR,P003196,P007519,7.05,-8,17,25
113,BAR,P003196,P009992,1.633,0,5,5
113,BAR,P003196,P011244,3.916,-7,6,13
113,BAR,P003196,P012745,17.033,1,43,42
113,BAR,P003478,P004866,11.984,1,30,29
113,BAR,P003478,P006435,0.95,-1,1,2
113,BAR,P003478,P007464,4.15,-3,12,15
113,BAR,P003478,P007519,5.067,-9,11,20
113,BAR,P003478,P011244,2.533,-3,4,7
113,BAR,P003478,P012745,14.551,0,39,39
113,BAR,P004866,P006435,10.85,7,23,16
113,BAR,P004866,P007519,1.7,-3,2,5
113,BAR,P004866,P011244,7.85,2,14,12
113,BAR,P004866,P012745,14.984,6,39,33
113,BAR,P006435,P007464,8.55,12,18,6
113,BAR,P006435,P007519,5.05,9,11,2
113,BAR,P006435,P011244,13.1,5,25,20
113,BAR,P006435,P012745,7.25,13,17,4
113,BAR,P007464,P007519,11.033,0,25,25
113,BAR,P007464,P009992,3.516,-8,5,13
113,BAR,P007464,P011244,6.783,-3,13,16
113,BAR,P007464,P012745,9.433,4,22,18
113,BAR,P007519,P009992,2.616,-3,5,8
113,BAR,P007519,P011244,3.233,-2,5,7
113,BAR,P007519,P012745,9.5,-1,22,23
113,BAR,P009992,P011244,0.9,-5,0,5
113,BAR,P009992,P012745,2.616,-3,5,8
113,ULK,P001932,P004004,3.917,-2,4,6
113,ULK,P001932,P008962,4.967,-4,4,8
113,ULK,P001932,P009849,1.05,-2,0,2
113,ULK,P001932,P010560,4.967,-4,4,8
113,ULK,P001932,P011157,4.967,-4,4,8
113,ULK,P002968,P004004,2.966,-6,0,6
113,ULK,P002968,P006661,9.05,10,30,20
113,ULK,P002968,P006961,2.966,-4,5,9
113,ULK,P002968,P008962,10.683,8,30,22
113,ULK,P002968,P009849,9.05,10,30,20
113,ULK,P002968,P010560,9.05,8,25,17
113,ULK,P002968,P011052,2.966,-6,0,6
113,ULK,P002968,P011980,1.333,-4,0,4
113,ULK,P004004,P006661,0.833,-2,2,4
113,ULK,P004004,P006961,1.383,-4,0,4
113,ULK,P004004,P008962,11.716,-9,16,25
113,ULK,P004004,P009849,4.566,-3,12,15
113,ULK,P004004,P010560,10.833,-7,14,21
113,ULK,P004004,P011052,4.566,-8,0,8
113,ULK,P004004,P011157,10.033,-7,16,23
113,ULK,P004004,P011980,1.383,-4,0,4
113,ULK,P006661,P006961,2.75,1,7,6
113,ULK,P006661,P008962,22.984,-2,55,57
113,ULK,P006661,P009849,21.867,-3,53,56
113,ULK,P006661,P010560,19.184,-3,44,47
113,ULK,P006661,P011052,1.334,3,4,1
113,ULK,P006661,P011157,13.934,-12,25,37
113,ULK,P006961,P008962,6.55,8,19,11
113,ULK,P006961,P009849,5.383,7,17,10
113,ULK,P006961,P011052,6.25,4,14,10
113,ULK,P006961,P011157,4.867,8,14,6
113,ULK,P006961,P011980,1.383,-4,0,4
113,ULK,P008962,P009849,30.4,1,75,74
113,ULK,P008962,P010560,31.067,-12,58,70
113,ULK,P008962,P011052,8.317,6,16,10
113,ULK,P008962,P011157,27.934,-12,51,63
113,ULK,P008962,P011980,0.05,0,0,0
113,ULK,P009849,P010560,23.967,-6,54,60
113,ULK,P009849,P011052,3.967,9,14,5
113,ULK,P009849,P011157,21.35,-9,45,54
113,ULK,P010560,P011052,3.183,-4,0,4
113,ULK,P010560,P011157,22.017,-20,33,53
113,ULK,P011052,P011157,6.634,8,16,8
113,ULK,P011052,P011980,1.383,-4,0,4
114,ASV,P000229,P002100,7.583,-9,5,14
114,ASV,P000229,P003526,0.1,0,0,0
114,ASV,P000229,P004194,2.533,-7,0,7
114,ASV,P000229,P012729,7.683,-9,5,14
114,ASV,P000229,P012730,5.15,-2,5,7
114,ASV,P000229,PKIR,7.683,-9,5,14
114,ASV,P002100,P003526,4.9,-9,2,11
114,ASV,P002100,P004194,13.999,-21,19,40
114,ASV,P002100,P006568,10.333,-2,15,17
114,ASV,P002100,P011225,9.067,-11,15,26
114,ASV,P002100,P012080,14.749,-7,29,36
114,ASV,P002100,P012729,16.35,-3,27,30
114,ASV,P002100,P012730,6.0,-2,7,9
114,ASV,P002100,PKIR,14.083,-8,17,25
114,ASV,P003526,P004194,13.533,-5,21,26
114,ASV,P003526,P006568,16.083,-8,21,29
114,ASV,P003526,P011225,13.117,-1,19,20
114,ASV,P003526,P012080,14.149,-6,21,27
114,ASV,P003526,P012729,2.75,-3,0,3
114,ASV,P003526,PKIR,0.1,0,0,0
114,ASV,P004194,P006568,20.716,-9,28,37
114,ASV,P004194,P011225,23.783,-16,36,52
114,ASV,P004194,P012080,26.182,-17,40,57
114,ASV,P004194,P012729,7.166,-9,12,21
114,ASV,P004194,PKIR,11.016,-20,4,24
114,ASV,P006568,P011225,18.217,-6,24,30
114,ASV,P006568,P012080,23.049,-2,36,38
114,ASV,P006568,P012729,4.267,5,8,3
114,ASV,P006568,PKIR,7.267,6,12,6
114,ASV,P011225,P012080,22.766,-14,36,50
114,ASV,P011225,P012729,5.55,-2,12,14
114,ASV,P011225,PKIR,6.3,-14,2,16
114,ASV,P012080,P012729,8.833,3,22,19
114,ASV,P012080,P012730,0.85,0,2,2
114,ASV,P012080,PKIR,10.95,-5,14,19
114,ASV,P012729,P012730,6.0,-2,7,9
114,ASV,P012729,PKIR,11.133,-4,15,19
114,ASV,P012730,PKIR,6.0,-2,7,9
114,PAM,P000556,P003960,0.867,-2,0,2
114,PAM,P000556,P004863,6.75,-4,9,13
114,PAM,P000556,P010568,0.867,-2,0,2
114,PAM,P000556,P011970,5.2,-6,6,12
114,PAM,P000556,P012738,6.75,-4,9,13
114,PAM,P000556,P012739,7.617,-6,9,15
114,PAM,P000556,P012740,2.417,0,3,3
114,PAM,P003960,P004863,4.5,8,10,2
114,PAM,P003960,P006643,10.833,9,21,12
114,PAM,P003960,P007870,14.183,13,28,15
114,PAM,P003960,P010393,0.1,0,0,0
114,PAM,P003960,P010568,16.132,7,30,23
114,PAM,P003960,P011970,3.484,2,9,7
114,PAM,P003960,P011982,17.398,10,33,23
114,PAM,P003960,P012738,2.766,4,6,2
114,PAM,P003960,P012739,3.583,-2,6,8
114,PAM,P003960,P012740,8.682,11,17,6
114,PAM,P004863,P006643,8.917,20,24,4
114,PAM,P004863,P007870,5.684,20,21,1
114,PAM,P004863,P010393,1.85,8,8,0
114,PAM,P004863,P010568,2.883,11,12,1
114,PAM,P004863,P011970,10.15,6,20,14
114,PAM,P004863,P011982,3.233,6,9,3
114,PAM,P004863,P012738,14.683,7,27,20
114,PAM,P004863,P012739,11.083,1,18,17
114,PAM,P004863,P012740,5.867,5,10,5
114,PAM,P006643,P007870,12.217,16,27,11
114,PAM,P006643,P010393,1.85,8,8,0
114,PAM,P006643,P010568,11.832,3,22,19
114,PAM,P006643,P011970,5.817,10,14,4
114,PAM,P006643,P011982,8.466,2,14,12
114,PAM,P006643,P012738,6.283,0,11,11
114,PAM,P006643,P012739,6.749,1,13,12
114,PAM,P006643,P012740,2.9,-1,6,7
114,PAM,P007870,P010393,1.85,8,8,0
114,PAM,P007870,P010568,14.699,17,33,16
114,PAM,P007870,P011970,1.484,5,5,0
114,PAM,P007870,P011982,12.916,11,27,16
114,PAM,P007870,P012738,1.467,5,6,1
114,PAM,P007870,P012740,5.5,9,13,4
114,PAM,P010393,P010568,4.433,7,10,3
114,PAM,P010393,P011982,2.65,1,4,3
114,PAM,P010393,P012739,2.55,1,4,3
114,PAM,P010393,P012740,2.717,3,6,3
114,PAM,P010568,P011970,2.367,-3,4,7
114,PAM,P010568,P011982,19.748,13,40,27
114,PAM,P010568,P012738,4.149,1,11,10
114,PAM,P010568,P012739,8.549,-8,12,20
114,PAM,P010568,P012740,10.265,2,18,16
114,PAM,P011970,P011982,1.5,-1,4,5
114,PAM,P011970,P012738,9.033,1,15,14
114,PAM,P011970,P012739,11.033,-2,19,21
114,PAM,P011982,P012738,4.699,7,12,5
114,PAM,P011982,P012739,6.099,-1,10,11
114,PAM,P011982,P012740,10.815,8,19,11
114,PAM,P012738,P012739,13.499,-6,20,26
114,PAM,P012738,P012740,7.599,-3,11,14
114,PAM,P012739,P012740,7.766,-6,9,15
115,BAS,P003198,P004603,7.817,8,18,10
115,BAS,P003198,P004761,8.55,2,20,18
115,BAS,P003198,P007230,10.751,9,33,24
115,BAS,P003198,P008072,2.15,1,8,7
115,BAS,P003198,P009048,11.717,3,28,25
115,BAS,P003198,P011085,2.35,-1,3,4
115,BAS,P003198,P011948,2.201,7,13,6
115,BAS,P003198,P012201,5.484,-2,13,15
115,BAS,P003198,P012765,1.384,5,8,3
115,BAS,P004603,P004761,20.234,11,40,29
115,BAS,P004603,P007230,20.251,9,43,34
115,BAS,P004603,P009048,25.534,7,46,39
115,BAS,P004603,P011085,21.334,-3,35,38
115,BAS,P004603,P011948,4.817,0,12,12
115,BAS,P004603,P012201,8.95,-4,11,15
115,BAS,P004603,P012765,2.267,0,7,7
115,BAS,P004761,P007230,20.134,7,48,41
115,BAS,P004761,P008072,1.083,-3,2,5
115,BAS,P004761,P009048,23.534,7,50,43
115,BAS,P004761,P011085,14.234,3,27,24
115,BAS,P004761,P011948,1.3,1,6,5
115,BAS,P004761,P012201,5.817,-3,7,10
115,BAS,P004761,P012765,0.25,-1,0,1
115,BAS,P007230,P008072,4.516,-7,10,17
115,BAS,P007230,P008850,1.833,-6,2,8
115,BAS,P007230,P009048,23.901,6,56,50
115,BAS,P007230,P011085,15.15,-3,28,31
115,BAS,P007230,P011948,7.634,-3,23,26
115,BAS,P007230,P012201,4.634,-3,11,14
115,BAS,P007230,P012765,4.4,-5,10,15
115,BAS,P008072,P008850,1.833,-6,2,8
115,BAS,P008072,P009048,0.833,-2,2,4
115,BAS,P008072,P011085,4.683,1,11,10
115,BAS,P008072,P011948,7.583,-1,19,20
115,BAS,P008072,P012201,4.15,3,11,8
115,BAS,P008072,P012765,7.833,-2,19,21
115,BAS,P008850,P011948,1.833,-6,2,8
115,BAS,P008850,P012765,1.833,-6,2,8
115,BAS,P009048,P011085,19.534,-1,33,34
115,BAS,P009048,P011948,3.917,1,13,12
115,BAS,P009048,P012201,10.634,-5,16,21
115,BAS,P011085,P011948,8.733,-2,21,23
115,BAS,P011085,P012201,12.767,-1,22,23
115,BAS,P011085,P012765,6.883,-1,16,17
115,BAS,P011948,P012201,7.2,4,21,17
115,BAS,P011948,P012765,9.85,-1,26,27
115,BAS,P012201,P012765,5.7,3,16,13
115,RED,P000848,P002553,7.05,-2,6,8
115,RED,P000848,P004720,6.233,-5,10,15
115,RED,P000848,P006436,14.917,-7,22,29
115,RED,P000848,P007960,14.6,-12,27,39
115,RED,P000848,P008966,4.95,-6,9,15
115,RED,P000848,P009035,16.7,-8,24,32
115,RED,P000848,P012044,2.683,-8,0,8
115,RED,P000848,PJDR,18.967,-6,33,39
115,RED,P000848,PLUO,0.5,-2,1,3
115,RED,P002553,P006436,23.2,9,52,43
115,RED,P002553,P008966,8.916,3,22,19
115,RED,P002553,P009035,14.284,6,30,24
115,RED,P002553,P012044,11.483,-2,26,28
115,RED,P002553,PJDR,11.817,11,26,15
115,RED,P002553,PLUO,16.05,11,46,35
115,RED,P004720,P006436,0.933,-2,0,2
115,RED,P004720,P007960,7.116,-5,10,15
115,RED,P004720,P008966,0.45,0,0,0
115,RED,P004720,P009035,6.716,-7,10,17
115,RED,P004720,P012044,0.05,-2,0,2
115,RED,P004720,PJDR,6.683,-5,10,15
115,RED,P004720,PLUO,0.483,-2,0,2
115,RED,P006436,P007960,10.016,-2,22,24
115,RED,P006436,P008966,12.616,3,35,32
115,RED,P006436,P009035,20.65,2,39,37
115,RED,P006436,P012044,12.066,-2,28,30
115,RED,P006436,PJDR,20.867,7,46,39
115,RED,P006436,PLUO,17.799,12,52,40
115,RED,P007960,P008966,3.7,0,13,13
115,RED,P007960,P009035,13.049,-9,20,29
115,RED,P007960,P012044,0.783,-1,2,3
115,RED,P007960,PJDR,15.533,-8,31,39
115,RED,P007960,PLUO,2.199,1,7,6
115,RED,P008966,P012044,6.033,-2,11,13
115,RED,P008966,PJDR,6.683,5,24,19
115,RED,P008966,PLUO,7.116,9,26,17
115,RED,P009035,P012044,6.283,-3,17,20
115,RED,P009035,PJDR,20.667,-2,33,35
115,RED,P009035,PLUO,11.183,1,27,26
115,RED,P012044,PJDR,0.1,0,0,0
115,RED,P012044,PLUO,9.783,0,28,28
115,RED,PJDR,PLUO,8.083,10,25,15
116,TEL,P004233,P005145,1.233,-2,0,2
116,TEL,P004233,P009622,3.616,-4,5,9
116,TEL,P004233,P009783,2.667,0,5,5
116,TEL,P004233,P009863,3.667,-2,7,9
116,TEL,P004233,P011193,1.283,0,2,2
116,TEL,P004233,P011199,4.084,-2,7,9
116,TEL,P004233,P011214,1.1,0,4,4
116,TEL,P004233,P011219,0.783,0,2,2
116,TEL,P004233,P012744,1.367,2,4,2
116,TEL,P005145,P009622,7.533,-8,15,23
116,TEL,P005145,P009783,4.1,-2,10,12
116,TEL,P005145,P009863,5.066,-4,10,14
116,TEL,P005145,P011193,2.7,-4,5,9
116,TEL,P005145,P011199,7.3,-8,15,23
116,TEL,P005145,P011214,0.233,0,0,0
116,TEL,P005145,P012744,1.967,-4,5,9
116,TEL,P009622,P009783,22.783,-12,48,60
116,TEL,P009622,P009863,24.299,-9,55,64
116,TEL,P009622,P011193,17.783,10,45,35
116,TEL,P009622,P011199,21.934,-9,47,56
116,TEL,P009622,P011214,16.066,2,42,40
116,TEL,P009622,P011219,12.449,4,35,31
116,TEL,P009622,P012744,10.601,-2,28,30
116,TEL,P009783,P009863,26.167,-13,50,63
116,TEL,P009783,P011193,9.983,0,15,15
116,TEL,P009783,P011199,18.301,-6,38,44
116,TEL,P009783,P011214,10.733,-12,17,29
116,TEL,P009783,P011219,8.849,-5,16,21
116,TEL,P009783,P012744,3.617,-2,9,11
116,TEL,P009863,P011193,12.216,3,26,23
116,TEL,P009863,P011199,19.434,-7,42,49
116,TEL,P009863,P011214,13.233,-9,30,39
116,TEL,P009863,P011219,10.716,-3,25,28
116,TEL,P009863,P012744,5.334,-4,15,19
116,TEL,P011193,P011199,10.367,4,22,18
116,TEL,P011193,P011214,13.316,6,35,29
116,TEL,P011193,P011219,11.583,1,29,28
116,TEL,P011193,P012744,9.501,0,25,25
116,TEL,P011199,P011214,4.034,0,11,11
116,TEL,P011199,P011219,0.433,2,2,0
116,TEL,P011199,P012744,7.185,-2,20,22
116,TEL,P011214,P011219,16.416,-3,39,42
116,TEL,P011214,P012744,7.801,4,22,18
116,TEL,P011219,P012744,6.167,0,16,16
116,VIR,P001133,P001844,23.532,15,66,51
116,VIR,P001133,P003048,20.766,13,62,49
116,VIR,P001133,P004007,15.266,7,33,26
116,VIR,P001133,P008847,9.816,3,21,18
116,VIR,P001133,P009549,12.65,9,37,28
116,VIR,P001133,P010781,15.599,1,32,31
116,VIR,P001133,P011192,15.016,8,35,27
116,VIR,P001133,P012714,1.35,-2,0,2
116,VIR,P001133,PBCN,21.465,10,58,48
116,VIR,P001844,P003048,22.832,6,62,56
116,VIR,P001844,P004007,11.866,1,25,24
116,VIR,P001844,P008847,7.649,-4,19,23
116,VIR,P001844,P009549,13.233,9,39,30
116,VIR,P001844,P010781,10.499,-8,22,30
116,VIR,P001844,P011192,6.916,1,17,16
116,VIR,P001844,P012714,1.45,0,6,6
116,VIR,P001844,PBCN,19.415,8,56,48
116,VIR,P003048,P004007,9.133,-2,21,23
116,VIR,P003048,P008847,3.066,-3,6,9
116,VIR,P003048,P009549,11.3,7,36,29
116,VIR,P003048,P010781,8.216,-8,15,23
116,VIR,P003048,P011192,9.216,0,23,23
116,VIR,P003048,PBCN,15.999,7,47,40
116,VIR,P004007,P008847,5.966,2,13,11
116,VIR,P004007,P009549,7.333,2,19,17
116,VIR,P004007,P010781,7.783,0,16,16
116,VIR,P004007,P011192,7.083,1,12,11
116,VIR,P004007,P012714,0.05,2,2,0
116,VIR,P004007,PBCN,2.916,3,7,4
116,VIR,P008847,P009549,0.85,0,2,2
116,VIR,P008847,P010781,14.016,0,31,31
116,VIR,P008847,P011192,6.017,5,12,7
116,VIR,P008847,P012714,1.45,0,6,6
116,VIR,P008847,PBCN,9.566,-3,22,25
116,VIR,P009549,P010781,0.267,0,0,0
116,VIR,P009549,P011192,0.267,0,0,0
116,VIR,P009549,PBCN,8.1,9,23,14
116,VIR,P010781,P011192,11.017,-1,20,21
116,VIR,P010781,P012714,2.85,0,8,8
116,VIR,P010781,PBCN,14.349,-4,32,36
116,VIR,P011192,P012714,1.4,0,2,2
116,VIR,P011192,PBCN,9.6,6,27,21
116,VIR,P012714,PBCN,2.85,0,8,8
117,MCO,P002581,P004790,5.5,5,15,10
117,MCO,P002581,P005985,3.05,-7,3,10
117,MCO,P002581,P010588,3.767,-7,5,12
117,MCO,P002581,P011212,9.267,-2,20,22
117,MCO,P002581,P011226,8.967,-2,20,22
117,MCO,P002581,P011231,0.3,0,0,0
117,MCO,P002581,P012709,6.217,5,17,12
117,MCO,P004790,P005985,9.367,3,20,17
117,MCO,P004790,P008099,0.2,2,2,0
117,MCO,P004790,P010588,6.117,-4,11,15
117,MCO,P004790,P011196,0.217,2,2,0
117,MCO,P004790,P011212,14.85,8,35,27
117,MCO,P004790,P011226,14.667,6,33,27
117,MCO,P004790,P012709,5.5,5,15,10
117,MCO,P004790,PLCZ,3.05,5,7,2
117,MCO,P005985,P008099,11.417,6,24,18
117,MCO,P005985,P010588,24.584,-8,46,54
117,MCO,P005985,P011196,5.05,2,13,11
117,MCO,P005985,P011212,22.566,-8,46,54
117,MCO,P005985,P011226,19.0,0,44,44
117,MCO,P005985,P011231,20.55,3,43,40
117,MCO,P005985,PLCZ,15.084,5,25,20
117,MCO,P008099,P010588,7.967,5,15,10
117,MCO,P008099,P011196,3.45,1,9,8
117,MCO,P008099,P011212,1.333,-1,4,5
117,MCO,P008099,P011226,2.117,2,5,3
117,MCO,P008099,P011231,11.217,4,22,18
117,MCO,P008099,PLCZ,7.967,5,15,10
117,MCO,P010588,P011196,0.017,0,0,0
117,MCO,P010588,P011212,17.317,-13,33,46
117,MCO,P010588,P011226,12.967,-8,30,38
117,MCO,P010588,P011231,15.717,3,32,29
117,MCO,P010588,P012709,0.717,0,2,2
117,MCO,P010588,PLCZ,12.034,0,18,18
117,MCO,P011196,P011212,4.033,0,8,8
117,MCO,P011196,P011226,4.834,3,9,6
117,MCO,P011196,P011231,5.95,0,11,11
117,MCO,P011196,P012709,1.117,0,0,0
117,MCO,P011212,P011226,24.2,3,56,53
117,MCO,P011212,P011231,11.583,-4,23,27
117,MCO,P011212,P012709,7.334,5,17,12
117,MCO,P011212,PLCZ,7.117,0,10,10
117,MCO,P011226,P011231,8.2,6,23,17
117,MCO,P011226,P012709,7.334,5,17,12
117,MCO,P011226,PLCZ,3.05,5,7,2
117,MCO,P011231,P012709,1.117,0,0,0
117,MCO,P011231,PLCZ,12.034,0,18,18
117,ZAL,P002329,P003211,17.334,-3,37,40
117,ZAL,P002329,P005504,15.067,6,27,21
117,ZAL,P002329,P006860,6.584,-1,14,15
117,ZAL,P002329,P007109,25.967,-1,51,52
117,ZAL,P002329,P007513,26.951,-2,49,51
117,ZAL,P002329,P010390,15.083,-10,21,31
117,ZAL,P002329,P011218,22.467,-3,46,49
117,ZAL,P002329,P012787,10.883,-10,23,33
117,ZAL,P003211,P005504,13.95,4,27,23
117,ZAL,P003211,P006860,6.617,0,15,15
117,ZAL,P003211,P007109,11.201,2,29,27
117,ZAL,P003211,P007513,9.935,1,21,20
117,ZAL,P003211,P010390,3.283,-5,5,10
117,ZAL,P003211,P011218,7.017,1,23,22
117,ZAL,P003211,P012787,12.067,-8,27,35
117,ZAL,P005504,P006860,7.7,-2,15,17
117,ZAL,P005504,P007109,11.584,12,24,12
117,ZAL,P005504,P007513,12.634,6,22,16
117,ZAL,P005504,P011218,8.983,3,19,16
117,ZAL,P005504,P012787,9.95,3,22,19
117,ZAL,P006860,P007513,3.418,-2,6,8
117,ZAL,P006860,P010390,2.267,0,6,6
117,ZAL,P006860,P011218,5.701,-1,13,14
117,ZAL,P006860,P012787,7.717,-2,15,17
117,ZAL,P007109,P007513,24.367,3,48,45
117,ZAL,P007109,P010390,10.966,-8,13,21
117,ZAL,P007109,P011218,18.433,4,41,37
117,ZAL,P007109,P012787,7.35,-4,18,22
117,ZAL,P007513,P010390,12.917,-5,16,21
117,ZAL,P007513,P011218,22.734,0,44,44
117,ZAL,P007513,P012787,5.384,-5,10,15
117,ZAL,P010390,P011218,13.65,-7,18,25
117,ZAL,P010390,P012787,2.166,-5,5,10
117,ZAL,P011218,P012787,7.683,-1,20,21
118,ASV,P000229,P002100,10.75,2,25,23
118,ASV,P000229,P003526,8.983,0,18,18
118,ASV,P000229,P004194,5.55,1,10,9
118,ASV,P000229,P006568,7.1,1,15,14
118,ASV,P000229,P011225,0.1,0,0,0
118,ASV,P000229,P012080,8.916,6,19,13
118,ASV,P000229,P012729,9.083,1,21,20
118,ASV,P000229,P012730,7.35,1,16,15
118,ASV,P000229,PKIR,1.1,-4,0,4
118,ASV,P002100,P003526,10.067,-1,23,24
118,ASV,P002100,P004194,9.65,-3,22,25
118,ASV,P002100,P006568,7.683,-3,17,20
118,ASV,P002100,P011225,4.983,-8,7,15
118,ASV,P002100,P012080,14.367,-2,32,34
118,ASV,P002100,P012729,16.35,-9,30,39
118,ASV,P002100,P012730,12.251,1,27,26
118,ASV,P002100,PKIR,5.767,-5,9,14
118,ASV,P003526,P004194,19.966,3,42,39
118,ASV,P003526,P006568,15.883,-3,31,34
118,ASV,P003526,P011225,11.883,-1,25,26
118,ASV,P003526,P012080,20.883,0,42,42
118,ASV,P003526,P012729,5.867,-5,12,17
118,ASV,P003526,P012730,9.767,1,23,22
118,ASV,P003526,PKIR,0.433,-2,0,2
118,ASV,P004194,P006568,18.217,-1,37,38
118,ASV,P004194,P011225,16.733,-5,34,39
118,ASV,P004194,P012080,24.9,-3,51,54
118,ASV,P004194,P012729,3.033,-5,4,9
118,ASV,P004194,P012730,5.0,4,14,10
118,ASV,P004194,PKIR,3.083,1,6,5
118,ASV,P006568,P011225,11.267,-1,25,26
118,ASV,P006568,P012080,20.65,-1,42,43
118,ASV,P006568,P012729,3.633,-2,8,10
118,ASV,P006568,PKIR,2.967,-2,5,7
118,ASV,P011225,P012080,15.1,-6,30,36
118,ASV,P011225,P012729,4.333,-9,4,13
118,ASV,P011225,P012730,3.733,-3,5,8
118,ASV,P011225,PKIR,4.0,-3,6,9
118,ASV,P012080,P012729,7.75,-4,14,18
118,ASV,P012080,P012730,9.017,6,23,17
118,ASV,P012080,PKIR,3.817,0,7,7
118,ASV,P012729,P012730,9.734,-4,18,22
118,ASV,P012729,PKIR,5.817,-7,9,16
118,ASV,P012730,PKIR,2.484,-6,2,8
118,PAN,P001926,P002328,24.149,11,61,50
118,PAN,P001926,P003842,21.367,7,52,45
118,PAN,P001926,P007553,6.117,-2,12,14
118,PAN,P001926,P007866,24.733,1,56,55
118,PAN,P001926,P007947,4.934,-5,6,11
118,PAN,P001926,P011204,19.917,5,51,46
118,PAN,P001926,P011221,6.85,4,17,13
118,PAN,P001926,P012712,10.618,4,25,21
118,PAN,P001926,P012774,18.651,11,44,33
118,PAN,P002328,P003842,14.533,10,37,27
118,PAN,P002328,P007553,5.483,-2,12,14
118,PAN,P002328,P007866,22.333,7,53,46
118,PAN,P002328,P007947,0.283,0,0,0
118,PAN,P002328,P011204,16.35,3,39,36
118,PAN,P002328,P011221,7.367,2,17,15
118,PAN,P002328,P012712,4.767,3,13,10
118,PAN,P002328,P012774,14.267,6,32,26
118,PAN,P003842,P007866,15.45,-2,34,36
118,PAN,P003842,P007947,5.667,-4,9,13
118,PAN,P003842,P011204,11.334,5,30,25
118,PAN,P003842,P011209,0.1,0,0,0
118,PAN,P003842,P012712,10.901,7,26,19
118,PAN,P003842,P012774,21.984,13,52,39
118,PAN,P007553,P007866,5.984,0,12,12
118,PAN,P007553,P007947,1.501,-1,0,1
118,PAN,P007553,P011204,6.784,-3,12,15
118,PAN,P007553,P012712,1.217,-3,0,3
118,PAN,P007553,P012774,1.718,-1,0,1
118,PAN,P007866,P007947,1.984,-4,0,4
118,PAN,P007866,P011204,19.784,2,45,43
118,PAN,P007866,P011221,6.7,2,15,13
118,PAN,P007866,P012712,1.4,-4,0,4
118,PAN,P007866,P012774,14.568,-2,29,31
118,PAN,P007947,P011204,3.601,-2,6,8
118,PAN,P007947,P012712,6.401,-5,9,14
118,PAN,P007947,P012774,4.701,1,6,5
118,PAN,P011204,P011209,0.1,0,0,0
118,PAN,P011204,P011221,7.367,2,17,15
118,PAN,P011204,P012712,5.901,2,14,12
118,PAN,P011204,P012774,11.202,2,22,20
118,PAN,P011209,P012712,0.1,0,0,0
118,PAN,P011209,P012774,0.1,0,0,0
118,PAN,P011221,P012712,0.667,0,2,2
118,PAN,P011221,P012774,0.517,-2,0,2
118,PAN,P012712,P012774,9.568,12,23,11
119,MAD,P001392,P003108,10.616,-4,22,26
119,MAD,P001392,P004887,0.5,-3,0,3
119,MAD,P001392,P005791,16.883,-1,34,35
119,MAD,P001392,P005928,14.283,-3,27,30
119,MAD,P001392,P006540,13.85,0,27,27
119,MAD,P001392,P009005,0.5,-3,0,3
119,MAD,P001392,P009213,10.3,-4,19,23
119,MAD,P001392,PCVM,2.6,2,7,5
119,MAD,P003108,P004887,8.567,3,18,15
119,MAD,P003108,P005791,11.699,3,28,25
119,MAD,P003108,P005928,11.349,5,27,22
119,MAD,P003108,P006540,8.283,3,19,16
119,MAD,P003108,P009005,7.933,4,18,14
119,MAD,P003108,P009213,5.65,3,15,12
119,MAD,P003108,PBMT,2.933,3,6,3
119,MAD,P003108,PCVM,7.5,0,15,15
119,MAD,P003108,PTGB,6.534,4,16,12
119,MAD,P004887,P005928,6.417,7,15,8
119,MAD,P004887,P009005,17.517,12,42,30
119,MAD,P004887,P009213,1.417,1,4,3
119,MAD,P004887,PBMT,12.517,11,30,19
119,MAD,P004887,PCVM,10.7,4,25,21
119,MAD,P004887,PTGB,16.501,13,42,29
119,MAD,P005791,P005928,17.533,1,33,32
119,MAD,P005791,P006540,15.05,3,31,28
119,MAD,P005791,P009005,1.1,3,6,3
119,MAD,P005791,P009213,13.284,0,23,23
119,MAD,P005791,PBMT,3.384,1,6,5
119,MAD,P005791,PCVM,3.934,2,11,9
119,MAD,P005791,PTGB,3.001,0,4,4
119,MAD,P005928,P006540,15.05,3,31,28
119,MAD,P005928,P009005,5.783,8,15,7
119,MAD,P005928,P009213,10.067,0,16,16
119,MAD,P005928,PBMT,8.284,6,15,9
119,MAD,P005928,PTGB,7.034,5,13,8
119,MAD,P006540,P009213,7.967,3,16,13
119,MAD,P009005,P009213,1.417,1,4,3
119,MAD,P009005,PBMT,12.6,14,34,20
119,MAD,P009005,PCVM,11.417,6,29,23
119,MAD,P009005,PTGB,16.201,15,44,29
119,MAD,P009213,PBMT,2.284,-2,0,2
119,MAD,P009213,PCVM,3.217,0,7,7
119,MAD,P009213,PTGB,3.201,2,4,2
119,MAD,PBMT,PCVM,7.617,6,21,15
119,MAD,PBMT,PTGB,13.985,9,32,23
119,MAD,PCVM,PTGB,11.551,4,29,25
119,MUN,P001557,P003583,10.133,-9,15,24
119,MUN,P001557,P006543,11.567,-3,20,23
119,MUN,P001557,P006760,2.15,-4,2,6
119,MUN,P001557,P007056,1.417,-6,0,6
119,MUN,P001557,P007639,5.001,-4,7,11
119,MUN,P001557,P007975,12.484,-7,20,27
119,MUN,P001557,P008985,2.65,-6,2,8
119,MUN,P001557,P010391,11.134,-13,14,27
119,MUN,P001557,P011987,4.0,0,8,8
119,MUN,P003583,P006543,11.0,-7,18,25
119,MUN,P003583,P006760,21.084,-6,39,45
119,MUN,P003583,P007056,13.2,-1,26,27
119,MUN,P003583,P007975,11.517,1,24,23
119,MUN,P003583,P008985,17.55,-12,28,40
119,MUN,P003583,P010391,10.267,-9,16,25
119,MUN,P003583,P011987,21.517,-1,42,43
119,MUN,P006543,P006760,3.3,-3,6,9
119,MUN,P006543,P007639,3.584,2,7,5
119,MUN,P006543,P007975,13.434,-5,23,28
119,MUN,P006543,P008985,1.433,-1,3,4
119,MUN,P006543,P010391,7.85,-4,13,17
119,MUN,P006543,P011987,7.3,-3,14,17
119,MUN,P006760,P007056,18.85,0,39,39
119,MUN,P006760,P007975,4.484,3,13,10
119,MUN,P006760,P008985,22.533,-9,40,49
119,MUN,P006760,P010391,10.8,-3,22,25
119,MUN,P006760,P011987,24.867,-2,51,53
119,MUN,P007056,P007639,1.417,-6,0,6
119,MUN,P007056,P007975,3.534,1,10,9
119,MUN,P007056,P008985,16.733,-7,29,36
119,MUN,P007056,P010391,7.067,-5,13,18
119,MUN,P007056,P011987,18.85,0,39,39
119,MUN,P007639,P007975,5.001,-4,7,11
119,MUN,P007639,P010391,3.584,-3,4,7
119,MUN,P007639,P011987,1.417,-1,3,4
119,MUN,P007975,P010391,8.934,-8,14,22
119,MUN,P007975,P011987,8.484,3,21,18
119,MUN,P008985,P010391,10.85,-4,20,24
119,MUN,P008985,P011987,20.383,-5,38,43
119,MUN,P010391,P011987,8.65,1,20,19
120,BAS,P003198,P004603,4.767,-7,6,13
120,BAS,P003198,P004761,4.767,-7,6,13
120,BAS,P003198,P007230,4.767,-7,6,13
120,BAS,P003198,P009048,4.767,-7,6,13
120,BAS,P004603,P004761,16.95,-4,38,42
120,BAS,P004603,P007230,14.7,-11,25,36
120,BAS,P004603,P008850,0.5,1,1,0
120,BAS,P004603,P009048,20.683,1,44,43
120,BAS,P004603,P011085,14.466,0,32,32
120,BAS,P004603,P011948,7.799,-7,10,17
120,BAS,P004603,P012201,9.716,1,20,19
120,BAS,P004603,P012765,2.283,-10,0,10
120,BAS,P004761,P007230,12.517,-5,29,34
120,BAS,P004761,P008072,6.166,10,18,8
120,BAS,P004761,P009048,19.783,3,51,48
120,BAS,P004761,P011085,13.466,7,42,35
120,BAS,P004761,P011948,7.066,5,16,11
120,BAS,P004761,P012201,14.965,9,43,34
120,BAS,P004761,P012765,5.516,2,13,11
120,BAS,P007230,P008850,0.5,1,1,0
120,BAS,P007230,P009048,15.3,-5,33,38
120,BAS,P007230,P011085,10.666,-4,26,30
120,BAS,P007230,P011948,3.866,-8,3,11
120,BAS,P007230,P012201,3.633,-2,9,11
120,BAS,P007230,P012765,1.583,-7,0,7
120,BAS,P008072,P008850,5.75,-5,7,12
120,BAS,P008072,P009048,10.033,-5,16,21
120,BAS,P008072,P011085,6.233,-5,11,16
120,BAS,P008072,P011948,11.549,0,22,22
120,BAS,P008072,P012201,14.849,0,29,29
120,BAS,P008072,P012765,4.816,5,13,8
120,BAS,P008850,P009048,6.25,-4,8,12
120,BAS,P008850,P011085,1.917,-4,0,4
120,BAS,P008850,P011948,3.833,-1,7,8
120,BAS,P008850,P012201,6.25,-4,8,12
120,BAS,P009048,P011085,19.216,0,44,44
120,BAS,P009048,P011948,14.332,-1,26,27
120,BAS,P009048,P012201,21.232,-2,44,46
120,BAS,P011085,P011948,7.499,-9,9,18
120,BAS,P011085,P012201,14.399,-3,33,36
120,BAS,P011085,P012765,3.666,-6,7,13
120,BAS,P011948,P012201,16.432,-1,29,30
120,BAS,P011948,P012765,5.016,-6,6,12
120,BAS,P012201,P012765,5.516,2,13,11
120,VIR,P001133,P001844,20.351,15,53,38
120,VIR,P001133,P003048,11.833,3,24,21
120,VIR,P001133,P003527,6.284,3,16,13
120,VIR,P001133,P004007,3.9,-8,2,10
120,VIR,P001133,P006739,11.334,1,29,28
120,VIR,P001133,P009549,20.517,16,51,35
120,VIR,P001133,P010781,6.3,-8,9,17
120,VIR,P001133,P012714,15.234,8,38,30
120,VIR,P001133,PBCN,21.251,18,62,44
120,VIR,P001844,P002084,4.383,-7,3,10
120,VIR,P001844,P003048,16.733,5,33,28
120,VIR,P001844,P003527,9.751,7,25,18
120,VIR,P001844,P004007,3.35,-5,3,8
120,VIR,P001844,P006739,4.334,-1,11,12
120,VIR,P001844,P009549,15.35,17,40,23
120,VIR,P001844,P010781,8.517,-4,14,18
120,VIR,P001844,P012714,9.284,6,23,17
120,VIR,P001844,PBCN,20.751,15,55,40
120,VIR,P002084,P003048,5.783,-6,8,14
120,VIR,P002084,P004007,3.3,-4,6,10
120,VIR,P002084,P006739,4.8,-4,8,12
120,VIR,P002084,P009549,2.9,1,8,7
120,VIR,P002084,P010781,2.483,-2,3,5
120,VIR,P002084,P012714,1.5,0,3,3
120,VIR,P002084,PBCN,3.983,-2,5,7
120,VIR,P003048,P003527,7.567,6,16,10
120,VIR,P003048,P004007,7.2,-12,8,20
120,VIR,P003048,P006739,5.45,-6,8,14
120,VIR,P003048,P009549,9.316,9,24,15
120,VIR,P003048,P010781,10.667,-6,17,23
120,VIR,P003048,PBCN,9.783,11,26,15
120,VIR,P003527,P006739,0.917,-2,3,5
120,VIR,P003527,P009549,4.317,10,13,3
120,VIR,P003527,P010781,4.517,-1,9,10
120,VIR,P003527,PBCN,5.651,5,18,13
120,VIR,P004007,P006739,3.85,-7,5,12
120,VIR,P004007,P009549,2.933,-4,5,9
120,VIR,P004007,P010781,4.267,-8,3,11
120,VIR,P006739,P009549,8.067,0,19,19
120,VIR,P006739,P010781,3.733,-2,7,9
120,VIR,P006739,P012714,9.767,5,26,21
120,VIR,P006739,PBCN,12.284,4,32,28
120,VIR,P009549,P012714,12.834,5,29,24
120,VIR,P009549,PBCN,17.434,14,47,33
120,VIR,P010781,P012714,1.583,0,4,4
120,VIR,P010781,PBCN,6.933,7,18,11
120,VIR,P012714,PBCN,16.734,8,41,33
121,PAR,P000956,P004172,0.05,0,0,0
121,PAR,P000956,P007400,0.05,0,0,0
121,PAR,P000956,P009862,0.05,0,0,0
121,PAR,P000956,P012742,0.05,0,0,0
121,PAR,P004172,P007400,11.583,0,23,23
121,PAR,P004172,P008987,10.566,1,21,20
121,PAR,P004172,P009862,6.7,3,14,11
121,PAR,P004172,P011051,9.717,2,18,16
121,PAR,P004172,P012096,2.45,-1,7,8
121,PAR,P004172,P012742,5.266,-5,9,14
121,PAR,P007400,P008987,20.482,-3,41,44
121,PAR,P007400,P009212,6.75,8,25,17
121,PAR,P007400,P009862,24.599,8,62,54
121,PAR,P007400,P011050,6.366,8,22,14
121,PAR,P007400,P011051,11.833,6,24,18
121,PAR,P007400,P012096,13.1,-7,30,37
121,PAR,P007400,P012742,23.165,0,57,57
121,PAR,P008987,P009862,27.083,2,56,54
121,PAR,P008987,P011050,1.033,-2,0,2
121,PAR,P008987,P011051,20.15,9,41,32
121,PAR,P008987,P012096,20.0,-2,44,46
121,PAR,P008987,P012742,24.682,-5,49,54
121,PAR,P009212,P009862,6.75,8,25,17
121,PAR,P009212,P011050,5.333,10,22,12
121,PAR,P009212,P012096,1.417,-2,3,5
121,PAR,P009212,P012742,6.75,8,25,17
121,PAR,P009862,P011050,6.366,8,22,14
121,PAR,P009862,P011051,18.95,12,42,30
121,PAR,P009862,P012096,21.167,-3,45,48
121,PAR,P009862,P012742,28.799,6,70,64
121,PAR,P011050,P012742,6.366,8,22,14
121,PAR,P011051,P012096,12.717,3,27,24
121,PAR,P011051,P012742,16.033,4,32,28
121,PAR,P012096,P012742,23.617,-4,52,56
121,ZAL,P002329,P003211,21.299,3,45,42
121,ZAL,P002329,P005504,5.784,-14,6,20
121,ZAL,P002329,P006860,9.466,8,20,12
121,ZAL,P002329,P007109,22.734,-6,42,48
121,ZAL,P002329,P007513,8.184,-17,7,24
121,ZAL,P002329,P009917,6.082,-4,11,15
121,ZAL,P002329,P010390,8.283,0,19,19
121,ZAL,P002329,P011218,23.3,-2,46,48
121,ZAL,P002329,P012787,1.8,0,4,4
121,ZAL,P003211,P005504,3.267,-9,5,14
121,ZAL,P003211,P006860,16.033,12,39,27
121,ZAL,P003211,P007109,23.983,10,58,48
121,ZAL,P003211,P007513,7.433,-5,15,20
121,ZAL,P003211,P009917,7.749,-6,14,20
121,ZAL,P003211,P010390,8.916,7,27,20
121,ZAL,P003211,P011218,25.016,19,65,46
121,ZAL,P003211,P012787,5.1,1,16,15
121,ZAL,P005504,P007109,6.684,-15,8,23
121,ZAL,P005504,P007513,4.317,-7,5,12
121,ZAL,P005504,P011218,6.684,-15,8,23
121,ZAL,P006860,P007109,12.833,12,30,18
121,ZAL,P006860,P007513,3.783,2,11,9
121,ZAL,P006860,P009917,2.3,-4,3,7
121,ZAL,P006860,P010390,2.567,2,9,7
121,ZAL,P006860,P011218,12.983,17,33,16
121,ZAL,P006860,P012787,4.167,-1,11,12
121,ZAL,P007109,P007513,15.8,-13,29,42
121,ZAL,P007109,P009917,7.283,-5,14,19
121,ZAL,P007109,P010390,10.716,-3,25,28
121,ZAL,P007109,P011218,32.333,-1,70,71
121,ZAL,P007109,P012787,4.766,-3,12,15
121,ZAL,P007513,P009917,4.916,-13,4,17
121,ZAL,P007513,P010390,8.816,-18,11,29
121,ZAL,P007513,P011218,14.75,-10,27,37
121,ZAL,P007513,P012787,2.933,-3,7,10
121,ZAL,P009917,P010390,5.799,-9,8,17
121,ZAL,P009917,P011218,8.799,-3,18,21
121,ZAL,P010390,P011218,12.966,3,34,31
121,ZAL,P010390,P012787,5.133,6,19,13
121,ZAL,P011218,P012787,4.233,4,15,11
122,IST,P004093,P007200,1.55,-1,5,6
122,IST,P004093,P010516,1.55,-1,5,6
122,IST,P004093,P011078,1.15,1,5,4
122,IST,P004093,P012710,0.4,-2,0,2
122,IST,P004093,P012788,1.55,-1,5,6
122,IST,P007200,P009513,7.767,-4,18,22
122,IST,P007200,P010516,11.283,-10,18,28
122,IST,P007200,P011078,31.633,5,71,66
122,IST,P007200,P011981,28.716,-4,57,61
122,IST,P007200,P012710,21.649,-2,40,42
122,IST,P007200,P012786,24.082,7,53,46
122,IST,P007200,P012788,8.116,9,22,13
122,IST,P009513,P010516,5.25,-9,11,20
122,IST,P009513,P011078,9.651,-8,26,34
122,IST,P009513,P011981,7.75,-4,18,22
122,IST,P009513,P012415,1.283,1,3,2
122,IST,P009513,P012710,4.2,-6,11,17
122,IST,P009513,P012786,9.033,-3,21,24
122,IST,P009513,P012788,2.934,-7,8,15
122,IST,P010516,P011078,14.234,-15,30,45
122,IST,P010516,P011981,9.083,-9,13,22
122,IST,P010516,P012415,1.283,1,3,2
122,IST,P010516,P012710,15.383,-17,28,45
122,IST,P010516,P012786,5.049,-5,7,12
122,IST,P010516,P012788,7.217,-11,17,28
122,IST,P011078,P011981,27.683,-1,57,58
122,IST,P011078,P012710,25.633,-10,52,62
122,IST,P011078,P012786,24.516,7,57,50
122,IST,P011078,P012788,12.1,1,34,33
122,IST,P011981,P012710,17.833,-5,31,36
122,IST,P011981,P012786,20.666,2,44,42
122,IST,P011981,P012788,3.133,5,8,3
122,IST,P012415,P012710,1.283,1,3,2
122,IST,P012415,P012786,1.283,1,3,2
122,IST,P012710,P012786,16.582,4,34,30
122,IST,P012710,P012788,8.833,-7,21,28
122,IST,P012786,P012788,8.649,7,21,14
122,TEL,P005145,P009622,11.767,-1,21,22
122,TEL,P005145,P009783,11.767,-1,21,22
122,TEL,P005145,P009863,11.767,-1,21,22
122,TEL,P005145,P011199,11.767,-1,21,22
122,TEL,P009622,P009783,27.283,2,64,62
122,TEL,P009622,P009863,15.767,-4,31,35
122,TEL,P009622,P011193,14.033,9,44,35
122,TEL,P009622,P011199,20.333,8,48,40
122,TEL,P009622,P011214,7.983,-2,21,23
122,TEL,P009622,P011219,8.2,3,16,13
122,TEL,P009622,P011971,10.784,12,39,27
122,TEL,P009622,P012744,3.25,1,8,7
122,TEL,P009783,P009863,15.817,-4,31,35
122,TEL,P009783,P011193,11.9,4,35,31
122,TEL,P009783,P011199,20.734,8,48,40
122,TEL,P009783,P011214,6.15,-5,14,19
122,TEL,P009783,P011219,5.683,-2,7,9
122,TEL,P009783,P011971,8.668,7,30,23
122,TEL,P009783,P012744,2.934,-1,6,7
122,TEL,P009863,P011193,5.234,-8,9,17
122,TEL,P009863,P011199,14.617,-2,27,29
122,TEL,P009863,P011214,3.917,-4,6,10
122,TEL,P009863,P011219,4.084,-6,5,11
122,TEL,P009863,P011971,4.084,-6,5,11
122,TEL,P009863,P012744,4.117,-5,9,14
122,TEL,P011193,P011199,8.05,11,28,17
122,TEL,P011193,P011214,15.534,4,38,34
122,TEL,P011193,P011219,14.801,4,29,25
122,TEL,P011193,P011971,19.719,14,59,45
122,TEL,P011193,P012744,7.401,6,22,16
122,TEL,P011199,P011214,2.367,1,7,6
122,TEL,P011199,P011219,2.133,2,3,1
122,TEL,P011199,P011971,5.851,9,25,16
122,TEL,P011199,P012744,4.884,0,13,13
122,TEL,P011214,P011219,10.934,5,21,16
122,TEL,P011214,P011971,14.435,9,36,27
122,TEL,P011214,P012744,5.684,8,17,9
122,TEL,P011219,P011971,12.785,5,28,23
122,TEL,P011219,P012744,5.384,5,15,10
122,TEL,P011971,P012744,7.418,6,22,16
123,MCO,P004790,P005985,3.933,-5,2,7
123,MCO,P004790,P011196,0.8,0,0,0
123,MCO,P004790,P011212,3.35,-5,2,7
123,MCO,P004790,P011226,3.933,-5,2,7
123,MCO,P004790,P012515,0.583,0,0,0
123,MCO,P004790,PLCZ,3.133,-5,2,7
123,MCO,P005985,P010588,19.484,-9,38,47
123,MCO,P005985,P011196,9.883,-7,14,21
123,MCO,P005985,P011212,21.716,-10,32,42
123,MCO,P005985,P011226,28.066,-7,49,56
123,MCO,P005985,P011231,17.3,-4,26,30
123,MCO,P005985,P012515,7.583,1,22,21
123,MCO,P005985,P012709,7.434,-6,9,15
123,MCO,P005985,PLCZ,22.733,-5,40,45
123,MCO,P010588,P011196,2.15,-3,3,6
123,MCO,P010588,P011212,9.433,-7,17,24
123,MCO,P010588,P011226,17.4,-6,39,45
123,MCO,P010588,P011231,8.367,-6,13,19
123,MCO,P010588,P012515,7.0,1,22,21
123,MCO,P010588,P012709,5.234,-4,4,8
123,MCO,P010588,PLCZ,17.6,-6,36,42
123,MCO,P011196,P011212,13.166,-5,25,30
123,MCO,P011196,P011226,10.966,-3,20,23
123,MCO,P011196,P011231,10.216,-2,22,24
123,MCO,P011196,P012709,5.483,0,16,16
123,MCO,P011212,P011226,24.982,-7,43,50
123,MCO,P011212,P011231,18.232,2,38,36
123,MCO,P011212,P012709,5.483,0,16,16
123,MCO,P011212,PLCZ,12.366,-4,19,23
123,MCO,P011226,P011231,16.299,3,33,30
123,MCO,P011226,P012515,7.583,1,22,21
123,MCO,P011226,P012709,4.25,2,11,9
123,MCO,P011226,PLCZ,20.649,-2,41,43
123,MCO,P011231,P012515,0.267,-1,0,1
123,MCO,P011231,P012709,9.75,-4,20,24
123,MCO,P011231,PLCZ,10.633,0,16,16
123,MCO,P012515,PLCZ,7.316,2,22,20
123,MCO,P012709,PLCZ,5.234,-4,4,8
123,ULK,P001932,P002968,21.316,13,49,36
123,ULK,P001932,P004004,13.699,1,29,28
123,ULK,P001932,P006661,22.899,4,48,44
123,ULK,P001932,P008962,23.982,4,50,46
123,ULK,P001932,P009849,4.033,5,10,5
123,ULK,P001932,P010560,13.916,8,32,24
123,ULK,P001932,P011157,3.5,2,5,3
123,ULK,P001932,P011980,4.383,-1,9,10
123,ULK,P002968,P004004,11.4,4,21,17
123,ULK,P002968,P006661,19.483,10,44,34
123,ULK,P002968,P008962,22.583,9,47,38
123,ULK,P002968,P009849,3.85,2,6,4
123,ULK,P002968,P010560,11.933,8,29,21
123,ULK,P002968,P011052,2.017,-1,1,2
123,ULK,P002968,P011980,0.75,3,3,0
123,ULK,P004004,P006661,11.699,-4,24,28
123,ULK,P004004,P008962,21.333,-1,41,42
123,ULK,P004004,P009849,14.0,10,33,23
123,ULK,P004004,P010560,1.75,-2,3,5
123,ULK,P004004,P011052,13.067,3,28,25
123,ULK,P004004,P011157,13.25,6,32,26
123,ULK,P004004,P011980,6.866,-1,17,18
123,ULK,P006661,P008962,24.932,4,53,49
123,ULK,P006661,P010560,13.916,8,32,24
123,ULK,P006661,P011052,2.033,0,5,5
123,ULK,P006661,P011157,3.333,0,5,5
123,ULK,P006661,P011980,1.433,-6,1,7
123,ULK,P008962,P009849,8.567,5,17,12
123,ULK,P008962,P010560,14.983,6,32,26
123,ULK,P008962,P011052,10.584,3,20,17
123,ULK,P008962,P011157,9.867,4,19,15
123,ULK,P008962,P011980,1.433,-6,1,7
123,ULK,P009849,P011052,9.967,5,23,18
123,ULK,P009849,P011157,10.15,8,27,19
123,ULK,P009849,P011980,5.433,5,16,11
123,ULK,P010560,P011052,1.067,-2,0,2
123,ULK,P010560,P011157,2.367,-2,0,2
123,ULK,P011052,P011157,11.05,4,27,23
123,ULK,P011052,P011980,2.483,0,8,8
123,ULK,P011157,P011980,4.683,2,13,11
124,BER,P003958,P006251,3.916,-4,6,10
124,BER,P003958,P006919,6.667,-8,6,14
124,BER,P003958,P007025,1.3,-3,2,5
124,BER,P003958,P008173,12.833,-9,22,31
124,BER,P003958,P008211,12.899,-5,19,24
124,BER,P003958,P008384,13.632,-7,26,33
124,BER,P003958,P008967,12.983,-5,17,22
124,BER,P003958,P011934,21.816,-10,35,45
124,BER,P003958,P012720,16.882,-5,31,36
124,BER,P006251,P006819,4.566,3,9,6
124,BER,P006251,P006919,11.499,0,27,27
124,BER,P006251,P007025,4.617,-5,5,10
124,BER,P006251,P008173,8.616,4,15,11
124,BER,P006251,P008211,9.566,-8,21,29
124,BER,P006251,P008384,6.233,-1,9,10
124,BER,P006251,P008967,7.816,-1,20,21
124,BER,P006251,P011934,0.683,1,1,0
124,BER,P006251,P012720,3.366,-7,5,12
124,BER,P006251,P012721,11.85,2,26,24
124,BER,P006819,P006919,4.566,3,9,6
124,BER,P006819,P008173,3.433,6,9,3
124,BER,P006819,P008211,1.133,-3,0,3
124,BER,P006819,P012720,1.733,-3,3,6
124,BER,P006819,P012721,2.833,6,6,0
124,BER,P006919,P007025,0.55,-2,0,2
124,BER,P006919,P008173,6.183,1,10,9
124,BER,P006919,P008211,11.433,-7,23,30
124,BER,P006919,P008967,12.5,-7,24,31
124,BER,P006919,P011934,6.8,-5,7,12
124,BER,P006919,P012720,1.733,-3,3,6
124,BER,P006919,P012721,8.533,4,23,19
124,BER,P007025,P008173,3.317,-2,3,5
124,BER,P007025,P008211,1.3,-3,2,5
124,BER,P007025,P008384,3.617,0,5,5
124,BER,P007025,P012720,0.45,-3,0,3
124,BER,P007025,P012721,3.317,-2,3,5
124,BER,P008173,P008384,13.633,-2,25,27
124,BER,P008173,P008967,2.75,-5,1,6
124,BER,P008173,P011934,12.333,-7,21,28
124,BER,P008173,P012720,11.816,-6,25,31
124,BER,P008173,P012721,6.15,4,9,5
124,BER,P008211,P008384,2.866,-4,4,8
124,BER,P008211,P008967,16.616,-1,34,35
124,BER,P008211,P011934,10.166,-2,15,17
124,BER,P008211,P012720,7.249,-5,9,14
124,BER,P008211,P012721,5.7,-2,17,19
124,BER,P008384,P008967,1.433,0,2,2
124,BER,P008384,P011934,10.266,-5,20,25
124,BER,P008384,P012720,11.449,-6,22,28
124,BER,P008384,P012721,2.867,1,3,2
124,BER,P008967,P011934,12.233,-4,16,20
124,BER,P008967,P012720,5.433,1,9,8
124,BER,P008967,P012721,5.7,-2,17,19
124,BER,P011934,P012720,15.699,-4,29,33
124,BER,P012720,P012721,0.45,-3,0,3
124,RED,P000848,P002553,12.95,7,28,21
124,RED,P000848,P006436,15.484,17,41,24
124,RED,P000848,P007960,4.417,7,17,10
124,RED,P000848,P009035,21.617,18,55,37
124,RED,P000848,P012044,19.1,12,44,32
124,RED,P000848,P012711,4.25,4,10,6
124,RED,P000848,PJDR,2.517,6,11,5
124,RED,P000848,PLUO,6.133,1,14,13
124,RED,P002553,P006436,8.784,6,19,13
124,RED,P002553,P008966,1.417,-2,3,5
124,RED,P002553,P009035,13.5,9,30,21
124,RED,P002553,P011224,1.967,0,5,5
124,RED,P002553,P012044,12.95,7,28,21
124,RED,P002553,PJDR,1.967,0,5,5
124,RED,P002553,PLUO,6.133,1,14,13
124,RED,P006436,P007960,16.666,2,39,37
124,RED,P006436,P008966,9.5,0,22,22
124,RED,P006436,P009035,17.367,18,46,28
124,RED,P006436,P011224,11.383,1,27,26
124,RED,P006436,P012044,15.8,5,30,25
124,RED,P006436,P012711,7.083,-2,10,12
124,RED,P006436,PJDR,13.9,7,38,31
124,RED,P006436,PLUO,2.833,-6,0,6
124,RED,P007960,P008966,12.25,3,22,19
124,RED,P007960,P009035,5.75,6,20,14
124,RED,P007960,P011224,13.583,2,25,23
124,RED,P007960,P012044,4.733,-5,6,11
124,RED,P007960,P012711,2.833,-6,0,6
124,RED,P007960,PJDR,16.1,8,36,28
124,RED,P007960,PLUO,7.0,-5,3,8
124,RED,P008966,P011224,13.667,1,25,24
124,RED,P008966,PJDR,13.667,1,25,24
124,RED,P008966,PLUO,4.167,1,3,2
124,RED,P009035,P011224,1.883,1,5,4
124,RED,P009035,P012044,19.1,12,44,32
124,RED,P009035,P012711,4.25,4,10,6
124,RED,P009035,PJDR,4.4,7,16,9
124,RED,P009035,PLUO,6.133,1,14,13
124,RED,P011224,PJDR,15.55,2,30,28
124,RED,P011224,PLUO,4.167,1,3,2
124,RED,P012044,P012711,7.083,-2,10,12
124,RED,P012044,PLUO,8.966,-5,14,19
124,RED,P012711,PLUO,2.833,-6,0,6
124,RED,PJDR,PLUO,4.167,1,3,2
125,BAR,P000925,P002939,13.217,2,24,22
125,BAR,P000925,P003478,16.7,4,32,28
125,BAR,P000925,P004866,10.384,5,22,17
125,BAR,P000925,P006435,10.65,5,28,23
125,BAR,P000925,P007464,13.35,8,32,24
125,BAR,P000925,P007519,4.25,7,14,7
125,BAR,P000925,P009992,5.4,1,12,11
125,BAR,P000925,P011244,1.517,0,0,0
125,BAR,P002939,P003196,11.968,-8,33,41
125,BAR,P002939,P003478,12.534,2,26,24
125,BAR,P002939,P004866,20.018,2,52,50
125,BAR,P002939,P006435,9.501,-1,19,20
125,BAR,P002939,P007464,9.1,1,18,17
125,BAR,P002939,P007519,1.117,-3,0,3
125,BAR,P002939,P009992,14.184,-3,42,45
125,BAR,P002939,P010641,0.85,2,2,0
125,BAR,P002939,P011244,11.651,-10,20,30
125,BAR,P003196,P003478,3.6,0,13,13
125,BAR,P003196,P004866,10.851,-5,33,38
125,BAR,P003196,P006435,7.284,-3,12,15
125,BAR,P003196,P007464,2.783,-3,4,7
125,BAR,P003196,P007519,3.9,-6,4,10
125,BAR,P003196,P009992,9.334,-7,31,38
125,BAR,P003196,P011244,9.284,-12,18,30
125,BAR,P003478,P004866,9.034,4,22,18
125,BAR,P003478,P006435,14.399,-4,23,27
125,BAR,P003478,P007464,17.099,-1,27,28
125,BAR,P003478,P007519,9.499,1,16,15
125,BAR,P003478,P009992,6.217,4,21,17
125,BAR,P003478,P010641,3.133,-2,0,2
125,BAR,P003478,P011244,1.517,0,0,0
125,BAR,P004866,P006435,9.351,5,26,21
125,BAR,P004866,P007464,8.784,4,19,15
125,BAR,P004866,P007519,3.067,0,8,8
125,BAR,P004866,P009992,14.184,-5,42,47
125,BAR,P004866,P010641,3.25,1,8,7
125,BAR,P004866,P011244,9.017,-7,20,27
125,BAR,P006435,P007464,16.049,0,35,35
125,BAR,P006435,P007519,13.683,-2,24,26
125,BAR,P006435,P009992,3.267,0,9,9
125,BAR,P006435,P010641,5.533,-3,6,9
125,BAR,P006435,P011244,4.151,-1,2,3
125,BAR,P007464,P007519,12.566,1,24,23
125,BAR,P007464,P009992,1.4,1,3,2
125,BAR,P007464,P010641,5.533,-3,6,9
125,BAR,P007519,P010641,5.533,-3,6,9
125,BAR,P007519,P011244,1.117,-3,0,3
125,BAR,P009992,P010641,0.85,2,2,0
125,BAR,P009992,P011244,7.5,-9,18,27
125,BAR,P010641,P011244,0.85,2,2,0
125,MIL,P001518,P002812,3.133,2,2,0
125,MIL,P001518,P002849,13.9,3,28,25
125,MIL,P001518,P005670,15.816,7,28,21
125,MIL,P001518,P006509,4.533,1,4,3
125,MIL,P001518,P006701,1.217,-2,2,4
125,MIL,P001518,P007201,12.683,5,26,21
125,MIL,P001518,P007831,12.5,4,26,22
125,MIL,P001518,P009960,3.133,2,2,0
125,MIL,P001518,P011205,1.217,-2,2,4
125,MIL,P002812,P002849,2.451,1,12,11
125,MIL,P002812,P005670,5.716,2,11,9
125,MIL,P002812,P006509,9.783,-5,18,23
125,MIL,P002812,P006701,1.167,2,2,0
125,MIL,P002812,P007831,6.934,1,23,22
125,MIL,P002812,P009960,9.349,-1,15,16
125,MIL,P002812,P011205,8.667,-2,25,27
125,MIL,P002849,P005670,25.617,7,62,55
125,MIL,P002849,P006509,2.067,-5,5,10
125,MIL,P002849,P006701,2.384,0,4,4
125,MIL,P002849,P007201,23.183,8,50,42
125,MIL,P002849,P007831,27.268,4,67,63
125,MIL,P002849,P009960,1.817,-4,5,9
125,MIL,P002849,P011205,15.985,-2,43,45
125,MIL,P005670,P006509,8.249,0,12,12
125,MIL,P005670,P007201,25.166,10,56,46
125,MIL,P005670,P007831,24.45,8,60,52
125,MIL,P005670,P009960,8.899,-3,15,18
125,MIL,P005670,P011205,16.883,1,44,43
125,MIL,P006509,P007201,3.383,1,8,7
125,MIL,P006509,P007831,4.917,-4,14,18
125,MIL,P006509,P009960,11.099,1,21,20
125,MIL,P006509,P011205,8.633,-5,22,27
125,MIL,P006701,P007831,2.384,0,4,4
125,MIL,P006701,P011205,2.384,0,4,4
125,MIL,P007201,P007831,21.783,9,48,39
125,MIL,P007201,P009960,1.983,2,6,4
125,MIL,P007201,P011205,12.483,5,30,25
125,MIL,P007831,P009960,6.3,-4,16,20
125,MIL,P007831,P011205,20.468,-2,54,56
125,MIL,P009960,P011205,10.016,-5,24,29
126,OLY,P001255,P003941,10.434,-8,9,17
126,OLY,P001255,P006589,10.583,8,17,9
126,OLY,P001255,P007853,7.85,3,17,14
126,OLY,P001255,P008811,19.566,11,36,25
126,OLY,P001255,P008855,30.0,3,45,42
126,OLY,P001255,P010392,4.95,-3,3,6
126,OLY,P001255,P010612,30.0,3,45,42
126,OLY,P001255,P011194,3.617,-6,3,9
126,OLY,P001255,P011983,3.0,1,5,4
126,OLY,P003941,P007853,6.6,-6,4,10
126,OLY,P003941,P007982,1.05,-3,1,4
126,OLY,P003941,P008855,12.367,-10,9,19
126,OLY,P003941,P010392,7.933,-8,4,12
126,OLY,P003941,P010612,10.434,-8,9,17
126,OLY,P003941,P011194,4.85,-9,4,13
126,OLY,P006589,P007982,2.45,-4,2,6
126,OLY,P006589,P008811,16.183,2,24,22
126,OLY,P006589,P008855,13.733,6,22,16
126,OLY,P006589,P010392,5.6,-6,7,13
126,OLY,P006589,P010612,10.583,8,17,9
126,OLY,P006589,P011983,5.6,-6,7,13
126,OLY,P007853,P007982,2.467,-2,4,6
126,OLY,P007853,P008811,5.65,5,17,12
126,OLY,P007853,P008855,9.783,1,17,16
126,OLY,P007853,P010392,4.4,-4,4,8
126,OLY,P007853,P010612,7.85,3,17,14
126,OLY,P007853,P011194,4.4,-4,4,8
126,OLY,P007982,P008811,3.867,-3,5,8
126,OLY,P007982,P010392,4.917,-6,6,12
126,OLY,P007982,P011194,2.467,-2,4,6
126,OLY,P007982,P011983,2.45,-4,2,6
126,OLY,P008811,P008855,22.716,9,41,32
126,OLY,P008811,P010392,7.017,-5,10,15
126,OLY,P008811,P010612,19.566,11,36,25
126,OLY,P008811,P011194,3.167,-1,3,4
126,OLY,P008811,P011983,8.6,-5,12,17
126,OLY,P008855,P010392,10.033,-7,8,15
126,OLY,P008855,P010612,30.0,3,45,42
126,OLY,P008855,P011194,5.55,-8,3,11
126,OLY,P008855,P011983,6.15,-1,10,11
126,OLY,P010392,P010612,4.95,-3,3,6
126,OLY,P010392,P011194,4.4,-4,4,8
126,OLY,P010392,P011983,5.6,-6,7,13
126,OLY,P010612,P011194,3.617,-6,3,9
126,OLY,P010612,P011983,3.0,1,5,4
126,PAM,P000556,P003960,2.034,0,8,8
126,PAM,P000556,P004863,11.017,2,21,19
126,PAM,P000556,P006643,1.733,-5,0,5
126,PAM,P000556,P007870,10.95,2,21,19
126,PAM,P000556,P008780,8.0,-3,10,13
126,PAM,P000556,P010393,8.383,3,13,10
126,PAM,P000556,P010568,23.533,-1,36,37
126,PAM,P000556,P012738,13.034,-8,15,23
126,PAM,P000556,P012739,14.167,-10,15,25
126,PAM,P000556,P012740,7.617,-12,5,17
126,PAM,P003960,P004863,8.535,8,21,13
126,PAM,P003960,P006643,12.167,11,25,14
126,PAM,P003960,P007870,8.535,8,21,13
126,PAM,P003960,P008780,4.917,6,12,6
126,PAM,P003960,P010393,0.583,-1,0,1
126,PAM,P003960,P010568,8.383,6,20,14
126,PAM,P003960,P012738,1.633,3,5,2
126,PAM,P003960,P012739,3.383,3,7,4
126,PAM,P003960,P012740,6.366,8,13,5
126,PAM,P004863,P006643,8.684,7,15,8
126,PAM,P004863,P007870,14.901,15,32,17
126,PAM,P004863,P008780,4.4,5,9,4
126,PAM,P004863,P010393,5.833,8,11,3
126,PAM,P004863,P010568,11.767,3,21,18
126,PAM,P004863,P012738,4.9,-3,4,7
126,PAM,P004863,P012739,4.55,-3,4,7
126,PAM,P004863,P012740,3.217,6,6,0
126,PAM,P006643,P007870,11.017,5,15,10
126,PAM,P006643,P008780,9.183,6,14,8
126,PAM,P006643,P010393,3.366,1,2,1
126,PAM,P006643,P010568,8.082,1,12,11
126,PAM,P006643,P012738,1.633,3,5,2
126,PAM,P006643,P012739,3.383,3,7,4
126,PAM,P006643,P012740,7.216,8,13,5
126,PAM,P007870,P008780,9.733,2,13,11
126,PAM,P007870,P010393,9.683,7,15,8
126,PAM,P007870,P010568,10.183,8,21,13
126,PAM,P007870,P012738,0.35,0,0,0
126,PAM,P007870,P012740,5.584,1,6,5
126,PAM,P008780,P010393,5.783,1,6,5
126,PAM,P008780,P010568,8.933,5,15,10
126,PAM,P008780,P012738,3.517,0,6,6
126,PAM,P008780,P012739,5.967,3,11,8
126,PAM,P008780,P012740,2.367,-5,0,5
126,PAM,P010393,P010568,7.449,7,13,6
126,PAM,P010393,P012739,1.483,-2,0,2
126,PAM,P010393,P012740,4.433,-8,0,8
126,PAM,P010568,P012738,14.667,-5,20,25
126,PAM,P010568,P012739,17.55,-7,22,29
126,PAM,P010568,P012740,9.249,-5,12,17
126,PAM,P012738,P012739,12.684,-8,15,23
126,PAM,P012738,P012740,6.25,-2,10,12
126,PAM,P012739,P012740,7.033,-7,7,14
127,BAR,P000925,P002939,19.166,5,41,36
127,BAR,P000925,P003204,3.2,1,8,7
127,BAR,P000925,P004866,16.666,9,36,27
127,BAR,P000925,P006435,19.466,4,41,37
127,BAR,P000925,P007464,4.333,-3,7,10
127,BAR,P000925,P007519,4.733,3,10,7
127,BAR,P000925,P009992,5.033,2,10,8
127,BAR,P000925,P011244,7.816,2,17,15
127,BAR,P000925,P012745,16.383,5,34,29
127,BAR,P002939,P003196,5.767,-2,7,9
127,BAR,P002939,P004866,20.816,12,42,30
127,BAR,P002939,P006435,23.249,1,46,45
127,BAR,P002939,P007464,6.883,-9,10,19
127,BAR,P002939,P009992,3.067,2,4,2
127,BAR,P002939,P010641,1.383,0,2,2
127,BAR,P002939,P011244,5.6,1,11,10
127,BAR,P002939,P012745,19.333,2,37,35
127,BAR,P003196,P003204,1.983,-5,2,7
127,BAR,P003196,P004866,4.867,4,8,4
127,BAR,P003196,P006435,4.65,-6,7,13
127,BAR,P003196,P007464,7.517,-10,7,17
127,BAR,P003196,P007519,8.6,-9,10,19
127,BAR,P003196,P009992,9.717,-5,10,15
127,BAR,P003196,P011244,11.117,-7,14,21
127,BAR,P003196,P012745,3.25,-4,3,7
127,BAR,P003204,P007519,5.183,-4,10,14
127,BAR,P003204,P009992,5.183,-4,10,14
127,BAR,P003204,P011244,5.183,-4,10,14
127,BAR,P004866,P006435,18.049,9,38,29
127,BAR,P004866,P007464,1.433,0,2,2
127,BAR,P004866,P007519,1.85,2,4,2
127,BAR,P004866,P009992,5.217,3,8,5
127,BAR,P004866,P010641,1.383,0,2,2
127,BAR,P004866,P011244,5.65,5,12,7
127,BAR,P004866,P012745,15.933,8,32,24
127,BAR,P006435,P007464,8.833,-11,14,25
127,BAR,P006435,P007519,1.95,-2,4,6
127,BAR,P006435,P009992,0.3,-1,0,1
127,BAR,P006435,P010641,1.383,0,2,2
127,BAR,P006435,P011244,5.033,-3,11,14
127,BAR,P006435,P012745,19.083,1,37,36
127,BAR,P007464,P007519,6.4,-4,6,10
127,BAR,P007464,P009992,4.45,-2,2,4
127,BAR,P007464,P010641,1.383,0,2,2
127,BAR,P007464,P011244,8.2,-6,9,15
127,BAR,P007464,P012745,3.7,-7,5,12
127,BAR,P007519,P009992,11.433,-4,16,20
127,BAR,P007519,P011244,13.383,-6,20,26
127,BAR,P009992,P011244,13.95,-2,20,22
127,BAR,P009992,P012745,0.85,-1,0,1
127,BER,P003958,P006251,2.067,4,4,0
127,BER,P003958,P007025,1.35,0,4,4
127,BER,P003958,P008173,16.417,8,36,28
127,BER,P003958,P008211,12.884,-5,22,27
127,BER,P003958,P008384,10.168,-5,17,22
127,BER,P003958,P008967,25.434,9,54,45
127,BER,P003958,P010791,3.017,-4,5,9
127,BER,P003958,P011934,24.217,3,49,46
127,BER,P003958,P012720,21.65,2,41,39
127,BER,P006251,P007025,10.699,1,16,15
127,BER,P006251,P008173,6.05,4,6,2
127,BER,P006251,P008211,6.716,1,14,13
127,BER,P006251,P008384,12.766,5,20,15
127,BER,P006251,P008967,2.067,4,4,0
127,BER,P006251,P010791,5.916,6,9,3
127,BER,P006251,P012721,4.783,-5,7,12
127,BER,P007025,P008173,5.333,0,6,6
127,BER,P007025,P008211,6.716,1,14,13
127,BER,P007025,P008384,12.049,1,20,19
127,BER,P007025,P010791,5.916,6,9,3
127,BER,P007025,P011934,1.35,0,4,4
127,BER,P007025,P012721,4.783,-5,7,12
127,BER,P008173,P008384,9.767,5,14,9
127,BER,P008173,P008967,15.067,8,32,24
127,BER,P008173,P010791,3.933,0,2,2
127,BER,P008173,P011934,14.35,4,32,28
127,BER,P008173,P012720,10.633,3,24,21
127,BER,P008173,P012721,0.05,0,0,0
127,BER,P008211,P008384,11.1,-9,19,28
127,BER,P008211,P008967,10.367,1,22,21
127,BER,P008211,P010791,5.0,2,12,10
127,BER,P008211,P011934,9.867,-1,17,18
127,BER,P008211,P012720,11.017,-1,17,18
127,BER,P008211,P012721,4.733,-5,7,12
127,BER,P008384,P008967,6.301,1,13,12
127,BER,P008384,P010791,7.783,2,14,12
127,BER,P008384,P011934,6.234,-5,8,13
127,BER,P008384,P012720,2.517,-6,0,6
127,BER,P008384,P012721,4.783,-5,7,12
127,BER,P008967,P010791,3.017,-4,5,9
127,BER,P008967,P011934,20.35,9,45,36
127,BER,P008967,P012720,19.133,8,41,33
127,BER,P010791,P012720,1.15,0,0,0
127,BER,P011934,P012720,20.5,2,41,39
128,MAD,P001392,P005791,6.233,-6,8,14
128,MAD,P001392,P005928,6.233,-6,8,14
128,MAD,P001392,P006540,6.233,-6,8,14
128,MAD,P001392,P009213,6.233,-6,8,14
128,MAD,P003108,P003733,15.533,16,34,18
128,MAD,P003108,P004887,17.099,14,34,20
128,MAD,P003108,P005791,13.684,11,28,17
128,MAD,P003108,P005928,15.133,12,26,14
128,MAD,P003108,P006540,12.817,4,19,15
128,MAD,P003108,P009213,11.784,10,25,15
128,MAD,P003108,PCVM,16.7,15,38,23
128,MAD,P003108,PTGB,20.85,18,44,26
128,MAD,P003733,P004887,16.566,14,36,22
128,MAD,P003733,P005928,5.4,-2,6,8
128,MAD,P003733,P009213,2.867,-5,2,7
128,MAD,P003733,P011649,1.717,-3,0,3
128,MAD,P003733,PCVM,15.567,12,32,20
128,MAD,P003733,PTGB,15.95,12,34,22
128,MAD,P004887,P005928,4.332,1,6,5
128,MAD,P004887,P006540,1.6,-2,0,2
128,MAD,P004887,P009213,1.15,-2,2,4
128,MAD,P004887,PCVM,14.733,13,32,19
128,MAD,P004887,PTGB,17.516,10,34,24
128,MAD,P005791,P005928,18.067,3,30,27
128,MAD,P005791,P006540,17.45,0,27,27
128,MAD,P005791,P009213,18.017,4,33,29
128,MAD,P005791,PCVM,1.85,2,6,4
128,MAD,P005791,PTGB,4.367,6,12,6
128,MAD,P005928,P006540,18.133,0,27,27
128,MAD,P005928,P009213,19.034,-3,29,32
128,MAD,P005928,P011649,1.717,-3,0,3
128,MAD,P005928,PCVM,2.65,-1,2,3
128,MAD,P005928,PTGB,6.233,3,10,7
128,MAD,P006540,P009213,15.55,-1,24,25
128,MAD,P006540,PCVM,0.917,-2,0,2
128,MAD,P006540,PTGB,3.5,-1,3,4
128,MAD,P009213,P011649,1.717,-3,0,3
128,MAD,P009213,PCVM,3.567,-1,6,7
128,MAD,P009213,PTGB,3.617,3,11,8
128,MAD,P011649,PCVM,1.717,-3,0,3
128,MAD,PCVM,PTGB,15.967,13,36,23
128,RED,P000848,P002553,10.133,-5,14,19
128,RED,P000848,P006436,9.733,-4,14,18
128,RED,P000848,P007960,11.45,-9,14,23
128,RED,P000848,P008966,6.033,-5,12,17
128,RED,P000848,P009035,9.049,0,10,10
128,RED,P000848,P012044,2.7,-2,3,5
128,RED,P000848,P012711,4.8,-7,8,15
128,RED,P000848,PJDR,14.366,-8,21,29
128,RED,P002553,P005099,10.883,0,19,19
128,RED,P002553,P006436,5.867,-2,6,8
128,RED,P002553,P007960,8.7,-7,12,19
128,RED,P002553,P008966,1.85,-2,4,6
128,RED,P002553,P009035,20.866,-5,29,34
128,RED,P002553,P012044,16.65,-5,24,29
128,RED,P002553,PJDR,8.3,-6,13,19
128,RED,P002553,PLUO,13.083,0,19,19
128,RED,P004720,P005099,1.717,5,5,0
128,RED,P004720,P006436,0.2,0,0,0
128,RED,P004720,P007960,1.8,5,5,0
128,RED,P004720,P009035,0.117,0,0,0
128,RED,P004720,P012044,1.917,5,5,0
128,RED,P004720,P012711,1.8,5,5,0
128,RED,P004720,PLUO,0.117,0,0,0
128,RED,P005099,P006436,2.75,-3,5,8
128,RED,P005099,P007960,8.783,-1,13,14
128,RED,P005099,P009035,17.949,-6,27,33
128,RED,P005099,P012044,14.583,3,26,23
128,RED,P005099,P012711,3.7,3,7,4
128,RED,P005099,PJDR,5.083,-4,6,10
128,RED,P005099,PLUO,13.216,-1,20,21
128,RED,P006436,P007960,6.95,-6,9,15
128,RED,P006436,P008966,4.183,-3,8,11
128,RED,P006436,P009035,9.5,-2,11,13
128,RED,P006436,P012044,3.267,-3,2,5
128,RED,P006436,P012711,4.883,-7,8,15
128,RED,P006436,PJDR,13.35,-10,21,31
128,RED,P006436,PLUO,2.317,0,0,0
128,RED,P007960,P008966,1.85,-2,4,6
128,RED,P007960,P009035,14.682,-8,16,24
128,RED,P007960,P012044,6.483,1,10,9
128,RED,P007960,P012711,4.4,-1,7,8
128,RED,P007960,PJDR,13.833,-11,17,28
128,RED,P007960,PLUO,2.333,-1,1,2
128,RED,P008966,P012711,4.183,-3,8,11
128,RED,P008966,PJDR,6.033,-5,12,17
128,RED,P009035,P012044,18.75,-7,26,33
128,RED,P009035,P012711,1.983,-2,2,4
128,RED,P009035,PJDR,12.299,-5,15,20
128,RED,P009035,PLUO,15.533,-1,20,21
128,RED,P012044,P012711,3.783,3,7,4
128,RED,P012044,PJDR,0.867,-3,2,5
128,RED,P012044,PLUO,13.2,0,19,19
128,RED,P012711,PJDR,4.8,-7,8,15
128,RED,PJDR,PLUO,2.333,-1,1,2
129,BAS,P003198,P004603,5.667,-7,9,16
129,BAS,P003198,P004761,5.667,-7,9,16
129,BAS,P003198,P007230,5.667,-7,9,16
129,BAS,P003198,P009048,5.667,-7,9,16
129,BAS,P004603,P004761,18.751,9,46,37
129,BAS,P004603,P007230,16.168,1,36,35
129,BAS,P004603,P009048,15.551,-2,32,34
129,BAS,P004603,P011085,1.534,1,3,2
129,BAS,P004603,P011948,10.167,5,26,21
129,BAS,P004603,P012201,8.417,11,25,14
129,BAS,P004603,P012765,6.817,6,19,13
129,BAS,P004761,P007230,28.468,-3,56,59
129,BAS,P004761,P008072,6.5,-6,9,15
129,BAS,P004761,P009048,27.534,-5,51,56
129,BAS,P004761,P011085,2.884,-2,4,6
129,BAS,P004761,P011948,18.417,4,40,36
129,BAS,P004761,P012201,16.883,13,40,27
129,BAS,P004761,P012765,12.5,5,29,24
129,BAS,P007230,P008072,5.167,-6,7,13
129,BAS,P007230,P009048,24.318,-12,42,54
129,BAS,P007230,P011085,2.884,-2,4,6
129,BAS,P007230,P011948,16.801,-5,33,38
129,BAS,P007230,P012201,13.667,6,31,25
129,BAS,P007230,P012765,11.6,8,30,22
129,BAS,P008072,P009048,9.383,-14,13,27
129,BAS,P008072,P011085,4.233,-11,5,16
129,BAS,P008072,P011948,8.033,-11,12,23
129,BAS,P008072,P012201,4.216,-8,6,14
129,BAS,P009048,P011085,5.4,-8,8,16
129,BAS,P009048,P011948,19.317,-6,39,45
129,BAS,P009048,P012201,19.033,-5,38,43
129,BAS,P009048,P012765,6.333,-1,12,13
129,BAS,P011085,P011948,2.883,-8,4,12
129,BAS,P011085,P012201,2.883,-8,4,12
129,BAS,P011085,P012765,0.367,-2,0,2
129,BAS,P011948,P012201,15.05,-4,32,36
129,BAS,P011948,P012765,5.4,1,14,13
129,BAS,P012201,P012765,9.783,7,24,17
129,TEL,P005145,P009622,7.583,2,17,15
129,TEL,P005145,P009783,7.583,2,17,15
129,TEL,P005145,P009863,6.383,0,13,13
129,TEL,P005145,P011193,1.2,2,4,2
129,TEL,P005145,P011199,7.583,2,17,15
129,TEL,P009622,P009783,22.116,9,46,37
129,TEL,P009622,P009863,17.916,9,41,32
129,TEL,P009622,P011193,12.516,-10,23,33
129,TEL,P009622,P011199,18.567,1,37,36
129,TEL,P009622,P011214,10.866,-6,19,25
129,TEL,P009622,P011219,9.116,0,23,23
129,TEL,P009622,P011971,22.399,3,47,44
129,TEL,P009622,P012744,3.717,-12,3,15
129,TEL,P009783,P009863,20.333,14,46,32
129,TEL,P009783,P011193,8.35,-1,16,17
129,TEL,P009783,P011199,17.867,5,37,32
129,TEL,P009783,P011214,5.5,-1,6,7
129,TEL,P009783,P011219,4.883,5,13,8
129,TEL,P009783,P011971,14.883,17,35,18
129,TEL,P009783,P012744,1.217,-6,0,6
129,TEL,P009863,P011193,8.367,7,25,18
129,TEL,P009863,P011199,15.7,7,33,26
129,TEL,P009863,P011214,4.484,-4,6,10
129,TEL,P009863,P011219,10.9,11,33,22
129,TEL,P009863,P011971,18.217,20,51,31
129,TEL,P009863,P012744,4.1,8,16,8
129,TEL,P011193,P011199,2.784,-6,4,10
129,TEL,P011193,P011214,13.766,-8,25,33
129,TEL,P011193,P011219,14.567,7,40,33
129,TEL,P011193,P011971,16.333,5,42,37
129,TEL,P011193,P012744,5.117,0,13,13
129,TEL,P011199,P011214,1.584,-2,0,2
129,TEL,P011199,P011219,0.117,0,0,0
129,TEL,P011199,P011971,10.451,5,20,15
129,TEL,P011199,P012744,2.351,-8,0,8
129,TEL,P011214,P011219,10.25,-6,21,27
129,TEL,P011214,P011971,13.35,-8,23,31
129,TEL,P011214,P012744,1.6,-5,0,5
129,TEL,P011219,P011971,15.35,11,46,35
129,TEL,P011219,P012744,4.217,8,16,8
129,TEL,P011971,P012744,5.817,3,16,13
130,PAM,P000556,P003960,15.234,-9,19,28
130,PAM,P000556,P004863,4.701,-4,6,10
130,PAM,P000556,P005356,5.417,-3,5,8
130,PAM,P000556,P006643,5.817,-6,8,14
130,PAM,P000556,P007870,11.584,-9,14,23
130,PAM,P000556,P010568,15.234,-9,19,28
130,PAM,P000556,P012738,0.584,-2,0,2
130,PAM,P000556,P012739,4.234,-2,5,7
130,PAM,P000556,P012740,0.467,0,0,0
130,PAM,P003960,P004863,7.867,-10,11,21
130,PAM,P003960,P005356,5.6,-3,5,8
130,PAM,P003960,P006643,7.534,-9,9,18
130,PAM,P003960,P007870,18.167,-10,29,39
130,PAM,P003960,P008780,2.1,-1,4,5
130,PAM,P003960,P010393,2.717,2,7,5
130,PAM,P003960,P010568,23.284,-14,35,49
130,PAM,P003960,P012738,1.583,1,4,3
130,PAM,P003960,P012739,5.117,-4,6,10
130,PAM,P003960,P012740,3.933,1,11,10
130,PAM,P004863,P005356,4.416,-2,5,7
130,PAM,P004863,P006643,8.434,-5,11,16
130,PAM,P004863,P007870,12.483,-1,20,21
130,PAM,P004863,P010393,6.4,0,8,8
130,PAM,P004863,P010568,9.283,-6,15,21
130,PAM,P004863,P012738,4.817,-4,5,9
130,PAM,P004863,P012739,6.684,-11,6,17
130,PAM,P004863,P012740,11.583,-5,17,22
130,PAM,P005356,P007870,4.167,-3,5,8
130,PAM,P005356,P010393,2.617,6,8,2
130,PAM,P005356,P010568,8.65,3,13,10
130,PAM,P005356,P012738,4.666,-2,5,7
130,PAM,P005356,P012739,8.716,4,13,9
130,PAM,P005356,P012740,7.283,4,13,9
130,PAM,P006643,P007870,14.917,2,27,25
130,PAM,P006643,P010393,8.2,6,16,10
130,PAM,P006643,P010568,11.317,0,22,22
130,PAM,P006643,P012738,0.684,-3,1,4
130,PAM,P006643,P012739,1.584,-6,1,7
130,PAM,P006643,P012740,7.517,5,17,12
130,PAM,P007870,P008780,2.1,-1,4,5
130,PAM,P007870,P010393,12.734,11,28,17
130,PAM,P007870,P010568,23.767,2,47,45
130,PAM,P007870,P012738,2.15,0,5,5
130,PAM,P007870,P012740,13.267,9,33,24
130,PAM,P008780,P010393,2.1,-1,4,5
130,PAM,P008780,P010568,2.1,-1,4,5
130,PAM,P010393,P010568,8.467,16,25,9
130,PAM,P010393,P012739,0.8,3,3,0
130,PAM,P010393,P012740,10.101,13,25,12
130,PAM,P010568,P012738,2.583,0,5,5
130,PAM,P010568,P012739,6.35,-1,9,10
130,PAM,P010568,P012740,9.433,14,30,16
130,PAM,P012738,P012739,5.25,-4,5,9
130,PAM,P012738,P012740,7.283,-2,10,12
130,PAM,P012739,P012740,5.933,1,8,7
130,PAR,P000956,P004172,0.45,0,0,0
130,PAR,P000956,P007400,5.25,-5,10,15
130,PAR,P000956,P008987,5.25,-5,10,15
130,PAR,P000956,P009862,4.8,-5,10,15
130,PAR,P000956,P011051,3.45,1,8,7
130,PAR,P000956,P012743,1.8,-6,2,8
130,PAR,P004058,P004172,4.183,-1,7,8
130,PAR,P004058,P007400,4.8,-4,7,11
130,PAR,P004058,P008987,0.617,-3,0,3
130,PAR,P004058,P009212,4.183,-1,7,8
130,PAR,P004058,P009862,0.617,-3,0,3
130,PAR,P004058,P012096,0.617,-3,0,3
130,PAR,P004058,P012743,4.183,-1,7,8
130,PAR,P004172,P007400,9.299,-1,16,17
130,PAR,P004172,P008987,4.883,0,10,10
130,PAR,P004172,P009212,7.866,-2,11,13
130,PAR,P004172,P009862,7.133,-2,9,11
130,PAR,P004172,P011051,4.883,0,10,10
130,PAR,P004172,P012096,0.217,-1,0,1
130,PAR,P004172,P012742,0.983,1,5,4
130,PAR,P004172,P012743,11.099,-2,16,18
130,PAR,P007400,P008987,22.717,4,44,40
130,PAR,P007400,P009212,7.866,-2,11,13
130,PAR,P007400,P009862,24.967,2,43,41
130,PAR,P007400,P011051,13.316,4,27,23
130,PAR,P007400,P012096,6.034,4,13,9
130,PAR,P007400,P012742,16.85,12,34,22
130,PAR,P007400,P012743,11.233,-6,15,21
130,PAR,P008987,P009862,30.701,6,56,50
130,PAR,P008987,P011051,22.733,7,44,37
130,PAR,P008987,P012096,12.218,7,25,18
130,PAR,P008987,P012742,22.817,16,46,30
130,PAR,P008987,P012743,6.6,-4,9,13
130,PAR,P009212,P009862,3.683,-1,4,5
130,PAR,P009212,P012743,7.866,-2,11,13
130,PAR,P009862,P011051,21.3,6,39,33
130,PAR,P009862,P012096,12.218,7,25,18
130,PAR,P009862,P012742,21.834,15,41,26
130,PAR,P009862,P012743,10.283,-5,13,18
130,PAR,P011051,P012096,6.184,3,12,9
130,PAR,P011051,P012742,15.833,7,31,24
130,PAR,P011051,P012743,3.233,0,5,5
130,PAR,P012096,P012742,11.384,11,25,14
130,PAR,P012742,P012743,1.567,2,2,0
131,OLY,P001255,P003941,11.4,-5,17,22
131,OLY,P001255,P007982,8.617,-1,12,13
131,OLY,P001255,P008811,8.6,3,17,14
131,OLY,P001255,P008829,20.0,-2,34,36
131,OLY,P001255,P008855,11.383,-1,22,23
131,OLY,P001255,P010612,20.0,-2,34,36
131,OLY,P003941,P007853,0.617,2,2,0
131,OLY,P003941,P007982,18.567,0,31,31
131,OLY,P003941,P008829,16.634,-3,24,27
131,OLY,P003941,P008855,9.783,-10,12,22
131,OLY,P003941,P010392,11.233,1,19,18
131,OLY,P003941,P010612,11.4,-5,17,22
131,OLY,P003941,P011194,6.616,1,14,13
131,OLY,P003941,P011983,6.75,11,16,5
131,OLY,P007853,P008811,2.917,0,3,3
131,OLY,P007853,P008855,3.534,2,5,3
131,OLY,P007853,P011194,3.534,2,5,3
131,OLY,P007853,P011983,3.534,2,5,3
131,OLY,P007982,P008811,2.05,-2,2,4
131,OLY,P007982,P008829,15.901,-1,21,22
131,OLY,P007982,P008855,5.617,-8,5,13
131,OLY,P007982,P010392,12.0,-1,21,22
131,OLY,P007982,P010612,8.617,-1,12,13
131,OLY,P007982,P011194,4.716,-1,12,13
131,OLY,P007982,P011983,6.383,7,16,9
131,OLY,P008811,P008829,11.65,0,21,21
131,OLY,P008811,P008855,15.217,2,27,25
131,OLY,P008811,P010392,4.516,-2,7,9
131,OLY,P008811,P010612,9.317,2,19,17
131,OLY,P008811,P011194,5.1,0,8,8
131,OLY,P008811,P011983,7.633,-3,12,15
131,OLY,P008829,P008855,15.717,-5,26,31
131,OLY,P008829,P010392,7.567,0,9,9
131,OLY,P008829,P010612,20.717,-3,36,39
131,OLY,P008829,P011983,4.95,2,9,7
131,OLY,P008855,P010392,9.366,-8,10,18
131,OLY,P008855,P010612,12.1,-2,24,26
131,OLY,P008855,P011194,9.283,-3,13,16
131,OLY,P008855,P011983,8.0,1,12,11
131,OLY,P010392,P011194,8.182,-1,17,18
131,OLY,P010392,P011983,10.132,7,21,14
131,OLY,P010612,P011983,0.717,-1,2,3
131,OLY,P011194,P011983,9.433,6,19,13
131,VIR,P001133,P001844,19.884,-1,29,30
131,VIR,P001133,P002084,1.567,1,3,2
131,VIR,P001133,P003048,14.317,-5,21,26
131,VIR,P001133,P003527,2.684,-2,3,5
131,VIR,P001133,P004007,9.484,1,15,14
131,VIR,P001133,P006739,9.768,4,22,18
131,VIR,P001133,P009549,26.385,5,47,42
131,VIR,P001133,P010781,5.167,-3,5,8
131,VIR,P001133,P012714,10.567,9,24,15
131,VIR,P001133,PBCN,18.785,3,35,32
131,VIR,P001844,P002084,1.567,1,3,2
131,VIR,P001844,P003048,17.533,2,32,30
131,VIR,P001844,P003527,7.35,4,13,9
131,VIR,P001844,P004007,12.65,9,24,15
131,VIR,P001844,P009549,20.217,3,33,30
131,VIR,P001844,P010781,7.5,0,11,11
131,VIR,P001844,P012714,3.683,4,7,3
131,VIR,P001844,PBCN,10.684,-2,16,18
131,VIR,P002084,P003048,4.917,-7,5,12
131,VIR,P002084,P004007,2.3,-3,3,6
131,VIR,P002084,P006739,4.917,-7,5,12
131,VIR,P002084,P009549,2.467,1,3,2
131,VIR,P002084,P010781,4.017,-7,5,12
131,VIR,P002084,PBCN,4.184,-3,5,8
131,VIR,P003048,P003527,5.433,6,13,7
131,VIR,P003048,P004007,11.783,7,25,18
131,VIR,P003048,P006739,7.134,-8,7,15
131,VIR,P003048,P009549,16.65,-1,25,26
131,VIR,P003048,P010781,10.517,-7,16,23
131,VIR,P003048,PBCN,10.384,-11,12,23
131,VIR,P003527,P004007,5.933,5,14,9
131,VIR,P003527,P006739,0.767,0,3,3
131,VIR,P003527,P009549,3.567,3,6,3
131,VIR,P003527,P010781,4.05,2,9,7
131,VIR,P003527,PBCN,2.684,-2,3,5
131,VIR,P004007,P006739,4.517,-5,7,12
131,VIR,P004007,P009549,7.6,7,15,8
131,VIR,P004007,P010781,9.017,-2,15,17
131,VIR,P004007,P012714,4.317,-2,5,7
131,VIR,P004007,PBCN,1.067,-1,1,2
131,VIR,P006739,P009549,8.501,6,18,12
131,VIR,P006739,P010781,5.734,-8,8,16
131,VIR,P006739,P012714,6.884,5,17,12
131,VIR,P006739,PBCN,10.718,1,21,20
131,VIR,P009549,P010781,2.5,-2,2,4
131,VIR,P009549,P012714,7.85,10,21,11
131,VIR,P009549,PBCN,19.135,4,34,30
131,VIR,P010781,P012714,2.717,-1,3,4
131,VIR,P010781,PBCN,1.717,-4,2,6
131,VIR,P012714,PBCN,6.25,11,19,8
132,MCO,P004197,P004790,0.933,1,3,2
132,MCO,P004197,P005985,16.434,-10,29,39
132,MCO,P004197,P010588,17.917,-8,31,39
132,MCO,P004197,P011196,2.85,-9,4,13
132,MCO,P004197,P011212,3.333,1,7,6
132,MCO,P004197,P011226,16.367,-11,26,37
132,MCO,P004197,PLCZ,14.434,-4,24,28
132,MCO,P004790,P005985,9.217,3,25,22
132,MCO,P004790,P010588,0.783,3,3,0
132,MCO,P004790,P011196,12.834,7,33,26
132,MCO,P004790,P011212,13.617,10,36,26
132,MCO,P004790,P011226,5.467,9,15,6
132,MCO,P004790,P012709,11.617,7,29,22
132,MCO,P005985,P010588,22.467,-9,46,55
132,MCO,P005985,P011196,10.201,-7,24,31
132,MCO,P005985,P011212,16.167,2,44,42
132,MCO,P005985,P011226,21.984,-10,45,55
132,MCO,P005985,P011231,0.1,1,1,0
132,MCO,P005985,P012709,7.217,0,18,18
132,MCO,P005985,PLCZ,19.817,-6,40,46
132,MCO,P010588,P011196,5.767,-6,13,19
132,MCO,P010588,P011212,12.433,3,33,30
132,MCO,P010588,P011226,25.617,-11,52,63
132,MCO,P010588,P011231,0.1,1,1,0
132,MCO,P010588,P012709,3.067,1,9,8
132,MCO,P010588,PLCZ,20.517,-6,40,46
132,MCO,P011196,P011212,16.834,8,44,36
132,MCO,P011196,P011226,11.234,3,28,25
132,MCO,P011196,P012709,14.684,8,38,30
132,MCO,P011212,P011226,16.35,9,43,34
132,MCO,P011212,P011231,0.1,1,1,0
132,MCO,P011212,P012709,14.684,8,38,30
132,MCO,P011212,PLCZ,7.55,-2,18,20
132,MCO,P011226,P011231,0.1,1,1,0
132,MCO,P011226,P012709,7.467,8,20,12
132,MCO,P011226,PLCZ,19.75,-6,38,44
132,PAN,P001926,P002328,18.3,14,49,35
132,PAN,P001926,P003842,21.449,19,60,41
132,PAN,P001926,P007553,4.317,-5,7,12
132,PAN,P001926,P007866,22.767,3,50,47
132,PAN,P001926,P007947,15.966,12,43,31
132,PAN,P001926,P011204,17.917,3,40,37
132,PAN,P001926,P011221,5.267,0,10,10
132,PAN,P001926,P012712,8.133,9,26,17
132,PAN,P001926,P012774,11.616,9,35,26
132,PAN,P002328,P003842,17.133,4,41,37
132,PAN,P002328,P007866,19.784,6,42,36
132,PAN,P002328,P007947,11.867,-3,25,28
132,PAN,P002328,P011204,9.35,9,25,16
132,PAN,P002328,P011221,7.084,0,14,14
132,PAN,P002328,P012712,4.2,-4,12,16
132,PAN,P002328,P012774,10.35,-2,24,26
132,PAN,P003842,P007866,16.65,-3,33,36
132,PAN,P003842,P007947,14.982,-1,35,36
132,PAN,P003842,P011204,15.817,-2,32,34
132,PAN,P003842,P012712,11.016,3,30,27
132,PAN,P003842,P012774,15.749,-4,37,41
132,PAN,P007553,P007866,4.317,-5,7,12
132,PAN,P007553,P007947,3.95,-2,7,9
132,PAN,P007553,P011204,4.317,-5,7,12
132,PAN,P007553,P012774,0.367,-3,0,3
132,PAN,P007866,P007947,15.017,-9,26,35
132,PAN,P007866,P011204,15.767,3,36,33
132,PAN,P007866,P011221,5.217,2,10,8
132,PAN,P007866,P012774,6.817,-13,8,21
132,PAN,P007947,P011204,8.1,-8,13,21
132,PAN,P007947,P011221,5.234,1,12,11
132,PAN,P007947,P012712,8.983,2,24,22
132,PAN,P007947,P012774,14.033,-4,31,35
132,PAN,P011204,P012712,4.5,-7,6,13
132,PAN,P011204,P012774,5.3,-9,9,18
132,PAN,P011221,P012712,1.867,-2,4,6
132,PAN,P011221,P012774,3.667,-1,6,7
132,PAN,P012712,P012774,12.833,3,34,31
133,ASV,P000229,P002100,1.7,5,5,0
133,ASV,P000229,P003526,8.134,5,16,11
133,ASV,P000229,P004194,3.934,-10,2,12
133,ASV,P000229,P006568,0.283,0,0,0
133,ASV,P000229,P011225,4.084,1,7,6
133,ASV,P000229,P012080,8.984,-7,13,20
133,ASV,P000229,P012729,13.968,8,26,18
133,ASV,P000229,P012730,15.485,-2,28,30
133,ASV,P000229,PKIR,10.768,-8,15,23
133,ASV,P002100,P003526,1.767,-2,5,7
133,ASV,P002100,P004194,1.167,-5,2,7
133,ASV,P002100,P006568,2.05,-2,5,7
133,ASV,P002100,P011225,3.017,3,10,7
133,ASV,P002100,P012080,0.45,0,0,0
133,ASV,P002100,P012729,2.3,8,8,0
133,ASV,P002100,P012730,1.417,5,5,0
133,ASV,P003526,P004194,13.533,-19,16,35
133,ASV,P003526,P006568,12.2,-19,16,35
133,ASV,P003526,P011225,15.416,-17,19,36
133,ASV,P003526,P012080,15.833,-10,22,32
133,ASV,P003526,P012729,10.017,7,19,12
133,ASV,P003526,P012730,11.35,7,19,12
133,ASV,P003526,PKIR,5.95,0,8,8
133,ASV,P004194,P006568,15.933,-18,23,41
133,ASV,P004194,P011225,24.117,-27,32,59
133,ASV,P004194,P012080,20.316,-21,28,49
133,ASV,P004194,P012729,3.934,-4,4,8
133,ASV,P004194,P012730,6.017,-13,5,18
133,ASV,P004194,PKIR,11.917,-15,16,31
133,ASV,P006568,P011225,16.816,-15,26,41
133,ASV,P006568,P012080,13.866,-10,21,31
133,ASV,P006568,P012729,0.883,3,3,0
133,ASV,P006568,PKIR,5.233,1,10,9
133,ASV,P011225,P012080,19.216,-15,28,43
133,ASV,P011225,P012729,7.067,3,12,9
133,ASV,P011225,P012730,7.167,-3,10,13
133,ASV,P011225,PKIR,12.1,-10,16,26
133,ASV,P012080,P012729,10.751,-5,17,22
133,ASV,P012080,P012730,12.134,-10,16,26
133,ASV,P012080,PKIR,11.25,-10,19,29
133,ASV,P012729,P012730,14.568,5,26,21
133,ASV,P012729,PKIR,11.384,-1,17,18
133,ASV,P012730,PKIR,11.534,-13,15,28
133,MIL,P002812,P005670,3.484,3,7,4
133,MIL,P002812,P005775,9.301,5,19,14
133,MIL,P002812,P006509,10.551,9,25,16
133,MIL,P002812,P006701,0.417,2,2,0
133,MIL,P002812,P007201,6.301,15,21,6
133,MIL,P002812,P007831,9.001,6,21,15
133,MIL,P002812,P009960,6.05,-5,9,14
133,MIL,P002812,P011205,13.101,11,31,20
133,MIL,P002812,P011926,2.934,2,5,3
133,MIL,P002849,P005670,17.549,5,32,27
133,MIL,P002849,P005775,6.833,-1,15,16
133,MIL,P002849,P006509,7.033,-6,5,11
133,MIL,P002849,P007201,14.6,12,32,20
133,MIL,P002849,P007831,18.85,14,41,27
133,MIL,P002849,P009960,4.533,2,9,7
133,MIL,P002849,P011205,15.132,12,36,24
133,MIL,P002849,P011926,2.666,-6,2,8
133,MIL,P005670,P005775,5.966,3,13,10
133,MIL,P005670,P006509,4.4,-6,0,6
133,MIL,P005670,P006701,3.25,6,8,2
133,MIL,P005670,P006721,2.833,4,6,2
133,MIL,P005670,P007201,17.667,13,37,24
133,MIL,P005670,P007831,19.75,9,37,28
133,MIL,P005670,P009960,2.366,-4,0,4
133,MIL,P005670,P011205,14.366,12,32,20
133,MIL,P005670,P011926,3.833,3,8,5
133,MIL,P005775,P006509,10.217,1,18,17
133,MIL,P005775,P006701,2.833,4,6,2
133,MIL,P005775,P006721,2.833,4,6,2
133,MIL,P005775,P007201,4.167,8,14,6
133,MIL,P005775,P007831,7.318,6,20,14
133,MIL,P005775,P009960,7.75,-3,15,18
133,MIL,P005775,P011205,11.766,0,23,23
133,MIL,P005775,P011926,7.216,1,11,10
133,MIL,P006509,P007201,6.334,9,16,7
133,MIL,P006509,P007831,9.634,2,16,14
133,MIL,P006509,P009960,6.816,-5,9,14
133,MIL,P006509,P011205,11.083,7,26,19
133,MIL,P006509,P011926,4.6,-3,5,8
133,MIL,P006701,P006721,2.833,4,6,2
133,MIL,P006701,P011205,0.417,2,2,0
133,MIL,P006701,P011926,3.25,6,8,2
133,MIL,P006721,P011926,2.833,4,6,2
133,MIL,P007201,P007831,19.751,22,48,26
133,MIL,P007201,P009960,0.083,-1,0,1
133,MIL,P007201,P011205,15.033,26,44,18
133,MIL,P007831,P009960,7.3,1,14,13
133,MIL,P007831,P011205,19.0,23,51,28
133,MIL,P007831,P011926,0.8,-3,0,3
133,MIL,P009960,P011205,7.766,-1,16,17
133,MIL,P011205,P011926,5.6,-4,7,11
134,IST,P004554,P007200,1.85,0,2,2
134,IST,P004554,P009846,2.767,-5,2,7
134,IST,P004554,P010516,2.767,-5,2,7
134,IST,P004554,P011078,0.917,-5,0,5
134,IST,P004554,P012786,2.767,-5,2,7
134,IST,P007200,P009513,9.984,-13,14,27
134,IST,P007200,P009846,19.584,-13,35,48
134,IST,P007200,P010516,5.749,-2,7,9
134,IST,P007200,P011078,21.667,-6,38,44
134,IST,P007200,P011981,24.1,-6,45,51
134,IST,P007200,P012786,28.9,-9,49,58
134,IST,P007200,P012788,21.366,-3,42,45
134,IST,P009513,P009846,1.417,-9,0,9
134,IST,P009513,P010516,2.566,-5,0,5
134,IST,P009513,P011078,9.067,-5,14,19
134,IST,P009513,P011981,8.584,-11,14,25
134,IST,P009513,P012786,10.4,-12,12,24
134,IST,P009513,P012788,4.05,-9,2,11
134,IST,P009846,P010516,7.017,1,15,14
134,IST,P009846,P011078,14.151,-7,28,35
134,IST,P009846,P011981,13.05,-13,22,35
134,IST,P009846,P012786,23.068,-7,46,53
134,IST,P009846,P012788,17.95,5,44,39
134,IST,P010516,P011078,9.566,-2,18,20
134,IST,P010516,P011981,2.066,-1,5,6
134,IST,P010516,P012786,10.383,-3,15,18
134,IST,P010516,P012788,9.682,1,18,17
134,IST,P011078,P011981,15.583,-4,27,31
134,IST,P011078,P012786,23.734,-1,42,43
134,IST,P011078,P012788,18.783,-2,37,39
134,IST,P011981,P012786,19.7,-2,36,38
134,IST,P011981,P012788,14.249,1,31,30
134,IST,P012786,P012788,22.516,7,46,39
134,MUN,P001288,P001557,5.383,1,15,14
134,MUN,P001288,P003583,7.067,15,23,8
134,MUN,P001288,P004508,9.367,2,23,21
134,MUN,P001288,P005460,2.534,-4,1,5
134,MUN,P001288,P006760,6.501,11,17,6
134,MUN,P001288,P007056,3.3,-4,8,12
134,MUN,P001288,P007975,12.634,12,35,23
134,MUN,P001288,P008985,0.733,1,3,2
134,MUN,P001288,P010391,1.25,-2,3,5
134,MUN,P001288,P011987,3.767,8,12,4
134,MUN,P001557,P003583,2.15,0,6,6
134,MUN,P001557,P004508,5.35,-1,15,16
134,MUN,P001557,P005460,1.617,-4,1,5
134,MUN,P001557,P006543,0.667,-4,0,4
134,MUN,P001557,P007056,2.283,1,8,7
134,MUN,P001557,P007975,6.05,-3,15,18
134,MUN,P001557,P011987,0.7,-2,0,2
134,MUN,P003583,P004508,8.767,4,19,15
134,MUN,P003583,P006543,4.034,3,10,7
134,MUN,P003583,P006760,21.751,15,45,30
134,MUN,P003583,P007056,16.167,4,28,24
134,MUN,P003583,P007975,9.801,9,28,19
134,MUN,P003583,P008985,17.467,13,33,20
134,MUN,P003583,P010391,6.434,12,17,5
134,MUN,P003583,P011987,15.434,13,35,22
134,MUN,P004508,P005460,2.05,-7,1,8
134,MUN,P004508,P006543,3.117,-2,5,7
134,MUN,P004508,P006760,4.167,2,8,6
134,MUN,P004508,P007056,3.933,-7,8,15
134,MUN,P004508,P007975,12.534,-5,28,33
134,MUN,P004508,P008985,1.083,0,0,0
134,MUN,P004508,P010391,4.1,-6,5,11
134,MUN,P005460,P006760,0.917,0,0,0
134,MUN,P005460,P007056,4.717,1,10,9
134,MUN,P005460,P007975,5.184,-7,7,14
134,MUN,P005460,P008985,2.067,4,4,0
134,MUN,P005460,P010391,4.717,1,10,9
134,MUN,P005460,P011987,5.201,4,10,6
134,MUN,P006543,P006760,0.483,0,0,0
134,MUN,P006543,P007056,1.95,-3,3,6
134,MUN,P006543,P007975,2.517,-2,5,7
134,MUN,P006543,P008985,3.467,2,8,6
134,MUN,P006543,P010391,5.317,4,13,9
134,MUN,P006543,P011987,2.384,2,8,6
134,MUN,P006760,P007056,16.65,4,28,24
134,MUN,P006760,P007975,7.684,7,17,10
134,MUN,P006760,P008985,15.467,8,28,20
134,MUN,P006760,P010391,3.55,5,7,2
134,MUN,P006760,P011987,15.434,8,30,22
134,MUN,P007056,P007975,6.633,-9,14,23
134,MUN,P007056,P008985,19.501,7,35,28
134,MUN,P007056,P010391,10.751,-2,20,22
134,MUN,P007056,P011987,18.651,0,34,34
134,MUN,P007975,P008985,0.233,3,3,0
134,MUN,P007975,P010391,5.25,-1,14,15
134,MUN,P007975,P011987,5.484,8,18,10
134,MUN,P008985,P010391,9.334,12,22,10
134,MUN,P008985,P011987,17.584,10,36,26
134,MUN,P010391,P011987,6.701,9,21,12
135,ULK,P001932,P002968,2.083,-3,5,8
135,ULK,P001932,P004004,3.25,-1,7,8
135,ULK,P001932,P005844,3.566,-2,7,9
135,ULK,P001932,P006661,15.95,0,31,31
135,ULK,P001932,P006961,0.733,-1,1,2
135,ULK,P001932,P008962,20.366,-5,38,43
135,ULK,P001932,P009849,3.683,-4,6,10
135,ULK,P001932,P010560,17.383,-4,31,35
135,ULK,P001932,P011157,14.45,0,26,26
135,ULK,P002968,P004004,8.166,-5,15,20
135,ULK,P002968,P006661,1.433,1,5,4
135,ULK,P002968,P006961,1.7,3,3,0
135,ULK,P002968,P008962,2.683,-3,8,11
135,ULK,P002968,P009849,6.733,-6,10,16
135,ULK,P002968,P010560,1.7,3,3,0
135,ULK,P002968,P011052,4.383,-5,7,12
135,ULK,P002968,P011980,3.783,-5,4,9
135,ULK,P004004,P005844,0.8,-2,0,2
135,ULK,P004004,P006661,13.1,17,36,19
135,ULK,P004004,P006961,2.883,-2,4,6
135,ULK,P004004,P008962,14.867,11,38,27
135,ULK,P004004,P009849,21.016,5,44,39
135,ULK,P004004,P010560,6.1,-6,7,13
135,ULK,P004004,P011052,5.183,-7,7,14
135,ULK,P004004,P011157,11.716,19,34,15
135,ULK,P004004,P011980,3.783,-5,4,9
135,ULK,P005844,P006661,0.7,1,2,1
135,ULK,P005844,P006961,0.733,-1,1,2
135,ULK,P005844,P008962,4.366,-4,7,11
135,ULK,P005844,P009849,2.933,-4,4,8
135,ULK,P005844,P010560,3.566,-2,7,9
135,ULK,P005844,P011052,0.8,-2,0,2
135,ULK,P006661,P008962,26.334,14,59,45
135,ULK,P006661,P009849,11.567,16,31,15
135,ULK,P006661,P010560,17.634,-5,29,34
135,ULK,P006661,P011157,23.35,20,55,35
135,ULK,P006961,P008962,0.733,-1,1,2
135,ULK,P006961,P009849,2.883,-2,4,6
135,ULK,P006961,P010560,3.616,-3,5,8
135,ULK,P006961,P011157,1.183,-5,1,6
135,ULK,P008962,P009849,15.467,8,37,29
135,ULK,P008962,P010560,19.317,-10,31,41
135,ULK,P008962,P011052,1.4,-2,3,5
135,ULK,P008962,P011157,23.067,20,54,34
135,ULK,P009849,P010560,8.133,-8,11,19
135,ULK,P009849,P011052,5.183,-7,7,14
135,ULK,P009849,P011157,11.883,19,34,15
135,ULK,P009849,P011980,3.783,-5,4,9
135,ULK,P010560,P011157,16.083,-5,28,33
135,ULK,P011052,P011980,3.783,-5,4,9
135,ZAL,P002329,P003211,8.967,6,18,12
135,ZAL,P002329,P005504,18.133,-17,28,45
135,ZAL,P002329,P006860,4.333,-2,8,10
135,ZAL,P002329,P007109,26.933,-3,50,53
135,ZAL,P002329,P007513,3.6,6,10,4
135,ZAL,P002329,P009917,11.716,-14,19,33
135,ZAL,P002329,P010390,6.166,5,12,7
135,ZAL,P002329,P011218,27.666,-9,50,59
135,ZAL,P002329,P012787,7.55,0,13,13
135,ZAL,P003211,P005504,8.833,0,14,14
135,ZAL,P003211,P006860,4.617,5,12,7
135,ZAL,P003211,P007109,15.583,6,32,26
135,ZAL,P003211,P007513,6.334,3,14,11
135,ZAL,P003211,P009917,5.416,1,10,9
135,ZAL,P003211,P010390,9.4,8,24,16
135,ZAL,P003211,P011218,14.283,8,30,22
135,ZAL,P003211,P012787,7.367,7,22,15
135,ZAL,P005504,P006860,1.033,-6,0,6
135,ZAL,P005504,P007109,19.633,-12,32,44
135,ZAL,P005504,P009917,13.566,-13,22,35
135,ZAL,P005504,P011218,20.666,-18,32,50
135,ZAL,P005504,P012787,0.8,-6,0,6
135,ZAL,P006860,P007109,2.5,2,6,4
135,ZAL,P006860,P007513,6.884,9,20,11
135,ZAL,P006860,P010390,5.184,7,14,7
135,ZAL,P006860,P011218,4.75,-2,8,10
135,ZAL,P006860,P012787,5.567,-1,12,13
135,ZAL,P007109,P007513,4.75,2,10,8
135,ZAL,P007109,P009917,17.132,-13,29,42
135,ZAL,P007109,P010390,9.682,4,20,16
135,ZAL,P007109,P011218,30.732,-3,60,63
135,ZAL,P007109,P012787,8.183,5,17,12
135,ZAL,P007513,P009917,1.95,-2,2,4
135,ZAL,P007513,P010390,8.234,7,18,11
135,ZAL,P007513,P011218,2.917,4,8,4
135,ZAL,P007513,P012787,5.067,7,14,7
135,ZAL,P009917,P010390,3.566,0,7,7
135,ZAL,P009917,P011218,15.182,-11,27,38
135,ZAL,P010390,P011218,7.849,6,18,12
135,ZAL,P010390,P012787,9.383,7,23,16
135,ZAL,P011218,P012787,7.883,-3,15,18
136,RED,P000848,P002553,5.033,-2,11,13
136,RED,P000848,P005099,6.317,-4,14,18
136,RED,P000848,P006436,7.55,-4,15,19
136,RED,P000848,P007960,6.017,7,18,11
136,RED,P000848,P008966,2.917,1,8,7
136,RED,P000848,P009035,9.9,1,26,25
136,RED,P000848,P012711,5.267,6,19,13
136,RED,P000848,PJDR,8.267,3,25,22
136,RED,P002553,P005099,6.183,-4,12,16
136,RED,P002553,P006436,15.333,2,38,36
136,RED,P002553,P008966,4.233,0,10,10
136,RED,P002553,P009035,11.4,1,28,27
136,RED,P002553,P012044,2.467,-4,2,6
136,RED,P002553,PJDR,9.533,7,30,23
136,RED,P002553,PLUO,8.35,4,21,17
136,RED,P005099,P006436,16.134,-3,38,41
136,RED,P005099,P007960,8.818,-1,23,24
136,RED,P005099,P008966,6.951,0,20,20
136,RED,P005099,P009035,14.434,-6,33,39
136,RED,P005099,P012044,2.784,-11,2,13
136,RED,P005099,P012711,6.501,-1,19,20
136,RED,P005099,PJDR,14.851,7,44,37
136,RED,P005099,PLUO,2.567,-1,7,8
136,RED,P006436,P007960,9.851,-5,19,24
136,RED,P006436,P008966,9.317,-1,20,21
136,RED,P006436,P009035,22.85,2,52,50
136,RED,P006436,P012044,7.501,-12,8,20
136,RED,P006436,P012711,5.766,7,13,6
136,RED,P006436,PJDR,22.25,12,60,48
136,RED,P006436,PLUO,12.116,6,25,19
136,RED,P007960,P008966,9.118,1,23,22
136,RED,P007960,P009035,6.5,3,17,14
136,RED,P007960,P012044,2.734,-7,2,9
136,RED,P007960,P012711,3.917,5,14,9
136,RED,P007960,PJDR,11.55,14,35,21
136,RED,P007960,PLUO,3.967,-1,9,10
136,RED,P008966,P012044,2.084,-4,2,6
136,RED,P008966,P012711,1.884,-1,6,7
136,RED,P008966,PJDR,9.933,8,28,20
136,RED,P008966,PLUO,6.967,0,15,15
136,RED,P009035,P012044,5.417,-8,6,14
136,RED,P009035,P012711,9.566,10,26,16
136,RED,P009035,PJDR,18.817,12,55,43
136,RED,P009035,PLUO,7.716,5,17,12
136,RED,P012044,P012711,1.083,2,2,0
136,RED,P012044,PJDR,1.217,-3,2,5
136,RED,P012044,PLUO,4.717,-1,6,7
136,RED,P012711,PJDR,9.033,10,27,17
136,RED,P012711,PLUO,2.783,-2,2,4
136,RED,PJDR,PLUO,9.549,10,26,16
136,TEL,P004233,P009622,6.483,6,17,11
136,TEL,P004233,P009783,6.483,6,17,11
136,TEL,P004233,P011193,6.483,6,17,11
136,TEL,P004233,P011199,5.45,1,12,11
136,TEL,P004233,P011971,1.033,5,5,0
136,TEL,P005145,P009622,9.033,5,19,14
136,TEL,P005145,P009783,6.2,4,10,6
136,TEL,P005145,P009863,9.033,5,19,14
136,TEL,P005145,P011199,9.033,5,19,14
136,TEL,P005145,P012744,2.833,1,9,8
136,TEL,P009622,P009783,20.516,-2,43,45
136,TEL,P009622,P009863,18.5,0,43,43
136,TEL,P009622,P011193,14.833,4,41,37
136,TEL,P009622,P011199,21.183,2,50,48
136,TEL,P009622,P011214,6.067,-4,16,20
136,TEL,P009622,P011219,7.117,-2,19,21
136,TEL,P009622,P011971,7.883,-2,22,24
136,TEL,P009622,P012744,9.317,1,26,25
136,TEL,P009783,P009863,14.55,-1,29,30
136,TEL,P009783,P011193,15.216,1,36,35
136,TEL,P009783,P011199,16.05,-4,30,34
136,TEL,P009783,P011214,8.733,-5,19,24
136,TEL,P009783,P011219,6.45,-1,16,17
136,TEL,P009783,P011971,6.266,-2,15,17
136,TEL,P009783,P012744,1.0,-4,1,5
136,TEL,P009863,P011193,12.417,-4,28,32
136,TEL,P009863,P011199,18.983,-7,40,47
136,TEL,P009863,P011214,6.417,1,15,14
136,TEL,P009863,P011219,8.384,-3,19,22
136,TEL,P009863,P011971,12.567,-15,23,38
136,TEL,P009863,P012744,10.417,0,28,28
136,TEL,P011193,P011199,12.367,-5,28,33
136,TEL,P011193,P011214,12.117,-5,29,34
136,TEL,P011193,P011219,10.667,-5,26,31
136,TEL,P011193,P011971,7.716,-3,17,20
136,TEL,P011193,P012744,6.584,-5,14,19
136,TEL,P011199,P011214,0.917,-1,3,4
136,TEL,P011199,P011219,2.117,-3,5,8
136,TEL,P011199,P011971,7.667,-14,13,27
136,TEL,P011199,P012744,7.633,-2,20,22
136,TEL,P011214,P011219,9.017,-1,24,25
136,TEL,P011214,P011971,2.966,-1,7,8
136,TEL,P011214,P012744,2.234,-4,3,7
136,TEL,P011219,P011971,5.75,-5,13,18
136,TEL,P011219,P012744,2.834,0,6,6
136,TEL,P011971,P012744,4.484,-3,9,12
137,MAD,P001392,P003108,3.934,-4,9,13
137,MAD,P001392,P004887,4.917,7,16,9
137,MAD,P001392,P005791,15.417,16,43,27
137,MAD,P001392,P005928,16.367,19,49,30
137,MAD,P001392,P006540,17.75,22,52,30
137,MAD,P001392,P009213,21.734,17,58,41
137,MAD,P001392,PBMT,5.251,-4,11,15
137,MAD,P001392,PCVM,6.634,-1,14,15
137,MAD,P003108,P004887,10.767,3,25,22
137,MAD,P003108,P005791,3.5,2,6,4
137,MAD,P003108,P005928,3.5,2,6,4
137,MAD,P003108,P006540,1.617,7,7,0
137,MAD,P003108,P009213,2.667,-5,4,9
137,MAD,P003108,P010623,0.467,0,0,0
137,MAD,P003108,PBMT,15.717,-7,28,35
137,MAD,P003108,PCVM,17.267,0,35,35
137,MAD,P003108,PTGB,9.9,2,20,18
137,MAD,P004887,P005928,0.95,3,6,3
137,MAD,P004887,P006540,3.55,13,16,3
137,MAD,P004887,P009213,7.25,0,13,13
137,MAD,P004887,P010623,0.067,0,0,0
137,MAD,P004887,PBMT,14.467,-10,22,32
137,MAD,P004887,PCVM,17.0,0,32,32
137,MAD,P004887,PTGB,13.1,-4,22,26
137,MAD,P005791,P005928,18.917,18,49,31
137,MAD,P005791,P006540,15.417,16,43,27
137,MAD,P005791,P009213,15.417,16,43,27
137,MAD,P005791,PBMT,3.5,2,6,4
137,MAD,P005791,PCVM,3.5,2,6,4
137,MAD,P005928,P006540,16.367,19,49,30
137,MAD,P005928,P009213,16.367,19,49,30
137,MAD,P005928,PBMT,3.5,2,6,4
137,MAD,P005928,PCVM,3.5,2,6,4
137,MAD,P006540,P009213,17.75,22,52,30
137,MAD,P006540,P010623,0.467,0,0,0
137,MAD,P006540,PCVM,2.933,10,10,0
137,MAD,P006540,PTGB,1.617,7,7,0
137,MAD,P009213,PBMT,7.584,-11,8,19
137,MAD,P009213,PCVM,8.967,-8,11,19
137,MAD,P009213,PTGB,3.6,-6,2,8
137,MAD,P010623,PCVM,0.4,0,0,0
137,MAD,P010623,PTGB,0.467,0,0,0
137,MAD,PBMT,PCVM,20.634,-13,32,45
137,MAD,PBMT,PTGB,11.883,-11,15,26
137,MAD,PCVM,PTGB,13.433,-4,22,26
137,PAR,P000956,P004058,2.666,5,9,4
137,PAR,P000956,P004172,2.666,5,9,4
137,PAR,P000956,P008987,7.283,-5,14,19
137,PAR,P000956,P009212,0.233,2,2,0
137,PAR,P000956,P009862,7.283,-5,14,19
137,PAR,P000956,P011050,2.666,5,9,4
137,PAR,P000956,P011051,2.433,3,7,4
137,PAR,P000956,P012096,7.283,-5,14,19
137,PAR,P000956,P012742,7.283,-5,14,19
137,PAR,P004058,P004172,11.983,11,26,15
137,PAR,P004058,P007400,8.267,6,17,11
137,PAR,P004058,P008987,8.1,-7,9,16
137,PAR,P004058,P009212,5.2,6,15,9
137,PAR,P004058,P009862,6.417,-9,5,14
137,PAR,P004058,P011050,7.633,9,22,13
137,PAR,P004058,P011051,11.216,-4,16,20
137,PAR,P004058,P012096,1.15,0,0,0
137,PAR,P004058,P012742,4.9,-9,5,14
137,PAR,P004172,P007400,22.15,-4,45,49
137,PAR,P004172,P008987,6.267,-2,11,13
137,PAR,P004172,P009212,12.183,8,30,22
137,PAR,P004172,P009862,9.817,-8,17,25
137,PAR,P004172,P011050,7.633,9,22,13
137,PAR,P004172,P011051,17.932,1,34,33
137,PAR,P004172,P012096,14.483,-2,30,32
137,PAR,P004172,P012743,1.15,-6,0,6
137,PAR,P007400,P008987,7.517,-7,11,18
137,PAR,P007400,P009212,11.25,4,26,22
137,PAR,P007400,P009862,9.317,-15,15,30
137,PAR,P007400,P011050,4.967,4,13,9
137,PAR,P007400,P011051,13.749,-4,25,29
137,PAR,P007400,P012096,13.983,-9,28,37
137,PAR,P007400,P012742,1.25,-5,0,5
137,PAR,P007400,P012743,1.15,-6,0,6
137,PAR,P008987,P009862,16.767,-23,26,49
137,PAR,P008987,P011051,7.633,-7,9,16
137,PAR,P008987,P012096,10.35,-8,21,29
137,PAR,P008987,P012742,13.333,-19,19,38
137,PAR,P008987,P012743,1.15,-6,0,6
137,PAR,P009212,P009862,0.7,2,2,0
137,PAR,P009212,P011050,5.2,6,15,9
137,PAR,P009212,P011051,6.983,2,15,13
137,PAR,P009212,P012096,6.983,2,15,13
137,PAR,P009862,P011051,11.283,-13,15,28
137,PAR,P009862,P012096,16.833,-12,31,43
137,PAR,P009862,P012742,13.433,-19,19,38
137,PAR,P009862,P012743,1.15,-6,0,6
137,PAR,P011050,P011051,2.433,3,7,4
137,PAR,P011051,P012096,12.766,-4,23,27
137,PAR,P011051,P012742,4.9,-9,5,14
137,PAR,P012096,P012742,8.633,-10,14,24
138,PAM,P003960,P004863,9.2,11,23,12
138,PAM,P003960,P005356,4.483,12,17,5
138,PAM,P003960,P006643,10.433,7,22,15
138,PAM,P003960,P007870,14.866,16,38,22
138,PAM,P003960,P008780,2.45,0,4,4
138,PAM,P003960,P010568,16.132,19,39,20
138,PAM,P003960,P012739,3.333,3,5,2
138,PAM,P003960,P012740,11.899,8,24,16
138,PAM,P004863,P005356,14.267,8,33,25
138,PAM,P004863,P006643,3.867,4,7,3
138,PAM,P004863,P007870,8.267,13,23,10
138,PAM,P004863,P008780,7.367,-7,12,19
138,PAM,P004863,P010393,9.95,3,18,15
138,PAM,P004863,P010568,8.017,12,20,8
138,PAM,P004863,P012738,1.817,-2,3,5
138,PAM,P004863,P012739,12.767,-1,21,22
138,PAM,P004863,P012740,8.617,7,16,9
138,PAM,P005356,P007870,5.35,8,20,12
138,PAM,P005356,P008780,7.1,-10,10,20
138,PAM,P005356,P010393,14.866,0,26,26
138,PAM,P005356,P010568,11.6,11,30,19
138,PAM,P005356,P012738,3.134,-1,7,8
138,PAM,P005356,P012739,17.2,3,30,27
138,PAM,P005356,P012740,12.2,13,27,14
138,PAM,P006643,P007870,12.883,-1,25,26
138,PAM,P006643,P010393,0.85,-2,3,5
138,PAM,P006643,P010568,14.166,-3,25,28
138,PAM,P006643,P012738,2.883,-8,0,8
138,PAM,P006643,P012739,1.283,-2,0,2
138,PAM,P006643,P012740,10.299,-7,18,25
138,PAM,P007870,P008780,2.45,0,4,4
138,PAM,P007870,P010393,2.383,-2,7,9
138,PAM,P007870,P010568,19.449,7,45,38
138,PAM,P007870,P012738,4.2,-7,4,11
138,PAM,P007870,P012740,16.216,-6,30,36
138,PAM,P008780,P010393,6.1,-7,8,15
138,PAM,P008780,P010568,2.183,-3,2,5
138,PAM,P008780,P012738,1.0,-3,2,5
138,PAM,P008780,P012739,7.1,-10,10,20
138,PAM,P008780,P012740,2.45,0,4,4
138,PAM,P010393,P010568,5.766,-5,11,16
138,PAM,P010393,P012739,13.333,0,22,22
138,PAM,P010393,P012740,9.616,5,21,16
138,PAM,P010568,P012738,5.017,-6,5,11
138,PAM,P010568,P012739,7.533,1,10,9
138,PAM,P010568,P012740,18.065,-1,33,34
138,PAM,P012738,P012739,1.817,-2,3,5
138,PAM,P012738,P012740,4.2,-7,4,11
138,PAM,P012739,P012740,9.566,12,19,7
138,VIR,P001133,P001844,24.167,4,44,40
138,VIR,P001133,P003048,18.433,-4,28,32
138,VIR,P001133,P004007,6.384,4,14,10
138,VIR,P001133,P006739,6.833,-2,14,16
138,VIR,P001133,P009549,24.583,-2,44,46
138,VIR,P001133,P010781,12.216,9,25,16
138,VIR,P001133,P012714,13.25,10,32,22
138,VIR,P001133,PBCN,21.866,-3,39,42
138,VIR,P001844,P002084,6.384,-10,7,17
138,VIR,P001844,P003048,15.234,-6,24,30
138,VIR,P001844,P004007,10.218,-5,14,19
138,VIR,P001844,P009549,18.067,0,33,33
138,VIR,P001844,P010781,16.417,-5,25,30
138,VIR,P001844,P012714,15.067,2,27,25
138,VIR,P001844,PBCN,16.65,-4,30,34
138,VIR,P002084,P003048,2.867,-9,2,11
138,VIR,P002084,P004007,7.4,-7,11,18
138,VIR,P002084,P006739,1.533,0,4,4
138,VIR,P002084,P009549,0.15,-2,0,2
138,VIR,P002084,P010781,8.067,-12,11,23
138,VIR,P002084,P012714,5.2,-3,9,12
138,VIR,P002084,PBCN,0.667,-5,0,5
138,VIR,P003048,P004007,3.85,-2,6,8
138,VIR,P003048,P006739,4.983,-7,4,11
138,VIR,P003048,P009549,18.183,-6,28,34
138,VIR,P003048,P010781,4.2,-7,4,11
138,VIR,P003048,PBCN,17.45,-11,24,35
138,VIR,P004007,P006739,3.566,2,11,9
138,VIR,P004007,P009549,2.717,0,6,6
138,VIR,P004007,P010781,11.134,-5,19,24
138,VIR,P004007,P012714,9.867,1,19,18
138,VIR,P006739,P009549,5.583,-4,9,13
138,VIR,P006739,P010781,2.783,2,9,7
138,VIR,P006739,P012714,3.383,5,14,9
138,VIR,P006739,PBCN,4.8,-4,7,11
138,VIR,P009549,P010781,5.016,1,9,8
138,VIR,P009549,P012714,6.3,4,16,12
138,VIR,P009549,PBCN,18.333,-7,31,38
138,VIR,P010781,P012714,15.833,6,32,26
138,VIR,P010781,PBCN,5.466,-1,10,11
138,VIR,P012714,PBCN,4.9,3,15,12
139,BER,P003958,P006251,2.817,-2,7,9
139,BER,P003958,P008173,20.917,-11,36,47
139,BER,P003958,P008211,6.25,-3,16,19
139,BER,P003958,P008384,5.717,-1,13,14
139,BER,P003958,P008967,8.683,-8,15,23
139,BER,P003958,P010791,9.917,-9,13,22
139,BER,P003958,P011934,14.433,-3,32,35
139,BER,P003958,P012720,27.167,-14,52,66
139,BER,P003958,P012721,12.767,-5,24,29
139,BER,P006251,P008211,15.65,3,37,34
139,BER,P006251,P008384,15.65,3,37,34
139,BER,P006251,P008967,12.833,5,30,25
139,BER,P006251,P010791,2.283,2,9,7
139,BER,P006251,P011934,10.55,3,21,18
139,BER,P006251,P012720,2.817,-2,7,9
139,BER,P008173,P008384,2.9,1,6,5
139,BER,P008173,P008967,6.95,-7,12,19
139,BER,P008173,P010791,9.917,-9,13,22
139,BER,P008173,P011934,11.0,-2,23,25
139,BER,P008173,P012720,20.917,-11,36,47
139,BER,P008173,P012721,11.067,-5,18,23
139,BER,P008211,P008384,15.65,3,37,34
139,BER,P008211,P008967,14.566,4,33,29
139,BER,P008211,P010791,2.283,2,9,7
139,BER,P008211,P011934,13.983,2,30,28
139,BER,P008211,P012720,6.25,-3,16,19
139,BER,P008211,P012721,1.7,0,6,6
139,BER,P008384,P008967,12.833,5,30,25
139,BER,P008384,P010791,2.9,1,11,10
139,BER,P008384,P011934,12.833,5,25,20
139,BER,P008384,P012720,5.717,-1,13,14
139,BER,P008967,P010791,4.866,-4,11,15
139,BER,P008967,P011934,16.65,1,34,33
139,BER,P008967,P012720,8.683,-8,15,23
139,BER,P010791,P012720,9.917,-9,13,22
139,BER,P010791,P012721,6.717,-2,9,11
139,BER,P011934,P012720,14.433,-3,32,35
139,BER,P011934,P012721,6.05,-3,15,18
139,BER,P012720,P012721,12.767,-5,24,29
139,ULK,P001932,P002968,2.233,0,2,2
139,ULK,P001932,P004004,4.55,6,13,7
139,ULK,P001932,P005844,9.283,9,22,13
139,ULK,P001932,P006661,22.833,13,49,36
139,ULK,P001932,P006961,0.6,-2,0,2
139,ULK,P001932,P008962,25.233,15,54,39
139,ULK,P001932,P009849,7.55,6,18,12
139,ULK,P001932,P010560,25.833,13,54,41
139,ULK,P001932,P011157,18.867,10,43,33
139,ULK,P001932,P011980,4.55,6,13,7
139,ULK,P002968,P006661,5.75,-1,13,14
139,ULK,P002968,P008962,5.75,-1,13,14
139,ULK,P002968,P010560,5.75,-1,13,14
139,ULK,P002968,P011052,3.517,-1,11,12
139,ULK,P004004,P005844,6.517,5,20,15
139,ULK,P004004,P008962,1.5,-5,0,5
139,ULK,P004004,P009849,8.017,0,20,20
139,ULK,P004004,P011052,3.467,-6,7,13
139,ULK,P004004,P011157,1.5,-5,0,5
139,ULK,P004004,P011980,6.517,5,20,15
139,ULK,P005844,P006661,4.733,3,9,6
139,ULK,P005844,P006961,0.6,-2,0,2
139,ULK,P005844,P008962,6.266,4,15,11
139,ULK,P005844,P009849,8.65,4,26,22
139,ULK,P005844,P010560,6.866,2,15,13
139,ULK,P005844,P011052,4.1,-2,13,15
139,ULK,P005844,P011980,6.517,5,20,15
139,ULK,P006661,P006961,0.6,-2,0,2
139,ULK,P006661,P008962,25.75,14,60,46
139,ULK,P006661,P010560,26.35,12,60,48
139,ULK,P006661,P011052,3.517,-1,11,12
139,ULK,P006661,P011157,15.867,10,38,28
139,ULK,P006961,P010560,0.6,-2,0,2
139,ULK,P008962,P009849,7.133,-8,11,19
139,ULK,P008962,P010560,31.383,11,71,60
139,ULK,P008962,P011052,7.65,-9,17,26
139,ULK,P008962,P011157,20.867,3,43,40
139,ULK,P009849,P010560,5.633,-3,11,14
139,ULK,P009849,P011052,6.1,-9,13,22
139,ULK,P009849,P011157,5.0,-7,5,12
139,ULK,P009849,P011980,6.517,5,20,15
139,ULK,P010560,P011052,6.15,-4,17,21
139,ULK,P010560,P011157,19.367,8,43,35
139,ULK,P011052,P011157,2.0,-7,0,7
139,ULK,P011052,P011980,1.967,-1,7,8
140,BAS,P004603,P004761,14.45,6,26,20
140,BAS,P004603,P007230,12.834,10,26,16
140,BAS,P004603,P008850,7.0,-1,9,10
140,BAS,P004603,P009048,16.484,15,36,21
140,BAS,P004603,P011085,5.5,10,17,7
140,BAS,P004603,P011948,11.5,11,30,19
140,BAS,P004603,P012201,7.333,4,17,13
140,BAS,P004603,P012765,5.567,1,11,10
140,BAS,P004761,P007230,27.151,16,61,45
140,BAS,P004761,P008072,3.217,3,7,4
140,BAS,P004761,P008850,11.034,3,17,14
140,BAS,P004761,P009048,25.801,13,56,43
140,BAS,P004761,P011085,5.233,-4,11,15
140,BAS,P004761,P011948,11.05,7,29,22
140,BAS,P004761,P012201,13.15,-5,28,33
140,BAS,P004761,P012765,4.85,1,9,8
140,BAS,P007230,P008072,3.55,1,7,6
140,BAS,P007230,P008850,11.367,1,17,16
140,BAS,P007230,P009048,29.334,5,65,60
140,BAS,P007230,P011085,8.216,-8,20,28
140,BAS,P007230,P011948,12.417,7,38,31
140,BAS,P007230,P012201,14.633,-5,37,42
140,BAS,P007230,P012765,3.234,5,9,4
140,BAS,P008072,P008850,3.55,1,7,6
140,BAS,P008072,P009048,5.533,-4,7,11
140,BAS,P008072,P011085,1.983,-5,0,5
140,BAS,P008072,P011948,1.983,-5,0,5
140,BAS,P008072,P012201,2.316,-7,0,7
140,BAS,P008850,P009048,11.367,1,17,16
140,BAS,P008850,P012201,1.15,-1,1,2
140,BAS,P009048,P011085,15.199,-5,35,40
140,BAS,P009048,P011948,18.05,7,48,41
140,BAS,P009048,P012201,21.616,-2,52,54
140,BAS,P009048,P012765,1.884,2,4,2
140,BAS,P011085,P011948,10.466,1,26,25
140,BAS,P011085,P012201,15.699,-3,37,40
140,BAS,P011085,P012765,0.5,2,2,0
140,BAS,P011948,P012201,17.566,-1,42,43
140,BAS,P011948,P012765,3.9,-3,7,10
140,BAS,P012201,P012765,2.333,-4,2,6
140,IST,P004554,P006590,3.2,-3,5,8
140,IST,P004554,P007200,2.766,5,7,2
140,IST,P004554,P009513,1.517,-6,0,6
140,IST,P004554,P009846,1.083,2,2,0
140,IST,P004554,P010516,1.683,3,5,2
140,IST,P004554,P011078,2.6,-4,2,6
140,IST,P004554,P012786,4.283,-1,7,8
140,IST,P006590,P007200,20.001,-3,46,49
140,IST,P006590,P009513,1.517,-6,0,6
140,IST,P006590,P009846,7.618,-11,10,21
140,IST,P006590,P010516,6.783,7,18,11
140,IST,P006590,P011078,11.201,-4,28,32
140,IST,P006590,P011981,6.968,-4,16,20
140,IST,P006590,P012710,8.901,-4,24,28
140,IST,P006590,P012786,8.6,-7,12,19
140,IST,P006590,P012788,11.283,-1,25,26
140,IST,P007200,P009846,21.584,-12,34,46
140,IST,P007200,P010516,7.066,2,18,16
140,IST,P007200,P011078,23.65,1,52,51
140,IST,P007200,P011981,9.351,0,24,24
140,IST,P007200,P012710,19.401,-11,38,49
140,IST,P007200,P012786,8.166,1,14,13
140,IST,P007200,P012788,23.883,1,47,46
140,IST,P009513,P009846,4.517,3,10,7
140,IST,P009513,P010516,0.834,2,2,0
140,IST,P009513,P011078,5.667,-5,8,13
140,IST,P009513,P011981,3.734,5,10,5
140,IST,P009513,P012710,0.783,-2,0,2
140,IST,P009513,P012786,2.917,-7,4,11
140,IST,P009513,P012788,2.65,4,6,2
140,IST,P009846,P010516,1.117,-3,2,5
140,IST,P009846,P011078,22.2,1,42,41
140,IST,P009846,P011981,10.101,0,20,20
140,IST,P009846,P012710,13.267,-18,14,32
140,IST,P009846,P012786,4.1,-3,6,9
140,IST,P009846,P012788,18.817,5,36,31
140,IST,P010516,P011078,0.75,-5,0,5
140,IST,P010516,P011981,1.901,6,8,2
140,IST,P010516,P012710,1.85,-1,6,7
140,IST,P010516,P012786,5.833,5,14,9
140,IST,P010516,P012788,3.783,0,7,7
140,IST,P011078,P011981,8.917,5,26,21
140,IST,P011078,P012710,16.95,-9,32,41
140,IST,P011078,P012786,3.633,-7,4,11
140,IST,P011078,P012788,21.7,11,46,35
140,IST,P011981,P012710,3.851,3,14,11
140,IST,P011981,P012786,3.017,-5,4,9
140,IST,P011981,P012788,4.5,10,14,4
140,IST,P012710,P012788,15.733,-10,24,34
140,IST,P012786,P012788,3.783,0,7,7
141,MIL,P002812,P002849,0.067,0,0,0
141,MIL,P002812,P005670,3.434,-6,3,9
141,MIL,P002812,P005775,5.217,-1,10,11
141,MIL,P002812,P006509,7.467,4,17,13
141,MIL,P002812,P006701,2.317,5,7,2
141,MIL,P002812,P007201,4.367,-4,7,11
141,MIL,P002812,P007831,8.651,-7,13,20
141,MIL,P002812,P009960,6.467,2,13,11
141,MIL,P002812,P011205,5.617,-1,10,11
141,MIL,P002849,P005670,12.267,-3,17,20
141,MIL,P002849,P005775,5.65,-2,11,13
141,MIL,P002849,P006509,8.967,-2,13,15
141,MIL,P002849,P006701,7.034,5,15,10
141,MIL,P002849,P007201,22.051,3,41,38
141,MIL,P002849,P007831,22.184,1,40,39
141,MIL,P002849,P009960,3.966,-2,4,6
141,MIL,P002849,P011205,24.85,-5,39,44
141,MIL,P002849,P011926,0.9,-3,0,3
141,MIL,P005670,P006509,0.9,-3,0,3
141,MIL,P005670,P006701,0.067,0,0,0
141,MIL,P005670,P007201,12.334,-7,16,23
141,MIL,P005670,P007831,14.734,-6,20,26
141,MIL,P005670,P009960,2.333,1,4,3
141,MIL,P005670,P011205,15.567,-9,20,29
141,MIL,P005670,P011926,0.9,-3,0,3
141,MIL,P005775,P006509,7.4,-5,13,18
141,MIL,P005775,P006721,2.183,-4,3,7
141,MIL,P005775,P007201,6.65,0,15,15
141,MIL,P005775,P007831,11.45,-2,24,26
141,MIL,P005775,P009960,6.4,-7,9,16
141,MIL,P005775,P011205,7.25,-7,11,18
141,MIL,P006509,P006701,8.217,8,18,10
141,MIL,P006509,P006721,2.183,-4,3,7
141,MIL,P006509,P007201,7.434,6,17,11
141,MIL,P006509,P007831,9.967,1,21,20
141,MIL,P006509,P009960,10.283,-5,16,21
141,MIL,P006509,P011205,10.75,-5,14,19
141,MIL,P006509,P011926,0.9,-3,0,3
141,MIL,P006701,P007201,5.334,8,15,7
141,MIL,P006701,P007831,3.134,5,10,5
141,MIL,P006701,P009960,3.883,2,7,5
141,MIL,P006701,P011205,7.15,7,16,9
141,MIL,P006721,P007831,0.583,1,3,2
141,MIL,P006721,P009960,2.183,-4,3,7
141,MIL,P006721,P011205,1.6,-5,0,5
141,MIL,P007201,P007831,24.151,-4,43,47
141,MIL,P007201,P011205,23.351,-6,38,44
141,MIL,P007831,P009960,7.133,-1,13,14
141,MIL,P007831,P011205,23.417,-8,37,45
141,MIL,P009960,P011205,7.816,-2,11,13
141,MIL,P011205,P011926,0.9,-3,0,3
141,PAN,P001926,P002328,16.166,-4,26,30
141,PAN,P001926,P003842,24.966,-9,41,50
141,PAN,P001926,P007866,20.616,-3,33,36
141,PAN,P001926,P007947,3.167,0,5,5
141,PAN,P001926,P011204,28.1,5,52,47
141,PAN,P001926,P011221,3.767,6,7,1
141,PAN,P001926,P012712,12.751,12,29,17
141,PAN,P001926,P012774,18.867,5,35,30
141,PAN,P002328,P003842,17.849,-6,27,33
141,PAN,P002328,P007866,15.566,-8,23,31
141,PAN,P002328,P007947,3.883,-2,5,7
141,PAN,P002328,P011204,17.75,0,35,35
141,PAN,P002328,P011221,4.617,2,13,11
141,PAN,P002328,P012712,4.8,4,13,9
141,PAN,P002328,P012774,9.233,-2,18,20
141,PAN,P003842,P007866,20.649,-8,29,37
141,PAN,P003842,P007947,4.067,0,7,7
141,PAN,P003842,P011204,23.466,-6,39,45
141,PAN,P003842,P012712,5.617,0,13,13
141,PAN,P003842,P012774,16.85,-3,28,31
141,PAN,P007866,P007947,2.95,3,5,2
141,PAN,P007866,P011204,20.783,-3,35,38
141,PAN,P007866,P011221,0.55,0,2,2
141,PAN,P007866,P012712,3.367,6,9,3
141,PAN,P007866,P012774,13.783,5,24,19
141,PAN,P007947,P011204,1.6,5,5,0
141,PAN,P007947,P011221,4.583,3,8,5
141,PAN,P007947,P012712,5.7,0,10,10
141,PAN,P007947,P012774,8.65,3,15,12
141,PAN,P011204,P011221,5.284,12,18,6
141,PAN,P011204,P012712,12.601,21,36,15
141,PAN,P011204,P012774,18.884,14,44,30
141,PAN,P011221,P012712,7.717,10,19,9
141,PAN,P011221,P012774,6.55,7,17,10
141,PAN,P012712,P012774,14.251,11,35,24
142,MCO,P004790,P005985,2.917,6,10,4
142,MCO,P004790,P008099,5.883,7,13,6
142,MCO,P004790,P010588,0.267,0,0,0
142,MCO,P004790,P011196,8.533,13,23,10
142,MCO,P004790,P011212,7.85,14,22,8
142,MCO,P004790,P011226,8.8,13,23,10
142,MCO,P004790,P012709,0.95,-1,1,2
142,MCO,P005985,P010588,25.884,9,60,51
142,MCO,P005985,P011196,7.483,-5,21,26
142,MCO,P005985,P011212,15.617,1,43,42
142,MCO,P005985,P011226,19.2,1,50,49
142,MCO,P005985,P011231,26.35,10,59,49
142,MCO,P005985,P012709,15.7,9,32,23
142,MCO,P005985,PLCZ,12.117,9,25,16
142,MCO,P008099,P010588,0.883,-5,0,5
142,MCO,P008099,P011196,5.883,7,13,6
142,MCO,P008099,P011212,6.766,2,13,11
142,MCO,P008099,P011226,6.766,2,13,11
142,MCO,P008099,PLCZ,0.883,-5,0,5
142,MCO,P010588,P011196,2.05,-6,6,12
142,MCO,P010588,P011212,11.75,-6,29,35
142,MCO,P010588,P011226,14.65,-5,35,40
142,MCO,P010588,P011231,23.567,15,54,39
142,MCO,P010588,P012709,15.017,10,31,21
142,MCO,P010588,PLCZ,13.0,4,25,21
142,MCO,P011196,P011212,14.6,2,36,34
142,MCO,P011196,P011226,15.283,1,37,36
142,MCO,P011196,P011231,4.7,-6,8,14
142,MCO,P011196,P012709,2.6,-2,4,6
142,MCO,P011212,P011226,24.3,2,59,57
142,MCO,P011212,P011231,13.517,-1,31,32
142,MCO,P011212,P012709,1.917,-1,3,4
142,MCO,P011212,PLCZ,0.883,-5,0,5
142,MCO,P011226,P011231,16.15,0,37,37
142,MCO,P011226,P012709,5.5,-1,10,11
142,MCO,P011226,PLCZ,0.883,-5,0,5
142,MCO,P011231,P012709,16.667,9,34,25
142,MCO,P011231,PLCZ,12.117,9,25,16
142,MCO,P012709,PLCZ,12.117,9,25,16
142,MUN,P001288,P001557,2.966,3,5,2
142,MUN,P001288,P003583,5.817,2,9,7
142,MUN,P001288,P004508,14.384,1,34,33
142,MUN,P001288,P005478,2.05,6,12,6
142,MUN,P001288,P006760,6.75,12,26,14
142,MUN,P001288,P007056,4.583,-6,5,11
142,MUN,P001288,P007639,6.733,0,16,16
142,MUN,P001288,P007975,18.383,-3,37,40
142,MUN,P001288,P010391,11.349,-10,14,24
142,MUN,P001288,P011987,4.049,3,10,7
142,MUN,P001557,P003583,4.816,6,10,4
142,MUN,P001557,P007056,2.083,3,5,2
142,MUN,P001557,P007639,0.233,0,0,0
142,MUN,P001557,P007975,2.083,-2,0,2
142,MUN,P001557,P010391,5.049,6,10,4
142,MUN,P001557,P011987,2.966,8,10,2
142,MUN,P003583,P004508,5.05,-5,6,11
142,MUN,P003583,P006760,9.834,-10,12,22
142,MUN,P003583,P007056,11.966,-12,15,27
142,MUN,P003583,P007975,5.167,-5,4,9
142,MUN,P003583,P008985,6.6,-11,6,17
142,MUN,P003583,P010391,10.999,-2,16,18
142,MUN,P003583,P011987,10.883,-3,18,21
142,MUN,P004508,P005478,1.417,5,9,4
142,MUN,P004508,P006760,6.117,11,23,12
142,MUN,P004508,P007056,5.266,-7,7,14
142,MUN,P004508,P007639,6.5,0,16,16
142,MUN,P004508,P007975,14.617,-1,34,35
142,MUN,P004508,P008985,1.733,-2,2,4
142,MUN,P004508,P010391,9.066,-14,11,25
142,MUN,P004508,P011987,1.25,0,2,2
142,MUN,P005478,P006760,4.167,5,15,10
142,MUN,P005478,P007056,6.433,-4,12,16
142,MUN,P005478,P007975,6.3,7,21,14
142,MUN,P005478,P008985,1.983,-5,2,7
142,MUN,P005478,P010391,4.516,-3,10,13
142,MUN,P005478,P011987,7.066,-3,15,18
142,MUN,P006760,P007056,12.367,-9,22,31
142,MUN,P006760,P007639,2.783,5,10,5
142,MUN,P006760,P007975,8.667,11,28,17
142,MUN,P006760,P008985,7.2,-6,15,21
142,MUN,P006760,P010391,5.583,1,16,15
142,MUN,P006760,P011987,13.0,-8,25,33
142,MUN,P007056,P007975,9.066,-7,14,21
142,MUN,P007056,P008985,10.916,-13,19,32
142,MUN,P007056,P010391,17.364,-9,35,44
142,MUN,P007056,P011987,21.216,-12,38,50
142,MUN,P007639,P007975,6.733,0,16,16
142,MUN,P007639,P010391,3.95,-5,6,11
142,MUN,P007975,P010391,13.032,-15,16,31
142,MUN,P007975,P011987,7.416,-1,14,15
142,MUN,P008985,P010391,6.049,-4,15,19
142,MUN,P008985,P011987,9.183,-11,17,28
142,MUN,P010391,P011987,14.231,3,35,32
143,ASV,P000229,P004194,5.3,1,10,9
143,ASV,P000229,P011225,7.534,2,18,16
143,ASV,P000229,P011386,0.517,-3,0,3
143,ASV,P000229,P012080,3.8,0,10,10
143,ASV,P000229,P012729,11.851,-1,28,29
143,ASV,P000229,P012730,9.918,0,24,24
143,ASV,P000229,P012731,0.983,0,2,2
143,ASV,P000229,PKIR,7.501,-3,20,23
143,ASV,P003526,P004194,14.183,-8,21,29
143,ASV,P003526,P006568,12.466,-7,19,26
143,ASV,P003526,P011225,14.183,-8,21,29
143,ASV,P003526,P012080,9.95,-8,15,23
143,ASV,P003526,P012729,4.75,1,8,7
143,ASV,P003526,PKIR,1.2,-2,0,2
143,ASV,P004194,P006568,14.799,-1,25,26
143,ASV,P004194,P011225,30.149,-4,50,54
143,ASV,P004194,P012080,22.582,-5,38,43
143,ASV,P004194,P012729,18.933,-1,33,34
143,ASV,P004194,P012730,10.433,2,16,14
143,ASV,P004194,P012731,2.95,-5,5,10
143,ASV,P004194,PKIR,5.199,5,10,5
143,ASV,P006568,P011225,14.799,-1,25,26
143,ASV,P006568,P012080,10.566,-1,19,20
143,ASV,P006568,P012729,3.033,2,6,4
143,ASV,P006568,PKIR,3.533,4,6,2
143,ASV,P011225,P012080,23.916,-11,39,50
143,ASV,P011225,P012729,23.484,-6,44,50
143,ASV,P011225,P012730,15.967,-3,29,32
143,ASV,P011225,P012731,1.967,-5,3,8
143,ASV,P011225,PKIR,10.733,0,23,23
143,ASV,P011386,P012729,0.517,-3,0,3
143,ASV,P011386,P012730,0.517,-3,0,3
143,ASV,P011386,PKIR,0.517,-3,0,3
143,ASV,P012080,P012729,16.717,-10,30,40
143,ASV,P012080,P012730,12.2,-6,21,27
143,ASV,P012080,P012731,2.95,-5,5,10
143,ASV,P012080,PKIR,8.183,2,19,17
143,ASV,P012729,P012730,18.868,-6,37,43
143,ASV,P012729,P012731,2.95,-5,5,10
143,ASV,P012729,PKIR,10.101,-7,25,32
143,ASV,P012730,PKIR,9.301,-8,21,29
143,OLY,P001255,P003941,1.033,-1,3,4
143,OLY,P001255,P007853,2.817,0,8,8
143,OLY,P001255,P007982,6.117,2,17,15
143,OLY,P001255,P008811,17.917,6,40,34
143,OLY,P001255,P008829,15.15,4,32,28
143,OLY,P001255,P008855,12.833,3,26,23
143,OLY,P001255,P010612,16.133,5,35,30
143,OLY,P001255,P011194,3.8,1,11,10
143,OLY,P003941,P008829,1.033,-1,3,4
143,OLY,P003941,P008855,1.033,-1,3,4
143,OLY,P003941,P010612,1.033,-1,3,4
143,OLY,P006589,P007853,5.0,3,12,9
143,OLY,P006589,P007982,5.0,3,12,9
143,OLY,P006589,P008829,1.85,-2,2,4
143,OLY,P006589,P010392,3.15,5,10,5
143,OLY,P006589,P011194,3.15,5,10,5
143,OLY,P006589,P011983,1.85,-2,2,4
143,OLY,P007853,P007982,16.8,3,34,31
143,OLY,P007853,P008811,13.0,2,24,22
143,OLY,P007853,P008829,6.183,0,8,8
143,OLY,P007853,P008855,1.2,2,2,0
143,OLY,P007853,P010392,4.133,5,12,7
143,OLY,P007853,P010612,8.0,0,12,12
143,OLY,P007853,P011194,11.817,5,28,23
143,OLY,P007853,P011983,3.05,0,4,4
143,OLY,P007982,P008811,20.967,4,45,41
143,OLY,P007982,P008829,11.167,3,24,21
143,OLY,P007982,P010392,10.0,7,26,19
143,OLY,P007982,P010612,17.167,4,35,31
143,OLY,P007982,P011194,14.8,4,33,29
143,OLY,P007982,P011983,1.85,-2,2,4
143,OLY,P008811,P008829,22.317,11,47,36
143,OLY,P008811,P008855,13.0,6,25,19
143,OLY,P008811,P010392,6.85,2,16,14
143,OLY,P008811,P010612,28.967,8,58,50
143,OLY,P008811,P011194,11.65,-1,23,24
143,OLY,P008811,P011983,1.2,2,2,0
143,OLY,P008829,P008855,14.033,5,28,23
143,OLY,P008829,P010392,3.867,4,12,8
143,OLY,P008829,P010612,22.15,8,48,40
143,OLY,P008829,P011983,3.05,0,4,4
143,OLY,P008855,P010612,12.833,3,26,23
143,OLY,P008855,P011983,1.2,2,2,0
143,OLY,P010392,P010612,5.867,2,14,12
143,OLY,P010392,P011194,6.133,3,14,11
143,OLY,P010612,P011194,7.85,-1,13,14
144,BAR,P000925,P002939,15.734,4,29,25
144,BAR,P000925,P004866,25.184,12,52,40
144,BAR,P000925,P006435,21.551,11,45,34
144,BAR,P000925,P007519,9.45,8,23,15
144,BAR,P000925,P009992,3.633,1,7,6
144,BAR,P000925,P011244,9.467,4,22,18
144,BAR,P000925,P012745,15.717,8,30,22
144,BAR,P002939,P003196,9.033,-4,21,25
144,BAR,P002939,P004866,23.583,0,45,45
144,BAR,P002939,P006435,22.917,2,48,46
144,BAR,P002939,P007464,1.55,3,8,5
144,BAR,P002939,P007519,2.25,-2,5,7
144,BAR,P002939,P009992,4.466,-1,10,11
144,BAR,P002939,P010641,2.616,1,8,7
144,BAR,P002939,P011244,3.867,-4,5,9
144,BAR,P002939,P012745,23.516,5,53,48
144,BAR,P003196,P004866,8.016,-6,18,24
144,BAR,P003196,P006435,5.35,-3,11,14
144,BAR,P003196,P007519,3.483,-6,7,13
144,BAR,P003196,P009992,4.916,-5,12,17
144,BAR,P003196,P011244,0.3,-2,0,2
144,BAR,P003196,P012745,9.966,-6,23,29
144,BAR,P004866,P006435,27.184,6,56,50
144,BAR,P004866,P007519,12.616,4,27,23
144,BAR,P004866,P009992,9.015,-2,16,18
144,BAR,P004866,P010641,2.999,-2,2,4
144,BAR,P004866,P011244,11.7,2,24,22
144,BAR,P004866,P012745,24.499,2,48,46
144,BAR,P006435,P007464,1.55,3,8,5
144,BAR,P006435,P007519,5.817,7,16,9
144,BAR,P006435,P010641,1.833,1,8,7
144,BAR,P006435,P011244,6.634,5,17,12
144,BAR,P006435,P012745,22.1,4,47,43
144,BAR,P007464,P010641,1.55,3,8,5
144,BAR,P007464,P012745,1.55,3,8,5
144,BAR,P007519,P009992,9.049,-5,16,21
144,BAR,P007519,P010641,1.933,0,2,2
144,BAR,P007519,P011244,7.833,6,19,13
144,BAR,P007519,P012745,7.033,-4,13,17
144,BAR,P009992,P010641,2.716,0,2,2
144,BAR,P009992,P011244,5.066,-3,7,10
144,BAR,P009992,P012745,6.199,-1,14,15
144,BAR,P010641,P011244,1.933,0,2,2
144,BAR,P010641,P012745,2.616,1,8,7
144,ZAL,P002329,P003210,1.966,-5,3,8
144,ZAL,P002329,P003211,13.9,-16,17,33
144,ZAL,P002329,P005504,17.882,-8,34,42
144,ZAL,P002329,P006860,1.566,-14,1,15
144,ZAL,P002329,P007109,26.149,3,52,49
144,ZAL,P002329,P007513,16.5,7,37,30
144,ZAL,P002329,P009917,4.933,-12,4,16
144,ZAL,P002329,P010390,10.433,0,20,20
144,ZAL,P002329,P011218,20.266,4,39,35
144,ZAL,P002329,P012787,4.333,-7,9,16
144,ZAL,P003210,P003211,0.517,-2,0,2
144,ZAL,P003210,P005504,1.566,-5,3,8
144,ZAL,P003210,P006860,0.683,-4,1,5
144,ZAL,P003210,P007109,1.8,-3,2,5
144,ZAL,P003210,P009917,2.483,-7,3,10
144,ZAL,P003210,P010390,0.917,-2,0,2
144,ZAL,P003211,P005504,16.25,-4,31,35
144,ZAL,P003211,P006860,4.25,-11,6,17
144,ZAL,P003211,P007109,16.65,0,31,31
144,ZAL,P003211,P007513,6.517,-3,12,15
144,ZAL,P003211,P009917,11.701,-1,22,23
144,ZAL,P003211,P010390,5.25,-4,7,11
144,ZAL,P003211,P011218,11.8,4,20,16
144,ZAL,P003211,P012787,3.833,-11,6,17
144,ZAL,P005504,P006860,3.633,-13,7,20
144,ZAL,P005504,P007109,18.949,13,44,31
144,ZAL,P005504,P007513,11.233,6,28,22
144,ZAL,P005504,P009917,9.8,1,22,21
144,ZAL,P005504,P011218,14.833,15,33,18
144,ZAL,P005504,P012787,3.25,-9,6,15
144,ZAL,P006860,P007513,0.417,0,0,0
144,ZAL,P006860,P009917,5.866,-6,12,18
144,ZAL,P006860,P010390,3.083,-1,5,6
144,ZAL,P006860,P011218,1.783,1,5,4
144,ZAL,P006860,P012787,5.583,-8,11,19
144,ZAL,P007109,P007513,14.733,8,36,28
144,ZAL,P007109,P009917,7.817,2,17,15
144,ZAL,P007109,P010390,11.4,1,23,22
144,ZAL,P007109,P011218,25.083,15,54,39
144,ZAL,P007109,P012787,3.483,1,9,8
144,ZAL,P007513,P009917,2.184,-1,1,2
144,ZAL,P007513,P010390,5.684,1,9,8
144,ZAL,P007513,P011218,10.1,10,25,15
144,ZAL,P007513,P012787,0.3,0,0,0
144,ZAL,P009917,P010390,4.483,-2,8,10
144,ZAL,P009917,P011218,7.8,6,20,14
144,ZAL,P009917,P012787,4.733,0,11,11
144,ZAL,P010390,P011218,10.866,5,26,21
144,ZAL,P010390,P012787,5.816,2,14,12
144,ZAL,P011218,P012787,4.933,4,14,10
145,IST,P004554,P006590,4.883,-6,7,13
145,IST,P004554,P007200,4.883,-6,7,13
145,IST,P004554,P009846,1.983,-4,0,4
145,IST,P004554,P011078,2.9,-2,7,9
145,IST,P004554,P012786,4.883,-6,7,13
145,IST,P006590,P007200,23.217,-11,40,51
145,IST,P006590,P009846,14.283,-2,27,29
145,IST,P006590,P011078,13.45,-7,25,32
145,IST,P006590,P011981,5.667,-6,5,11
145,IST,P006590,P012710,5.55,1,15,14
145,IST,P006590,P012786,17.383,-7,28,35
145,IST,P006590,P012788,18.567,-2,37,39
145,IST,P007200,P009513,1.633,0,2,2
145,IST,P007200,P009846,17.516,-2,39,41
145,IST,P007200,P011078,23.033,-7,50,57
145,IST,P007200,P011981,13.75,-9,26,35
145,IST,P007200,P012710,7.95,5,23,18
145,IST,P007200,P012786,24.183,-6,47,53
145,IST,P007200,P012788,25.167,-4,50,54
145,IST,P009513,P011078,1.633,0,2,2
145,IST,P009513,P012786,1.633,0,2,2
145,IST,P009513,P012788,1.633,0,2,2
145,IST,P009846,P011078,10.432,6,31,25
145,IST,P009846,P011981,8.899,1,21,20
145,IST,P009846,P012710,6.8,3,21,18
145,IST,P009846,P012786,11.599,5,29,24
145,IST,P009846,P012788,17.216,5,40,35
145,IST,P011078,P011981,13.083,-3,31,34
145,IST,P011078,P012710,2.4,4,8,4
145,IST,P011078,P012786,24.349,1,56,55
145,IST,P011078,P012788,19.516,0,42,42
145,IST,P011981,P012786,11.533,2,30,28
145,IST,P011981,P012788,10.6,-5,19,24
145,IST,P012710,P012786,1.15,2,2,0
145,IST,P012710,P012788,7.95,5,23,18
145,IST,P012786,P012788,18.683,5,39,34
145,ULK,P001932,P002968,5.017,-2,10,12
145,ULK,P001932,P004004,6.15,4,18,14
145,ULK,P001932,P005844,10.4,8,25,17
145,ULK,P001932,P006661,25.667,9,61,52
145,ULK,P001932,P006961,11.334,8,21,13
145,ULK,P001932,P008962,24.134,6,58,52
145,ULK,P001932,P010560,10.066,4,27,23
145,ULK,P001932,P011157,9.9,-1,24,25
145,ULK,P002968,P004004,3.85,-1,9,10
145,ULK,P002968,P005844,0.017,-2,0,2
145,ULK,P002968,P006661,6.9,2,16,14
145,ULK,P002968,P006961,6.433,-1,13,14
145,ULK,P002968,P008962,9.117,-7,19,26
145,ULK,P002968,P009849,4.301,-12,6,18
145,ULK,P002968,P010560,3.084,-7,6,13
145,ULK,P002968,P011052,4.001,-7,6,13
145,ULK,P002968,P011980,2.084,-3,3,6
145,ULK,P004004,P005844,13.183,6,29,23
145,ULK,P004004,P006661,9.0,8,26,18
145,ULK,P004004,P006961,10.7,5,24,19
145,ULK,P004004,P008962,16.4,7,40,33
145,ULK,P004004,P009849,8.317,-1,14,15
145,ULK,P004004,P011052,1.0,0,0,0
145,ULK,P004004,P011980,1.0,0,0,0
145,ULK,P005844,P006661,11.367,8,27,19
145,ULK,P005844,P006961,13.5,12,28,16
145,ULK,P005844,P008962,16.934,9,38,29
145,ULK,P005844,P009849,7.1,4,14,10
145,ULK,P005844,P010560,1.533,3,3,0
145,ULK,P005844,P011052,0.083,0,0,0
145,ULK,P005844,P011980,0.083,0,0,0
145,ULK,P006661,P006961,14.184,12,29,17
145,ULK,P006661,P008962,26.984,10,66,56
145,ULK,P006661,P010560,10.066,4,27,23
145,ULK,P006661,P011157,9.9,-1,24,25
145,ULK,P006961,P008962,20.051,8,40,32
145,ULK,P006961,P009849,7.4,-1,14,15
145,ULK,P006961,P010560,1.533,3,3,0
145,ULK,P006961,P011052,0.083,0,0,0
145,ULK,P006961,P011157,1.367,-2,0,2
145,ULK,P006961,P011980,0.083,0,0,0
145,ULK,P008962,P009849,9.317,-5,17,22
145,ULK,P008962,P010560,10.45,-3,27,30
145,ULK,P008962,P011052,1.917,-4,3,7
145,ULK,P008962,P011157,9.9,-1,24,25
145,ULK,P009849,P010560,3.084,-7,6,13
145,ULK,P009849,P011052,4.001,-7,6,13
145,ULK,P009849,P011980,2.084,-3,3,6
145,ULK,P010560,P011052,3.084,-7,6,13
145,ULK,P010560,P011157,8.533,1,24,23
145,ULK,P010560,P011980,1.167,-3,3,6
145,ULK,P011052,P011980,2.167,-3,3,6
146,BAS,P003198,P004603,2.867,-7,2,9
146,BAS,P003198,P004761,2.867,-7,2,9
146,BAS,P003198,P007230,2.867,-7,2,9
146,BAS,P003198,P009048,2.867,-7,2,9
146,BAS,P004603,P004761,12.65,-13,18,31
146,BAS,P004603,P007230,12.817,-15,18,33
146,BAS,P004603,P009048,12.65,-13,18,31
146,BAS,P004603,P011085,2.95,-1,6,7
146,BAS,P004603,P011948,6.117,-5,9,14
146,BAS,P004603,P012201,1.05,-4,1,5
146,BAS,P004603,P012765,0.167,-2,0,2
146,BAS,P004761,P007230,20.15,-9,36,45
146,BAS,P004761,P009048,21.35,-16,37,53
146,BAS,P004761,P010444,8.95,-3,18,21
146,BAS,P004761,P011085,6.383,0,14,14
146,BAS,P004761,P011948,9.017,-3,17,20
146,BAS,P004761,P012201,10.483,-1,21,22
146,BAS,P004761,P012765,2.15,4,5,1
146,BAS,P007230,P008072,5.867,2,9,7
146,BAS,P007230,P009048,22.733,-17,34,51
146,BAS,P007230,P010444,15.5,5,28,23
146,BAS,P007230,P011085,9.834,10,24,14
146,BAS,P007230,P011948,16.2,-5,26,31
146,BAS,P007230,P012201,23.017,7,40,33
146,BAS,P007230,P012765,15.151,13,27,14
146,BAS,P008072,P009048,1.85,0,0,0
146,BAS,P008072,P011085,4.017,2,9,7
146,BAS,P008072,P012201,5.867,2,9,7
146,BAS,P008072,P012765,5.867,2,9,7
146,BAS,P009048,P010444,9.683,-11,16,27
146,BAS,P009048,P011085,6.383,0,14,14
146,BAS,P009048,P011948,11.9,-7,20,27
146,BAS,P009048,P012201,13.066,-9,19,28
146,BAS,P009048,P012765,1.85,0,0,0
146,BAS,P010444,P011085,6.534,2,13,11
146,BAS,P010444,P011948,9.1,-4,13,17
146,BAS,P010444,P012201,18.167,0,30,30
146,BAS,P010444,P012765,9.734,11,18,7
146,BAS,P011085,P011948,0.667,-2,0,2
146,BAS,P011085,P012201,11.018,4,24,20
146,BAS,P011085,P012765,7.418,5,16,11
146,BAS,P011948,P012201,9.5,-2,13,15
146,BAS,P011948,P012765,4.967,0,6,6
146,BAS,P012201,P012765,15.768,11,27,16
146,MIL,P002812,P002849,20.05,12,40,28
146,MIL,P002812,P005670,16.183,19,38,19
146,MIL,P002812,P005775,5.6,-8,4,12
146,MIL,P002812,P006509,6.3,-10,4,14
146,MIL,P002812,P006701,1.333,-4,0,4
146,MIL,P002812,P007201,19.783,13,40,27
146,MIL,P002812,P009960,0.833,-4,0,4
146,MIL,P002812,P011205,21.25,10,42,32
146,MIL,P002849,P005670,21.383,22,52,30
146,MIL,P002849,P005775,12.651,-14,13,27
146,MIL,P002849,P006509,13.95,-4,21,25
146,MIL,P002849,P006701,1.567,-2,0,2
146,MIL,P002849,P007201,21.45,15,48,33
146,MIL,P002849,P009960,11.15,2,20,18
146,MIL,P002849,P011205,25.667,17,54,37
146,MIL,P005670,P005775,4.217,-2,7,9
146,MIL,P005670,P006509,11.866,4,27,23
146,MIL,P005670,P006721,0.867,-2,2,4
146,MIL,P005670,P007201,23.733,24,56,32
146,MIL,P005670,P009960,10.716,8,26,18
146,MIL,P005670,P011205,22.5,21,54,33
146,MIL,P005670,P011926,0.867,-2,2,4
146,MIL,P005775,P006509,11.8,-8,12,20
146,MIL,P005775,P006701,1.85,-2,0,2
146,MIL,P005775,P007201,6.017,-6,8,14
146,MIL,P005775,P009960,9.0,-2,11,13
146,MIL,P005775,P011205,9.201,-6,13,19
146,MIL,P006509,P006701,2.9,-6,0,6
146,MIL,P006509,P006721,0.867,-2,2,4
146,MIL,P006509,P007201,10.933,3,22,19
146,MIL,P006509,P009960,15.199,1,27,26
146,MIL,P006509,P011205,13.25,-4,23,27
146,MIL,P006509,P011926,0.867,-2,2,4
146,MIL,P006701,P007201,0.5,0,0,0
146,MIL,P006701,P009960,2.4,-6,0,6
146,MIL,P006701,P011205,1.05,-4,0,4
146,MIL,P006721,P011205,0.867,-2,2,4
146,MIL,P006721,P011926,0.867,-2,2,4
146,MIL,P007201,P009960,7.233,7,18,11
146,MIL,P007201,P011205,21.483,16,48,32
146,MIL,P009960,P011205,8.933,2,18,16
146,MIL,P011205,P011926,0.867,-2,2,4
147,MUN,P001288,P001557,3.884,2,9,7
147,MUN,P001288,P004508,17.384,6,41,35
147,MUN,P001288,P005460,1.467,-2,3,5
147,MUN,P001288,P006760,13.55,7,37,30
147,MUN,P001288,P007056,14.35,-12,27,39
147,MUN,P001288,P007639,9.983,15,29,14
147,MUN,P001288,P007975,5.75,-8,8,16
147,MUN,P001288,P008985,16.933,3,43,40
147,MUN,P001288,P010391,11.633,-3,23,26
147,MUN,P001288,P011987,8.466,0,20,20
147,MUN,P001557,P004508,6.617,-3,12,15
147,MUN,P001557,P005460,3.2,-4,6,10
147,MUN,P001557,P006543,4.066,-3,5,8
147,MUN,P001557,P007056,2.333,-1,2,3
147,MUN,P001557,P007639,2.417,4,6,2
147,MUN,P001557,P007975,4.783,-8,5,13
147,MUN,P001557,P010391,3.167,7,9,2
147,MUN,P001557,P011987,1.333,2,2,0
147,MUN,P004508,P005460,3.2,-4,6,10
147,MUN,P004508,P006543,2.733,-5,3,8
147,MUN,P004508,P006760,8.484,8,26,18
147,MUN,P004508,P007056,10.467,-6,21,27
147,MUN,P004508,P007639,11.017,12,30,18
147,MUN,P004508,P007975,10.65,-13,17,30
147,MUN,P004508,P008985,8.75,9,26,17
147,MUN,P004508,P010391,10.633,5,23,18
147,MUN,P004508,P011987,0.333,3,3,0
147,MUN,P005460,P006543,1.733,-2,3,5
147,MUN,P005460,P007975,2.45,-7,3,10
147,MUN,P005460,P010391,0.75,3,3,0
147,MUN,P006543,P006760,0.2,0,0,0
147,MUN,P006543,P007056,2.533,-1,2,3
147,MUN,P006543,P007975,4.266,-3,5,8
147,MUN,P006543,P011987,1.533,2,2,0
147,MUN,P006760,P007056,19.117,-6,38,44
147,MUN,P006760,P007639,13.433,14,34,20
147,MUN,P006760,P007975,3.65,1,9,8
147,MUN,P006760,P008985,19.7,6,46,40
147,MUN,P006760,P010391,0.65,-5,0,5
147,MUN,P006760,P011987,14.616,3,30,27
147,MUN,P007056,P007639,9.25,2,18,16
147,MUN,P007056,P007975,9.133,-4,13,17
147,MUN,P007056,P008985,17.633,-7,36,43
147,MUN,P007056,P010391,5.966,-9,9,18
147,MUN,P007056,P011987,16.282,0,30,30
147,MUN,P007639,P007975,4.033,0,9,9
147,MUN,P007639,P008985,12.783,13,32,19
147,MUN,P007639,P010391,6.05,3,13,10
147,MUN,P007639,P011987,7.966,5,17,12
147,MUN,P007975,P010391,4.383,-4,5,9
147,MUN,P007975,P011987,2.166,2,2,0
147,MUN,P008985,P010391,4.966,-6,11,17
147,MUN,P008985,P011987,15.299,2,34,32
147,MUN,P010391,P011987,1.866,-3,4,7
147,PAM,P005356,P006643,2.899,-3,3,6
147,PAM,P005356,P007870,4.183,-7,5,12
147,PAM,P005356,P008780,10.384,3,23,20
147,PAM,P005356,P010393,2.6,-2,5,7
147,PAM,P005356,P010568,3.316,-2,6,8
147,PAM,P005356,P012738,11.9,6,26,20
147,PAM,P005356,P012739,8.3,8,22,14
147,PAM,P005356,P012740,0.35,2,3,1
147,PAM,P005356,P012795,11.2,-1,23,24
147,PAM,P006643,P007870,15.683,-3,30,33
147,PAM,P006643,P010393,17.766,-5,32,37
147,PAM,P006643,P010568,20.466,-4,35,39
147,PAM,P006643,P012738,3.216,3,5,2
147,PAM,P006643,P012739,3.9,-1,3,4
147,PAM,P006643,P012740,17.9,-1,32,33
147,PAM,P006643,P012795,0.366,-2,0,2
147,PAM,P007870,P008780,5.217,-4,9,13
147,PAM,P007870,P010393,19.05,-7,40,47
147,PAM,P007870,P010568,22.566,-3,50,53
147,PAM,P007870,P012738,5.9,1,12,11
147,PAM,P007870,P012740,18.083,2,43,41
147,PAM,P007870,P012795,9.25,-7,19,26
147,PAM,P008780,P010393,2.867,0,7,7
147,PAM,P008780,P010568,2.8,0,7,7
147,PAM,P008780,P012738,10.984,5,25,20
147,PAM,P008780,P012739,7.3,5,19,14
147,PAM,P008780,P012795,13.184,3,30,27
147,PAM,P010393,P010568,21.067,-9,42,51
147,PAM,P010393,P012738,1.1,4,4,0
147,PAM,P010393,P012739,1.367,-2,0,2
147,PAM,P010393,P012740,17.084,0,37,37
147,PAM,P010393,P012795,4.367,-7,9,16
147,PAM,P010568,P012738,8.783,8,21,13
147,PAM,P010568,P012739,6.067,-1,9,10
147,PAM,P010568,P012740,23.767,0,51,51
147,PAM,P010568,P012795,9.3,-5,23,28
147,PAM,P012738,P012739,12.0,6,28,22
147,PAM,P012738,P012740,7.0,3,16,13
147,PAM,P012738,P012795,16.117,8,39,31
147,PAM,P012739,P012740,5.067,-4,6,10
147,PAM,P012739,P012795,9.467,5,25,20
147,PAM,P012740,P012795,5.817,-2,16,18
148,ASV,P000229,P003526,6.917,-9,8,17
148,ASV,P000229,P004194,2.15,-5,0,5
148,ASV,P000229,P006568,0.5,-3,0,3
148,ASV,P000229,P011225,9.167,-9,9,18
148,ASV,P000229,P012080,4.85,-4,8,12
148,ASV,P000229,P012729,14.017,-13,17,30
148,ASV,P000229,P012730,11.867,-8,17,25
148,ASV,P000229,PKIR,6.6,-1,9,10
148,ASV,P003526,P004194,0.033,0,0,0
148,ASV,P003526,P011225,5.467,-9,2,11
148,ASV,P003526,P012080,3.751,0,6,6
148,ASV,P003526,P012729,8.084,-9,8,17
148,ASV,P003526,P012730,8.034,-9,8,17
148,ASV,P003526,PKIR,0.05,0,0,0
148,ASV,P004194,P006568,17.283,11,38,27
148,ASV,P004194,P011225,26.266,13,59,46
148,ASV,P004194,P012080,22.916,19,57,38
148,ASV,P004194,P012729,10.483,-2,21,23
148,ASV,P004194,P012730,3.0,-3,4,7
148,ASV,P004194,PKIR,22.933,19,57,38
148,ASV,P006568,P011225,17.283,11,38,27
148,ASV,P006568,P012080,16.783,14,38,24
148,ASV,P006568,P012729,3.333,-6,2,8
148,ASV,P006568,PKIR,13.95,17,36,19
148,ASV,P011225,P012080,24.783,13,57,44
148,ASV,P011225,P012729,19.367,-12,30,42
148,ASV,P011225,P012730,11.867,-13,13,26
148,ASV,P011225,PKIR,26.4,18,64,46
148,ASV,P012080,P012729,13.85,-6,27,33
148,ASV,P012080,P012730,8.533,-12,10,22
148,ASV,P012080,PKIR,23.066,12,57,45
148,ASV,P012729,P012730,14.884,-15,19,34
148,ASV,P012729,PKIR,12.85,-1,28,29
148,ASV,P012730,PKIR,8.683,-8,13,21
148,MAD,P001392,P003733,6.65,-2,16,18
148,MAD,P001392,P004887,12.651,6,28,22
148,MAD,P001392,P005791,16.116,-18,26,44
148,MAD,P001392,P005928,19.283,-12,33,45
148,MAD,P001392,P006540,17.834,-1,32,33
148,MAD,P001392,P009213,10.616,-12,14,26
148,MAD,P001392,P010868,0.033,0,0,0
148,MAD,P001392,P011649,2.617,0,6,6
148,MAD,P001392,PCVM,3.684,0,9,9
148,MAD,P001392,PTGB,2.516,-9,4,13
148,MAD,P003733,P004887,11.785,19,31,12
148,MAD,P003733,P005791,13.317,-4,26,30
148,MAD,P003733,P005928,6.783,-5,12,17
148,MAD,P003733,P006540,8.25,15,25,10
148,MAD,P003733,P009213,3.65,-9,7,16
148,MAD,P003733,P010868,0.033,0,0,0
148,MAD,P003733,P011649,7.334,4,12,8
148,MAD,P003733,PCVM,12.885,16,31,15
148,MAD,P003733,PTGB,16.717,10,36,26
148,MAD,P004887,P005791,9.151,4,20,16
148,MAD,P004887,P005928,9.751,3,21,18
148,MAD,P004887,P006540,13.701,20,33,13
148,MAD,P004887,P009213,3.117,0,4,4
148,MAD,P004887,P011649,2.934,0,6,6
148,MAD,P004887,PCVM,11.302,15,27,12
148,MAD,P004887,PTGB,8.684,9,18,9
148,MAD,P005791,P005928,20.149,-17,32,49
148,MAD,P005791,P006540,16.7,-5,32,37
148,MAD,P005791,P009213,12.3,-21,17,38
148,MAD,P005791,P011649,4.533,4,6,2
148,MAD,P005791,PCVM,6.601,5,14,9
148,MAD,P005791,PTGB,14.533,-4,27,31
148,MAD,P005928,P006540,18.0,0,33,33
148,MAD,P005928,P009213,11.933,-18,14,32
148,MAD,P005928,P011649,2.266,3,3,0
148,MAD,P005928,PCVM,0.767,1,3,2
148,MAD,P005928,PTGB,6.332,-7,9,16
148,MAD,P006540,P009213,14.067,-13,21,34
148,MAD,P006540,P010868,0.033,0,0,0
148,MAD,P006540,PCVM,5.5,13,15,2
148,MAD,P006540,PTGB,7.583,11,21,10
148,MAD,P009213,P010868,0.033,0,0,0
148,MAD,P009213,P011649,0.133,0,0,0
148,MAD,P009213,PCVM,1.117,-2,0,2
148,MAD,P009213,PTGB,4.834,-9,7,16
148,MAD,P011649,PCVM,5.201,1,9,8
148,MAD,P011649,PTGB,4.85,4,6,2
148,MAD,PCVM,PTGB,11.151,15,24,9
149,TEL,P004233,P007990,6.783,11,19,8
149,TEL,P004233,P009622,4.182,6,8,2
149,TEL,P004233,P009783,0.583,3,3,0
149,TEL,P004233,P011193,9.582,13,23,10
149,TEL,P004233,P011214,10.149,15,25,10
149,TEL,P004233,P011219,4.333,9,13,4
149,TEL,P004233,P011971,4.583,3,9,6
149,TEL,P004233,P012744,0.733,0,0,0
149,TEL,P005145,P007990,1.483,0,2,2
149,TEL,P005145,P009622,4.916,2,9,7
149,TEL,P005145,P009783,4.916,2,9,7
149,TEL,P005145,P011193,3.433,2,7,5
149,TEL,P005145,P011199,4.916,2,9,7
149,TEL,P007990,P009622,11.599,-14,13,27
149,TEL,P007990,P009783,9.133,-9,11,20
149,TEL,P007990,P011193,10.266,3,21,18
149,TEL,P007990,P011199,7.916,-5,11,16
149,TEL,P007990,P011214,10.3,1,20,19
149,TEL,P007990,P011219,11.866,-3,20,23
149,TEL,P007990,P011971,3.85,0,7,7
149,TEL,P009622,P009783,27.965,2,55,53
149,TEL,P009622,P011193,20.281,10,44,34
149,TEL,P009622,P011199,25.282,1,50,49
149,TEL,P009622,P011214,7.932,-3,10,13
149,TEL,P009622,P011219,17.632,-12,26,38
149,TEL,P009622,P011971,7.683,5,19,14
149,TEL,P009622,P012744,5.716,-5,6,11
149,TEL,P009783,P011193,15.599,16,41,25
149,TEL,P009783,P011199,25.282,1,50,49
149,TEL,P009783,P011214,2.683,1,5,4
149,TEL,P009783,P011219,15.916,-10,24,34
149,TEL,P009783,P011971,4.8,7,16,9
149,TEL,P009783,P012744,4.983,-5,6,11
149,TEL,P011193,P011199,14.133,11,36,25
149,TEL,P011193,P011214,12.765,9,26,17
149,TEL,P011193,P011219,10.349,8,24,16
149,TEL,P011193,P011971,10.783,8,26,18
149,TEL,P011193,P012744,0.733,0,0,0
149,TEL,P011199,P011219,13.816,-8,22,30
149,TEL,P011199,P011971,4.8,7,16,9
149,TEL,P011199,P012744,4.983,-5,6,11
149,TEL,P011214,P011219,7.983,4,16,12
149,TEL,P011214,P011971,5.983,1,10,9
149,TEL,P011214,P012744,0.733,0,0,0
149,TEL,P011219,P011971,0.65,1,1,0
149,TEL,P011219,P012744,4.983,-5,6,11
149,ZAL,P002329,P003210,0.583,0,0,0
149,ZAL,P002329,P003211,3.599,-7,2,9
149,ZAL,P002329,P005504,15.35,3,32,29
149,ZAL,P002329,P006860,2.95,3,6,3
149,ZAL,P002329,P007109,23.749,2,46,44
149,ZAL,P002329,P007513,17.4,2,33,31
149,ZAL,P002329,P010390,8.499,2,17,15
149,ZAL,P002329,P011218,24.533,12,52,40
149,ZAL,P002329,P012715,7.867,-2,11,13
149,ZAL,P002329,P012787,12.466,1,25,24
149,ZAL,P003210,P003211,3.033,-3,4,7
149,ZAL,P003210,P006860,3.25,-6,4,10
149,ZAL,P003210,P007109,0.583,0,0,0
149,ZAL,P003210,P007513,0.583,0,0,0
149,ZAL,P003210,P009917,4.067,-11,4,15
149,ZAL,P003210,P010390,3.533,-12,0,12
149,ZAL,P003210,P011218,2.2,-8,0,8
149,ZAL,P003210,P012715,3.1,-4,4,8
149,ZAL,P003211,P005504,0.4,2,2,0
149,ZAL,P003211,P006860,4.566,-2,6,8
149,ZAL,P003211,P007109,2.9,3,7,4
149,ZAL,P003211,P007513,4.999,-2,7,9
149,ZAL,P003211,P009917,3.05,-1,6,7
149,ZAL,P003211,P010390,3.999,-4,5,9
149,ZAL,P003211,P011218,2.183,3,5,2
149,ZAL,P003211,P012715,7.116,-9,6,15
149,ZAL,P003211,P012787,2.283,0,2,2
149,ZAL,P005504,P006860,0.417,2,2,0
149,ZAL,P005504,P007109,15.033,-1,29,30
149,ZAL,P005504,P007513,10.367,-2,17,19
149,ZAL,P005504,P011218,15.85,0,31,31
149,ZAL,P005504,P012715,2.75,-2,4,6
149,ZAL,P005504,P012787,12.633,-6,23,29
149,ZAL,P006860,P007513,3.85,3,8,5
149,ZAL,P006860,P009917,2.667,-6,4,10
149,ZAL,P006860,P010390,3.35,-6,4,10
149,ZAL,P006860,P011218,3.684,-1,6,7
149,ZAL,P006860,P012715,3.983,1,6,5
149,ZAL,P006860,P012787,2.283,0,2,2
149,ZAL,P007109,P007513,15.8,2,29,27
149,ZAL,P007109,P009917,0.6,2,2,0
149,ZAL,P007109,P010390,7.316,8,18,10
149,ZAL,P007109,P011218,23.766,9,50,41
149,ZAL,P007109,P012715,4.667,-1,7,8
149,ZAL,P007109,P012787,13.65,0,28,28
149,ZAL,P007513,P009917,0.35,-2,0,2
149,ZAL,P007513,P010390,6.566,0,15,15
149,ZAL,P007513,P011218,17.367,7,35,28
149,ZAL,P007513,P012715,10.3,-5,13,18
149,ZAL,P007513,P012787,6.35,-7,7,14
149,ZAL,P009917,P010390,3.9,-12,2,14
149,ZAL,P009917,P011218,2.567,-8,2,10
149,ZAL,P009917,P012715,2.867,-6,4,10
149,ZAL,P010390,P011218,11.083,2,22,20
149,ZAL,P010390,P012715,2.4,-9,0,9
149,ZAL,P010390,P012787,1.95,3,5,2
149,ZAL,P011218,P012715,6.934,-4,11,15
149,ZAL,P011218,P012787,12.633,0,26,26
149,ZAL,P012715,P012787,3.216,-3,2,5
150,PAN,P001926,P002328,10.983,9,30,21
150,PAN,P001926,P003842,21.25,15,53,38
150,PAN,P001926,P007866,18.484,10,44,34
150,PAN,P001926,P007947,3.617,2,6,4
150,PAN,P001926,P011204,14.267,15,40,25
150,PAN,P001926,P011209,9.267,-1,14,15
150,PAN,P001926,P011221,7.134,1,9,8
150,PAN,P001926,P012712,9.934,6,18,12
150,PAN,P001926,P012774,18.668,7,34,27
150,PAN,P002328,P003842,14.982,13,39,26
150,PAN,P002328,P007553,1.117,-3,0,3
150,PAN,P002328,P007866,11.366,11,32,21
150,PAN,P002328,P007947,5.883,-1,9,10
150,PAN,P002328,P011204,14.999,10,37,27
150,PAN,P002328,P011209,0.783,-2,0,2
150,PAN,P002328,P011221,0.85,-2,0,2
150,PAN,P002328,P012712,5.583,-3,7,10
150,PAN,P002328,P012774,1.25,0,2,2
150,PAN,P003842,P007866,21.1,10,53,43
150,PAN,P003842,P007947,8.066,2,16,14
150,PAN,P003842,P011204,22.399,17,56,39
150,PAN,P003842,P011209,5.983,0,11,11
150,PAN,P003842,P012712,8.299,7,16,9
150,PAN,P003842,P012774,15.517,4,32,28
150,PAN,P007553,P007947,1.117,-3,0,3
150,PAN,P007553,P011204,1.117,-3,0,3
150,PAN,P007553,P012712,1.117,-3,0,3
150,PAN,P007866,P007947,4.75,0,11,11
150,PAN,P007866,P011204,16.15,10,44,34
150,PAN,P007866,P011209,7.1,0,11,11
150,PAN,P007866,P011221,2.2,0,2,2
150,PAN,P007866,P012712,0.017,0,0,0
150,PAN,P007866,P012774,12.101,-1,23,24
150,PAN,P007947,P011204,11.516,1,20,19
150,PAN,P007947,P011221,5.95,4,10,6
150,PAN,P007947,P012712,10.383,3,15,12
150,PAN,P007947,P012774,9.25,4,17,13
150,PAN,P011204,P011209,0.083,0,0,0
150,PAN,P011204,P011221,2.333,2,4,2
150,PAN,P011204,P012712,9.733,6,16,10
150,PAN,P011204,P012774,10.867,6,23,17
150,PAN,P011209,P011221,3.367,-1,3,4
150,PAN,P011209,P012712,2.25,-1,3,4
150,PAN,P011209,P012774,8.567,1,14,13
150,PAN,P011221,P012712,7.267,3,11,8
150,PAN,P011221,P012774,8.767,5,13,8
150,PAN,P012712,P012774,12.217,10,22,12
150,RED,P000848,P002553,8.7,5,18,13
150,RED,P000848,P004720,0.917,4,4,0
150,RED,P000848,P005099,10.767,-5,17,22
150,RED,P000848,P006436,15.784,-10,22,32
150,RED,P000848,P007960,16.984,-2,25,27
150,RED,P000848,P008966,8.417,-1,15,16
150,RED,P000848,P009035,11.85,-2,20,22
150,RED,P000848,P012044,16.0,0,31,31
150,RED,P000848,P012711,3.567,-2,6,8
150,RED,P000848,PJDR,6.117,1,10,9
150,RED,P000848,PLUO,2.033,0,4,4
150,RED,P002553,P004720,2.2,1,4,3
150,RED,P002553,P005099,5.5,3,9,6
150,RED,P002553,P006436,6.583,-4,10,14
150,RED,P002553,P007960,3.967,4,6,2
150,RED,P002553,P008966,1.35,1,4,3
150,RED,P002553,P009035,15.466,-8,28,36
150,RED,P002553,P012044,9.55,-5,21,26
150,RED,P002553,PJDR,16.883,-4,28,32
150,RED,P002553,PLUO,12.933,-5,24,29
150,RED,P004720,P005099,1.317,-1,2,3
150,RED,P004720,P006436,1.417,-1,2,3
150,RED,P004720,P007960,1.317,-1,2,3
150,RED,P004720,P009035,2.2,1,4,3
150,RED,P004720,P012044,2.1,1,4,3
150,RED,P004720,PJDR,1.183,-3,0,3
150,RED,P004720,PLUO,1.417,-1,2,3
150,RED,P005099,P006436,4.434,-9,4,13
150,RED,P005099,P007960,8.317,-6,11,17
150,RED,P005099,P008966,3.75,-1,5,6
150,RED,P005099,P009035,11.267,1,17,16
150,RED,P005099,P012044,8.5,-3,15,18
150,RED,P005099,P012711,3.567,-2,6,8
150,RED,P005099,PJDR,5.3,1,7,6
150,RED,P005099,PLUO,6.817,2,11,9
150,RED,P006436,P007960,14.268,-4,20,24
150,RED,P006436,P008966,5.567,-2,10,12
150,RED,P006436,P009035,6.033,-13,4,17
150,RED,P006436,P012044,8.533,-7,14,21
150,RED,P006436,P012711,1.05,-4,0,4
150,RED,P006436,PJDR,5.917,-4,8,12
150,RED,P006436,PLUO,2.15,-6,2,8
150,RED,P007960,P008966,7.967,-4,11,15
150,RED,P007960,P009035,4.9,0,6,6
150,RED,P007960,P012044,11.683,-5,17,22
150,RED,P007960,PJDR,6.084,-1,8,9
150,RED,P007960,PLUO,1.317,-1,2,3
150,RED,P008966,P012044,8.1,0,13,13
150,RED,P008966,PJDR,2.117,-5,2,7
150,RED,P009035,P012044,15.017,-7,29,36
150,RED,P009035,P012711,3.984,-5,6,11
150,RED,P009035,PJDR,13.333,-11,22,33
150,RED,P009035,PLUO,13.35,-8,24,32
150,RED,P012044,P012711,2.934,-1,6,7
150,RED,P012044,PJDR,8.167,-11,13,24
150,RED,P012044,PLUO,6.084,-6,13,19
150,RED,P012711,PJDR,0.417,-3,0,3
150,RED,P012711,PLUO,0.417,-3,0,3
150,RED,PJDR,PLUO,12.15,-8,22,30
151,BER,P003958,P008173,13.133,-17,21,38
151,BER,P003958,P008211,4.65,3,11,8
151,BER,P003958,P008967,17.783,-14,32,46
151,BER,P003958,P010791,1.217,1,3,2
151,BER,P003958,P011934,16.566,-15,29,44
151,BER,P003958,P012720,9.0,-9,13,22
151,BER,P003958,P012721,8.783,-5,19,24
151,BER,P006251,P007025,13.601,2,22,20
151,BER,P006251,P008173,7.501,-6,16,22
151,BER,P006251,P008211,11.8,-2,15,17
151,BER,P006251,P008967,4.65,-6,11,17
151,BER,P006251,P010791,17.851,-4,29,33
151,BER,P006251,P011631,3.434,-2,6,8
151,BER,P006251,P011934,1.45,-4,2,6
151,BER,P006251,P012720,10.001,5,19,14
151,BER,P006251,P012721,6.916,-15,4,19
151,BER,P007025,P008173,3.484,0,10,10
151,BER,P007025,P008211,10.934,-1,14,15
151,BER,P007025,P008967,2.967,-2,8,10
151,BER,P007025,P010791,14.418,-1,24,25
151,BER,P007025,P011934,0.817,-3,2,5
151,BER,P007025,P012720,5.334,10,10,0
151,BER,P007025,P012721,6.117,-9,6,15
151,BER,P008173,P008967,16.1,-19,29,48
151,BER,P008173,P010791,8.151,-4,16,20
151,BER,P008173,P011631,3.434,-2,6,8
151,BER,P008173,P011934,16.683,-23,25,48
151,BER,P008173,P012720,10.984,-18,12,30
151,BER,P008173,P012721,11.466,-11,21,32
151,BER,P008211,P008967,6.333,-1,14,15
151,BER,P008211,P010791,13.834,-4,20,24
151,BER,P008211,P011934,4.25,-1,10,11
151,BER,P008211,P012720,10.117,12,22,10
151,BER,P008211,P012721,7.15,-14,6,20
151,BER,P008967,P010791,5.867,-5,14,19
151,BER,P008967,P011934,16.566,-15,29,44
151,BER,P008967,P012720,9.65,-8,16,24
151,BER,P008967,P012721,9.816,-10,19,29
151,BER,P010791,P011631,2.567,-2,4,6
151,BER,P010791,P011934,2.917,-5,4,9
151,BER,P010791,P012720,11.868,8,22,14
151,BER,P010791,P012721,9.25,-16,8,24
151,BER,P011631,P011934,0.867,0,2,2
151,BER,P011631,P012720,3.434,-2,6,8
151,BER,P011934,P012720,11.333,-16,14,30
151,BER,P011934,P012721,12.283,-14,23,37
151,BER,P012720,P012721,2.683,-6,2,8
151,OLY,P001255,P003941,4.367,-5,6,11
151,OLY,P001255,P006589,1.3,-5,0,5
151,OLY,P001255,P007853,1.3,-5,0,5
151,OLY,P001255,P007982,3.8,0,6,6
151,OLY,P001255,P008811,18.7,18,46,28
151,OLY,P001255,P008829,21.767,18,52,34
151,OLY,P001255,P008855,19.267,13,46,33
151,OLY,P001255,P010392,3.067,0,6,6
151,OLY,P001255,P010612,18.7,18,46,28
151,OLY,P003941,P006589,13.617,4,31,27
151,OLY,P003941,P007853,13.367,1,27,26
151,OLY,P003941,P007982,19.401,13,47,34
151,OLY,P003941,P008829,7.084,4,16,12
151,OLY,P003941,P008855,5.567,2,14,12
151,OLY,P003941,P010392,19.401,13,47,34
151,OLY,P006589,P007853,9.35,-3,17,20
151,OLY,P006589,P007982,12.317,9,31,22
151,OLY,P006589,P008855,5.567,2,14,12
151,OLY,P006589,P010392,12.317,9,31,22
151,OLY,P007853,P007982,12.35,6,27,21
151,OLY,P007853,P008811,0.283,0,0,0
151,OLY,P007853,P008829,4.017,4,10,6
151,OLY,P007853,P008855,1.583,-5,0,5
151,OLY,P007853,P010392,12.35,6,27,21
151,OLY,P007982,P008811,1.333,1,1,0
151,OLY,P007982,P008829,8.134,5,17,12
151,OLY,P007982,P008855,4.867,8,15,7
151,OLY,P007982,P010392,20.001,14,48,34
151,OLY,P007982,P010612,0.733,0,0,0
151,OLY,P008811,P008829,19.017,19,47,28
151,OLY,P008811,P008855,18.567,19,47,28
151,OLY,P008811,P010392,0.6,1,1,0
151,OLY,P008811,P010612,18.7,18,46,28
151,OLY,P008829,P008855,18.284,19,47,28
151,OLY,P008829,P010392,7.401,5,17,12
151,OLY,P008829,P010612,18.7,18,46,28
151,OLY,P008855,P010392,4.867,8,15,7
151,OLY,P008855,P010612,17.967,18,46,28
152,BAR,P000925,P002939,14.234,-8,24,32
152,BAR,P000925,P003204,4.334,1,9,8
152,BAR,P000925,P004866,13.401,-13,18,31
152,BAR,P000925,P006435,16.834,-10,27,37
152,BAR,P000925,P007464,9.25,0,19,19
152,BAR,P000925,P007519,8.417,-5,13,18
152,BAR,P000925,P009992,3.2,-2,6,8
152,BAR,P000925,P011244,9.417,-8,12,20
152,BAR,P000925,P012745,11.517,-7,20,27
152,BAR,P002939,P003196,4.283,3,9,6
152,BAR,P002939,P003204,4.25,4,12,8
152,BAR,P002939,P004866,15.334,-9,25,34
152,BAR,P002939,P006435,19.934,-14,35,49
152,BAR,P002939,P007464,6.383,-8,12,20
152,BAR,P002939,P007519,1.75,1,2,1
152,BAR,P002939,P009992,3.933,-2,4,6
152,BAR,P002939,P010641,5.35,-11,6,17
152,BAR,P002939,P011244,4.617,-9,3,12
152,BAR,P002939,P012745,15.4,-11,24,35
152,BAR,P003196,P003204,2.533,2,7,5
152,BAR,P003196,P004866,2.133,2,7,5
152,BAR,P003196,P006435,2.533,2,7,5
152,BAR,P003196,P007464,2.817,-1,7,8
152,BAR,P003196,P007519,4.567,0,9,9
152,BAR,P003196,P009992,4.567,0,9,9
152,BAR,P003196,P012745,4.967,0,9,9
152,BAR,P003204,P004866,3.85,4,12,8
152,BAR,P003204,P006435,4.25,4,12,8
152,BAR,P003204,P007464,4.084,7,12,5
152,BAR,P003204,P007519,4.084,7,12,5
152,BAR,P003204,P010641,1.467,8,8,0
152,BAR,P003204,P012745,4.484,7,12,5
152,BAR,P004866,P006435,13.151,-6,23,29
152,BAR,P004866,P007519,3.2,-2,6,8
152,BAR,P004866,P009992,5.383,-5,8,13
152,BAR,P004866,P010641,3.0,0,6,6
152,BAR,P004866,P011244,7.817,-11,9,20
152,BAR,P004866,P012745,6.867,-4,10,14
152,BAR,P006435,P007464,10.666,-12,17,29
152,BAR,P006435,P007519,4.283,-4,5,9
152,BAR,P006435,P010641,4.85,-10,6,16
152,BAR,P006435,P011244,6.217,-6,6,12
152,BAR,P006435,P012745,14.15,-16,22,38
152,BAR,P007464,P007519,12.934,-2,26,28
152,BAR,P007464,P009992,4.567,-5,9,14
152,BAR,P007464,P010641,7.25,-9,12,21
152,BAR,P007464,P011244,1.6,3,3,0
152,BAR,P007464,P012745,17.717,-13,35,48
152,BAR,P007519,P009992,9.517,-6,17,23
152,BAR,P007519,P010641,4.9,2,12,10
152,BAR,P007519,P011244,4.8,1,9,8
152,BAR,P007519,P012745,13.084,-4,25,29
152,BAR,P009992,P010641,3.933,-7,4,11
152,BAR,P009992,P011244,3.2,-2,6,8
152,BAR,P009992,P012745,8.5,-7,13,20
152,BAR,P010641,P012745,10.25,-9,18,27
152,MCO,P004790,P005985,12.033,12,35,23
152,MCO,P004790,P008099,4.083,-9,5,14
152,MCO,P004790,P010588,5.183,-9,4,13
152,MCO,P004790,P011196,14.283,24,48,24
152,MCO,P004790,P011212,15.383,24,47,23
152,MCO,P004790,P011226,15.666,23,50,27
152,MCO,P004790,P011231,3.8,-8,2,10
152,MCO,P004790,P012709,7.433,3,17,14
152,MCO,P005985,P008099,16.933,-2,34,36
152,MCO,P005985,P010588,18.699,-2,32,34
152,MCO,P005985,P011196,7.85,17,31,14
152,MCO,P005985,P011212,10.933,15,32,17
152,MCO,P005985,P011226,10.8,14,36,22
152,MCO,P005985,P011231,19.383,-7,33,40
152,MCO,P005985,PLCZ,14.833,5,31,26
152,MCO,P008099,P010588,14.933,1,28,27
152,MCO,P008099,P011196,0.283,-1,3,4
152,MCO,P008099,P011226,2.0,-3,6,9
152,MCO,P008099,P011231,16.65,-1,31,32
152,MCO,P008099,PLCZ,12.85,7,29,22
152,MCO,P010588,P011196,0.4,0,0,0
152,MCO,P010588,P011212,3.766,-3,4,7
152,MCO,P010588,P011226,1.633,-1,2,3
152,MCO,P010588,P011231,17.066,-1,30,31
152,MCO,P010588,PLCZ,13.116,7,28,21
152,MCO,P011196,P011212,19.7,25,53,28
152,MCO,P011196,P011226,19.583,24,56,32
152,MCO,P011196,P011231,5.7,0,8,8
152,MCO,P011196,P012709,12.133,7,25,18
152,MCO,P011212,P011226,20.933,24,55,31
152,MCO,P011212,P011231,7.433,-2,10,12
152,MCO,P011212,P012709,12.133,7,25,18
152,MCO,P011212,PLCZ,1.983,-2,2,4
152,MCO,P011226,P011231,7.017,-2,11,13
152,MCO,P011226,P012709,12.133,7,25,18
152,MCO,P011226,PLCZ,1.967,-2,3,5
152,MCO,P011231,P012709,4.7,4,8,4
152,MCO,P011231,PLCZ,14.583,5,31,26
153,PAR,P000956,P004058,5.433,2,10,8
153,PAR,P000956,P007400,5.433,2,10,8
153,PAR,P000956,P009862,5.433,2,10,8
153,PAR,P000956,P012743,5.433,2,10,8
153,PAR,P004058,P004172,4.217,6,9,3
153,PAR,P004058,P007400,29.517,7,61,54
153,PAR,P004058,P008987,24.084,5,51,46
153,PAR,P004058,P009862,23.35,-8,41,49
153,PAR,P004058,P012096,15.184,0,29,29
153,PAR,P004058,P012742,1.95,9,11,2
153,PAR,P004058,P012743,14.333,7,32,25
153,PAR,P004172,P007400,5.467,6,11,5
153,PAR,P004172,P008987,5.467,6,11,5
153,PAR,P004172,P009212,7.983,-9,10,19
153,PAR,P004172,P009862,7.983,-9,10,19
153,PAR,P004172,P012096,13.45,-3,21,24
153,PAR,P004172,P012742,9.233,-9,12,21
153,PAR,P007400,P008987,26.584,5,55,50
153,PAR,P007400,P009862,24.6,-8,43,51
153,PAR,P007400,P012096,16.434,0,31,31
153,PAR,P007400,P012742,4.45,9,15,6
153,PAR,P007400,P012743,15.583,7,34,27
153,PAR,P008987,P009862,19.167,-10,33,43
153,PAR,P008987,P012096,16.434,0,31,31
153,PAR,P008987,P012742,4.45,9,15,6
153,PAR,P008987,P012743,10.15,5,24,19
153,PAR,P009212,P009862,7.983,-9,10,19
153,PAR,P009212,P012096,7.983,-9,10,19
153,PAR,P009212,P012742,7.983,-9,10,19
153,PAR,P009862,P012096,17.0,-24,19,43
153,PAR,P009862,P012742,9.233,-9,12,21
153,PAR,P009862,P012743,15.583,7,34,27
153,PAR,P012096,P012742,11.183,0,23,23
153,PAR,P012742,P012743,1.25,0,2,2
153,VIR,P001133,P001844,23.2,1,42,41
153,VIR,P001133,P002084,2.65,-5,0,5
153,VIR,P001133,P003048,16.916,-3,30,33
153,VIR,P001133,P003527,5.299,-3,8,11
153,VIR,P001133,P004007,4.783,-11,5,16
153,VIR,P001133,P006739,8.616,-6,15,21
153,VIR,P001133,P009549,20.1,2,36,34
153,VIR,P001133,P010781,13.516,-3,27,30
153,VIR,P001133,P012714,9.75,3,24,21
153,VIR,P001133,PBCN,21.834,5,41,36
153,VIR,P001844,P002084,5.067,-2,7,9
153,VIR,P001844,P003048,16.283,-2,30,32
153,VIR,P001844,P003527,3.7,0,9,9
153,VIR,P001844,P006739,0.15,0,0,0
153,VIR,P001844,P009549,18.85,-1,31,32
153,VIR,P001844,P010781,8.717,9,24,15
153,VIR,P001844,P012714,5.917,9,17,8
153,VIR,P001844,PBCN,20.584,2,36,34
153,VIR,P002084,P003527,4.1,7,13,6
153,VIR,P002084,P006739,1.683,4,6,2
153,VIR,P002084,P009549,2.65,-5,0,5
153,VIR,P002084,P010781,4.1,7,13,6
153,VIR,P002084,P012714,4.1,7,13,6
153,VIR,P002084,PBCN,2.65,-5,0,5
153,VIR,P003048,P003527,6.149,-4,9,13
153,VIR,P003048,P004007,4.233,0,7,7
153,VIR,P003048,P006739,5.016,-1,7,8
153,VIR,P003048,P009549,13.95,0,26,26
153,VIR,P003048,P010781,8.382,-1,15,16
153,VIR,P003048,PBCN,13.667,-1,24,25
153,VIR,P003527,P004007,5.816,-2,8,10
153,VIR,P003527,P006739,9.932,4,19,15
153,VIR,P003527,P010781,13.632,4,28,24
153,VIR,P003527,P012714,5.9,10,18,8
153,VIR,P004007,P006739,9.016,-11,12,23
153,VIR,P004007,P010781,9.016,-11,12,23
153,VIR,P004007,P012714,3.2,-9,4,13
153,VIR,P006739,P009549,1.25,3,5,2
153,VIR,P006739,P010781,13.282,-5,23,28
153,VIR,P006739,P012714,7.933,1,20,19
153,VIR,P006739,PBCN,1.25,3,5,2
153,VIR,P009549,P010781,1.95,4,6,2
153,VIR,P009549,P012714,2.733,5,8,3
153,VIR,P009549,PBCN,18.917,0,32,32
153,VIR,P010781,P012714,11.117,5,29,24
153,VIR,P010781,PBCN,3.684,7,11,4
153,VIR,P012714,PBCN,4.75,9,15,6
154,RED,P000848,P005099,9.75,0,19,19
154,RED,P000848,P006436,12.601,16,37,21
154,RED,P000848,P007960,4.783,-1,5,6
154,RED,P000848,P008966,9.6,13,25,12
154,RED,P000848,P009035,14.45,6,29,23
154,RED,P000848,P010985,4.683,-2,9,11
154,RED,P000848,P012044,9.866,10,22,12
154,RED,P000848,PJDR,9.417,11,23,12
154,RED,P000848,PLUO,7.718,15,23,8
154,RED,P005099,P006436,14.367,4,38,34
154,RED,P005099,P007960,9.366,-11,9,20
154,RED,P005099,P008966,0.9,0,3,3
154,RED,P005099,P009035,18.133,0,35,35
154,RED,P005099,P010985,12.266,-1,28,29
154,RED,P005099,P012044,2.283,0,5,5
154,RED,P005099,PJDR,7.0,9,15,6
154,RED,P005099,PLUO,2.067,-1,0,1
154,RED,P006436,P007960,11.667,-8,23,31
154,RED,P006436,P008966,9.3,4,23,19
154,RED,P006436,P009035,21.384,4,52,48
154,RED,P006436,P010985,16.0,1,42,41
154,RED,P006436,P011941,2.8,-6,3,9
154,RED,P006436,P012044,9.283,1,20,19
154,RED,P006436,PJDR,14.784,11,37,26
154,RED,P006436,PLUO,9.618,9,21,12
154,RED,P007960,P009035,16.316,-7,27,34
154,RED,P007960,P010985,14.9,-11,23,34
154,RED,P007960,P011941,1.567,-3,1,4
154,RED,P007960,P012044,0.283,0,0,0
154,RED,P007960,PJDR,7.05,4,16,12
154,RED,P007960,PLUO,5.6,-3,8,11
154,RED,P008966,P009035,5.133,-2,8,10
154,RED,P008966,P011941,1.233,-3,2,5
154,RED,P008966,P012044,11.233,3,24,21
154,RED,P008966,PJDR,7.766,-2,15,17
154,RED,P008966,PLUO,5.367,11,16,5
154,RED,P009035,P010985,17.666,1,41,40
154,RED,P009035,P012044,6.799,-2,10,12
154,RED,P009035,PJDR,16.9,17,40,23
154,RED,P009035,PLUO,6.951,-1,10,11
154,RED,P010985,P011941,1.567,-3,1,4
154,RED,P010985,PJDR,6.95,11,21,10
154,RED,P010985,PLUO,2.9,-4,3,7
154,RED,P011941,P012044,1.233,-3,2,5
154,RED,P011941,PJDR,2.8,-6,3,9
154,RED,P012044,PJDR,6.649,-5,10,15
154,RED,P012044,PLUO,3.967,8,11,3
154,RED,PJDR,PLUO,5.084,6,12,6
154,ULK,P001932,P002968,7.383,-5,8,13
154,ULK,P001932,P004004,12.916,-7,15,22
154,ULK,P001932,P005844,2.35,-5,2,7
154,ULK,P001932,P006661,20.116,-4,41,45
154,ULK,P001932,P006961,11.2,1,27,26
154,ULK,P001932,P008962,22.482,-10,44,54
154,ULK,P001932,P009849,7.766,-4,11,15
154,ULK,P001932,P011157,16.266,3,37,34
154,ULK,P001932,P011980,3.517,3,3,0
154,ULK,P002968,P004004,5.1,-2,3,5
154,ULK,P002968,P005844,0.017,-2,0,2
154,ULK,P002968,P006661,3.45,-6,9,15
154,ULK,P002968,P006961,0.4,-2,0,2
154,ULK,P002968,P008962,4.65,-12,9,21
154,ULK,P002968,P009849,7.367,-6,12,18
154,ULK,P002968,P011052,0.784,-4,4,8
154,ULK,P002968,P011980,3.517,3,3,0
154,ULK,P004004,P005844,10.7,4,23,19
154,ULK,P004004,P006661,8.6,-1,13,14
154,ULK,P004004,P008962,14.783,-12,20,32
154,ULK,P004004,P009849,14.833,-3,23,26
154,ULK,P004004,P011052,10.517,3,21,18
154,ULK,P004004,P011157,7.633,-6,10,16
154,ULK,P004004,P011980,8.65,8,16,8
154,ULK,P005844,P006661,3.917,-2,6,8
154,ULK,P005844,P006961,1.45,-4,0,4
154,ULK,P005844,P008962,7.034,-7,10,17
154,ULK,P005844,P009849,8.25,0,17,17
154,ULK,P005844,P011052,9.817,3,21,18
154,ULK,P005844,P011980,5.133,5,13,8
154,ULK,P006661,P006961,12.633,2,28,26
154,ULK,P006661,P008962,23.883,-2,50,52
154,ULK,P006661,P009849,2.65,-3,9,12
154,ULK,P006661,P011052,3.767,2,9,7
154,ULK,P006661,P011157,16.516,6,35,29
154,ULK,P006961,P008962,13.9,0,31,31
154,ULK,P006961,P009849,1.267,-2,3,5
154,ULK,P006961,P011052,2.7,-1,4,5
154,ULK,P006961,P011157,12.05,6,31,25
154,ULK,P008962,P009849,10.117,-18,19,37
154,ULK,P008962,P011052,8.868,-7,16,23
154,ULK,P008962,P011157,19.683,0,41,41
154,ULK,P009849,P011052,11.001,-6,24,30
154,ULK,P009849,P011157,3.167,-6,6,12
154,ULK,P009849,P011980,8.65,8,16,8
154,ULK,P011052,P011157,3.417,-3,4,7
154,ULK,P011052,P011980,5.133,5,13,8
155,MCO,P002581,P005985,11.667,4,28,24
155,MCO,P002581,P010588,10.767,4,25,21
155,MCO,P002581,P011212,0.9,0,3,3
155,MCO,P002581,P011226,11.667,4,28,24
155,MCO,P002581,P011231,0.9,0,3,3
155,MCO,P002581,P012709,10.767,4,25,21
155,MCO,P004197,P005985,5.217,-2,8,10
155,MCO,P004197,P010588,5.217,-2,8,10
155,MCO,P004197,P011226,5.217,-2,8,10
155,MCO,P004197,PLCZ,5.217,-2,8,10
155,MCO,P004790,P005985,3.867,-6,5,11
155,MCO,P004790,P010588,1.367,-2,0,2
155,MCO,P004790,P011196,5.734,-4,9,13
155,MCO,P004790,P011212,7.101,-6,9,15
155,MCO,P004790,P011231,7.101,-6,9,15
155,MCO,P004790,P012709,3.234,0,4,4
155,MCO,P005985,P010588,23.234,-1,50,51
155,MCO,P005985,P011196,11.25,-10,20,30
155,MCO,P005985,P011212,13.467,-16,23,39
155,MCO,P005985,P011226,28.367,-8,58,66
155,MCO,P005985,P011231,9.75,-15,13,28
155,MCO,P005985,P012709,13.55,4,32,28
155,MCO,P005985,PLCZ,8.567,-6,15,21
155,MCO,P010588,P011196,4.083,2,12,10
155,MCO,P010588,P011212,11.3,-2,28,30
155,MCO,P010588,P011226,27.767,3,66,63
155,MCO,P010588,P011231,6.65,0,16,16
155,MCO,P010588,P012709,18.517,7,46,39
155,MCO,P010588,PLCZ,7.634,-5,13,18
155,MCO,P011196,P011212,13.117,-8,24,32
155,MCO,P011196,P011226,7.383,-4,15,19
155,MCO,P011196,P011231,9.034,-10,12,22
155,MCO,P011196,P012709,1.867,2,4,2
155,MCO,P011212,P011226,14.133,-6,34,40
155,MCO,P011212,P011231,16.584,-10,31,41
155,MCO,P011212,P012709,7.767,4,20,16
155,MCO,P011212,PLCZ,0.567,-4,0,4
155,MCO,P011226,P011231,10.416,-5,24,29
155,MCO,P011226,P012709,18.083,8,48,40
155,MCO,P011226,PLCZ,8.567,-6,15,21
155,MCO,P011231,P012709,8.7,3,22,19
155,MCO,P011231,PLCZ,0.933,-1,2,3
155,MCO,P012709,PLCZ,2.783,0,7,7
155,TEL,P004233,P005145,3.434,1,7,6
155,TEL,P004233,P009622,6.767,4,17,13
155,TEL,P004233,P009783,0.317,2,2,0
155,TEL,P004233,P009863,2.284,3,6,3
155,TEL,P004233,P011193,8.734,5,21,16
155,TEL,P004233,P011214,4.517,2,10,8
155,TEL,P004233,P011219,3.9,1,9,8
155,TEL,P004233,P011971,4.983,2,12,10
155,TEL,P005145,P009622,2.884,-1,3,4
155,TEL,P005145,P009783,1.417,-1,0,1
155,TEL,P005145,P009863,3.384,0,4,4
155,TEL,P005145,P011193,3.434,1,7,6
155,TEL,P005145,P011214,4.851,0,7,7
155,TEL,P009622,P009783,24.984,8,62,54
155,TEL,P009622,P009863,21.05,3,50,47
155,TEL,P009622,P011193,13.684,1,34,33
155,TEL,P009622,P011199,20.5,-4,48,52
155,TEL,P009622,P011214,7.134,11,17,6
155,TEL,P009622,P011219,23.95,12,60,48
155,TEL,P009622,P011971,12.483,-3,29,32
155,TEL,P009622,P012744,0.9,-7,0,7
155,TEL,P009783,P009863,20.7,6,50,44
155,TEL,P009783,P011193,5.084,3,16,13
155,TEL,P009783,P011199,19.6,3,48,45
155,TEL,P009783,P011214,3.334,7,8,1
155,TEL,P009783,P011219,18.8,8,48,40
155,TEL,P009783,P011971,5.7,-4,14,18
155,TEL,P009863,P011193,7.567,2,17,15
155,TEL,P009863,P011199,18.833,3,46,43
155,TEL,P009863,P011214,7.834,3,13,10
155,TEL,P009863,P011219,14.516,6,36,30
155,TEL,P009863,P011971,8.9,2,21,19
155,TEL,P009863,P012744,4.8,0,9,9
155,TEL,P011193,P011199,2.017,-10,2,12
155,TEL,P011193,P011214,12.134,16,30,14
155,TEL,P011193,P011219,9.917,5,26,21
155,TEL,P011193,P011971,12.483,1,26,25
155,TEL,P011193,P012744,5.35,-4,9,13
155,TEL,P011199,P011219,15.15,4,36,32
155,TEL,P011199,P011971,5.0,-5,12,17
155,TEL,P011199,P012744,0.9,-7,0,7
155,TEL,P011214,P011219,3.167,11,11,0
155,TEL,P011214,P011971,6.783,7,15,8
155,TEL,P011214,P012744,4.45,3,9,6
155,TEL,P011219,P011971,6.4,1,14,13
155,TEL,P011971,P012744,5.0,-1,9,10
156,MIL,P002812,P002849,8.233,4,17,13
156,MIL,P002812,P005670,16.533,4,37,33
156,MIL,P002812,P006509,14.866,3,31,28
156,MIL,P002812,P006701,6.016,5,15,10
156,MIL,P002812,P007201,9.15,3,17,14
156,MIL,P002812,P009960,5.85,4,15,11
156,MIL,P002812,P011205,12.4,6,27,21
156,MIL,P002812,P011224,13.016,7,29,22
156,MIL,P002849,P005670,7.8,1,18,17
156,MIL,P002849,P006509,16.584,-2,28,30
156,MIL,P002849,P006701,6.933,4,16,12
156,MIL,P002849,P007201,13.701,-13,15,28
156,MIL,P002849,P009960,5.467,3,12,9
156,MIL,P002849,P011205,14.617,-13,18,31
156,MIL,P002849,P011224,25.734,-8,42,50
156,MIL,P002849,P011926,3.867,-8,2,10
156,MIL,P005670,P006509,16.05,-2,32,34
156,MIL,P005670,P006701,2.75,2,7,5
156,MIL,P005670,P007201,11.833,-1,24,25
156,MIL,P005670,P009960,5.75,0,13,13
156,MIL,P005670,P011205,11.716,2,27,25
156,MIL,P005670,P011224,11.5,2,26,24
156,MIL,P006509,P006701,6.633,8,17,9
156,MIL,P006509,P007201,16.533,-8,28,36
156,MIL,P006509,P009960,8.167,5,19,14
156,MIL,P006509,P011205,12.2,-9,17,26
156,MIL,P006509,P011224,21.367,1,40,39
156,MIL,P006701,P009960,8.583,7,23,16
156,MIL,P006701,P011205,4.133,0,10,10
156,MIL,P006701,P011224,8.016,6,20,14
156,MIL,P007201,P009960,0.983,-2,2,4
156,MIL,P007201,P011205,15.0,-15,17,32
156,MIL,P007201,P011224,17.401,-12,23,35
156,MIL,P007201,P011926,3.867,-8,2,10
156,MIL,P009960,P011205,7.85,-2,16,18
156,MIL,P009960,P011224,6.55,5,16,11
156,MIL,P011205,P011224,14.617,-13,18,31
156,MIL,P011205,P011926,3.867,-8,2,10
156,MIL,P011224,P011926,3.867,-8,2,10
156,OLY,P001255,P003941,5.216,-11,5,16
156,OLY,P001255,P007982,7.183,-4,15,19
156,OLY,P001255,P008811,14.784,18,36,18
156,OLY,P001255,P008829,20.0,7,41,34
156,OLY,P001255,P008855,15.05,6,29,23
156,OLY,P001255,P010612,17.767,12,38,26
156,OLY,P003941,P007853,6.667,4,13,9
156,OLY,P003941,P007982,15.683,-12,27,39
156,OLY,P003941,P008829,11.666,-20,16,36
156,OLY,P003941,P008855,4.883,-9,5,14
156,OLY,P003941,P010392,13.117,-5,24,29
156,OLY,P003941,P010612,9.433,-15,13,28
156,OLY,P003941,P011194,6.667,4,13,9
156,OLY,P007853,P007982,8.65,5,16,11
156,OLY,P007853,P008811,6.817,3,14,11
156,OLY,P007853,P008829,3.583,1,5,4
156,OLY,P007853,P008855,8.417,3,16,13
156,OLY,P007853,P010392,8.134,5,16,11
156,OLY,P007853,P010612,1.867,1,6,5
156,OLY,P007853,P011194,10.001,6,22,16
156,OLY,P007982,P008811,6.617,4,15,11
156,OLY,P007982,P008829,17.183,-12,31,43
156,OLY,P007982,P008855,5.783,-4,8,12
156,OLY,P007982,P010392,11.567,-5,22,27
156,OLY,P007982,P010612,11.417,-8,23,31
156,OLY,P007982,P011194,5.117,4,11,7
156,OLY,P008811,P008829,18.334,19,41,22
156,OLY,P008811,P008855,18.551,18,40,22
156,OLY,P008811,P010392,1.467,1,3,2
156,OLY,P008811,P010612,16.618,19,42,23
156,OLY,P008811,P011194,3.284,2,9,7
156,OLY,P008829,P008855,18.65,7,34,27
156,OLY,P008829,P010392,6.45,-9,11,20
156,OLY,P008829,P010612,24.284,3,49,46
156,OLY,P008829,P011194,0.05,0,0,0
156,OLY,P008855,P010392,3.017,1,5,4
156,OLY,P008855,P010612,14.701,12,32,20
156,OLY,P008855,P011194,4.884,2,11,9
156,OLY,P010392,P010612,6.45,-9,11,20
156,OLY,P010392,P011194,8.134,5,16,11
156,OLY,P010612,P011194,1.867,1,6,5
157,ASV,P000229,P003526,11.317,2,24,22
157,ASV,P000229,P004194,1.883,0,7,7
157,ASV,P000229,P006568,1.583,2,5,3
157,ASV,P000229,P011225,12.533,6,30,24
157,ASV,P000229,P012080,6.417,0,13,13
157,ASV,P000229,P012729,18.933,6,43,37
157,ASV,P000229,P012730,13.4,1,26,25
157,ASV,P000229,PKIR,9.666,7,24,17
157,ASV,P003526,P004194,0.533,-2,0,2
157,ASV,P003526,P006568,0.533,-2,0,2
157,ASV,P003526,P011225,9.45,1,27,26
157,ASV,P003526,P012080,9.733,1,25,24
157,ASV,P003526,P012729,14.717,4,38,34
157,ASV,P003526,P012730,9.25,-1,19,20
157,ASV,P003526,PKIR,5.467,5,19,14
157,ASV,P004194,P006568,13.633,-16,18,34
157,ASV,P004194,P011225,19.549,-21,27,48
157,ASV,P004194,P012080,17.666,-21,20,41
157,ASV,P004194,P012729,5.916,-5,9,14
157,ASV,P004194,PKIR,19.016,-19,27,46
157,ASV,P006568,P011225,15.216,-14,23,37
157,ASV,P006568,P012080,13.633,-16,18,34
157,ASV,P006568,P012729,1.583,2,5,3
157,ASV,P006568,PKIR,14.683,-12,23,35
157,ASV,P011225,P012080,21.083,-19,34,53
157,ASV,P011225,P012729,19.966,3,46,43
157,ASV,P011225,P012730,9.067,4,18,14
157,ASV,P011225,PKIR,27.532,-12,51,63
157,ASV,P012080,P012729,13.85,-3,29,32
157,ASV,P012080,P012730,4.35,-3,8,11
157,ASV,P012080,PKIR,23.2,-15,41,56
157,ASV,P012729,P012730,13.4,1,26,25
157,ASV,P012729,PKIR,17.099,4,40,36
157,ASV,P012730,PKIR,4.133,2,7,5
157,PAR,P000956,P004058,12.95,-16,21,37
157,PAR,P000956,P004172,3.4,-2,12,14
157,PAR,P000956,P007400,9.55,-14,9,23
157,PAR,P000956,P009212,13.4,3,31,28
157,PAR,P000956,P009862,7.05,10,19,9
157,PAR,P000956,P011050,6.6,-9,9,18
157,PAR,P000956,P011192,7.05,10,19,9
157,PAR,P000956,P012096,10.0,5,19,14
157,PAR,P000956,P012743,10.0,-11,21,32
157,PAR,P004058,P004172,3.4,-2,12,14
157,PAR,P004058,P007400,19.316,-4,34,38
157,PAR,P004058,P009212,7.933,-8,16,24
157,PAR,P004058,P009862,1.0,-5,0,5
157,PAR,P004058,P011050,6.6,-9,9,18
157,PAR,P004058,P011051,8.133,11,21,10
157,PAR,P004058,P011192,8.816,15,25,10
157,PAR,P004058,P012096,4.533,-6,4,10
157,PAR,P004058,P012742,0.05,0,0,0
157,PAR,P004058,P012743,18.133,0,42,42
157,PAR,P004172,P009212,11.267,4,30,26
157,PAR,P004172,P009862,7.867,6,18,12
157,PAR,P004172,P012096,7.867,6,18,12
157,PAR,P004172,P012742,7.867,6,18,12
157,PAR,P004172,P012743,3.4,-2,12,14
157,PAR,P007400,P009212,4.533,-6,4,10
157,PAR,P007400,P009862,2.767,-3,4,7
157,PAR,P007400,P011050,6.6,-9,9,18
157,PAR,P007400,P011051,9.9,13,25,12
157,PAR,P007400,P011192,10.583,17,29,12
157,PAR,P007400,P012096,4.533,-6,4,10
157,PAR,P007400,P012742,0.05,0,0,0
157,PAR,P007400,P012743,16.5,4,34,30
157,PAR,P009212,P009862,15.867,11,37,26
157,PAR,P009212,P011192,7.683,14,23,9
157,PAR,P009212,P012096,19.45,10,41,31
157,PAR,P009212,P012742,7.867,6,18,12
157,PAR,P009212,P012743,3.4,-2,12,14
157,PAR,P009862,P011051,2.367,3,7,4
157,PAR,P009862,P011192,9.467,13,26,13
157,PAR,P009862,P012096,16.467,12,40,28
157,PAR,P009862,P012742,8.517,7,21,14
157,PAR,P009862,P012743,1.767,2,4,2
157,PAR,P011050,P012743,6.6,-9,9,18
157,PAR,P011051,P011192,10.5,14,28,14
157,PAR,P011051,P012096,0.6,1,3,2
157,PAR,P011051,P012742,0.6,1,3,2
157,PAR,P011051,P012743,9.9,13,25,12
157,PAR,P011192,P012096,8.283,15,26,11
157,PAR,P011192,P012742,0.65,1,3,2
157,PAR,P011192,P012743,9.9,13,25,12
157,PAR,P012096,P012742,8.467,7,21,14
158,BER,P003958,P006251,2.1,0,2,2
158,BER,P003958,P007025,5.866,-4,6,10
158,BER,P003958,P008173,24.499,-8,45,53
158,BER,P003958,P008211,6.084,7,16,9
158,BER,P003958,P008967,12.033,3,22,19
158,BER,P003958,P011934,28.116,3,59,56
158,BER,P003958,P012720,27.633,2,59,57
158,BER,P003958,P012721,15.333,1,35,34
158,BER,P006251,P007025,7.433,-5,5,10
158,BER,P006251,P008173,1.633,0,2,2
158,BER,P006251,P008211,10.05,-7,10,17
158,BER,P006251,P008967,10.3,-8,8,16
158,BER,P006251,P010791,8.2,-8,6,14
158,BER,P006251,P011934,1.383,1,4,3
158,BER,P006251,P012720,4.25,-2,7,9
158,BER,P006251,P012721,1.383,1,4,3
158,BER,P007025,P008173,5.266,-4,6,10
158,BER,P007025,P008211,6.683,-7,3,10
158,BER,P007025,P008967,8.533,-8,5,13
158,BER,P007025,P010791,6.083,-7,3,10
158,BER,P007025,P011934,4.516,-6,4,10
158,BER,P007025,P012720,3.416,-3,4,7
158,BER,P008173,P008211,0.167,-2,0,2
158,BER,P008173,P008967,6.249,-6,6,12
158,BER,P008173,P011934,22.666,-6,43,49
158,BER,P008173,P012720,22.183,-7,43,50
158,BER,P008173,P012721,15.333,1,35,34
158,BER,P008211,P008967,13.984,1,22,21
158,BER,P008211,P010791,8.2,-8,6,14
158,BER,P008211,P011934,6.833,10,20,10
158,BER,P008211,P012720,9.117,7,23,16
158,BER,P008211,P012721,1.55,-1,4,5
158,BER,P008967,P010791,8.2,-8,6,14
158,BER,P008967,P011934,9.9,3,20,17
158,BER,P008967,P012720,11.367,3,23,20
158,BER,P008967,P012721,0.366,0,0,0
158,BER,P010791,P012720,2.117,-1,3,4
158,BER,P011934,P012720,28.066,7,63,56
158,BER,P011934,P012721,16.516,4,39,35
158,BER,P012720,P012721,16.383,2,39,37
158,ZAL,P002329,P003210,13.334,2,26,24
158,ZAL,P002329,P003211,13.934,10,22,12
158,ZAL,P002329,P005504,11.867,-4,27,31
158,ZAL,P002329,P007109,10.851,-6,11,17
158,ZAL,P002329,P007513,0.3,0,0,0
158,ZAL,P002329,P009917,16.151,2,38,36
158,ZAL,P002329,P010390,12.634,12,28,16
158,ZAL,P002329,P011218,27.369,8,56,48
158,ZAL,P002329,P012715,6.05,3,19,16
158,ZAL,P002329,P012787,3.45,1,9,8
158,ZAL,P003210,P003211,15.534,3,22,19
158,ZAL,P003210,P005504,4.517,-2,12,14
158,ZAL,P003210,P007109,2.134,3,4,1
158,ZAL,P003210,P009917,9.284,-5,20,25
158,ZAL,P003210,P010390,17.7,0,28,28
158,ZAL,P003210,P011218,16.318,2,33,31
158,ZAL,P003210,P012715,12.4,-2,21,23
158,ZAL,P003210,P012787,6.183,3,10,7
158,ZAL,P003211,P005504,3.8,-4,4,8
158,ZAL,P003211,P007109,6.4,1,8,7
158,ZAL,P003211,P007513,0.3,0,0,0
158,ZAL,P003211,P009917,6.967,2,12,10
158,ZAL,P003211,P010390,14.784,13,26,13
158,ZAL,P003211,P011218,16.118,10,28,18
158,ZAL,P003211,P012715,9.934,1,16,15
158,ZAL,P003211,P012787,4.233,4,6,2
158,ZAL,P005504,P007109,5.867,-7,5,12
158,ZAL,P005504,P009917,6.934,-3,18,21
158,ZAL,P005504,P011218,14.184,-6,31,37
158,ZAL,P005504,P012715,6.117,1,18,17
158,ZAL,P005504,P012787,3.45,1,9,8
158,ZAL,P007109,P009917,4.834,-6,4,10
158,ZAL,P007109,P010390,0.5,2,2,0
158,ZAL,P007109,P011218,10.951,-4,13,17
158,ZAL,P007109,P012715,0.1,2,2,0
158,ZAL,P007109,P012787,2.167,-1,3,4
158,ZAL,P007513,P009917,0.233,0,0,0
158,ZAL,P007513,P010390,0.3,0,0,0
158,ZAL,P007513,P011218,0.067,0,0,0
158,ZAL,P009917,P010390,9.017,3,20,17
158,ZAL,P009917,P011218,14.535,3,35,32
158,ZAL,P009917,P012715,6.317,-4,13,17
158,ZAL,P010390,P011218,12.968,12,29,17
158,ZAL,P010390,P012715,10.85,-1,17,18
158,ZAL,P010390,P012787,6.183,3,10,7
158,ZAL,P011218,P012715,9.034,3,26,23
158,ZAL,P011218,P012787,5.4,0,13,13
158,ZAL,P012715,P012787,7.466,5,16,11
159,BAR,P000925,P002939,17.9,5,37,32
159,BAR,P000925,P003204,0.333,3,3,0
159,BAR,P000925,P004866,25.417,10,56,46
159,BAR,P000925,P006435,12.184,3,28,25
159,BAR,P000925,P007464,2.9,4,4,0
159,BAR,P000925,P007519,10.35,6,26,20
159,BAR,P000925,P009992,3.366,5,10,5
159,BAR,P000925,P011244,8.883,3,22,19
159,BAR,P000925,P012745,26.667,9,58,49
159,BAR,P002939,P003196,8.15,-7,11,18
159,BAR,P002939,P003204,0.333,3,3,0
159,BAR,P002939,P004866,19.067,2,36,34
159,BAR,P002939,P006435,13.017,-8,20,28
159,BAR,P002939,P007464,11.05,-3,15,18
159,BAR,P002939,P007519,5.167,-3,7,10
159,BAR,P002939,P009992,1.583,2,5,3
159,BAR,P002939,P011244,8.883,3,22,19
159,BAR,P002939,P012745,19.05,-2,36,38
159,BAR,P003196,P004866,5.683,0,11,11
159,BAR,P003196,P006435,12.983,-7,22,29
159,BAR,P003196,P007464,12.983,-7,22,29
159,BAR,P003196,P007519,8.75,-2,16,18
159,BAR,P003196,P011244,0.033,0,0,0
159,BAR,P003196,P012745,3.35,-5,6,11
159,BAR,P003204,P006435,0.017,0,0,0
159,BAR,P003204,P007464,0.017,0,0,0
159,BAR,P003204,P007519,0.017,0,0,0
159,BAR,P003204,P009992,0.333,3,3,0
159,BAR,P003204,P011244,0.35,3,3,0
159,BAR,P004866,P006435,17.867,3,39,36
159,BAR,P004866,P007464,8.583,4,15,11
159,BAR,P004866,P007519,12.033,8,31,23
159,BAR,P004866,P009992,1.783,3,5,2
159,BAR,P004866,P011244,8.55,0,19,19
159,BAR,P004866,P012745,25.417,10,56,46
159,BAR,P006435,P007464,13.0,-7,22,29
159,BAR,P006435,P007519,16.084,2,35,33
159,BAR,P006435,P011244,0.05,0,0,0
159,BAR,P006435,P012745,15.534,-2,34,36
159,BAR,P007464,P007519,8.767,-2,16,18
159,BAR,P007464,P011244,0.05,0,0,0
159,BAR,P007464,P012745,6.25,-1,10,11
159,BAR,P007519,P009992,3.033,2,7,5
159,BAR,P007519,P011244,0.05,0,0,0
159,BAR,P007519,P012745,12.217,5,30,25
159,BAR,P009992,P011244,0.333,3,3,0
159,BAR,P009992,P012745,3.033,2,7,5
159,BAR,P011244,P012745,8.55,0,19,19
159,MAD,P001392,P003108,12.883,6,33,27
159,MAD,P001392,P003733,0.5,0,0,0
159,MAD,P001392,P004887,10.199,-1,22,23
159,MAD,P001392,P005791,5.7,5,16,11
159,MAD,P001392,P005928,6.117,6,19,13
159,MAD,P001392,P006540,6.65,0,18,18
159,MAD,P001392,P009213,6.549,-2,13,15
159,MAD,P001392,PCVM,9.266,0,19,19
159,MAD,P001392,PTGB,5.8,2,12,10
159,MAD,P003108,P003733,8.0,-3,8,11
159,MAD,P003108,P004887,12.65,-6,24,30
159,MAD,P003108,P005791,16.25,-3,27,30
159,MAD,P003108,P005928,16.384,-8,27,35
159,MAD,P003108,P006540,18.234,-10,31,41
159,MAD,P003108,P009213,4.933,-3,8,11
159,MAD,P003108,PCVM,12.0,1,24,23
159,MAD,P003108,PTGB,14.334,-10,22,32
159,MAD,P003733,P004887,0.5,0,0,0
159,MAD,P003733,P005791,14.967,3,30,27
159,MAD,P003733,P005928,14.967,3,30,27
159,MAD,P003733,P006540,14.967,3,30,27
159,MAD,P003733,P009213,7.467,6,22,16
159,MAD,P003733,PTGB,0.5,0,0,0
159,MAD,P004887,P005928,2.217,-4,3,7
159,MAD,P004887,P006540,9.9,-10,17,27
159,MAD,P004887,P009213,3.066,-4,5,9
159,MAD,P004887,PCVM,12.933,-2,26,28
159,MAD,P004887,PTGB,11.267,-5,19,24
159,MAD,P005791,P005928,23.467,3,49,46
159,MAD,P005791,P006540,19.4,4,41,37
159,MAD,P005791,P009213,12.95,5,30,25
159,MAD,P005791,PCVM,0.833,0,0,0
159,MAD,P005791,PTGB,3.633,-5,3,8
159,MAD,P005928,P006540,21.617,0,44,44
159,MAD,P005928,P009213,13.367,6,33,27
159,MAD,P005928,PTGB,4.6,-10,3,13
159,MAD,P006540,P009213,11.116,2,27,25
159,MAD,P006540,PCVM,7.667,-4,14,18
159,MAD,P006540,PTGB,7.717,-9,10,19
159,MAD,P009213,PCVM,2.616,-3,2,5
159,MAD,P009213,PTGB,2.0,-3,0,3
159,MAD,PCVM,PTGB,9.817,0,19,19
160,BAS,P003198,P004761,8.217,10,22,12
160,BAS,P003198,P007230,8.217,10,22,12
160,BAS,P003198,P009048,1.15,1,1,0
160,BAS,P003198,P011948,1.667,-3,1,4
160,BAS,P003198,P012201,6.55,13,21,8
160,BAS,P003198,P012765,7.067,9,21,12
160,BAS,P004603,P004761,4.75,-6,2,8
160,BAS,P004603,P007230,4.75,-6,2,8
160,BAS,P004603,P008850,4.75,-6,2,8
160,BAS,P004603,P009048,4.75,-6,2,8
160,BAS,P004761,P007230,24.551,-1,42,43
160,BAS,P004761,P008072,3.65,4,9,5
160,BAS,P004761,P008850,8.133,-5,7,12
160,BAS,P004761,P009048,18.667,-6,25,31
160,BAS,P004761,P010444,11.517,-12,16,28
160,BAS,P004761,P011085,1.317,-2,2,4
160,BAS,P004761,P011948,10.55,-9,16,25
160,BAS,P004761,P012201,15.55,9,37,28
160,BAS,P004761,P012765,10.234,2,26,24
160,BAS,P007230,P008850,9.266,-7,7,14
160,BAS,P007230,P009048,21.334,4,37,33
160,BAS,P007230,P010444,17.617,0,34,34
160,BAS,P007230,P011085,1.317,-2,2,4
160,BAS,P007230,P011948,13.0,-1,25,26
160,BAS,P007230,P012201,16.867,19,46,27
160,BAS,P007230,P012765,10.017,0,23,23
160,BAS,P008072,P009048,2.3,4,6,2
160,BAS,P008072,P011085,0.317,-2,0,2
160,BAS,P008072,P011948,3.967,2,9,7
160,BAS,P008072,P012201,3.967,2,9,7
160,BAS,P008072,P012765,1.667,-2,3,5
160,BAS,P008850,P009048,6.85,-3,5,8
160,BAS,P008850,P010444,4.816,1,7,6
160,BAS,P008850,P011948,1.433,0,2,2
160,BAS,P008850,P012201,0.683,2,2,0
160,BAS,P008850,P012765,2.333,-2,4,6
160,BAS,P009048,P010444,15.367,2,32,30
160,BAS,P009048,P011085,1.317,-2,2,4
160,BAS,P009048,P011948,14.733,2,31,29
160,BAS,P009048,P012201,12.4,8,31,23
160,BAS,P010444,P011085,4.234,-1,6,7
160,BAS,P010444,P011948,14.483,-2,28,30
160,BAS,P010444,P012201,13.467,2,29,27
160,BAS,P010444,P012765,6.167,-6,8,14
160,BAS,P011085,P011948,3.234,-1,4,5
160,BAS,P011085,P012201,3.234,-1,4,5
160,BAS,P011085,P012765,3.234,-1,4,5
160,BAS,P011948,P012201,15.467,5,35,30
160,BAS,P011948,P012765,6.534,-5,9,14
160,BAS,P012201,P012765,12.351,9,30,21
160,PAN,P001926,P002328,11.401,-4,23,27
160,PAN,P001926,P003842,19.834,-6,38,44
160,PAN,P001926,P007866,15.868,-4,32,36
160,PAN,P001926,P007947,2.95,-7,4,11
160,PAN,P001926,P011204,11.534,-6,20,26
160,PAN,P001926,P011221,0.217,-2,0,2
160,PAN,P001926,P012712,5.5,-6,6,12
160,PAN,P001926,P012774,15.768,-5,29,34
160,PAN,P002328,P003842,16.033,-6,27,33
160,PAN,P002328,P007553,3.2,1,3,2
160,PAN,P002328,P007866,21.251,12,49,37
160,PAN,P002328,P007947,8.033,-10,8,18
160,PAN,P002328,P011204,16.917,10,37,27
160,PAN,P002328,P011221,10.134,11,25,14
160,PAN,P002328,P012712,9.933,-7,11,18
160,PAN,P002328,P012774,25.634,9,49,40
160,PAN,P003842,P007866,18.617,-3,36,39
160,PAN,P003842,P007947,4.116,-8,4,12
160,PAN,P003842,P011204,14.4,-7,24,31
160,PAN,P003842,P012712,6.183,-9,6,15
160,PAN,P003842,P012774,20.017,-9,33,42
160,PAN,P007553,P007947,3.2,1,3,2
160,PAN,P007553,P012712,3.2,1,3,2
160,PAN,P007553,P012774,3.2,1,3,2
160,PAN,P007866,P007947,1.867,-2,5,7
160,PAN,P007866,P011204,26.284,4,52,48
160,PAN,P007866,P011221,10.134,11,25,14
160,PAN,P007866,P012712,1.15,1,2,1
160,PAN,P007866,P012774,27.301,5,55,50
160,PAN,P007947,P011204,0.6,-1,1,2
160,PAN,P007947,P012712,6.166,-8,3,11
160,PAN,P007947,P012774,5.2,-5,4,9
160,PAN,P011204,P011221,10.134,11,25,14
160,PAN,P011204,P012712,1.15,1,2,1
160,PAN,P011204,P012774,24.117,4,47,43
160,PAN,P011221,P012774,9.917,13,25,12
160,PAN,P012712,P012774,8.85,-1,11,12
161,IST,P006590,P007200,24.934,9,58,49
161,IST,P006590,P009513,3.1,0,8,8
161,IST,P006590,P009846,19.217,4,44,40
161,IST,P006590,P011078,17.634,1,42,41
161,IST,P006590,P011981,13.0,-2,29,31
161,IST,P006590,P012786,9.55,3,25,22
161,IST,P006590,P012788,16.384,0,33,33
161,IST,P006590,PLHK,23.117,9,53,44
161,IST,P007200,P009846,23.784,-4,52,56
161,IST,P007200,P011078,19.101,-7,42,49
161,IST,P007200,P011981,16.6,-7,34,41
161,IST,P007200,P012786,3.817,4,12,8
161,IST,P007200,P012788,18.034,-2,37,39
161,IST,P007200,PLHK,26.534,-1,57,58
161,IST,P009513,P011078,3.1,0,8,8
161,IST,P009513,P011981,3.1,0,8,8
161,IST,P009513,P012786,3.1,0,8,8
161,IST,P009846,P011078,13.384,-12,28,40
161,IST,P009846,P011981,8.9,-9,16,25
161,IST,P009846,P012786,6.684,0,16,16
161,IST,P009846,P012788,16.184,-7,32,39
161,IST,P009846,PLHK,21.783,0,48,48
161,IST,P011078,P011981,17.9,-3,39,42
161,IST,P011078,P012786,8.7,-4,20,24
161,IST,P011078,P012788,6.851,-18,9,27
161,IST,P011078,PLHK,16.934,3,40,37
161,IST,P011981,P012786,5.0,-1,13,14
161,IST,P011981,P012788,2.45,-5,4,9
161,IST,P011981,PLHK,11.85,-1,25,26
161,IST,P012786,P012788,3.034,-2,7,9
161,IST,P012786,PLHK,2.583,4,7,3
161,IST,P012788,PLHK,13.667,-2,26,28
161,PAM,P003960,P004863,12.583,5,35,30
161,PAM,P003960,P005356,5.75,4,15,11
161,PAM,P003960,P007870,18.768,10,51,41
161,PAM,P003960,P010568,14.535,4,36,32
161,PAM,P003960,P011970,13.534,5,36,31
161,PAM,P003960,P011982,10.034,10,31,21
161,PAM,P003960,P012739,4.433,-1,10,11
161,PAM,P003960,P012795,13.167,-1,30,31
161,PAM,P004863,P005356,3.467,1,10,9
161,PAM,P004863,P007870,9.784,11,32,21
161,PAM,P004863,P010568,4.317,2,12,10
161,PAM,P004863,P011970,7.866,4,22,18
161,PAM,P004863,P011982,6.3,8,20,12
161,PAM,P004863,P012738,3.517,0,9,9
161,PAM,P004863,P012739,6.633,-4,14,18
161,PAM,P004863,P012795,11.533,1,30,29
161,PAM,P005356,P007870,5.784,-1,10,11
161,PAM,P005356,P010568,11.301,-1,24,25
161,PAM,P005356,P011982,10.368,-6,24,30
161,PAM,P005356,P012738,8.684,-4,19,23
161,PAM,P005356,P012739,7.6,2,22,20
161,PAM,P005356,P012740,1.217,-1,2,3
161,PAM,P005356,P012795,4.233,6,10,4
161,PAM,P007870,P010568,14.435,1,33,32
161,PAM,P007870,P011970,10.284,11,33,22
161,PAM,P007870,P011982,9.034,9,28,19
161,PAM,P007870,P012738,0.9,-2,0,2
161,PAM,P007870,P012795,10.951,1,25,24
161,PAM,P010568,P011970,6.134,5,18,13
161,PAM,P010568,P011982,19.185,-1,42,43
161,PAM,P010568,P012738,12.884,-6,21,27
161,PAM,P010568,P012739,12.084,0,24,24
161,PAM,P010568,P012740,7.684,-5,9,14
161,PAM,P010568,P012795,8.717,1,17,16
161,PAM,P011970,P011982,7.0,13,25,12
161,PAM,P011970,P012739,3.4,-4,5,9
161,PAM,P011970,P012795,6.85,-6,13,19
161,PAM,P011982,P012738,14.651,-7,27,34
161,PAM,P011982,P012739,14.751,-3,30,33
161,PAM,P011982,P012740,7.684,-5,9,14
161,PAM,P011982,P012795,1.333,2,4,2
161,PAM,P012738,P012739,14.284,-3,28,31
161,PAM,P012738,P012740,7.684,-5,9,14
161,PAM,P012738,P012795,3.0,3,7,4
161,PAM,P012739,P012740,6.467,-4,7,11
161,PAM,P012739,P012795,5.216,1,12,11
162,MUN,P001288,P003583,7.217,-1,15,16
162,MUN,P001288,P004508,13.967,2,31,29
162,MUN,P001288,P006760,1.1,0,3,3
162,MUN,P001288,P007056,5.833,5,16,11
162,MUN,P001288,P007639,2.65,0,5,5
162,MUN,P001288,P007975,13.95,2,31,29
162,MUN,P001288,P008985,1.75,2,5,3
162,MUN,P001288,P010391,14.6,4,33,29
162,MUN,P001288,P011987,1.733,2,5,3
162,MUN,P001557,P004508,0.2,-3,0,3
162,MUN,P001557,P007639,0.2,-3,0,3
162,MUN,P001557,P007975,0.2,-3,0,3
162,MUN,P001557,P010391,0.2,-3,0,3
162,MUN,P003583,P004508,11.818,-4,25,29
162,MUN,P003583,P006543,2.867,0,7,7
162,MUN,P003583,P006760,14.417,4,32,28
162,MUN,P003583,P007056,17.9,-5,30,35
162,MUN,P003583,P007975,8.767,0,20,20
162,MUN,P003583,P008985,19.284,-4,34,38
162,MUN,P003583,P010391,13.701,-6,24,30
162,MUN,P003583,P011987,16.233,0,29,29
162,MUN,P004508,P006760,1.167,2,5,3
162,MUN,P004508,P007056,10.367,0,24,24
162,MUN,P004508,P007639,1.117,-5,0,5
162,MUN,P004508,P007975,15.484,0,36,36
162,MUN,P004508,P008985,3.284,-4,5,9
162,MUN,P004508,P010391,17.668,-4,38,42
162,MUN,P006543,P006760,2.867,0,7,7
162,MUN,P006543,P008985,2.867,0,7,7
162,MUN,P006543,P011987,2.867,0,7,7
162,MUN,P006760,P007056,11.3,-1,20,21
162,MUN,P006760,P007639,0.917,-3,0,3
162,MUN,P006760,P007975,1.4,2,5,3
162,MUN,P006760,P008985,13.934,-1,27,28
162,MUN,P006760,P010391,0.067,2,2,0
162,MUN,P006760,P011987,14.167,-1,27,28
162,MUN,P007056,P007639,3.267,0,8,8
162,MUN,P007056,P007975,7.333,4,19,15
162,MUN,P007056,P008985,19.667,-4,35,39
162,MUN,P007056,P010391,15.7,1,34,33
162,MUN,P007056,P011987,16.633,0,30,30
162,MUN,P007639,P007975,1.117,-5,0,5
162,MUN,P007639,P008985,5.0,2,13,11
162,MUN,P007639,P010391,5.2,0,13,13
162,MUN,P007639,P011987,5.0,2,13,11
162,MUN,P007975,P010391,14.384,0,33,33
162,MUN,P007975,P011987,0.233,0,0,0
162,MUN,P008985,P010391,10.35,-1,20,21
162,MUN,P008985,P011987,21.0,2,42,40
162,MUN,P010391,P011987,7.066,3,15,12
162,VIR,P001133,P001844,23.533,4,48,44
162,VIR,P001133,P002084,5.066,-6,6,12
162,VIR,P001133,P003048,17.033,1,34,33
162,VIR,P001133,P003527,7.683,-7,15,22
162,VIR,P001133,P004554,8.383,6,26,20
162,VIR,P001133,P006739,8.183,-4,20,24
162,VIR,P001133,P009549,21.55,4,44,40
162,VIR,P001133,P010781,18.483,-6,40,46
162,VIR,P001133,PBCN,16.95,8,39,31
162,VIR,P001844,P002084,4.033,3,8,5
162,VIR,P001844,P003048,19.683,1,39,38
162,VIR,P001844,P003527,5.749,-3,10,13
162,VIR,P001844,P004554,6.816,6,18,12
162,VIR,P001844,P006739,0.883,-3,0,3
162,VIR,P001844,P009549,23.25,7,50,43
162,VIR,P001844,P010781,12.95,-2,25,27
162,VIR,P001844,PBCN,19.299,7,42,35
162,VIR,P002084,P003048,3.05,7,9,2
162,VIR,P002084,P003527,2.533,-4,3,7
162,VIR,P002084,P006739,4.083,-2,7,9
162,VIR,P002084,P009549,2.533,-2,3,5
162,VIR,P002084,P010781,5.583,3,12,9
162,VIR,P002084,PBCN,5.583,5,12,7
162,VIR,P003048,P003527,2.883,-4,3,7
162,VIR,P003048,P006739,1.55,2,4,2
162,VIR,P003048,P009549,14.767,0,29,29
162,VIR,P003048,P010781,13.383,1,26,25
162,VIR,P003048,PBCN,12.583,4,28,24
162,VIR,P003527,P004554,6.283,-3,15,18
162,VIR,P003527,P006739,8.05,-12,13,25
162,VIR,P003527,P009549,3.483,5,10,5
162,VIR,P003527,P010781,8.55,-14,13,27
162,VIR,P003527,PBCN,6.45,-6,10,16
162,VIR,P004554,P006739,6.533,-3,16,19
162,VIR,P004554,P009549,6.216,10,19,9
162,VIR,P004554,P010781,6.75,-1,19,20
162,VIR,P004554,PBCN,8.883,9,23,14
162,VIR,P006739,P009549,0.283,1,1,0
162,VIR,P006739,P010781,10.95,-3,25,28
162,VIR,P006739,PBCN,6.817,0,14,14
162,VIR,P009549,P010781,8.317,-2,16,18
162,VIR,P009549,PBCN,13.733,9,32,23
162,VIR,P010781,PBCN,10.634,4,24,20
163,PAR,P000956,P007400,13.817,-9,29,38
163,PAR,P000956,P009862,12.033,0,28,28
163,PAR,P000956,P011051,6.917,-9,8,17
163,PAR,P000956,P011192,11.0,-4,26,30
163,PAR,P000956,P012096,4.167,-3,5,8
163,PAR,P000956,P012742,4.167,-3,5,8
163,PAR,P000956,P012743,8.567,0,23,23
163,PAR,P004058,P004172,3.634,-2,5,7
163,PAR,P004058,P007400,5.266,-4,8,12
163,PAR,P004058,P009862,5.266,-4,8,12
163,PAR,P004058,P011051,1.033,-6,0,6
163,PAR,P004058,P011192,3.634,-2,5,7
163,PAR,P004058,P012096,4.4,2,8,6
163,PAR,P004058,P012742,8.9,-6,13,19
163,PAR,P004058,P012743,3.467,-2,5,7
163,PAR,P004172,P007400,3.567,3,10,7
163,PAR,P004172,P009212,3.417,-1,4,5
163,PAR,P004172,P009862,7.551,-1,14,15
163,PAR,P004172,P011051,0.567,-3,0,3
163,PAR,P004172,P011192,3.634,-2,5,7
163,PAR,P004172,P012096,7.718,-1,14,15
163,PAR,P004172,P012742,11.185,-3,19,22
163,PAR,P004172,P012743,3.467,-2,5,7
163,PAR,P007400,P009212,4.567,2,7,5
163,PAR,P007400,P009862,27.899,-5,58,63
163,PAR,P007400,P011051,9.166,-21,11,32
163,PAR,P007400,P011192,12.683,-7,28,35
163,PAR,P007400,P012096,19.0,-2,35,37
163,PAR,P007400,P012742,19.6,-5,35,40
163,PAR,P007400,P012743,8.567,0,23,23
163,PAR,P009212,P009862,7.984,1,11,10
163,PAR,P009212,P012096,7.984,1,11,10
163,PAR,P009212,P012742,7.984,1,11,10
163,PAR,P009862,P011051,7.949,-15,10,25
163,PAR,P009862,P011192,12.366,-5,28,33
163,PAR,P009862,P012096,21.517,1,38,37
163,PAR,P009862,P012742,22.117,-2,38,40
163,PAR,P009862,P012743,8.25,2,23,21
163,PAR,P011051,P011192,3.183,-9,3,12
163,PAR,P011051,P012096,7.3,-10,10,20
163,PAR,P011051,P012742,7.9,-13,10,23
163,PAR,P011051,P012743,0.317,-2,0,2
163,PAR,P011192,P012096,1.85,-3,2,5
163,PAR,P011192,P012742,4.884,-2,7,9
163,PAR,P011192,P012743,12.034,-2,28,30
163,PAR,P012096,P012742,24.068,-1,41,42
163,PAR,P012742,P012743,3.467,-2,5,7
163,RED,P000848,P005099,8.967,14,25,11
163,RED,P000848,P006436,13.6,3,32,29
163,RED,P000848,P007960,11.167,8,22,14
163,RED,P000848,P009035,17.751,6,35,29
163,RED,P000848,P010985,8.134,0,11,11
163,RED,P000848,P011941,6.333,2,16,14
163,RED,P000848,P012044,11.917,-2,26,28
163,RED,P000848,PJDR,5.967,8,19,11
163,RED,P000848,PLUO,12.5,-7,18,25
163,RED,P005099,P006436,14.767,15,41,26
163,RED,P005099,P007960,7.183,5,14,9
163,RED,P005099,P009035,6.267,4,12,8
163,RED,P005099,P010985,2.367,1,3,2
163,RED,P005099,P011941,15.683,16,43,27
163,RED,P005099,P012044,15.783,11,40,29
163,RED,P005099,PJDR,16.333,13,41,28
163,RED,P005099,PLUO,0.45,1,1,0
163,RED,P006436,P007960,0.683,3,3,0
163,RED,P006436,P009035,7.75,2,18,16
163,RED,P006436,P010985,2.167,2,5,3
163,RED,P006436,P011941,18.084,10,46,36
163,RED,P006436,P012044,21.351,1,49,48
163,RED,P006436,PJDR,18.201,17,51,34
163,RED,P006436,PLUO,6.733,-5,11,16
163,RED,P007960,P009035,13.934,6,25,19
163,RED,P007960,P010985,9.351,0,13,13
163,RED,P007960,P011941,0.916,1,2,1
163,RED,P007960,P012044,4.816,4,11,7
163,RED,P007960,PJDR,4.366,2,8,6
163,RED,P007960,PLUO,6.984,-1,10,11
163,RED,P009035,P010985,9.351,0,13,13
163,RED,P009035,P012044,10.967,2,24,22
163,RED,P009035,PJDR,5.3,5,13,8
163,RED,P009035,PLUO,12.684,-5,20,25
163,RED,P010985,P011941,2.167,2,5,3
163,RED,P010985,P012044,2.167,2,5,3
163,RED,P010985,PJDR,3.384,2,7,5
163,RED,P010985,PLUO,6.984,-1,10,11
163,RED,P011941,P012044,15.2,3,36,33
163,RED,P011941,PJDR,16.584,11,43,32
163,RED,P011941,PLUO,1.033,-1,1,2
163,RED,P012044,PJDR,16.184,5,39,34
163,RED,P012044,PLUO,6.283,-6,10,16
163,RED,PJDR,PLUO,1.217,1,3,2
164,ASV,P000229,P003526,5.217,-15,2,17
164,ASV,P000229,P004194,3.134,-1,4,5
164,ASV,P000229,P006568,5.517,3,9,6
164,ASV,P000229,P011225,7.951,-1,11,12
164,ASV,P000229,P011386,0.55,-5,0,5
164,ASV,P000229,P012080,0.65,-3,0,3
164,ASV,P000229,P012729,7.334,-12,7,19
164,ASV,P000229,P012730,2.117,-7,2,9
164,ASV,P000229,PKIR,4.134,5,9,4
164,ASV,P003526,P004194,1.867,-5,0,5
164,ASV,P003526,P006568,3.166,0,6,6
164,ASV,P003526,P011225,5.6,-4,8,12
164,ASV,P003526,P011386,2.883,-2,7,9
164,ASV,P003526,P012080,4.633,3,13,10
164,ASV,P003526,P012729,9.0,-8,15,23
164,ASV,P003526,P012730,4.167,-4,9,13
164,ASV,P003526,PKIR,0.267,-1,0,1
164,ASV,P004194,P006568,19.7,22,55,33
164,ASV,P004194,P011225,25.25,22,66,44
164,ASV,P004194,P011386,1.066,-2,0,2
164,ASV,P004194,P012080,24.549,15,62,47
164,ASV,P004194,P012729,7.216,-4,11,15
164,ASV,P004194,PKIR,25.35,21,66,45
164,ASV,P006568,P011225,28.5,23,73,50
164,ASV,P006568,P012080,22.983,20,64,44
164,ASV,P006568,P012729,8.883,1,18,17
164,ASV,P006568,PKIR,25.251,23,67,44
164,ASV,P011225,P012080,27.666,22,75,53
164,ASV,P011225,P012729,15.8,0,31,31
164,ASV,P011225,P012730,1.567,-2,2,4
164,ASV,P011225,PKIR,30.134,24,78,54
164,ASV,P011386,P012080,3.116,1,7,6
164,ASV,P011386,P012729,3.666,-4,7,11
164,ASV,P011386,P012730,2.6,-2,7,9
164,ASV,P011386,PKIR,0.783,-2,0,2
164,ASV,P012080,P012729,13.499,2,31,29
164,ASV,P012080,P012730,2.05,3,7,4
164,ASV,P012080,PKIR,26.85,17,69,52
164,ASV,P012729,P012730,4.167,-4,9,13
164,ASV,P012729,PKIR,11.167,1,23,22
164,ZAL,P002329,P003210,9.683,-7,17,24
164,ZAL,P002329,P003211,8.017,-8,13,21
164,ZAL,P002329,P005504,9.566,-5,18,23
164,ZAL,P002329,P006860,4.85,-5,6,11
164,ZAL,P002329,P007109,13.25,-10,27,37
164,ZAL,P002329,P009917,3.017,3,9,6
164,ZAL,P002329,P010390,4.283,-3,8,11
164,ZAL,P002329,P011218,22.3,-13,42,55
164,ZAL,P002329,P012715,10.934,-4,24,28
164,ZAL,P002329,P012787,9.1,-12,12,24
164,ZAL,P003210,P003211,8.95,-9,15,24
164,ZAL,P003210,P005504,8.333,-12,12,24
164,ZAL,P003210,P006860,2.367,-3,4,7
164,ZAL,P003210,P007109,12.999,-13,21,34
164,ZAL,P003210,P009917,7.05,-6,13,19
164,ZAL,P003210,P010390,6.2,2,14,12
164,ZAL,P003210,P011218,9.966,-8,15,23
164,ZAL,P003210,P012715,4.783,-3,7,10
164,ZAL,P003210,P012787,1.933,-5,2,7
164,ZAL,P003211,P005504,5.133,-8,8,16
164,ZAL,P003211,P007109,15.983,-4,37,41
164,ZAL,P003211,P009917,7.6,-3,15,18
164,ZAL,P003211,P010390,5.334,3,13,10
164,ZAL,P003211,P011218,11.783,1,26,25
164,ZAL,P003211,P012715,9.199,1,20,19
164,ZAL,P003211,P012787,7.533,-1,17,18
164,ZAL,P005504,P006860,4.85,-5,6,11
164,ZAL,P005504,P007109,7.566,-10,14,24
164,ZAL,P005504,P009917,3.633,-10,2,12
164,ZAL,P005504,P011218,10.449,-8,18,26
164,ZAL,P005504,P012715,0.783,0,0,0
164,ZAL,P005504,P012787,2.483,-2,2,4
164,ZAL,P006860,P011218,4.85,-5,6,11
164,ZAL,P006860,P012787,2.483,-2,2,4
164,ZAL,P007109,P009917,12.701,-4,26,30
164,ZAL,P007109,P010390,7.634,-1,14,15
164,ZAL,P007109,P011218,21.25,-7,45,52
164,ZAL,P007109,P012715,11.517,2,30,28
164,ZAL,P007109,P012787,7.9,-1,18,19
164,ZAL,P009917,P010390,7.218,8,18,10
164,ZAL,P009917,P011218,8.834,4,18,14
164,ZAL,P009917,P012715,5.967,7,15,8
164,ZAL,P009917,P012787,3.984,5,8,3
164,ZAL,P010390,P011218,8.634,0,15,15
164,ZAL,P010390,P012715,3.067,5,10,5
164,ZAL,P010390,P012787,5.834,2,12,10
164,ZAL,P011218,P012715,15.467,10,41,31
164,ZAL,P011218,P012787,14.067,2,30,28
164,ZAL,P012715,P012787,8.683,2,25,23
165,TEL,P004233,P007990,3.467,-5,7,12
165,TEL,P004233,P011193,3.467,-5,7,12
165,TEL,P004233,P011214,3.467,-5,7,12
165,TEL,P004233,P011219,0.167,0,0,0
165,TEL,P004233,P011971,3.3,-5,7,12
165,TEL,P005145,P007990,4.2,-2,7,9
165,TEL,P005145,P009622,2.817,-2,8,10
165,TEL,P005145,P009783,3.134,0,10,10
165,TEL,P005145,P009863,2.817,-2,8,10
165,TEL,P005145,P011193,4.2,-2,7,9
165,TEL,P005145,P011199,2.817,-2,8,10
165,TEL,P005145,P011214,4.2,-2,7,9
165,TEL,P005145,P012744,3.883,-4,5,9
165,TEL,P007990,P009622,1.666,-5,0,5
165,TEL,P007990,P009783,0.317,2,2,0
165,TEL,P007990,P009863,1.333,-2,0,2
165,TEL,P007990,P011193,12.55,-6,30,36
165,TEL,P007990,P011199,1.333,-2,0,2
165,TEL,P007990,P011214,12.55,-6,30,36
165,TEL,P007990,P011219,1.5,-2,0,2
165,TEL,P007990,P011971,8.183,-4,23,27
165,TEL,P007990,P012744,8.433,0,21,21
165,TEL,P009622,P009783,25.085,-21,44,65
165,TEL,P009622,P009863,27.451,-29,44,73
165,TEL,P009622,P011193,0.333,-3,0,3
165,TEL,P009622,P011199,22.034,-16,36,52
165,TEL,P009622,P011214,3.683,-11,6,17
165,TEL,P009622,P011219,17.05,-13,26,39
165,TEL,P009622,P011971,6.85,-16,10,26
165,TEL,P009622,P012744,4.167,-12,2,14
165,TEL,P009783,P009863,25.085,-21,44,65
165,TEL,P009783,P011193,0.317,2,2,0
165,TEL,P009783,P011199,20.701,-14,36,50
165,TEL,P009783,P011214,2.634,0,8,8
165,TEL,P009783,P011219,14.684,-5,26,31
165,TEL,P009783,P011971,5.484,-7,10,17
165,TEL,P009783,P012744,4.167,-12,2,14
165,TEL,P009863,P011199,22.034,-16,36,52
165,TEL,P009863,P011214,3.35,-8,6,14
165,TEL,P009863,P011219,17.05,-13,26,39
165,TEL,P009863,P011971,6.517,-13,10,23
165,TEL,P009863,P012744,4.167,-12,2,14
165,TEL,P011193,P011214,12.55,-6,30,36
165,TEL,P011193,P011219,0.167,0,0,0
165,TEL,P011193,P011971,8.183,-4,23,27
165,TEL,P011193,P012744,8.433,0,21,21
165,TEL,P011199,P011219,13.95,-2,24,26
165,TEL,P011199,P011971,3.167,-5,4,9
165,TEL,P011199,P012744,2.1,-7,0,7
165,TEL,P011214,P011219,1.2,-6,0,6
165,TEL,P011214,P011971,11.533,-12,29,41
165,TEL,P011214,P012744,8.433,0,21,21
165,TEL,P011219,P011971,1.033,-6,0,6
165,TEL,P011219,P012744,2.067,-5,2,7
165,TEL,P011971,P012744,4.55,4,16,12
165,ULK,P001932,P002968,8.483,-2,18,20
165,ULK,P001932,P004004,1.817,6,8,2
165,ULK,P001932,P005844,6.867,10,20,10
165,ULK,P001932,P006661,15.35,8,38,30
165,ULK,P001932,P006961,14.283,2,32,30
165,ULK,P001932,P008962,16.1,8,40,32
165,ULK,P001932,P009849,0.75,0,2,2
165,ULK,P001932,P011157,0.75,0,2,2
165,ULK,P002968,P004004,7.45,1,19,18
165,ULK,P002968,P006661,11.483,3,25,22
165,ULK,P002968,P006961,8.483,-2,18,20
165,ULK,P002968,P008962,9.85,1,23,22
165,ULK,P002968,P009849,4.45,-4,12,16
165,ULK,P002968,P011052,7.45,1,19,18
165,ULK,P002968,P011157,6.083,-2,14,16
165,ULK,P002969,P004004,2.167,2,8,6
165,ULK,P002969,P009849,5.334,7,17,10
165,ULK,P002969,P011052,5.334,7,17,10
165,ULK,P002969,P011157,5.334,7,17,10
165,ULK,P002969,P011980,3.167,5,9,4
165,ULK,P004004,P005844,10.217,26,35,9
165,ULK,P004004,P006661,8.717,25,29,4
165,ULK,P004004,P008962,10.551,28,39,11
165,ULK,P004004,P009849,13.834,3,39,36
165,ULK,P004004,P011052,20.734,22,60,38
165,ULK,P004004,P011157,11.184,-1,28,29
165,ULK,P004004,P011980,3.533,0,7,7
165,ULK,P005844,P006661,11.517,24,36,12
165,ULK,P005844,P006961,5.8,4,14,10
165,ULK,P005844,P008962,12.267,30,42,12
165,ULK,P005844,P009849,4.5,6,13,7
165,ULK,P005844,P011052,9.15,20,29,9
165,ULK,P005844,P011157,0.217,0,0,0
165,ULK,P005844,P011980,3.533,0,7,7
165,ULK,P006661,P006961,14.283,2,32,30
165,ULK,P006661,P008962,21.367,25,59,34
165,ULK,P006661,P011052,7.65,19,23,4
165,ULK,P006661,P011157,1.633,2,2,0
165,ULK,P006961,P008962,14.283,2,32,30
165,ULK,P008962,P009849,3.467,5,12,7
165,ULK,P008962,P011052,8.734,22,31,9
165,ULK,P008962,P011157,2.717,-1,6,7
165,ULK,P009849,P011052,16.251,8,46,38
165,ULK,P009849,P011157,12.718,2,35,33
165,ULK,P009849,P011980,6.7,5,16,11
165,ULK,P011052,P011157,13.601,4,35,31
165,ULK,P011052,P011980,6.7,5,16,11
165,ULK,P011157,P011980,3.167,5,9,4
166,MCO,P002581,P004197,12.25,5,26,21
166,MCO,P002581,P005985,15.75,3,33,30
166,MCO,P002581,P010588,14.583,7,31,24
166,MCO,P002581,P011212,3.217,2,7,5
166,MCO,P002581,P011226,16.634,3,35,32
166,MCO,P002581,P011231,6.317,0,8,8
166,MCO,P002581,P012709,6.317,0,8,8
166,MCO,P004197,P005985,13.983,7,32,25
166,MCO,P004197,P010588,13.983,7,32,25
166,MCO,P004197,P011226,13.983,7,32,25
166,MCO,P004197,PLCZ,1.733,2,6,4
166,MCO,P004790,P005985,0.15,1,1,0
166,MCO,P004790,P010588,0.15,1,1,0
166,MCO,P004790,P011212,4.25,-1,6,7
166,MCO,P004790,P011226,0.15,1,1,0
166,MCO,P004790,P011231,4.2,-2,5,7
166,MCO,P004790,P012709,4.15,-2,5,7
166,MCO,P004790,PLCZ,4.15,-2,5,7
166,MCO,P005985,P010588,29.216,1,57,56
166,MCO,P005985,P011196,3.25,-2,4,6
166,MCO,P005985,P011212,13.05,-8,23,31
166,MCO,P005985,P011226,22.233,-2,46,48
166,MCO,P005985,P011231,9.367,-5,15,20
166,MCO,P005985,P012709,3.3,-2,4,6
166,MCO,P005985,PLCZ,11.233,-5,21,26
166,MCO,P010588,P011196,3.25,-2,4,6
166,MCO,P010588,P011212,15.5,-7,28,35
166,MCO,P010588,P011226,21.066,2,44,42
166,MCO,P010588,P011231,10.65,0,18,18
166,MCO,P010588,P012709,4.583,3,7,4
166,MCO,P010588,PLCZ,13.683,-4,26,30
166,MCO,P011196,P011212,3.25,-2,4,6
166,MCO,P011196,P011226,3.25,-2,4,6
166,MCO,P011212,P011226,10.05,-3,16,19
166,MCO,P011212,P011231,15.634,-2,25,27
166,MCO,P011212,P012709,9.617,1,14,13
166,MCO,P011212,PLCZ,16.1,-8,25,33
166,MCO,P011226,P011231,4.234,-2,6,8
166,MCO,P011226,P012709,4.184,-2,6,8
166,MCO,P011226,PLCZ,5.216,-2,10,12
166,MCO,P011231,P012709,12.917,-1,18,19
166,MCO,P011231,PLCZ,12.617,-4,21,25
166,MCO,P012709,PLCZ,6.6,-1,10,11
166,OLY,P001255,P003941,1.05,-4,0,4
166,OLY,P001255,P007853,0.25,0,3,3
166,OLY,P001255,P007982,0.05,0,0,0
166,OLY,P001255,P008811,17.483,-5,37,42
166,OLY,P001255,P008829,15.116,-10,26,36
166,OLY,P001255,P008855,18.616,-8,38,46
166,OLY,P001255,P010612,18.566,-8,38,46
166,OLY,P001255,P011194,3.333,3,10,7
166,OLY,P003941,P007853,14.533,5,23,18
166,OLY,P003941,P007982,9.716,-1,12,13
166,OLY,P003941,P008829,6.1,1,9,8
166,OLY,P003941,P008855,12.2,2,19,17
166,OLY,P003941,P010612,2.684,0,4,4
166,OLY,P003941,P011194,9.5,0,14,14
166,OLY,P003941,P011983,6.617,1,11,10
166,OLY,P007853,P007982,11.282,-1,14,15
166,OLY,P007853,P008811,5.116,3,12,9
166,OLY,P007853,P008829,9.299,12,20,8
166,OLY,P007853,P008855,14.866,10,30,20
166,OLY,P007853,P010392,1.566,0,2,2
166,OLY,P007853,P010612,5.3,8,15,7
166,OLY,P007853,P011194,10.316,-2,14,16
166,OLY,P007853,P011983,6.6,1,11,10
166,OLY,P007982,P008811,3.399,1,6,5
166,OLY,P007982,P008829,5.899,5,11,6
166,OLY,P007982,P008855,6.516,-1,8,9
166,OLY,P007982,P010392,3.399,1,6,5
166,OLY,P007982,P010612,1.833,1,4,3
166,OLY,P007982,P011194,7.166,-4,7,11
166,OLY,P007982,P011983,3.4,-1,4,5
166,OLY,P008811,P008829,19.832,1,39,38
166,OLY,P008811,P008855,21.016,-2,45,47
166,OLY,P008811,P010392,3.349,1,6,5
166,OLY,P008811,P010612,22.699,0,49,49
166,OLY,P008811,P011194,4.166,1,10,9
166,OLY,P008829,P008855,23.649,-1,43,44
166,OLY,P008829,P010392,2.466,4,6,2
166,OLY,P008829,P010612,21.899,0,42,42
166,OLY,P008855,P010392,0.15,-1,0,1
166,OLY,P008855,P010612,23.733,-1,50,51
166,OLY,P008855,P011194,9.433,4,20,16
166,OLY,P008855,P011983,3.217,2,7,5
166,OLY,P010392,P010612,1.833,1,4,3
166,OLY,P010392,P011194,0.833,-2,0,2
166,OLY,P010612,P011194,3.3,3,10,7
166,OLY,P010612,P011983,0.017,0,0,0
166,OLY,P011194,P011983,6.617,1,11,10
167,BER,P003958,P006251,4.317,-4,6,10
167,BER,P003958,P007025,8.567,-10,12,22
167,BER,P003958,P008173,15.034,-14,21,35
167,BER,P003958,P008211,10.834,-3,23,26
167,BER,P003958,P008384,4.234,1,9,8
167,BER,P003958,P008967,12.551,1,30,29
167,BER,P003958,P010791,6.567,4,18,14
167,BER,P003958,P011934,14.984,-17,20,37
167,BER,P003958,P012720,16.617,-10,29,39
167,BER,P003958,P012721,9.767,-16,8,24
167,BER,P006251,P007025,9.1,-1,16,17
167,BER,P006251,P008173,3.783,0,10,10
167,BER,P006251,P008211,6.55,-4,7,11
167,BER,P006251,P008384,5.216,-2,10,12
167,BER,P006251,P008967,8.716,-5,12,17
167,BER,P006251,P010791,7.066,-4,9,13
167,BER,P006251,P011934,1.933,3,7,4
167,BER,P006251,P012720,4.733,0,8,8
167,BER,P006251,P012721,1.85,-3,3,6
167,BER,P007025,P008173,5.2,-1,12,13
167,BER,P007025,P008211,6.117,-6,7,13
167,BER,P007025,P008384,1.933,3,7,4
167,BER,P007025,P008967,6.333,-5,10,15
167,BER,P007025,P010791,5.5,-3,7,10
167,BER,P007025,P011934,5.433,-2,13,15
167,BER,P007025,P012720,7.35,-3,11,14
167,BER,P007025,P012721,1.667,-4,1,5
167,BER,P008173,P008384,5.8,4,16,12
167,BER,P008173,P008967,5.517,8,15,7
167,BER,P008173,P010791,5.133,3,8,5
167,BER,P008173,P011934,20.25,-5,33,38
167,BER,P008173,P012720,15.4,-10,19,29
167,BER,P008173,P012721,12.283,-17,10,27
167,BER,P008211,P008384,2.7,-4,1,5
167,BER,P008211,P008967,12.15,-4,25,29
167,BER,P008211,P010791,10.65,1,22,21
167,BER,P008211,P011934,1.8,-6,2,8
167,BER,P008211,P012720,8.1,4,21,17
167,BER,P008211,P012721,0.767,-2,0,2
167,BER,P008384,P008967,4.9,-2,8,10
167,BER,P008384,P010791,2.333,-4,1,5
167,BER,P008384,P011934,5.217,5,14,9
167,BER,P008384,P012721,1.667,-1,2,3
167,BER,P008967,P010791,12.966,8,31,23
167,BER,P008967,P011934,7.067,2,17,15
167,BER,P008967,P012720,12.4,9,32,23
167,BER,P010791,P011934,5.133,3,8,5
167,BER,P010791,P012720,15.666,9,34,25
167,BER,P010791,P012721,4.05,-5,2,7
167,BER,P011934,P012720,15.95,-13,19,32
167,BER,P011934,P012721,10.433,-14,7,21
167,BER,P012720,P012721,9.716,-14,7,21
167,VIR,P001133,P001844,19.167,7,43,36
167,VIR,P001133,P003048,21.15,2,47,45
167,VIR,P001133,P003527,4.034,-2,7,9
167,VIR,P001133,P004554,1.966,5,5,0
167,VIR,P001133,P005553,5.967,-5,11,16
167,VIR,P001133,P006739,1.583,5,5,0
167,VIR,P001133,P009549,19.449,9,45,36
167,VIR,P001133,P010781,2.75,10,10,0
167,VIR,P001133,P012713,3.1,-5,4,9
167,VIR,P001133,PBCN,14.766,2,31,29
167,VIR,P001844,P002084,0.817,0,0,0
167,VIR,P001844,P003048,19.751,6,43,37
167,VIR,P001844,P003527,4.568,-1,7,8
167,VIR,P001844,P004554,0.383,0,0,0
167,VIR,P001844,P005553,3.234,0,7,7
167,VIR,P001844,P009549,16.45,6,36,30
167,VIR,P001844,P010781,1.984,5,5,0
167,VIR,P001844,P012713,0.367,0,0,0
167,VIR,P001844,PBCN,15.283,1,31,30
167,VIR,P002084,P003048,2.617,2,6,4
167,VIR,P002084,P003527,10.001,6,20,14
167,VIR,P002084,P004554,8.951,2,16,14
167,VIR,P002084,P006739,8.134,2,16,14
167,VIR,P002084,P009549,1.567,-2,2,4
167,VIR,P002084,P010781,11.568,4,22,18
167,VIR,P002084,P012713,2.617,2,6,4
167,VIR,P003048,P003527,9.568,2,18,16
167,VIR,P003048,P005553,5.6,-5,11,16
167,VIR,P003048,P006739,2.767,3,5,2
167,VIR,P003048,P009549,20.767,6,45,39
167,VIR,P003048,P010781,6.551,10,16,6
167,VIR,P003048,P012713,4.533,-3,10,13
167,VIR,P003048,PBCN,14.9,1,31,30
167,VIR,P003527,P004554,9.051,6,18,12
167,VIR,P003527,P005553,4.034,-2,7,9
167,VIR,P003527,P006739,11.001,9,23,14
167,VIR,P003527,P009549,4.951,4,9,5
167,VIR,P003527,P010781,14.435,11,29,18
167,VIR,P003527,P012713,3.784,0,6,6
167,VIR,P003527,PBCN,0.517,-1,0,1
167,VIR,P004554,P006739,11.384,9,25,16
167,VIR,P004554,P009549,5.2,5,11,6
167,VIR,P004554,P010781,12.201,9,25,16
167,VIR,P004554,P012713,0.817,0,0,0
167,VIR,P004554,PBCN,0.383,0,0,0
167,VIR,P005553,P009549,1.933,-3,4,7
167,VIR,P005553,P012713,3.1,-5,4,9
167,VIR,P006739,P009549,7.584,8,16,8
167,VIR,P006739,P010781,14.151,12,30,18
167,VIR,P009549,P010781,8.751,13,21,8
167,VIR,P009549,P012713,1.933,-3,4,7
167,VIR,P009549,PBCN,15.283,1,31,30
167,VIR,P010781,P012713,2.617,2,6,4
168,MIL,P001518,P002812,4.217,-12,4,16
168,MIL,P001518,P005670,2.867,5,7,2
168,MIL,P001518,P006509,7.867,-6,13,19
168,MIL,P001518,P006701,9.05,9,23,14
168,MIL,P001518,P006721,0.783,1,2,1
168,MIL,P001518,P007201,0.1,-2,0,2
168,MIL,P001518,P009960,8.584,19,26,7
168,MIL,P001518,P011205,12.701,9,30,21
168,MIL,P001518,P011224,7.384,8,21,13
168,MIL,P001518,P011926,0.783,1,2,1
168,MIL,P002812,P002849,5.116,6,11,5
168,MIL,P002812,P005670,4.601,1,8,7
168,MIL,P002812,P006509,8.1,-14,12,26
168,MIL,P002812,P006701,10.8,3,19,16
168,MIL,P002812,P007201,6.051,-4,10,14
168,MIL,P002812,P011205,14.317,-6,25,31
168,MIL,P002812,P011224,7.934,-6,11,17
168,MIL,P002849,P005670,14.3,2,23,21
168,MIL,P002849,P006509,5.999,-1,9,10
168,MIL,P002849,P006701,5.733,6,11,5
168,MIL,P002849,P007201,12.017,2,18,16
168,MIL,P002849,P009960,14.75,2,23,21
168,MIL,P002849,P011205,9.049,6,16,10
168,MIL,P002849,P011224,14.9,9,25,16
168,MIL,P005670,P006509,5.45,3,10,7
168,MIL,P005670,P006701,3.134,3,6,3
168,MIL,P005670,P007201,16.018,3,26,23
168,MIL,P005670,P009960,17.167,7,30,23
168,MIL,P005670,P011205,9.484,6,20,14
168,MIL,P005670,P011224,14.051,2,22,20
168,MIL,P006509,P006701,6.316,-4,10,14
168,MIL,P006509,P006721,0.783,1,2,1
168,MIL,P006509,P007201,1.883,-5,2,7
168,MIL,P006509,P009960,5.9,3,10,7
168,MIL,P006509,P011205,14.333,-9,22,31
168,MIL,P006509,P011224,3.45,-9,4,13
168,MIL,P006509,P011926,0.783,1,2,1
168,MIL,P006701,P006721,0.783,1,2,1
168,MIL,P006701,P007201,3.401,1,6,5
168,MIL,P006701,P009960,6.167,14,19,5
168,MIL,P006701,P011205,16.167,19,38,19
168,MIL,P006701,P011224,9.334,19,24,5
168,MIL,P006701,P011926,0.783,1,2,1
168,MIL,P006721,P011926,0.783,1,2,1
168,MIL,P007201,P009960,11.417,2,18,16
168,MIL,P007201,P011205,5.684,-2,10,12
168,MIL,P007201,P011224,15.701,-3,22,25
168,MIL,P009960,P011205,11.917,19,31,12
168,MIL,P009960,P011224,17.434,18,39,21
168,MIL,P011205,P011224,13.684,10,32,22
168,MUN,P001288,P001557,5.2,0,9,9
168,MUN,P001288,P003583,17.35,-9,24,33
168,MUN,P001288,P004508,9.633,-4,14,18
168,MUN,P001288,P006760,7.917,-6,12,18
168,MUN,P001288,P007056,10.716,2,17,15
168,MUN,P001288,P007639,2.533,-1,5,6
168,MUN,P001288,P007975,8.333,-6,11,17
168,MUN,P001288,P008985,13.433,-2,25,27
168,MUN,P001288,P010391,7.016,-8,5,13
168,MUN,P001288,P011987,14.533,-6,22,28
168,MUN,P001557,P003583,2.417,-5,2,7
168,MUN,P001557,P004508,5.733,-2,9,11
168,MUN,P001557,P007056,4.35,1,7,6
168,MUN,P001557,P007975,5.733,-2,9,11
168,MUN,P001557,P011987,0.167,0,0,0
168,MUN,P003583,P004508,6.584,1,10,9
168,MUN,P003583,P006760,16.851,-2,28,30
168,MUN,P003583,P007056,18.283,2,27,25
168,MUN,P003583,P007975,12.084,-5,18,23
168,MUN,P003583,P008985,16.283,0,27,27
168,MUN,P003583,P010391,7.466,-4,5,9
168,MUN,P003583,P011987,25.75,-6,39,45
168,MUN,P004508,P006760,7.284,-3,13,16
168,MUN,P004508,P007056,8.9,-4,16,20
168,MUN,P004508,P007639,2.533,-1,5,6
168,MUN,P004508,P007975,13.017,-5,22,27
168,MUN,P004508,P008985,2.8,-1,5,6
168,MUN,P004508,P010391,2.8,-1,5,6
168,MUN,P004508,P011987,3.984,-4,9,13
168,MUN,P006760,P007056,11.384,-10,17,27
168,MUN,P006760,P007975,13.051,-9,21,30
168,MUN,P006760,P008985,7.017,-2,12,14
168,MUN,P006760,P011987,16.768,-12,29,41
168,MUN,P007056,P007975,13.167,-7,22,29
168,MUN,P007056,P008985,9.416,5,17,12
168,MUN,P007056,P010391,5.216,1,5,4
168,MUN,P007056,P011987,18.5,-6,28,34
168,MUN,P007639,P008985,2.533,-1,5,6
168,MUN,P007639,P010391,2.533,-1,5,6
168,MUN,P007975,P011987,9.751,-10,17,27
168,MUN,P008985,P010391,7.766,-3,10,13
168,MUN,P008985,P011987,16.016,0,27,27
168,MUN,P010391,P011987,7.199,-4,5,9
169,BAR,P000925,P002939,16.799,3,36,33
169,BAR,P000925,P004866,16.416,15,45,30
169,BAR,P000925,P006435,8.649,3,21,18
169,BAR,P000925,P007464,14.649,8,35,27
169,BAR,P000925,P009992,9.349,2,22,20
169,BAR,P000925,P012745,20.666,13,53,40
169,BAR,P002939,P003196,10.718,-11,19,30
169,BAR,P002939,P004866,19.534,-1,42,43
169,BAR,P002939,P006435,10.7,-12,17,29
169,BAR,P002939,P007464,14.15,-5,27,32
169,BAR,P002939,P009992,13.183,-2,28,30
169,BAR,P002939,P012745,24.984,-4,51,55
169,BAR,P003196,P003204,7.65,4,17,13
169,BAR,P003196,P004866,14.451,-3,29,32
169,BAR,P003196,P006435,14.534,-3,30,33
169,BAR,P003196,P007464,11.984,-1,26,27
169,BAR,P003196,P009992,3.834,-4,6,10
169,BAR,P003196,P012745,10.301,-10,17,27
169,BAR,P003204,P004866,6.5,5,15,10
169,BAR,P003204,P006435,7.65,4,17,13
169,BAR,P003204,P007464,7.65,4,17,13
169,BAR,P003204,P012745,1.15,-1,2,3
169,BAR,P004866,P006435,15.45,9,40,31
169,BAR,P004866,P007464,17.5,15,46,31
169,BAR,P004866,P009992,11.3,-1,24,25
169,BAR,P004866,P012745,22.317,9,55,46
169,BAR,P006435,P007464,19.066,4,43,39
169,BAR,P006435,P009992,0.483,-2,0,2
169,BAR,P006435,P012745,16.2,-3,36,39
169,BAR,P007464,P009992,3.933,-3,8,11
169,BAR,P007464,P012745,17.6,6,42,36
169,BAR,P009992,P012745,10.65,2,24,22
169,BAS,P003198,P004603,4.601,2,12,10
169,BAS,P003198,P004761,3.35,-2,9,11
169,BAS,P003198,P007230,4.283,5,13,8
169,BAS,P003198,P008072,1.883,0,5,5
169,BAS,P003198,P008850,0.617,2,4,2
169,BAS,P003198,P009048,10.767,7,30,23
169,BAS,P003198,P010444,4.283,5,13,8
169,BAS,P003198,P011948,6.8,7,17,10
169,BAS,P003198,P012201,6.484,2,17,15
169,BAS,P004603,P004761,13.35,5,34,29
169,BAS,P004603,P007230,9.65,8,25,17
169,BAS,P004603,P008850,0.617,2,4,2
169,BAS,P004603,P009048,13.284,9,34,25
169,BAS,P004603,P011948,11.2,9,26,17
169,BAS,P004603,P012201,10.034,1,25,24
169,BAS,P004603,P012765,3.2,0,8,8
169,BAS,P004761,P007230,20.416,-1,42,43
169,BAS,P004761,P008072,3.433,-5,5,10
169,BAS,P004761,P009048,19.516,1,46,45
169,BAS,P004761,P010444,9.233,-4,17,21
169,BAS,P004761,P011948,12.033,10,29,19
169,BAS,P004761,P012201,16.233,-15,32,47
169,BAS,P004761,P012765,6.5,-5,10,15
169,BAS,P007230,P008072,1.55,-5,0,5
169,BAS,P007230,P008850,3.817,-6,5,11
169,BAS,P007230,P009048,24.766,0,53,53
169,BAS,P007230,P010444,20.066,-8,38,46
169,BAS,P007230,P011948,20.633,7,45,38
169,BAS,P007230,P012201,13.383,-15,21,36
169,BAS,P007230,P012765,6.5,-5,10,15
169,BAS,P008072,P009048,1.883,0,5,5
169,BAS,P008072,P012201,3.433,-5,5,10
169,BAS,P008072,P012765,1.55,-5,0,5
169,BAS,P008850,P009048,4.434,-4,9,13
169,BAS,P008850,P010444,3.817,-6,5,11
169,BAS,P008850,P011948,3.817,-6,5,11
169,BAS,P008850,P012201,0.617,2,4,2
169,BAS,P009048,P010444,18.333,-8,36,44
169,BAS,P009048,P011948,25.4,8,54,46
169,BAS,P009048,P012201,15.617,-9,33,42
169,BAS,P010444,P011948,14.2,-1,28,29
169,BAS,P010444,P012201,8.65,-10,13,23
169,BAS,P010444,P012765,1.75,0,2,2
169,BAS,P011948,P012201,7.517,-2,12,14
169,BAS,P012201,P012765,6.5,-5,10,15
170,IST,P006590,P007200,22.933,-23,64,87
170,IST,P006590,P009846,10.067,-12,28,40
170,IST,P006590,P011078,18.967,5,65,60
170,IST,P006590,P011981,11.75,-11,30,41
170,IST,P006590,P012786,16.549,-11,36,47
170,IST,P006590,P012788,13.9,-11,30,41
170,IST,P006590,PLHK,24.834,-9,71,80
170,IST,P007200,P009846,16.75,-3,54,57
170,IST,P007200,P011078,27.4,14,93,79
170,IST,P007200,P011981,15.333,-16,31,47
170,IST,P007200,P012786,20.233,3,46,43
170,IST,P007200,P012788,19.683,-11,49,60
170,IST,P007200,PLHK,30.4,0,99,99
170,IST,P009846,P011078,15.584,19,60,41
170,IST,P009846,P011981,11.017,-8,17,25
170,IST,P009846,P012786,15.117,11,35,24
170,IST,P009846,P012788,5.033,-1,19,20
170,IST,P009846,PLHK,20.7,2,71,69
170,IST,P011078,P011981,9.2,11,28,17
170,IST,P011078,P012786,20.6,9,47,38
170,IST,P011078,P012788,15.883,-4,42,46
170,IST,P011078,PLHK,29.234,22,105,83
170,IST,P011981,P012786,4.15,-8,5,13
170,IST,P011981,P012788,2.8,-6,5,11
170,IST,P011981,PLHK,12.55,-2,32,34
170,IST,P012786,P012788,8.183,-7,12,19
170,IST,P012786,PLHK,17.9,11,47,36
170,IST,P012788,PLHK,13.25,-4,39,43
170,MAD,P001392,P003108,30.833,24,102,78
170,MAD,P001392,P004887,3.083,-1,5,6
170,MAD,P001392,P005791,30.833,24,102,78
170,MAD,P001392,P005928,26.899,25,88,63
170,MAD,P001392,P006540,33.633,14,90,76
170,MAD,P001392,P010357,4.716,6,12,6
170,MAD,P001392,PCVM,3.6,2,8,6
170,MAD,P001392,PTGB,2.067,-2,21,23
170,MAD,P003108,P003733,3.367,2,5,3
170,MAD,P003108,P004887,0.25,0,0,0
170,MAD,P003108,P005791,34.15,18,117,99
170,MAD,P003108,P005928,29.116,18,99,81
170,MAD,P003108,P006540,31.2,10,98,88
170,MAD,P003108,P009213,4.617,-12,6,18
170,MAD,P003108,P010357,1.883,7,7,0
170,MAD,P003108,PCVM,1.867,4,7,3
170,MAD,P003108,PTGB,0.317,1,27,26
170,MAD,P003733,P004887,6.383,-7,8,15
170,MAD,P003733,P005791,3.367,2,5,3
170,MAD,P003733,P005928,3.367,2,5,3
170,MAD,P003733,P006540,1.517,2,5,3
170,MAD,P003733,P010357,6.383,-7,8,15
170,MAD,P003733,PCVM,6.383,-7,8,15
170,MAD,P003733,PTGB,8.233,-7,8,15
170,MAD,P004887,P005928,1.416,-4,2,6
170,MAD,P004887,P006540,4.216,-7,5,12
170,MAD,P004887,P010357,10.849,-14,13,27
170,MAD,P004887,PCVM,10.566,-16,11,27
170,MAD,P004887,PTGB,6.633,-7,8,15
170,MAD,P005791,P005928,29.116,18,99,81
170,MAD,P005791,P006540,31.2,10,98,88
170,MAD,P005791,P009213,4.617,-12,6,18
170,MAD,P005791,P010357,1.633,7,7,0
170,MAD,P005791,PCVM,1.617,4,7,3
170,MAD,P005791,PTGB,0.067,1,27,26
170,MAD,P005928,P006540,29.199,10,89,79
170,MAD,P005928,P009213,3.8,-11,4,15
170,MAD,P005928,P010357,2.249,-2,4,6
170,MAD,P005928,PCVM,1.133,-6,0,6
170,MAD,P005928,PTGB,-4.167,6,14,8
170,MAD,P006540,P009213,3.8,-11,4,15
170,MAD,P006540,P010357,4.216,-7,5,12
170,MAD,P006540,PCVM,3.933,-9,3,12
170,MAD,P006540,PTGB,-1.25,0,15,15
170,MAD,P009213,PCVM,0.817,-1,2,3
170,MAD,P009213,PTGB,0.817,-1,2,3
170,MAD,P010357,PCVM,11.366,-11,16,27
170,MAD,P010357,PTGB,6.633,-7,8,15
170,MAD,PCVM,PTGB,7.45,-8,10,18
171,PAM,P003960,P004863,5.366,-2,15,17
171,PAM,P003960,P005356,3.833,-3,3,6
171,PAM,P003960,P006643,0.383,0,0,0
171,PAM,P003960,P007870,8.517,2,20,18
171,PAM,P003960,P010393,0.783,-2,3,5
171,PAM,P003960,P010568,16.15,5,37,32
171,PAM,P003960,P011970,8.6,3,26,23
171,PAM,P003960,P011982,15.265,-3,32,35
171,PAM,P003960,P012738,10.367,10,28,18
171,PAM,P003960,P012740,8.217,5,21,16
171,PAM,P003960,P012795,6.851,1,19,18
171,PAM,P004863,P005356,4.733,-1,5,6
171,PAM,P004863,P007870,6.1,1,13,12
171,PAM,P004863,P010393,6.433,0,15,15
171,PAM,P004863,P010568,1.983,-3,3,6
171,PAM,P004863,P011970,6.617,6,21,15
171,PAM,P004863,P011982,4.549,-3,5,8
171,PAM,P004863,P012738,5.4,9,13,4
171,PAM,P004863,P012795,12.083,1,26,25
171,PAM,P005356,P006643,4.317,1,11,10
171,PAM,P005356,P007870,2.717,-3,0,3
171,PAM,P005356,P010393,2.417,2,6,4
171,PAM,P005356,P010568,7.034,-2,11,13
171,PAM,P005356,P011982,7.633,-3,13,16
171,PAM,P005356,P012738,6.517,4,10,6
171,PAM,P005356,P012795,7.867,-7,5,12
171,PAM,P006643,P010393,2.417,2,6,4
171,PAM,P006643,P010568,4.317,1,11,10
171,PAM,P006643,P011982,4.317,1,11,10
171,PAM,P006643,P012738,1.1,2,5,3
171,PAM,P006643,P012795,0.417,-3,0,3
171,PAM,P007870,P010393,10.967,-5,17,22
171,PAM,P007870,P010568,17.101,-10,27,37
171,PAM,P007870,P011970,10.251,5,25,20
171,PAM,P007870,P011982,11.367,-8,19,27
171,PAM,P007870,P012738,1.717,-3,0,3
171,PAM,P007870,P012740,6.284,-5,9,14
171,PAM,P007870,P012795,9.851,2,18,16
171,PAM,P010393,P010568,9.267,-7,13,20
171,PAM,P010393,P011970,4.9,2,13,11
171,PAM,P010393,P011982,7.734,-5,11,16
171,PAM,P010393,P012740,5.317,-7,5,12
171,PAM,P010393,P012795,6.433,0,15,15
171,PAM,P010568,P011970,6.134,1,15,14
171,PAM,P010568,P011982,22.717,-5,46,51
171,PAM,P010568,P012738,10.067,2,22,20
171,PAM,P010568,P012740,13.534,-2,26,28
171,PAM,P010568,P012795,6.368,-4,9,13
171,PAM,P011970,P011982,6.4,2,15,13
171,PAM,P011970,P012738,1.7,4,8,4
171,PAM,P011970,P012795,6.334,5,21,16
171,PAM,P011982,P012738,11.199,8,25,17
171,PAM,P011982,P012740,12.35,-5,21,26
171,PAM,P011982,P012795,3.733,-7,2,9
171,PAM,P012738,P012740,7.25,3,17,14
171,PAM,P012738,P012795,6.551,5,12,7
171,PAM,P012740,P012795,1.184,3,5,2
171,PAN,P002328,P003842,23.4,3,42,39
171,PAN,P002328,P007866,15.767,-2,26,28
171,PAN,P002328,P007947,17.133,10,39,29
171,PAN,P002328,P011204,27.466,7,62,55
171,PAN,P002328,P011221,5.95,2,18,16
171,PAN,P002328,P012712,13.816,9,36,27
171,PAN,P002328,P012774,14.8,-1,25,26
171,PAN,P003842,P007866,18.2,1,33,32
171,PAN,P003842,P007947,13.433,7,26,19
171,PAN,P003842,P011204,25.299,6,53,47
171,PAN,P003842,P011209,1.533,2,4,2
171,PAN,P003842,P011221,0.017,0,0,0
171,PAN,P003842,P012712,9.216,5,20,15
171,PAN,P003842,P012774,18.566,0,34,34
171,PAN,P007866,P007947,11.867,-8,19,27
171,PAN,P007866,P011204,21.35,-8,40,48
171,PAN,P007866,P011221,4.917,-9,7,16
171,PAN,P007866,P012774,20.367,-6,35,41
171,PAN,P007947,P011204,22.766,2,53,51
171,PAN,P007947,P011209,1.283,-4,0,4
171,PAN,P007947,P011221,12.083,-9,25,34
171,PAN,P007947,P012712,13.899,8,34,26
171,PAN,P007947,P012774,10.6,-6,16,22
171,PAN,P011204,P011209,2.183,2,6,4
171,PAN,P011204,P011221,11.467,-5,27,32
171,PAN,P011204,P012712,15.649,11,42,31
171,PAN,P011204,P012774,21.816,-3,45,48
171,PAN,P011209,P011221,1.533,-2,2,4
171,PAN,P011209,P012712,3.066,0,6,6
171,PAN,P011209,P012774,2.666,2,6,4
171,PAN,P011221,P012712,7.433,2,20,18
171,PAN,P011221,P012774,6.0,-7,9,16
171,PAN,P012712,P012774,4.449,1,10,9
172,PAR,P000956,P007400,6.95,-8,10,18
172,PAR,P000956,P007673,3.55,-6,3,9
172,PAR,P000956,P008987,4.116,-4,5,9
172,PAR,P000956,P009862,3.4,-2,7,9
172,PAR,P000956,P011192,2.25,-4,1,5
172,PAR,P000956,P012096,1.517,-6,0,6
172,PAR,P000956,P012742,4.7,-4,9,13
172,PAR,P000956,P012743,1.317,2,5,3
172,PAR,P007400,P007673,6.6,-7,9,16
172,PAR,P007400,P008987,22.683,7,48,41
172,PAR,P007400,P009212,2.35,-2,5,7
172,PAR,P007400,P009862,28.017,0,61,61
172,PAR,P007400,P011192,19.8,-5,38,43
172,PAR,P007400,P012096,23.084,-3,48,51
172,PAR,P007400,P012742,12.417,-7,26,33
172,PAR,P007400,P012743,4.367,1,11,10
172,PAR,P007673,P008987,2.866,-1,4,5
172,PAR,P007673,P009862,8.95,-2,16,18
172,PAR,P007673,P011192,11.2,-6,17,23
172,PAR,P007673,P012096,1.067,-4,0,4
172,PAR,P007673,P012742,7.2,-3,12,15
172,PAR,P007673,P012743,8.567,-3,15,18
172,PAR,P008987,P009862,23.116,2,48,46
172,PAR,P008987,P011192,19.016,-5,35,40
172,PAR,P008987,P012096,18.567,11,43,32
172,PAR,P008987,P012742,9.499,-2,19,21
172,PAR,P008987,P012743,2.533,-8,2,10
172,PAR,P009212,P009862,2.35,-2,5,7
172,PAR,P009212,P012096,2.35,-2,5,7
172,PAR,P009212,P012742,2.35,-2,5,7
172,PAR,P009862,P011192,25.983,-10,49,59
172,PAR,P009862,P012096,22.017,1,48,47
172,PAR,P009862,P012742,19.55,-14,36,50
172,PAR,P009862,P012743,12.417,-9,22,31
172,PAR,P011192,P012096,14.5,0,31,31
172,PAR,P011192,P012742,9.083,-15,12,27
172,PAR,P011192,P012743,11.1,-11,17,28
172,PAR,P012096,P012742,9.234,-9,17,26
172,PAR,P012742,P012743,9.367,-8,16,24
172,ULK,P001932,P002968,4.833,-5,12,17
172,ULK,P001932,P004004,9.449,-5,21,26
172,ULK,P001932,P005844,11.199,8,28,20
172,ULK,P001932,P006661,11.683,-4,26,30
172,ULK,P001932,P008962,13.215,-4,29,33
172,ULK,P001932,P009849,11.132,13,30,17
172,ULK,P001932,P010560,14.95,12,38,26
172,ULK,P001932,P011052,2.966,2,9,7
172,ULK,P001932,P011157,3.283,2,9,7
172,ULK,P001932,P011980,14.35,9,34,25
172,ULK,P002968,P004004,1.4,-5,2,7
172,ULK,P002968,P006661,4.833,-5,12,17
172,ULK,P002968,P006961,0.467,-2,0,2
172,ULK,P002968,P008962,4.833,-5,12,17
172,ULK,P002968,P010560,4.367,-4,10,14
172,ULK,P002968,P011052,0.467,-2,0,2
172,ULK,P004004,P005844,4.133,-2,9,11
172,ULK,P004004,P006661,4.066,-8,6,14
172,ULK,P004004,P006961,0.7,-2,0,2
172,ULK,P004004,P008962,14.548,-2,30,32
172,ULK,P004004,P009849,17.649,19,41,22
172,ULK,P004004,P010560,6.201,13,15,2
172,ULK,P004004,P011052,17.382,14,38,24
172,ULK,P004004,P011157,3.432,-7,5,12
172,ULK,P004004,P011980,16.5,13,33,20
172,ULK,P005844,P006661,5.917,-3,12,15
172,ULK,P005844,P008962,4.366,1,9,8
172,ULK,P005844,P009849,7.399,9,21,12
172,ULK,P005844,P010560,9.183,8,24,16
172,ULK,P005844,P011052,2.117,-2,5,7
172,ULK,P005844,P011980,8.95,5,24,19
172,ULK,P006661,P008962,7.966,-10,16,26
172,ULK,P006661,P010560,10.517,-1,25,26
172,ULK,P006661,P011052,2.9,-5,5,10
172,ULK,P006661,P011157,3.833,-1,7,8
172,ULK,P006661,P011980,6.617,1,15,14
172,ULK,P006961,P008962,0.233,0,0,0
172,ULK,P006961,P010560,0.467,-2,0,2
172,ULK,P006961,P011052,0.7,-2,0,2
172,ULK,P006961,P011980,0.233,0,0,0
172,ULK,P008962,P009849,9.799,10,23,13
172,ULK,P008962,P010560,4.783,0,12,12
172,ULK,P008962,P011052,8.732,4,20,16
172,ULK,P008962,P011157,0.966,-4,2,6
172,ULK,P008962,P011980,7.883,2,15,13
172,ULK,P009849,P010560,11.233,24,31,7
172,ULK,P009849,P011052,13.649,19,33,14
172,ULK,P009849,P011157,2.649,-4,5,9
172,ULK,P009849,P011980,19.55,22,44,22
172,ULK,P010560,P011052,7.501,9,18,9
172,ULK,P010560,P011157,3.05,2,7,5
172,ULK,P010560,P011980,17.084,23,44,21
172,ULK,P011052,P011157,3.432,-7,5,12
172,ULK,P011052,P011980,14.95,10,31,21
172,ULK,P011157,P011980,5.283,-1,8,9
173,BAS,P003198,P007230,1.283,-4,0,4
173,BAS,P003198,P011948,1.283,-4,0,4
173,BAS,P003198,P012201,1.283,-4,0,4
173,BAS,P003198,P012765,1.283,-4,0,4
173,BAS,P004603,P004761,19.6,1,45,44
173,BAS,P004603,P007230,9.784,-2,17,19
173,BAS,P004603,P008850,4.467,-1,6,7
173,BAS,P004603,P009048,14.717,-1,30,31
173,BAS,P004603,P010444,4.433,0,10,10
173,BAS,P004603,P011948,16.65,11,46,35
173,BAS,P004603,P012201,14.117,6,38,32
173,BAS,P004603,P012765,8.3,6,24,18
173,BAS,P004761,P007230,16.001,-21,21,42
173,BAS,P004761,P008850,4.467,-1,6,7
173,BAS,P004761,P009048,21.95,-14,39,53
173,BAS,P004761,P010444,14.417,-1,35,36
173,BAS,P004761,P011948,23.483,5,57,52
173,BAS,P004761,P012201,25.634,-7,58,65
173,BAS,P004761,P012765,12.584,6,35,29
173,BAS,P007230,P008850,4.467,-1,6,7
173,BAS,P007230,P009048,17.951,-13,29,42
173,BAS,P007230,P010444,5.451,-9,9,18
173,BAS,P007230,P011948,10.417,-10,13,23
173,BAS,P007230,P012201,17.001,-22,24,46
173,BAS,P007230,P012765,3.517,-10,1,11
173,BAS,P008850,P009048,4.467,-1,6,7
173,BAS,P009048,P010444,5.7,-1,14,15
173,BAS,P009048,P011948,15.783,-1,32,33
173,BAS,P009048,P012201,20.9,-9,42,51
173,BAS,P010444,P011948,10.5,4,26,22
173,BAS,P010444,P012201,10.751,-3,25,28
173,BAS,P010444,P012765,9.484,-2,21,23
173,BAS,P011948,P012201,24.517,3,56,53
173,BAS,P011948,P012765,13.167,4,34,30
173,BAS,P012201,P012765,10.201,0,25,25
173,MCO,P002581,P004197,9.833,2,26,24
173,MCO,P002581,P005985,8.75,4,25,21
173,MCO,P002581,P008099,4.7,-5,8,13
173,MCO,P002581,P009754,2.533,-3,3,6
173,MCO,P002581,P010588,12.4,-5,27,32
173,MCO,P002581,P011226,8.817,-8,17,25
173,MCO,P002581,P011231,3.183,1,9,8
173,MCO,P002581,P012709,12.116,-2,29,31
173,MCO,P004197,P004790,5.317,2,10,8
173,MCO,P004197,P005985,21.317,0,49,49
173,MCO,P004197,P009754,11.166,-4,20,24
173,MCO,P004197,P010588,12.55,-7,26,33
173,MCO,P004197,P011226,6.834,-8,14,22
173,MCO,P004197,P011231,7.266,0,18,18
173,MCO,P004197,P012709,7.483,6,21,15
173,MCO,P004197,PLCZ,11.834,-3,24,27
173,MCO,P004790,P005985,5.317,2,10,8
173,MCO,P004790,P009754,5.317,2,10,8
173,MCO,P004790,PLCZ,5.317,2,10,8
173,MCO,P005985,P008099,1.3,4,4,0
173,MCO,P005985,P009754,18.666,16,44,28
173,MCO,P005985,P010588,18.817,14,49,35
173,MCO,P005985,P011226,18.317,12,47,35
173,MCO,P005985,P011231,16.699,18,44,26
173,MCO,P005985,P012709,6.0,8,20,12
173,MCO,P005985,PLCZ,16.017,2,36,34
173,MCO,P008099,P010588,6.0,-1,12,13
173,MCO,P008099,P011226,6.0,-1,12,13
173,MCO,P008099,P011231,1.3,4,4,0
173,MCO,P008099,P012709,4.7,-5,8,13
173,MCO,P009754,P010588,10.683,8,25,17
173,MCO,P009754,P011226,10.0,15,27,12
173,MCO,P009754,P011231,11.899,11,29,18
173,MCO,P009754,P012709,2.5,-5,3,8
173,MCO,P009754,PLCZ,11.9,4,27,23
173,MCO,P010588,P011226,20.301,3,48,45
173,MCO,P010588,P011231,8.033,14,21,7
173,MCO,P010588,P012709,9.7,-5,20,25
173,MCO,P010588,PLCZ,5.584,-5,12,17
173,MCO,P011226,P011231,9.433,18,26,8
173,MCO,P011226,P012709,5.717,-8,10,18
173,MCO,P011226,PLCZ,8.317,-3,19,22
173,MCO,P011231,P012709,3.5,3,11,8
173,MCO,P011231,PLCZ,5.483,3,14,11
173,MCO,P012709,PLCZ,1.084,0,2,2
174,IST,P006590,P007200,14.499,-9,25,34
174,IST,P006590,P009513,3.033,4,6,2
174,IST,P006590,P009664,15.916,-5,31,36
174,IST,P006590,P009846,12.983,3,26,23
174,IST,P006590,P010516,3.283,-3,5,8
174,IST,P006590,P011078,11.399,1,24,23
174,IST,P006590,P012786,3.767,-10,5,15
174,IST,P006590,P012788,4.733,-3,10,13
174,IST,P006590,PLHK,14.715,6,28,22
174,IST,P007200,P009513,3.35,1,6,5
174,IST,P007200,P009664,23.166,-4,47,51
174,IST,P007200,P009846,28.599,-8,52,60
174,IST,P007200,P011078,23.415,-4,45,49
174,IST,P007200,P012786,10.683,-18,11,29
174,IST,P007200,P012788,5.716,-2,9,11
174,IST,P007200,PLHK,24.232,-4,49,53
174,IST,P009513,P009664,0.317,-3,0,3
174,IST,P009513,P009846,3.35,1,6,5
174,IST,P009513,PLHK,3.35,1,6,5
174,IST,P009664,P009846,22.533,6,48,42
174,IST,P009664,P010516,2.033,-2,2,4
174,IST,P009664,P011078,21.532,14,49,35
174,IST,P009664,P012786,5.7,-10,5,15
174,IST,P009664,P012788,4.833,0,9,9
174,IST,P009664,PLHK,17.966,12,45,33
174,IST,P009846,P011078,21.899,8,46,38
174,IST,P009846,P012786,9.933,-19,8,27
174,IST,P009846,P012788,4.833,0,9,9
174,IST,P009846,PLHK,23.466,9,53,44
174,IST,P010516,P011078,3.283,-3,5,8
174,IST,P010516,P012786,1.35,-2,2,4
174,IST,P010516,P012788,1.25,-1,3,4
174,IST,P010516,PLHK,1.933,-1,3,4
174,IST,P011078,P012786,10.366,-11,13,24
174,IST,P011078,P012788,4.366,-3,5,8
174,IST,P011078,PLHK,23.732,2,53,51
174,IST,P012786,PLHK,6.333,-10,8,18
174,IST,P012788,PLHK,2.133,-3,3,6
174,PAN,P001926,P002328,18.033,10,45,35
174,PAN,P001926,P003842,18.816,8,45,37
174,PAN,P001926,P007866,18.033,10,45,35
174,PAN,P001926,P011204,17.816,-10,32,42
174,PAN,P001926,P011221,3.033,-5,2,7
174,PAN,P001926,P012712,3.816,-7,2,9
174,PAN,P001926,P012774,7.849,6,17,11
174,PAN,P002328,P003842,27.683,17,67,50
174,PAN,P002328,P007866,35.033,12,75,63
174,PAN,P002328,P011204,31.0,-1,60,61
174,PAN,P002328,P011209,1.033,2,2,0
174,PAN,P002328,P011221,7.35,-5,8,13
174,PAN,P002328,P012774,20.0,13,43,30
174,PAN,P003842,P007866,28.833,19,73,54
174,PAN,P003842,P011204,25.933,4,58,54
174,PAN,P003842,P011209,2.183,4,8,4
174,PAN,P003842,P012712,1.133,-2,0,2
174,PAN,P003842,P012774,15.283,18,41,23
174,PAN,P007866,P011204,32.15,1,66,65
174,PAN,P007866,P011209,2.183,4,8,4
174,PAN,P007866,P011221,7.35,-5,8,13
174,PAN,P007866,P012774,21.15,15,49,34
174,PAN,P011204,P011209,2.183,4,8,4
174,PAN,P011204,P011221,10.033,-10,10,20
174,PAN,P011204,P012712,3.816,-7,2,9
174,PAN,P011204,P012774,20.933,-5,36,41
174,PAN,P011209,P012774,1.15,2,6,4
174,PAN,P011221,P012712,2.683,-5,2,7
174,PAN,P011221,P012774,9.683,-10,10,20
174,PAN,P012712,P012774,3.816,-7,2,9
175,ASV,P000229,P003274,2.617,2,9,7
175,ASV,P000229,P004194,11.15,4,31,27
175,ASV,P000229,P006568,2.1,4,9,5
175,ASV,P000229,P011225,8.184,9,32,23
175,ASV,P000229,P011386,5.066,-1,8,9
175,ASV,P000229,P012080,2.65,-1,7,8
175,ASV,P000229,P012729,4.65,2,8,6
175,ASV,P000229,P012731,8.6,6,32,26
175,ASV,P000229,PKIR,7.983,7,24,17
175,ASV,P003274,P004194,0.517,-2,0,2
175,ASV,P003274,P006568,2.417,4,9,5
175,ASV,P003274,P011225,3.867,-3,9,12
175,ASV,P003274,P012080,0.933,-5,0,5
175,ASV,P003274,P012729,0.534,1,1,0
175,ASV,P003274,P012730,0.933,-5,0,5
175,ASV,P003274,P012731,3.333,-4,8,12
175,ASV,P003274,PKIR,0.317,0,0,0
175,ASV,P003526,P006568,9.733,-2,22,24
175,ASV,P003526,P011225,9.733,-2,22,24
175,ASV,P003526,P012080,9.733,-2,22,24
175,ASV,P003526,P012729,9.733,-2,22,24
175,ASV,P004194,P011225,11.55,5,38,33
175,ASV,P004194,P011386,9.483,6,20,14
175,ASV,P004194,P012080,11.166,6,32,26
175,ASV,P004194,P012729,6.783,-4,11,15
175,ASV,P004194,P012731,15.617,15,49,34
175,ASV,P004194,PKIR,17.866,14,51,37
175,ASV,P006568,P011225,13.617,0,34,34
175,ASV,P006568,P011386,3.533,1,6,5
175,ASV,P006568,P012080,14.733,-3,31,34
175,ASV,P006568,P012729,13.517,2,31,29
175,ASV,P006568,P012731,3.633,-1,9,10
175,ASV,P006568,PKIR,5.317,-1,9,10
175,ASV,P011225,P012080,18.766,-10,44,54
175,ASV,P011225,P012729,12.35,-2,29,31
175,ASV,P011225,P012730,0.933,-5,0,5
175,ASV,P011225,P012731,13.75,2,43,41
175,ASV,P011225,PKIR,11.65,6,37,31
175,ASV,P011386,P012080,8.949,10,21,11
175,ASV,P011386,P012729,8.833,2,15,13
175,ASV,P011386,P012731,7.316,9,17,8
175,ASV,P011386,PKIR,12.416,9,25,16
175,ASV,P012080,P012729,14.849,-2,34,36
175,ASV,P012080,P012730,0.933,-5,0,5
175,ASV,P012080,P012731,13.749,4,33,29
175,ASV,P012080,PKIR,14.399,8,36,28
175,ASV,P012729,P012731,2.25,2,4,2
175,ASV,P012729,PKIR,11.233,1,21,20
175,ASV,P012730,P012731,0.933,-5,0,5
175,ASV,P012731,PKIR,15.083,16,45,29
175,RED,P000848,P005099,3.85,-8,5,13
175,RED,P000848,P006436,16.367,-11,39,50
175,RED,P000848,P007960,15.916,10,44,34
175,RED,P000848,P008966,2.55,-1,5,6
175,RED,P000848,P009035,18.783,3,51,48
175,RED,P000848,P011941,4.083,-8,5,13
175,RED,P000848,P011964,1.583,-3,0,3
175,RED,P000848,P012044,24.616,-2,61,63
175,RED,P000848,PJDR,3.15,-6,9,15
175,RED,P000848,PLUO,10.766,2,25,23
175,RED,P004720,P005099,4.933,1,15,14
175,RED,P004720,P006436,5.866,6,20,14
175,RED,P004720,P008966,3.333,4,10,6
175,RED,P004720,P009035,2.533,2,10,8
175,RED,P004720,P012044,0.933,5,5,0
175,RED,P004720,PJDR,4.933,1,15,14
175,RED,P004720,PLUO,0.933,5,5,0
175,RED,P005099,P006436,14.416,-15,25,40
175,RED,P005099,P007960,3.783,-2,3,5
175,RED,P005099,P008966,6.583,3,13,10
175,RED,P005099,P009035,3.866,-8,7,15
175,RED,P005099,P011941,4.5,-11,5,16
175,RED,P005099,P011964,2.266,-6,2,8
175,RED,P005099,P012044,3.167,-5,5,10
175,RED,P005099,PJDR,11.899,-12,20,32
175,RED,P005099,PLUO,0.533,-1,0,1
175,RED,P006436,P007960,12.1,1,25,24
175,RED,P006436,P008966,9.133,2,18,16
175,RED,P006436,P009035,14.233,-4,41,45
175,RED,P006436,P011941,4.5,-11,5,16
175,RED,P006436,P011964,2.266,-6,2,8
175,RED,P006436,P012044,16.617,-3,44,47
175,RED,P006436,PJDR,13.316,-13,29,42
175,RED,P006436,PLUO,2.65,2,8,6
175,RED,P007960,P008966,5.8,-2,8,10
175,RED,P007960,P009035,16.216,10,44,34
175,RED,P007960,P011941,0.233,0,0,0
175,RED,P007960,P012044,18.466,10,49,39
175,RED,P007960,PJDR,6.333,-2,8,10
175,RED,P007960,PLUO,10.149,7,27,20
175,RED,P008966,P012044,2.55,-1,5,6
175,RED,P008966,PJDR,6.583,3,13,10
175,RED,P009035,P011964,3.316,-7,2,9
175,RED,P009035,P012044,22.266,8,61,53
175,RED,P009035,PJDR,8.766,-10,21,31
175,RED,P009035,PLUO,14.549,6,35,29
175,RED,P011941,P011964,0.533,-2,0,2
175,RED,P011941,P012044,3.4,-5,5,10
175,RED,P011941,PJDR,1.45,-7,0,7
175,RED,P011941,PLUO,0.233,0,0,0
175,RED,P011964,P012044,1.583,-3,0,3
175,RED,P011964,PJDR,2.266,-6,2,8
175,RED,P011964,PLUO,1.583,-3,0,3
175,RED,P012044,PJDR,5.017,-3,14,17
175,RED,P012044,PLUO,14.249,7,35,28
175,RED,PJDR,PLUO,3.483,-1,5,6
176,PAM,P003960,P004863,4.333,-4,12,16
176,PAM,P003960,P005356,4.617,-7,8,15
176,PAM,P003960,P006433,11.016,5,25,20
176,PAM,P003960,P007870,21.566,-4,51,55
176,PAM,P003960,P010393,0.1,0,0,0
176,PAM,P003960,P010568,21.566,-4,51,55
176,PAM,P003960,P011970,1.8,2,6,4
176,PAM,P003960,P011982,12.75,12,34,22
176,PAM,P003960,P012795,8.916,-16,17,33
176,PAM,P004863,P005356,5.5,0,4,4
176,PAM,P004863,P007870,6.467,-4,16,20
176,PAM,P004863,P010393,5.817,2,6,4
176,PAM,P004863,P010568,4.483,-6,12,18
176,PAM,P004863,P011970,9.351,0,13,13
176,PAM,P004863,P011982,8.084,5,21,16
176,PAM,P004863,P012738,10.1,2,13,11
176,PAM,P004863,P012739,4.267,2,7,5
176,PAM,P004863,P012795,4.066,-5,4,9
176,PAM,P005356,P007870,5.134,-7,8,15
176,PAM,P005356,P010393,7.533,-3,6,9
176,PAM,P005356,P010568,6.55,-10,10,20
176,PAM,P005356,P011970,3.467,-2,2,4
176,PAM,P005356,P012738,6.816,-3,6,9
176,PAM,P005356,P012795,8.583,-8,12,20
176,PAM,P006433,P007870,12.749,10,30,20
176,PAM,P006433,P010393,3.866,3,11,8
176,PAM,P006433,P010568,12.749,10,30,20
176,PAM,P006433,P011970,3.283,-5,6,11
176,PAM,P006433,P011982,12.116,7,27,20
176,PAM,P006433,P012738,3.283,-5,6,11
176,PAM,P006433,P012739,1.15,-3,0,3
176,PAM,P006433,P012795,3.916,-2,9,11
176,PAM,P007870,P010393,2.667,7,7,0
176,PAM,P007870,P010568,23.549,-1,56,57
176,PAM,P007870,P011970,4.034,2,10,8
176,PAM,P007870,P011982,14.367,12,38,26
176,PAM,P007870,P012738,1.05,0,2,2
176,PAM,P007870,P012795,10.549,-11,22,33
176,PAM,P010393,P010568,3.766,2,7,5
176,PAM,P010393,P011970,5.917,-2,10,12
176,PAM,P010393,P011982,1.15,4,6,2
176,PAM,P010393,P012738,8.949,-5,12,17
176,PAM,P010393,P012795,7.099,0,11,11
176,PAM,P010568,P011970,2.05,0,6,6
176,PAM,P010568,P011982,13.0,10,34,24
176,PAM,P010568,P012738,2.033,-3,2,5
176,PAM,P010568,P012795,12.582,-14,24,38
176,PAM,P011970,P011982,8.284,2,16,14
176,PAM,P011970,P012738,11.45,-5,17,22
176,PAM,P011970,P012739,5.417,-1,7,8
176,PAM,P011970,P012795,2.683,-3,7,10
176,PAM,P011982,P012738,7.3,1,13,12
176,PAM,P011982,P012739,5.417,-1,7,8
176,PAM,P012738,P012739,5.417,-1,7,8
176,PAM,P012738,P012795,5.266,-5,6,11
176,ZAL,P002329,P003210,12.349,10,30,20
176,ZAL,P002329,P003211,10.882,12,31,19
176,ZAL,P002329,P005504,13.95,3,35,32
176,ZAL,P002329,P007109,26.532,8,67,59
176,ZAL,P002329,P007513,12.484,-8,27,35
176,ZAL,P002329,P010390,2.983,-1,6,7
176,ZAL,P002329,P011218,27.549,10,71,61
176,ZAL,P002329,P012715,15.617,9,39,30
176,ZAL,P002329,P012787,1.45,1,2,1
176,ZAL,P003210,P003211,8.299,3,13,10
176,ZAL,P003210,P005504,1.867,-1,4,5
176,ZAL,P003210,P007109,14.015,5,27,22
176,ZAL,P003210,P007513,0.9,0,2,2
176,ZAL,P003210,P009917,3.65,-6,3,9
176,ZAL,P003210,P010390,5.683,2,10,8
176,ZAL,P003210,P011218,8.949,9,24,15
176,ZAL,P003210,P012715,16.483,-1,26,27
176,ZAL,P003210,P012787,9.533,-5,9,14
176,ZAL,P003211,P005504,3.783,7,13,6
176,ZAL,P003211,P007109,10.015,8,23,15
176,ZAL,P003211,P007513,0.683,0,2,2
176,ZAL,P003211,P009917,0.967,0,0,0
176,ZAL,P003211,P010390,5.517,-1,8,9
176,ZAL,P003211,P011218,9.049,12,27,15
176,ZAL,P003211,P012715,10.433,7,19,12
176,ZAL,P003211,P012787,5.5,0,4,4
176,ZAL,P005504,P007109,11.516,2,29,27
176,ZAL,P005504,P007513,8.617,-5,18,23
176,ZAL,P005504,P009917,0.317,-2,0,2
176,ZAL,P005504,P011218,13.533,4,35,31
176,ZAL,P005504,P012715,2.751,-1,6,7
176,ZAL,P005504,P012787,0.734,-3,0,3
176,ZAL,P007109,P007513,12.217,-8,27,35
176,ZAL,P007109,P009917,2.133,-2,1,3
176,ZAL,P007109,P010390,1.0,-3,2,5
176,ZAL,P007109,P011218,25.532,8,65,57
176,ZAL,P007109,P012715,15.266,2,30,28
176,ZAL,P007109,P012787,4.166,-4,1,5
176,ZAL,P007513,P011218,11.584,-8,25,33
176,ZAL,P007513,P012715,3.451,-3,7,10
176,ZAL,P009917,P010390,2.167,-2,2,4
176,ZAL,P009917,P012715,4.617,-6,3,9
176,ZAL,P009917,P012787,4.617,-6,3,9
176,ZAL,P010390,P011218,1.0,-3,2,5
176,ZAL,P010390,P012715,6.65,2,10,8
176,ZAL,P010390,P012787,5.6,2,8,6
176,ZAL,P011218,P012715,13.0,8,35,27
176,ZAL,P012715,P012787,10.4,-5,9,14
177,BER,P003958,P007025,5.383,5,10,5
177,BER,P003958,P008173,10.417,0,16,16
177,BER,P003958,P008211,13.667,1,25,24
177,BER,P003958,P008384,9.217,1,12,11
177,BER,P003958,P008967,17.951,-4,31,35
177,BER,P003958,P010791,11.467,0,15,15
177,BER,P003958,P011934,12.4,1,26,25
177,BER,P003958,P012720,15.834,0,29,29
177,BER,P006251,P007025,3.3,0,9,9
177,BER,P006251,P008173,15.334,-9,33,42
177,BER,P006251,P008211,0.583,2,2,0
177,BER,P006251,P008384,6.117,-4,16,20
177,BER,P006251,P008967,10.45,-3,21,24
177,BER,P006251,P010791,5.75,-4,14,18
177,BER,P006251,P011934,10.167,-3,21,24
177,BER,P006251,P012720,11.967,-7,24,31
177,BER,P007025,P008173,3.983,-1,10,11
177,BER,P007025,P008211,4.7,6,9,3
177,BER,P007025,P008384,8.683,5,19,14
177,BER,P007025,P010791,8.0,6,18,12
177,BER,P007025,P011934,0.683,-1,1,2
177,BER,P008173,P008384,9.284,-10,15,25
177,BER,P008173,P008967,18.851,-4,34,38
177,BER,P008173,P010791,8.184,-7,14,21
177,BER,P008173,P011934,17.35,-2,35,37
177,BER,P008173,P012720,19.601,-3,39,42
177,BER,P008211,P008384,6.05,7,13,6
177,BER,P008211,P008967,9.55,-3,18,21
177,BER,P008211,P010791,9.033,3,15,12
177,BER,P008211,P011934,5.217,0,12,12
177,BER,P008211,P012720,8.2,-4,14,18
177,BER,P008384,P008967,3.734,-4,4,8
177,BER,P008384,P010791,12.734,-1,23,24
177,BER,P008384,P011934,2.383,-2,5,7
177,BER,P008384,P012720,3.134,-4,5,9
177,BER,P008967,P010791,6.3,-6,6,12
177,BER,P008967,P011934,21.884,-1,46,47
177,BER,P008967,P012720,24.884,-3,48,51
177,BER,P010791,P012720,7.4,-7,11,18
177,BER,P011934,P012720,20.184,0,42,42
177,MIL,P001518,P002812,3.584,-6,3,9
177,MIL,P001518,P002849,5.467,7,13,6
177,MIL,P001518,P005670,1.7,-4,1,5
177,MIL,P001518,P006509,1.234,-3,0,3
177,MIL,P001518,P006701,8.134,2,16,14
177,MIL,P001518,P007201,3.584,-6,3,9
177,MIL,P001518,P011205,5.467,7,13,6
177,MIL,P001518,P011224,7.034,7,15,8
177,MIL,P002812,P002849,6.767,2,15,13
177,MIL,P002812,P005670,12.8,0,28,28
177,MIL,P002812,P006509,10.685,5,23,18
177,MIL,P002812,P006701,14.018,0,31,31
177,MIL,P002812,P007201,14.768,0,29,29
177,MIL,P002812,P011205,11.734,4,23,19
177,MIL,P002812,P011224,11.784,3,24,21
177,MIL,P002849,P005670,12.284,0,23,23
177,MIL,P002849,P006509,1.984,-1,2,3
177,MIL,P002849,P006701,12.584,10,31,21
177,MIL,P002849,P007201,6.967,-3,12,15
177,MIL,P002849,P009960,5.817,0,13,13
177,MIL,P002849,P011205,25.235,6,53,47
177,MIL,P002849,P011224,23.835,3,50,47
177,MIL,P005670,P006509,7.334,4,18,14
177,MIL,P005670,P006701,9.534,3,22,19
177,MIL,P005670,P007201,15.284,-2,30,32
177,MIL,P005670,P009960,5.817,0,13,13
177,MIL,P005670,P011205,15.284,-1,28,29
177,MIL,P005670,P011224,12.767,-4,25,29
177,MIL,P006509,P006701,6.534,2,18,16
177,MIL,P006509,P007201,9.618,5,21,16
177,MIL,P006509,P011205,5.068,2,5,3
177,MIL,P006509,P011224,3.951,2,5,3
177,MIL,P006701,P007201,13.401,-2,29,31
177,MIL,P006701,P011205,12.584,10,31,21
177,MIL,P006701,P011224,12.751,7,30,23
177,MIL,P007201,P011205,11.934,-1,20,21
177,MIL,P007201,P011224,11.384,-3,20,23
177,MIL,P009960,P011205,5.817,0,13,13
177,MIL,P009960,P011224,5.817,0,13,13
177,MIL,P011205,P011224,27.685,5,58,53
178,MAD,P001392,P003108,17.833,1,35,34
178,MAD,P001392,P003733,3.067,-7,3,10
178,MAD,P001392,P004887,5.384,-4,9,13
178,MAD,P001392,P005791,16.783,2,32,30
178,MAD,P001392,P005928,8.284,-6,11,17
178,MAD,P001392,P006540,19.1,5,38,33
178,MAD,P001392,P010357,4.334,-3,6,9
178,MAD,P001392,P010623,13.883,4,30,26
178,MAD,P003108,P003733,5.634,11,21,10
178,MAD,P003108,P004887,5.634,11,21,10
178,MAD,P003108,P005791,15.766,2,32,30
178,MAD,P003108,P005928,7.517,9,23,14
178,MAD,P003108,P006540,15.766,2,32,30
178,MAD,P003108,P010623,13.883,4,30,26
178,MAD,P003108,PTGB,3.567,12,18,6
178,MAD,P003733,P004887,18.551,11,47,36
178,MAD,P003733,P005791,1.017,2,2,0
178,MAD,P003733,P005928,17.668,12,45,33
178,MAD,P003733,P010357,12.034,1,24,23
178,MAD,P003733,P010623,1.9,1,4,3
178,MAD,P003733,P011649,1.9,1,4,3
178,MAD,P003733,PTGB,16.501,20,46,26
178,MAD,P004887,P005928,18.968,13,49,36
178,MAD,P004887,P006540,2.317,3,6,3
178,MAD,P004887,P010357,13.334,2,28,26
178,MAD,P004887,P010623,1.9,1,4,3
178,MAD,P004887,P011649,1.9,1,4,3
178,MAD,P004887,PTGB,15.484,18,44,26
178,MAD,P005791,P005928,5.25,3,9,6
178,MAD,P005791,P006540,18.116,5,37,32
178,MAD,P005791,P010357,3.367,5,7,2
178,MAD,P005791,P010623,13.883,4,30,26
178,MAD,P005791,PTGB,2.35,5,7,2
178,MAD,P005928,P006540,6.55,4,13,9
178,MAD,P005928,P010357,16.701,7,35,28
178,MAD,P005928,PTGB,15.934,22,47,25
178,MAD,P006540,P010357,4.667,6,11,5
178,MAD,P006540,P010623,13.883,4,30,26
178,MAD,P006540,PTGB,1.333,3,5,2
178,MAD,P010357,PTGB,12.367,10,29,19
178,MAD,P010623,P011649,1.9,1,4,3
178,MAD,P010623,PTGB,1.9,1,4,3
178,MAD,P011649,PTGB,1.9,1,4,3
178,MUN,P001288,P003583,7.6,-10,8,18
178,MUN,P001288,P004508,11.484,-7,22,29
178,MUN,P001288,P007056,2.35,-8,3,11
178,MUN,P001288,P007639,7.917,0,19,19
178,MUN,P001288,P007975,16.017,-18,23,41
178,MUN,P001288,P008985,1.85,0,7,7
178,MUN,P001288,P010391,17.867,-18,30,48
178,MUN,P001288,P011987,6.383,-11,8,19
178,MUN,P003583,P004508,6.267,-8,6,14
178,MUN,P003583,P006760,12.35,-2,24,26
178,MUN,P003583,P007056,15.766,-2,30,32
178,MUN,P003583,P007975,9.7,-8,12,20
178,MUN,P003583,P008985,13.666,-4,26,30
178,MUN,P003583,P010391,11.016,-10,14,24
178,MUN,P003583,P011987,17.099,-4,32,36
178,MUN,P004508,P006760,5.984,-1,11,12
178,MUN,P004508,P007056,7.084,-4,14,18
178,MUN,P004508,P007639,10.101,3,24,21
178,MUN,P004508,P007975,12.451,-4,21,25
178,MUN,P004508,P008985,1.85,0,7,7
178,MUN,P004508,P010391,14.651,-11,27,38
178,MUN,P006760,P007056,18.334,-3,35,38
178,MUN,P006760,P007639,5.984,-1,11,12
178,MUN,P006760,P007975,3.034,3,6,3
178,MUN,P006760,P008985,12.133,-2,24,26
178,MUN,P006760,P010391,3.167,-4,5,9
178,MUN,P006760,P011987,12.35,-2,24,26
178,MUN,P007056,P007639,6.367,-1,11,12
178,MUN,P007056,P007975,7.267,-3,13,16
178,MUN,P007056,P008985,14.049,-4,26,30
178,MUN,P007056,P010391,9.316,-12,14,26
178,MUN,P007056,P011987,17.399,-7,30,37
178,MUN,P007639,P007975,8.884,3,18,15
178,MUN,P007639,P008985,2.233,0,7,7
178,MUN,P007639,P010391,11.467,-4,24,28
178,MUN,P007639,P011987,4.183,-4,6,10
178,MUN,P007975,P010391,17.9,-16,27,43
178,MUN,P007975,P011987,8.483,-9,12,21
178,MUN,P008985,P010391,3.766,-2,9,11
178,MUN,P008985,P011987,14.049,-4,26,30
178,MUN,P010391,P011987,10.182,-11,14,25
179,BAR,P000925,P002939,16.767,11,46,35
179,BAR,P000925,P004866,14.033,12,37,25
179,BAR,P000925,P007464,6.667,-6,11,17
179,BAR,P000925,P007519,3.283,-6,3,9
179,BAR,P000925,P009992,13.4,16,41,25
179,BAR,P000925,P011244,3.767,-2,8,10
179,BAR,P000925,P012745,14.283,11,38,27
179,BAR,P002939,P003196,18.599,6,34,28
179,BAR,P002939,P003204,0.067,0,0,0
179,BAR,P002939,P004866,22.333,26,59,33
179,BAR,P002939,P007464,14.4,-10,23,33
179,BAR,P002939,P007519,16.933,6,35,29
179,BAR,P002939,P009992,17.2,12,43,31
179,BAR,P002939,P011244,9.5,-7,16,23
179,BAR,P002939,P012745,25.933,24,64,40
179,BAR,P003196,P004866,12.867,5,28,23
179,BAR,P003196,P007464,9.983,-9,14,23
179,BAR,P003196,P007519,18.15,3,38,35
179,BAR,P003196,P009992,6.05,-8,6,14
179,BAR,P003196,P011244,5.666,-5,8,13
179,BAR,P003196,P012745,16.217,4,32,28
179,BAR,P003204,P007519,0.067,0,0,0
179,BAR,P003204,P009992,0.067,0,0,0
179,BAR,P003204,P011244,0.067,0,0,0
179,BAR,P004866,P007464,3.617,-6,4,10
179,BAR,P004866,P007519,10.417,7,26,19
179,BAR,P004866,P009992,17.433,7,41,34
179,BAR,P004866,P011244,1.733,2,4,2
179,BAR,P004866,P012745,25.167,15,61,46
179,BAR,P007464,P007519,13.266,-15,17,32
179,BAR,P007464,P009992,2.017,1,6,5
179,BAR,P007464,P011244,7.7,-9,12,21
179,BAR,P007464,P012745,8.95,-6,13,19
179,BAR,P007519,P009992,2.384,-4,4,8
179,BAR,P007519,P011244,7.483,-8,10,18
179,BAR,P007519,P012745,14.017,5,31,26
179,BAR,P009992,P011244,2.084,1,6,5
179,BAR,P009992,P012745,17.433,7,41,34
179,OLY,P001255,P003941,1.217,6,8,2
179,OLY,P001255,P007982,1.983,-5,2,7
179,OLY,P001255,P008811,14.866,-21,25,46
179,OLY,P001255,P008829,16.083,-15,33,48
179,OLY,P001255,P008855,14.1,-10,31,41
179,OLY,P001255,P010612,16.083,-15,33,48
179,OLY,P003941,P006589,9.284,-1,16,17
179,OLY,P003941,P007853,16.584,10,33,23
179,OLY,P003941,P007982,16.584,10,33,23
179,OLY,P003941,P008829,9.884,13,25,12
179,OLY,P003941,P008855,2.584,2,8,6
179,OLY,P003941,P010392,7.284,-3,9,12
179,OLY,P003941,P010612,11.251,9,25,16
179,OLY,P003941,P011983,2.0,2,7,5
179,OLY,P006589,P007853,9.933,4,21,17
179,OLY,P006589,P007982,8.85,7,20,13
179,OLY,P006589,P008811,2.016,1,5,4
179,OLY,P006589,P008855,2.45,-7,1,8
179,OLY,P006589,P010392,7.284,-3,9,12
179,OLY,P006589,P010612,1.367,-4,0,4
179,OLY,P006589,P011983,4.016,3,12,9
179,OLY,P007853,P007982,21.4,14,44,30
179,OLY,P007853,P008811,5.899,1,12,11
179,OLY,P007853,P008829,12.617,7,24,17
179,OLY,P007853,P008855,1.15,-3,1,4
179,OLY,P007853,P010392,5.917,1,9,8
179,OLY,P007853,P010612,12.617,7,24,17
179,OLY,P007853,P011983,4.083,3,12,9
179,OLY,P007982,P008811,6.799,-1,13,14
179,OLY,P007982,P008829,14.533,2,26,24
179,OLY,P007982,P010392,5.917,1,9,8
179,OLY,P007982,P010612,14.533,2,26,24
179,OLY,P007982,P011983,2.933,6,11,5
179,OLY,P008811,P008829,18.749,-21,32,53
179,OLY,P008811,P008855,13.966,-19,24,43
179,OLY,P008811,P010612,18.749,-21,32,53
179,OLY,P008811,P011983,2.016,1,5,4
179,OLY,P008829,P008855,14.167,-10,31,41
179,OLY,P008829,P010612,28.7,-8,57,65
179,OLY,P008829,P011983,0.067,0,0,0
179,OLY,P008855,P010392,1.367,-4,0,4
179,OLY,P008855,P010612,15.534,-14,31,45
179,OLY,P008855,P011983,1.15,-3,1,4
179,OLY,P010392,P010612,1.367,-4,0,4
179,OLY,P010612,P011983,0.067,0,0,0
180,TEL,P004233,P007990,11.65,11,34,23
180,TEL,P004233,P009622,0.233,0,0,0
180,TEL,P004233,P009783,0.85,2,5,3
180,TEL,P004233,P009863,10.933,12,32,20
180,TEL,P004233,P011199,6.499,6,17,11
180,TEL,P004233,P011214,6.184,5,17,12
180,TEL,P004233,P011219,4.833,2,10,8
180,TEL,P004233,P011433,0.15,-1,2,3
180,TEL,P004233,P011971,6.2,7,19,12
180,TEL,P007990,P009622,8.233,0,21,21
180,TEL,P007990,P009783,9.383,5,27,22
180,TEL,P007990,P009863,15.533,11,47,36
180,TEL,P007990,P011199,12.449,14,37,23
180,TEL,P007990,P011214,11.684,-7,22,29
180,TEL,P007990,P011219,10.95,-1,18,19
180,TEL,P007990,P011433,0.15,-1,2,3
180,TEL,P007990,P011971,10.15,3,25,22
180,TEL,P007990,P012744,3.15,-7,3,10
180,TEL,P009622,P009783,24.166,10,55,45
180,TEL,P009622,P009863,18.049,13,47,34
180,TEL,P009622,P011199,22.049,15,53,38
180,TEL,P009622,P011214,2.85,-5,4,9
180,TEL,P009622,P011219,23.016,7,44,37
180,TEL,P009622,P011971,0.5,0,2,2
180,TEL,P009622,P012744,0.5,0,2,2
180,TEL,P009783,P009863,19.316,19,53,34
180,TEL,P009783,P011199,23.466,20,61,41
180,TEL,P009783,P011214,2.35,-5,2,7
180,TEL,P009783,P011219,22.783,7,44,37
180,TEL,P009783,P011433,0.15,-1,2,3
180,TEL,P009783,P011971,0.8,3,3,0
180,TEL,P009863,P011199,24.165,23,65,42
180,TEL,P009863,P011214,8.034,-2,18,20
180,TEL,P009863,P011219,21.266,12,46,34
180,TEL,P009863,P011971,8.85,3,23,20
180,TEL,P009863,P012744,2.65,-7,1,8
180,TEL,P011199,P011214,0.8,0,0,0
180,TEL,P011199,P011219,23.599,15,49,34
180,TEL,P011199,P011433,0.15,-1,2,3
180,TEL,P011199,P011971,3.283,4,8,4
180,TEL,P011214,P011219,4.017,-6,5,11
180,TEL,P011214,P011971,7.667,-1,17,18
180,TEL,P011214,P012744,3.15,-7,3,10
180,TEL,P011971,P012744,3.15,-7,3,10
180,VIR,P001133,P001844,23.25,-18,41,59
180,VIR,P001133,P003048,23.433,-20,40,60
180,VIR,P001133,P003527,16.1,-14,19,33
180,VIR,P001133,P004554,4.033,-1,5,6
180,VIR,P001133,P006739,5.899,-6,14,20
180,VIR,P001133,P009549,22.55,-17,33,50
180,VIR,P001133,P010781,5.216,-7,7,14
180,VIR,P001133,PBCN,12.183,-9,25,34
180,VIR,P001844,P002084,0.467,-1,1,2
180,VIR,P001844,P003048,21.3,-15,41,56
180,VIR,P001844,P003527,14.367,-8,21,29
180,VIR,P001844,P004554,2.267,0,2,2
180,VIR,P001844,P006739,0.983,-1,9,10
180,VIR,P001844,P009549,22.2,-17,34,51
180,VIR,P001844,P010781,1.667,-1,4,5
180,VIR,P001844,PBCN,10.567,-7,23,30
180,VIR,P002084,P003048,1.6,-2,5,7
180,VIR,P002084,P004554,5.95,11,20,9
180,VIR,P002084,P006739,7.083,10,24,14
180,VIR,P002084,P009549,0.467,-1,1,2
180,VIR,P002084,P010781,7.083,10,24,14
180,VIR,P002084,PBCN,7.55,9,25,16
180,VIR,P003048,P003527,12.7,-9,18,27
180,VIR,P003048,P006739,5.266,-6,15,21
180,VIR,P003048,P009549,20.2,-16,31,47
180,VIR,P003048,P010781,4.983,-5,10,15
180,VIR,P003048,PBCN,12.85,-7,28,35
180,VIR,P003527,P004554,6.983,-6,7,13
180,VIR,P003527,P006739,6.016,-9,5,14
180,VIR,P003527,P009549,14.167,-10,19,29
180,VIR,P003527,P010781,6.216,-7,7,14
180,VIR,P003527,PBCN,4.983,-5,8,13
180,VIR,P004554,P006739,11.449,5,28,23
180,VIR,P004554,P009549,2.117,0,2,2
180,VIR,P004554,P010781,11.599,5,28,23
180,VIR,P004554,PBCN,10.466,6,28,22
180,VIR,P006739,P009549,1.4,-3,3,6
180,VIR,P006739,P010781,14.915,1,34,33
180,VIR,P006739,PBCN,13.849,5,40,35
180,VIR,P009549,PBCN,8.967,-8,13,21
180,VIR,P010781,PBCN,14.649,4,38,34
181,MUN,P001288,P001557,2.8,-1,5,6
181,MUN,P001288,P004508,17.166,-7,34,41
181,MUN,P001288,P005460,3.266,5,9,4
181,MUN,P001288,P006543,1.033,3,5,2
181,MUN,P001288,P006760,0.333,-3,1,4
181,MUN,P001288,P007056,29.883,-18,57,75
181,MUN,P001288,P007639,12.767,-14,21,35
181,MUN,P001288,P007975,14.9,-1,32,33
181,MUN,P001288,P008985,15.883,-14,30,44
181,MUN,P001288,P010391,14.883,-6,32,38
181,MUN,P001288,P011987,10.75,-4,22,26
181,MUN,P001557,P006543,2.483,1,5,4
181,MUN,P001557,P007056,5.283,0,10,10
181,MUN,P001557,P008985,5.283,0,10,10
181,MUN,P001557,P010391,5.283,0,10,10
181,MUN,P004508,P005460,11.699,7,23,16
181,MUN,P004508,P006543,7.616,-5,11,16
181,MUN,P004508,P006760,10.482,2,19,17
181,MUN,P004508,P007056,19.766,3,45,42
181,MUN,P004508,P007639,3.4,-7,4,11
181,MUN,P004508,P007975,25.266,4,54,50
181,MUN,P004508,P008985,2.133,-6,2,8
181,MUN,P004508,P010391,12.583,-2,29,31
181,MUN,P004508,P011987,0.017,3,3,0
181,MUN,P005460,P006543,8.049,-5,11,16
181,MUN,P005460,P006760,9.949,2,16,14
181,MUN,P005460,P007056,5.016,12,14,2
181,MUN,P005460,P007975,10.549,5,21,16
181,MUN,P005460,P008985,2.666,2,4,2
181,MUN,P005460,P010391,0.583,0,0,0
181,MUN,P005460,P011987,1.083,0,2,2
181,MUN,P006543,P006760,7.816,-6,8,14
181,MUN,P006543,P007056,3.283,3,7,4
181,MUN,P006543,P007975,7.616,-5,11,16
181,MUN,P006543,P008985,3.716,3,7,4
181,MUN,P006543,P010391,3.716,3,7,4
181,MUN,P006760,P007056,4.749,9,16,7
181,MUN,P006760,P007975,10.349,2,19,17
181,MUN,P006760,P008985,1.433,-1,3,4
181,MUN,P006760,P010391,2.549,-1,6,7
181,MUN,P007056,P007639,12.767,-14,21,35
181,MUN,P007056,P007975,17.5,9,43,34
181,MUN,P007056,P008985,19.166,-11,37,48
181,MUN,P007056,P010391,19.016,0,45,45
181,MUN,P007056,P011987,10.767,-1,25,26
181,MUN,P007639,P007975,2.417,1,4,3
181,MUN,P007639,P008985,10.35,-15,17,32
181,MUN,P007639,P011987,9.367,-7,17,24
181,MUN,P007975,P010391,12.45,-2,29,31
181,MUN,P007975,P011987,0.017,3,3,0
181,MUN,P008985,P010391,7.016,2,16,14
181,MUN,P008985,P011987,10.75,-4,22,26
181,MUN,P010391,P011987,0.317,6,6,0
181,ULK,P001932,P002968,2.35,3,5,2
181,ULK,P001932,P004004,9.683,2,26,24
181,ULK,P001932,P005844,5.966,9,19,10
181,ULK,P001932,P006661,26.165,21,66,45
181,ULK,P001932,P006961,8.867,5,26,21
181,ULK,P001932,P009849,13.383,9,36,27
181,ULK,P001932,P010560,22.649,20,62,42
181,ULK,P001932,P011157,23.616,10,59,49
181,ULK,P001932,P011980,15.049,9,33,24
181,ULK,P002968,P004004,6.483,0,6,6
181,ULK,P002968,P006661,4.217,2,8,6
181,ULK,P002968,P006961,10.233,-4,14,18
181,ULK,P002968,P009849,6.566,-6,6,12
181,ULK,P002968,P010560,5.45,-6,8,14
181,ULK,P002968,P011052,7.283,-5,9,14
181,ULK,P002968,P011980,0.55,0,0,0
181,ULK,P004004,P006661,6.232,-4,11,15
181,ULK,P004004,P006961,16.75,-7,29,36
181,ULK,P004004,P009849,16.833,2,31,29
181,ULK,P004004,P010560,5.116,-8,9,17
181,ULK,P004004,P011052,7.783,-3,8,11
181,ULK,P004004,P011157,14.316,-6,32,38
181,ULK,P005844,P006661,5.966,9,19,10
181,ULK,P005844,P009849,0.183,0,0,0
181,ULK,P005844,P010560,5.966,9,19,10
181,ULK,P005844,P011980,5.783,9,19,10
181,ULK,P006661,P006961,6.0,0,14,14
181,ULK,P006661,P009849,8.049,5,19,14
181,ULK,P006661,P010560,25.382,19,67,48
181,ULK,P006661,P011052,0.717,1,3,2
181,ULK,P006661,P011157,19.015,6,44,38
181,ULK,P006661,P011980,15.049,9,33,24
181,ULK,P006961,P009849,15.5,-7,27,34
181,ULK,P006961,P010560,8.55,-11,16,27
181,ULK,P006961,P011052,9.733,-10,11,21
181,ULK,P006961,P011157,11.567,-6,27,33
181,ULK,P009849,P010560,6.483,-1,17,18
181,ULK,P009849,P011052,9.016,-11,8,19
181,ULK,P009849,P011157,16.8,4,40,36
181,ULK,P009849,P011980,1.383,-3,0,3
181,ULK,P010560,P011052,1.95,-7,3,10
181,ULK,P010560,P011157,16.516,5,42,37
181,ULK,P010560,P011980,13.666,12,33,21
181,ULK,P011052,P011157,2.45,-5,2,7
181,ULK,P011157,P011980,8.716,0,14,14
182,MCO,P002581,P005985,4.667,-7,5,12
182,MCO,P002581,P008099,4.667,-7,5,12
182,MCO,P002581,P010588,4.667,-7,5,12
182,MCO,P002581,P011231,4.667,-7,5,12
182,MCO,P004197,P004790,5.734,0,14,14
182,MCO,P004197,P005985,12.934,-9,19,28
182,MCO,P004197,P008099,12.583,-6,24,30
182,MCO,P004197,P010588,6.717,-3,7,10
182,MCO,P004197,P011196,12.583,-6,24,30
182,MCO,P004197,P011226,7.917,-1,9,10
182,MCO,P004197,P011231,4.833,-7,5,12
182,MCO,P004197,PLCZ,3.567,0,2,2
182,MCO,P004790,P005985,12.968,-1,31,32
182,MCO,P004790,P008099,6.134,3,17,14
182,MCO,P004790,P010588,2.034,-4,3,7
182,MCO,P004790,P011196,5.517,2,14,12
182,MCO,P004790,P011226,9.851,1,21,20
182,MCO,P004790,P012709,7.817,0,16,16
182,MCO,P004790,PLCZ,6.617,3,16,13
182,MCO,P005985,P008099,17.384,-19,29,48
182,MCO,P005985,P010588,20.802,-22,23,45
182,MCO,P005985,P011196,9.333,-8,17,25
182,MCO,P005985,P011226,15.518,-3,24,27
182,MCO,P005985,P011231,16.734,-23,20,43
182,MCO,P005985,P012709,14.701,-5,25,30
182,MCO,P005985,PLCZ,19.835,-7,31,38
182,MCO,P008099,P010588,11.167,-13,17,30
182,MCO,P008099,P011196,13.116,-7,24,31
182,MCO,P008099,P011226,4.933,1,10,9
182,MCO,P008099,P011231,11.917,-19,14,33
182,MCO,P008099,PLCZ,2.767,-5,4,9
182,MCO,P010588,P011196,3.116,-2,5,7
182,MCO,P010588,P011226,11.484,-7,13,20
182,MCO,P010588,P011231,12.251,-16,15,31
182,MCO,P010588,P012709,8.084,-8,9,17
182,MCO,P010588,PLCZ,13.218,-10,15,25
182,MCO,P011196,P011226,4.316,0,7,7
182,MCO,P011196,P011231,4.483,-7,5,12
182,MCO,P011226,P011231,0.35,0,0,0
182,MCO,P011226,P012709,10.234,-1,19,20
182,MCO,P011226,PLCZ,12.601,2,21,19
182,MCO,P011231,P012709,4.467,-4,6,10
182,MCO,P011231,PLCZ,7.234,-9,10,19
182,MCO,P012709,PLCZ,13.501,-2,25,27
182,PAN,P001926,P002328,12.166,4,20,16
182,PAN,P001926,P003842,10.799,7,19,12
182,PAN,P001926,P007866,8.766,0,16,16
182,PAN,P001926,P011204,12.483,-3,21,24
182,PAN,P001926,P011209,3.949,-1,6,7
182,PAN,P001926,P011221,6.0,-11,8,19
182,PAN,P001926,P012712,8.866,-6,11,17
182,PAN,P001926,P012774,7.499,-14,7,21
182,PAN,P002328,P003842,29.183,35,72,37
182,PAN,P002328,P007866,20.133,20,47,27
182,PAN,P002328,P011204,24.617,26,60,34
182,PAN,P002328,P011209,6.866,5,15,10
182,PAN,P002328,P011221,2.667,-4,3,7
182,PAN,P002328,P012712,12.55,9,28,19
182,PAN,P002328,P012774,22.55,21,55,34
182,PAN,P003842,P007866,18.583,23,46,23
182,PAN,P003842,P011204,24.533,26,57,31
182,PAN,P003842,P011209,6.033,7,15,8
182,PAN,P003842,P012712,11.983,10,26,16
182,PAN,P003842,P012774,21.15,24,53,29
182,PAN,P006544,P011204,1.6,6,6,0
182,PAN,P006544,P011209,0.25,0,0,0
182,PAN,P006544,P011221,1.85,6,6,0
182,PAN,P006544,P012712,1.85,6,6,0
182,PAN,P006544,P012774,1.85,6,6,0
182,PAN,P007866,P011204,20.45,17,49,32
182,PAN,P007866,P011209,1.366,-2,0,2
182,PAN,P007866,P011221,2.4,-6,3,9
182,PAN,P007866,P012774,15.566,8,35,27
182,PAN,P011204,P011221,7.15,-4,16,20
182,PAN,P011204,P012712,11.233,5,24,19
182,PAN,P011204,P012774,24.666,15,59,44
182,PAN,P011209,P011221,0.25,0,0,0
182,PAN,P011209,P012712,5.75,7,15,8
182,PAN,P011209,P012774,4.0,4,9,5
182,PAN,P011221,P012712,6.2,0,13,13
182,PAN,P011221,P012774,7.883,-5,15,20
182,PAN,P012712,P012774,14.3,9,33,24
183,MIL,P001518,P002812,0.533,-2,0,2
183,MIL,P001518,P002849,3.367,-7,0,7
183,MIL,P001518,P005670,3.9,-9,0,9
183,MIL,P001518,P006509,0.533,-2,0,2
183,MIL,P001518,P006701,2.05,-5,0,5
183,MIL,P001518,P011205,3.9,-9,0,9
183,MIL,P001518,P011224,1.317,-2,0,2
183,MIL,P002812,P005670,4.633,-4,5,9
183,MIL,P002812,P006509,10.317,-2,22,24
183,MIL,P002812,P006701,10.95,-2,23,25
183,MIL,P002812,P007201,12.417,-2,25,27
183,MIL,P002812,P011205,5.083,-4,5,9
183,MIL,P002812,P011224,7.867,0,20,20
183,MIL,P002849,P005670,20.517,-1,28,29
183,MIL,P002849,P006509,1.8,-1,2,3
183,MIL,P002849,P006701,6.849,-10,6,16
183,MIL,P002849,P007201,8.033,-6,10,16
183,MIL,P002849,P009960,13.333,7,24,17
183,MIL,P002849,P011205,22.933,-5,32,37
183,MIL,P002849,P011224,22.1,-1,34,35
183,MIL,P005670,P006509,3.517,-3,4,7
183,MIL,P005670,P006701,5.266,-7,3,10
183,MIL,P005670,P007201,8.867,-3,9,12
183,MIL,P005670,P009960,14.283,7,24,17
183,MIL,P005670,P011205,24.583,-4,31,35
183,MIL,P005670,P011224,18.834,4,28,24
183,MIL,P006509,P006701,9.967,-4,23,27
183,MIL,P006509,P007201,12.951,-5,27,32
183,MIL,P006509,P009960,1.367,-4,3,7
183,MIL,P006509,P011205,2.45,-2,2,4
183,MIL,P006509,P011224,11.034,-5,25,30
183,MIL,P006701,P007201,16.533,-11,32,43
183,MIL,P006701,P009960,1.95,-4,3,7
183,MIL,P006701,P011205,9.649,-12,9,21
183,MIL,P006701,P011224,13.45,-9,29,38
183,MIL,P007201,P009960,2.317,-4,3,7
183,MIL,P007201,P011205,11.733,-7,13,20
183,MIL,P007201,P011224,18.217,-10,33,43
183,MIL,P009960,P011205,14.283,7,24,17
183,MIL,P009960,P011224,15.067,3,27,24
183,MIL,P011205,P011224,21.25,0,32,32
183,RED,P000848,P002553,2.483,0,2,2
183,RED,P000848,P005099,3.566,1,8,7
183,RED,P000848,P006436,0.067,0,0,0
183,RED,P000848,P008966,0.183,2,2,0
183,RED,P000848,P009035,7.683,1,14,13
183,RED,P000848,P011964,5.017,-1,10,11
183,RED,P000848,P012044,6.017,-1,10,11
183,RED,P000848,PJDR,1.666,2,4,2
183,RED,P000848,PLUO,4.05,0,6,6
183,RED,P002553,P005099,9.233,-6,7,13
183,RED,P002553,P006436,6.668,1,17,16
183,RED,P002553,P009035,12.567,-7,20,27
183,RED,P002553,P012044,5.534,-1,13,14
183,RED,P002553,PJDR,7.033,-6,7,13
183,RED,P002553,PLUO,6.75,-9,14,23
183,RED,P005099,P006436,17.401,19,35,16
183,RED,P005099,P007960,14.367,19,33,14
183,RED,P005099,P008966,0.45,2,2,0
183,RED,P005099,P009035,20.667,6,36,30
183,RED,P005099,P011941,4.35,8,10,2
183,RED,P005099,P011964,0.967,-1,4,5
183,RED,P005099,P012044,3.734,1,6,5
183,RED,P005099,PJDR,19.35,15,40,25
183,RED,P005099,PLUO,5.983,-8,3,11
183,RED,P006436,P007960,20.866,16,40,24
183,RED,P006436,P008966,0.267,0,0,0
183,RED,P006436,P009035,21.401,9,47,38
183,RED,P006436,P011941,6.933,10,12,2
183,RED,P006436,P012044,9.617,-2,22,24
183,RED,P006436,PJDR,17.2,23,37,14
183,RED,P006436,PLUO,12.916,0,26,26
183,RED,P007960,P009035,14.5,8,30,22
183,RED,P007960,P011941,6.933,10,12,2
183,RED,P007960,P012044,5.05,-1,9,10
183,RED,P007960,PJDR,14.9,21,33,12
183,RED,P007960,PLUO,9.116,-1,11,12
183,RED,P008966,P009035,0.45,2,2,0
183,RED,P008966,PJDR,0.45,2,2,0
183,RED,P009035,P011964,5.017,-1,10,11
183,RED,P009035,P012044,16.134,-1,34,35
183,RED,P009035,PJDR,15.983,9,32,23
183,RED,P009035,PLUO,17.866,-10,31,41
183,RED,P011941,PJDR,6.933,10,12,2
183,RED,P011941,PLUO,2.583,2,2,0
183,RED,P011964,P012044,5.017,-1,10,11
183,RED,P011964,PLUO,4.05,0,6,6
183,RED,P012044,PJDR,1.55,4,4,0
183,RED,P012044,PLUO,11.883,-2,28,30
183,RED,PJDR,PLUO,6.599,-4,5,9
184,MAD,P001392,P005791,16.5,4,33,29
184,MAD,P001392,P005928,16.5,4,33,29
184,MAD,P001392,P006540,16.5,4,33,29
184,MAD,P001392,P010357,16.5,4,33,29
184,MAD,P003108,P003733,13.183,1,26,25
184,MAD,P003108,P005791,18.168,5,40,35
184,MAD,P003108,P005928,10.451,3,24,21
184,MAD,P003108,P006540,9.417,14,27,13
184,MAD,P003108,P009213,6.683,1,14,13
184,MAD,P003108,P010357,2.851,-5,5,10
184,MAD,P003108,P010623,0.183,0,0,0
184,MAD,P003108,PCVM,14.251,7,34,27
184,MAD,P003108,PTGB,24.285,6,54,48
184,MAD,P003733,P005791,11.116,2,23,21
184,MAD,P003733,P005928,3.999,1,10,9
184,MAD,P003733,P006540,2.416,2,6,4
184,MAD,P003733,P009213,4.533,1,9,8
184,MAD,P003733,P010357,2.466,2,6,4
184,MAD,P003733,P010623,0.183,0,0,0
184,MAD,P003733,PCVM,11.467,2,22,20
184,MAD,P003733,PTGB,13.233,1,26,25
184,MAD,P005791,P005928,28.4,5,60,55
184,MAD,P005791,P006540,26.184,12,58,46
184,MAD,P005791,P010357,22.967,-5,43,48
184,MAD,P005791,P010623,0.667,-2,0,2
184,MAD,P005791,PCVM,9.234,4,20,16
184,MAD,P005791,PTGB,19.968,3,43,40
184,MAD,P005928,P006540,26.15,9,55,46
184,MAD,P005928,P009213,1.5,0,2,2
184,MAD,P005928,P010357,21.65,3,45,42
184,MAD,P005928,PCVM,0.017,2,2,0
184,MAD,P005928,PTGB,11.001,1,25,24
184,MAD,P006540,P009213,2.733,2,7,5
184,MAD,P006540,P010357,19.5,0,38,38
184,MAD,P006540,P010623,0.667,-2,0,2
184,MAD,P006540,PCVM,2.1,7,10,3
184,MAD,P006540,PTGB,10.001,8,26,18
184,MAD,P009213,P010623,0.183,0,0,0
184,MAD,P009213,PCVM,5.0,1,12,11
184,MAD,P009213,PTGB,6.1,-1,12,13
184,MAD,P010357,P010623,0.667,-2,0,2
184,MAD,P010357,PCVM,0.684,-2,2,4
184,MAD,P010357,PTGB,4.651,-7,8,15
184,MAD,P010623,PTGB,0.85,-2,0,2
184,MAD,PCVM,PTGB,14.251,7,34,27
184,PAM,P003960,P004863,16.401,4,43,39
184,PAM,P003960,P005356,2.784,-4,4,8
184,PAM,P003960,P006643,11.134,8,28,20
184,PAM,P003960,P007870,20.052,6,49,43
184,PAM,P003960,P010393,2.767,-2,4,6
184,PAM,P003960,P010568,16.252,-5,35,40
184,PAM,P003960,P011970,16.251,-5,33,38
184,PAM,P003960,P012738,6.35,-5,13,18
184,PAM,P003960,P012740,12.217,5,28,23
184,PAM,P003960,P012795,12.468,-6,27,33
184,PAM,P004863,P006643,11.867,5,28,23
184,PAM,P004863,P007870,14.151,1,33,32
184,PAM,P004863,P010393,1.65,-1,2,3
184,PAM,P004863,P010568,3.484,0,12,12
184,PAM,P004863,P011970,5.784,3,17,14
184,PAM,P004863,P012738,4.767,3,14,11
184,PAM,P004863,P012739,0.867,1,2,1
184,PAM,P004863,P012740,11.1,5,25,20
184,PAM,P004863,P012795,5.601,-5,12,17
184,PAM,P005356,P006643,0.6,0,2,2
184,PAM,P005356,P007870,0.017,-2,0,2
184,PAM,P005356,P010393,5.134,-4,6,10
184,PAM,P005356,P010568,5.151,-6,6,12
184,PAM,P005356,P011970,4.084,-2,4,6
184,PAM,P005356,P012738,1.767,-2,0,2
184,PAM,P005356,P012740,0.45,-2,0,2
184,PAM,P005356,P012795,0.617,-2,2,4
184,PAM,P006643,P007870,12.617,7,29,22
184,PAM,P006643,P010393,5.0,-2,9,11
184,PAM,P006643,P010568,5.434,0,12,12
184,PAM,P006643,P012738,2.917,-1,6,7
184,PAM,P006643,P012740,14.367,7,32,25
184,PAM,P006643,P012795,0.6,0,2,2
184,PAM,P007870,P010393,3.3,-2,5,7
184,PAM,P007870,P010568,12.685,3,33,30
184,PAM,P007870,P011970,8.951,1,20,19
184,PAM,P007870,P012740,12.567,9,29,20
184,PAM,P007870,P012795,9.068,-7,18,25
184,PAM,P010393,P010568,7.884,-5,11,16
184,PAM,P010393,P011970,4.084,-2,4,6
184,PAM,P010393,P012738,2.867,-2,2,4
184,PAM,P010393,P012740,4.85,-4,7,11
184,PAM,P010393,P012795,0.6,0,2,2
184,PAM,P010568,P011970,22.301,-9,34,43
184,PAM,P010568,P012738,13.517,-15,12,27
184,PAM,P010568,P012739,8.2,-6,9,15
184,PAM,P010568,P012740,5.967,-4,10,14
184,PAM,P010568,P012795,17.401,-9,30,39
184,PAM,P011970,P012738,14.917,-9,20,29
184,PAM,P011970,P012739,9.067,-5,11,16
184,PAM,P011970,P012740,1.35,-5,0,5
184,PAM,P011970,P012795,19.751,-7,33,40
184,PAM,P012738,P012739,9.067,-5,11,16
184,PAM,P012738,P012740,4.5,-8,6,14
184,PAM,P012738,P012795,12.467,-4,20,24
184,PAM,P012739,P012795,9.067,-5,11,16
184,PAM,P012740,P012795,0.9,1,3,2
185,IST,P006590,P007200,18.284,10,42,32
185,IST,P006590,P009664,17.55,7,39,32
185,IST,P006590,P009846,14.201,-4,27,31
185,IST,P006590,P010400,4.983,2,6,4
185,IST,P006590,P011078,8.651,9,26,17
185,IST,P006590,P011981,9.15,6,21,15
185,IST,P006590,P012710,3.167,-1,4,5
185,IST,P006590,P012788,10.234,2,23,21
185,IST,P006590,PLHK,3.984,-3,4,7
185,IST,P007200,P009664,25.383,26,72,46
185,IST,P007200,P009846,26.067,17,70,53
185,IST,P007200,P010400,5.75,6,15,9
185,IST,P007200,P011078,19.75,26,60,34
185,IST,P007200,P011981,16.0,6,38,32
185,IST,P007200,P012710,3.167,-1,4,5
185,IST,P007200,P012788,12.467,18,40,22
185,IST,P007200,PLHK,10.8,4,23,19
185,IST,P009664,P009846,24.967,12,63,51
185,IST,P009664,P010400,8.8,8,20,12
185,IST,P009664,P011078,13.75,19,46,27
185,IST,P009664,P011981,12.05,3,28,25
185,IST,P009664,P012788,15.317,16,43,27
185,IST,P009664,PLHK,2.783,5,9,4
185,IST,P009846,P010400,7.184,5,17,12
185,IST,P009846,P011078,16.867,11,47,36
185,IST,P009846,P011981,14.401,1,36,35
185,IST,P009846,P012788,14.467,7,33,26
185,IST,P009846,PLHK,8.45,3,19,16
185,IST,P010400,P011078,1.317,-1,2,3
185,IST,P010400,P011981,5.217,0,10,10
185,IST,P010400,P012788,4.4,6,10,4
185,IST,P010400,PLHK,0.817,-2,0,2
185,IST,P011078,P011981,10.0,8,29,21
185,IST,P011078,P012710,3.167,-1,4,5
185,IST,P011078,P012788,6.834,9,23,14
185,IST,P011078,PLHK,10.8,4,23,19
185,IST,P011981,PLHK,4.85,0,10,10
185,IST,P012710,PLHK,3.167,-1,4,5
185,IST,P012788,PLHK,0.817,-2,0,2
185,VIR,P001133,P001844,4.784,0,9,9
185,VIR,P001133,P003048,14.6,-14,24,38
185,VIR,P001133,P003527,4.817,-11,2,13
185,VIR,P001133,P005553,0.167,0,0,0
185,VIR,P001133,P006739,9.816,-14,15,29
185,VIR,P001133,P009549,6.617,1,16,15
185,VIR,P001133,P010781,7.816,-15,8,23
185,VIR,P001133,PBCN,9.783,-3,22,25
185,VIR,P001844,P002084,12.666,-1,23,24
185,VIR,P001844,P003048,14.833,-8,29,37
185,VIR,P001844,P003527,9.683,-6,20,26
185,VIR,P001844,P004554,8.216,-3,13,16
185,VIR,P001844,P005553,5.133,-1,12,13
185,VIR,P001844,P008847,9.633,2,21,19
185,VIR,P001844,P009549,17.9,-7,34,41
185,VIR,P001844,P010781,10.133,-4,16,20
185,VIR,P001844,PBCN,13.483,0,27,27
185,VIR,P002084,P003048,4.766,-6,5,11
185,VIR,P002084,P003527,4.15,-5,8,13
185,VIR,P002084,P004554,4.333,1,9,8
185,VIR,P002084,P005553,4.517,-3,11,14
185,VIR,P002084,P006739,0.9,4,4,0
185,VIR,P002084,P008847,7.134,1,18,17
185,VIR,P002084,P009549,9.733,-3,18,21
185,VIR,P002084,P010781,8.0,-2,16,18
185,VIR,P002084,PBCN,8.733,-2,16,18
185,VIR,P003048,P003527,11.583,-11,20,31
185,VIR,P003048,P005553,2.35,2,8,6
185,VIR,P003048,P006739,9.816,-14,15,29
185,VIR,P003048,P008847,2.183,2,8,6
185,VIR,P003048,P009549,12.5,-11,25,36
185,VIR,P003048,P010781,12.899,-17,18,35
185,VIR,P003048,PBCN,13.066,-11,24,35
185,VIR,P003527,P004554,0.833,-3,2,5
185,VIR,P003527,P005553,5.85,-8,15,23
185,VIR,P003527,P006739,2.733,-8,2,10
185,VIR,P003527,P008847,5.683,-8,15,23
185,VIR,P003527,P009549,3.1,-4,7,11
185,VIR,P003527,P010781,11.9,-20,17,37
185,VIR,P004554,P005553,1.833,-3,2,5
185,VIR,P004554,P008847,3.883,-4,4,8
185,VIR,P004554,P009549,7.383,0,11,11
185,VIR,P004554,PBCN,6.383,0,11,11
185,VIR,P005553,P006739,0.9,4,4,0
185,VIR,P005553,P008847,8.533,-4,21,25
185,VIR,P005553,P009549,1.0,0,0,0
185,VIR,P005553,P010781,4.517,-3,11,14
185,VIR,P006739,P008847,0.9,4,4,0
185,VIR,P006739,P009549,4.6,0,9,9
185,VIR,P006739,P010781,6.116,-10,10,20
185,VIR,P006739,PBCN,7.083,-6,13,19
185,VIR,P008847,P009549,5.667,3,9,6
185,VIR,P008847,P010781,6.017,-4,13,17
185,VIR,P008847,PBCN,3.167,4,7,3
185,VIR,P009549,P010781,4.6,-5,9,14
185,VIR,P009549,PBCN,16.9,-2,34,36
185,VIR,P010781,PBCN,3.666,-4,6,10
186,ASV,P000229,P003526,1.383,0,2,2
186,ASV,P000229,P004194,14.317,-7,18,25
186,ASV,P000229,P006568,1.467,-3,2,5
186,ASV,P000229,P011225,5.451,-2,8,10
186,ASV,P000229,P011386,10.333,-8,12,20
186,ASV,P000229,P012080,5.134,-6,9,15
186,ASV,P000229,P012729,5.05,-6,5,11
186,ASV,P000229,P012731,10.734,-4,15,19
186,ASV,P000229,PKIR,9.267,-4,9,13
186,ASV,P003526,P004194,3.183,-3,5,8
186,ASV,P003526,P006568,10.367,-14,12,26
186,ASV,P003526,P011225,10.367,-14,12,26
186,ASV,P003526,P011386,1.383,0,2,2
186,ASV,P003526,P012080,10.367,-14,12,26
186,ASV,P003526,P012729,8.567,-11,9,20
186,ASV,P003526,P012731,1.383,0,2,2
186,ASV,P004194,P006568,3.15,-3,7,10
186,ASV,P004194,P011225,13.684,-4,25,29
186,ASV,P004194,P011386,10.333,-8,12,20
186,ASV,P004194,P012080,13.367,-8,26,34
186,ASV,P004194,P012729,4.966,-5,5,10
186,ASV,P004194,P012731,15.901,-4,25,29
186,ASV,P004194,PKIR,17.167,-6,25,31
186,ASV,P006568,P011225,19.134,-16,33,49
186,ASV,P006568,P012080,19.134,-16,33,49
186,ASV,P006568,P012729,12.601,-21,16,37
186,ASV,P006568,P012731,3.383,8,10,2
186,ASV,P006568,PKIR,7.3,1,19,18
186,ASV,P011225,P012080,27.401,-18,48,66
186,ASV,P011225,P012729,16.651,-23,21,44
186,ASV,P011225,P012731,9.867,9,23,14
186,ASV,P011225,PKIR,16.117,0,34,34
186,ASV,P011386,P012080,1.95,-3,4,7
186,ASV,P011386,P012729,0.916,-3,0,3
186,ASV,P011386,P012731,9.417,-5,12,17
186,ASV,P011386,PKIR,7.0,-5,6,11
186,ASV,P012080,P012729,16.134,-23,21,44
186,ASV,P012080,P012731,10.067,5,24,19
186,ASV,P012080,PKIR,13.85,-1,31,32
186,ASV,P012729,PKIR,5.383,-12,7,19
186,ASV,P012731,PKIR,16.384,7,29,22
186,BER,P003958,P006251,11.634,8,25,17
186,BER,P003958,P008173,10.633,6,24,18
186,BER,P003958,P008211,13.167,9,28,19
186,BER,P003958,P008384,13.583,16,34,18
186,BER,P003958,P008967,10.85,2,21,19
186,BER,P003958,P010791,8.183,7,21,14
186,BER,P003958,P011934,3.983,0,6,6
186,BER,P003958,P012720,12.9,2,26,24
186,BER,P003958,P012721,10.267,10,23,13
186,BER,P006251,P006819,1.384,0,2,2
186,BER,P006251,P007025,1.384,0,2,2
186,BER,P006251,P008173,9.6,7,19,12
186,BER,P006251,P008211,10.168,0,19,19
186,BER,P006251,P008384,16.417,8,31,23
186,BER,P006251,P008967,3.084,-1,7,8
186,BER,P006251,P011934,6.75,-1,11,12
186,BER,P006251,P012720,4.718,-1,9,10
186,BER,P006251,P012721,13.933,8,27,19
186,BER,P006819,P007025,1.384,0,2,2
186,BER,P006819,P008211,1.384,0,2,2
186,BER,P006819,P008384,1.117,0,2,2
186,BER,P006819,P012720,0.267,0,0,0
186,BER,P007025,P008211,1.384,0,2,2
186,BER,P007025,P008384,1.117,0,2,2
186,BER,P007025,P012720,0.267,0,0,0
186,BER,P008173,P008384,12.916,13,30,17
186,BER,P008173,P008967,8.567,4,18,14
186,BER,P008173,P010791,8.8,10,23,13
186,BER,P008173,P011934,12.667,5,24,19
186,BER,P008173,P012720,11.984,4,25,21
186,BER,P008173,P012721,8.233,7,17,10
186,BER,P008211,P008384,6.817,1,12,11
186,BER,P008211,P008967,12.067,10,31,21
186,BER,P008211,P010791,7.45,8,21,13
186,BER,P008211,P011934,6.133,5,16,11
186,BER,P008211,P012720,12.334,10,31,21
186,BER,P008211,P012721,5.7,1,10,9
186,BER,P008384,P008967,0.633,3,3,0
186,BER,P008384,P010791,2.683,3,8,5
186,BER,P008384,P011934,5.666,1,9,8
186,BER,P008384,P012720,4.05,3,10,7
186,BER,P008384,P012721,13.933,8,27,19
186,BER,P008967,P010791,13.567,15,36,21
186,BER,P008967,P011934,13.767,12,34,22
186,BER,P008967,P012720,20.001,11,46,35
186,BER,P010791,P011934,8.067,11,23,12
186,BER,P010791,P012720,16.25,18,44,26
186,BER,P011934,P012720,14.501,9,33,24
186,BER,P011934,P012721,3.666,-2,4,6
187,BAR,P000925,P002939,16.15,5,37,32
187,BAR,P000925,P003204,2.734,-1,6,7
187,BAR,P000925,P004866,10.367,9,26,17
187,BAR,P000925,P007464,10.4,-4,21,25
187,BAR,P000925,P007519,2.733,-8,2,10
187,BAR,P000925,P009992,7.633,14,23,9
187,BAR,P000925,P011244,3.867,-9,6,15
187,BAR,P000925,P011666,1.567,0,4,4
187,BAR,P000925,P012197,1.567,0,4,4
187,BAR,P000925,P012745,13.85,14,35,21
187,BAR,P002939,P003196,8.417,1,16,15
187,BAR,P002939,P003204,1.167,-1,2,3
187,BAR,P002939,P004866,19.617,10,44,34
187,BAR,P002939,P007464,13.367,-10,23,33
187,BAR,P002939,P007519,2.733,-8,2,10
187,BAR,P002939,P009992,14.866,18,39,21
187,BAR,P002939,P011244,5.15,-12,6,18
187,BAR,P002939,P012745,20.133,21,51,30
187,BAR,P003196,P004866,17.084,12,41,29
187,BAR,P003196,P007464,7.333,-5,9,14
187,BAR,P003196,P007519,13.033,12,32,20
187,BAR,P003196,P009992,19.433,16,46,30
187,BAR,P003196,P011244,8.55,2,17,15
187,BAR,P003196,P012745,11.95,14,31,17
187,BAR,P003204,P007464,1.167,-1,2,3
187,BAR,P003204,P011244,1.784,-1,4,5
187,BAR,P003204,P011666,1.567,0,4,4
187,BAR,P003204,P012197,1.567,0,4,4
187,BAR,P003204,P012745,0.95,0,2,2
187,BAR,P004866,P007464,7.584,-6,12,18
187,BAR,P004866,P007519,8.667,11,25,14
187,BAR,P004866,P009992,21.65,24,57,33
187,BAR,P004866,P011244,6.25,1,12,11
187,BAR,P004866,P012745,21.917,23,59,36
187,BAR,P007464,P007519,7.099,-7,9,16
187,BAR,P007464,P009992,7.199,3,14,11
187,BAR,P007464,P011244,7.45,-11,11,22
187,BAR,P007464,P012745,9.333,5,19,14
187,BAR,P007519,P009992,13.033,12,32,20
187,BAR,P007519,P011244,8.616,-3,17,20
187,BAR,P007519,P012745,7.15,7,17,10
187,BAR,P009992,P011244,7.366,5,17,12
187,BAR,P009992,P012745,20.416,28,56,28
187,BAR,P011244,P011666,1.567,0,4,4
187,BAR,P011244,P012197,1.567,0,4,4
187,BAR,P011244,P012745,0.833,0,2,2
187,BAR,P011666,P012197,1.567,0,4,4
187,ZAL,P002329,P003210,4.6,-1,9,10
187,ZAL,P002329,P003211,6.183,-15,0,15
187,ZAL,P002329,P005504,24.884,-2,52,54
187,ZAL,P002329,P007109,12.916,-19,9,28
187,ZAL,P002329,P007513,2.083,3,7,4
187,ZAL,P002329,P009917,3.3,-1,3,4
187,ZAL,P002329,P010390,1.067,0,0,0
187,ZAL,P002329,P011218,22.984,4,43,39
187,ZAL,P002329,P012715,16.667,8,40,32
187,ZAL,P002329,P012787,21.984,-1,45,46
187,ZAL,P003210,P003211,10.75,-13,18,31
187,ZAL,P003210,P005504,5.383,-3,14,17
187,ZAL,P003210,P007109,10.966,-8,20,28
187,ZAL,P003210,P007513,2.083,3,7,4
187,ZAL,P003210,P009917,5.8,-7,10,17
187,ZAL,P003210,P010390,5.234,-7,11,18
187,ZAL,P003210,P012715,7.75,-8,14,22
187,ZAL,P003210,P012787,2.834,-4,5,9
187,ZAL,P003211,P005504,3.533,-13,5,18
187,ZAL,P003211,P007109,14.449,-25,14,39
187,ZAL,P003211,P009917,9.4,-14,11,25
187,ZAL,P003211,P010390,6.401,-8,13,21
187,ZAL,P003211,P011218,4.266,-2,3,5
187,ZAL,P003211,P012715,9.649,-11,15,26
187,ZAL,P003211,P012787,3.433,-7,5,12
187,ZAL,P005504,P007109,10.266,-17,14,31
187,ZAL,P005504,P007513,2.083,3,7,4
187,ZAL,P005504,P009917,0.917,1,3,2
187,ZAL,P005504,P011218,20.051,6,43,37
187,ZAL,P005504,P012715,16.967,10,45,35
187,ZAL,P005504,P012787,21.984,-1,45,46
187,ZAL,P007109,P007513,2.083,3,7,4
187,ZAL,P007109,P009917,9.183,-12,9,21
187,ZAL,P007109,P010390,4.001,-8,6,14
187,ZAL,P007109,P011218,8.383,-11,3,14
187,ZAL,P007109,P012715,7.249,-11,8,19
187,ZAL,P007109,P012787,5.9,-16,2,18
187,ZAL,P009917,P010390,2.984,-8,8,16
187,ZAL,P009917,P011218,3.433,1,4,3
187,ZAL,P009917,P012715,4.833,-7,5,12
187,ZAL,P009917,P012787,0.75,3,3,0
187,ZAL,P010390,P011218,0.75,2,2,0
187,ZAL,P010390,P012715,2.817,-3,7,10
187,ZAL,P010390,P012787,2.35,0,5,5
187,ZAL,P011218,P012715,16.316,14,41,27
187,ZAL,P011218,P012787,20.417,10,45,35
187,ZAL,P012715,P012787,17.684,12,45,33
188,BAS,P003198,P004603,17.05,9,34,25
188,BAS,P003198,P004761,13.05,3,21,18
188,BAS,P003198,P007230,14.85,-2,21,23
188,BAS,P003198,P009048,7.617,7,23,16
188,BAS,P003198,P010444,3.617,1,10,9
188,BAS,P003198,P011948,7.617,7,23,16
188,BAS,P003198,P012201,5.817,12,23,11
188,BAS,P003198,P012765,13.05,3,21,18
188,BAS,P004603,P004761,19.267,-5,28,33
188,BAS,P004603,P007230,18.416,3,31,28
188,BAS,P004603,P009048,19.017,7,41,34
188,BAS,P004603,P011085,7.767,5,16,11
188,BAS,P004603,P011948,14.867,11,36,25
188,BAS,P004603,P012201,18.834,7,41,34
188,BAS,P004603,P012765,13.05,3,21,18
188,BAS,P004761,P007230,13.15,3,21,18
188,BAS,P004761,P008850,0.1,0,0,0
188,BAS,P004761,P009048,8.4,-7,12,19
188,BAS,P004761,P010444,2.083,1,5,4
188,BAS,P004761,P011085,4.15,-4,5,9
188,BAS,P004761,P011948,4.15,-3,7,10
188,BAS,P004761,P012201,8.4,-7,12,19
188,BAS,P004761,P012765,13.05,3,21,18
188,BAS,P007230,P008850,0.1,0,0,0
188,BAS,P007230,P009048,7.083,-5,10,15
188,BAS,P007230,P010444,1.617,-5,0,5
188,BAS,P007230,P011948,6.983,-5,10,15
188,BAS,P007230,P012201,5.283,0,10,10
188,BAS,P007230,P012765,13.05,3,21,18
188,BAS,P008850,P009048,0.1,0,0,0
188,BAS,P008850,P012201,0.1,0,0,0
188,BAS,P009048,P010444,7.833,1,18,17
188,BAS,P009048,P011085,9.9,4,19,15
188,BAS,P009048,P011948,22.7,12,54,42
188,BAS,P009048,P012201,25.15,13,59,46
188,BAS,P010444,P011085,2.133,-1,3,4
188,BAS,P010444,P011948,7.833,1,18,17
188,BAS,P010444,P012201,6.216,6,18,12
188,BAS,P011085,P011948,5.75,8,14,6
188,BAS,P011085,P012201,9.9,4,19,15
188,BAS,P011948,P012201,20.9,17,54,37
188,OLY,P001255,P003941,7.95,-2,13,15
188,OLY,P001255,P007982,9.516,2,19,17
188,OLY,P001255,P008811,8.666,-2,12,14
188,OLY,P001255,P008829,16.433,-4,25,29
188,OLY,P001255,P008855,7.1,-6,6,12
188,OLY,P001255,P010612,16.616,-4,25,29
188,OLY,P001255,P011194,0.183,0,0,0
188,OLY,P003941,P007853,4.967,-7,4,11
188,OLY,P003941,P007982,22.966,2,44,42
188,OLY,P003941,P008829,7.767,-2,13,15
188,OLY,P003941,P008855,4.85,4,9,5
188,OLY,P003941,P010392,9.45,-5,18,23
188,OLY,P003941,P010612,14.383,7,30,23
188,OLY,P003941,P011194,16.766,2,31,29
188,OLY,P003941,P011983,9.033,1,14,13
188,OLY,P007853,P007982,9.017,-13,13,26
188,OLY,P007853,P008811,4.05,-6,9,15
188,OLY,P007853,P008829,4.05,-6,9,15
188,OLY,P007853,P010392,1.117,-8,0,8
188,OLY,P007853,P010612,4.05,-6,9,15
188,OLY,P007853,P011194,4.967,-7,4,11
188,OLY,P007853,P011983,3.85,1,4,3
188,OLY,P007982,P008811,9.833,-7,19,26
188,OLY,P007982,P008829,15.0,-3,32,35
188,OLY,P007982,P008855,5.933,3,13,10
188,OLY,P007982,P010392,9.55,-5,18,23
188,OLY,P007982,P010612,22.749,2,49,47
188,OLY,P007982,P011194,17.999,-2,31,33
188,OLY,P007982,P011983,9.033,1,14,13
188,OLY,P008811,P008829,14.233,-7,25,32
188,OLY,P008811,P008855,8.183,-7,10,17
188,OLY,P008811,P010612,15.366,-11,25,36
188,OLY,P008811,P011194,1.133,-4,0,4
188,OLY,P008829,P008855,8.617,-5,10,15
188,OLY,P008829,P010392,0.1,0,0,0
188,OLY,P008829,P010612,22.1,-9,38,47
188,OLY,P008829,P011194,0.1,0,0,0
188,OLY,P008855,P010612,11.25,-3,16,19
188,OLY,P008855,P011194,4.416,2,9,7
188,OLY,P008855,P011983,1.783,0,3,3
188,OLY,P010392,P010612,5.033,3,11,8
188,OLY,P010392,P011194,9.55,-5,18,23
188,OLY,P010392,P011983,3.4,0,7,7
188,OLY,P010612,P011194,7.849,5,17,12
188,OLY,P011194,P011983,9.033,1,14,13
189,PAR,P004058,P004172,0.717,-3,3,6
189,PAR,P004058,P007400,17.017,24,52,28
189,PAR,P004058,P007673,16.167,24,49,25
189,PAR,P004058,P008987,13.566,22,40,18
189,PAR,P004058,P009862,3.383,6,8,2
189,PAR,P004058,P011051,9.683,12,23,11
189,PAR,P004058,P012096,14.567,24,47,23
189,PAR,P004058,P012742,6.5,11,18,7
189,PAR,P004172,P007400,0.717,-3,3,6
189,PAR,P004172,P007673,0.717,-3,3,6
189,PAR,P004172,P012096,0.717,-3,3,6
189,PAR,P007400,P007673,14.617,15,41,26
189,PAR,P007400,P008987,17.466,7,43,36
189,PAR,P007400,P009862,7.917,-8,15,23
189,PAR,P007400,P011051,12.967,-2,25,27
189,PAR,P007400,P012096,20.617,19,56,37
189,PAR,P007400,P012742,15.75,0,33,33
189,PAR,P007673,P008987,23.149,7,48,41
189,PAR,P007673,P009862,13.233,-4,21,25
189,PAR,P007673,P011051,11.167,9,25,16
189,PAR,P007673,P011192,3.533,-13,0,13
189,PAR,P007673,P012096,18.4,4,41,37
189,PAR,P007673,P012742,10.417,5,20,15
189,PAR,P008987,P009862,18.683,-10,32,42
189,PAR,P008987,P011051,14.75,3,32,29
189,PAR,P008987,P011192,3.533,-13,0,13
189,PAR,P008987,P012096,15.449,0,32,32
189,PAR,P008987,P012742,16.2,-4,29,33
189,PAR,P009862,P011051,14.767,1,31,30
189,PAR,P009862,P011192,3.533,-13,0,13
189,PAR,P009862,P012096,8.35,-15,9,24
189,PAR,P009862,P012742,14.734,-5,28,33
189,PAR,P011051,P012096,6.817,4,14,10
189,PAR,P011051,P012742,16.117,1,34,33
189,PAR,P011192,P012096,3.533,-13,0,13
189,PAR,P012096,P012742,10.55,4,22,18
189,TEL,P007990,P009622,3.8,-7,4,11
189,TEL,P007990,P009783,5.25,-11,11,22
189,TEL,P007990,P009863,5.783,-7,9,16
189,TEL,P007990,P011193,8.25,0,20,20
189,TEL,P007990,P011199,2.884,0,7,7
189,TEL,P007990,P011214,7.683,0,18,18
189,TEL,P007990,P011219,7.733,-11,13,24
189,TEL,P007990,P011971,8.784,1,20,19
189,TEL,P007990,P012744,5.033,7,14,7
189,TEL,P009622,P009783,20.216,-4,33,37
189,TEL,P009622,P009863,24.65,-3,43,46
189,TEL,P009622,P011193,6.134,-7,14,21
189,TEL,P009622,P011199,17.517,-2,29,31
189,TEL,P009622,P011214,4.467,-3,10,13
189,TEL,P009622,P011219,20.283,1,35,34
189,TEL,P009622,P011971,12.35,-14,18,32
189,TEL,P009622,P012744,2.183,-1,2,3
189,TEL,P009783,P009863,23.266,-4,42,46
189,TEL,P009783,P011193,6.684,-11,14,25
189,TEL,P009783,P011199,19.267,-2,36,38
189,TEL,P009783,P011214,4.25,-7,8,15
189,TEL,P009783,P011219,17.099,5,36,31
189,TEL,P009783,P011971,9.4,-10,12,22
189,TEL,P009783,P012744,0.5,0,0,0
189,TEL,P009863,P011193,4.8,1,15,14
189,TEL,P009863,P011199,19.65,-1,35,36
189,TEL,P009863,P011214,3.133,5,11,6
189,TEL,P009863,P011219,19.183,7,36,29
189,TEL,P009863,P011971,11.483,-7,20,27
189,TEL,P009863,P012744,1.316,1,1,0
189,TEL,P011193,P011199,3.534,-3,9,12
189,TEL,P011193,P011214,13.75,-2,35,37
189,TEL,P011193,P011219,6.116,-16,8,24
189,TEL,P011193,P011971,9.352,7,30,23
189,TEL,P011193,P012744,7.316,7,19,12
189,TEL,P011199,P011214,0.8,1,3,2
189,TEL,P011199,P011219,13.15,9,28,19
189,TEL,P011199,P011971,4.934,-7,6,13
189,TEL,P011199,P012744,0.8,1,3,2
189,TEL,P011214,P011219,6.616,-16,8,24
189,TEL,P011214,P011971,8.785,7,28,21
189,TEL,P011214,P012744,7.516,7,19,12
189,TEL,P011219,P011971,6.9,-7,10,17
189,TEL,P011219,P012744,2.516,-4,2,6
189,TEL,P011971,P012744,4.884,10,16,6
190,BER,P003958,P008173,21.3,9,46,37
190,BER,P003958,P008384,1.35,0,3,3
190,BER,P003958,P008780,3.634,-4,5,9
190,BER,P003958,P008967,12.901,4,27,23
190,BER,P003958,P010791,3.634,-4,5,9
190,BER,P003958,P011934,21.3,9,46,37
190,BER,P003958,P012720,22.567,7,48,41
190,BER,P003958,P012721,13.05,-1,24,25
190,BER,P006251,P008173,1.267,-3,0,3
190,BER,P006251,P008384,4.983,-10,4,14
190,BER,P006251,P008780,4.983,-10,4,14
190,BER,P006251,P008967,6.25,-13,4,17
190,BER,P006251,P010791,6.25,-13,4,17
190,BER,P006251,P012720,1.267,-3,0,3
190,BER,P008173,P008211,0.933,0,0,0
190,BER,P008173,P008384,3.383,-2,3,5
190,BER,P008173,P008967,12.734,3,24,21
190,BER,P008173,P010791,3.3,-5,0,5
190,BER,P008173,P011934,22.4,9,48,39
190,BER,P008173,P012720,22.317,6,45,39
190,BER,P008173,P012721,15.166,-1,26,27
190,BER,P008211,P008384,4.866,-6,6,12
190,BER,P008211,P008780,4.816,-5,8,13
190,BER,P008211,P008967,0.883,1,2,1
190,BER,P008211,P010791,5.749,-5,8,13
190,BER,P008211,P012721,5.749,-5,8,13
190,BER,P008384,P008780,8.916,-16,10,26
190,BER,P008384,P008967,7.433,-12,7,19
190,BER,P008384,P010791,10.949,-18,10,28
190,BER,P008384,P011934,1.35,0,3,3
190,BER,P008384,P012721,5.966,-8,6,14
190,BER,P008780,P008967,10.367,-15,11,26
190,BER,P008780,P010791,13.433,-19,17,36
190,BER,P008780,P011934,0.867,-2,0,2
190,BER,P008780,P012720,3.484,-4,5,9
190,BER,P008780,P012721,6.7,-9,8,17
190,BER,P008967,P010791,11.867,-18,11,29
190,BER,P008967,P011934,11.234,6,24,18
190,BER,P008967,P012720,13.768,1,26,25
190,BER,P008967,P012721,4.967,-5,4,9
190,BER,P010791,P012720,3.884,-5,5,10
190,BER,P010791,P012721,7.866,-9,8,17
190,BER,P011934,P012720,21.917,7,45,38
190,BER,P011934,P012721,14.0,-1,26,27
190,BER,P012720,P012721,14.0,-1,26,27
190,MUN,P001288,P001557,5.967,8,14,6
190,MUN,P001288,P003583,5.55,8,15,7
190,MUN,P001288,P004508,14.333,19,33,14
190,MUN,P001288,P006543,2.516,1,5,4
190,MUN,P001288,P007056,3.383,6,11,5
190,MUN,P001288,P007639,10.733,18,28,10
190,MUN,P001288,P007975,12.45,18,30,12
190,MUN,P001288,P008985,3.833,8,13,5
190,MUN,P001288,P010391,4.417,11,13,2
190,MUN,P001288,P011987,1.95,7,10,3
190,MUN,P001557,P003583,4.083,1,6,5
190,MUN,P001557,P004508,7.45,9,17,8
190,MUN,P001557,P007056,2.983,-1,4,5
190,MUN,P001557,P007639,8.083,7,19,12
190,MUN,P001557,P007975,7.45,9,17,8
190,MUN,P001557,P008985,4.716,-1,8,9
190,MUN,P001557,P010391,3.216,1,7,6
190,MUN,P001557,P011987,4.716,-1,8,9
190,MUN,P003583,P004508,4.333,3,8,5
190,MUN,P003583,P006543,1.333,1,3,2
190,MUN,P003583,P006760,6.183,-10,4,14
190,MUN,P003583,P007056,19.632,-11,32,43
190,MUN,P003583,P007975,2.45,2,5,3
190,MUN,P003583,P008985,20.232,-12,32,44
190,MUN,P003583,P010391,8.583,-9,14,23
190,MUN,P003583,P011987,18.349,-13,29,42
190,MUN,P004508,P006543,2.516,1,5,4
190,MUN,P004508,P007056,2.166,1,4,3
190,MUN,P004508,P007639,12.216,19,31,12
190,MUN,P004508,P007975,14.666,21,36,15
190,MUN,P004508,P008985,1.883,1,3,2
190,MUN,P004508,P010391,6.633,14,19,5
190,MUN,P006543,P007639,2.45,3,5,2
190,MUN,P006543,P007975,1.183,0,2,2
190,MUN,P006543,P008985,2.6,4,6,2
190,MUN,P006543,P010391,1.267,3,3,0
190,MUN,P006543,P011987,1.267,3,3,0
190,MUN,P006760,P007056,6.183,-10,4,14
190,MUN,P006760,P008985,6.183,-10,4,14
190,MUN,P006760,P011987,6.183,-10,4,14
190,MUN,P007056,P007639,2.983,4,8,4
190,MUN,P007056,P007975,3.716,6,11,5
190,MUN,P007056,P008985,18.899,-13,29,42
190,MUN,P007056,P010391,10.066,-2,21,23
190,MUN,P007056,P011987,20.449,-8,36,44
190,MUN,P007639,P007975,14.316,24,38,14
190,MUN,P007639,P008985,3.0,3,7,4
190,MUN,P007639,P010391,10.383,22,30,8
190,MUN,P007639,P011987,5.1,8,14,6
190,MUN,P007975,P010391,8.733,19,26,7
190,MUN,P007975,P011987,2.1,5,7,2
190,MUN,P008985,P010391,10.233,-6,18,24
190,MUN,P008985,P011987,21.349,-10,36,46
190,MUN,P010391,P011987,12.333,-1,25,26
191,BAS,P003198,P004603,3.283,-3,5,8
191,BAS,P003198,P008850,3.283,-3,5,8
191,BAS,P003198,P009048,4.217,3,14,11
191,BAS,P003198,P010444,4.217,3,14,11
191,BAS,P003198,P011085,7.5,0,19,19
191,BAS,P003198,P012201,7.5,0,19,19
191,BAS,P004603,P004761,3.317,-6,8,14
191,BAS,P004603,P007230,3.317,-6,8,14
191,BAS,P004603,P008850,3.283,-3,5,8
191,BAS,P004603,P009048,3.317,-6,8,14
191,BAS,P004603,P011085,3.283,-3,5,8
191,BAS,P004603,P011948,3.317,-6,8,14
191,BAS,P004603,P012201,3.283,-3,5,8
191,BAS,P004761,P007230,14.717,-17,32,49
191,BAS,P004761,P008850,0.45,0,3,3
191,BAS,P004761,P009048,24.784,6,60,54
191,BAS,P004761,P010444,22.7,14,53,39
191,BAS,P004761,P011085,5.533,-3,9,12
191,BAS,P004761,P011948,19.617,8,49,41
191,BAS,P004761,P012201,20.35,10,50,40
191,BAS,P007230,P008850,0.45,0,3,3
191,BAS,P007230,P009048,16.267,-16,32,48
191,BAS,P007230,P010444,14.183,-8,25,33
191,BAS,P007230,P011085,5.583,1,10,9
191,BAS,P007230,P011948,11.05,-18,20,38
191,BAS,P007230,P012201,11.833,-12,22,34
191,BAS,P008850,P009048,0.45,0,3,3
191,BAS,P008850,P011085,3.283,-3,5,8
191,BAS,P008850,P012201,3.733,-3,8,11
191,BAS,P009048,P010444,28.467,18,67,49
191,BAS,P009048,P011085,11.133,2,25,23
191,BAS,P009048,P011948,19.784,7,47,40
191,BAS,P009048,P012201,26.117,14,64,50
191,BAS,P010444,P011085,11.133,2,25,23
191,BAS,P010444,P011948,18.15,15,43,28
191,BAS,P010444,P012201,27.35,16,65,49
191,BAS,P011085,P012201,10.216,0,22,22
191,BAS,P011948,P012201,19.55,10,45,35
191,RED,P002553,P005099,1.65,-4,1,5
191,RED,P002553,P006436,23.317,2,53,51
191,RED,P002553,P009035,18.317,1,42,41
191,RED,P002553,P011941,5.417,5,15,10
191,RED,P002553,P012044,22.467,10,56,46
191,RED,P002553,P012801,3.967,3,10,7
191,RED,P002553,PLUO,19.801,7,51,44
191,RED,P005099,P006436,13.283,-9,22,31
191,RED,P005099,P007960,16.033,-7,30,37
191,RED,P005099,P009035,14.616,-7,24,31
191,RED,P005099,P011941,3.067,-4,7,11
191,RED,P005099,P012044,3.733,4,6,2
191,RED,P005099,P012801,13.95,-15,25,40
191,RED,P005099,PLUO,4.4,-2,9,11
191,RED,P006436,P007960,11.633,-5,21,26
191,RED,P006436,P009035,29.766,-8,62,70
191,RED,P006436,P011941,5.417,5,15,10
191,RED,P006436,P012044,25.633,10,61,51
191,RED,P006436,P012801,12.066,-10,24,34
191,RED,P006436,PLUO,19.617,3,50,47
191,RED,P007960,P009035,12.966,-3,23,26
191,RED,P007960,P011941,3.067,-4,7,11
191,RED,P007960,P012044,3.35,4,6,2
191,RED,P007960,P012801,12.683,-11,24,35
191,RED,P007960,PLUO,4.4,-2,9,11
191,RED,P009035,P012044,20.633,9,50,41
191,RED,P009035,P012801,13.816,-4,30,34
191,RED,P009035,PLUO,15.95,4,41,37
191,RED,P011941,P012044,5.417,5,15,10
191,RED,P011941,P012801,3.067,-4,7,11
191,RED,P011941,PLUO,8.484,1,22,21
191,RED,P012044,P012801,2.933,7,12,5
191,RED,P012044,PLUO,20.034,7,54,47
191,RED,P012801,PLUO,5.05,2,16,14
192,ASV,P000229,P003526,0.983,-2,0,2
192,ASV,P000229,P004194,9.7,0,13,13
192,ASV,P000229,P005094,8.566,1,11,10
192,ASV,P000229,P006568,1.517,-1,2,3
192,ASV,P000229,P011225,0.883,-3,2,5
192,ASV,P000229,P011386,8.817,3,11,8
192,ASV,P000229,P012080,0.383,0,0,0
192,ASV,P000229,P012729,0.333,0,2,2
192,ASV,P000229,P012731,9.15,2,11,9
192,ASV,P003526,P004194,4.066,-7,2,9
192,ASV,P003526,P005094,9.833,-3,17,20
192,ASV,P003526,P006568,15.7,7,32,25
192,ASV,P003526,P011225,19.166,2,34,32
192,ASV,P003526,P011386,0.6,-2,0,2
192,ASV,P003526,P012080,19.549,2,34,32
192,ASV,P003526,P012729,10.316,3,17,14
192,ASV,P003526,P012731,0.383,0,0,0
192,ASV,P004194,P005094,12.549,-10,15,25
192,ASV,P004194,P006568,4.867,-1,7,8
192,ASV,P004194,P011225,8.582,-10,11,21
192,ASV,P004194,P011386,9.617,-1,11,12
192,ASV,P004194,P012080,8.499,-11,9,20
192,ASV,P004194,P012729,1.116,0,2,2
192,ASV,P004194,P012731,13.8,-4,18,22
192,ASV,P005094,P006568,11.884,-2,24,26
192,ASV,P005094,P011225,16.333,-12,30,42
192,ASV,P005094,P011386,8.1,0,9,9
192,ASV,P005094,P012080,16.633,-13,28,41
192,ASV,P005094,P012729,0.333,0,2,2
192,ASV,P005094,P012731,15.033,-9,20,29
192,ASV,P006568,P011225,24.767,1,46,45
192,ASV,P006568,P011386,1.517,-1,2,3
192,ASV,P006568,P012080,24.767,1,46,45
192,ASV,P006568,P012729,9.533,3,17,14
192,ASV,P006568,P012731,10.584,-7,16,23
192,ASV,P011225,P012080,29.116,-6,50,56
192,ASV,P011225,P012729,10.316,3,17,14
192,ASV,P011225,P012731,10.833,-11,18,29
192,ASV,P011386,P012080,0.8,-4,0,4
192,ASV,P011386,P012729,0.333,0,2,2
192,ASV,P011386,P012731,8.684,1,9,8
192,ASV,P012080,P012729,10.316,3,17,14
192,ASV,P012080,P012731,11.133,-12,16,28
192,VIR,P001844,P002084,12.05,16,31,15
192,VIR,P001844,P003048,14.5,-2,21,23
192,VIR,P001844,P003527,0.65,-1,1,2
192,VIR,P001844,P004554,11.75,12,28,16
192,VIR,P001844,P006739,7.266,17,23,6
192,VIR,P001844,P008847,17.016,-7,19,26
192,VIR,P001844,P009549,16.25,-8,22,30
192,VIR,P001844,P010781,10.35,13,20,7
192,VIR,P001844,PBCN,22.1,-4,35,39
192,VIR,P002084,P003048,3.5,-1,9,10
192,VIR,P002084,P003527,3.717,-2,5,7
192,VIR,P002084,P004554,14.6,15,36,21
192,VIR,P002084,P006739,17.499,15,39,24
192,VIR,P002084,P008847,4.516,0,4,4
192,VIR,P002084,P009549,7.733,-1,15,16
192,VIR,P002084,P010781,14.783,11,28,17
192,VIR,P002084,PBCN,12.066,3,29,26
192,VIR,P003048,P003527,0.6,2,2,0
192,VIR,P003048,P006739,3.683,3,11,8
192,VIR,P003048,P008847,14.683,2,23,21
192,VIR,P003048,P009549,18.183,1,32,31
192,VIR,P003048,PBCN,17.583,-1,30,31
192,VIR,P003527,P004554,3.117,-4,3,7
192,VIR,P003527,P006739,3.384,-2,3,5
192,VIR,P003527,P008847,0.65,-1,1,2
192,VIR,P003527,P009549,1.667,1,5,4
192,VIR,P003527,P010781,3.033,-4,3,7
192,VIR,P003527,PBCN,0.65,-1,1,2
192,VIR,P004554,P006739,10.75,15,29,14
192,VIR,P004554,P008847,2.05,-5,0,5
192,VIR,P004554,P009549,2.283,-5,2,7
192,VIR,P004554,P010781,13.317,11,28,17
192,VIR,P004554,PBCN,8.733,1,18,17
192,VIR,P006739,P008847,5.966,3,9,6
192,VIR,P006739,P009549,7.583,3,15,12
192,VIR,P006739,P010781,10.933,11,21,10
192,VIR,P006739,PBCN,8.732,7,26,19
192,VIR,P008847,P009549,19.866,-4,28,32
192,VIR,P008847,P010781,2.983,0,0,0
192,VIR,P008847,PBCN,19.866,-4,28,32
192,VIR,P009549,P010781,1.283,0,2,2
192,VIR,P009549,PBCN,21.816,-7,35,42
192,VIR,P010781,PBCN,6.25,2,10,8
193,BAR,P000925,P002939,15.333,-11,28,39
193,BAR,P000925,P004866,17.533,-3,37,40
193,BAR,P000925,P007464,2.5,-1,6,7
193,BAR,P000925,P007519,5.666,-8,9,17
193,BAR,P000925,P009992,16.766,-10,31,41
193,BAR,P000925,P011244,2.383,1,7,6
193,BAR,P000925,P012745,16.883,-12,30,42
193,BAR,P002939,P003196,13.799,-5,30,35
193,BAR,P002939,P004866,20.116,-16,38,54
193,BAR,P002939,P007464,8.933,5,24,19
193,BAR,P002939,P007519,13.732,-11,27,38
193,BAR,P002939,P009992,15.983,-10,27,37
193,BAR,P002939,P011244,10.266,-7,20,27
193,BAR,P002939,P012745,19.366,-9,38,47
193,BAR,P003196,P004866,10.766,-20,14,34
193,BAR,P003196,P007464,8.366,5,21,16
193,BAR,P003196,P007519,18.682,-11,34,45
193,BAR,P003196,P009992,9.833,-8,12,20
193,BAR,P003196,P011244,10.483,-10,22,32
193,BAR,P003196,P012745,9.999,-3,15,18
193,BAR,P004866,P007464,2.75,-1,6,7
193,BAR,P004866,P007519,12.899,-18,20,38
193,BAR,P004866,P009992,21.333,-11,38,49
193,BAR,P004866,P011244,6.933,-15,11,26
193,BAR,P004866,P012745,21.866,-8,40,48
193,BAR,P007464,P007519,8.366,5,21,16
193,BAR,P007464,P009992,2.183,-1,3,4
193,BAR,P007464,P011244,7.033,6,18,12
193,BAR,P007464,P012745,4.333,-2,9,11
193,BAR,P007519,P009992,13.699,-14,18,32
193,BAR,P007519,P011244,12.266,-9,29,38
193,BAR,P007519,P012745,12.082,-10,14,24
193,BAR,P009992,P011244,2.85,-2,9,11
193,BAR,P009992,P012745,23.749,-16,34,50
193,BAR,P011244,P012745,0.25,0,0,0
193,IST,P004888,P006590,4.867,0,12,12
193,IST,P004888,P007200,7.983,10,26,16
193,IST,P004888,P009664,3.95,6,9,3
193,IST,P004888,P009846,2.967,4,5,1
193,IST,P004888,P011078,4.35,5,9,4
193,IST,P004888,P011981,1.517,3,5,2
193,IST,P004888,P012786,4.567,1,12,11
193,IST,P004888,P012788,8.417,11,26,15
193,IST,P004888,PLHK,1.25,0,0,0
193,IST,P006590,P007200,13.033,13,39,26
193,IST,P006590,P009664,9.466,14,28,14
193,IST,P006590,P009846,12.15,13,35,22
193,IST,P006590,P010400,0.567,0,0,0
193,IST,P006590,P011078,4.8,-1,10,11
193,IST,P006590,P011981,0.05,-1,0,1
193,IST,P006590,P012786,8.084,2,18,16
193,IST,P006590,P012788,15.333,9,43,34
193,IST,P006590,PLHK,4.05,3,11,8
193,IST,P007200,P009664,20.983,21,54,33
193,IST,P007200,P009846,26.784,18,67,49
193,IST,P007200,P011078,19.484,6,44,38
193,IST,P007200,P011981,4.784,3,13,10
193,IST,P007200,P012786,5.767,2,16,14
193,IST,P007200,P012788,17.483,23,57,34
193,IST,P007200,PLHK,17.167,0,36,36
193,IST,P009664,P009846,22.917,15,53,38
193,IST,P009664,P011078,20.933,7,46,39
193,IST,P009664,P011981,0.317,0,0,0
193,IST,P009664,P012786,1.333,0,2,2
193,IST,P009664,P012788,11.666,18,35,17
193,IST,P009664,PLHK,14.967,3,29,26
193,IST,P009846,P010400,0.567,0,0,0
193,IST,P009846,P011078,21.051,1,43,42
193,IST,P009846,P011981,5.051,4,13,9
193,IST,P009846,P012786,2.184,1,4,3
193,IST,P009846,P012788,13.517,14,42,28
193,IST,P009846,PLHK,19.484,2,38,36
193,IST,P010400,P012786,0.567,0,0,0
193,IST,P010400,PLHK,0.567,0,0,0
193,IST,P011078,P011981,3.634,-1,8,9
193,IST,P011078,P012786,1.75,0,2,2
193,IST,P011078,P012788,9.0,6,25,19
193,IST,P011078,PLHK,15.934,1,29,28
193,IST,P011981,P012788,4.084,6,13,7
193,IST,P011981,PLHK,0.967,-2,0,2
193,IST,P012786,P012788,6.117,-1,14,15
193,IST,P012786,PLHK,1.967,3,4,1
193,IST,P012788,PLHK,1.583,-2,5,7
194,OLY,P001255,P003941,22.35,15,56,41
194,OLY,P001255,P007853,2.35,1,3,2
194,OLY,P001255,P007982,6.05,-9,9,18
194,OLY,P001255,P008829,16.733,22,45,23
194,OLY,P001255,P008855,20.1,18,50,32
194,OLY,P001255,P010392,5.35,-3,6,9
194,OLY,P001255,P010612,22.2,12,56,44
194,OLY,P001255,P011194,6.267,-12,11,23
194,OLY,P003941,P007853,5.817,3,11,8
194,OLY,P003941,P007982,12.217,8,31,23
194,OLY,P003941,P008829,18.616,26,51,25
194,OLY,P003941,P008855,23.033,22,58,36
194,OLY,P003941,P010392,11.517,14,28,14
194,OLY,P003941,P010612,21.967,23,62,39
194,OLY,P003941,P011194,10.551,1,27,26
194,OLY,P006589,P007982,4.183,-5,5,10
194,OLY,P006589,P010392,4.183,-5,5,10
194,OLY,P006589,P011194,4.183,-5,5,10
194,OLY,P006589,P011965,4.183,-5,5,10
194,OLY,P007853,P007982,3.467,2,8,6
194,OLY,P007853,P008855,2.35,1,3,2
194,OLY,P007853,P010392,5.817,3,11,8
194,OLY,P007853,P011194,3.467,2,8,6
194,OLY,P007982,P008829,3.583,2,6,4
194,OLY,P007982,P008855,4.533,0,8,8
194,OLY,P007982,P010392,17.65,2,33,31
194,OLY,P007982,P010612,8.517,0,18,18
194,OLY,P007982,P011194,18.417,-7,33,40
194,OLY,P007982,P011965,4.183,-5,5,10
194,OLY,P008829,P008855,18.216,26,51,25
194,OLY,P008829,P010392,3.183,2,6,4
194,OLY,P008829,P010612,18.033,20,45,25
194,OLY,P008829,P011194,1.3,-2,0,2
194,OLY,P008855,P010392,6.883,1,11,10
194,OLY,P008855,P010612,16.95,19,47,28
194,OLY,P008855,P011194,3.267,-7,4,11
194,OLY,P010392,P010612,5.467,5,12,7
194,OLY,P010392,P011194,15.767,-2,27,29
194,OLY,P010392,P011965,4.183,-5,5,10
194,OLY,P010612,P011194,8.734,-3,20,23
194,OLY,P011194,P011965,4.183,-5,5,10
194,TEL,P004233,P007990,12.033,11,28,17
194,TEL,P004233,P009783,1.784,0,2,2
194,TEL,P004233,P009863,7.733,3,17,14
194,TEL,P004233,P011193,5.567,6,13,7
194,TEL,P004233,P011199,6.0,5,13,8
194,TEL,P004233,P011214,5.35,6,13,7
194,TEL,P004233,P011219,3.75,0,9,9
194,TEL,P004233,P011433,0.2,0,0,0
194,TEL,P004233,P011971,10.116,7,23,16
194,TEL,P004233,P012744,1.467,-2,2,4
194,TEL,P007990,P009783,14.151,-7,23,30
194,TEL,P007990,P009863,15.349,-1,28,29
194,TEL,P007990,P011193,12.884,3,28,25
194,TEL,P007990,P011199,12.767,-1,19,20
194,TEL,P007990,P011214,11.0,1,26,25
194,TEL,P007990,P011219,13.033,-7,22,29
194,TEL,P007990,P011971,13.499,9,34,25
194,TEL,P007990,P012744,5.816,0,16,16
194,TEL,P009783,P009863,19.183,-23,27,50
194,TEL,P009783,P011193,16.768,-18,24,42
194,TEL,P009783,P011199,16.234,-17,20,37
194,TEL,P009783,P011214,5.634,-9,8,17
194,TEL,P009783,P011219,20.5,-23,29,52
194,TEL,P009783,P011971,2.767,-1,6,7
194,TEL,P009783,P012744,3.183,2,9,7
194,TEL,P009863,P011193,11.5,-17,14,31
194,TEL,P009863,P011199,21.333,-14,31,45
194,TEL,P009863,P011214,1.05,-6,0,6
194,TEL,P009863,P011219,22.783,-20,36,56
194,TEL,P009863,P011971,6.683,-2,12,14
194,TEL,P009863,P012744,4.45,0,11,11
194,TEL,P011193,P011199,11.734,-9,16,25
194,TEL,P011193,P011214,12.05,-5,26,31
194,TEL,P011193,P011219,12.817,-17,16,33
194,TEL,P011193,P011971,9.183,3,24,21
194,TEL,P011193,P012744,2.633,-2,7,9
194,TEL,P011199,P011219,18.217,-15,25,40
194,TEL,P011199,P011971,4.183,3,8,5
194,TEL,P011214,P011219,1.3,-8,0,8
194,TEL,P011214,P011971,9.183,3,24,21
194,TEL,P011214,P012744,2.633,-2,7,9
194,TEL,P011219,P011433,0.2,0,0,0
194,TEL,P011219,P011971,2.15,-2,4,6
194,TEL,P011219,P012744,4.65,0,11,11
194,TEL,P011433,P011971,0.2,0,0,0
194,TEL,P011433,P012744,0.2,0,0,0
194,TEL,P011971,P012744,4.1,-4,9,13
195,MAD,P001392,P003108,8.183,-11,16,27
195,MAD,P001392,P003733,0.033,-2,0,2
195,MAD,P001392,P004887,12.466,-8,28,36
195,MAD,P001392,P005928,12.233,-15,22,37
195,MAD,P001392,P006540,8.183,-11,16,27
195,MAD,P001392,P009005,1.583,-2,4,6
195,MAD,P001392,P009213,3.15,-1,6,7
195,MAD,P001392,P010357,7.466,0,18,18
195,MAD,P001392,P010623,1.833,6,8,2
195,MAD,P001392,PBMT,5.883,2,14,12
195,MAD,P001392,PCVM,1.583,-2,4,6
195,MAD,P003108,P003733,3.383,-7,5,12
195,MAD,P003108,P004887,16.966,-19,26,45
195,MAD,P003108,P005928,12.549,-12,24,36
195,MAD,P003108,P006540,14.883,-14,24,38
195,MAD,P003108,P009005,4.417,-7,2,9
195,MAD,P003108,P010357,1.3,-2,3,5
195,MAD,P003108,PBMT,5.666,-3,11,14
195,MAD,P003108,PCVM,5.717,-9,5,14
195,MAD,P003733,P004887,3.416,-8,4,12
195,MAD,P003733,P005928,2.083,-5,2,7
195,MAD,P003733,P009005,7.533,-3,12,15
195,MAD,P003733,P009213,5.933,2,10,8
195,MAD,P003733,P010357,13.016,-5,24,29
195,MAD,P003733,P010623,7.266,-1,12,13
195,MAD,P003733,PBMT,11.983,-7,23,30
195,MAD,P003733,PCVM,5.75,-4,12,16
195,MAD,P004887,P005928,14.249,-12,28,40
195,MAD,P004887,P006540,16.066,-13,28,41
195,MAD,P004887,P009005,7.15,-6,10,16
195,MAD,P004887,P010357,6.799,1,18,17
195,MAD,P004887,P010623,3.166,3,10,7
195,MAD,P004887,PBMT,8.432,-1,18,19
195,MAD,P004887,PCVM,6.35,-9,6,15
195,MAD,P005928,P006540,12.666,-7,28,35
195,MAD,P005928,P009005,2.2,0,6,6
195,MAD,P005928,P009213,4.55,-4,8,12
195,MAD,P005928,P010357,6.25,-4,12,16
195,MAD,P005928,PBMT,8.416,-5,14,19
195,MAD,P006540,P009005,7.0,-9,8,17
195,MAD,P006540,P009213,1.4,-3,2,5
195,MAD,P006540,P010357,2.583,-2,6,8
195,MAD,P006540,PBMT,2.283,4,6,2
195,MAD,P006540,PCVM,4.8,-9,2,11
195,MAD,P009005,P009213,4.483,-4,5,9
195,MAD,P009005,P010357,11.666,-5,22,27
195,MAD,P009005,P010623,3.083,-1,3,4
195,MAD,P009005,PBMT,4.417,0,9,9
195,MAD,P009005,PCVM,10.8,-11,15,26
195,MAD,P009213,P010357,10.483,-2,18,20
195,MAD,P009213,P010623,5.933,2,10,8
195,MAD,P009213,PBMT,6.0,2,13,11
195,MAD,P010357,P010623,9.099,5,20,15
195,MAD,P010357,PBMT,15.783,0,35,35
195,MAD,P010357,PCVM,7.683,-6,16,22
195,MAD,P010623,PBMT,6.016,6,17,11
195,MAD,PBMT,PCVM,5.717,-2,12,14
195,MCO,P002581,P004197,9.333,12,24,12
195,MCO,P002581,P005985,9.333,12,24,12
195,MCO,P002581,P011226,9.333,12,24,12
195,MCO,P002581,P011231,9.333,12,24,12
195,MCO,P004197,P004790,5.383,-2,12,14
195,MCO,P004197,P005985,17.799,11,40,29
195,MCO,P004197,P009754,0.683,2,2,0
195,MCO,P004197,P011196,6.499,0,11,11
195,MCO,P004197,P011212,9.149,1,18,17
195,MCO,P004197,P011226,9.333,12,24,12
195,MCO,P004197,P011231,13.099,15,30,15
195,MCO,P004197,PLCZ,2.65,1,7,6
195,MCO,P004790,P005985,13.116,17,41,24
195,MCO,P004790,P009754,12.233,17,37,20
195,MCO,P004790,P011196,7.166,6,20,14
195,MCO,P004790,P011212,15.016,9,39,30
195,MCO,P004790,P011226,9.299,10,24,14
195,MCO,P004790,PLCZ,11.183,11,31,20
195,MCO,P005985,P009754,11.117,11,35,24
195,MCO,P005985,P011196,12.583,5,28,23
195,MCO,P005985,P011212,17.166,13,42,29
195,MCO,P005985,P011226,19.15,19,51,32
195,MCO,P005985,P011231,19.5,10,43,33
195,MCO,P005985,PLCZ,10.7,10,32,22
195,MCO,P009754,P011196,7.983,4,21,17
195,MCO,P009754,P011212,12.383,6,31,25
195,MCO,P009754,P011226,12.817,-3,30,33
195,MCO,P009754,P011231,6.267,-9,12,21
195,MCO,P009754,PLCZ,10.517,4,28,24
195,MCO,P011196,P011212,14.299,1,27,26
195,MCO,P011196,P011226,8.934,5,24,19
195,MCO,P011196,P011231,9.6,-1,17,18
195,MCO,P011212,P011226,10.4,0,21,21
195,MCO,P011212,P011231,9.533,1,17,16
195,MCO,P011212,PLCZ,10.25,9,29,20
195,MCO,P011226,P011231,16.551,4,39,35
195,MCO,P011226,PLCZ,7.583,-3,15,18
195,MCO,P011231,PLCZ,2.717,-4,6,10
196,PAN,P001926,P002328,11.85,5,27,22
196,PAN,P001926,P003842,17.684,16,45,29
196,PAN,P001926,P007866,20.601,12,48,36
196,PAN,P001926,P011204,22.402,16,53,37
196,PAN,P001926,P011221,7.384,-1,15,16
196,PAN,P001926,P012712,7.867,3,16,13
196,PAN,P001926,P012774,19.284,9,44,35
196,PAN,P002328,P003842,22.283,5,47,42
196,PAN,P002328,P007866,23.05,3,46,43
196,PAN,P002328,P011204,20.717,4,40,36
196,PAN,P002328,P011209,0.833,2,2,0
196,PAN,P002328,P011221,1.1,-2,0,2
196,PAN,P002328,P012712,3.733,0,5,5
196,PAN,P002328,P012774,16.766,-5,29,34
196,PAN,P003842,P007866,28.717,9,61,52
196,PAN,P003842,P011204,27.534,15,60,45
196,PAN,P003842,P011209,0.833,2,2,0
196,PAN,P003842,P012712,2.2,5,6,1
196,PAN,P003842,P012774,24.417,4,47,43
196,PAN,P007866,P011204,30.401,13,64,51
196,PAN,P007866,P011209,0.833,2,2,0
196,PAN,P007866,P011221,3.417,1,7,6
196,PAN,P007866,P012712,1.7,0,2,2
196,PAN,P007866,P012774,26.617,0,50,50
196,PAN,P011204,P011209,0.833,2,2,0
196,PAN,P011204,P011221,7.384,-1,15,16
196,PAN,P011204,P012712,5.951,1,11,10
196,PAN,P011204,P012774,27.318,6,55,49
196,PAN,P011221,P012712,3.967,-2,8,10
196,PAN,P011221,P012774,6.284,1,15,14
196,PAN,P012712,P012774,6.05,5,16,11
196,PAR,P000956,P004058,2.45,-2,5,7
196,PAR,P000956,P004172,3.883,3,7,4
196,PAR,P000956,P007400,8.516,-6,15,21
196,PAR,P000956,P008987,7.349,0,13,13
196,PAR,P000956,P011050,3.1,-2,5,7
196,PAR,P000956,P011051,9.983,-2,18,20
196,PAR,P000956,P011192,2.083,1,2,1
196,PAR,P000956,P012096,3.066,2,6,4
196,PAR,P000956,P012742,7.866,-2,15,17
196,PAR,P000956,P012743,1.3,-4,2,6
196,PAR,P004058,P007400,2.45,-2,5,7
196,PAR,P004058,P007673,6.9,1,12,11
196,PAR,P004058,P008987,6.9,1,12,11
196,PAR,P004058,P011050,2.45,-2,5,7
196,PAR,P004058,P011051,2.45,-2,5,7
196,PAR,P004058,P012096,6.9,1,12,11
196,PAR,P004058,P012742,6.9,1,12,11
196,PAR,P004172,P007400,0.767,0,0,0
196,PAR,P004172,P007673,5.001,-8,6,14
196,PAR,P004172,P008987,8.884,-5,13,18
196,PAR,P004172,P011050,3.951,-2,6,8
196,PAR,P004172,P011051,3.267,-2,5,7
196,PAR,P004172,P011192,2.65,-3,4,7
196,PAR,P004172,P012096,1.666,-1,2,3
196,PAR,P004172,P012742,5.467,-2,9,11
196,PAR,P007400,P007673,10.5,0,19,19
196,PAR,P007400,P008987,9.599,1,20,19
196,PAR,P007400,P011050,10.617,-2,18,20
196,PAR,P007400,P011051,18.467,-8,35,43
196,PAR,P007400,P011192,8.384,-7,15,22
196,PAR,P007400,P012096,7.367,-1,14,15
196,PAR,P007400,P012742,20.833,-7,41,48
196,PAR,P007400,P012743,1.3,-4,2,6
196,PAR,P007673,P008987,16.7,-1,30,31
196,PAR,P007673,P011050,6.784,1,11,10
196,PAR,P007673,P011051,6.917,-7,12,19
196,PAR,P007673,P011192,3.55,-8,5,13
196,PAR,P007673,P012096,11.383,-3,18,21
196,PAR,P007673,P012742,19.933,-3,35,38
196,PAR,P008987,P011050,6.784,1,11,10
196,PAR,P008987,P011051,7.433,0,16,16
196,PAR,P008987,P011192,3.783,-5,6,11
196,PAR,P008987,P012096,9.699,-2,16,18
196,PAR,P008987,P012742,21.482,0,41,41
196,PAR,P008987,P012743,0.983,-2,2,4
196,PAR,P011050,P011051,7.017,-5,13,18
196,PAR,P011050,P011192,5.184,-3,10,13
196,PAR,P011050,P012742,9.317,-2,17,19
196,PAR,P011051,P011192,7.101,-7,11,18
196,PAR,P011051,P012096,5.717,1,10,9
196,PAR,P011051,P012742,18.267,-6,35,41
196,PAR,P011051,P012743,0.317,-2,0,2
196,PAR,P011192,P012096,4.516,-1,8,9
196,PAR,P011192,P012742,8.017,-7,15,22
196,PAR,P012096,P012742,14.55,0,26,26
196,PAR,P012742,P012743,1.3,-4,2,6
197,MIL,P001518,P002849,1.9,2,4,2
197,MIL,P001518,P011205,1.9,2,4,2
197,MIL,P001518,P011224,1.9,2,4,2
197,MIL,P001518,P012800,1.9,2,4,2
197,MIL,P002812,P002849,15.033,-1,25,26
197,MIL,P002812,P005670,0.75,3,3,0
197,MIL,P002812,P006509,1.866,3,5,2
197,MIL,P002812,P007201,1.849,-2,2,4
197,MIL,P002812,P007831,2.249,-8,0,8
197,MIL,P002812,P011205,16.149,-1,27,28
197,MIL,P002812,P011224,15.099,-4,24,28
197,MIL,P002812,P012800,14.533,-2,22,24
197,MIL,P002849,P005670,1.45,6,6,0
197,MIL,P002849,P006509,8.284,-1,14,15
197,MIL,P002849,P007201,9.05,-1,16,17
197,MIL,P002849,P007831,3.933,2,11,9
197,MIL,P002849,P009960,1.467,3,6,3
197,MIL,P002849,P011205,27.45,3,51,48
197,MIL,P002849,P011224,24.933,-3,42,45
197,MIL,P002849,P012800,16.3,2,29,27
197,MIL,P005670,P006509,6.533,4,19,15
197,MIL,P005670,P007201,7.233,-9,16,25
197,MIL,P005670,P007831,6.933,-7,16,23
197,MIL,P005670,P009960,7.933,-6,19,25
197,MIL,P005670,P011205,3.9,-3,9,12
197,MIL,P006509,P007201,15.533,-2,32,34
197,MIL,P006509,P007831,6.95,-1,16,17
197,MIL,P006509,P009960,7.217,2,19,17
197,MIL,P006509,P011205,9.667,2,19,17
197,MIL,P006509,P011224,9.75,-3,16,19
197,MIL,P007201,P007831,11.149,-13,21,34
197,MIL,P007201,P009960,10.7,-13,19,32
197,MIL,P007201,P011205,14.816,-15,21,36
197,MIL,P007201,P011224,13.633,-5,21,26
197,MIL,P007201,P012800,2.433,-4,0,4
197,MIL,P007831,P009960,9.467,-9,22,31
197,MIL,P007831,P011205,6.616,-13,11,24
197,MIL,P007831,P011224,4.666,-5,8,13
197,MIL,P007831,P012800,1.633,-2,3,5
197,MIL,P009960,P011205,6.117,-11,9,20
197,MIL,P009960,P011224,3.467,-4,3,7
197,MIL,P009960,P012800,2.3,-2,3,5
197,MIL,P011205,P011224,27.516,-6,44,50
197,MIL,P011205,P012800,18.733,-2,29,31
197,MIL,P011224,P012800,17.1,0,26,26
197,PAM,P003960,P005356,0.55,-1,2,3
197,PAM,P003960,P007870,13.233,-1,25,26
197,PAM,P003960,P010393,0.55,-1,2,3
197,PAM,P003960,P010568,14.683,0,29,29
197,PAM,P003960,P011970,0.9,2,2,0
197,PAM,P003960,P011982,14.416,1,27,26
197,PAM,P003960,P012739,0.9,2,2,0
197,PAM,P003960,P012740,13.233,-1,25,26
197,PAM,P003960,P012795,0.267,-1,2,3
197,PAM,P005356,P006433,3.834,-2,6,8
197,PAM,P005356,P007870,6.584,-7,7,14
197,PAM,P005356,P010393,7.867,-9,10,19
197,PAM,P005356,P010568,7.134,-8,9,17
197,PAM,P005356,P011970,3.834,-2,6,8
197,PAM,P005356,P011982,4.45,-4,4,8
197,PAM,P005356,P012738,5.801,-3,9,12
197,PAM,P005356,P012740,3.084,-1,5,6
197,PAM,P005356,P012795,0.734,-3,2,5
197,PAM,P006433,P010393,5.467,1,9,8
197,PAM,P006433,P011970,11.201,-2,19,21
197,PAM,P006433,P011982,0.517,3,3,0
197,PAM,P006433,P012738,11.201,-2,19,21
197,PAM,P006433,P012739,5.717,-3,10,13
197,PAM,P006433,P012795,6.867,-3,10,13
197,PAM,P007870,P010393,7.167,1,13,12
197,PAM,P007870,P010568,24.517,2,46,44
197,PAM,P007870,P011970,1.033,3,3,0
197,PAM,P007870,P011982,22.083,5,43,38
197,PAM,P007870,P012738,1.967,-1,3,4
197,PAM,P007870,P012740,21.017,8,44,36
197,PAM,P007870,P012795,0.467,-2,0,2
197,PAM,P010393,P010568,9.684,9,25,16
197,PAM,P010393,P011970,6.917,11,19,8
197,PAM,P010393,P011982,9.45,15,26,11
197,PAM,P010393,P012738,7.434,10,19,9
197,PAM,P010393,P012740,4.184,6,11,5
197,PAM,P010393,P012795,1.884,-3,2,5
197,PAM,P010568,P011970,4.25,17,20,3
197,PAM,P010568,P011982,26.1,18,60,42
197,PAM,P010568,P012738,4.801,10,18,8
197,PAM,P010568,P012739,1.767,4,7,3
197,PAM,P010568,P012740,21.534,7,44,37
197,PAM,P010568,P012795,0.734,-3,2,5
197,PAM,P011970,P011982,4.767,20,23,3
197,PAM,P011970,P012738,13.518,10,34,24
197,PAM,P011970,P012739,7.484,1,17,16
197,PAM,P011970,P012740,1.033,3,3,0
197,PAM,P011970,P012795,6.867,-3,10,13
197,PAM,P011982,P012738,3.351,14,18,4
197,PAM,P011982,P012739,1.767,4,7,3
197,PAM,P011982,P012740,19.567,8,41,33
197,PAM,P012738,P012739,6.584,-1,15,16
197,PAM,P012738,P012740,2.484,-2,3,5
197,PAM,P012738,P012795,6.867,-3,10,13
197,PAM,P012739,P012795,5.717,-3,10,13
198,ULK,P001932,P002968,13.05,-5,21,26
198,ULK,P001932,P002969,2.133,0,4,4
198,ULK,P001932,P004004,9.016,7,22,15
198,ULK,P001932,P005844,14.067,-7,22,29
198,ULK,P001932,P006661,16.216,-7,26,33
198,ULK,P001932,P009849,6.883,2,15,13
198,ULK,P001932,P010560,15.2,-14,19,33
198,ULK,P001932,P011052,0.117,0,0,0
198,ULK,P001932,P011157,2.45,4,7,3
198,ULK,P002968,P002969,1.6,-6,0,6
198,ULK,P002968,P004004,6.316,7,16,9
198,ULK,P002968,P005844,12.75,-4,19,23
198,ULK,P002968,P006661,15.4,-14,21,35
198,ULK,P002968,P009849,10.016,2,18,16
198,ULK,P002968,P010560,15.95,-15,19,34
198,ULK,P002968,P011052,7.933,-7,11,18
198,ULK,P002968,P011157,2.917,-6,3,9
198,ULK,P002968,P011201,1.6,-6,0,6
198,ULK,P002968,P012724,1.6,-6,0,6
198,ULK,P002969,P004004,6.166,-3,17,20
198,ULK,P002969,P005844,2.133,0,4,4
198,ULK,P002969,P006661,4.033,-3,13,16
198,ULK,P002969,P009849,6.983,-3,20,23
198,ULK,P002969,P011052,1.6,-6,0,6
198,ULK,P002969,P011157,4.85,-3,16,19
198,ULK,P002969,P011201,2.417,-6,3,9
198,ULK,P002969,P012724,2.417,-6,3,9
198,ULK,P004004,P005844,12.383,-3,24,27
198,ULK,P004004,P006661,13.916,2,38,36
198,ULK,P004004,P009849,17.649,-6,42,48
198,ULK,P004004,P010560,10.149,-9,17,26
198,ULK,P004004,P011052,7.849,-2,17,19
198,ULK,P004004,P011157,9.416,3,31,28
198,ULK,P005844,P006661,12.0,-10,16,26
198,ULK,P005844,P009849,9.7,-6,14,20
198,ULK,P005844,P010560,13.367,-21,11,32
198,ULK,P005844,P011052,5.033,-3,8,11
198,ULK,P005844,P011157,0.167,2,2,0
198,ULK,P006661,P009849,11.783,-3,31,34
198,ULK,P006661,P010560,17.083,-20,21,41
198,ULK,P006661,P011052,3.65,-3,7,10
198,ULK,P006661,P011157,10.783,-6,27,33
198,ULK,P009849,P010560,11.649,-5,23,28
198,ULK,P009849,P011052,9.799,0,21,21
198,ULK,P009849,P011157,9.3,3,34,31
198,ULK,P009849,P011201,0.817,0,3,3
198,ULK,P009849,P012724,0.817,0,3,3
198,ULK,P010560,P011052,8.533,-11,10,21
198,ULK,P010560,P011157,6.133,-5,12,17
198,ULK,P011052,P011157,4.95,-4,10,14
198,ULK,P011052,P011201,1.6,-6,0,6
198,ULK,P011052,P012724,1.6,-6,0,6
198,ULK,P011157,P011201,0.817,0,3,3
198,ULK,P011157,P012724,0.817,0,3,3
198,ULK,P011201,P012724,2.417,-6,3,9
198,ZAL,P002329,P002676,5.383,-1,16,17
198,ZAL,P002329,P003210,6.566,-3,16,19
198,ZAL,P002329,P003211,5.733,6,15,9
198,ZAL,P002329,P005504,13.85,24,36,12
198,ZAL,P002329,P007109,9.533,-7,23,30
198,ZAL,P002329,P010390,4.466,-7,12,19
198,ZAL,P002329,P011218,16.367,20,43,23
198,ZAL,P002329,P012715,18.1,22,47,25
198,ZAL,P002329,P012787,11.734,14,28,14
198,ZAL,P002676,P003210,6.984,3,19,16
198,ZAL,P002676,P003211,7.284,7,21,14
198,ZAL,P002676,P005504,2.867,4,9,5
198,ZAL,P002676,P006860,1.6,6,6,0
198,ZAL,P002676,P007109,7.083,-4,19,23
198,ZAL,P002676,P010390,8.534,-6,19,25
198,ZAL,P002676,P011218,9.451,-3,22,25
198,ZAL,P002676,P012715,9.018,6,25,19
198,ZAL,P003210,P003211,7.401,9,17,8
198,ZAL,P003210,P005504,4.067,8,10,2
198,ZAL,P003210,P006860,1.6,6,6,0
198,ZAL,P003210,P007109,7.483,-9,14,23
198,ZAL,P003210,P007513,0.733,0,2,2
198,ZAL,P003210,P010390,9.05,-7,19,26
198,ZAL,P003210,P011218,1.884,-3,2,5
198,ZAL,P003210,P012715,6.451,0,11,11
198,ZAL,P003210,P012787,0.717,0,0,0
198,ZAL,P003211,P005504,6.217,14,20,6
198,ZAL,P003211,P006860,1.6,6,6,0
198,ZAL,P003211,P007109,4.884,-7,7,14
198,ZAL,P003211,P010390,7.267,-6,13,19
198,ZAL,P003211,P011218,6.5,2,19,17
198,ZAL,P003211,P012715,8.601,13,26,13
198,ZAL,P003211,P012787,0.117,0,0,0
198,ZAL,P005504,P006860,1.6,6,6,0
198,ZAL,P005504,P007109,5.817,7,14,7
198,ZAL,P005504,P011218,18.301,25,49,24
198,ZAL,P005504,P012715,19.951,29,53,24
198,ZAL,P005504,P012787,15.334,23,39,16
198,ZAL,P007109,P007513,1.05,-3,2,5
198,ZAL,P007109,P010390,8.283,-18,14,32
198,ZAL,P007109,P011218,11.334,4,28,24
198,ZAL,P007109,P012715,12.901,3,30,27
198,ZAL,P007109,P012787,8.168,2,17,15
198,ZAL,P007513,P010390,1.05,-3,2,5
198,ZAL,P007513,P012715,1.05,-3,2,5
198,ZAL,P007513,P012787,0.317,-3,0,3
198,ZAL,P010390,P011218,5.117,-6,8,14
198,ZAL,P010390,P012715,7.184,-4,13,17
198,ZAL,P010390,P012787,0.917,-3,0,3
198,ZAL,P011218,P012715,27.285,28,71,43
198,ZAL,P011218,P012787,17.101,21,42,21
198,ZAL,P012715,P012787,18.135,18,42,24
199,BER,P003958,P008173,0.533,3,3,0
199,BER,P003958,P008384,2.517,5,11,6
199,BER,P003958,P008780,15.501,8,38,30
199,BER,P003958,P008967,16.034,11,41,30
199,BER,P003958,P010791,7.75,6,18,12
199,BER,P003958,P011934,8.284,5,23,18
199,BER,P003958,P012720,13.517,6,30,24
199,BER,P006251,P008173,3.017,-3,4,7
199,BER,P006251,P008211,3.984,-5,6,11
199,BER,P006251,P008384,3.517,-5,6,11
199,BER,P006251,P008780,2.45,-1,3,4
199,BER,P006251,P008967,1.983,-1,3,4
199,BER,P006251,P010791,2.45,-4,2,6
199,BER,P006251,P011934,3.517,-2,7,9
199,BER,P006251,P012720,2.95,-3,5,8
199,BER,P008173,P008211,12.7,0,27,27
199,BER,P008173,P008384,12.133,0,25,25
199,BER,P008173,P008967,1.1,3,5,2
199,BER,P008173,P010791,5.516,-2,10,12
199,BER,P008173,P011934,7.717,5,20,15
199,BER,P008173,P012720,0.533,3,3,0
199,BER,P008173,P012721,9.683,3,23,20
199,BER,P008211,P008384,12.633,-2,27,29
199,BER,P008211,P008780,0.467,0,0,0
199,BER,P008211,P008967,0.567,0,2,2
199,BER,P008211,P010791,4.983,-5,7,12
199,BER,P008211,P011934,8.684,3,22,19
199,BER,P008211,P012720,0.967,-2,2,4
199,BER,P008211,P012721,9.683,3,23,20
199,BER,P008384,P008780,4.35,5,15,10
199,BER,P008384,P008967,4.35,5,15,10
199,BER,P008384,P010791,6.816,-5,11,16
199,BER,P008384,P011934,10.167,8,31,23
199,BER,P008384,P012720,0.5,-2,2,4
199,BER,P008384,P012721,10.949,3,25,22
199,BER,P008780,P008967,25.8,8,57,49
199,BER,P008780,P010791,9.05,3,19,16
199,BER,P008780,P011934,17.217,5,38,33
199,BER,P008780,P012720,21.917,3,42,39
199,BER,P008780,P012721,8.316,1,16,15
199,BER,P008967,P010791,9.583,6,22,16
199,BER,P008967,P011934,17.317,5,40,35
199,BER,P008967,P012720,21.983,6,45,39
199,BER,P008967,P012721,8.883,1,18,17
199,BER,P010791,P012720,7.75,6,18,12
199,BER,P010791,P012721,4.366,-1,9,10
199,BER,P011934,P012720,15.2,-2,29,31
199,BER,P011934,P012721,13.633,5,30,25
199,BER,P012720,P012721,6.483,1,12,11
199,RED,P000848,P002553,2.1,2,5,3
199,RED,P000848,P005099,7.633,-5,12,17
199,RED,P000848,P006436,5.633,-4,8,12
199,RED,P000848,P007960,10.683,-9,17,26
199,RED,P000848,P009035,8.566,-2,16,18
199,RED,P000848,P011941,4.217,-5,6,11
199,RED,P000848,P012044,5.15,-2,10,12
199,RED,P000848,P012801,7.15,-3,14,17
199,RED,P002553,P005099,4.916,-3,8,11
199,RED,P002553,P006436,12.332,-5,22,27
199,RED,P002553,P008966,1.6,-2,3,5
199,RED,P002553,P009035,13.382,-1,25,26
199,RED,P002553,P012044,11.449,-7,20,27
199,RED,P002553,P012801,4.316,4,8,4
199,RED,P002553,PLUO,9.833,0,21,21
199,RED,P005099,P006436,14.149,-1,30,31
199,RED,P005099,P007960,10.366,-6,18,24
199,RED,P005099,P009035,19.732,3,44,41
199,RED,P005099,P011941,3.65,-5,4,9
199,RED,P005099,P012044,7.866,-3,15,18
199,RED,P005099,P012801,20.949,7,48,41
199,RED,P005099,PLUO,4.267,5,13,8
199,RED,P006436,P007960,8.533,-9,11,20
199,RED,P006436,P008966,2.833,-3,8,11
199,RED,P006436,P009035,28.598,-6,57,63
199,RED,P006436,P012044,23.915,-10,45,55
199,RED,P006436,P012801,14.766,6,32,26
199,RED,P006436,PLUO,10.033,0,27,27
199,RED,P007960,P009035,11.466,-7,19,26
199,RED,P007960,P011941,4.217,-5,6,11
199,RED,P007960,P012044,5.317,-6,7,13
199,RED,P007960,P012801,12.15,-6,22,28
199,RED,P008966,P009035,1.233,-1,5,6
199,RED,P008966,P012044,2.833,-3,8,11
199,RED,P008966,PLUO,2.833,-3,8,11
199,RED,P009035,P012044,22.315,-8,42,50
199,RED,P009035,P012801,20.349,10,46,36
199,RED,P009035,PLUO,11.083,4,30,26
199,RED,P011941,P012044,0.567,0,2,2
199,RED,P011941,P012801,4.217,-5,6,11
199,RED,P012044,P012801,10.1,2,19,17
199,RED,P012044,PLUO,8.416,-3,20,23
199,RED,P012801,PLUO,4.267,5,13,8
200,ASV,P000229,P003526,10.984,-1,21,22
200,ASV,P000229,P004194,9.233,-10,10,20
200,ASV,P000229,P005094,9.699,-9,12,21
200,ASV,P000229,P006568,24.467,13,50,37
200,ASV,P000229,P011225,28.116,14,56,42
200,ASV,P000229,P011386,5.384,-9,4,13
200,ASV,P000229,P012729,24.034,14,50,36
200,ASV,P000229,P012731,21.1,-1,33,34
200,ASV,P000229,PKIR,1.783,1,4,3
200,ASV,P003526,P004194,1.367,0,2,2
200,ASV,P003526,P005094,1.367,0,2,2
200,ASV,P003526,P006568,11.634,1,23,22
200,ASV,P003526,P011225,12.084,3,25,22
200,ASV,P003526,P011386,0.717,0,0,0
200,ASV,P003526,P012729,11.634,1,23,22
200,ASV,P003526,P012731,2.217,0,4,4
200,ASV,P004194,P005094,12.333,-3,20,23
200,ASV,P004194,P011225,9.799,10,20,10
200,ASV,P004194,P011386,6.867,-3,12,15
200,ASV,P004194,P012729,2.383,4,6,2
200,ASV,P004194,P012731,14.65,-3,22,25
200,ASV,P004194,PKIR,2.1,1,4,3
200,ASV,P005094,P006568,2.816,3,6,3
200,ASV,P005094,P011225,10.932,13,24,11
200,ASV,P005094,P011386,6.2,-5,10,15
200,ASV,P005094,P012729,0.033,2,2,0
200,ASV,P005094,P012731,13.333,-3,20,23
200,ASV,P005094,PKIR,3.883,2,8,6
200,ASV,P006568,P011225,24.6,13,52,39
200,ASV,P006568,P011386,0.717,0,0,0
200,ASV,P006568,P012729,22.501,10,46,36
200,ASV,P006568,P012731,12.75,11,27,16
200,ASV,P006568,PKIR,1.783,1,4,3
200,ASV,P011225,P011386,2.183,6,8,2
200,ASV,P011225,P012729,23.5,12,50,38
200,ASV,P011225,P012731,22.516,19,45,26
200,ASV,P011225,PKIR,3.866,2,8,6
200,ASV,P011386,P012729,1.384,2,2,0
200,ASV,P011386,P012731,6.867,-3,12,15
200,ASV,P011386,PKIR,0.017,0,0,0
200,ASV,P012729,P012731,14.067,11,29,18
200,ASV,P012731,PKIR,2.1,1,4,3
200,MUN,P001288,P001557,0.1,-2,0,2
200,MUN,P001288,P004508,13.084,-14,14,28
200,MUN,P001288,P005460,16.568,7,31,24
200,MUN,P001288,P006760,6.617,1,12,11
200,MUN,P001288,P007056,8.834,2,17,15
200,MUN,P001288,P007639,14.15,-19,14,33
200,MUN,P001288,P007975,16.985,-5,23,28
200,MUN,P001288,P008985,11.633,-1,22,23
200,MUN,P001288,P010391,7.25,-12,2,14
200,MUN,P001288,P011987,27.651,-5,45,50
200,MUN,P001557,P004508,4.867,-4,6,10
200,MUN,P001557,P005460,2.9,0,6,6
200,MUN,P001557,P006760,7.5,-2,12,14
200,MUN,P001557,P007639,2.267,-3,3,6
200,MUN,P001557,P007975,4.383,6,12,6
200,MUN,P001557,P008985,0.5,-2,0,2
200,MUN,P001557,P010391,5.75,0,12,12
200,MUN,P001557,P011987,2.933,3,9,6
200,MUN,P004508,P005460,12.018,-9,17,26
200,MUN,P004508,P006760,8.451,-9,10,19
200,MUN,P004508,P007056,2.651,-4,4,8
200,MUN,P004508,P007639,7.517,-10,7,17
200,MUN,P004508,P007975,7.901,-11,7,18
200,MUN,P004508,P008985,6.4,-3,12,15
200,MUN,P004508,P010391,5.234,-5,5,10
200,MUN,P004508,P011987,10.017,-7,14,21
200,MUN,P005460,P006760,8.484,-1,17,18
200,MUN,P005460,P007056,3.601,1,9,8
200,MUN,P005460,P007975,16.518,2,29,27
200,MUN,P005460,P008985,3.467,4,10,6
200,MUN,P005460,P010391,3.283,-1,3,4
200,MUN,P005460,P011987,15.701,13,34,21
200,MUN,P006760,P007056,1.584,-1,4,5
200,MUN,P006760,P007639,4.584,-3,5,8
200,MUN,P006760,P007975,9.967,5,23,18
200,MUN,P006760,P008985,0.5,-2,0,2
200,MUN,P006760,P010391,7.867,-3,11,14
200,MUN,P006760,P011987,7.25,7,18,11
200,MUN,P007056,P007639,6.817,0,12,12
200,MUN,P007056,P007975,4.268,-1,9,10
200,MUN,P007056,P008985,5.733,0,10,10
200,MUN,P007056,P010391,0.417,2,2,0
200,MUN,P007056,P011987,7.767,5,17,12
200,MUN,P007639,P007975,3.384,-6,2,8
200,MUN,P007639,P008985,8.666,-7,12,19
200,MUN,P007639,P010391,7.401,-9,7,16
200,MUN,P007639,P011987,12.15,-15,14,29
200,MUN,P007975,P010391,7.983,-1,11,12
200,MUN,P007975,P011987,18.751,3,32,29
200,MUN,P008985,P011987,11.633,-1,22,23
200,MUN,P010391,P011987,8.083,-3,11,14
201,ULK,P001932,P002968,2.333,5,7,2
201,ULK,P001932,P002969,0.833,1,4,3
201,ULK,P001932,P004004,19.499,11,43,32
201,ULK,P001932,P005844,8.366,4,20,16
201,ULK,P001932,P006068,12.933,17,33,16
201,ULK,P001932,P006661,23.032,20,58,38
201,ULK,P001932,P009849,4.433,7,16,9
201,ULK,P001932,P011157,20.699,15,51,36
201,ULK,P002968,P002969,3.517,0,7,7
201,ULK,P002968,P004004,7.616,8,18,10
201,ULK,P002968,P005844,2.883,0,5,5
201,ULK,P002968,P006068,8.233,10,22,12
201,ULK,P002968,P006661,8.066,10,20,10
201,ULK,P002968,P009849,4.083,2,9,7
201,ULK,P002968,P011052,9.133,5,20,15
201,ULK,P002969,P006068,6.15,-2,15,17
201,ULK,P002969,P006661,0.95,1,4,3
201,ULK,P002969,P009849,5.434,-3,11,14
201,ULK,P002969,P011052,5.434,-3,11,14
201,ULK,P002969,P011157,2.75,-2,8,10
201,ULK,P004004,P005844,15.549,-4,30,34
201,ULK,P004004,P006068,12.383,14,27,13
201,ULK,P004004,P006661,26.015,14,58,44
201,ULK,P004004,P009849,6.749,-8,11,19
201,ULK,P004004,P011052,9.499,0,17,17
201,ULK,P004004,P011157,22.282,1,44,43
201,ULK,P005844,P006661,12.799,-1,26,27
201,ULK,P005844,P009849,5.916,-9,6,15
201,ULK,P005844,P011052,7.416,-8,8,16
201,ULK,P005844,P011157,13.799,-6,25,31
201,ULK,P006068,P006661,15.916,23,42,19
201,ULK,P006068,P009849,8.017,5,22,17
201,ULK,P006068,P011052,8.3,3,20,17
201,ULK,P006068,P011157,13.0,10,31,21
201,ULK,P006661,P009849,6.816,3,18,15
201,ULK,P006661,P011052,6.866,3,13,10
201,ULK,P006661,P011157,22.732,11,53,42
201,ULK,P009849,P011052,10.683,-10,15,25
201,ULK,P009849,P011157,11.933,-7,24,31
201,ULK,P011052,P011157,6.933,-10,8,18
201,VIR,P001844,P002084,7.284,-17,5,22
201,VIR,P001844,P003048,13.4,-7,21,28
201,VIR,P001844,P003527,19.266,-2,34,36
201,VIR,P001844,P004554,13.767,-4,25,29
201,VIR,P001844,P005553,0.967,-2,3,5
201,VIR,P001844,P006739,2.934,-3,2,5
201,VIR,P001844,P008847,17.916,-6,36,42
201,VIR,P001844,P009549,18.033,-9,35,44
201,VIR,P001844,P010781,27.233,-10,47,57
201,VIR,P002084,P003048,1.567,-2,0,2
201,VIR,P002084,P003527,1.8,-2,0,2
201,VIR,P002084,P004554,11.651,-5,22,27
201,VIR,P002084,P005553,2.601,-3,4,7
201,VIR,P002084,P006739,8.75,3,18,15
201,VIR,P002084,P008847,0.7,-3,0,3
201,VIR,P002084,P009549,12.584,-8,22,30
201,VIR,P002084,P010781,9.667,-3,17,20
201,VIR,P003048,P003527,12.9,-8,18,26
201,VIR,P003048,P006739,1.566,-3,4,7
201,VIR,P003048,P008847,12.666,-6,24,30
201,VIR,P003048,P009549,2.799,-4,8,12
201,VIR,P003048,P010781,14.966,-10,25,35
201,VIR,P003527,P004554,5.983,4,12,8
201,VIR,P003527,P006739,2.1,-4,3,7
201,VIR,P003527,P008847,12.85,-6,24,30
201,VIR,P003527,P009549,9.199,0,20,20
201,VIR,P003527,P010781,21.366,-6,37,43
201,VIR,P004554,P005553,2.601,-3,4,7
201,VIR,P004554,P006739,9.667,2,19,17
201,VIR,P004554,P008847,3.283,3,9,6
201,VIR,P004554,P009549,21.234,2,43,41
201,VIR,P004554,P010781,16.75,9,38,29
201,VIR,P005553,P006739,1.517,-2,0,2
201,VIR,P005553,P009549,2.601,-3,4,7
201,VIR,P005553,P010781,0.117,1,1,0
201,VIR,P006739,P008847,2.217,-2,4,6
201,VIR,P006739,P009549,12.617,-2,24,26
201,VIR,P006739,P010781,9.1,3,22,19
201,VIR,P008847,P009549,8.916,-4,23,27
201,VIR,P008847,P010781,19.516,-8,40,48
201,VIR,P009549,P010781,23.349,0,53,53
202,PAN,P002328,P003842,14.733,-17,23,40
202,PAN,P002328,P005161,2.617,-4,4,8
202,PAN,P002328,P007866,13.617,-18,20,38
202,PAN,P002328,P011204,21.317,-8,41,49
202,PAN,P002328,P011209,14.75,-2,31,33
202,PAN,P002328,P011221,11.834,4,26,22
202,PAN,P002328,P012712,13.65,4,29,25
202,PAN,P002328,P012774,13.75,-11,22,33
202,PAN,P003842,P005161,5.667,-10,5,15
202,PAN,P003842,P007866,20.433,-26,28,54
202,PAN,P003842,P011204,21.033,-25,31,56
202,PAN,P003842,P011209,7.182,-8,14,22
202,PAN,P003842,P012712,6.866,-1,13,14
202,PAN,P003842,P012774,18.75,-17,26,43
202,PAN,P005161,P007866,10.167,-3,19,22
202,PAN,P005161,P011204,10.167,-3,19,22
202,PAN,P005161,P011209,5.3,1,11,10
202,PAN,P005161,P011221,7.117,3,18,15
202,PAN,P005161,P012712,2.617,-4,4,8
202,PAN,P005161,P012774,7.484,-8,12,20
202,PAN,P007866,P011204,27.05,-20,46,66
202,PAN,P007866,P011209,8.349,0,19,19
202,PAN,P007866,P011221,6.617,6,18,12
202,PAN,P007866,P012712,3.633,-1,6,7
202,PAN,P007866,P012774,18.334,-18,28,46
202,PAN,P011204,P011209,15.449,9,37,28
202,PAN,P011204,P011221,13.717,15,36,21
202,PAN,P011204,P012712,11.333,9,27,18
202,PAN,P011204,P012774,18.934,-17,31,48
202,PAN,P011209,P011221,13.517,12,31,19
202,PAN,P011209,P012712,15.283,4,32,28
202,PAN,P011209,P012774,2.966,0,5,5
202,PAN,P011221,P012712,9.717,5,22,17
202,PAN,P011221,P012774,2.817,-1,9,10
202,PAN,P012712,P012774,3.233,0,7,7
202,TEL,P004233,P009622,0.55,0,0,0
202,TEL,P004233,P009863,3.117,-5,5,10
202,TEL,P004233,P011193,3.667,-5,5,10
202,TEL,P004233,P011214,3.667,-5,5,10
202,TEL,P004233,P011219,3.667,-5,5,10
202,TEL,P005145,P009622,9.25,5,19,14
202,TEL,P005145,P009783,9.25,5,19,14
202,TEL,P005145,P009863,9.25,5,19,14
202,TEL,P005145,P011199,9.25,5,19,14
202,TEL,P007990,P009622,4.567,13,14,1
202,TEL,P007990,P009783,4.567,13,14,1
202,TEL,P007990,P011199,4.567,13,14,1
202,TEL,P007990,P011971,4.567,13,14,1
202,TEL,P009622,P009783,30.5,25,72,47
202,TEL,P009622,P009863,23.017,18,56,38
202,TEL,P009622,P011193,4.766,-12,2,14
202,TEL,P009622,P011199,28.617,27,72,45
202,TEL,P009622,P011214,3.733,-8,0,8
202,TEL,P009622,P011219,4.333,-12,2,14
202,TEL,P009622,P011971,20.067,20,51,31
202,TEL,P009783,P009863,26.301,19,67,48
202,TEL,P009783,P011193,6.2,-5,13,18
202,TEL,P009783,P011199,30.584,30,78,48
202,TEL,P009783,P011214,3.2,-4,5,9
202,TEL,P009783,P011219,4.45,-3,8,11
202,TEL,P009783,P011971,20.084,24,56,32
202,TEL,P009863,P011193,7.651,-4,18,22
202,TEL,P009863,P011199,23.534,23,62,39
202,TEL,P009863,P011214,7.134,-9,12,21
202,TEL,P009863,P011219,6.334,-2,13,15
202,TEL,P009863,P011971,16.334,11,44,33
202,TEL,P011193,P011199,4.45,-3,8,11
202,TEL,P011193,P011214,7.967,-13,12,25
202,TEL,P011193,P011219,10.667,-14,15,29
202,TEL,P011193,P011971,4.3,-8,7,15
202,TEL,P011199,P011219,4.45,-3,8,11
202,TEL,P011199,P011971,16.884,28,51,23
202,TEL,P011214,P011219,6.217,-11,7,18
202,TEL,P011214,P011971,5.75,-10,7,17
202,TEL,P011219,P011971,2.55,-6,2,8
203,MAD,P001392,P003108,12.734,-4,25,29
203,MAD,P001392,P003733,0.167,-2,0,2
203,MAD,P001392,P004887,7.017,-5,20,25
203,MAD,P001392,P005928,4.9,-5,13,18
203,MAD,P001392,P006540,3.0,-5,8,13
203,MAD,P001392,P009005,6.1,-9,15,24
203,MAD,P001392,P009213,10.233,-6,15,21
203,MAD,P001392,PBMT,12.566,-4,22,26
203,MAD,P001392,PCVM,12.283,-4,22,26
203,MAD,P003108,P003733,3.167,3,9,6
203,MAD,P003108,P004887,8.35,4,23,19
203,MAD,P003108,P005928,4.75,2,14,12
203,MAD,P003108,P006540,4.333,4,11,7
203,MAD,P003108,P009005,2.917,-3,7,10
203,MAD,P003108,P009213,8.717,-4,13,17
203,MAD,P003108,PBMT,11.05,-2,20,22
203,MAD,P003108,PCVM,12.25,0,22,22
203,MAD,P003733,P004887,20.45,15,51,36
203,MAD,P003733,P005928,20.317,15,51,36
203,MAD,P003733,P006540,18.833,7,43,36
203,MAD,P003733,P009005,18.417,12,44,32
203,MAD,P003733,P009213,1.134,0,2,2
203,MAD,P003733,PBMT,2.584,10,10,0
203,MAD,P003733,PCVM,1.267,0,2,2
203,MAD,P004887,P005928,25.2,7,64,57
203,MAD,P004887,P006540,23.166,1,53,52
203,MAD,P004887,P009005,23.3,4,57,53
203,MAD,P004887,PBMT,4.117,8,15,7
203,MAD,P004887,PCVM,3.6,2,9,7
203,MAD,P005928,P006540,22.066,-1,51,52
203,MAD,P005928,P009005,24.65,6,59,53
203,MAD,P005928,P009213,1.35,2,2,0
203,MAD,P005928,PBMT,2.967,10,10,0
203,MAD,P006540,P009005,20.166,-4,44,48
203,MAD,P006540,PCVM,1.1,2,2,0
203,MAD,P009005,P009213,2.55,-2,4,6
203,MAD,P009005,PBMT,4.167,6,12,6
203,MAD,P009005,PCVM,1.133,-2,2,4
203,MAD,P009213,PBMT,11.033,-2,17,19
203,MAD,P009213,PCVM,9.783,-4,15,19
203,MAD,PBMT,PCVM,12.116,-2,22,24
203,OLY,P001255,P006589,22.35,5,49,44
203,OLY,P001255,P007853,19.467,3,45,42
203,OLY,P001255,P008829,12.7,14,40,26
203,OLY,P001255,P008855,12.05,21,42,21
203,OLY,P001255,P010392,10.0,-5,17,22
203,OLY,P001255,P010612,5.567,11,19,8
203,OLY,P001255,P011194,1.867,6,10,4
203,OLY,P001255,P011965,18.267,1,42,41
203,OLY,P006589,P007853,19.801,-6,40,46
203,OLY,P006589,P008829,11.167,-1,25,26
203,OLY,P006589,P008855,10.517,6,27,21
203,OLY,P006589,P010392,10.067,-3,19,22
203,OLY,P006589,P010612,5.317,-3,9,12
203,OLY,P006589,P011965,16.917,-2,35,37
203,OLY,P007853,P008829,10.534,-9,23,32
203,OLY,P007853,P008855,10.534,-2,27,29
203,OLY,P007853,P010392,9.534,-3,17,20
203,OLY,P007853,P010612,3.867,-14,2,16
203,OLY,P007853,P011194,2.25,-6,2,8
203,OLY,P007853,P011965,17.617,1,40,39
203,OLY,P008829,P008855,21.234,-5,45,50
203,OLY,P008829,P010392,0.6,2,4,2
203,OLY,P008829,P010612,19.934,-10,36,46
203,OLY,P008829,P011194,14.617,-7,27,34
203,OLY,P008829,P011965,7.25,3,21,18
203,OLY,P008829,P011983,10.5,-7,15,22
203,OLY,P008855,P010392,1.917,4,7,3
203,OLY,P008855,P010612,19.817,-10,36,46
203,OLY,P008855,P011194,14.617,-7,27,34
203,OLY,P008855,P011965,4.75,8,18,10
203,OLY,P008855,P011983,10.5,-7,15,22
203,OLY,P010392,P011965,8.15,-7,12,19
203,OLY,P010612,P011194,14.617,-7,27,34
203,OLY,P010612,P011965,0.117,0,0,0
203,OLY,P010612,P011983,10.5,-7,15,22
203,OLY,P011194,P011983,10.5,-7,15,22
204,IST,P004888,P006590,17.967,1,37,36
204,IST,P004888,P007200,10.551,-8,12,20
204,IST,P004888,P009664,8.65,-5,11,16
204,IST,P004888,P009846,11.184,6,26,20
204,IST,P004888,P011078,17.901,-13,31,44
204,IST,P004888,P011981,11.051,-5,13,18
204,IST,P004888,P012788,11.368,3,28,25
204,IST,P004888,PLHK,6.4,-15,6,21
204,IST,P006590,P007200,14.117,10,31,21
204,IST,P006590,P009664,18.583,5,37,32
204,IST,P006590,P009846,21.217,12,50,38
204,IST,P006590,P011078,15.0,-1,32,33
204,IST,P006590,P011981,7.367,6,12,6
204,IST,P006590,P012788,14.267,7,34,27
204,IST,P006590,PLHK,7.95,-4,19,23
204,IST,P007200,P009664,17.85,4,35,31
204,IST,P007200,P009846,15.433,8,37,29
204,IST,P007200,P011078,9.767,-13,13,26
204,IST,P007200,P011981,8.934,-6,10,16
204,IST,P007200,P012788,5.4,0,14,14
204,IST,P007200,PLHK,13.484,-7,24,31
204,IST,P009664,P009846,16.266,7,37,30
204,IST,P009664,P011078,13.333,-5,24,29
204,IST,P009664,P011981,6.067,6,10,4
204,IST,P009664,P012788,6.016,2,12,10
204,IST,P009664,PLHK,12.767,-6,26,32
204,IST,P009846,P011078,17.067,4,37,33
204,IST,P009846,P011981,2.817,5,5,0
204,IST,P009846,P012788,16.367,8,38,30
204,IST,P009846,PLHK,9.317,2,22,20
204,IST,P011078,P011981,6.484,-6,8,14
204,IST,P011078,P012788,13.984,1,30,29
204,IST,P011078,PLHK,10.0,-15,13,28
204,IST,P011981,P012788,2.134,-1,4,5
204,IST,P011981,PLHK,2.95,-7,2,9
204,MCO,P002581,P004197,5.083,3,12,9
204,MCO,P002581,P005985,10.35,2,26,24
204,MCO,P002581,P009754,10.35,2,26,24
204,MCO,P002581,P010588,10.35,2,26,24
204,MCO,P002581,P011226,5.267,-1,14,15
204,MCO,P004197,P005985,5.083,3,12,9
204,MCO,P004197,P009754,5.083,3,12,9
204,MCO,P004197,P010588,5.083,3,12,9
204,MCO,P005985,P009754,15.383,3,34,31
204,MCO,P005985,P010588,25.467,-5,47,52
204,MCO,P005985,P011196,9.966,-8,13,21
204,MCO,P005985,P011212,15.3,5,31,26
204,MCO,P005985,P011226,23.033,-5,44,49
204,MCO,P005985,P011231,11.233,5,28,23
204,MCO,P005985,P012709,4.45,-7,3,10
204,MCO,P005985,PLCZ,12.667,11,26,15
204,MCO,P009754,P010588,11.467,0,26,26
204,MCO,P009754,P011196,6.883,-4,8,12
204,MCO,P009754,P011212,7.549,3,16,13
204,MCO,P009754,P011226,15.949,3,36,33
204,MCO,P009754,P011231,9.899,2,20,18
204,MCO,P009754,P012709,1.117,-2,0,2
204,MCO,P009754,PLCZ,4.916,6,14,8
204,MCO,P010588,P011196,4.45,-7,3,10
204,MCO,P010588,P011212,10.667,0,18,18
204,MCO,P010588,P011226,15.267,-11,25,36
204,MCO,P010588,P011231,4.25,1,11,10
204,MCO,P010588,P012709,4.45,-7,3,10
204,MCO,P010588,PLCZ,10.417,4,17,13
204,MCO,P011196,P011212,5.016,-5,6,11
204,MCO,P011196,P011226,9.532,-9,12,21
204,MCO,P011196,P011231,10.099,-4,15,19
204,MCO,P011196,P012709,4.45,-7,3,10
204,MCO,P011212,P011226,20.016,1,38,37
204,MCO,P011212,P011231,12.916,5,33,28
204,MCO,P011212,PLCZ,16.8,15,38,23
204,MCO,P011226,P011231,13.999,1,32,31
204,MCO,P011226,P012709,1.383,-5,0,5
204,MCO,P011226,PLCZ,14.75,10,31,21
204,MCO,P011231,P012709,1.95,0,3,3
204,MCO,P011231,PLCZ,7.65,14,26,12
205,BAR,P000925,P002939,21.716,10,53,43
205,BAR,P000925,P004866,25.349,9,53,44
205,BAR,P000925,P006435,4.316,2,5,3
205,BAR,P000925,P007519,15.816,20,40,20
205,BAR,P000925,P009992,13.05,-2,23,25
205,BAR,P000925,P011244,3.083,2,5,3
205,BAR,P000925,P012745,23.666,11,53,42
205,BAR,P002939,P003196,7.251,-10,4,14
205,BAR,P002939,P004866,25.233,1,50,49
205,BAR,P002939,P006435,6.567,-7,4,11
205,BAR,P002939,P007519,13.117,12,37,25
205,BAR,P002939,P009992,13.017,-6,23,29
205,BAR,P002939,P011244,5.7,-6,4,10
205,BAR,P002939,P012745,23.267,6,53,47
205,BAR,P003196,P004866,7.9,-8,5,13
205,BAR,P003196,P006435,8.367,-9,5,14
205,BAR,P003196,P007464,3.016,-4,5,9
205,BAR,P003196,P007519,8.333,-12,10,22
205,BAR,P003196,P009992,4.883,-8,7,15
205,BAR,P003196,P011244,8.933,-10,6,16
205,BAR,P003196,P012745,4.317,-7,6,13
205,BAR,P004866,P006435,12.216,-6,10,16
205,BAR,P004866,P007519,17.399,13,38,25
205,BAR,P004866,P009992,11.65,-6,18,24
205,BAR,P004866,P011244,10.583,-6,10,16
205,BAR,P004866,P012745,22.666,7,48,41
205,BAR,P006435,P007519,6.583,-1,6,7
205,BAR,P006435,P011244,10.583,-6,10,16
205,BAR,P006435,P012745,2.1,-1,0,1
205,BAR,P007464,P007519,3.016,-4,5,9
205,BAR,P007464,P009992,3.016,-4,5,9
205,BAR,P007464,P011244,1.433,-2,1,3
205,BAR,P007464,P012745,1.583,-2,4,6
205,BAR,P007519,P009992,8.183,-4,14,18
205,BAR,P007519,P011244,6.316,-2,7,9
205,BAR,P007519,P012745,17.833,10,43,33
205,BAR,P009992,P011244,1.433,-2,1,3
205,BAR,P009992,P012745,16.5,-8,29,37
205,MIL,P001518,P002812,3.634,-7,2,9
205,MIL,P001518,P002849,5.016,4,11,7
205,MIL,P001518,P005670,3.133,0,2,2
205,MIL,P001518,P007032,1.667,-3,0,3
205,MIL,P001518,P007201,1.05,0,0,0
205,MIL,P001518,P007831,9.017,-2,15,17
205,MIL,P001518,P009960,3.333,1,4,3
205,MIL,P001518,P011205,6.0,-4,6,10
205,MIL,P001518,P011224,6.9,4,15,11
205,MIL,P001518,P012800,8.85,-1,13,14
205,MIL,P002812,P002849,1.933,-2,4,6
205,MIL,P002812,P005670,5.184,5,8,3
205,MIL,P002812,P007032,1.9,-3,0,3
205,MIL,P002812,P007201,5.85,9,14,5
205,MIL,P002812,P007831,6.4,-2,12,14
205,MIL,P002812,P011205,6.5,-3,12,15
205,MIL,P002812,P011224,4.067,-1,10,11
205,MIL,P002812,P012800,10.2,4,18,14
205,MIL,P002849,P005670,3.55,0,5,5
205,MIL,P002849,P007201,7.8,3,16,13
205,MIL,P002849,P007831,23.933,4,51,47
205,MIL,P002849,P009960,13.033,-5,22,27
205,MIL,P002849,P011205,20.216,-14,32,46
205,MIL,P002849,P011224,23.349,0,48,48
205,MIL,P002849,P012800,8.766,10,23,13
205,MIL,P005670,P007201,5.334,7,11,4
205,MIL,P005670,P007831,2.317,5,7,2
205,MIL,P005670,P009960,1.15,-2,0,2
205,MIL,P005670,P011205,5.534,0,6,6
205,MIL,P005670,P012800,8.734,5,13,8
205,MIL,P007032,P007201,0.233,0,0,0
205,MIL,P007032,P007831,1.9,-3,0,3
205,MIL,P007032,P012800,1.9,-3,0,3
205,MIL,P007201,P007831,11.533,13,27,14
205,MIL,P007201,P011205,10.467,2,18,16
205,MIL,P007201,P011224,8.9,4,18,14
205,MIL,P007201,P012800,8.101,14,20,6
205,MIL,P007831,P009960,14.6,-4,26,30
205,MIL,P007831,P011205,20.183,-11,35,46
205,MIL,P007831,P011224,28.05,4,57,53
205,MIL,P007831,P012800,13.267,16,34,18
205,MIL,P009960,P011205,9.7,-6,17,23
205,MIL,P009960,P011224,14.333,-2,26,28
205,MIL,P009960,P012800,5.783,2,9,7
205,MIL,P011205,P011224,20.433,-11,35,46
205,MIL,P011205,P012800,6.967,-1,11,12
205,MIL,P011224,P012800,9.3,14,27,13
206,PAR,P003983,P007400,15.55,6,26,20
206,PAR,P003983,P007673,12.75,3,20,17
206,PAR,P003983,P008987,13.833,5,24,19
206,PAR,P003983,P009862,1.45,1,2,1
206,PAR,P003983,P011051,4.584,-2,4,6
206,PAR,P003983,P012096,4.0,-1,3,4
206,PAR,P003983,P012742,3.217,3,6,3
206,PAR,P003983,P012743,6.816,9,19,10
206,PAR,P007400,P007673,13.1,3,20,17
206,PAR,P007400,P008987,20.199,9,42,33
206,PAR,P007400,P009862,17.316,13,42,29
206,PAR,P007400,P011051,17.367,8,34,26
206,PAR,P007400,P012096,8.25,2,15,13
206,PAR,P007400,P012742,19.083,15,46,31
206,PAR,P007400,P012743,14.799,16,39,23
206,PAR,P007673,P008987,16.633,3,29,26
206,PAR,P007673,P009862,4.65,0,9,9
206,PAR,P007673,P011051,3.767,-2,2,4
206,PAR,P007673,P012096,8.3,-1,12,13
206,PAR,P007673,P012742,5.067,0,9,9
206,PAR,P007673,P012743,5.333,6,15,9
206,PAR,P008987,P009862,15.099,-5,33,38
206,PAR,P008987,P011051,11.383,-9,18,27
206,PAR,P008987,P012096,12.583,-10,18,28
206,PAR,P008987,P012742,16.449,-3,37,40
206,PAR,P008987,P012743,8.949,10,27,17
206,PAR,P009862,P011051,17.416,1,36,35
206,PAR,P009862,P012096,12.833,-6,27,33
206,PAR,P009862,P012742,25.899,4,57,53
206,PAR,P009862,P012743,8.933,8,22,14
206,PAR,P011051,P012096,8.533,-6,18,24
206,PAR,P011051,P012742,18.65,1,38,37
206,PAR,P011051,P012743,4.9,5,10,5
206,PAR,P012096,P012742,12.833,-6,27,33
206,PAR,P012742,P012743,9.466,10,24,14
206,ZAL,P002329,P002676,3.533,1,9,8
206,ZAL,P002329,P003210,1.317,0,2,2
206,ZAL,P002329,P003211,4.033,1,4,3
206,ZAL,P002329,P005504,10.066,5,21,16
206,ZAL,P002329,P007109,16.249,3,30,27
206,ZAL,P002329,P007513,8.249,-2,17,19
206,ZAL,P002329,P010390,7.066,-5,11,16
206,ZAL,P002329,P011218,17.132,0,32,32
206,ZAL,P002329,P012715,0.883,-3,2,5
206,ZAL,P002676,P003210,6.333,-8,9,17
206,ZAL,P002676,P003211,0.533,-2,0,2
206,ZAL,P002676,P005504,5.85,-4,11,15
206,ZAL,P002676,P007109,11.066,-7,22,29
206,ZAL,P002676,P007513,15.799,-4,32,36
206,ZAL,P002676,P010390,14.699,1,32,31
206,ZAL,P002676,P011218,14.849,3,34,31
206,ZAL,P002676,P012715,12.066,0,23,23
206,ZAL,P003210,P003211,1.466,-2,2,4
206,ZAL,P003210,P005504,4.984,-9,4,13
206,ZAL,P003210,P007109,5.534,-11,4,15
206,ZAL,P003210,P007513,7.317,-11,9,20
206,ZAL,P003210,P010390,4.299,-4,9,13
206,ZAL,P003210,P011218,1.734,0,2,2
206,ZAL,P003210,P012715,5.383,-2,9,11
206,ZAL,P003210,P012787,2.033,-5,2,7
206,ZAL,P003211,P005504,2.683,1,2,1
206,ZAL,P003211,P007109,4.033,1,4,3
206,ZAL,P003211,P010390,5.583,0,8,8
206,ZAL,P003211,P011218,6.8,3,8,5
206,ZAL,P003211,P012715,4.233,0,6,6
206,ZAL,P003211,P012787,3.7,2,6,4
206,ZAL,P005504,P007109,14.683,-1,28,29
206,ZAL,P005504,P007513,12.616,-5,28,33
206,ZAL,P005504,P011218,12.949,5,30,25
206,ZAL,P005504,P012715,1.933,-3,4,7
206,ZAL,P005504,P012787,0.7,-5,0,5
206,ZAL,P007109,P007513,15.099,-12,26,38
206,ZAL,P007109,P010390,9.166,-7,15,22
206,ZAL,P007109,P011218,21.499,1,41,40
206,ZAL,P007109,P012715,2.767,-2,2,4
206,ZAL,P007109,P012787,1.1,-5,0,5
206,ZAL,P007513,P010390,11.499,-4,21,25
206,ZAL,P007513,P011218,18.665,0,40,40
206,ZAL,P007513,P012715,11.916,-1,23,24
206,ZAL,P007513,P012787,1.1,-5,0,5
206,ZAL,P010390,P011218,17.633,1,31,30
206,ZAL,P010390,P012715,14.083,4,27,23
206,ZAL,P010390,P012787,3.7,2,6,4
206,ZAL,P011218,P012715,12.5,1,22,21
206,ZAL,P011218,P012787,2.767,2,4,2
206,ZAL,P012715,P012787,4.1,2,6,4
207,BAS,P003198,P004761,4.833,1,8,7
207,BAS,P003198,P009048,4.833,1,8,7
207,BAS,P003198,P010444,4.833,1,8,7
207,BAS,P003198,P012201,4.833,1,8,7
207,BAS,P004603,P004761,10.783,-10,10,20
207,BAS,P004603,P007230,16.316,-14,20,34
207,BAS,P004603,P007946,6.233,-6,12,18
207,BAS,P004603,P008850,5.533,-4,10,14
207,BAS,P004603,P009048,10.083,-8,8,16
207,BAS,P004603,P011948,12.316,-13,17,30
207,BAS,P004603,P012201,4.0,-1,3,4
207,BAS,P004761,P007230,20.467,-11,27,38
207,BAS,P004761,P007946,7.633,5,18,13
207,BAS,P004761,P009048,19.533,-15,17,32
207,BAS,P004761,P010444,14.983,2,25,23
207,BAS,P004761,P011085,0.467,-2,0,2
207,BAS,P004761,P011948,6.783,-9,7,16
207,BAS,P004761,P012201,19.45,-1,28,29
207,BAS,P007230,P007946,15.766,5,36,31
207,BAS,P007230,P008850,8.216,-6,14,20
207,BAS,P007230,P009048,17.85,-18,13,31
207,BAS,P007230,P010444,12.05,5,25,20
207,BAS,P007230,P011085,2.85,-4,4,8
207,BAS,P007230,P011948,16.049,-9,25,34
207,BAS,P007230,P012201,20.1,0,32,32
207,BAS,P007946,P008850,5.833,-4,10,14
207,BAS,P007946,P009048,3.95,-3,5,8
207,BAS,P007946,P010444,11.083,8,29,21
207,BAS,P007946,P011948,11.283,-5,25,30
207,BAS,P007946,P012201,12.283,8,29,21
207,BAS,P008850,P009048,2.683,-2,4,6
207,BAS,P008850,P011085,2.383,-2,4,6
207,BAS,P008850,P011948,5.533,-4,10,14
207,BAS,P008850,P012201,2.683,-2,4,6
207,BAS,P009048,P010444,11.3,-8,14,22
207,BAS,P009048,P011085,2.85,-4,4,8
207,BAS,P009048,P011948,9.3,-10,10,20
207,BAS,P009048,P012201,19.35,-13,21,34
207,BAS,P010444,P011948,4.65,1,13,12
207,BAS,P010444,P012201,19.633,3,38,35
207,BAS,P011085,P012201,2.85,-4,4,8
207,BAS,P011948,P012201,5.55,1,13,12
207,PAM,P003960,P004863,1.633,1,3,2
207,PAM,P003960,P005356,11.716,9,19,10
207,PAM,P003960,P006433,11.816,6,18,12
207,PAM,P003960,P007870,20.482,19,40,21
207,PAM,P003960,P010568,21.649,25,46,21
207,PAM,P003960,P011970,4.783,9,15,6
207,PAM,P003960,P011982,2.1,6,6,0
207,PAM,P003960,P012795,16.149,25,37,12
207,PAM,P004863,P005356,12.749,2,29,27
207,PAM,P004863,P007870,7.416,0,13,13
207,PAM,P004863,P010393,11.316,0,22,22
207,PAM,P004863,P010568,4.4,1,7,6
207,PAM,P004863,P011970,4.666,-3,9,12
207,PAM,P004863,P011982,14.966,1,30,29
207,PAM,P004863,P012740,5.3,3,11,8
207,PAM,P004863,P012795,3.95,3,8,5
207,PAM,P005356,P006433,5.733,-1,6,7
207,PAM,P005356,P007870,11.549,2,19,17
207,PAM,P005356,P010393,9.183,2,20,18
207,PAM,P005356,P010568,12.766,7,21,14
207,PAM,P005356,P011970,2.533,-1,7,8
207,PAM,P005356,P011982,13.216,7,32,25
207,PAM,P005356,P012740,5.3,3,11,8
207,PAM,P005356,P012795,6.583,10,16,6
207,PAM,P006433,P007870,11.816,6,18,12
207,PAM,P006433,P010568,11.816,6,18,12
207,PAM,P006433,P012795,6.083,7,12,5
207,PAM,P007870,P010393,2.133,-2,2,4
207,PAM,P007870,P010568,24.349,8,43,35
207,PAM,P007870,P011970,9.366,-4,18,22
207,PAM,P007870,P011982,8.233,-12,11,23
207,PAM,P007870,P012795,19.516,11,40,29
207,PAM,P010393,P010568,1.35,0,2,2
207,PAM,P010393,P011970,4.666,-3,9,12
207,PAM,P010393,P011982,11.316,0,22,22
207,PAM,P010393,P012740,5.3,3,11,8
207,PAM,P010568,P011970,7.233,-2,16,18
207,PAM,P010568,P011982,8.25,-5,11,16
207,PAM,P010568,P012795,19.383,16,40,24
207,PAM,P011970,P011982,7.116,-14,10,24
207,PAM,P011970,P012795,7.233,-2,16,18
207,PAM,P011982,P012740,5.3,3,11,8
207,PAM,P011982,P012795,7.567,-2,15,17
208,PAM,P000556,P003960,6.15,-2,8,10
208,PAM,P000556,P005356,0.267,0,0,0
208,PAM,P000556,P006433,0.65,-3,0,3
208,PAM,P000556,P006643,0.267,0,0,0
208,PAM,P000556,P010393,1.55,-4,4,8
208,PAM,P000556,P010568,7.05,-3,12,15
208,PAM,P000556,P011970,7.25,-5,12,17
208,PAM,P000556,P011982,9.967,-6,14,20
208,PAM,P000556,P012738,2.0,0,2,2
208,PAM,P000556,P012740,4.45,-1,4,5
208,PAM,P000556,P012795,0.267,0,0,0
208,PAM,P003960,P005356,11.067,-3,15,18
208,PAM,P003960,P006643,7.217,-4,8,12
208,PAM,P003960,P010568,22.934,-1,38,39
208,PAM,P003960,P011970,9.05,4,18,14
208,PAM,P003960,P011982,8.267,2,15,13
208,PAM,P003960,P012738,15.084,-2,25,27
208,PAM,P003960,P012740,10.267,-1,20,21
208,PAM,P003960,P012795,1.7,3,5,2
208,PAM,P005356,P006643,3.884,-4,0,4
208,PAM,P005356,P010393,0.917,-3,0,3
208,PAM,P005356,P010568,11.4,-3,15,18
208,PAM,P005356,P011970,5.167,-1,10,11
208,PAM,P005356,P011982,2.117,-3,3,6
208,PAM,P005356,P012738,12.0,-3,18,21
208,PAM,P005356,P012740,5.65,-4,11,15
208,PAM,P005356,P012795,0.267,0,0,0
208,PAM,P006433,P006643,2.533,-4,5,9
208,PAM,P006433,P010393,10.233,-15,13,28
208,PAM,P006433,P011970,7.7,-11,8,19
208,PAM,P006433,P011982,7.7,-11,8,19
208,PAM,P006433,P012738,2.533,-4,5,9
208,PAM,P006433,P012740,2.533,-4,5,9
208,PAM,P006433,P012795,7.05,-8,8,16
208,PAM,P006643,P010393,2.533,-4,5,9
208,PAM,P006643,P010568,8.5,-2,12,14
208,PAM,P006643,P011982,1.55,2,4,2
208,PAM,P006643,P012738,11.033,-6,17,23
208,PAM,P006643,P012740,7.416,-2,17,19
208,PAM,P006643,P012795,0.267,0,0,0
208,PAM,P010393,P010568,0.9,-1,4,5
208,PAM,P010393,P011970,10.05,-15,12,27
208,PAM,P010393,P011982,10.05,-15,12,27
208,PAM,P010393,P012738,2.533,-4,5,9
208,PAM,P010393,P012740,3.983,-7,5,12
208,PAM,P010393,P012795,7.583,-8,8,16
208,PAM,P010568,P011970,9.95,3,22,19
208,PAM,P010568,P011982,10.783,3,23,20
208,PAM,P010568,P012738,16.7,0,29,29
208,PAM,P010568,P012740,11.883,1,24,23
208,PAM,P010568,P012795,1.7,3,5,2
208,PAM,P011970,P011982,18.05,-13,28,41
208,PAM,P011970,P012738,6.25,2,12,10
208,PAM,P011970,P012740,4.05,-3,5,8
208,PAM,P011970,P012795,9.283,-5,13,18
208,PAM,P011982,P012738,4.633,3,11,8
208,PAM,P011982,P012740,8.533,-1,13,14
208,PAM,P011982,P012795,9.55,-5,13,18
208,PAM,P012738,P012740,14.566,-2,32,34
208,PAM,P012740,P012795,0.533,0,0,0
208,RED,P000848,P002553,2.217,-5,3,8
208,RED,P000848,P005099,2.667,2,8,6
208,RED,P000848,P006436,9.1,7,26,19
208,RED,P000848,P007960,14.115,11,37,26
208,RED,P000848,P008966,9.0,9,23,14
208,RED,P000848,P009035,7.399,2,19,17
208,RED,P000848,P011941,2.05,-2,4,6
208,RED,P000848,P012044,7.35,4,20,16
208,RED,P000848,P012801,3.383,0,6,6
208,RED,P000848,PJDR,11.783,5,26,21
208,RED,P000848,PLUO,4.732,3,12,9
208,RED,P002553,P006436,7.734,1,10,9
208,RED,P002553,P008966,0.617,-2,0,2
208,RED,P002553,P009035,8.45,0,11,11
208,RED,P002553,P011941,0.417,-1,1,2
208,RED,P002553,P012044,8.617,-1,12,13
208,RED,P002553,P012801,3.434,-2,5,7
208,RED,P002553,PJDR,0.867,-2,0,2
208,RED,P002553,PLUO,5.583,0,6,6
208,RED,P005099,P006436,5.267,0,10,10
208,RED,P005099,P007960,6.033,10,17,7
208,RED,P005099,P008966,9.85,9,24,15
208,RED,P005099,P009035,1.45,1,3,2
208,RED,P005099,P012044,0.45,-3,0,3
208,RED,P005099,P012801,8.183,11,19,8
208,RED,P005099,PJDR,10.85,13,27,14
208,RED,P005099,PLUO,0.45,-3,0,3
208,RED,P006436,P007960,9.899,9,25,16
208,RED,P006436,P008966,11.217,9,25,16
208,RED,P006436,P009035,10.833,5,19,14
208,RED,P006436,P011941,2.05,-2,4,6
208,RED,P006436,P012044,14.517,11,28,17
208,RED,P006436,P012801,10.7,0,17,17
208,RED,P006436,PJDR,10.317,2,21,19
208,RED,P006436,PLUO,4.766,6,7,1
208,RED,P007960,P008966,18.316,19,43,24
208,RED,P007960,P009035,4.099,1,11,10
208,RED,P007960,P011941,1.633,-1,3,4
208,RED,P007960,P012044,11.833,3,25,22
208,RED,P007960,P012801,12.399,10,25,15
208,RED,P007960,PJDR,13.099,17,33,16
208,RED,P007960,PLUO,4.766,-3,9,12
208,RED,P008966,P012044,8.317,3,17,14
208,RED,P008966,P012801,16.216,9,32,23
208,RED,P008966,PJDR,15.317,14,34,20
208,RED,P008966,PLUO,2.15,-6,2,8
208,RED,P009035,P012044,10.6,1,16,15
208,RED,P009035,P012801,3.967,-2,5,7
208,RED,P009035,PJDR,4.866,3,12,9
208,RED,P009035,PLUO,9.132,5,16,11
208,RED,P011941,P012044,1.8,-2,4,6
208,RED,P011941,PJDR,0.25,0,0,0
208,RED,P012044,P012801,8.617,-4,12,16
208,RED,P012044,PJDR,1.151,1,1,0
208,RED,P012044,PLUO,9.616,-5,13,18
208,RED,P012801,PJDR,11.566,11,25,14
208,RED,P012801,PLUO,2.267,-5,2,7
208,RED,PJDR,PLUO,1.666,4,5,1
209,BAS,P003198,P004603,15.867,-2,36,38
209,BAS,P003198,P004761,21.901,-8,48,56
209,BAS,P003198,P007946,20.284,-2,48,50
209,BAS,P003198,P008850,0.417,-2,0,2
209,BAS,P003198,P009048,28.051,0,68,68
209,BAS,P003198,P010444,17.151,2,41,39
209,BAS,P003198,P011085,1.117,-3,2,5
209,BAS,P003198,P011948,17.7,10,46,36
209,BAS,P003198,P012201,10.184,-3,19,22
209,BAS,P004603,P004761,10.451,-11,22,33
209,BAS,P004603,P007946,15.867,-2,36,38
209,BAS,P004603,P009048,13.917,-4,33,37
209,BAS,P004603,P010444,3.167,-4,6,10
209,BAS,P004603,P011948,11.75,1,26,25
209,BAS,P004603,P012201,5.117,-2,9,11
209,BAS,P004761,P007946,10.701,-11,24,35
209,BAS,P004761,P008850,1.734,0,5,5
209,BAS,P004761,P009048,21.518,-11,50,61
209,BAS,P004761,P010444,19.201,-4,43,47
209,BAS,P004761,P011948,9.85,-3,23,26
209,BAS,P004761,P012201,11.184,-4,21,25
209,BAS,P007946,P008850,0.15,-2,0,2
209,BAS,P007946,P009048,15.167,0,39,39
209,BAS,P007946,P010444,4.267,2,12,10
209,BAS,P007946,P011948,9.583,9,24,15
209,BAS,P007946,P012201,5.117,-2,9,11
209,BAS,P008850,P009048,5.634,5,21,16
209,BAS,P008850,P010444,5.484,7,21,14
209,BAS,P008850,P011948,3.9,5,16,11
209,BAS,P008850,P012201,5.217,7,21,14
209,BAS,P009048,P010444,28.985,1,73,72
209,BAS,P009048,P011085,4.317,-4,7,11
209,BAS,P009048,P011948,28.217,7,73,66
209,BAS,P009048,P012201,13.734,2,36,34
209,BAS,P010444,P011085,4.317,-4,7,11
209,BAS,P010444,P011948,19.634,2,53,51
209,BAS,P010444,P012201,13.734,2,36,34
209,BAS,P011085,P011948,4.317,-4,7,11
209,BAS,P011085,P012201,3.2,-1,5,6
209,BAS,P011948,P012201,7.917,1,24,23
209,MUN,P001288,P001557,21.752,-6,46,52
209,MUN,P001288,P003583,24.851,-1,54,55
209,MUN,P001288,P004508,11.217,-5,23,28
209,MUN,P001288,P005460,7.55,-5,19,24
209,MUN,P001288,P006543,1.7,1,8,7
209,MUN,P001288,P007975,14.4,-5,29,34
209,MUN,P001288,P008985,19.101,3,53,50
209,MUN,P001288,P010391,14.05,-1,34,35
209,MUN,P001288,P011987,21.783,-1,58,59
209,MUN,P001557,P003583,16.718,-1,36,37
209,MUN,P001557,P004508,5.484,-5,9,14
209,MUN,P001557,P005460,5.017,-3,10,13
209,MUN,P001557,P006543,0.217,-2,0,2
209,MUN,P001557,P007975,6.417,-7,9,16
209,MUN,P001557,P008985,13.535,5,33,28
209,MUN,P001557,P010391,6.084,-5,13,18
209,MUN,P001557,P011987,12.584,0,28,28
209,MUN,P003583,P004508,13.917,-4,26,30
209,MUN,P003583,P006543,6.783,0,16,16
209,MUN,P003583,P007975,20.55,-7,43,50
209,MUN,P003583,P008985,12.101,5,32,27
209,MUN,P003583,P010391,14.416,1,32,31
209,MUN,P003583,P011987,17.2,3,41,38
209,MUN,P004508,P005460,8.1,7,28,21
209,MUN,P004508,P006543,10.8,8,31,23
209,MUN,P004508,P007975,17.767,7,43,36
209,MUN,P004508,P008985,3.1,-5,7,12
209,MUN,P004508,P010391,15.3,11,40,29
209,MUN,P004508,P011987,2.783,-2,9,11
209,MUN,P005460,P006543,3.917,8,15,7
209,MUN,P005460,P007975,4.75,10,17,7
209,MUN,P005460,P008985,5.3,-3,13,16
209,MUN,P005460,P010391,8.934,5,25,20
209,MUN,P005460,P011987,3.1,-7,9,16
209,MUN,P006543,P007975,10.7,8,31,23
209,MUN,P006543,P008985,1.7,1,8,7
209,MUN,P006543,P010391,12.3,9,39,30
209,MUN,P006543,P011987,1.483,3,8,5
209,MUN,P007975,P008985,1.4,-1,5,6
209,MUN,P007975,P010391,18.166,9,44,35
209,MUN,P007975,P011987,7.05,-2,19,21
209,MUN,P008985,P010391,4.784,2,17,15
209,MUN,P008985,P011987,15.383,5,44,39
209,MUN,P010391,P011987,5.766,-3,16,19
210,ASV,P000229,P003526,13.75,-8,18,26
210,ASV,P000229,P005094,13.949,-16,20,36
210,ASV,P000229,P006568,19.633,-12,32,44
210,ASV,P000229,P011225,18.449,-15,32,47
210,ASV,P000229,P011386,8.467,5,14,9
210,ASV,P000229,P012729,14.866,4,33,29
210,ASV,P000229,P012731,8.767,1,12,11
210,ASV,P000229,PKIR,9.783,1,23,22
210,ASV,P003526,P005094,8.983,-10,12,22
210,ASV,P003526,P006568,12.517,-9,15,24
210,ASV,P003526,P011225,15.433,-8,25,33
210,ASV,P003526,P011386,5.384,0,6,6
210,ASV,P003526,P012729,8.3,1,16,15
210,ASV,P003526,P012731,10.501,1,16,15
210,ASV,P003526,PKIR,8.4,1,16,15
210,ASV,P005094,P006568,12.349,-10,19,29
210,ASV,P005094,P011225,19.166,-15,32,47
210,ASV,P005094,P012729,9.45,-5,20,25
210,ASV,P005094,P012731,5.95,1,12,11
210,ASV,P005094,PKIR,6.817,-5,13,18
210,ASV,P006568,P011225,18.533,-12,31,43
210,ASV,P006568,P011386,3.667,1,5,4
210,ASV,P006568,P012729,8.383,1,21,20
210,ASV,P006568,P012731,6.984,-5,6,11
210,ASV,P006568,PKIR,6.734,2,15,13
210,ASV,P011225,P012729,18.866,-2,45,47
210,ASV,P011225,P012731,16.0,1,32,31
210,ASV,P011225,PKIR,17.217,-1,39,40
210,ASV,P011386,P012729,7.317,4,13,9
210,ASV,P011386,P012731,5.851,0,7,7
210,ASV,P011386,PKIR,5.65,2,11,9
210,ASV,P012729,P012731,17.017,3,36,33
210,ASV,P012729,PKIR,20.533,2,48,46
210,ASV,P012731,PKIR,16.334,2,35,33
210,ULK,P001932,P002968,14.15,10,29,19
210,ULK,P001932,P004004,11.05,0,19,19
210,ULK,P001932,P005844,17.05,10,35,25
210,ULK,P001932,P006068,25.35,7,45,38
210,ULK,P001932,P006661,24.517,12,51,39
210,ULK,P001932,P006961,1.816,1,7,6
210,ULK,P001932,P009849,2.633,-3,2,5
210,ULK,P001932,P011157,13.483,-1,24,25
210,ULK,P001932,P011980,0.483,0,0,0
210,ULK,P002968,P002969,0.367,0,0,0
210,ULK,P002968,P004004,5.334,6,15,9
210,ULK,P002968,P005844,14.417,5,31,26
210,ULK,P002968,P006068,15.934,9,33,24
210,ULK,P002968,P006661,16.734,10,36,26
210,ULK,P002969,P004004,3.55,-7,2,9
210,ULK,P002969,P006068,0.9,-4,0,4
210,ULK,P002969,P006661,0.367,0,0,0
210,ULK,P002969,P009849,3.183,-7,2,9
210,ULK,P002969,P011157,3.183,-7,2,9
210,ULK,P002969,P011980,2.65,-3,2,5
210,ULK,P004004,P005844,8.184,8,26,18
210,ULK,P004004,P006068,13.368,-1,25,26
210,ULK,P004004,P006661,17.084,13,47,34
210,ULK,P004004,P006961,4.533,3,14,11
210,ULK,P004004,P009849,7.666,-11,7,18
210,ULK,P004004,P011157,18.083,-5,34,39
210,ULK,P004004,P011980,4.816,-2,7,9
210,ULK,P005844,P006068,19.601,16,46,30
210,ULK,P005844,P006661,23.667,17,58,41
210,ULK,P005844,P006961,3.2,4,9,5
210,ULK,P005844,P009849,0.85,-4,0,4
210,ULK,P005844,P011157,9.767,12,27,15
210,ULK,P006068,P006661,26.168,17,57,40
210,ULK,P006068,P006961,1.2,-2,2,4
210,ULK,P006068,P009849,3.166,-7,2,9
210,ULK,P006068,P011157,14.017,-1,26,27
210,ULK,P006068,P011980,0.1,-2,0,2
210,ULK,P006661,P006961,3.433,5,14,9
210,ULK,P006661,P009849,2.433,-1,5,6
210,ULK,P006661,P011157,16.35,12,43,31
210,ULK,P006661,P011980,1.583,3,5,2
210,ULK,P006961,P009849,0.583,0,2,2
210,ULK,P006961,P011157,5.116,3,16,13
210,ULK,P006961,P011980,0.583,-2,0,2
210,ULK,P009849,P011157,8.249,-11,9,20
210,ULK,P009849,P011980,4.233,0,7,7
210,ULK,P011157,P011980,4.816,-2,7,9
211,BER,P006251,P007025,4.2,-5,11,16
211,BER,P006251,P008173,6.016,2,18,16
211,BER,P006251,P008211,14.666,-8,28,36
211,BER,P006251,P008384,16.133,-9,32,41
211,BER,P006251,P008780,12.85,-15,21,36
211,BER,P006251,P010791,16.133,-9,32,41
211,BER,P006251,P011934,2.733,-4,7,11
211,BER,P006251,P012720,2.733,-4,7,11
211,BER,P006819,P007025,4.3,5,13,8
211,BER,P006819,P008173,4.3,5,13,8
211,BER,P006819,P008384,4.3,5,13,8
211,BER,P006819,P010791,0.45,0,0,0
211,BER,P006819,P012721,3.85,5,13,8
211,BER,P007025,P008173,10.983,11,35,24
211,BER,P007025,P008384,5.767,4,17,13
211,BER,P007025,P008780,1.467,-1,4,5
211,BER,P007025,P010791,1.917,-1,4,5
211,BER,P007025,P011934,6.683,6,22,16
211,BER,P007025,P012720,6.683,6,22,16
211,BER,P007025,P012721,7.8,15,28,13
211,BER,P008173,P008211,3.283,6,11,5
211,BER,P008173,P008384,9.416,12,31,19
211,BER,P008173,P008967,10.883,-13,18,31
211,BER,P008173,P010791,3.733,6,11,5
211,BER,P008173,P011934,17.566,-7,40,47
211,BER,P008173,P012720,15.733,-8,33,41
211,BER,P008173,P012721,18.683,2,46,44
211,BER,P008211,P008384,14.666,-8,28,36
211,BER,P008211,P008780,11.383,-14,17,31
211,BER,P008211,P010791,14.666,-8,28,36
211,BER,P008384,P008780,14.85,-18,23,41
211,BER,P008384,P008967,3.833,-2,9,11
211,BER,P008384,P010791,16.583,-9,32,41
211,BER,P008384,P011934,3.833,-2,9,11
211,BER,P008384,P012721,7.683,3,22,19
211,BER,P008780,P008967,2.0,-3,2,5
211,BER,P008780,P010791,12.85,-15,21,36
211,BER,P008780,P011934,2.0,-3,2,5
211,BER,P008780,P012721,2.0,-3,2,5
211,BER,P008967,P011934,12.883,-16,20,36
211,BER,P008967,P012720,9.05,-14,11,25
211,BER,P008967,P012721,12.883,-16,20,36
211,BER,P011934,P012720,15.733,-8,33,41
211,BER,P011934,P012721,16.833,-6,35,41
211,BER,P012720,P012721,13.0,-4,26,30
211,OLY,P001255,P006589,10.133,-6,25,31
211,OLY,P001255,P007853,7.0,-1,20,21
211,OLY,P001255,P007982,15.034,3,41,38
211,OLY,P001255,P008829,3.7,0,11,11
211,OLY,P001255,P008855,6.033,17,25,8
211,OLY,P001255,P010392,14.3,-3,36,39
211,OLY,P001255,P010612,16.3,10,44,34
211,OLY,P001255,P011965,6.917,-13,11,24
211,OLY,P001255,P011983,6.166,17,25,8
211,OLY,P001255,P012878,15.017,16,46,30
211,OLY,P006589,P007853,7.0,-1,20,21
211,OLY,P006589,P007982,11.617,0,28,28
211,OLY,P006589,P008829,7.15,-7,13,20
211,OLY,P006589,P010392,8.15,-5,21,26
211,OLY,P006589,P010612,8.967,-7,12,19
211,OLY,P006589,P011965,4.083,-10,5,15
211,OLY,P006589,P011983,5.7,-4,8,12
211,OLY,P007853,P007982,6.05,4,20,16
211,OLY,P007853,P010392,5.15,0,16,16
211,OLY,P007853,P010612,1.85,-1,4,5
211,OLY,P007853,P011965,0.95,-5,0,5
211,OLY,P007982,P008829,9.684,0,21,21
211,OLY,P007982,P010392,10.35,7,31,24
211,OLY,P007982,P010612,15.267,-6,32,38
211,OLY,P007982,P011965,3.851,-5,8,13
211,OLY,P007982,P011983,7.567,-3,15,18
211,OLY,P007982,P012878,10.984,0,28,28
211,OLY,P008829,P008855,7.283,7,15,8
211,OLY,P008829,P010392,1.583,-3,5,8
211,OLY,P008829,P010612,13.833,6,28,22
211,OLY,P008829,P011965,4.717,-2,13,15
211,OLY,P008829,P011983,14.85,4,30,26
211,OLY,P008829,P012878,11.4,11,28,17
211,OLY,P008855,P010612,13.316,24,40,16
211,OLY,P008855,P011983,13.316,24,40,16
211,OLY,P008855,P012878,13.316,24,40,16
211,OLY,P010392,P010612,7.567,0,15,15
211,OLY,P010392,P011965,3.95,-10,5,15
211,OLY,P010392,P012878,6.15,2,15,13
211,OLY,P010612,P011965,2.267,-8,0,8
211,OLY,P010612,P011983,19.999,23,53,30
211,OLY,P010612,P012878,21.166,23,60,37
211,OLY,P011965,P011983,1.15,-2,2,4
211,OLY,P011965,P012878,3.851,-5,8,13
211,OLY,P011983,P012878,15.316,25,47,22
212,MAD,P001392,P003108,8.183,-4,20,24
212,MAD,P001392,P004887,8.183,-4,20,24
212,MAD,P001392,P005928,7.25,-2,19,21
212,MAD,P001392,P006540,2.166,-3,5,8
212,MAD,P001392,P009005,6.017,-1,15,16
212,MAD,P001392,PCVM,0.933,-2,1,3
212,MAD,P003108,P003733,8.1,6,22,16
212,MAD,P003108,P004887,21.999,4,60,56
212,MAD,P003108,P005928,21.316,10,61,51
212,MAD,P003108,P006540,12.148,6,36,30
212,MAD,P003108,P009005,15.284,5,42,37
212,MAD,P003108,P009213,3.083,4,10,6
212,MAD,P003108,P010357,3.766,8,10,2
212,MAD,P003108,P010623,0.45,0,0,0
212,MAD,P003108,PBMT,4.699,7,15,8
212,MAD,P003108,PCVM,6.032,-2,16,18
212,MAD,P003733,P004887,8.1,6,22,16
212,MAD,P003733,P005928,8.1,6,22,16
212,MAD,P003733,P009005,8.1,6,22,16
212,MAD,P004887,P005928,21.616,10,61,51
212,MAD,P004887,P006540,11.515,2,35,33
212,MAD,P004887,P009005,14.817,6,41,35
212,MAD,P004887,P010357,5.916,6,17,11
212,MAD,P004887,PBMT,4.883,4,17,13
212,MAD,P004887,PCVM,5.499,-6,15,21
212,MAD,P005928,P006540,10.632,4,33,29
212,MAD,P005928,P009005,17.267,1,46,45
212,MAD,P005928,P009213,1.45,5,7,2
212,MAD,P005928,P010357,5.716,2,14,12
212,MAD,P005928,PBMT,4.116,3,13,10
212,MAD,P005928,PCVM,1.533,-3,4,7
212,MAD,P006540,P009005,8.067,-7,22,29
212,MAD,P006540,P009213,6.633,4,16,12
212,MAD,P006540,P010357,17.149,0,41,41
212,MAD,P006540,P010623,0.45,0,0,0
212,MAD,P006540,PBMT,18.432,1,48,47
212,MAD,P006540,PCVM,16.332,-7,40,47
212,MAD,P009005,P009213,0.767,1,3,2
212,MAD,P009005,P010357,6.55,-9,15,24
212,MAD,P009005,PBMT,6.9,-7,17,24
212,MAD,P009005,PCVM,4.967,-3,13,16
212,MAD,P009213,P010357,3.55,0,6,6
212,MAD,P009213,P010623,0.45,0,0,0
212,MAD,P009213,PBMT,5.866,3,13,10
212,MAD,P009213,PCVM,4.733,-1,9,10
212,MAD,P010357,PBMT,14.516,-5,34,39
212,MAD,P010357,PCVM,11.433,-2,27,29
212,MAD,P010623,PBMT,0.45,0,0,0
212,MAD,PBMT,PCVM,13.866,-2,35,37
212,TEL,P005145,P009622,6.3,-7,11,18
212,TEL,P005145,P009783,6.3,-7,11,18
212,TEL,P005145,P009863,6.3,-7,11,18
212,TEL,P005145,P011199,6.3,-7,11,18
212,TEL,P007990,P009622,1.8,3,5,2
212,TEL,P007990,P009783,2.15,1,5,4
212,TEL,P007990,P009863,3.283,0,6,6
212,TEL,P007990,P011193,4.733,-7,8,15
212,TEL,P007990,P011199,3.183,1,5,4
212,TEL,P007990,P011214,3.35,-5,8,13
212,TEL,P007990,P011219,5.083,-9,8,17
212,TEL,P007990,P011971,3.6,-6,7,13
212,TEL,P007990,P012744,0.35,-2,0,2
212,TEL,P009622,P009783,29.467,6,79,73
212,TEL,P009622,P009863,21.734,4,59,55
212,TEL,P009622,P011193,7.75,-5,19,24
212,TEL,P009622,P011199,20.3,3,52,49
212,TEL,P009622,P011214,4.651,-10,9,19
212,TEL,P009622,P011219,11.551,0,35,35
212,TEL,P009622,P011971,21.533,14,63,49
212,TEL,P009622,P012744,0.05,0,0,0
212,TEL,P009783,P009863,25.368,6,69,63
212,TEL,P009783,P011193,9.567,1,25,24
212,TEL,P009783,P011199,21.767,2,54,52
212,TEL,P009783,P011214,2.834,-6,5,11
212,TEL,P009783,P011219,13.718,4,41,37
212,TEL,P009783,P011971,22.233,19,67,48
212,TEL,P009783,P012744,0.4,-2,0,2
212,TEL,P009863,P011193,6.917,2,16,14
212,TEL,P009863,P011199,20.967,1,49,48
212,TEL,P009863,P011214,2.267,-2,6,8
212,TEL,P009863,P011219,11.101,3,32,29
212,TEL,P009863,P011971,16.617,17,52,35
212,TEL,P009863,P012744,0.05,0,0,0
212,TEL,P011193,P011199,3.233,-7,2,9
212,TEL,P011193,P011214,7.634,-11,17,28
212,TEL,P011193,P011219,15.734,-6,37,43
212,TEL,P011193,P011971,8.9,-7,24,31
212,TEL,P011199,P011219,3.467,-2,6,8
212,TEL,P011199,P011971,13.383,9,37,28
212,TEL,P011214,P011219,8.001,-15,17,32
212,TEL,P011214,P011971,3.267,-11,6,17
212,TEL,P011219,P011971,12.067,-1,36,37
212,TEL,P011219,P012744,0.35,-2,0,2
212,TEL,P011971,P012744,0.4,-2,0,2
213,MCO,P002581,P004197,15.983,7,31,24
213,MCO,P002581,P005985,17.6,6,33,27
213,MCO,P002581,P009754,0.25,0,0,0
213,MCO,P002581,P010588,17.6,6,33,27
213,MCO,P002581,P011212,6.65,4,13,9
213,MCO,P002581,P011226,10.95,2,20,18
213,MCO,P002581,P011231,1.367,-1,2,3
213,MCO,P004197,P005985,15.983,7,31,24
213,MCO,P004197,P010588,15.983,7,31,24
213,MCO,P004197,P011212,5.033,5,11,6
213,MCO,P004197,P011226,10.95,2,20,18
213,MCO,P005985,P009754,8.217,11,25,14
213,MCO,P005985,P010588,25.667,19,65,46
213,MCO,P005985,P011196,5.417,8,18,10
213,MCO,P005985,P011212,18.833,17,47,30
213,MCO,P005985,P011226,19.0,9,42,33
213,MCO,P005985,P011231,8.9,6,17,11
213,MCO,P005985,PLCZ,8.183,9,22,13
213,MCO,P009754,P010588,8.901,9,27,18
213,MCO,P009754,P011196,2.167,4,8,4
213,MCO,P009754,P011212,14.1,-1,27,28
213,MCO,P009754,P011226,10.217,-4,18,22
213,MCO,P009754,P011231,7.366,-6,8,14
213,MCO,P009754,PLCZ,13.85,-1,27,28
213,MCO,P010588,P011196,3.0,3,10,7
213,MCO,P010588,P011212,15.217,11,39,28
213,MCO,P010588,P011226,17.367,3,34,31
213,MCO,P010588,P011231,2.617,2,7,5
213,MCO,P010588,PLCZ,6.984,8,22,14
213,MCO,P011196,P011212,3.25,4,10,6
213,MCO,P011196,P011226,5.417,8,18,10
213,MCO,P011196,P011231,2.417,5,8,3
213,MCO,P011212,P011226,13.933,-5,24,29
213,MCO,P011212,P011231,14.283,0,25,25
213,MCO,P011212,PLCZ,16.233,1,32,31
213,MCO,P011226,P011231,10.433,-2,20,22
213,MCO,P011226,PLCZ,9.933,-9,12,21
213,MCO,P011231,PLCZ,9.749,-4,13,17
213,PAR,P003983,P004058,2.55,-4,0,4
213,PAR,P003983,P007400,17.15,5,41,36
213,PAR,P003983,P007673,3.7,-4,2,6
213,PAR,P003983,P008987,18.383,10,46,36
213,PAR,P003983,P009862,17.733,11,46,35
213,PAR,P003983,P011051,3.566,-5,3,8
213,PAR,P003983,P012096,5.933,-1,10,11
213,PAR,P003983,P012742,2.167,0,3,3
213,PAR,P003983,P012743,14.95,4,33,29
213,PAR,P004058,P007400,0.117,0,0,0
213,PAR,P004058,P007673,2.55,-4,0,4
213,PAR,P004058,P009862,0.117,0,0,0
213,PAR,P004058,P011051,2.433,-4,0,4
213,PAR,P004058,P012096,2.433,-4,0,4
213,PAR,P007400,P007673,0.434,0,0,0
213,PAR,P007400,P008987,34.9,-12,65,77
213,PAR,P007400,P009862,33.933,-11,65,76
213,PAR,P007400,P011051,2.85,-3,5,8
213,PAR,P007400,P012096,11.717,-16,17,33
213,PAR,P007400,P012742,19.834,-22,24,46
213,PAR,P007400,P012743,21.533,3,43,40
213,PAR,P007673,P008987,1.467,0,2,2
213,PAR,P007673,P009862,1.267,0,2,2
213,PAR,P007673,P011051,2.75,-4,0,4
213,PAR,P007673,P012096,3.583,-4,2,6
213,PAR,P007673,P012742,0.317,0,0,0
213,PAR,P008987,P009862,35.766,-8,70,78
213,PAR,P008987,P011051,2.25,-1,5,6
213,PAR,P008987,P012096,12.867,-16,19,35
213,PAR,P008987,P012742,20.034,-17,27,44
213,PAR,P008987,P012743,21.733,8,46,38
213,PAR,P009862,P011051,1.933,-1,5,6
213,PAR,P009862,P012096,12.867,-16,19,35
213,PAR,P009862,P012742,18.95,-16,27,43
213,PAR,P009862,P012743,20.966,9,46,37
213,PAR,P011051,P012096,2.433,-4,0,4
213,PAR,P011051,P012742,2.317,-4,2,6
213,PAR,P011051,P012743,0.6,-2,0,2
213,PAR,P012096,P012742,9.367,-19,9,28
213,PAR,P012742,P012743,9.55,2,16,14
214,BAR,P000925,P002939,15.15,9,34,25
214,BAR,P000925,P004866,19.8,13,43,30
214,BAR,P000925,P006435,18.8,16,43,27
214,BAR,P000925,P007519,4.65,4,9,5
214,BAR,P000925,P009992,1.0,-3,0,3
214,BAR,P000925,P011244,1.733,-1,2,3
214,BAR,P000925,P012745,18.067,14,41,27
214,BAR,P002939,P003196,12.75,5,26,21
214,BAR,P002939,P004866,20.933,17,49,32
214,BAR,P002939,P006435,14.15,12,34,22
214,BAR,P002939,P007464,4.05,-1,7,8
214,BAR,P002939,P007519,2.917,-2,4,6
214,BAR,P002939,P009992,13.75,2,26,24
214,BAR,P002939,P011244,9.133,-1,13,14
214,BAR,P002939,P012745,18.767,15,47,32
214,BAR,P003196,P004866,8.3,8,19,11
214,BAR,P003196,P007464,7.45,3,13,10
214,BAR,P003196,P007519,8.834,2,14,12
214,BAR,P003196,P009992,18.667,9,36,27
214,BAR,P003196,P011244,12.167,6,21,15
214,BAR,P003196,P012745,6.5,3,15,12
214,BAR,P003204,P006435,1.533,5,5,0
214,BAR,P003204,P007519,1.533,5,5,0
214,BAR,P003204,P010641,1.533,5,5,0
214,BAR,P003204,P012745,1.533,5,5,0
214,BAR,P004866,P006435,18.8,16,43,27
214,BAR,P004866,P007519,7.167,4,13,9
214,BAR,P004866,P009992,9.3,5,19,14
214,BAR,P004866,P011244,6.583,3,13,10
214,BAR,P004866,P012745,21.517,18,49,31
214,BAR,P006435,P007519,6.183,9,14,5
214,BAR,P006435,P010641,1.533,5,5,0
214,BAR,P006435,P011244,0.733,2,2,0
214,BAR,P006435,P012745,19.6,19,46,27
214,BAR,P007464,P007519,3.4,4,6,2
214,BAR,P007464,P009992,7.45,3,13,10
214,BAR,P007464,P011244,4.4,4,6,2
214,BAR,P007464,P012745,3.05,-1,7,8
214,BAR,P007519,P009992,8.834,2,14,12
214,BAR,P007519,P010641,1.533,5,5,0
214,BAR,P007519,P011244,7.684,4,14,10
214,BAR,P007519,P012745,7.333,7,14,7
214,BAR,P009992,P011244,13.167,3,21,18
214,BAR,P009992,P012745,6.5,3,15,12
214,BAR,P010641,P012745,1.533,5,5,0
214,VIR,P001844,P002084,6.217,-1,10,11
214,VIR,P001844,P003048,17.85,-14,26,40
214,VIR,P001844,P003527,14.315,-15,15,30
214,VIR,P001844,P004554,7.033,-3,10,13
214,VIR,P001844,P005553,1.533,-5,0,5
214,VIR,P001844,P008847,18.966,-15,26,41
214,VIR,P001844,P009549,19.199,-9,26,35
214,VIR,P001844,P010781,14.083,-21,16,37
214,VIR,P001844,PBCN,17.8,-5,31,36
214,VIR,P002084,P003048,0.7,-2,0,2
214,VIR,P002084,P003527,1.1,2,2,0
214,VIR,P002084,P004007,4.634,-1,10,11
214,VIR,P002084,P004554,12.951,-3,21,24
214,VIR,P002084,P006739,8.868,-1,14,15
214,VIR,P002084,P008847,3.317,-1,6,7
214,VIR,P002084,P009549,8.584,-6,11,17
214,VIR,P002084,P010781,14.801,-8,23,31
214,VIR,P002084,PBCN,6.7,-3,11,14
214,VIR,P003048,P003527,7.333,-8,9,17
214,VIR,P003048,P008847,14.6,-10,22,32
214,VIR,P003048,P009549,11.65,0,20,20
214,VIR,P003048,P010781,6.9,-16,6,22
214,VIR,P003048,PBCN,12.367,-6,21,27
214,VIR,P003527,P004554,2.616,-2,2,4
214,VIR,P003527,P005553,1.533,-5,0,5
214,VIR,P003527,P008847,9.149,-11,9,20
214,VIR,P003527,P009549,13.732,-11,15,26
214,VIR,P003527,P010781,3.349,-8,2,10
214,VIR,P003527,PBCN,4.133,-2,6,8
214,VIR,P004007,P004554,3.567,-1,8,9
214,VIR,P004007,P006739,4.634,-1,10,11
214,VIR,P004007,P008847,1.067,0,2,2
214,VIR,P004007,P009549,1.067,0,2,2
214,VIR,P004007,P010781,3.567,-1,8,9
214,VIR,P004554,P006739,7.801,-1,12,13
214,VIR,P004554,P009549,7.183,-5,7,12
214,VIR,P004554,P010781,13.984,-5,21,26
214,VIR,P004554,PBCN,7.133,0,11,11
214,VIR,P005553,P008847,1.533,-5,0,5
214,VIR,P005553,P009549,1.533,-5,0,5
214,VIR,P006739,P008847,1.067,0,2,2
214,VIR,P006739,P009549,4.334,0,6,6
214,VIR,P006739,P010781,7.801,-1,12,13
214,VIR,P006739,PBCN,0.967,0,0,0
214,VIR,P008847,P009549,15.566,-8,24,32
214,VIR,P008847,P010781,8.5,-15,10,25
214,VIR,P008847,PBCN,10.967,-7,19,26
214,VIR,P009549,P010781,9.183,-12,9,21
214,VIR,P009549,PBCN,9.633,4,20,16
214,VIR,P010781,PBCN,12.9,-17,17,34
215,MIL,P000796,P002812,6.717,0,6,6
215,MIL,P000796,P005670,4.1,-2,2,4
215,MIL,P000796,P007032,5.433,-4,11,15
215,MIL,P000796,P007201,9.3,-4,15,19
215,MIL,P000796,P007831,4.617,-4,6,10
215,MIL,P000796,P009960,3.25,-4,4,8
215,MIL,P000796,P011205,9.7,-4,19,23
215,MIL,P000796,P011224,5.634,0,10,10
215,MIL,P000796,P012800,11.917,-2,19,21
215,MIL,P002812,P002849,5.767,-2,14,16
215,MIL,P002812,P005670,5.9,0,6,6
215,MIL,P002812,P007032,5.95,0,14,14
215,MIL,P002812,P007201,7.9,-3,7,10
215,MIL,P002812,P007831,7.75,-7,10,17
215,MIL,P002812,P011205,5.551,-5,5,10
215,MIL,P002812,P011224,8.784,-1,19,20
215,MIL,P002812,P012800,10.817,6,19,13
215,MIL,P002849,P005670,1.733,-3,2,5
215,MIL,P002849,P007032,5.283,0,14,14
215,MIL,P002849,P007201,2.899,-4,3,7
215,MIL,P002849,P007831,18.299,-14,23,37
215,MIL,P002849,P009960,11.45,-4,15,19
215,MIL,P002849,P011205,11.417,-5,16,21
215,MIL,P002849,P011224,20.116,-10,32,42
215,MIL,P002849,P012800,3.5,2,9,7
215,MIL,P005670,P007201,7.633,-3,8,11
215,MIL,P005670,P007831,3.533,-1,6,7
215,MIL,P005670,P011224,1.733,-3,2,5
215,MIL,P005670,P012800,5.9,0,6,6
215,MIL,P007032,P007201,3.833,-2,11,13
215,MIL,P007032,P007831,3.466,-4,5,9
215,MIL,P007032,P009960,0.933,-2,0,2
215,MIL,P007032,P011205,5.433,-4,11,15
215,MIL,P007032,P011224,5.283,0,14,14
215,MIL,P007032,P012800,7.25,0,20,20
215,MIL,P007201,P007831,8.983,-5,12,17
215,MIL,P007201,P009960,0.917,0,2,2
215,MIL,P007201,P011205,6.85,-4,15,19
215,MIL,P007201,P011224,7.183,-7,8,15
215,MIL,P007201,P012800,12.166,-4,19,23
215,MIL,P007831,P009960,15.617,-8,21,29
215,MIL,P007831,P011205,17.101,-12,23,35
215,MIL,P007831,P011224,25.833,-21,32,53
215,MIL,P007831,P012800,5.333,0,6,6
215,MIL,P009960,P011205,13.584,-6,21,27
215,MIL,P009960,P011224,15.617,-8,21,29
215,MIL,P009960,P012800,1.1,0,0,0
215,MIL,P011205,P011224,18.118,-8,27,35
215,MIL,P011205,P012800,6.45,0,15,15
215,MIL,P011224,P012800,6.367,6,15,9
215,PAN,P002328,P003842,20.35,11,42,31
215,PAN,P002328,P007866,16.333,4,28,24
215,PAN,P002328,P007947,3.9,4,10,6
215,PAN,P002328,P011204,27.55,11,49,38
215,PAN,P002328,P011209,10.5,8,21,13
215,PAN,P002328,P011221,11.583,4,19,15
215,PAN,P002328,P012712,15.6,11,33,22
215,PAN,P002328,P012774,21.916,7,42,35
215,PAN,P003842,P007866,7.1,-1,12,13
215,PAN,P003842,P007947,7.367,8,19,11
215,PAN,P003842,P011204,15.967,7,30,23
215,PAN,P003842,P011209,7.817,9,21,12
215,PAN,P003842,P012712,16.717,16,39,23
215,PAN,P003842,P012774,19.95,10,41,31
215,PAN,P006544,P007947,1.817,-4,5,9
215,PAN,P006544,P011209,1.817,-4,5,9
215,PAN,P006544,P011221,1.817,-4,5,9
215,PAN,P006544,P012712,1.817,-4,5,9
215,PAN,P007866,P011204,19.116,6,32,26
215,PAN,P007866,P011209,10.6,7,19,12
215,PAN,P007866,P011221,12.016,7,20,13
215,PAN,P007866,P012712,0.833,0,0,0
215,PAN,P007866,P012774,10.466,1,17,16
215,PAN,P007947,P011209,5.284,0,14,14
215,PAN,P007947,P011221,1.817,-4,5,9
215,PAN,P007947,P012712,9.184,4,24,20
215,PAN,P007947,P012774,7.367,8,19,11
215,PAN,P011204,P011209,12.55,10,23,13
215,PAN,P011204,P011221,14.366,6,23,17
215,PAN,P011204,P012712,12.05,7,21,14
215,PAN,P011204,P012774,19.733,5,34,29
215,PAN,P011209,P011221,10.5,1,18,17
215,PAN,P011209,P012712,8.3,3,20,17
215,PAN,P011209,P012774,5.9,6,15,9
215,PAN,P011221,P012712,5.0,-5,8,13
215,PAN,P011221,P012774,7.633,3,14,11
215,PAN,P012712,P012774,17.367,12,38,26
216,IST,P004888,P006590,16.733,9,44,35
216,IST,P004888,P007200,22.015,-30,25,55
216,IST,P004888,P009664,23.749,-5,52,57
216,IST,P004888,P009846,8.449,-10,8,18
216,IST,P004888,P010516,4.266,-5,3,8
216,IST,P004888,P011078,23.999,-8,46,54
216,IST,P004888,P011981,15.665,6,36,30
216,IST,P004888,P012710,3.083,-6,0,6
216,IST,P004888,P012788,4.833,-8,3,11
216,IST,P004888,PLHK,20.532,-15,35,50
216,IST,P006590,P007200,12.017,-13,19,32
216,IST,P006590,P009664,13.75,9,39,30
216,IST,P006590,P009846,5.434,-11,7,18
216,IST,P006590,P011078,8.883,14,32,18
216,IST,P006590,P011981,11.65,3,30,27
216,IST,P006590,P012788,4.167,-8,7,15
216,IST,P006590,PLHK,10.966,1,26,25
216,IST,P007200,P009664,13.516,-20,17,37
216,IST,P007200,P009846,11.266,-19,12,31
216,IST,P007200,P010516,0.683,-2,0,2
216,IST,P007200,P011078,10.183,-20,8,28
216,IST,P007200,P011981,13.482,-17,19,36
216,IST,P007200,P012788,9.0,-16,10,26
216,IST,P007200,PLHK,12.566,-15,18,33
216,IST,P009664,P009846,3.533,-2,5,7
216,IST,P009664,P011078,17.966,0,43,43
216,IST,P009664,P011981,9.116,8,25,17
216,IST,P009664,PLHK,13.366,-10,27,37
216,IST,P009846,P010516,0.083,0,0,0
216,IST,P009846,P011078,3.8,-4,3,7
216,IST,P009846,P011981,8.516,-12,13,25
216,IST,P009846,P012788,9.0,-16,10,26
216,IST,P009846,PLHK,0.383,2,2,0
216,IST,P010516,P011078,3.583,-3,3,6
216,IST,P010516,P011981,1.183,1,3,2
216,IST,P010516,P012710,3.083,-6,0,6
216,IST,P010516,PLHK,4.183,-5,3,8
216,IST,P011078,P011981,9.083,13,28,15
216,IST,P011078,P012710,3.083,-6,0,6
216,IST,P011078,P012788,2.45,-5,0,5
216,IST,P011078,PLHK,12.966,-13,21,34
216,IST,P011981,P012788,6.55,-11,10,21
216,IST,P011981,PLHK,4.083,1,8,7
216,IST,P012710,PLHK,3.083,-6,0,6
216,ZAL,P002329,P002676,5.183,7,11,4
216,ZAL,P002329,P003211,8.117,-1,20,21
216,ZAL,P002329,P005504,19.1,17,48,31
216,ZAL,P002329,P007109,6.601,6,14,8
216,ZAL,P002329,P007513,16.283,18,38,20
216,ZAL,P002329,P010390,1.45,3,3,0
216,ZAL,P002329,P011218,16.517,23,44,21
216,ZAL,P002329,P012715,8.766,7,26,19
216,ZAL,P002329,P012787,0.183,0,0,0
216,ZAL,P002676,P003210,1.933,1,8,7
216,ZAL,P002676,P003211,16.117,7,38,31
216,ZAL,P002676,P005504,9.683,9,22,13
216,ZAL,P002676,P006860,2.2,2,2,0
216,ZAL,P002676,P007109,9.3,11,27,16
216,ZAL,P002676,P007513,12.466,9,27,18
216,ZAL,P002676,P010390,14.867,6,34,28
216,ZAL,P002676,P011218,5.183,7,11,4
216,ZAL,P002676,P012715,8.033,-9,16,25
216,ZAL,P002676,P012787,13.567,2,28,26
216,ZAL,P003210,P003211,1.85,3,8,5
216,ZAL,P003210,P007109,1.933,1,8,7
216,ZAL,P003210,P010390,1.85,3,8,5
216,ZAL,P003210,P012715,0.083,-2,0,2
216,ZAL,P003210,P012787,0.083,-2,0,2
216,ZAL,P003211,P005504,7.917,-3,21,24
216,ZAL,P003211,P006860,2.2,2,2,0
216,ZAL,P003211,P007109,12.501,19,37,18
216,ZAL,P003211,P007513,7.883,-2,16,18
216,ZAL,P003211,P010390,16.317,9,37,28
216,ZAL,P003211,P011218,4.267,2,13,11
216,ZAL,P003211,P012715,9.533,-15,19,34
216,ZAL,P003211,P012787,10.234,3,21,18
216,ZAL,P005504,P007109,6.818,5,15,10
216,ZAL,P005504,P007513,19.333,17,46,29
216,ZAL,P005504,P011218,16.517,23,44,21
216,ZAL,P005504,P012715,11.599,7,33,26
216,ZAL,P005504,P012787,3.433,1,7,6
216,ZAL,P006860,P010390,2.2,2,2,0
216,ZAL,P006860,P012787,2.2,2,2,0
216,ZAL,P007109,P007513,9.534,6,18,12
216,ZAL,P007109,P010390,9.0,14,26,12
216,ZAL,P007109,P011218,3.584,2,7,5
216,ZAL,P007109,P012715,0.083,-2,0,2
216,ZAL,P007109,P012787,4.25,6,12,6
216,ZAL,P007513,P010390,4.233,3,8,5
216,ZAL,P007513,P011218,12.25,21,31,10
216,ZAL,P007513,P012715,8.849,7,25,18
216,ZAL,P007513,P012787,3.433,1,7,6
216,ZAL,P010390,P012715,5.117,-7,9,16
216,ZAL,P010390,P012787,10.234,3,21,18
216,ZAL,P011218,P012715,7.75,14,26,12
216,ZAL,P012715,P012787,7.383,-8,14,22
217,BER,P006251,P007025,3.066,1,6,5
217,BER,P006251,P008173,8.65,-4,14,18
217,BER,P006251,P008211,7.183,-1,10,11
217,BER,P006251,P008384,11.901,-15,12,27
217,BER,P006251,P008780,14.967,-16,15,31
217,BER,P006251,P008967,15.001,-16,19,35
217,BER,P006251,P010791,5.316,-2,8,10
217,BER,P006251,P011934,12.45,-15,13,28
217,BER,P006251,P012720,10.083,-9,11,20
217,BER,P006251,P012721,5.851,-3,8,11
217,BER,P006819,P007025,1.6,5,5,0
217,BER,P006819,P008173,1.6,5,5,0
217,BER,P006819,P008211,1.6,5,5,0
217,BER,P006819,P012721,1.6,5,5,0
217,BER,P007025,P008173,11.266,11,29,18
217,BER,P007025,P008211,6.316,11,19,8
217,BER,P007025,P008384,4.0,3,10,7
217,BER,P007025,P008780,1.433,-3,0,3
217,BER,P007025,P010791,8.716,9,24,15
217,BER,P007025,P011934,2.383,-6,0,6
217,BER,P007025,P012720,2.383,-6,0,6
217,BER,P007025,P012721,9.633,7,23,16
217,BER,P008173,P008211,11.866,6,23,17
217,BER,P008173,P008384,13.15,-3,24,27
217,BER,P008173,P008967,3.6,-1,10,11
217,BER,P008173,P010791,14.532,5,32,27
217,BER,P008173,P011934,0.95,-3,0,3
217,BER,P008173,P012720,0.95,-3,0,3
217,BER,P008173,P012721,15.1,7,35,28
217,BER,P008211,P008384,5.55,-5,4,9
217,BER,P008211,P010791,8.399,0,16,16
217,BER,P008211,P012721,6.55,8,15,7
217,BER,P008384,P008780,5.351,-6,5,11
217,BER,P008384,P008967,8.951,-7,15,22
217,BER,P008384,P010791,9.816,-1,18,19
217,BER,P008384,P011934,2.834,-5,3,8
217,BER,P008384,P012721,12.451,3,25,22
217,BER,P008780,P008967,18.151,-17,23,40
217,BER,P008780,P011934,17.067,-19,21,40
217,BER,P008780,P012720,14.233,-14,18,32
217,BER,P008780,P012721,7.134,-5,10,15
217,BER,P008967,P010791,2.133,2,6,4
217,BER,P008967,P011934,15.634,-16,21,37
217,BER,P008967,P012720,12.8,-11,18,29
217,BER,P008967,P012721,10.734,-6,20,26
217,BER,P010791,P012721,9.216,7,24,17
217,BER,P011934,P012720,15.183,-17,18,35
217,BER,P011934,P012721,5.567,-7,8,15
217,BER,P012720,P012721,5.1,-8,7,15
217,PAM,P003960,P004863,12.101,4,22,18
217,PAM,P003960,P005356,15.318,2,30,28
217,PAM,P003960,P006433,9.134,1,13,12
217,PAM,P003960,P010393,2.334,2,3,1
217,PAM,P003960,P010568,5.534,1,11,10
217,PAM,P003960,P011970,7.217,0,13,13
217,PAM,P003960,P011982,1.367,1,3,2
217,PAM,P003960,P012738,14.684,1,27,26
217,PAM,P003960,P012740,3.267,4,7,3
217,PAM,P003960,P012795,2.584,0,3,3
217,PAM,P004863,P005356,11.634,4,22,18
217,PAM,P004863,P006433,9.183,4,15,11
217,PAM,P004863,P010393,1.9,3,3,0
217,PAM,P004863,P010568,0.467,0,0,0
217,PAM,P004863,P011970,2.85,4,6,2
217,PAM,P004863,P011982,2.8,4,6,2
217,PAM,P004863,P012738,10.267,3,19,16
217,PAM,P004863,P012740,0.667,2,4,2
217,PAM,P004863,P012795,2.267,0,3,3
217,PAM,P005356,P006433,11.784,0,21,21
217,PAM,P005356,P010393,3.5,-2,8,10
217,PAM,P005356,P010568,4.367,-2,11,13
217,PAM,P005356,P011970,9.867,-1,21,22
217,PAM,P005356,P011982,2.417,1,6,5
217,PAM,P005356,P012738,18.501,-1,38,39
217,PAM,P005356,P012740,1.717,2,7,5
217,PAM,P005356,P012795,0.367,-3,0,3
217,PAM,P006433,P010393,7.766,-7,13,20
217,PAM,P006433,P010568,1.4,-2,3,5
217,PAM,P006433,P011970,5.467,-7,8,15
217,PAM,P006433,P011982,4.033,1,8,7
217,PAM,P006433,P012738,10.934,-3,18,21
217,PAM,P006433,P012740,1.6,-5,0,5
217,PAM,P006433,P012795,2.899,-2,5,7
217,PAM,P010393,P010568,16.367,17,37,20
217,PAM,P010393,P011970,5.1,-7,8,15
217,PAM,P010393,P011982,16.316,17,37,20
217,PAM,P010393,P012738,4.017,-4,8,12
217,PAM,P010393,P012740,16.267,15,35,20
217,PAM,P010393,P012795,18.033,18,40,22
217,PAM,P010568,P011970,3.15,-3,7,10
217,PAM,P010568,P011982,15.933,14,37,23
217,PAM,P010568,P012738,5.1,-2,11,13
217,PAM,P010568,P012740,16.45,20,38,18
217,PAM,P010568,P012795,17.1,17,37,20
217,PAM,P011970,P012738,10.384,-3,21,24
217,PAM,P011970,P012740,1.6,-5,0,5
217,PAM,P011970,P012795,0.233,-2,0,2
217,PAM,P011982,P012738,1.05,0,3,3
217,PAM,P011982,P012740,14.7,17,35,18
217,PAM,P011982,P012795,16.316,17,37,20
217,PAM,P012738,P012740,2.967,0,7,7
217,PAM,P012738,P012795,1.1,-3,0,3
217,PAM,P012740,P012795,15.633,18,35,17
218,MUN,P001288,P001557,14.867,7,26,19
218,MUN,P001288,P003583,20.884,14,47,33
218,MUN,P001288,P004508,3.134,4,9,5
218,MUN,P001288,P005460,0.417,0,0,0
218,MUN,P001288,P006543,9.334,3,21,18
218,MUN,P001288,P007639,3.517,-5,3,8
218,MUN,P001288,P007975,11.251,2,26,24
218,MUN,P001288,P008985,12.834,2,19,17
218,MUN,P001288,P010391,9.183,8,26,18
218,MUN,P001288,P011987,13.851,1,23,22
218,MUN,P001557,P003583,15.217,8,26,18
218,MUN,P001557,P007639,2.484,-3,3,6
218,MUN,P001557,P007975,1.617,0,2,2
218,MUN,P001557,P008985,15.351,0,22,22
218,MUN,P001557,P010391,7.167,5,16,11
218,MUN,P001557,P011987,14.101,3,21,18
218,MUN,P003583,P004508,2.417,0,6,6
218,MUN,P003583,P006543,6.617,4,18,14
218,MUN,P003583,P006760,2.334,-4,0,4
218,MUN,P003583,P007975,9.451,1,23,22
218,MUN,P003583,P008985,14.601,1,19,18
218,MUN,P003583,P010391,13.084,1,26,25
218,MUN,P003583,P011987,14.535,3,23,20
218,MUN,P004508,P005460,8.95,-2,19,21
218,MUN,P004508,P006543,4.984,4,10,6
218,MUN,P004508,P006760,10.433,-9,19,28
218,MUN,P004508,P007639,2.2,-3,3,6
218,MUN,P004508,P007975,10.984,-2,22,24
218,MUN,P004508,P008985,2.583,-3,6,9
218,MUN,P004508,P010391,7.966,-8,15,23
218,MUN,P004508,P011987,0.617,-1,3,4
218,MUN,P005460,P006543,2.884,-1,4,5
218,MUN,P005460,P006760,8.533,-2,19,21
218,MUN,P005460,P007975,6.367,1,13,12
218,MUN,P005460,P008985,2.583,-3,6,9
218,MUN,P005460,P010391,6.066,-1,15,16
218,MUN,P006543,P006760,2.467,-1,4,5
218,MUN,P006543,P007639,2.3,-1,3,4
218,MUN,P006543,P007975,11.484,2,25,23
218,MUN,P006543,P008985,0.317,0,0,0
218,MUN,P006543,P010391,4.85,1,13,12
218,MUN,P006543,P011987,1.967,-3,2,5
218,MUN,P006760,P007639,1.483,-5,0,5
218,MUN,P006760,P007975,8.35,-6,13,19
218,MUN,P006760,P008985,4.0,-5,6,11
218,MUN,P006760,P010391,9.883,-10,15,25
218,MUN,P006760,P011987,1.917,-2,0,2
218,MUN,P007639,P007975,3.783,-6,3,9
218,MUN,P007639,P008985,2.484,-3,3,6
218,MUN,P007639,P010391,2.75,-4,3,7
218,MUN,P007639,P011987,4.067,-6,3,9
218,MUN,P007975,P010391,12.35,-4,24,28
218,MUN,P007975,P011987,2.767,-4,5,9
218,MUN,P008985,P010391,8.817,-5,15,20
218,MUN,P008985,P011987,15.102,-4,16,20
218,MUN,P010391,P011987,5.484,1,8,7
218,OLY,P001255,P006589,4.3,-4,8,12
218,OLY,P001255,P007853,16.566,-6,32,38
218,OLY,P001255,P007982,9.917,-3,22,25
218,OLY,P001255,P008855,8.334,0,15,15
218,OLY,P001255,P010392,19.483,-6,39,45
218,OLY,P001255,P011194,15.7,-2,31,33
218,OLY,P001255,P011965,5.7,-3,9,12
218,OLY,P006589,P007853,2.833,-3,7,10
218,OLY,P006589,P007982,4.3,-4,8,12
218,OLY,P006589,P008855,1.467,-1,1,2
218,OLY,P006589,P010392,4.3,-4,8,12
218,OLY,P007853,P007982,6.483,-3,15,18
218,OLY,P007853,P008855,4.9,0,8,8
218,OLY,P007853,P010392,16.049,-6,32,38
218,OLY,P007853,P011194,13.733,-3,25,28
218,OLY,P007853,P011965,5.7,-3,9,12
218,OLY,P007982,P008829,6.75,13,22,9
218,OLY,P007982,P008855,10.701,13,29,16
218,OLY,P007982,P010392,9.4,-3,22,25
218,OLY,P007982,P011194,8.867,8,25,17
218,OLY,P007982,P011983,6.75,13,22,9
218,OLY,P007982,P012878,3.5,6,11,5
218,OLY,P008829,P008855,20.0,10,37,27
218,OLY,P008829,P010612,13.25,-3,15,18
218,OLY,P008829,P011194,3.25,7,11,4
218,OLY,P008829,P011983,20.0,10,37,27
218,OLY,P008829,P012878,16.75,3,26,23
218,OLY,P008855,P010392,7.817,0,15,15
218,OLY,P008855,P010612,13.25,-3,15,18
218,OLY,P008855,P011194,10.117,8,25,17
218,OLY,P008855,P011983,20.0,10,37,27
218,OLY,P008855,P012878,16.75,3,26,23
218,OLY,P010392,P011194,15.183,-2,31,33
218,OLY,P010392,P011965,5.7,-3,9,12
218,OLY,P010612,P011983,13.25,-3,15,18
218,OLY,P010612,P012878,13.25,-3,15,18
218,OLY,P011194,P011965,5.7,-3,9,12
218,OLY,P011194,P011983,3.25,7,11,4
218,OLY,P011983,P012878,16.75,3,26,23
219,ASV,P000229,P003526,15.6,-10,30,40
219,ASV,P000229,P005094,25.366,-4,50,54
219,ASV,P000229,P006568,15.2,-18,22,40
219,ASV,P000229,P011225,23.949,3,52,49
219,ASV,P000229,P011386,5.683,-8,4,12
219,ASV,P000229,P012729,16.416,11,38,27
219,ASV,P000229,P012731,17.866,1,34,33
219,ASV,P000229,PKIR,6.116,-3,10,13
219,ASV,P003526,P005094,17.55,-14,34,48
219,ASV,P003526,P006568,11.617,-11,19,30
219,ASV,P003526,P011225,21.983,-8,45,53
219,ASV,P003526,P011386,0.15,0,0,0
219,ASV,P003526,P012729,12.433,1,30,29
219,ASV,P003526,P012731,10.367,-2,23,25
219,ASV,P003526,PKIR,6.5,4,15,11
219,ASV,P005094,P006568,15.133,-18,22,40
219,ASV,P005094,P011225,23.049,1,51,50
219,ASV,P005094,P011386,3.083,-7,1,8
219,ASV,P005094,P012729,12.916,10,34,24
219,ASV,P005094,P012731,15.099,0,32,32
219,ASV,P006568,P011225,10.967,-7,19,26
219,ASV,P006568,P011386,2.733,-7,1,8
219,ASV,P006568,P012729,0.067,0,0,0
219,ASV,P006568,P012731,5.083,-11,5,16
219,ASV,P011225,P012729,21.499,10,52,42
219,ASV,P011225,P012731,18.866,11,45,34
219,ASV,P011225,PKIR,9.283,2,20,18
219,ASV,P011386,P012729,2.95,-1,3,4
219,ASV,P011386,P012731,5.533,-8,4,12
219,ASV,P011386,PKIR,2.6,-1,3,4
219,ASV,P012729,P012731,21.3,12,48,36
219,ASV,P012729,PKIR,11.883,1,23,22
219,ASV,P012731,PKIR,11.15,1,21,20
219,MAD,P001392,P003108,5.451,1,10,9
219,MAD,P001392,P004887,4.534,1,10,9
219,MAD,P001392,P005928,1.117,-3,2,5
219,MAD,P001392,P009005,4.534,1,10,9
219,MAD,P001392,P009213,1.367,3,5,2
219,MAD,P001392,P010357,2.284,3,5,2
219,MAD,P001392,PBMT,2.284,3,5,2
219,MAD,P001392,PCVM,5.701,7,13,6
219,MAD,P003108,P003733,12.233,5,24,19
219,MAD,P003108,P004887,16.767,6,34,28
219,MAD,P003108,P005928,13.35,2,26,24
219,MAD,P003108,P006540,6.583,-6,14,20
219,MAD,P003108,P009005,16.767,6,34,28
219,MAD,P003108,P010357,7.5,-6,14,20
219,MAD,P003108,PBMT,7.5,-6,14,20
219,MAD,P003108,PCVM,10.917,-2,22,24
219,MAD,P003733,P004887,14.15,5,27,22
219,MAD,P003733,P005928,12.233,5,24,19
219,MAD,P003733,P006540,5.017,3,12,9
219,MAD,P003733,P009005,17.25,8,36,28
219,MAD,P003733,P010357,3.1,3,9,6
219,MAD,P003733,PCVM,5.017,3,12,9
219,MAD,P004887,P005928,13.35,2,26,24
219,MAD,P004887,P006540,6.084,8,15,7
219,MAD,P004887,P009005,18.684,6,37,31
219,MAD,P004887,P010357,4.167,8,12,4
219,MAD,P004887,P010623,4.167,8,12,4
219,MAD,P004887,PBMT,4.167,8,12,4
219,MAD,P004887,PCVM,5.334,4,11,7
219,MAD,P005928,P006540,0.933,-2,2,4
219,MAD,P005928,P009005,13.35,2,26,24
219,MAD,P005928,P009213,0.933,-2,2,4
219,MAD,P005928,P010357,0.933,-2,2,4
219,MAD,P005928,PBMT,0.933,-2,2,4
219,MAD,P006540,P009005,6.5,3,17,14
219,MAD,P006540,P009213,3.7,-7,4,11
219,MAD,P006540,P010357,19.033,-2,44,46
219,MAD,P006540,P010623,4.584,6,12,6
219,MAD,P006540,PBMT,15.933,-5,35,40
219,MAD,P006540,PCVM,15.433,-6,33,39
219,MAD,P009005,P010357,4.583,3,14,11
219,MAD,P009005,PBMT,1.483,0,5,5
219,MAD,P009005,PCVM,9.917,7,25,18
219,MAD,P009213,P010357,5.067,-4,9,13
219,MAD,P009213,P010623,0.417,-2,0,2
219,MAD,P009213,PBMT,5.067,-4,9,13
219,MAD,P009213,PCVM,3.717,0,7,7
219,MAD,P010357,P010623,4.584,6,12,6
219,MAD,P010357,PBMT,18.217,-2,40,42
219,MAD,P010357,PCVM,15.8,-3,35,38
219,MAD,P010623,PBMT,4.584,6,12,6
219,MAD,PBMT,PCVM,12.7,-6,26,32
220,BAS,P003198,P004603,2.283,-7,2,9
220,BAS,P003198,P004761,1.183,-4,2,6
220,BAS,P003198,P007946,0.867,0,2,2
220,BAS,P003198,P008850,2.283,-7,2,9
220,BAS,P003198,P009048,4.15,-9,6,15
220,BAS,P003198,P011948,3.967,-7,6,13
220,BAS,P003198,P012201,1.867,-2,4,6
220,BAS,P004603,P004761,28.401,15,63,48
220,BAS,P004603,P007946,9.433,11,29,18
220,BAS,P004603,P008850,3.15,-7,6,13
220,BAS,P004603,P009048,28.817,1,60,59
220,BAS,P004603,P011085,22.234,11,50,39
220,BAS,P004603,P011948,20.185,17,52,35
220,BAS,P004603,P012201,33.301,23,82,59
220,BAS,P004761,P007946,4.8,8,13,5
220,BAS,P004761,P008850,1.05,-2,4,6
220,BAS,P004761,P009048,21.267,-2,39,41
220,BAS,P004761,P011085,19.884,14,45,31
220,BAS,P004761,P011948,13.168,8,31,23
220,BAS,P004761,P012201,27.851,15,63,48
220,BAS,P007946,P008850,1.166,-4,2,6
220,BAS,P007946,P009048,6.683,-1,20,21
220,BAS,P007946,P011085,4.733,-1,10,11
220,BAS,P007946,P011948,6.767,8,23,15
220,BAS,P007946,P012201,11.483,7,33,26
220,BAS,P008850,P009048,3.449,-11,4,15
220,BAS,P008850,P011085,0.083,-2,0,2
220,BAS,P008850,P011948,4.05,-7,8,15
220,BAS,P008850,P012201,2.033,-4,6,10
220,BAS,P009048,P011085,15.767,-5,31,36
220,BAS,P009048,P011948,19.118,5,42,37
220,BAS,P009048,P012201,28.217,2,62,60
220,BAS,P011085,P011948,5.668,10,16,6
220,BAS,P011085,P012201,20.967,9,48,39
220,BAS,P011948,P012201,19.685,18,54,36
220,TEL,P005145,P009622,4.367,3,11,8
220,TEL,P005145,P009783,4.367,3,11,8
220,TEL,P005145,P009863,4.367,3,11,8
220,TEL,P005145,P011199,4.367,3,11,8
220,TEL,P007990,P009622,3.484,-8,4,12
220,TEL,P007990,P009783,1.017,-1,2,3
220,TEL,P007990,P009863,0.317,0,0,0
220,TEL,P007990,P011199,3.167,-8,4,12
220,TEL,P007990,P011214,3.484,-8,4,12
220,TEL,P007990,P012744,2.467,-7,2,9
220,TEL,P009622,P009783,17.1,-3,33,36
220,TEL,P009622,P009863,17.518,-3,36,39
220,TEL,P009622,P011193,9.116,-2,20,22
220,TEL,P009622,P011199,19.601,-13,34,47
220,TEL,P009622,P011214,13.884,-8,32,40
220,TEL,P009622,P011219,7.366,4,20,16
220,TEL,P009622,P011971,8.467,-10,11,21
220,TEL,P009622,P012744,11.701,4,31,27
220,TEL,P009783,P009863,24.634,-6,46,52
220,TEL,P009783,P011193,14.766,-2,29,31
220,TEL,P009783,P011199,20.333,-6,35,41
220,TEL,P009783,P011214,6.167,-4,13,17
220,TEL,P009783,P011219,7.95,0,20,20
220,TEL,P009783,P011971,13.066,-10,19,29
220,TEL,P009783,P012744,5.0,5,12,7
220,TEL,P009863,P011193,13.167,-5,26,31
220,TEL,P009863,P011199,23.034,-5,41,46
220,TEL,P009863,P011214,3.867,-2,10,12
220,TEL,P009863,P011219,5.5,3,17,14
220,TEL,P009863,P011971,17.001,-10,31,41
220,TEL,P009863,P012744,8.067,9,22,13
220,TEL,P011193,P011199,8.3,-6,11,17
220,TEL,P011193,P011214,7.366,4,20,16
220,TEL,P011193,P011219,12.35,5,35,30
220,TEL,P011193,P011971,10.567,-6,20,26
220,TEL,P011193,P012744,6.9,0,15,15
220,TEL,P011199,P011214,5.667,-12,8,20
220,TEL,P011199,P011219,0.35,2,2,0
220,TEL,P011199,P011971,11.45,-9,14,23
220,TEL,P011199,P012744,9.667,2,20,18
220,TEL,P011214,P011219,7.699,4,20,16
220,TEL,P011214,P011971,0.867,0,4,4
220,TEL,P011214,P012744,7.867,-6,17,23
220,TEL,P011219,P011971,4.984,1,15,14
220,TEL,P011219,P012744,4.533,1,11,10
220,TEL,P011971,P012744,2.734,4,10,6
221,IST,P004888,P006590,5.816,-11,11,22
221,IST,P004888,P007200,29.2,8,57,49
221,IST,P004888,P009664,26.317,17,54,37
221,IST,P004888,P009846,5.816,-11,11,22
221,IST,P004888,P010516,5.25,3,9,6
221,IST,P004888,P011078,24.0,12,53,41
221,IST,P004888,P011981,7.716,-12,15,27
221,IST,P004888,PLHK,24.417,18,50,32
221,IST,P006590,P007200,6.35,-15,7,22
221,IST,P006590,P009664,7.867,0,14,14
221,IST,P006590,P009846,13.683,-11,25,36
221,IST,P006590,P011078,7.333,4,18,14
221,IST,P006590,P011981,10.399,-7,19,26
221,IST,P006590,PLHK,3.284,-4,6,10
221,IST,P007200,P009664,29.784,11,58,47
221,IST,P007200,P009846,6.35,-15,7,22
221,IST,P007200,P010516,5.25,3,9,6
221,IST,P007200,P011078,21.067,14,45,31
221,IST,P007200,P011981,5.483,-12,7,19
221,IST,P007200,PLHK,27.184,14,54,40
221,IST,P009664,P009846,7.867,0,14,14
221,IST,P009664,P010516,5.25,3,9,6
221,IST,P009664,P011078,25.467,20,55,35
221,IST,P009664,P011981,6.483,3,12,9
221,IST,P009664,PLHK,27.701,14,56,42
221,IST,P009846,P011078,7.333,4,18,14
221,IST,P009846,P011981,10.399,-7,19,26
221,IST,P009846,PLHK,3.284,-4,6,10
221,IST,P010516,PLHK,5.25,3,9,6
221,IST,P011078,P011981,8.716,3,20,17
221,IST,P011078,PLHK,19.684,15,43,28
221,MIL,P000796,P002812,10.634,1,24,23
221,MIL,P000796,P006509,7.266,8,22,14
221,MIL,P000796,P007032,12.6,-5,27,32
221,MIL,P000796,P007201,4.683,-9,5,14
221,MIL,P000796,P007831,5.884,-14,5,19
221,MIL,P000796,P011205,8.051,-16,7,23
221,MIL,P000796,P011224,2.717,-3,2,5
221,MIL,P000796,P012800,9.433,6,24,18
221,MIL,P002812,P002849,1.183,-1,3,4
221,MIL,P002812,P006509,6.266,11,23,12
221,MIL,P002812,P007032,7.917,4,22,18
221,MIL,P002812,P007831,3.384,-9,2,11
221,MIL,P002812,P011205,5.551,-11,4,15
221,MIL,P002812,P011224,3.9,-4,5,9
221,MIL,P002812,P012800,8.433,9,25,16
221,MIL,P002849,P006509,1.183,-1,3,4
221,MIL,P002849,P007201,19.516,7,36,29
221,MIL,P002849,P007831,23.5,3,41,38
221,MIL,P002849,P009960,3.767,-2,5,7
221,MIL,P002849,P011205,12.567,-3,18,21
221,MIL,P002849,P011224,24.683,2,44,42
221,MIL,P002849,P012800,12.333,3,26,23
221,MIL,P006509,P007032,7.266,8,22,14
221,MIL,P006509,P007201,2.183,-4,2,6
221,MIL,P006509,P011224,1.183,-1,3,4
221,MIL,P006509,P012800,8.449,7,25,18
221,MIL,P007032,P007201,4.683,-9,5,14
221,MIL,P007032,P007831,3.467,-11,3,14
221,MIL,P007032,P011205,5.334,-13,5,18
221,MIL,P007032,P012800,9.133,6,24,18
221,MIL,P007201,P007831,22.016,2,39,37
221,MIL,P007201,P011205,12.233,-8,16,24
221,MIL,P007201,P011224,19.516,7,36,29
221,MIL,P007201,P012800,11.966,6,25,19
221,MIL,P007831,P009960,3.767,-2,5,7
221,MIL,P007831,P011205,18.451,-17,23,40
221,MIL,P007831,P011224,25.917,0,43,43
221,MIL,P007831,P012800,11.15,4,23,19
221,MIL,P009960,P011205,2.617,2,5,3
221,MIL,P009960,P011224,3.767,-2,5,7
221,MIL,P009960,P012800,1.15,-4,0,4
221,MIL,P011205,P011224,15.284,-6,20,26
221,MIL,P011205,P012800,2.384,-4,2,6
221,MIL,P011224,P012800,12.633,3,26,23
222,MCO,P002581,P005985,5.35,5,14,9
222,MCO,P002581,P009754,3.567,4,11,7
222,MCO,P002581,P010588,5.35,5,14,9
222,MCO,P002581,P011212,7.1,4,18,14
222,MCO,P002581,P011226,5.283,-1,11,12
222,MCO,P002581,P011231,1.75,-1,4,5
222,MCO,P004197,P005985,5.217,-5,8,13
222,MCO,P004197,P010588,5.217,-5,8,13
222,MCO,P004197,P011226,5.217,-5,8,13
222,MCO,P004197,PLCZ,5.217,-5,8,13
222,MCO,P005985,P009754,13.0,-2,20,22
222,MCO,P005985,P010588,33.6,4,61,57
222,MCO,P005985,P011196,8.833,4,16,12
222,MCO,P005985,P011212,20.683,16,42,26
222,MCO,P005985,P011226,22.867,0,43,43
222,MCO,P005985,P011231,5.433,-1,9,10
222,MCO,P005985,PLCZ,19.417,-5,31,36
222,MCO,P009754,P010588,15.584,2,27,25
222,MCO,P009754,P011196,4.934,-1,9,10
222,MCO,P009754,P011212,11.701,8,24,16
222,MCO,P009754,P011226,8.668,-3,17,20
222,MCO,P009754,P011231,9.25,-2,17,19
222,MCO,P009754,PLCZ,10.9,-2,15,17
222,MCO,P010588,P011196,10.65,6,21,15
222,MCO,P010588,P011212,23.267,20,49,29
222,MCO,P010588,P011226,25.451,4,50,46
222,MCO,P010588,P011231,5.433,-1,9,10
222,MCO,P010588,PLCZ,20.184,-3,33,36
222,MCO,P011196,P011212,11.667,9,25,16
222,MCO,P011196,P011226,12.717,6,25,19
222,MCO,P011196,P011231,2.067,0,4,4
222,MCO,P011212,P011226,21.784,14,48,34
222,MCO,P011212,P011231,3.817,-1,8,9
222,MCO,P011212,PLCZ,8.317,6,14,8
222,MCO,P011226,P011231,3.817,-1,8,9
222,MCO,P011226,PLCZ,11.268,-2,22,24
222,MCO,P011231,PLCZ,5.433,-1,9,10
222,ULK,P001932,P002968,16.45,-3,26,29
222,ULK,P001932,P004004,10.017,-8,8,16
222,ULK,P001932,P005844,13.867,-3,20,23
222,ULK,P001932,P006068,15.784,5,29,24
222,ULK,P001932,P006661,21.101,-3,28,31
222,ULK,P001932,P008962,11.317,-2,15,17
222,ULK,P001932,P009849,4.083,-2,7,9
222,ULK,P001932,P011157,8.117,-4,7,11
222,ULK,P002968,P004004,12.366,-10,19,29
222,ULK,P002968,P005844,11.583,-3,22,25
222,ULK,P002968,P006068,13.434,-1,28,29
222,ULK,P002968,P006661,20.4,-7,35,42
222,ULK,P002968,P006961,2.8,-2,7,9
222,ULK,P002968,P008962,11.167,-6,18,24
222,ULK,P002968,P009849,2.333,-2,5,7
222,ULK,P002968,P011052,0.467,-2,0,2
222,ULK,P004004,P005844,7.383,-5,12,17
222,ULK,P004004,P006068,3.884,0,9,9
222,ULK,P004004,P006661,18.9,-12,29,41
222,ULK,P004004,P006961,8.684,0,18,18
222,ULK,P004004,P008962,15.001,-7,23,30
222,ULK,P004004,P009849,3.9,-2,8,10
222,ULK,P004004,P011157,9.401,-4,14,18
222,ULK,P005844,P006068,13.35,0,24,24
222,ULK,P005844,P006661,17.95,-2,30,32
222,ULK,P005844,P006961,1.05,3,3,0
222,ULK,P005844,P008962,0.25,1,1,0
222,ULK,P005844,P011157,6.367,1,8,7
222,ULK,P006068,P006661,16.934,6,35,29
222,ULK,P006068,P006961,0.234,0,0,0
222,ULK,P006068,P008962,7.901,4,18,14
222,ULK,P006068,P009849,4.083,-2,7,9
222,ULK,P006068,P011052,2.2,1,6,5
222,ULK,P006068,P011157,7.2,3,12,9
222,ULK,P006661,P006961,5.45,1,13,12
222,ULK,P006661,P008962,14.734,-2,27,29
222,ULK,P006661,P009849,0.65,-2,2,4
222,ULK,P006661,P011052,2.2,1,6,5
222,ULK,P006661,P011157,11.417,0,19,19
222,ULK,P006961,P008962,8.134,-1,17,18
222,ULK,P006961,P009849,3.25,0,6,6
222,ULK,P006961,P011157,6.134,3,12,9
222,ULK,P008962,P009849,7.983,-4,15,19
222,ULK,P008962,P011052,2.2,1,6,5
222,ULK,P008962,P011157,10.517,0,20,20
222,ULK,P009849,P011157,5.65,-2,10,12
222,ULK,P011052,P011157,1.733,3,6,3
223,BAR,P000925,P002939,23.5,9,46,37
223,BAR,P000925,P004866,16.666,6,30,24
223,BAR,P000925,P006435,16.683,9,32,23
223,BAR,P000925,P007464,6.75,3,16,13
223,BAR,P000925,P007519,7.1,6,19,13
223,BAR,P000925,P009992,8.25,3,19,16
223,BAR,P000925,P012745,20.783,12,42,30
223,BAR,P002939,P003196,8.717,-1,23,24
223,BAR,P002939,P004866,20.483,1,38,37
223,BAR,P002939,P006435,19.067,1,35,34
223,BAR,P002939,P007464,5.85,-2,11,13
223,BAR,P002939,P007519,10.567,7,29,22
223,BAR,P002939,P009992,13.15,7,34,27
223,BAR,P002939,P011244,4.367,6,15,9
223,BAR,P002939,P012745,23.167,4,45,41
223,BAR,P003196,P004866,9.6,-4,19,23
223,BAR,P003196,P006435,5.433,-3,12,15
223,BAR,P003196,P007464,0.533,-2,0,2
223,BAR,P003196,P007519,10.683,5,26,21
223,BAR,P003196,P009992,9.067,3,22,19
223,BAR,P003196,P011244,5.2,3,16,13
223,BAR,P003196,P012745,8.767,-1,18,19
223,BAR,P003204,P007519,0.283,-3,0,3
223,BAR,P003204,P009992,0.283,-3,0,3
223,BAR,P003204,P010641,0.283,-3,0,3
223,BAR,P003204,P011244,0.283,-3,0,3
223,BAR,P004866,P006435,19.516,3,37,34
223,BAR,P004866,P007519,6.066,1,11,10
223,BAR,P004866,P009992,7.033,-1,12,13
223,BAR,P004866,P010641,0.283,0,0,0
223,BAR,P004866,P011244,1.116,-3,1,4
223,BAR,P004866,P012745,25.433,5,48,43
223,BAR,P006435,P007464,2.6,3,7,4
223,BAR,P006435,P007519,3.049,5,9,4
223,BAR,P006435,P011244,0.383,-2,0,2
223,BAR,P006435,P012745,21.733,8,44,36
223,BAR,P007464,P007519,6.116,1,14,13
223,BAR,P007464,P009992,4.683,-2,9,11
223,BAR,P007464,P012745,2.6,3,7,4
223,BAR,P007519,P009992,15.3,3,36,33
223,BAR,P007519,P010641,0.566,-3,0,3
223,BAR,P007519,P011244,5.766,0,16,16
223,BAR,P007519,P012745,7.9,10,20,10
223,BAR,P009992,P010641,0.566,-3,0,3
223,BAR,P009992,P011244,5.383,2,16,14
223,BAR,P009992,P012745,7.817,3,16,13
223,BAR,P010641,P011244,0.566,-3,0,3
223,RED,P000848,P002553,6.067,-2,11,13
223,RED,P000848,P005099,11.467,2,24,22
223,RED,P000848,P006436,22.583,2,47,45
223,RED,P000848,P007960,8.15,-2,19,21
223,RED,P000848,P008966,4.8,2,9,7
223,RED,P000848,P009035,18.434,-6,31,37
223,RED,P000848,P011941,7.65,8,23,15
223,RED,P000848,P012044,14.517,5,35,30
223,RED,P000848,P012801,7.65,8,23,15
223,RED,P000848,PJDR,14.9,-1,28,29
223,RED,P000848,PLUO,1.45,0,2,2
223,RED,P002553,P005099,7.134,-3,16,19
223,RED,P002553,P006436,2.117,-4,2,6
223,RED,P002553,P008966,7.5,-3,18,21
223,RED,P002553,P009035,2.734,-4,2,6
223,RED,P002553,P012044,5.8,-6,11,17
223,RED,P002553,P012801,3.067,-4,7,11
223,RED,P002553,PJDR,4.434,-1,9,10
223,RED,P002553,PLUO,2.083,-1,4,5
223,RED,P005099,P006436,7.883,4,17,13
223,RED,P005099,P007960,1.4,-6,0,6
223,RED,P005099,P008966,7.3,-5,16,21
223,RED,P005099,P009035,9.117,0,17,17
223,RED,P005099,P012044,3.483,-4,7,11
223,RED,P005099,P012801,3.067,-4,7,11
223,RED,P005099,PJDR,13.717,-3,26,29
223,RED,P005099,PLUO,1.1,-1,2,3
223,RED,P006436,P007960,9.8,-6,14,20
223,RED,P006436,P008966,1.0,0,0,0
223,RED,P006436,P009035,20.8,-6,33,39
223,RED,P006436,P011941,5.85,4,16,12
223,RED,P006436,P012044,15.334,-3,28,31
223,RED,P006436,P012801,5.85,4,16,12
223,RED,P006436,PJDR,11.316,1,21,20
223,RED,P006436,PLUO,4.067,-4,2,6
223,RED,P007960,P008966,2.35,-4,2,6
223,RED,P007960,P009035,10.417,-10,14,24
223,RED,P007960,P011941,1.8,4,7,3
223,RED,P007960,P012044,11.517,-3,19,22
223,RED,P007960,P012801,3.367,2,9,7
223,RED,P007960,PJDR,5.4,-11,6,17
223,RED,P007960,PLUO,4.067,-4,2,6
223,RED,P008966,P009035,1.467,0,0,0
223,RED,P008966,P012044,6.5,-6,11,17
223,RED,P008966,P012801,4.634,-6,9,15
223,RED,P008966,PJDR,7.167,-5,11,16
223,RED,P008966,PLUO,2.55,-1,4,5
223,RED,P009035,P012044,9.951,-7,12,19
223,RED,P009035,PJDR,12.55,-3,21,24
223,RED,P009035,PLUO,4.534,-4,2,6
223,RED,P011941,P012044,7.65,8,23,15
223,RED,P011941,P012801,7.65,8,23,15
223,RED,P012044,P012801,10.817,5,30,25
223,RED,P012044,PJDR,2.35,-4,2,6
223,RED,P012044,PLUO,6.617,-5,6,11
223,RED,P012801,PJDR,3.034,-5,4,9
224,PAR,P003983,P004172,9.816,-2,20,22
224,PAR,P003983,P007400,12.084,4,36,32
224,PAR,P003983,P008987,1.033,-3,0,3
224,PAR,P003983,P009862,12.55,6,35,29
224,PAR,P003983,P011050,11.066,4,23,19
224,PAR,P003983,P011051,13.05,-3,34,37
224,PAR,P003983,P011192,9.833,-4,20,24
224,PAR,P003983,P012096,0.783,2,2,0
224,PAR,P003983,P012742,13.417,3,36,33
224,PAR,P003983,P012743,9.3,-3,18,21
224,PAR,P004172,P007400,0.067,0,0,0
224,PAR,P004172,P008987,3.8,-6,5,11
224,PAR,P004172,P009862,3.484,-4,5,9
224,PAR,P004172,P011050,0.383,-2,0,2
224,PAR,P004172,P011051,10.467,0,23,23
224,PAR,P004172,P011192,13.3,-6,25,31
224,PAR,P004172,P012096,0.783,2,2,0
224,PAR,P004172,P012743,11.1,-6,20,26
224,PAR,P007400,P008987,7.85,-3,15,18
224,PAR,P007400,P009862,21.617,6,54,48
224,PAR,P007400,P011050,15.333,5,31,26
224,PAR,P007400,P011051,5.484,-1,18,19
224,PAR,P007400,P011192,2.567,0,4,4
224,PAR,P007400,P012096,1.317,1,3,2
224,PAR,P007400,P012742,22.417,3,55,52
224,PAR,P007400,P012743,1.2,-3,4,7
224,PAR,P008987,P009862,11.917,-8,20,28
224,PAR,P008987,P011050,5.716,-3,8,11
224,PAR,P008987,P011051,0.967,0,3,3
224,PAR,P008987,P011192,3.8,-6,5,11
224,PAR,P008987,P012096,1.317,1,3,2
224,PAR,P008987,P012742,8.5,-4,15,19
224,PAR,P008987,P012743,4.3,-8,6,14
224,PAR,P009862,P011050,17.783,6,34,28
224,PAR,P009862,P011051,9.217,2,24,22
224,PAR,P009862,P011192,8.917,-2,13,15
224,PAR,P009862,P012096,1.317,1,3,2
224,PAR,P009862,P012742,25.833,5,58,53
224,PAR,P009862,P012743,4.633,-8,6,14
224,PAR,P011050,P011051,4.15,-1,5,6
224,PAR,P011050,P011192,3.0,-2,4,6
224,PAR,P011050,P012742,18.633,5,35,30
224,PAR,P011051,P011192,15.917,0,31,31
224,PAR,P011051,P012096,0.783,2,2,0
224,PAR,P011051,P012742,9.05,-1,22,23
224,PAR,P011051,P012743,8.983,-2,18,20
224,PAR,P011192,P012096,0.783,2,2,0
224,PAR,P011192,P012742,5.45,0,8,8
224,PAR,P011192,P012743,11.433,-6,20,26
224,PAR,P012096,P012742,1.317,1,3,2
224,PAR,P012742,P012743,2.183,-4,4,8
224,VIR,P001133,P001844,17.4,2,35,33
224,VIR,P001133,P003048,16.367,1,34,33
224,VIR,P001133,P003527,4.384,3,9,6
224,VIR,P001133,P006739,4.284,0,8,8
224,VIR,P001133,P008847,5.317,1,9,8
224,VIR,P001133,P009549,15.567,4,31,27
224,VIR,P001133,P010781,6.117,-2,12,14
224,VIR,P001133,PBCN,17.3,-1,34,35
224,VIR,P001844,P003048,21.767,9,53,44
224,VIR,P001844,P003527,8.217,15,28,13
224,VIR,P001844,P008847,2.583,4,6,2
224,VIR,P001844,P009549,21.85,14,52,38
224,VIR,P001844,P010781,7.5,6,23,17
224,VIR,P001844,PBCN,18.083,2,39,37
224,VIR,P003048,P003527,8.35,6,24,18
224,VIR,P003048,P006739,5.5,1,14,13
224,VIR,P003048,P008847,2.55,3,9,6
224,VIR,P003048,P009549,20.867,10,48,38
224,VIR,P003048,P010781,11.4,7,35,28
224,VIR,P003048,PBCN,22.267,3,51,48
224,VIR,P003527,P004007,0.25,-3,1,4
224,VIR,P003527,P006739,11.934,-13,17,30
224,VIR,P003527,P008847,11.801,-4,21,25
224,VIR,P003527,P009549,10.567,6,29,23
224,VIR,P003527,P010781,17.601,-2,35,37
224,VIR,P003527,PBCN,7.5,0,16,16
224,VIR,P004007,P006739,0.25,-3,1,4
224,VIR,P004007,P008847,0.25,-3,1,4
224,VIR,P004007,P009549,0.25,-3,1,4
224,VIR,P006739,P008847,12.701,-7,24,31
224,VIR,P006739,P009549,4.617,-8,6,14
224,VIR,P006739,P010781,14.051,-6,26,32
224,VIR,P006739,PBCN,9.267,0,20,20
224,VIR,P008847,P009549,6.95,-4,12,16
224,VIR,P008847,P010781,11.351,-4,21,25
224,VIR,P008847,PBCN,7.633,2,17,15
224,VIR,P009549,P010781,8.017,2,19,17
224,VIR,P009549,PBCN,17.183,3,34,31
224,VIR,P010781,PBCN,10.167,-1,25,26
225,PAN,P002328,P003842,29.567,-8,56,64
225,PAN,P002328,P006544,0.117,0,0,0
225,PAN,P002328,P007866,22.499,-5,43,48
225,PAN,P002328,P007947,11.667,2,20,18
225,PAN,P002328,P011204,23.949,-8,48,56
225,PAN,P002328,P011209,0.117,0,0,0
225,PAN,P002328,P011221,2.733,2,6,4
225,PAN,P002328,P012712,12.667,3,23,20
225,PAN,P002328,P012774,31.616,-2,60,62
225,PAN,P003842,P005161,1.617,-2,2,4
225,PAN,P003842,P006544,0.117,0,0,0
225,PAN,P003842,P007866,21.1,-15,37,52
225,PAN,P003842,P007947,15.317,2,24,22
225,PAN,P003842,P011204,24.583,-16,44,60
225,PAN,P003842,P011209,3.3,-2,2,4
225,PAN,P003842,P012712,13.267,3,23,20
225,PAN,P003842,P012774,28.6,-10,52,62
225,PAN,P005161,P007866,1.617,-2,2,4
225,PAN,P005161,P007947,1.617,-2,2,4
225,PAN,P005161,P011204,1.617,-2,2,4
225,PAN,P006544,P011209,0.117,0,0,0
225,PAN,P006544,P012712,0.117,0,0,0
225,PAN,P007866,P007947,3.367,-4,2,6
225,PAN,P007866,P011204,23.516,-9,45,54
225,PAN,P007866,P011209,1.15,-4,0,4
225,PAN,P007866,P011221,2.733,2,6,4
225,PAN,P007866,P012712,1.433,2,2,0
225,PAN,P007866,P012774,23.649,-9,43,52
225,PAN,P007947,P011204,7.117,-6,8,14
225,PAN,P007947,P011209,2.033,2,2,0
225,PAN,P007947,P011221,1.467,-4,0,4
225,PAN,P007947,P012712,13.417,2,22,20
225,PAN,P007947,P012774,11.134,0,16,16
225,PAN,P011204,P011209,3.183,-2,2,4
225,PAN,P011204,P011221,4.2,-2,6,8
225,PAN,P011204,P012712,8.133,-5,9,14
225,PAN,P011204,P012774,24.566,-14,44,58
225,PAN,P011209,P012712,2.15,2,2,0
225,PAN,P011209,P012774,1.15,-4,0,4
225,PAN,P011221,P012712,1.467,-4,0,4
225,PAN,P011221,P012774,4.2,-2,6,8
225,PAN,P012712,P012774,12.017,1,19,18
225,ZAL,P002329,P002676,11.117,10,20,10
225,ZAL,P002329,P003210,2.733,-2,4,6
225,ZAL,P002329,P003211,4.567,-4,4,8
225,ZAL,P002329,P005504,17.367,3,43,40
225,ZAL,P002329,P007109,6.917,4,14,10
225,ZAL,P002329,P007513,21.784,17,56,39
225,ZAL,P002329,P010390,8.367,10,15,5
225,ZAL,P002329,P011218,23.118,22,57,35
225,ZAL,P002329,P012715,17.401,11,44,33
225,ZAL,P002329,P012787,6.833,5,15,10
225,ZAL,P002676,P003210,1.483,-3,3,6
225,ZAL,P002676,P003211,6.084,3,10,7
225,ZAL,P002676,P005504,7.567,-1,12,13
225,ZAL,P002676,P006860,0.117,-1,0,1
225,ZAL,P002676,P007109,10.034,-6,12,18
225,ZAL,P002676,P007513,7.234,1,12,11
225,ZAL,P002676,P010390,11.751,2,18,16
225,ZAL,P002676,P011218,13.768,8,20,12
225,ZAL,P002676,P012715,2.617,2,2,0
225,ZAL,P002676,P012787,12.5,-3,19,22
225,ZAL,P003210,P003211,3.516,-1,7,8
225,ZAL,P003210,P005504,2.0,-4,2,6
225,ZAL,P003210,P007109,4.083,-5,7,12
225,ZAL,P003210,P010390,2.216,-1,5,6
225,ZAL,P003210,P012715,0.133,0,0,0
225,ZAL,P003210,P012787,0.7,-4,0,4
225,ZAL,P003211,P005504,2.667,-4,2,6
225,ZAL,P003211,P006860,0.117,-1,0,1
225,ZAL,P003211,P007109,7.033,2,14,12
225,ZAL,P003211,P007513,0.117,-1,0,1
225,ZAL,P003211,P010390,6.634,1,10,9
225,ZAL,P003211,P011218,2.701,-2,0,2
225,ZAL,P003211,P012715,2.85,0,2,2
225,ZAL,P003211,P012787,3.65,3,7,4
225,ZAL,P005504,P007109,5.134,-8,4,12
225,ZAL,P005504,P007513,12.434,-1,33,34
225,ZAL,P005504,P011218,17.634,6,41,35
225,ZAL,P005504,P012715,11.2,4,31,27
225,ZAL,P005504,P012787,6.533,1,12,11
225,ZAL,P006860,P007513,0.117,-1,0,1
225,ZAL,P006860,P010390,0.117,-1,0,1
225,ZAL,P007109,P007513,3.617,4,10,6
225,ZAL,P007109,P010390,5.75,-2,10,12
225,ZAL,P007109,P011218,6.718,0,10,10
225,ZAL,P007109,P012715,5.0,8,12,4
225,ZAL,P007109,P012787,9.25,-5,11,16
225,ZAL,P007513,P010390,6.584,9,13,4
225,ZAL,P007513,P011218,17.951,16,49,33
225,ZAL,P007513,P012715,15.034,13,44,31
225,ZAL,P007513,P012787,4.2,-1,7,8
225,ZAL,P010390,P011218,7.301,4,10,6
225,ZAL,P010390,P012715,2.751,1,3,2
225,ZAL,P010390,P012787,6.001,-3,8,11
225,ZAL,P011218,P012715,15.985,8,39,31
225,ZAL,P011218,P012787,6.1,2,10,8
225,ZAL,P012715,P012787,2.833,5,7,2
226,MAD,P001392,P003108,6.417,3,16,13
226,MAD,P001392,P005791,6.417,3,16,13
226,MAD,P001392,P005928,4.417,2,11,9
226,MAD,P001392,P009005,6.417,3,16,13
226,MAD,P001392,PCVM,2.0,1,5,4
226,MAD,P003108,P004887,1.117,-1,2,3
226,MAD,P003108,P005791,17.401,3,39,36
226,MAD,P003108,P005928,15.551,4,36,32
226,MAD,P003108,P006540,11.134,2,25,23
226,MAD,P003108,P009005,16.551,4,38,34
226,MAD,P003108,PBMT,1.967,-2,3,5
226,MAD,P003108,PCVM,2.967,-2,5,7
226,MAD,P003108,PTGB,0.967,-3,0,3
226,MAD,P004887,P005928,3.417,-6,2,8
226,MAD,P004887,P006540,8.601,4,22,18
226,MAD,P004887,P009005,6.501,3,13,10
226,MAD,P004887,P010357,16.517,-3,31,34
226,MAD,P004887,PBMT,6.4,-21,0,21
226,MAD,P004887,PCVM,14.884,0,31,31
226,MAD,P004887,PTGB,15.767,0,31,31
226,MAD,P005791,P005928,15.217,1,34,33
226,MAD,P005791,P006540,12.35,-1,23,24
226,MAD,P005791,P009005,15.434,5,36,31
226,MAD,P005791,P010357,4.299,-2,4,6
226,MAD,P005791,PBMT,4.433,-2,7,9
226,MAD,P005791,PCVM,6.483,0,9,9
226,MAD,P005791,PTGB,4.766,-3,4,7
226,MAD,P005928,P006540,13.051,-5,25,30
226,MAD,P005928,P009005,14.251,4,33,29
226,MAD,P005928,P010357,2.416,-7,0,7
226,MAD,P005928,PBMT,5.05,-11,3,14
226,MAD,P005928,PTGB,1.166,-2,0,2
226,MAD,P006540,P009005,9.834,2,22,20
226,MAD,P006540,P010357,9.15,3,20,17
226,MAD,P006540,PBMT,3.884,-9,3,12
226,MAD,P006540,PCVM,7.9,8,20,12
226,MAD,P006540,PTGB,7.9,8,20,12
226,MAD,P009005,P010357,4.717,6,11,5
226,MAD,P009005,PBMT,0.667,-2,0,2
226,MAD,P009005,PCVM,7.684,4,16,12
226,MAD,P009005,PTGB,5.684,3,11,8
226,MAD,P010357,PBMT,8.199,-19,4,23
226,MAD,P010357,PCVM,18.4,2,35,33
226,MAD,P010357,PTGB,19.566,0,35,35
226,MAD,PBMT,PCVM,5.783,-12,4,16
226,MAD,PBMT,PTGB,6.949,-14,4,18
226,MAD,PCVM,PTGB,19.367,-1,35,36
226,MIL,P000796,P002812,11.149,19,30,11
226,MIL,P000796,P002849,13.416,-9,25,34
226,MIL,P000796,P007032,18.883,9,42,33
226,MIL,P000796,P007201,4.083,-6,5,11
226,MIL,P000796,P007831,19.316,-8,38,46
226,MIL,P000796,P011205,21.299,15,51,36
226,MIL,P000796,P011224,7.099,0,15,15
226,MIL,P000796,P012800,8.683,16,22,6
226,MIL,P001518,P002849,4.917,-4,8,12
226,MIL,P001518,P007201,4.917,-4,8,12
226,MIL,P001518,P007831,4.917,-4,8,12
226,MIL,P001518,P011224,4.917,-4,8,12
226,MIL,P002812,P002849,0.317,2,2,0
226,MIL,P002812,P007032,7.55,20,22,2
226,MIL,P002812,P007201,6.6,-3,8,11
226,MIL,P002812,P007831,6.883,5,16,11
226,MIL,P002812,P011205,12.617,15,31,16
226,MIL,P002812,P011224,8.516,-5,13,18
226,MIL,P002812,P012800,11.9,15,26,11
226,MIL,P002849,P007032,12.95,-6,25,31
226,MIL,P002849,P007201,9.767,-8,17,25
226,MIL,P002849,P007831,22.517,-9,44,53
226,MIL,P002849,P011205,12.583,-3,26,29
226,MIL,P002849,P011224,7.85,-3,15,18
226,MIL,P002849,P012800,5.751,4,14,10
226,MIL,P007032,P007201,5.434,-3,9,12
226,MIL,P007032,P007831,16.367,-3,33,36
226,MIL,P007032,P011205,17.5,15,41,26
226,MIL,P007032,P012800,8.984,20,24,4
226,MIL,P007201,P007831,13.267,-8,22,30
226,MIL,P007201,P011205,5.201,-7,6,13
226,MIL,P007201,P011224,10.95,-7,16,23
226,MIL,P007201,P012800,10.917,-2,17,19
226,MIL,P007831,P011205,18.033,-1,39,40
226,MIL,P007831,P011224,12.416,-4,23,27
226,MIL,P007831,P012800,8.284,4,17,13
226,MIL,P011205,P011224,6.633,-5,12,17
226,MIL,P011205,P012800,9.534,11,22,11
226,MIL,P011224,P012800,7.083,-4,10,14
227,IST,P004888,P006590,10.083,9,33,24
227,IST,P004888,P007200,24.0,3,62,59
227,IST,P004888,P009664,20.0,5,56,51
227,IST,P004888,P009846,1.45,2,5,3
227,IST,P004888,P010516,4.717,-5,11,16
227,IST,P004888,P011078,11.95,-5,23,28
227,IST,P004888,P011981,4.884,1,9,8
227,IST,P004888,P012710,6.1,-3,11,14
227,IST,P004888,PLHK,21.216,1,58,57
227,IST,P006590,P007200,12.75,18,45,27
227,IST,P006590,P009664,7.983,10,28,18
227,IST,P006590,P009846,4.7,8,17,9
227,IST,P006590,P011078,2.167,-1,5,6
227,IST,P006590,P011981,6.517,9,22,13
227,IST,P006590,P012710,6.867,7,22,15
227,IST,P006590,PLHK,8.333,8,28,20
227,IST,P007200,P009664,21.033,5,58,53
227,IST,P007200,P009846,15.283,14,43,29
227,IST,P007200,P010516,4.717,-5,11,16
227,IST,P007200,P011078,19.05,0,39,39
227,IST,P007200,P011981,16.9,12,42,30
227,IST,P007200,P012710,16.867,10,42,32
227,IST,P007200,PLHK,21.0,3,58,55
227,IST,P009664,P009846,2.483,2,7,5
227,IST,P009664,P010516,4.717,-5,11,16
227,IST,P009664,P011078,6.883,-2,14,16
227,IST,P009664,P011981,1.033,0,2,2
227,IST,P009664,PLHK,20.0,5,56,51
227,IST,P009846,P011078,9.133,4,21,17
227,IST,P009846,P011981,13.833,12,38,26
227,IST,P009846,P012710,12.8,12,36,24
227,IST,P009846,PLHK,1.45,2,5,3
227,IST,P010516,PLHK,4.717,-5,11,16
227,IST,P011078,P011981,14.017,5,30,25
227,IST,P011078,P012710,14.267,1,30,29
227,IST,P011078,PLHK,7.133,-6,14,20
227,IST,P011981,P012710,17.684,13,45,32
227,IST,P012710,PLHK,1.283,-4,2,6
227,TEL,P004233,P007990,0.717,-1,5,6
227,TEL,P004233,P009783,0.55,-3,3,6
227,TEL,P004233,P009863,0.55,-3,3,6
227,TEL,P004233,P011193,5.266,-3,12,15
227,TEL,P004233,P011199,0.2,2,2,0
227,TEL,P004233,P011214,5.55,0,17,17
227,TEL,P004233,P011971,5.066,-1,12,13
227,TEL,P004233,P012744,5.233,1,14,13
227,TEL,P007990,P009783,20.567,-7,48,55
227,TEL,P007990,P009863,20.567,-7,48,55
227,TEL,P007990,P011193,0.483,-2,0,2
227,TEL,P007990,P011199,18.834,0,45,45
227,TEL,P007990,P011214,1.834,-1,7,8
227,TEL,P007990,P011219,13.517,-6,33,39
227,TEL,P007990,P011971,0.283,0,0,0
227,TEL,P007990,P012744,6.134,4,14,10
227,TEL,P009783,P009863,28.001,-13,66,79
227,TEL,P009783,P011193,11.25,-12,23,35
227,TEL,P009783,P011199,24.951,-8,57,65
227,TEL,P009783,P011214,6.15,-7,14,21
227,TEL,P009783,P011219,16.817,-7,40,47
227,TEL,P009783,P011971,5.233,-7,10,17
227,TEL,P009783,P012744,11.817,-4,23,27
227,TEL,P009863,P011193,11.35,-6,24,30
227,TEL,P009863,P011199,25.051,-8,57,65
227,TEL,P009863,P011214,6.15,-1,15,16
227,TEL,P009863,P011219,16.817,-7,40,47
227,TEL,P009863,P011971,5.333,-1,11,12
227,TEL,P009863,P012744,11.917,2,24,22
227,TEL,P011193,P011199,6.384,-6,14,20
227,TEL,P011193,P011214,13.099,-3,27,30
227,TEL,P011193,P011219,3.3,-1,7,8
227,TEL,P011193,P011971,13.416,-6,28,34
227,TEL,P011193,P012744,14.316,-5,29,34
227,TEL,P011199,P011214,0.2,2,2,0
227,TEL,P011199,P011219,15.667,-7,36,43
227,TEL,P011199,P011971,2.033,-3,5,8
227,TEL,P011199,P012744,7.684,4,18,14
227,TEL,P011214,P011219,1.15,0,4,4
227,TEL,P011214,P011971,11.732,-3,23,26
227,TEL,P011214,P012744,12.999,-3,27,30
227,TEL,P011971,P012744,11.832,-3,23,26
228,OLY,P001255,P007853,7.75,1,15,14
228,OLY,P001255,P007982,9.217,1,19,18
228,OLY,P001255,P008811,1.417,-3,0,3
228,OLY,P001255,P008829,3.634,1,6,5
228,OLY,P001255,P008855,5.101,1,10,9
228,OLY,P001255,P010612,3.634,1,6,5
228,OLY,P001255,P011194,9.217,1,19,18
228,OLY,P001255,P012878,11.434,5,25,20
228,OLY,P007853,P007982,17.117,6,37,31
228,OLY,P007853,P008811,6.367,7,14,7
228,OLY,P007853,P008829,9.117,4,16,12
228,OLY,P007853,P008855,13.2,3,24,21
228,OLY,P007853,P010392,2.266,-2,4,6
228,OLY,P007853,P010612,8.767,10,22,12
228,OLY,P007853,P011194,15.616,5,35,30
228,OLY,P007853,P012878,18.0,2,37,35
228,OLY,P007982,P008829,2.567,-3,2,5
228,OLY,P007982,P008855,9.067,-2,14,16
228,OLY,P007982,P010392,1.2,2,4,2
228,OLY,P007982,P010612,4.233,1,8,7
228,OLY,P007982,P011194,17.85,7,39,32
228,OLY,P007982,P012878,20.417,4,41,37
228,OLY,P008811,P008829,16.301,9,31,22
228,OLY,P008811,P008855,16.301,9,31,22
228,OLY,P008811,P010612,16.301,9,31,22
228,OLY,P008811,P011983,8.517,5,17,12
228,OLY,P008829,P008855,21.268,10,39,29
228,OLY,P008829,P010392,0.183,0,0,0
228,OLY,P008829,P010612,18.518,13,37,24
228,OLY,P008829,P011194,0.183,0,0,0
228,OLY,P008829,P011983,8.517,5,17,12
228,OLY,P008829,P012878,4.784,1,8,7
228,OLY,P008855,P010392,1.066,-4,0,4
228,OLY,P008855,P010612,20.351,11,37,26
228,OLY,P008855,P011194,7.566,-3,12,15
228,OLY,P008855,P011983,8.517,5,17,12
228,OLY,P008855,P012878,12.167,-2,20,22
228,OLY,P010392,P011194,2.266,-2,4,6
228,OLY,P010392,P012878,2.083,-2,4,6
228,OLY,P010612,P011194,4.233,1,8,7
228,OLY,P010612,P011983,8.517,5,17,12
228,OLY,P010612,P012878,6.45,5,14,9
228,OLY,P011194,P012878,18.733,3,39,36
228,PAM,P003960,P004863,6.467,6,13,7
228,PAM,P003960,P005356,14.05,14,32,18
228,PAM,P003960,P006433,4.85,8,14,6
228,PAM,P003960,P006643,0.367,-2,0,2
228,PAM,P003960,P010393,1.667,-6,0,6
228,PAM,P003960,P010568,20.833,3,38,35
228,PAM,P003960,P011970,4.55,5,9,4
228,PAM,P003960,P011982,11.784,12,26,14
228,PAM,P003960,P012738,11.583,-5,17,22
228,PAM,P003960,P012740,12.05,-9,15,24
228,PAM,P003960,P012795,16.199,-6,24,30
228,PAM,P004863,P005356,9.617,1,16,15
228,PAM,P004863,P006643,5.217,-5,8,13
228,PAM,P004863,P010393,10.967,-18,11,29
228,PAM,P004863,P010568,1.483,2,4,2
228,PAM,P004863,P011970,13.184,-5,20,25
228,PAM,P004863,P011982,14.651,-6,22,28
228,PAM,P004863,P012740,1.3,-4,0,4
228,PAM,P004863,P012795,1.65,-3,2,5
228,PAM,P005356,P006433,4.85,8,14,6
228,PAM,P005356,P010393,4.45,-9,3,12
228,PAM,P005356,P010568,11.033,3,23,20
228,PAM,P005356,P011970,8.717,-2,12,14
228,PAM,P005356,P011982,16.901,0,29,29
228,PAM,P005356,P012738,1.867,-5,2,7
228,PAM,P005356,P012795,5.183,-2,9,11
228,PAM,P006433,P010568,4.85,8,14,6
228,PAM,P006433,P011970,1.717,1,5,4
228,PAM,P006433,P011982,4.484,9,15,6
228,PAM,P006433,P012738,2.917,-1,7,8
228,PAM,P006433,P012795,2.6,3,7,4
228,PAM,P006643,P010393,7.434,-9,10,19
228,PAM,P006643,P010568,2.217,-4,2,6
228,PAM,P006643,P011970,5.217,-5,8,13
228,PAM,P006643,P011982,7.067,-7,10,17
228,PAM,P006643,P012740,2.217,-4,2,6
228,PAM,P010393,P010568,2.5,-6,2,8
228,PAM,P010393,P011970,9.384,-12,11,23
228,PAM,P010393,P011982,11.517,-16,13,29
228,PAM,P010393,P012740,3.517,-8,2,10
228,PAM,P010393,P012795,1.3,-4,0,4
228,PAM,P010568,P011970,0.75,-2,0,2
228,PAM,P010568,P011982,10.617,-1,19,20
228,PAM,P010568,P012738,12.25,-8,17,25
228,PAM,P010568,P012740,12.6,-7,17,24
228,PAM,P010568,P012795,15.399,-4,24,28
228,PAM,P011970,P011982,15.651,-6,25,31
228,PAM,P011970,P012738,1.717,1,5,4
228,PAM,P011970,P012795,1.717,1,5,4
228,PAM,P011982,P012738,2.384,-2,5,7
228,PAM,P011982,P012740,1.85,-2,2,4
228,PAM,P011982,P012795,5.834,-5,10,15
228,PAM,P012738,P012740,10.383,-3,15,18
228,PAM,P012738,P012795,12.767,-5,20,25
228,PAM,P012740,P012795,11.683,-7,15,22
229,MUN,P001288,P001557,14.266,-3,27,30
229,MUN,P001288,P003583,20.95,-1,44,45
229,MUN,P001288,P004508,5.433,-2,10,12
229,MUN,P001288,P006760,15.317,-5,30,35
229,MUN,P001288,P007639,9.816,-2,18,20
229,MUN,P001288,P007975,11.633,0,23,23
229,MUN,P001288,P010391,27.266,-1,56,57
229,MUN,P001288,P011987,18.383,2,40,38
229,MUN,P001557,P003583,12.033,-2,24,26
229,MUN,P001557,P004508,1.083,3,3,0
229,MUN,P001557,P006760,0.017,0,0,0
229,MUN,P001557,P007639,2.233,-1,3,4
229,MUN,P001557,P007975,2.383,1,5,4
229,MUN,P001557,P010391,13.183,-6,24,30
229,MUN,P001557,P011987,11.866,-4,22,26
229,MUN,P003583,P004508,3.983,-3,7,10
229,MUN,P003583,P006543,1.083,-3,1,4
229,MUN,P003583,P006760,8.817,-7,16,23
229,MUN,P003583,P007975,12.116,-1,24,25
229,MUN,P003583,P010391,18.05,-1,38,39
229,MUN,P003583,P011987,11.1,2,26,24
229,MUN,P004508,P006543,6.366,7,11,4
229,MUN,P004508,P006760,11.666,3,21,18
229,MUN,P004508,P007639,8.766,9,17,8
229,MUN,P004508,P007975,10.816,6,20,14
229,MUN,P004508,P010391,2.883,1,7,6
229,MUN,P006543,P006760,8.283,3,14,11
229,MUN,P006543,P007639,7.2,6,13,7
229,MUN,P006543,P007975,7.716,6,14,8
229,MUN,P006543,P010391,0.567,-3,0,3
229,MUN,P006543,P011987,1.917,-4,3,7
229,MUN,P006760,P007639,15.733,6,31,25
229,MUN,P006760,P007975,16.716,1,30,29
229,MUN,P006760,P010391,14.417,-2,30,32
229,MUN,P006760,P011987,7.234,-3,16,19
229,MUN,P007639,P007975,8.183,8,16,8
229,MUN,P007639,P010391,10.733,-2,21,23
229,MUN,P007639,P011987,9.2,-4,17,21
229,MUN,P007975,P010391,9.083,3,20,17
229,MUN,P007975,P011987,2.55,4,8,4
229,MUN,P010391,P011987,18.95,-1,40,41
229,PAR,P003983,P004058,7.617,9,20,11
229,PAR,P003983,P004172,14.6,8,28,20
229,PAR,P003983,P007400,1.117,-5,2,7
229,PAR,P003983,P008987,15.717,3,30,27
229,PAR,P003983,P009862,4.15,-3,8,11
229,PAR,P003983,P011051,0.967,0,0,0
229,PAR,P003983,P012096,3.666,-3,2,5
229,PAR,P003983,P012742,3.95,-3,2,5
229,PAR,P003983,P012743,11.084,6,28,22
229,PAR,P004058,P004172,9.901,9,23,14
229,PAR,P004058,P007400,7.916,3,16,13
229,PAR,P004058,P008987,12.884,8,28,20
229,PAR,P004058,P009862,7.817,6,17,11
229,PAR,P004058,P011051,4.933,4,11,7
229,PAR,P004058,P012096,1.567,0,3,3
229,PAR,P004058,P012742,2.383,-3,2,5
229,PAR,P004058,P012743,16.25,12,36,24
229,PAR,P004172,P007400,0.533,0,0,0
229,PAR,P004172,P008987,17.417,8,31,23
229,PAR,P004172,P009862,5.85,2,9,7
229,PAR,P004172,P011051,0.967,0,0,0
229,PAR,P004172,P012096,5.233,-3,5,8
229,PAR,P004172,P012742,4.483,-3,2,5
229,PAR,P004172,P012743,10.684,11,26,15
229,PAR,P007400,P008987,12.699,-16,22,38
229,PAR,P007400,P009862,20.732,-6,45,51
229,PAR,P007400,P011050,3.683,-1,7,8
229,PAR,P007400,P011051,10.416,7,25,18
229,PAR,P007400,P012096,7.733,-5,16,21
229,PAR,P007400,P012742,16.465,-10,31,41
229,PAR,P007400,P012743,11.166,-3,24,27
229,PAR,P008987,P009862,18.016,-14,31,45
229,PAR,P008987,P011050,3.683,-1,7,8
229,PAR,P008987,P011051,0.967,0,0,0
229,PAR,P008987,P012096,7.483,-11,7,18
229,PAR,P008987,P012742,12.549,-13,17,30
229,PAR,P008987,P012743,16.917,4,39,35
229,PAR,P009862,P011050,3.683,-1,7,8
229,PAR,P009862,P011051,9.0,10,23,13
229,PAR,P009862,P012096,10.133,-5,21,26
229,PAR,P009862,P012742,14.082,-7,29,36
229,PAR,P009862,P012743,10.733,2,26,24
229,PAR,P011050,P012742,3.683,-1,7,8
229,PAR,P011051,P012096,5.483,3,14,11
229,PAR,P011051,P012742,7.866,0,16,16
229,PAR,P011051,P012743,4.933,4,11,7
229,PAR,P012096,P012742,10.566,-8,16,24
229,PAR,P012742,P012743,5.633,-4,10,14
230,ASV,P000229,P003526,14.066,0,36,36
230,ASV,P000229,P004194,20.183,1,52,51
230,ASV,P000229,P005094,14.166,0,36,36
230,ASV,P000229,P011225,7.116,3,16,13
230,ASV,P000229,P011386,13.067,-2,36,38
230,ASV,P000229,P012729,6.017,1,16,15
230,ASV,P000229,P012731,6.117,1,16,15
230,ASV,P003274,P005094,0.733,0,0,0
230,ASV,P003274,P012080,5.783,-1,5,6
230,ASV,P003274,P012729,5.783,-1,5,6
230,ASV,P003274,P012731,5.783,-1,5,6
230,ASV,P003274,PKIR,5.05,-1,5,6
230,ASV,P003526,P004194,15.533,-3,38,41
230,ASV,P003526,P005094,10.349,0,26,26
230,ASV,P003526,P011225,10.832,0,24,24
230,ASV,P003526,P011386,8.417,-6,22,28
230,ASV,P003526,P012080,5.183,-6,10,16
230,ASV,P003526,P012729,9.333,-8,20,28
230,ASV,P003526,PKIR,3.283,-1,8,9
230,ASV,P004194,P005094,16.483,-1,38,39
230,ASV,P004194,P011225,7.116,3,16,13
230,ASV,P004194,P011386,17.951,-7,43,50
230,ASV,P004194,P012080,4.884,-5,7,12
230,ASV,P004194,P012729,8.584,-3,21,24
230,ASV,P004194,P012731,8.434,0,18,18
230,ASV,P004194,PKIR,1.1,-1,3,4
230,ASV,P005094,P011225,5.466,-2,10,12
230,ASV,P005094,P011386,11.45,-1,28,29
230,ASV,P005094,P012080,3.483,-3,2,5
230,ASV,P005094,P012729,1.166,-2,0,2
230,ASV,P005094,P012731,7.3,-3,12,15
230,ASV,P011225,P012080,3.983,-3,10,13
230,ASV,P011225,P012729,6.066,0,16,16
230,ASV,P011225,P012731,0.267,0,2,2
230,ASV,P011225,PKIR,3.55,-1,10,11
230,ASV,P011386,P012080,10.051,-11,13,24
230,ASV,P011386,P012729,11.668,-12,21,33
230,ASV,P011386,P012731,13.601,-6,24,30
230,ASV,P011386,PKIR,6.267,-7,9,16
230,ASV,P012080,P012729,17.5,-14,26,40
230,ASV,P012080,P012731,13.534,-8,15,23
230,ASV,P012080,PKIR,14.867,-9,24,33
230,ASV,P012729,P012731,13.084,-4,19,23
230,ASV,P012729,PKIR,14.867,-9,24,33
230,ASV,P012731,PKIR,10.484,-7,13,20
230,BAS,P003198,P004603,5.033,0,10,10
230,BAS,P003198,P004761,10.966,2,15,13
230,BAS,P003198,P007946,0.267,-2,0,2
230,BAS,P003198,P008850,6.05,-1,6,7
230,BAS,P003198,P009048,19.449,7,36,29
230,BAS,P003198,P010444,14.416,7,26,19
230,BAS,P003198,P011085,8.75,3,21,18
230,BAS,P003198,P011948,12.683,4,28,24
230,BAS,P003198,P012201,1.25,0,2,2
230,BAS,P004603,P004761,3.917,2,12,10
230,BAS,P004603,P008850,3.917,2,12,10
230,BAS,P004603,P009048,11.567,0,28,28
230,BAS,P004603,P011085,7.65,-2,16,18
230,BAS,P004603,P011948,7.65,-2,16,18
230,BAS,P004603,P012201,6.534,0,18,18
230,BAS,P004761,P007946,3.167,4,8,4
230,BAS,P004761,P008850,16.767,7,34,27
230,BAS,P004761,P009048,20.765,13,47,34
230,BAS,P004761,P010444,20.265,17,43,26
230,BAS,P004761,P011085,2.283,6,9,3
230,BAS,P004761,P011948,4.416,2,10,8
230,BAS,P004761,P012201,14.733,15,42,27
230,BAS,P004761,P012765,0.517,0,0,0
230,BAS,P007946,P008850,3.167,4,8,4
230,BAS,P007946,P010444,2.9,6,8,2
230,BAS,P007946,P012201,3.167,4,8,4
230,BAS,P008850,P009048,13.083,3,26,23
230,BAS,P008850,P010444,13.383,5,24,19
230,BAS,P008850,P012201,11.784,4,30,26
230,BAS,P008850,P012365,0.8,-2,2,4
230,BAS,P008850,P012765,1.317,-2,2,4
230,BAS,P009048,P010444,23.948,12,56,44
230,BAS,P009048,P011085,17.033,5,46,41
230,BAS,P009048,P011948,19.166,1,47,46
230,BAS,P009048,P012201,17.049,7,50,43
230,BAS,P010444,P011085,9.383,7,30,23
230,BAS,P010444,P011948,11.516,3,31,28
230,BAS,P010444,P012201,14.732,11,42,31
230,BAS,P010444,P012365,0.8,-2,2,4
230,BAS,P010444,P012765,1.317,-2,2,4
230,BAS,P011085,P011948,14.75,-1,37,38
230,BAS,P011085,P012201,8.283,2,25,23
230,BAS,P011948,P012201,6.483,-3,19,22
230,BAS,P012201,P012365,0.8,-2,2,4
230,BAS,P012201,P012765,1.317,-2,2,4
230,BAS,P012365,P012765,0.8,-2,2,4
231,RED,P000848,P002553,13.833,-8,30,38
231,RED,P000848,P004720,2.067,-3,4,7
231,RED,P000848,P005099,2.016,2,4,2
231,RED,P000848,P006436,19.983,0,50,50
231,RED,P000848,P007960,9.983,7,26,19
231,RED,P000848,P009035,17.033,-3,41,44
231,RED,P000848,P011941,6.866,2,17,15
231,RED,P000848,P012044,22.166,-3,54,57
231,RED,P000848,P012801,2.249,2,6,4
231,RED,P002553,P004720,3.15,-6,4,10
231,RED,P002553,P005099,1.65,-3,1,4
231,RED,P002553,P006436,15.866,-8,33,41
231,RED,P002553,P008966,2.433,0,6,6
231,RED,P002553,P009035,14.933,-11,30,41
231,RED,P002553,P011941,1.65,-3,1,4
231,RED,P002553,P012044,17.549,-11,36,47
231,RED,P002553,P012801,5.0,-6,7,13
231,RED,P004720,P005099,4.217,-2,6,8
231,RED,P004720,P006436,0.817,-1,3,4
231,RED,P004720,P007960,6.117,2,14,12
231,RED,P004720,P008966,4.217,-2,6,8
231,RED,P004720,P009035,5.033,-2,12,14
231,RED,P004720,P011964,0.567,0,0,0
231,RED,P004720,P012044,5.05,-2,12,14
231,RED,P004720,P012801,5.833,0,11,11
231,RED,P005099,P006436,3.55,-4,5,9
231,RED,P005099,P007960,8.133,-1,14,15
231,RED,P005099,P008966,4.217,-2,6,8
231,RED,P005099,P009035,0.283,-2,0,2
231,RED,P005099,P011941,5.15,0,9,9
231,RED,P005099,P011964,0.567,0,0,0
231,RED,P005099,P012044,1.566,-3,2,5
231,RED,P005099,P012801,7.783,-1,13,14
231,RED,P006436,P007960,13.434,7,37,30
231,RED,P006436,P008966,2.433,0,6,6
231,RED,P006436,P009035,16.233,-2,42,44
231,RED,P006436,P011941,10.85,1,24,23
231,RED,P006436,P012044,27.416,0,69,69
231,RED,P006436,P012801,7.55,3,19,16
231,RED,P007960,P008966,4.217,-2,6,8
231,RED,P007960,P009035,5.3,8,19,11
231,RED,P007960,P011941,11.083,6,27,21
231,RED,P007960,P011964,0.567,0,0,0
231,RED,P007960,P012044,14.0,10,40,30
231,RED,P007960,P012801,10.166,11,25,14
231,RED,P008966,P011964,0.567,0,0,0
231,RED,P008966,P012044,2.433,0,6,6
231,RED,P008966,P012801,6.083,-2,12,14
231,RED,P009035,P012044,20.466,-3,51,54
231,RED,P009035,P012801,2.583,3,9,6
231,RED,P011941,P012044,8.733,2,21,19
231,RED,P011941,P012801,6.6,4,13,9
231,RED,P012044,P012801,7.749,6,21,15
231,ZAL,P002329,P002676,2.483,-4,3,7
231,ZAL,P002329,P003210,2.467,-4,3,7
231,ZAL,P002329,P003211,11.699,1,30,29
231,ZAL,P002329,P005504,25.399,2,62,60
231,ZAL,P002329,P007109,20.433,10,54,44
231,ZAL,P002329,P007513,18.883,8,51,43
231,ZAL,P002329,P010390,1.65,2,4,2
231,ZAL,P002329,P011218,21.699,12,59,47
231,ZAL,P002329,P012715,2.1,-3,3,6
231,ZAL,P002329,P012787,3.183,-8,3,11
231,ZAL,P002676,P003210,2.566,0,6,6
231,ZAL,P002676,P003211,7.1,2,13,11
231,ZAL,P002676,P005504,2.316,-6,2,8
231,ZAL,P002676,P007109,0.133,0,0,0
231,ZAL,P002676,P007513,5.883,-6,7,13
231,ZAL,P002676,P010390,10.017,-1,17,18
231,ZAL,P002676,P011218,4.25,-8,4,12
231,ZAL,P002676,P012715,9.684,-2,16,18
231,ZAL,P002676,P012787,5.3,-3,8,11
231,ZAL,P003210,P005504,2.467,-4,3,7
231,ZAL,P003210,P007109,2.6,-4,3,7
231,ZAL,P003210,P007513,5.033,-4,9,13
231,ZAL,P003210,P010390,2.566,0,6,6
231,ZAL,P003210,P012715,2.433,0,6,6
231,ZAL,P003211,P005504,12.432,-3,33,36
231,ZAL,P003211,P007109,8.483,3,25,22
231,ZAL,P003211,P007513,7.449,0,22,22
231,ZAL,P003211,P010390,7.284,6,14,8
231,ZAL,P003211,P011218,10.533,7,31,24
231,ZAL,P003211,P012715,7.884,-1,13,14
231,ZAL,P003211,P012787,7.8,-3,15,18
231,ZAL,P005504,P007109,22.633,11,61,50
231,ZAL,P005504,P007513,20.766,9,57,48
231,ZAL,P005504,P011218,23.049,12,62,50
231,ZAL,P005504,P012715,1.85,-8,0,8
231,ZAL,P005504,P012787,3.816,-13,4,17
231,ZAL,P007109,P007513,17.966,9,51,42
231,ZAL,P007109,P010390,0.133,0,0,0
231,ZAL,P007109,P011218,18.6,17,54,37
231,ZAL,P007109,P012787,1.483,-2,4,6
231,ZAL,P007513,P010390,4.983,-5,7,12
231,ZAL,P007513,P011218,17.85,11,50,39
231,ZAL,P007513,P012715,4.5,-4,6,10
231,ZAL,P007513,P012787,1.483,-2,4,6
231,ZAL,P010390,P011218,1.834,-2,2,4
231,ZAL,P010390,P012715,9.934,3,19,16
231,ZAL,P010390,P012787,5.067,5,11,6
231,ZAL,P011218,P012715,2.434,-4,2,6
231,ZAL,P011218,P012787,1.083,-5,0,5
231,ZAL,P012715,P012787,6.317,-1,11,12
232,BAR,P000925,P002939,8.716,11,31,20
232,BAR,P000925,P003204,1.833,5,5,0
232,BAR,P000925,P004866,10.333,13,35,22
232,BAR,P000925,P006435,10.799,20,40,20
232,BAR,P000925,P007519,3.45,7,9,2
232,BAR,P000925,P009992,1.367,-2,0,2
232,BAR,P000925,P011244,10.799,20,40,20
232,BAR,P000925,P012745,1.367,-2,0,2
232,BAR,P002939,P003196,8.816,11,23,12
232,BAR,P002939,P003204,7.516,10,19,9
232,BAR,P002939,P004866,9.416,9,33,24
232,BAR,P002939,P006435,11.716,12,39,27
232,BAR,P002939,P007464,1.2,0,2,2
232,BAR,P002939,P009992,6.533,7,15,8
232,BAR,P002939,P010641,0.483,-3,0,3
232,BAR,P002939,P011244,14.882,17,48,31
232,BAR,P002939,P012745,3.25,2,6,4
232,BAR,P003196,P003204,6.95,8,16,8
232,BAR,P003196,P004866,6.95,11,19,8
232,BAR,P003196,P006435,6.817,12,20,8
232,BAR,P003196,P007464,5.2,-5,7,12
232,BAR,P003196,P007519,10.284,3,19,16
232,BAR,P003196,P009992,12.283,2,22,20
232,BAR,P003196,P011244,11.85,17,31,14
232,BAR,P003196,P012745,7.25,-3,11,14
232,BAR,P003204,P006435,3.833,7,10,3
232,BAR,P003204,P007464,3.467,-8,4,12
232,BAR,P003204,P007519,10.001,-13,13,26
232,BAR,P003204,P009992,13.801,-10,22,32
232,BAR,P003204,P010641,8.617,-16,11,27
232,BAR,P003204,P011244,14.05,5,28,23
232,BAR,P004866,P006435,14.383,22,50,28
232,BAR,P004866,P007519,7.867,15,21,6
232,BAR,P004866,P009992,2.9,2,4,2
232,BAR,P004866,P011244,13.866,24,50,26
232,BAR,P004866,P012745,3.417,0,4,4
232,BAR,P006435,P007519,6.5,17,21,4
232,BAR,P006435,P009992,0.117,0,0,0
232,BAR,P006435,P010641,0.483,-3,0,3
232,BAR,P006435,P011244,17.699,31,60,29
232,BAR,P006435,P012745,0.517,-2,0,2
232,BAR,P007464,P007519,7.467,-13,9,22
232,BAR,P007464,P009992,8.667,-13,11,24
232,BAR,P007464,P010641,3.467,-8,4,12
232,BAR,P007464,P012745,5.2,-5,7,12
232,BAR,P007519,P009992,15.368,-20,18,38
232,BAR,P007519,P010641,8.134,-13,11,24
232,BAR,P007519,P011244,13.034,12,30,18
232,BAR,P007519,P012745,5.367,-7,5,12
232,BAR,P009992,P010641,8.134,-13,11,24
232,BAR,P009992,P011244,10.334,-2,18,20
232,BAR,P009992,P012745,8.1,-3,11,14
232,BAR,P010641,P011244,5.15,-8,7,15
232,BER,P003958,P006251,1.9,0,4,4
232,BER,P003958,P006819,6.833,-1,12,13
232,BER,P003958,P007025,8.117,-7,15,22
232,BER,P003958,P008173,13.816,-10,23,33
232,BER,P003958,P008211,6.45,-11,8,19
232,BER,P003958,P008384,8.766,-1,15,16
232,BER,P003958,P008780,1.9,0,4,4
232,BER,P003958,P008967,2.5,-2,4,6
232,BER,P003958,P010791,6.983,-9,11,20
232,BER,P003958,P011934,0.117,0,0,0
232,BER,P003958,P012721,5.95,1,12,11
232,BER,P006251,P006819,0.4,0,0,0
232,BER,P006251,P007025,5.967,6,12,6
232,BER,P006251,P008173,5.133,0,4,4
232,BER,P006251,P008211,7.117,5,26,21
232,BER,P006251,P008384,9.184,-4,16,20
232,BER,P006251,P008780,14.984,-19,28,47
232,BER,P006251,P008967,15.667,-19,28,47
232,BER,P006251,P010791,8.167,3,16,13
232,BER,P006251,P011934,11.167,-16,20,36
232,BER,P006251,P012721,6.85,-8,6,14
232,BER,P006819,P007025,7.333,5,18,13
232,BER,P006819,P008173,7.233,-1,12,13
232,BER,P006819,P008211,7.783,-1,16,17
232,BER,P006819,P008384,7.916,14,24,10
232,BER,P006819,P008967,0.4,0,0,0
232,BER,P006819,P012721,8.766,8,22,14
232,BER,P007025,P008173,12.45,-7,19,26
232,BER,P007025,P008211,9.634,9,28,19
232,BER,P007025,P008384,14.833,10,35,25
232,BER,P007025,P010791,11.067,1,23,22
232,BER,P007025,P011934,0.117,0,0,0
232,BER,P007025,P012721,4.55,7,14,7
232,BER,P008173,P008211,6.85,-11,8,19
232,BER,P008173,P008384,12.699,-1,19,20
232,BER,P008173,P008967,1.283,-2,0,2
232,BER,P008173,P010791,11.433,-9,15,24
232,BER,P008173,P011934,0.283,0,0,0
232,BER,P008173,P012721,4.616,1,8,7
232,BER,P008211,P008384,7.233,11,22,11
232,BER,P008211,P008780,5.2,-1,18,19
232,BER,P008211,P008967,5.2,-1,18,19
232,BER,P008211,P010791,5.017,3,14,11
232,BER,P008211,P011934,5.2,-1,18,19
232,BER,P008211,P012721,6.316,2,16,14
232,BER,P008384,P008780,3.617,-10,4,14
232,BER,P008384,P008967,4.217,-12,4,16
232,BER,P008384,P010791,12.933,-5,21,26
232,BER,P008384,P011934,1.534,-7,0,7
232,BER,P008384,P012721,6.6,13,20,7
232,BER,P008780,P008967,14.984,-19,28,47
232,BER,P008780,P010791,2.2,-3,4,7
232,BER,P008780,P011934,10.884,-16,20,36
232,BER,P008780,P012721,6.167,-8,6,14
232,BER,P008967,P010791,2.8,-5,4,9
232,BER,P008967,P011934,11.167,-16,20,36
232,BER,P008967,P012721,6.85,-8,6,14
232,BER,P011934,P012721,4.667,-8,2,10
233,PAN,P002328,P003842,18.667,-6,32,38
233,PAN,P002328,P007866,14.184,-15,17,32
233,PAN,P002328,P007947,2.05,-10,0,10
233,PAN,P002328,P011204,20.834,-4,36,40
233,PAN,P002328,P011209,1.434,-3,2,5
233,PAN,P002328,P011221,3.25,-4,4,8
233,PAN,P002328,P012712,7.733,5,19,14
233,PAN,P002328,P012774,19.516,-3,34,37
233,PAN,P003842,P007866,14.9,-7,20,27
233,PAN,P003842,P007947,4.9,0,10,10
233,PAN,P003842,P011204,29.133,9,52,43
233,PAN,P003842,P011209,15.767,7,27,20
233,PAN,P003842,P012712,20.166,21,47,26
233,PAN,P003842,P012774,32.599,12,60,48
233,PAN,P007866,P007947,1.334,-6,0,6
233,PAN,P007866,P011204,17.783,-9,24,33
233,PAN,P007866,P011209,3.867,-2,4,6
233,PAN,P007866,P011221,3.25,-4,4,8
233,PAN,P007866,P012712,1.033,5,5,0
233,PAN,P007866,P012774,16.249,-6,22,28
233,PAN,P007947,P011204,2.817,0,6,6
233,PAN,P007947,P011209,7.184,8,18,10
233,PAN,P007947,P011221,3.684,2,8,6
233,PAN,P007947,P012712,7.25,8,18,10
233,PAN,P007947,P012774,5.117,6,12,6
233,PAN,P011204,P011209,13.15,9,23,14
233,PAN,P011204,P011221,5.1,0,10,10
233,PAN,P011204,P012712,17.483,23,43,20
233,PAN,P011204,P012774,30.632,8,54,46
233,PAN,P011209,P011221,2.717,6,8,2
233,PAN,P011209,P012712,14.617,15,31,16
233,PAN,P011209,P012774,15.2,12,27,15
233,PAN,P011221,P012712,2.717,6,8,2
233,PAN,P011221,P012774,3.15,2,6,4
233,PAN,P012712,P012774,20.533,25,49,24
233,ULK,P001932,P002968,17.583,1,28,27
233,ULK,P001932,P004004,8.017,-6,10,16
233,ULK,P001932,P005844,3.417,-6,2,8
233,ULK,P001932,P006068,11.216,6,20,14
233,ULK,P001932,P006661,17.55,1,27,26
233,ULK,P001932,P006961,12.034,-16,12,28
233,ULK,P001932,P008962,26.234,-10,37,47
233,ULK,P001932,P009849,7.051,-9,9,18
233,ULK,P001932,P011157,8.634,-9,11,20
233,ULK,P002968,P004004,5.9,-2,8,10
233,ULK,P002968,P006068,9.516,6,17,11
233,ULK,P002968,P006661,12.883,6,23,17
233,ULK,P002968,P006961,4.7,-5,5,10
233,ULK,P002968,P008962,17.583,1,28,27
233,ULK,P002968,P009849,2.167,-3,3,6
233,ULK,P004004,P005844,1.317,-1,2,3
233,ULK,P004004,P006661,8.267,-5,10,15
233,ULK,P004004,P006961,3.684,-4,4,8
233,ULK,P004004,P008962,10.834,-8,14,22
233,ULK,P004004,P009849,2.984,-6,2,8
233,ULK,P004004,P011157,5.801,-8,6,14
233,ULK,P005844,P006661,1.717,-4,0,4
233,ULK,P005844,P006961,4.734,-7,4,11
233,ULK,P005844,P008962,2.167,-3,2,5
233,ULK,P005844,P009849,2.567,-4,2,6
233,ULK,P005844,P011157,3.017,-3,4,7
233,ULK,P006068,P006661,11.266,13,26,13
233,ULK,P006068,P006961,8.866,4,17,13
233,ULK,P006068,P008962,12.466,9,23,14
233,ULK,P006068,P009849,0.9,2,2,0
233,ULK,P006068,P011052,5.533,8,14,6
233,ULK,P006068,P011157,7.233,8,17,9
233,ULK,P006661,P006961,14.167,-6,23,29
233,ULK,P006661,P008962,22.767,-5,35,40
233,ULK,P006661,P011052,7.133,2,17,15
233,ULK,P006661,P011157,12.45,-2,23,25
233,ULK,P006961,P008962,17.251,-16,23,39
233,ULK,P006961,P009849,4.901,-9,5,14
233,ULK,P006961,P011052,8.383,5,20,15
233,ULK,P006961,P011157,17.684,-6,31,37
233,ULK,P008962,P009849,5.351,-7,7,14
233,ULK,P008962,P011052,4.1,0,9,9
233,ULK,P008962,P011157,13.851,-9,22,31
233,ULK,P009849,P011157,5.751,-8,6,14
233,ULK,P011052,P011157,8.383,5,20,15
234,MCO,P002581,P004197,6.817,8,17,9
234,MCO,P002581,P005985,10.9,8,25,17
234,MCO,P002581,P009754,9.716,3,20,17
234,MCO,P002581,P010588,3.417,2,6,4
234,MCO,P002581,P011212,11.25,5,24,19
234,MCO,P002581,P011226,11.416,1,25,24
234,MCO,P002581,P011231,11.816,5,27,22
234,MCO,P004197,P005985,5.3,8,15,7
234,MCO,P004197,P009754,3.65,5,12,7
234,MCO,P004197,P011196,2.133,5,10,5
234,MCO,P004197,P011212,5.3,10,17,7
234,MCO,P004197,P011226,3.65,3,10,7
234,MCO,P004197,P011231,8.95,13,27,14
234,MCO,P005985,P009754,19.066,-6,32,38
234,MCO,P005985,P010588,19.667,-7,31,38
234,MCO,P005985,P011196,4.983,0,12,12
234,MCO,P005985,P011212,16.167,4,29,25
234,MCO,P005985,P011226,27.299,-3,53,56
234,MCO,P005985,P011231,12.849,4,29,25
234,MCO,P005985,PLCZ,17.233,-4,26,30
234,MCO,P009754,P010588,14.8,-5,25,30
234,MCO,P009754,P011196,3.933,1,14,13
234,MCO,P009754,P011212,12.15,2,26,24
234,MCO,P009754,P011226,17.632,-8,33,41
234,MCO,P009754,P011231,9.799,0,22,22
234,MCO,P009754,PLCZ,12.05,-8,16,24
234,MCO,P010588,P011196,1.95,-1,7,8
234,MCO,P010588,P011212,9.284,-3,11,14
234,MCO,P010588,P011226,15.25,-6,26,32
234,MCO,P010588,P011231,0.25,-3,0,3
234,MCO,P010588,PLCZ,14.05,-5,18,23
234,MCO,P011196,P011212,3.45,3,12,9
234,MCO,P011196,P011226,4.05,-3,9,12
234,MCO,P011196,P011231,4.233,3,12,9
234,MCO,P011212,P011226,13.083,-3,25,28
234,MCO,P011212,P011231,12.666,5,33,28
234,MCO,P011212,PLCZ,7.85,1,11,10
234,MCO,P011226,P011231,14.182,-4,30,34
234,MCO,P011226,PLCZ,14.566,-1,25,26
234,MCO,P011231,PLCZ,3.183,1,8,7
234,VIR,P001133,P001844,18.001,9,38,29
234,VIR,P001133,P003048,15.884,0,25,25
234,VIR,P001133,P003527,1.083,-2,0,2
234,VIR,P001133,P004007,4.083,-4,4,8
234,VIR,P001133,P004554,4.733,-1,10,11
234,VIR,P001133,P006739,10.683,-1,21,22
234,VIR,P001133,P008847,5.567,8,20,12
234,VIR,P001133,P009549,15.284,0,26,26
234,VIR,P001133,P010781,11.983,6,30,24
234,VIR,P001133,PBCN,19.367,13,46,33
234,VIR,P001844,P002084,4.25,1,9,8
234,VIR,P001844,P003048,13.184,5,22,17
234,VIR,P001844,P003527,3.366,-3,4,7
234,VIR,P001844,P006739,2.017,1,4,3
234,VIR,P001844,P008847,13.017,2,29,27
234,VIR,P001844,P009549,20.484,4,36,32
234,VIR,P001844,P010781,14.384,2,29,27
234,VIR,P001844,PBCN,16.101,7,33,26
234,VIR,P002084,P006739,1.483,-3,3,6
234,VIR,P002084,P008847,5.733,-2,12,14
234,VIR,P002084,P009549,4.117,3,9,6
234,VIR,P002084,P010781,5.733,-2,12,14
234,VIR,P002084,PBCN,1.616,-5,3,8
234,VIR,P003048,P004007,0.7,-2,0,2
234,VIR,P003048,P006739,2.7,-5,3,8
234,VIR,P003048,P009549,14.017,3,25,22
234,VIR,P003048,P010781,1.867,-3,0,3
234,VIR,P003048,PBCN,15.184,2,25,23
234,VIR,P003527,P004007,0.483,0,0,0
234,VIR,P003527,P006739,1.95,-3,4,7
234,VIR,P003527,P008847,4.833,-6,8,14
234,VIR,P003527,P009549,4.233,-4,8,12
234,VIR,P003527,P010781,5.316,-6,8,14
234,VIR,P004007,P004554,2.9,-2,4,6
234,VIR,P004007,P006739,4.083,-4,4,8
234,VIR,P004007,P009549,1.367,-4,0,4
234,VIR,P004007,P010781,2.716,0,4,4
234,VIR,P004554,P006739,7.183,-3,13,16
234,VIR,P004554,P008847,2.45,-2,3,5
234,VIR,P004554,P009549,0.667,-2,0,2
234,VIR,P004554,P010781,6.516,-1,13,14
234,VIR,P004554,PBCN,4.283,-1,9,10
234,VIR,P006739,P008847,7.9,-3,18,21
234,VIR,P006739,P009549,4.067,-7,7,14
234,VIR,P006739,P010781,12.949,-5,28,33
234,VIR,P006739,PBCN,8.249,-3,19,22
234,VIR,P008847,P009549,9.867,-4,18,22
234,VIR,P008847,P010781,18.9,-2,43,45
234,VIR,P008847,PBCN,7.333,1,21,20
234,VIR,P009549,P010781,9.867,-4,18,22
234,VIR,P009549,PBCN,14.234,3,25,22
234,VIR,P010781,PBCN,11.033,-1,27,28
235,BER,P003958,P006919,11.432,-13,13,26
235,BER,P003958,P007025,3.65,-2,9,11
235,BER,P003958,P008173,7.484,-10,12,22
235,BER,P003958,P008211,10.916,-11,20,31
235,BER,P003958,P008384,1.367,0,5,5
235,BER,P003958,P008780,14.883,-24,21,45
235,BER,P003958,P008967,10.967,-17,12,29
235,BER,P003958,P011934,15.351,-22,26,48
235,BER,P003958,P012720,11.25,-21,15,36
235,BER,P003958,P012721,8.5,-8,15,23
235,BER,P006251,P006919,5.6,0,13,13
235,BER,P006251,P007025,7.467,1,19,18
235,BER,P006251,P008173,6.017,4,15,11
235,BER,P006251,P008211,3.133,6,12,6
235,BER,P006251,P008384,1.967,0,3,3
235,BER,P006251,P008780,7.55,-5,15,20
235,BER,P006251,P008967,4.933,-4,7,11
235,BER,P006251,P011934,5.916,-2,11,13
235,BER,P006251,P012720,6.0,-1,14,15
235,BER,P006251,P012721,9.617,5,27,22
235,BER,P006919,P007025,1.883,2,4,2
235,BER,P006919,P008173,4.95,-2,8,10
235,BER,P006919,P008211,12.099,-9,21,30
235,BER,P006919,P008384,1.5,-4,0,4
235,BER,P006919,P008780,10.582,-13,14,27
235,BER,P006919,P008967,6.433,-8,5,13
235,BER,P006919,P011934,6.983,-11,7,18
235,BER,P006919,P012720,3.766,-8,3,11
235,BER,P006919,P012721,8.9,-2,16,18
235,BER,P007025,P008173,4.567,-4,7,11
235,BER,P007025,P008211,2.866,4,8,4
235,BER,P007025,P008384,3.634,0,8,8
235,BER,P007025,P008780,3.984,-1,13,14
235,BER,P007025,P011934,2.35,2,9,7
235,BER,P007025,P012720,5.217,-5,12,17
235,BER,P007025,P012721,10.05,-1,23,24
235,BER,P008173,P008211,4.917,0,15,15
235,BER,P008173,P008384,1.967,0,3,3
235,BER,P008173,P008967,4.017,-2,5,7
235,BER,P008173,P011934,3.984,0,12,12
235,BER,P008173,P012720,4.117,-2,9,11
235,BER,P008173,P012721,11.984,-8,22,30
235,BER,P008211,P008384,1.5,-4,0,4
235,BER,P008211,P008780,6.649,-9,9,18
235,BER,P008211,P011934,6.983,-7,13,20
235,BER,P008211,P012720,3.283,-8,3,11
235,BER,P008211,P012721,9.85,2,27,25
235,BER,P008384,P008780,1.45,0,5,5
235,BER,P008384,P011934,1.367,0,5,5
235,BER,P008384,P012720,1.2,-4,0,4
235,BER,P008384,P012721,3.384,-4,3,7
235,BER,P008780,P008967,11.883,-19,14,33
235,BER,P008780,P011934,16.3,-26,21,47
235,BER,P008780,P012720,13.216,-20,20,40
235,BER,P008780,P012721,3.567,1,12,11
235,BER,P008967,P011934,12.917,-17,19,36
235,BER,P008967,P012720,9.95,-13,14,27
235,BER,P008967,P012721,2.5,-4,0,4
235,BER,P011934,P012720,9.467,-13,14,27
235,BER,P011934,P012721,3.45,0,11,11
235,BER,P012720,P012721,6.334,-9,12,21
235,TEL,P004233,P005145,3.0,-4,4,8
235,TEL,P004233,P007990,4.467,-2,6,8
235,TEL,P004233,P011193,0.6,2,2,0
235,TEL,P004233,P011199,2.5,4,4,0
235,TEL,P004233,P011971,2.067,4,4,0
235,TEL,P004233,P012095,5.067,0,8,8
235,TEL,P004233,P012744,2.567,-4,4,8
235,TEL,P005145,P007990,3.0,-4,4,8
235,TEL,P005145,P009622,13.8,17,40,23
235,TEL,P005145,P009783,14.2,20,42,22
235,TEL,P005145,P009863,14.617,19,42,23
235,TEL,P005145,P011193,0.817,2,2,0
235,TEL,P005145,P011199,14.233,17,40,23
235,TEL,P005145,P011214,0.817,2,2,0
235,TEL,P005145,P012095,3.0,-4,4,8
235,TEL,P005145,P012744,2.984,-5,4,9
235,TEL,P007990,P011193,7.717,9,21,12
235,TEL,P007990,P011199,1.9,2,2,0
235,TEL,P007990,P011214,7.717,9,21,12
235,TEL,P007990,P011971,9.184,11,23,12
235,TEL,P007990,P012095,4.467,-2,6,8
235,TEL,P007990,P012744,10.284,5,25,20
235,TEL,P009622,P009783,16.3,21,50,29
235,TEL,P009622,P009863,18.934,16,54,38
235,TEL,P009622,P011193,2.983,0,7,7
235,TEL,P009622,P011199,16.867,20,50,30
235,TEL,P009622,P011214,5.05,-4,11,15
235,TEL,P009622,P011971,8.117,-1,21,22
235,TEL,P009622,P012744,5.617,-5,11,16
235,TEL,P009783,P009863,17.85,26,55,29
235,TEL,P009783,P011193,1.55,5,5,0
235,TEL,P009783,P011199,16.6,23,52,29
235,TEL,P009783,P011214,1.25,3,3,0
235,TEL,P009783,P011971,3.65,6,13,7
235,TEL,P009863,P011193,2.967,6,9,3
235,TEL,P009863,P011199,17.717,26,56,30
235,TEL,P009863,P011214,4.184,-4,7,11
235,TEL,P009863,P011971,7.284,3,21,18
235,TEL,P009863,P012744,4.051,-4,8,12
235,TEL,P011193,P011199,1.75,8,8,0
235,TEL,P011193,P011214,14.85,13,38,25
235,TEL,P011193,P011971,15.783,19,44,25
235,TEL,P011193,P012095,2.933,6,9,3
235,TEL,P011193,P012744,14.45,14,39,25
235,TEL,P011199,P011971,6.134,13,20,7
235,TEL,P011199,P012095,2.5,4,4,0
235,TEL,P011199,P012744,1.267,3,4,1
235,TEL,P011214,P011971,16.25,7,40,33
235,TEL,P011214,P012095,2.333,4,7,3
235,TEL,P011214,P012744,15.817,6,39,33
235,TEL,P011971,P012095,4.4,8,11,3
235,TEL,P011971,P012744,16.667,10,43,33
235,TEL,P012095,P012744,4.9,0,11,11
236,IST,P004888,P006372,0.417,0,0,0
236,IST,P004888,P006590,21.183,-2,61,63
236,IST,P004888,P007200,21.0,-6,56,62
236,IST,P004888,P009513,2.534,-1,4,5
236,IST,P004888,P009664,20.116,1,51,50
236,IST,P004888,P009846,3.134,-5,10,15
236,IST,P004888,P011078,8.0,-7,15,22
236,IST,P004888,P011981,12.867,-3,35,38
236,IST,P004888,P012710,2.117,-1,4,5
236,IST,P004888,P012788,4.133,-2,8,10
236,IST,P004888,PLHK,10.767,-6,28,34
236,IST,P006372,P009513,0.417,0,0,0
236,IST,P006372,P009664,0.417,0,0,0
236,IST,P006372,P011981,0.3,0,0,0
236,IST,P006372,P012788,0.117,0,0,0
236,IST,P006590,P007200,20.417,6,61,55
236,IST,P006590,P009513,3.617,6,10,4
236,IST,P006590,P009664,17.616,6,50,44
236,IST,P006590,P009846,3.134,-5,10,15
236,IST,P006590,P011078,5.917,-2,14,16
236,IST,P006590,P011981,12.617,-1,37,38
236,IST,P006590,P012710,3.617,6,10,4
236,IST,P006590,P012788,1.883,1,5,4
236,IST,P006590,PLHK,12.267,1,34,33
236,IST,P007200,P009513,14.784,-3,24,27
236,IST,P007200,P009664,15.316,3,41,38
236,IST,P007200,P009846,12.184,-13,20,33
236,IST,P007200,P011078,3.617,-5,5,10
236,IST,P007200,P011981,8.184,-1,25,26
236,IST,P007200,P012710,14.784,-3,24,27
236,IST,P007200,P012788,4.016,-2,8,10
236,IST,P007200,PLHK,23.434,-8,48,56
236,IST,P009513,P009664,0.417,0,0,0
236,IST,P009513,P009846,9.05,-8,10,18
236,IST,P009513,P011981,0.3,0,0,0
236,IST,P009513,P012710,14.784,-3,24,27
236,IST,P009513,P012788,0.117,0,0,0
236,IST,P009513,PLHK,14.784,-3,24,27
236,IST,P009664,P011078,8.767,-7,17,24
236,IST,P009664,P011981,10.467,0,26,26
236,IST,P009664,P012788,4.133,-2,8,10
236,IST,P009664,PLHK,6.283,3,19,16
236,IST,P009846,P011981,1.967,0,8,8
236,IST,P009846,P012710,9.05,-8,10,18
236,IST,P009846,PLHK,10.217,-13,12,25
236,IST,P011078,P011981,6.634,-4,14,18
236,IST,P011078,P012788,2.133,-3,3,6
236,IST,P011981,PLHK,1.2,-3,3,6
236,IST,P012710,PLHK,14.784,-3,24,27
236,PAR,P000956,P003983,17.067,11,55,44
236,PAR,P000956,P004172,8.783,-4,27,31
236,PAR,P000956,P007673,13.2,3,35,32
236,PAR,P000956,P008987,20.767,7,63,56
236,PAR,P000956,P009862,6.734,9,28,19
236,PAR,P000956,P011051,2.233,-4,3,7
236,PAR,P000956,P012096,12.217,0,32,32
236,PAR,P000956,P012743,2.067,6,9,3
236,PAR,P003983,P004172,9.517,4,29,25
236,PAR,P003983,P007673,9.65,5,27,22
236,PAR,P003983,P008987,21.534,13,65,52
236,PAR,P003983,P009862,11.034,11,38,27
236,PAR,P003983,P011051,2.233,-4,3,7
236,PAR,P003983,P012096,8.567,4,24,20
236,PAR,P003983,P012743,6.534,8,19,11
236,PAR,P004172,P007673,7.883,-2,18,20
236,PAR,P004172,P008987,25.6,4,60,56
236,PAR,P004172,P009862,21.067,13,52,39
236,PAR,P004172,P011051,1.0,-5,0,5
236,PAR,P004172,P012096,7.833,-2,18,20
236,PAR,P004172,P012742,8.2,2,13,11
236,PAR,P004172,P012743,12.517,6,23,17
236,PAR,P007673,P008987,19.917,0,49,49
236,PAR,P007673,P009862,6.884,-3,14,17
236,PAR,P007673,P011051,1.233,1,3,2
236,PAR,P007673,P012096,16.217,4,42,38
236,PAR,P007673,P012742,2.267,-3,4,7
236,PAR,P007673,P012743,2.417,-5,4,9
236,PAR,P008987,P009862,25.968,12,65,53
236,PAR,P008987,P011051,2.233,-4,3,7
236,PAR,P008987,P012096,16.517,2,42,40
236,PAR,P008987,P012742,10.467,-1,17,18
236,PAR,P008987,P012743,17.001,7,36,29
236,PAR,P009862,P012096,4.717,0,10,10
236,PAR,P009862,P012742,10.467,-1,17,18
236,PAR,P009862,P012743,17.001,7,36,29
236,PAR,P012742,P012743,10.467,-1,17,18
237,MAD,P001392,P003108,14.35,1,38,37
237,MAD,P001392,P003733,6.783,5,16,11
237,MAD,P001392,P004887,3.433,0,6,6
237,MAD,P001392,P005791,17.4,9,46,37
237,MAD,P001392,P005928,22.467,7,58,51
237,MAD,P001392,P006540,4.217,-5,12,17
237,MAD,P001392,P009005,1.817,0,4,4
237,MAD,P001392,P010357,20.85,8,52,44
237,MAD,P001392,PCVM,0.483,-1,0,1
237,MAD,P003108,P004887,13.799,-16,23,39
237,MAD,P003108,P005791,8.8,4,26,22
237,MAD,P003108,P005928,14.4,-3,38,41
237,MAD,P003108,P006540,12.383,-21,24,45
237,MAD,P003108,P009005,5.616,-5,11,16
237,MAD,P003108,P010357,14.45,3,37,34
237,MAD,P003108,PCVM,10.316,-12,17,29
237,MAD,P003108,PTGB,4.75,-11,6,17
237,MAD,P003733,P005791,6.866,5,16,11
237,MAD,P003733,P005928,6.866,5,16,11
237,MAD,P003733,P009005,0.083,0,0,0
237,MAD,P003733,P010357,6.866,5,16,11
237,MAD,P004887,P005928,3.483,-4,6,10
237,MAD,P004887,P006540,10.95,-11,19,30
237,MAD,P004887,P009005,7.983,0,18,18
237,MAD,P004887,P010357,7.583,5,18,13
237,MAD,P004887,PCVM,12.683,-7,24,31
237,MAD,P004887,PTGB,4.75,-11,6,17
237,MAD,P005791,P005928,21.717,3,50,47
237,MAD,P005791,P006540,5.917,-8,10,18
237,MAD,P005791,P009005,6.134,-6,8,14
237,MAD,P005791,P010357,17.267,10,44,34
237,MAD,P005791,PTGB,2.767,-5,0,5
237,MAD,P005928,P006540,8.984,-16,16,32
237,MAD,P005928,P009005,6.667,-11,8,19
237,MAD,P005928,P010357,21.917,8,56,48
237,MAD,P005928,PTGB,2.767,-5,0,5
237,MAD,P006540,P009005,10.017,-6,17,23
237,MAD,P006540,P010357,5.951,1,17,16
237,MAD,P006540,PCVM,10.0,-6,19,25
237,MAD,P006540,PTGB,7.517,-16,6,22
237,MAD,P009005,P010357,7.934,4,20,16
237,MAD,P009005,PCVM,7.45,5,18,13
237,MAD,P009005,PTGB,2.767,-5,0,5
237,MAD,P010357,PCVM,5.05,4,12,8
237,MAD,PCVM,PTGB,4.75,-11,6,17
237,PAN,P001926,P002328,4.617,1,13,12
237,PAN,P001926,P003842,21.4,8,55,47
237,PAN,P001926,P005161,19.633,10,49,39
237,PAN,P001926,P007866,14.434,4,35,31
237,PAN,P001926,P011204,5.234,1,13,12
237,PAN,P001926,P012712,13.9,10,34,24
237,PAN,P001926,P012774,20.25,10,49,39
237,PAN,P002328,P003842,12.617,9,34,25
237,PAN,P002328,P005161,2.383,5,9,4
237,PAN,P002328,P007553,5.433,-7,9,16
237,PAN,P002328,P007866,16.933,-1,40,41
237,PAN,P002328,P011204,19.0,-2,43,45
237,PAN,P002328,P012712,3.367,-1,7,8
237,PAN,P002328,P012774,12.65,-4,25,29
237,PAN,P003842,P005161,19.016,12,51,39
237,PAN,P003842,P007866,16.65,8,44,36
237,PAN,P003842,P011204,12.367,7,32,25
237,PAN,P003842,P012712,12.75,8,32,24
237,PAN,P003842,P012774,22.8,12,56,44
237,PAN,P005161,P007553,0.5,1,3,2
237,PAN,P005161,P007866,11.833,7,32,25
237,PAN,P005161,P011204,2.133,3,7,4
237,PAN,P005161,P012712,13.533,9,35,26
237,PAN,P005161,P012774,20.033,9,50,41
237,PAN,P007553,P007866,5.933,-6,12,18
237,PAN,P007553,P011204,5.433,-7,9,16
237,PAN,P007553,P012712,0.5,1,3,2
237,PAN,P007553,P012774,5.933,-6,12,18
237,PAN,P007866,P011204,17.55,-1,40,41
237,PAN,P007866,P012712,5.017,2,12,10
237,PAN,P007866,P012774,20.65,-1,45,46
237,PAN,P011204,P012712,4.234,1,9,8
237,PAN,P011204,P012774,13.517,-2,27,29
237,PAN,P012712,P012774,17.767,10,44,34
238,PAM,P003960,P006433,13.366,-2,26,28
238,PAM,P003960,P007870,11.233,-1,23,24
238,PAM,P003960,P010393,2.616,-4,3,7
238,PAM,P003960,P010568,11.233,-1,23,24
238,PAM,P003960,P011970,0.633,1,1,0
238,PAM,P003960,P011982,1.083,-1,1,2
238,PAM,P003960,P012740,2.466,-8,2,10
238,PAM,P003960,P012795,12.766,-4,25,29
238,PAM,P004863,P006643,5.75,-8,5,13
238,PAM,P004863,P007870,5.267,3,15,12
238,PAM,P004863,P010393,9.0,-9,19,28
238,PAM,P004863,P010568,5.5,0,15,15
238,PAM,P004863,P011970,14.0,-16,15,31
238,PAM,P004863,P011982,16.967,-13,28,41
238,PAM,P004863,P012738,9.567,-9,13,22
238,PAM,P004863,P012740,0.333,0,0,0
238,PAM,P004863,P012795,1.484,0,2,2
238,PAM,P006433,P007870,14.599,13,36,23
238,PAM,P006433,P010393,8.065,0,17,17
238,PAM,P006433,P010568,14.866,6,32,26
238,PAM,P006433,P011970,0.833,3,3,0
238,PAM,P006433,P011982,5.399,5,12,7
238,PAM,P006433,P012738,1.983,2,5,3
238,PAM,P006433,P012740,5.199,-1,11,12
238,PAM,P006433,P012795,19.282,6,42,36
238,PAM,P006643,P010393,1.55,-4,0,4
238,PAM,P006643,P011970,5.75,-8,5,13
238,PAM,P006643,P011982,5.75,-8,5,13
238,PAM,P006643,P012738,4.2,-4,5,9
238,PAM,P007870,P010393,6.566,1,18,17
238,PAM,P007870,P010568,20.216,4,45,41
238,PAM,P007870,P011970,2.667,4,6,2
238,PAM,P007870,P011982,7.883,12,24,12
238,PAM,P007870,P012740,3.366,-6,4,10
238,PAM,P007870,P012795,16.199,2,33,31
238,PAM,P010393,P010568,7.266,-7,16,23
238,PAM,P010393,P011970,6.666,-11,7,18
238,PAM,P010393,P011982,12.316,-10,25,35
238,PAM,P010393,P012738,5.7,-1,13,14
238,PAM,P010393,P012740,6.849,-6,11,17
238,PAM,P010393,P012795,8.266,-5,15,20
238,PAM,P010568,P011970,2.7,-1,4,5
238,PAM,P010568,P011982,9.616,4,24,20
238,PAM,P010568,P012740,2.133,-8,0,8
238,PAM,P010568,P012795,16.466,-5,29,34
238,PAM,P011970,P011982,14.833,-13,18,31
238,PAM,P011970,P012738,9.4,-11,11,22
238,PAM,P011970,P012740,0.333,0,0,0
238,PAM,P011970,P012795,1.517,0,2,2
238,PAM,P011982,P012738,9.567,-9,13,22
238,PAM,P011982,P012740,0.783,-2,0,2
238,PAM,P011982,P012795,5.267,3,10,7
238,PAM,P012738,P012740,2.316,2,5,3
238,PAM,P012738,P012795,3.467,2,7,5
238,PAM,P012740,P012795,6.882,-7,11,18
238,VIR,P001133,P001844,6.25,-5,12,17
238,VIR,P001133,P003048,4.967,-4,7,11
238,VIR,P001133,P008847,1.283,-1,5,6
238,VIR,P001133,P009549,6.25,-5,12,17
238,VIR,P001133,PBCN,6.25,-5,12,17
238,VIR,P001844,P002084,12.05,5,23,18
238,VIR,P001844,P003048,12.2,-4,21,25
238,VIR,P001844,P003527,2.5,1,3,2
238,VIR,P001844,P006739,0.333,-2,0,2
238,VIR,P001844,P008847,5.917,9,17,8
238,VIR,P001844,P009549,17.983,3,38,35
238,VIR,P001844,P010781,0.467,0,0,0
238,VIR,P001844,PBCN,16.1,5,38,33
238,VIR,P002084,P003048,7.233,0,14,14
238,VIR,P002084,P003527,8.783,6,18,12
238,VIR,P002084,P006739,13.767,8,33,25
238,VIR,P002084,P008847,17.918,17,42,25
238,VIR,P002084,P009549,17.7,4,35,31
238,VIR,P002084,P010781,8.501,12,22,10
238,VIR,P002084,PBCN,15.984,8,37,29
238,VIR,P003048,P009549,12.2,-4,21,25
238,VIR,P003048,PBCN,12.2,-4,21,25
238,VIR,P003527,P004554,7.25,1,14,13
238,VIR,P003527,P006739,14.183,7,32,25
238,VIR,P003527,P008847,16.017,12,35,23
238,VIR,P003527,P009549,5.316,1,10,9
238,VIR,P003527,P010781,11.034,9,25,16
238,VIR,P003527,PBCN,0.317,3,3,0
238,VIR,P004554,P006739,7.95,0,16,16
238,VIR,P004554,P008847,7.95,0,16,16
238,VIR,P004554,P009549,0.5,-1,0,1
238,VIR,P004554,P010781,7.45,1,16,15
238,VIR,P004554,PBCN,0.7,-1,2,3
238,VIR,P006739,P008847,21.551,10,49,39
238,VIR,P006739,P009549,6.95,-4,12,16
238,VIR,P006739,P010781,15.651,13,38,25
238,VIR,P006739,PBCN,7.151,0,16,16
238,VIR,P008847,P009549,12.067,7,29,22
238,VIR,P008847,P010781,16.118,13,38,25
238,VIR,P008847,PBCN,11.051,9,33,24
238,VIR,P009549,P010781,0.717,1,1,0
238,VIR,P009549,PBCN,18.717,2,42,40
238,VIR,P010781,PBCN,4.534,3,12,9
239,OLY,P001255,P007853,11.283,3,27,24
239,OLY,P001255,P008811,19.184,7,44,37
239,OLY,P001255,P008829,19.45,13,50,37
239,OLY,P001255,P008855,24.017,13,60,47
239,OLY,P001255,P010612,20.0,14,51,37
239,OLY,P001255,P011194,8.2,2,19,17
239,OLY,P001255,P012878,8.466,8,25,17
239,OLY,P006302,P007853,7.067,-4,13,17
239,OLY,P006302,P008829,6.267,-6,11,17
239,OLY,P006302,P010612,0.067,2,2,0
239,OLY,P006302,P011194,7.067,-4,13,17
239,OLY,P006302,P011983,6.467,-3,11,14
239,OLY,P006302,P012878,1.333,-1,2,3
239,OLY,P007853,P008811,7.934,9,21,12
239,OLY,P007853,P008829,11.167,3,27,24
239,OLY,P007853,P008855,12.934,9,31,22
239,OLY,P007853,P010612,3.7,4,11,7
239,OLY,P007853,P011194,20.551,6,45,39
239,OLY,P007853,P011983,9.934,-3,16,19
239,OLY,P007853,P012878,9.966,1,21,20
239,OLY,P008811,P008829,14.884,14,39,25
239,OLY,P008811,P008855,21.001,15,52,37
239,OLY,P008811,P010612,13.067,6,31,25
239,OLY,P008811,P011194,7.934,9,21,12
239,OLY,P008829,P008855,18.184,20,50,30
239,OLY,P008829,P010612,19.517,15,52,37
239,OLY,P008829,P011194,8.084,2,19,17
239,OLY,P008829,P011983,5.667,-5,9,14
239,OLY,P008829,P012878,6.916,4,19,15
239,OLY,P008855,P010612,16.367,12,42,30
239,OLY,P008855,P011194,12.934,9,31,22
239,OLY,P008855,P011983,3.467,0,5,5
239,OLY,P008855,P012878,8.3,6,21,15
239,OLY,P010612,P011194,0.617,3,3,0
239,OLY,P010612,P012878,6.933,8,20,12
239,OLY,P011194,P011983,9.934,-3,16,19
239,OLY,P011194,P012878,6.883,0,13,13
239,OLY,P011983,P012878,4.267,2,7,5
239,ZAL,P002329,P002676,4.884,-5,9,14
239,ZAL,P002329,P003210,10.85,-12,21,33
239,ZAL,P002329,P003211,14.0,-4,31,35
239,ZAL,P002329,P005504,11.051,-4,18,22
239,ZAL,P002329,P006158,8.183,1,17,16
239,ZAL,P002329,P007109,9.483,-7,18,25
239,ZAL,P002329,P010390,4.933,-4,11,15
239,ZAL,P002329,P011218,19.65,-11,35,46
239,ZAL,P002329,P012715,10.8,-8,16,24
239,ZAL,P002329,P012787,8.034,-6,12,18
239,ZAL,P002676,P003210,11.767,0,25,25
239,ZAL,P002676,P003211,12.268,-9,23,32
239,ZAL,P002676,P005504,6.884,-7,11,18
239,ZAL,P002676,P006158,3.5,-1,7,8
239,ZAL,P002676,P007109,10.584,0,23,23
239,ZAL,P002676,P010390,8.934,-4,18,22
239,ZAL,P002676,P011218,7.584,-7,13,20
239,ZAL,P002676,P012715,4.05,-1,8,9
239,ZAL,P002676,P012787,7.217,-2,15,17
239,ZAL,P003210,P003211,12.367,-6,26,32
239,ZAL,P003210,P005504,4.867,-4,7,11
239,ZAL,P003210,P006158,6.65,-1,14,15
239,ZAL,P003210,P007109,10.15,0,23,23
239,ZAL,P003210,P010390,9.1,-1,20,21
239,ZAL,P003210,P011218,5.033,-8,9,17
239,ZAL,P003210,P012715,4.083,-1,8,9
239,ZAL,P003210,P012787,4.933,1,11,10
239,ZAL,P003211,P005504,4.717,1,10,9
239,ZAL,P003211,P006158,5.5,2,13,11
239,ZAL,P003211,P007109,13.784,-8,28,36
239,ZAL,P003211,P010390,12.084,-4,25,29
239,ZAL,P003211,P011218,13.55,-6,28,34
239,ZAL,P003211,P012715,4.167,-1,8,9
239,ZAL,P003211,P012787,1.967,-1,4,5
239,ZAL,P005504,P006158,5.5,3,13,10
239,ZAL,P005504,P011218,12.218,-9,18,27
239,ZAL,P005504,P012715,8.001,-12,8,20
239,ZAL,P005504,P012787,9.634,-8,15,23
239,ZAL,P006158,P007109,3.033,-3,4,7
239,ZAL,P006158,P010390,3.15,0,7,7
239,ZAL,P006158,P011218,5.033,1,10,9
239,ZAL,P006158,P012715,2.683,-1,4,5
239,ZAL,P006158,P012787,3.5,-1,7,8
239,ZAL,P007109,P010390,6.984,-2,14,16
239,ZAL,P007109,P011218,10.066,-10,18,28
239,ZAL,P007109,P012715,4.116,1,8,7
239,ZAL,P007109,P012787,3.4,1,8,7
239,ZAL,P010390,P011218,5.483,-1,13,14
239,ZAL,P010390,P012715,2.733,2,8,6
239,ZAL,P010390,P012787,0.067,-2,0,2
239,ZAL,P011218,P012715,13.417,-11,20,31
239,ZAL,P011218,P012787,8.034,-6,12,18
239,ZAL,P012715,P012787,5.35,-4,8,12
240,BAR,P000925,P002939,20.533,6,44,38
240,BAR,P000925,P003478,4.533,-1,6,7
240,BAR,P000925,P004866,18.15,1,38,37
240,BAR,P000925,P006435,21.916,1,44,43
240,BAR,P000925,P007519,2.317,-3,4,7
240,BAR,P000925,P009992,7.517,-1,12,13
240,BAR,P000925,P011244,2.166,0,2,2
240,BAR,P000925,P012745,22.45,0,44,44
240,BAR,P000925,PLFW,5.95,-3,6,9
240,BAR,P002939,P003196,2.684,-4,3,7
240,BAR,P002939,P003478,1.9,1,2,1
240,BAR,P002939,P004866,15.8,1,35,34
240,BAR,P002939,P006435,21.333,2,47,45
240,BAR,P002939,P007519,1.234,0,0,0
240,BAR,P002939,P009992,5.517,0,10,10
240,BAR,P002939,P011244,0.733,2,2,0
240,BAR,P002939,P012745,22.484,0,45,45
240,BAR,P002939,PLFW,0.65,0,0,0
240,BAR,P003196,P003478,10.767,-3,14,17
240,BAR,P003196,P004866,2.8,-7,3,10
240,BAR,P003196,P006435,3.133,-3,4,7
240,BAR,P003196,P007519,10.134,-3,12,15
240,BAR,P003196,P009992,6.05,-4,8,12
240,BAR,P003196,P011244,5.583,-5,7,12
240,BAR,P003196,P012745,8.034,-5,10,15
240,BAR,P003196,PLFW,5.283,-6,7,13
240,BAR,P003478,P004866,1.767,0,4,4
240,BAR,P003478,P006435,4.449,0,3,3
240,BAR,P003478,P007519,11.284,-3,16,19
240,BAR,P003478,P009992,5.217,-1,8,9
240,BAR,P003478,P011244,6.916,-2,9,11
240,BAR,P003478,P012745,6.617,-2,7,9
240,BAR,P003478,PLFW,7.75,-5,11,16
240,BAR,P004866,P006435,15.133,-2,35,37
240,BAR,P004866,P007519,2.884,-3,4,7
240,BAR,P004866,P009992,2.833,-4,2,6
240,BAR,P004866,P011244,0.783,-3,0,3
240,BAR,P004866,P012745,18.4,-3,37,40
240,BAR,P004866,PLFW,5.25,-4,6,10
240,BAR,P006435,P007519,2.233,-2,1,3
240,BAR,P006435,P009992,5.467,0,10,10
240,BAR,P006435,P011244,2.166,0,2,2
240,BAR,P006435,P012745,22.883,-2,46,48
240,BAR,P006435,PLFW,1.483,-2,0,2
240,BAR,P007519,P009992,4.017,-1,6,7
240,BAR,P007519,P011244,3.55,-2,5,7
240,BAR,P007519,P012745,7.134,-4,7,11
240,BAR,P007519,PLFW,5.017,-3,9,12
240,BAR,P009992,P011244,5.583,-5,7,12
240,BAR,P009992,P012745,7.984,0,13,13
240,BAR,P009992,PLFW,4.083,-4,4,8
240,BAR,P011244,PLFW,3.516,-5,2,7
240,BAR,P012745,PLFW,5.95,-4,7,11
240,MCO,P002581,P004790,1.166,-4,1,5
240,MCO,P002581,P005985,4.083,-7,2,9
240,MCO,P002581,P008099,0.817,-3,0,3
240,MCO,P002581,P010588,2.833,0,2,2
240,MCO,P002581,P011212,4.049,-4,3,7
240,MCO,P002581,P011226,4.766,-7,3,10
240,MCO,P002581,P011231,0.817,-3,0,3
240,MCO,P002581,P012709,0.733,0,1,1
240,MCO,P004790,P005985,4.566,-2,6,8
240,MCO,P004790,P010588,4.133,2,6,4
240,MCO,P004790,P011196,5.367,8,12,4
240,MCO,P004790,P011212,10.666,6,19,13
240,MCO,P004790,P011226,10.666,6,19,13
240,MCO,P004790,P012709,6.1,8,13,5
240,MCO,P005985,P008099,14.501,2,37,35
240,MCO,P005985,P010588,24.1,4,45,41
240,MCO,P005985,P011196,9.934,1,20,19
240,MCO,P005985,P011212,16.199,-2,21,23
240,MCO,P005985,P011226,18.566,-3,30,33
240,MCO,P005985,P011231,18.151,3,41,38
240,MCO,P005985,PLCZ,12.5,4,30,26
240,MCO,P008099,P010588,10.784,3,28,25
240,MCO,P008099,P011196,6.617,4,18,14
240,MCO,P008099,P011212,3.3,2,6,4
240,MCO,P008099,P011226,6.917,1,15,14
240,MCO,P008099,P011231,17.751,4,43,39
240,MCO,P008099,PLCZ,10.317,3,25,22
240,MCO,P010588,P011196,4.934,0,9,9
240,MCO,P010588,P011212,13.316,1,17,16
240,MCO,P010588,P011226,12.066,1,17,16
240,MCO,P010588,P011231,12.034,3,28,25
240,MCO,P010588,PLCZ,12.2,2,28,26
240,MCO,P011196,P011212,15.184,9,26,17
240,MCO,P011196,P011226,16.534,9,33,24
240,MCO,P011196,P011231,10.267,5,22,17
240,MCO,P011196,P012709,5.367,8,12,4
240,MCO,P011212,P011226,24.249,8,40,32
240,MCO,P011212,P011231,6.95,3,10,7
240,MCO,P011212,P012709,6.1,8,13,5
240,MCO,P011212,PLCZ,2.183,1,5,4
240,MCO,P011226,P011231,9.317,2,19,17
240,MCO,P011226,P012709,6.1,8,13,5
240,MCO,P011226,PLCZ,2.483,3,7,4
240,MCO,P011231,PLCZ,10.317,3,25,22
241,MUN,P001288,P001557,2.666,-3,2,5
241,MUN,P001288,P003583,22.332,-1,41,42
241,MUN,P001288,P004508,8.317,9,17,8
241,MUN,P001288,P006760,2.167,0,5,5
241,MUN,P001288,P007056,23.767,3,45,42
241,MUN,P001288,P007639,2.334,5,5,0
241,MUN,P001288,P008985,12.466,-2,26,28
241,MUN,P001288,P010391,15.083,7,31,24
241,MUN,P001288,P011987,17.8,-2,32,34
241,MUN,P001557,P003583,4.55,-3,4,7
241,MUN,P001557,P004508,8.751,-2,11,13
241,MUN,P001557,P006760,8.751,-2,11,13
241,MUN,P001557,P007056,2.2,3,6,3
241,MUN,P001557,P007639,4.667,-5,3,8
241,MUN,P001557,P008985,4.5,2,10,8
241,MUN,P001557,P010391,7.0,-10,3,13
241,MUN,P001557,P011987,2.583,0,2,2
241,MUN,P003583,P004508,6.317,4,9,5
241,MUN,P003583,P006760,1.884,0,2,2
241,MUN,P003583,P007056,19.366,-2,35,37
241,MUN,P003583,P008985,13.333,-2,28,30
241,MUN,P003583,P010391,11.699,2,21,19
241,MUN,P003583,P011987,17.383,-2,32,34
241,MUN,P004508,P006760,15.101,2,26,24
241,MUN,P004508,P007056,14.8,16,33,17
241,MUN,P004508,P007639,10.767,4,18,14
241,MUN,P004508,P008985,3.734,5,8,3
241,MUN,P004508,P010391,17.617,6,30,24
241,MUN,P006760,P007056,8.883,9,23,14
241,MUN,P006760,P007639,9.283,1,15,14
241,MUN,P006760,P008985,3.734,5,8,3
241,MUN,P006760,P010391,11.7,-1,20,21
241,MUN,P006760,P011987,0.233,2,2,0
241,MUN,P007056,P007639,6.85,11,17,6
241,MUN,P007056,P008985,12.467,2,26,24
241,MUN,P007056,P010391,18.449,10,39,29
241,MUN,P007056,P011987,15.15,-4,28,32
241,MUN,P007639,P010391,11.517,6,20,14
241,MUN,P007639,P011987,0.65,2,2,0
241,MUN,P008985,P010391,0.816,1,6,5
241,MUN,P008985,P011987,11.35,1,24,23
241,MUN,P010391,P011987,6.983,3,14,11
241,RED,P000848,P002553,7.367,-3,13,16
241,RED,P000848,P005099,13.7,-5,23,28
241,RED,P000848,P006436,7.367,-3,13,16
241,RED,P000848,P007960,9.367,1,20,19
241,RED,P000848,P008966,9.885,-7,16,23
241,RED,P000848,P009035,9.783,-2,17,19
241,RED,P000848,P011941,5.834,-9,4,13
241,RED,P000848,P012044,5.984,-4,9,13
241,RED,P000848,P012801,3.501,-1,8,9
241,RED,P000848,PLUO,11.684,-7,17,24
241,RED,P002553,P005099,6.466,-2,10,12
241,RED,P002553,P006436,18.417,1,40,39
241,RED,P002553,P008966,0.9,1,3,2
241,RED,P002553,P009035,17.517,0,37,37
241,RED,P002553,P012044,10.517,4,27,23
241,RED,P002553,P012801,12.484,3,30,27
241,RED,P004720,P006436,0.383,0,0,0
241,RED,P004720,P007960,3.55,0,4,4
241,RED,P004720,P009035,3.55,0,4,4
241,RED,P004720,P012044,3.167,0,4,4
241,RED,P004720,P012801,3.167,0,4,4
241,RED,P004720,PLUO,0.383,0,0,0
241,RED,P005099,P006436,8.216,-4,10,14
241,RED,P005099,P007960,7.6,0,13,13
241,RED,P005099,P008966,7.267,-7,6,13
241,RED,P005099,P009035,8.716,0,17,17
241,RED,P005099,P011941,1.917,-5,0,5
241,RED,P005099,P012801,2.283,-2,0,2
241,RED,P005099,PLUO,7.767,-3,13,16
241,RED,P006436,P007960,3.05,-2,0,2
241,RED,P006436,P008966,2.65,-1,3,4
241,RED,P006436,P009035,18.817,0,37,37
241,RED,P006436,P012044,11.434,4,27,23
241,RED,P006436,P012801,15.151,1,30,29
241,RED,P006436,PLUO,0.383,0,0,0
241,RED,P007960,P008966,6.884,-2,11,13
241,RED,P007960,P009035,7.25,2,11,9
241,RED,P007960,P011941,3.067,-1,2,3
241,RED,P007960,P012044,9.218,-1,11,12
241,RED,P007960,P012801,9.518,-2,9,11
241,RED,P007960,PLUO,9.3,1,15,14
241,RED,P008966,P011941,4.384,-8,2,10
241,RED,P008966,P012044,4.534,-3,7,10
241,RED,P008966,P012801,4.717,-1,8,9
241,RED,P008966,PLUO,7.451,-8,8,16
241,RED,P009035,P012044,14.601,4,31,27
241,RED,P009035,P012801,15.668,2,31,29
241,RED,P009035,PLUO,3.166,2,7,5
241,RED,P011941,P012044,5.534,-4,4,8
241,RED,P011941,P012801,1.617,0,0,0
241,RED,P011941,PLUO,7.451,-9,4,13
241,RED,P012044,P012801,18.285,4,36,32
241,RED,P012044,PLUO,5.534,-4,4,8
241,RED,P012801,PLUO,1.617,0,0,0
242,BAS,P003198,P004603,7.784,0,26,26
242,BAS,P003198,P004761,12.684,-3,34,37
242,BAS,P003198,P007230,7.367,-3,18,21
242,BAS,P003198,P007946,4.234,-1,11,12
242,BAS,P003198,P009048,17.1,-4,49,53
242,BAS,P003198,P010444,11.833,-6,29,35
242,BAS,P003198,P011948,8.65,-2,26,28
242,BAS,P003198,P012201,15.684,-1,47,48
242,BAS,P004603,P004761,7.151,-7,17,24
242,BAS,P004603,P007230,2.367,-5,4,9
242,BAS,P004603,P007946,2.517,-2,6,8
242,BAS,P004603,P009048,7.634,-3,24,27
242,BAS,P004603,P011948,3.0,2,13,11
242,BAS,P004603,P012201,10.151,-5,30,35
242,BAS,P004761,P007230,20.384,-9,41,50
242,BAS,P004761,P007946,14.884,-3,32,35
242,BAS,P004761,P009048,20.184,-14,45,59
242,BAS,P004761,P010444,19.466,-3,43,46
242,BAS,P004761,P011085,6.933,2,14,12
242,BAS,P004761,P012201,23.718,-15,54,69
242,BAS,P007230,P007946,12.367,-1,26,27
242,BAS,P007230,P009048,17.384,-16,35,51
242,BAS,P007230,P010444,18.933,-5,40,45
242,BAS,P007230,P011085,6.933,2,14,12
242,BAS,P007230,P011948,5.65,-4,13,17
242,BAS,P007230,P012201,12.751,-11,25,36
242,BAS,P007946,P009048,3.717,-4,7,11
242,BAS,P007946,P010444,7.633,2,16,14
242,BAS,P007946,P011085,6.933,2,14,12
242,BAS,P007946,P012201,7.251,-5,16,21
242,BAS,P009048,P010444,18.183,-9,42,51
242,BAS,P009048,P011948,8.65,-2,26,28
242,BAS,P009048,P012201,22.484,-12,56,68
242,BAS,P010444,P011085,6.933,2,14,12
242,BAS,P010444,P011948,5.65,-4,13,17
242,BAS,P010444,P012201,11.833,-5,27,32
242,BAS,P011948,P012201,3.0,2,13,11
242,ULK,P001932,P002968,5.65,4,17,13
242,ULK,P001932,P004004,11.5,20,40,20
242,ULK,P001932,P005844,3.917,-1,8,9
242,ULK,P001932,P006068,13.867,-6,30,36
242,ULK,P001932,P006661,8.833,3,25,22
242,ULK,P001932,P006961,16.266,24,58,34
242,ULK,P001932,P008962,25.917,9,68,59
242,ULK,P001932,P009849,9.034,-1,23,24
242,ULK,P001932,P011157,19.8,19,63,44
242,ULK,P001932,P011980,4.216,9,20,11
242,ULK,P002968,P004004,4.284,-1,9,10
242,ULK,P002968,P006068,4.2,2,13,11
242,ULK,P002968,P006661,0.267,-2,0,2
242,ULK,P002968,P006961,4.017,1,9,8
242,ULK,P002968,P008962,4.2,2,13,11
242,ULK,P002968,P009849,7.034,-1,18,19
242,ULK,P002968,P011980,4.284,-1,9,10
242,ULK,P004004,P005844,0.35,0,0,0
242,ULK,P004004,P006661,5.651,-5,14,19
242,ULK,P004004,P006961,19.034,19,59,40
242,ULK,P004004,P008962,8.75,10,28,18
242,ULK,P004004,P009849,3.251,-6,5,11
242,ULK,P004004,P011157,15.084,15,50,35
242,ULK,P004004,P011980,10.968,4,31,27
242,ULK,P005844,P006068,5.95,0,12,12
242,ULK,P005844,P006661,4.883,3,10,7
242,ULK,P005844,P006961,0.35,0,0,0
242,ULK,P005844,P008962,3.917,-1,8,9
242,ULK,P005844,P009849,3.45,-2,6,8
242,ULK,P005844,P011980,2.383,1,4,3
242,ULK,P006068,P006661,7.3,-4,12,16
242,ULK,P006068,P006961,0.383,-2,0,2
242,ULK,P006068,P008962,13.867,-6,30,36
242,ULK,P006068,P009849,10.25,2,26,24
242,ULK,P006068,P011157,5.367,-5,9,14
242,ULK,P006068,P011980,2.416,-1,4,5
242,ULK,P006661,P006961,8.533,8,31,23
242,ULK,P006661,P008962,7.75,2,17,15
242,ULK,P006661,P009849,2.717,-4,4,8
242,ULK,P006661,P011157,11.367,-2,33,35
242,ULK,P006661,P011980,8.767,-3,26,29
242,ULK,P006961,P008962,12.433,13,38,25
242,ULK,P006961,P009849,3.384,-3,6,9
242,ULK,P006961,P011157,19.05,24,68,44
242,ULK,P006961,P011980,11.75,8,39,31
242,ULK,P008962,P009849,9.034,-1,23,24
242,ULK,P008962,P011157,17.417,10,47,37
242,ULK,P008962,P011980,0.383,-2,0,2
242,ULK,P009849,P011157,3.834,-3,8,11
242,ULK,P009849,P011980,5.284,-5,9,14
242,ULK,P011157,P011980,7.417,6,30,24
243,ASV,P000229,P002100,5.233,0,11,11
243,ASV,P000229,P003526,10.317,-1,20,21
243,ASV,P000229,P004194,16.517,0,33,33
243,ASV,P000229,P011225,10.317,-1,20,21
243,ASV,P000229,P011386,1.8,-2,4,6
243,ASV,P000229,P012080,7.283,-1,16,17
243,ASV,P000229,P012729,1.083,-2,3,5
243,ASV,P000229,P012731,14.05,-7,25,32
243,ASV,P000229,PKIR,3.8,6,12,6
243,ASV,P002100,P003526,1.766,4,4,0
243,ASV,P002100,P004194,8.399,10,19,9
243,ASV,P002100,P011225,5.932,4,12,8
243,ASV,P002100,P011386,15.967,5,33,28
243,ASV,P002100,P012080,25.366,5,52,47
243,ASV,P002100,P012729,21.899,4,45,41
243,ASV,P002100,P012731,2.516,-3,2,5
243,ASV,P002100,PKIR,21.45,7,46,39
243,ASV,P003526,P004194,12.083,3,24,21
243,ASV,P003526,P011225,12.083,3,24,21
243,ASV,P003526,P012729,0.933,2,2,0
243,ASV,P003526,P012731,11.15,1,22,21
243,ASV,P004194,P011225,14.316,6,30,24
243,ASV,P004194,P011386,1.8,-2,4,6
243,ASV,P004194,P012080,8.433,4,19,15
243,ASV,P004194,P012729,3.166,5,8,3
243,ASV,P004194,P012731,14.633,-6,26,32
243,ASV,P004194,PKIR,2.717,8,9,1
243,ASV,P011225,P012080,4.166,0,8,8
243,ASV,P011225,P012729,5.099,2,10,8
243,ASV,P011225,P012731,11.15,1,22,21
243,ASV,P011225,PKIR,1.933,-3,2,5
243,ASV,P011386,P012080,18.267,0,37,37
243,ASV,P011386,P012729,16.467,2,33,31
243,ASV,P011386,P012731,2.3,-5,4,9
243,ASV,P011386,PKIR,16.467,2,33,31
243,ASV,P012080,P012729,21.716,0,44,44
243,ASV,P012080,P012731,4.233,-9,5,14
243,ASV,P012080,PKIR,22.2,5,47,42
243,ASV,P012729,P012731,0.75,-2,1,3
243,ASV,P012729,PKIR,19.483,-3,38,41
243,ASV,P012731,PKIR,0.75,-2,1,3
243,MIL,P001518,P002812,7.833,-7,10,17
243,MIL,P001518,P002849,5.15,1,11,10
243,MIL,P001518,P006701,2.95,-7,1,8
243,MIL,P001518,P007032,8.366,0,17,17
243,MIL,P001518,P007831,13.133,-11,19,30
243,MIL,P001518,P009960,1.2,-5,0,5
243,MIL,P001518,P011205,10.383,-5,17,22
243,MIL,P001518,P012800,7.717,-10,9,19
243,MIL,P002812,P006701,1.75,-2,1,3
243,MIL,P002812,P007032,7.899,13,22,9
243,MIL,P002812,P007201,5.666,14,16,2
243,MIL,P002812,P007831,12.449,7,24,17
243,MIL,P002812,P011205,12.216,12,26,14
243,MIL,P002812,P012800,6.183,-9,5,14
243,MIL,P002849,P006701,3.75,1,3,2
243,MIL,P002849,P007032,19.384,-8,36,44
243,MIL,P002849,P007201,15.217,-11,29,40
243,MIL,P002849,P007831,22.049,-1,48,49
243,MIL,P002849,P009960,4.916,5,11,6
243,MIL,P002849,P011205,13.216,3,31,28
243,MIL,P002849,P012800,17.45,-10,35,45
243,MIL,P006701,P007032,1.717,-2,0,2
243,MIL,P006701,P007201,1.717,-2,0,2
243,MIL,P006701,P007831,4.983,-4,4,8
243,MIL,P006701,P009960,3.233,-2,3,5
243,MIL,P006701,P011205,6.7,-6,4,10
243,MIL,P007032,P007201,16.984,2,35,33
243,MIL,P007032,P007831,23.016,8,53,45
243,MIL,P007032,P009960,1.967,1,6,5
243,MIL,P007032,P011205,13.95,17,38,21
243,MIL,P007032,P012800,15.917,-15,25,40
243,MIL,P007201,P007831,17.666,6,42,36
243,MIL,P007201,P009960,0.017,-1,0,1
243,MIL,P007201,P011205,13.3,11,35,24
243,MIL,P007201,P012800,13.033,-11,23,34
243,MIL,P007831,P009960,6.133,-1,11,12
243,MIL,P007831,P011205,22.365,13,52,39
243,MIL,P007831,P012800,21.066,-17,35,52
243,MIL,P009960,P011205,4.183,-3,5,8
243,MIL,P009960,P012800,2.883,2,8,6
243,MIL,P011205,P012800,10.283,-6,20,26
244,IST,P004888,P006590,9.316,4,20,16
244,IST,P004888,P007200,24.782,17,72,55
244,IST,P004888,P009513,8.833,-3,23,26
244,IST,P004888,P009664,6.399,5,17,12
244,IST,P004888,P009846,7.934,3,23,20
244,IST,P004888,P011078,14.833,18,45,27
244,IST,P004888,P011981,9.333,3,22,19
244,IST,P004888,P012710,14.549,10,40,30
244,IST,P004888,P012788,13.416,23,47,24
244,IST,P004888,PLHK,6.133,-8,11,19
244,IST,P006590,P007200,6.383,5,20,15
244,IST,P006590,P009513,4.617,4,9,5
244,IST,P006590,P009664,14.667,0,31,31
244,IST,P006590,P009846,13.634,2,33,31
244,IST,P006590,P011078,8.95,-4,16,20
244,IST,P006590,P011981,16.5,6,39,33
244,IST,P006590,P012710,2.283,4,6,2
244,IST,P006590,P012788,3.45,-1,6,7
244,IST,P007200,P009513,8.766,-5,21,26
244,IST,P007200,P009664,3.949,10,21,11
244,IST,P007200,P009846,9.45,5,31,26
244,IST,P007200,P011078,11.216,21,41,20
244,IST,P007200,P011981,9.85,3,28,25
244,IST,P007200,P012710,14.549,10,40,30
244,IST,P007200,P012788,10.382,26,43,17
244,IST,P007200,PLHK,6.133,-8,11,19
244,IST,P009513,P009664,6.65,5,15,10
244,IST,P009513,P009846,4.684,6,11,5
244,IST,P009513,P011078,0.067,2,2,0
244,IST,P009513,P011981,4.617,4,9,5
244,IST,P009513,P012710,6.733,-6,15,21
244,IST,P009513,P012788,2.7,5,12,7
244,IST,P009513,PLHK,6.133,-8,11,19
244,IST,P009664,P009846,11.117,5,29,24
244,IST,P009664,P011078,9.766,5,25,20
244,IST,P009664,P011981,11.217,1,25,24
244,IST,P009664,P012788,6.299,9,21,12
244,IST,P009846,P011078,10.334,3,29,26
244,IST,P009846,P011981,17.101,0,41,41
244,IST,P009846,P012788,1.95,8,11,3
244,IST,P011078,P011981,8.967,-5,18,23
244,IST,P011078,P012710,5.533,12,19,7
244,IST,P011078,P012788,11.266,24,41,17
244,IST,P011981,P012710,2.283,4,6,2
244,IST,P012710,P012788,6.133,14,23,9
244,IST,P012710,PLHK,6.133,-8,11,19
244,MUN,P001288,P001557,3.784,-4,7,11
244,MUN,P001288,P003583,18.617,-4,48,52
244,MUN,P001288,P004508,8.049,2,18,16
244,MUN,P001288,P005478,4.317,-2,8,10
244,MUN,P001288,P006760,2.0,2,4,2
244,MUN,P001288,P007056,20.699,7,54,47
244,MUN,P001288,P007639,2.183,-1,5,6
244,MUN,P001288,P007975,10.6,5,26,21
244,MUN,P001288,P008985,21.883,-1,54,55
244,MUN,P001288,P010391,8.049,2,18,16
244,MUN,P001288,P011987,14.483,-6,38,44
244,MUN,P001557,P003583,4.3,-10,10,20
244,MUN,P001557,P004508,2.516,-4,7,11
244,MUN,P001557,P005478,4.0,-6,4,10
244,MUN,P001557,P006760,5.716,-4,11,15
244,MUN,P001557,P007975,6.1,-8,11,19
244,MUN,P001557,P008985,1.883,-6,3,9
244,MUN,P001557,P010391,2.166,-10,0,10
244,MUN,P001557,P011987,1.467,-4,3,7
244,MUN,P003583,P004508,5.966,-11,9,20
244,MUN,P003583,P005478,2.317,-4,4,8
244,MUN,P003583,P006760,6.283,-4,14,18
244,MUN,P003583,P007056,19.5,-2,48,50
244,MUN,P003583,P007975,11.267,-3,28,31
244,MUN,P003583,P008985,18.35,-7,44,51
244,MUN,P003583,P010391,0.9,-6,0,6
244,MUN,P003583,P011987,15.7,-5,43,48
244,MUN,P004508,P005478,0.533,0,0,0
244,MUN,P004508,P006760,5.483,-7,9,16
244,MUN,P004508,P007056,9.683,-2,17,19
244,MUN,P004508,P007639,3.083,1,7,6
244,MUN,P004508,P007975,9.999,-3,19,22
244,MUN,P004508,P008985,4.916,-4,10,14
244,MUN,P004508,P010391,9.432,0,20,20
244,MUN,P005478,P006760,3.683,-4,4,8
244,MUN,P005478,P007639,0.533,0,0,0
244,MUN,P005478,P007975,6.533,-8,8,16
244,MUN,P005478,P008985,2.0,-2,4,6
244,MUN,P005478,P010391,2.216,-6,0,6
244,MUN,P006760,P007056,5.617,-10,7,17
244,MUN,P006760,P007639,1.367,-6,0,6
244,MUN,P006760,P007975,11.333,-14,18,32
244,MUN,P006760,P010391,1.683,-6,0,6
244,MUN,P006760,P011987,2.167,-3,5,8
244,MUN,P007056,P007639,1.934,-7,2,9
244,MUN,P007056,P007975,10.217,-1,22,23
244,MUN,P007056,P008985,18.9,1,47,46
244,MUN,P007056,P010391,6.85,0,15,15
244,MUN,P007056,P011987,15.8,-10,40,50
244,MUN,P007639,P007975,4.65,-8,7,15
244,MUN,P007639,P010391,3.283,-2,7,9
244,MUN,P007639,P011987,1.567,-9,0,9
244,MUN,P007975,P008985,3.817,4,10,6
244,MUN,P007975,P010391,6.399,-5,10,15
244,MUN,P007975,P011987,3.217,-7,9,16
244,MUN,P008985,P010391,5.333,-6,10,16
244,MUN,P008985,P011987,14.05,-7,34,41
244,MUN,P010391,P011987,0.617,-5,0,5
245,MCO,P002581,P004197,3.0,-1,5,6
245,MCO,P002581,P004790,4.1,-2,6,8
245,MCO,P002581,P005985,2.233,4,6,2
245,MCO,P002581,P010588,1.133,5,5,0
245,MCO,P002581,P011212,5.233,3,11,8
245,MCO,P002581,P011226,5.233,3,11,8
245,MCO,P004197,P004790,1.867,-6,0,6
245,MCO,P004197,P005985,1.717,3,4,1
245,MCO,P004197,P008099,1.333,-4,0,4
245,MCO,P004197,P010588,5.65,11,16,5
245,MCO,P004197,P011212,7.517,5,16,11
245,MCO,P004197,P011226,4.467,6,12,6
245,MCO,P004197,PLCZ,4.517,6,11,5
245,MCO,P004790,P005985,2.233,4,6,2
245,MCO,P004790,P011212,4.1,-2,6,8
245,MCO,P004790,P011226,4.1,-2,6,8
245,MCO,P005985,P008099,13.2,-3,29,32
245,MCO,P005985,P010588,20.601,0,46,46
245,MCO,P005985,P011196,9.934,9,27,18
245,MCO,P005985,P011212,12.201,18,34,16
245,MCO,P005985,P011226,16.334,17,48,31
245,MCO,P005985,P011231,19.417,0,42,42
245,MCO,P005985,P012709,4.75,-3,10,13
245,MCO,P005985,PLCZ,17.984,-1,40,41
245,MCO,P008099,P010588,14.533,-7,29,36
245,MCO,P008099,P011196,4.05,4,13,9
245,MCO,P008099,P011212,5.383,0,13,13
245,MCO,P008099,P011226,6.95,10,25,15
245,MCO,P008099,P011231,14.35,-5,30,35
245,MCO,P008099,PLCZ,14.533,-7,29,36
245,MCO,P010588,P011196,2.617,1,6,5
245,MCO,P010588,P011212,9.534,10,25,15
245,MCO,P010588,P011226,9.384,17,33,16
245,MCO,P010588,P011231,12.1,-8,21,29
245,MCO,P010588,P012709,1.8,1,4,3
245,MCO,P010588,PLCZ,20.784,2,47,45
245,MCO,P011196,P011212,9.234,16,30,14
245,MCO,P011196,P011226,12.184,12,36,24
245,MCO,P011196,P011231,13.167,13,38,25
245,MCO,P011196,P012709,4.75,-3,10,13
245,MCO,P011212,P011226,19.001,25,55,30
245,MCO,P011212,P011231,8.417,16,28,12
245,MCO,P011212,PLCZ,7.584,5,18,13
245,MCO,P011226,P011231,11.367,12,34,22
245,MCO,P011226,P012709,2.95,-4,6,10
245,MCO,P011226,PLCZ,7.434,12,26,14
245,MCO,P011231,P012709,4.75,-3,10,13
245,MCO,P011231,PLCZ,10.3,-9,17,26
245,RED,P000848,P002553,6.267,-7,8,15
245,RED,P000848,P004720,1.6,0,2,2
245,RED,P000848,P005099,1.467,-7,0,7
245,RED,P000848,P008966,1.917,-6,1,7
245,RED,P000848,P009035,2.917,-1,4,5
245,RED,P000848,P011941,3.333,-4,5,9
245,RED,P000848,P012044,5.75,-2,9,11
245,RED,P000848,P012801,2.417,-9,1,10
245,RED,P000848,PLUO,3.2,0,6,6
245,RED,P002553,P004720,9.65,6,23,17
245,RED,P002553,P005099,5.833,-7,12,19
245,RED,P002553,P006436,20.033,4,53,49
245,RED,P002553,P008966,2.8,-6,3,9
245,RED,P002553,P009035,21.8,8,57,49
245,RED,P002553,P011941,3.683,-10,4,14
245,RED,P002553,P012044,26.516,5,64,59
245,RED,P002553,P012801,3.3,-9,3,12
245,RED,P002553,PLUO,12.65,-4,29,33
245,RED,P004720,P005099,5.716,-9,7,16
245,RED,P004720,P006436,15.566,-4,31,35
245,RED,P004720,P008966,3.783,-8,5,13
245,RED,P004720,P009035,15.183,3,31,28
245,RED,P004720,P011941,3.05,-2,5,7
245,RED,P004720,P012044,11.3,8,26,18
245,RED,P004720,P012801,2.816,-10,2,12
245,RED,P005099,P006436,8.249,-7,16,23
245,RED,P005099,P008966,7.416,-14,8,22
245,RED,P005099,P009035,6.766,-3,14,17
245,RED,P005099,P011941,5.533,0,8,8
245,RED,P005099,P012044,6.049,-1,15,16
245,RED,P005099,P012801,8.749,-20,8,28
245,RED,P005099,PLUO,0.95,0,0,0
245,RED,P006436,P008966,4.55,-8,7,15
245,RED,P006436,P009035,24.416,6,61,55
245,RED,P006436,P011941,4.967,-7,7,14
245,RED,P006436,P012044,22.45,6,58,52
245,RED,P006436,P012801,2.816,-10,2,12
245,RED,P006436,PLUO,10.217,-4,25,29
245,RED,P008966,P009035,1.8,-1,3,4
245,RED,P008966,P011941,4.35,-3,6,9
245,RED,P008966,P012044,7.033,-6,12,18
245,RED,P008966,P012801,8.366,-16,9,25
245,RED,P008966,PLUO,1.717,0,2,2
245,RED,P009035,P011941,3.05,-2,5,7
245,RED,P009035,P012044,22.95,13,60,47
245,RED,P009035,P012801,1.333,-6,0,6
245,RED,P009035,PLUO,9.117,3,25,22
245,RED,P011941,P012044,6.933,-10,10,20
245,RED,P011941,P012801,3.583,-3,4,7
245,RED,P011941,PLUO,5.25,-7,6,13
245,RED,P012044,P012801,4.466,-5,7,12
245,RED,P012044,PLUO,13.417,-4,31,35
245,RED,P012801,PLUO,0.95,0,0,0
246,TEL,P005145,P007990,3.5,8,11,3
246,TEL,P005145,P009622,11.934,1,31,30
246,TEL,P005145,P009783,11.934,1,31,30
246,TEL,P005145,P009863,9.3,-7,20,27
246,TEL,P005145,P011193,0.433,0,0,0
246,TEL,P005145,P011199,11.934,1,31,30
246,TEL,P005145,P011214,0.433,0,0,0
246,TEL,P007990,P009622,7.1,6,16,10
246,TEL,P007990,P009783,8.367,7,19,12
246,TEL,P007990,P009863,0.433,0,0,0
246,TEL,P007990,P011193,7.133,10,19,9
246,TEL,P007990,P011199,4.5,4,11,7
246,TEL,P007990,P011214,10.383,10,24,14
246,TEL,P007990,P011971,7.483,8,19,11
246,TEL,P007990,P012744,8.033,11,21,10
246,TEL,P009622,P009783,24.284,-2,56,58
246,TEL,P009622,P009863,14.284,-7,35,42
246,TEL,P009622,P011193,2.9,-1,5,6
246,TEL,P009622,P011199,21.251,1,51,50
246,TEL,P009622,P011214,7.633,-8,14,22
246,TEL,P009622,P011971,2.367,-4,0,4
246,TEL,P009622,P012744,5.383,6,16,10
246,TEL,P009783,P009863,14.901,-7,35,42
246,TEL,P009783,P011193,4.784,0,8,8
246,TEL,P009783,P011199,21.251,1,51,50
246,TEL,P009783,P011214,9.517,-7,17,24
246,TEL,P009783,P011971,4.251,-3,3,6
246,TEL,P009783,P012744,5.383,6,16,10
246,TEL,P009863,P011193,9.017,-1,8,9
246,TEL,P009863,P011199,15.351,0,37,37
246,TEL,P009863,P011214,10.55,-11,10,21
246,TEL,P009863,P011971,8.618,-2,8,10
246,TEL,P009863,P012744,10.75,3,19,16
246,TEL,P011193,P011199,4.4,1,7,6
246,TEL,P011193,P011214,16.033,7,30,23
246,TEL,P011193,P011971,16.368,8,27,19
246,TEL,P011193,P012744,13.4,8,24,16
246,TEL,P011199,P011214,4.833,-5,9,14
246,TEL,P011199,P011971,3.634,-2,2,4
246,TEL,P011199,P012744,3.85,11,13,2
246,TEL,P011214,P011971,13.784,7,25,18
246,TEL,P011214,P012744,15.166,3,27,24
246,TEL,P011971,P012744,13.167,8,24,16
246,ZAL,P002329,P002676,14.883,6,30,24
246,ZAL,P002329,P003210,9.666,-6,12,18
246,ZAL,P002329,P003211,9.249,-12,12,24
246,ZAL,P002329,P005504,13.401,-13,26,39
246,ZAL,P002329,P007109,16.883,8,41,33
246,ZAL,P002329,P010390,15.065,9,33,24
246,ZAL,P002329,P011218,22.883,4,55,51
246,ZAL,P002329,P012715,9.183,-7,17,24
246,ZAL,P002329,P012787,10.783,-1,26,27
246,ZAL,P002676,P003210,7.6,-1,8,9
246,ZAL,P002676,P003211,4.416,-4,2,6
246,ZAL,P002676,P005504,1.7,-3,0,3
246,ZAL,P002676,P007109,9.216,9,22,13
246,ZAL,P002676,P010390,16.633,9,33,24
246,ZAL,P002676,P011218,16.333,10,38,28
246,ZAL,P002676,P012715,10.916,-1,21,22
246,ZAL,P002676,P012787,4.499,-5,6,11
246,ZAL,P003210,P003211,10.949,-10,10,20
246,ZAL,P003210,P005504,6.067,-7,7,14
246,ZAL,P003210,P007109,4.033,-4,4,8
246,ZAL,P003210,P010390,10.216,-2,12,14
246,ZAL,P003210,P011218,4.867,5,10,5
246,ZAL,P003210,P012715,10.733,-1,12,13
246,ZAL,P003210,P012787,5.933,-6,5,11
246,ZAL,P003211,P005504,3.984,-11,5,16
246,ZAL,P003211,P007109,4.449,-2,8,10
246,ZAL,P003211,P010390,9.898,-7,9,16
246,ZAL,P003211,P011218,3.766,-7,7,14
246,ZAL,P003211,P012715,8.782,-13,7,20
246,ZAL,P003211,P012787,5.099,-2,8,10
246,ZAL,P005504,P007109,7.984,-5,20,25
246,ZAL,P005504,P011218,9.384,-5,23,28
246,ZAL,P005504,P012715,3.717,-5,6,11
246,ZAL,P005504,P012787,7.367,-3,17,20
246,ZAL,P007109,P010390,6.866,12,17,5
246,ZAL,P007109,P011218,15.249,12,44,32
246,ZAL,P007109,P012715,1.999,-1,6,7
246,ZAL,P007109,P012787,8.849,-1,26,27
246,ZAL,P010390,P011218,14.333,11,33,22
246,ZAL,P010390,P012715,12.966,-5,18,23
246,ZAL,P010390,P012787,4.283,-3,5,8
246,ZAL,P011218,P012715,12.383,-5,28,33
246,ZAL,P011218,P012787,8.466,-1,26,27
246,ZAL,P012715,P012787,4.049,-6,5,11
247,OLY,P001255,P006302,8.75,-2,15,17
247,OLY,P001255,P007853,17.134,3,32,29
247,OLY,P001255,P007982,15.633,20,32,12
247,OLY,P001255,P008811,24.401,9,50,41
247,OLY,P001255,P008829,18.8,6,39,33
247,OLY,P001255,P010612,20.784,4,44,40
247,OLY,P001255,P011194,13.617,10,28,18
247,OLY,P001255,P011965,1.867,1,5,4
247,OLY,P001255,P012878,7.35,1,11,10
247,OLY,P006302,P007853,4.1,0,6,6
247,OLY,P006302,P008811,8.75,-2,15,17
247,OLY,P006302,P008829,7.516,-4,15,19
247,OLY,P006302,P010612,6.083,-3,12,15
247,OLY,P006302,P011194,4.1,0,6,6
247,OLY,P006302,P011983,1.433,-1,3,4
247,OLY,P007853,P007982,11.466,0,17,17
247,OLY,P007853,P008811,11.084,-3,21,24
247,OLY,P007853,P008829,9.816,-1,19,20
247,OLY,P007853,P010612,7.884,-9,15,24
247,OLY,P007853,P011194,19.466,-2,31,33
247,OLY,P007853,P011965,3.65,1,7,6
247,OLY,P007853,P011983,5.866,-5,7,12
247,OLY,P007853,P012878,9.734,-4,13,17
247,OLY,P007982,P008811,12.883,14,29,15
247,OLY,P007982,P008829,8.933,9,15,6
247,OLY,P007982,P010612,10.917,10,23,13
247,OLY,P007982,P011194,12.083,4,22,18
247,OLY,P007982,P011983,2.65,-4,2,6
247,OLY,P007982,P012878,6.767,-1,8,9
247,OLY,P008811,P008829,18.467,3,36,33
247,OLY,P008811,P010612,19.117,2,39,37
247,OLY,P008811,P011194,7.567,4,17,13
247,OLY,P008811,P011965,1.867,1,5,4
247,OLY,P008829,P010612,15.483,5,32,27
247,OLY,P008829,P011194,4.232,2,8,6
247,OLY,P008829,P011965,3.65,1,7,6
247,OLY,P008829,P011983,3.899,-1,5,6
247,OLY,P010612,P011194,7.684,-1,18,19
247,OLY,P010612,P012878,3.384,-4,5,9
247,OLY,P011194,P011965,1.783,0,2,2
247,OLY,P011194,P011983,5.866,-5,7,12
247,OLY,P011194,P012878,9.734,-4,13,17
247,OLY,P011965,P011983,1.783,0,2,2
247,OLY,P011983,P012878,1.967,-4,2,6
247,VIR,P001133,P001844,11.017,-9,14,23
247,VIR,P001133,P003048,3.433,2,9,7
247,VIR,P001133,P003527,6.433,6,14,8
247,VIR,P001133,P004007,14.801,-3,22,25
247,VIR,P001133,P004554,13.851,0,23,23
247,VIR,P001133,P006739,20.317,7,41,34
247,VIR,P001133,P008847,10.933,-3,16,19
247,VIR,P001133,P009549,7.95,1,14,13
247,VIR,P001133,P010781,17.15,-1,27,28
247,VIR,P001133,PBCN,6.983,-4,12,16
247,VIR,P001844,P003048,14.616,-1,28,29
247,VIR,P001844,P003527,0.333,-3,0,3
247,VIR,P001844,P004007,4.501,-2,5,7
247,VIR,P001844,P004554,4.167,-8,3,11
247,VIR,P001844,P006739,3.45,-4,7,11
247,VIR,P001844,P008847,14.933,-9,21,30
247,VIR,P001844,P009549,13.116,-11,17,28
247,VIR,P001844,P010781,6.3,-3,9,12
247,VIR,P001844,PBCN,17.699,-10,28,38
247,VIR,P003048,P006739,2.3,2,6,4
247,VIR,P003048,P008847,11.183,-3,19,22
247,VIR,P003048,P009549,9.633,-5,15,20
247,VIR,P003048,P010781,2.683,2,7,5
247,VIR,P003048,PBCN,14.616,-1,28,29
247,VIR,P003527,P006739,7.033,5,16,11
247,VIR,P003527,P008847,7.033,5,16,11
247,VIR,P003527,P009549,0.6,-1,2,3
247,VIR,P003527,P010781,6.7,8,16,8
247,VIR,P004007,P004554,12.534,1,20,19
247,VIR,P004007,P006739,10.867,-2,18,20
247,VIR,P004007,P008847,2.267,-4,2,6
247,VIR,P004007,P009549,4.134,3,8,5
247,VIR,P004007,P010781,10.1,-5,13,18
247,VIR,P004554,P006739,10.501,5,21,16
247,VIR,P004554,P009549,3.667,4,9,5
247,VIR,P004554,P010781,9.367,-1,13,14
247,VIR,P004554,PBCN,1.317,-1,3,4
247,VIR,P006739,P008847,8.116,-1,16,17
247,VIR,P006739,P009549,4.267,3,11,8
247,VIR,P006739,P010781,13.8,6,27,21
247,VIR,P006739,PBCN,3.017,3,9,6
247,VIR,P008847,P009549,12.25,-9,16,25
247,VIR,P008847,P010781,10.733,4,23,19
247,VIR,P008847,PBCN,13.416,-8,19,27
247,VIR,P009549,P010781,0.267,2,2,0
247,VIR,P009549,PBCN,12.316,-7,18,25
247,VIR,P010781,PBCN,3.3,0,7,7
248,MAD,P001392,P003108,1.884,-2,0,2
248,MAD,P001392,P004887,5.55,-1,10,11
248,MAD,P001392,P005791,1.85,-3,0,3
248,MAD,P001392,P005928,0.317,0,0,0
248,MAD,P001392,P006540,5.516,-2,10,12
248,MAD,P001392,P009005,7.4,-4,10,14
248,MAD,P001392,PCVM,7.083,-4,10,14
248,MAD,P003108,P004887,7.25,-9,14,23
248,MAD,P003108,P005791,20.35,7,46,39
248,MAD,P003108,P005928,21.35,-7,42,49
248,MAD,P003108,P006540,7.717,1,18,17
248,MAD,P003108,P009005,7.251,-6,9,15
248,MAD,P003108,P010357,24.883,-2,55,57
248,MAD,P003108,PCVM,3.117,-3,5,8
248,MAD,P003108,PTGB,25.666,1,59,58
248,MAD,P004887,P005928,4.783,-8,9,17
248,MAD,P004887,P006540,4.683,-2,11,13
248,MAD,P004887,P009005,8.65,-2,17,19
248,MAD,P004887,P010357,3.233,-8,7,15
248,MAD,P004887,PCVM,7.1,-2,15,17
248,MAD,P004887,PTGB,6.283,-8,13,21
248,MAD,P005791,P005928,15.883,6,37,31
248,MAD,P005791,P006540,10.899,1,22,21
248,MAD,P005791,P009005,6.466,-6,7,13
248,MAD,P005791,P010357,23.999,6,53,47
248,MAD,P005791,PCVM,4.566,-8,1,9
248,MAD,P005791,PTGB,19.383,9,46,37
248,MAD,P005928,P006540,3.85,-1,8,9
248,MAD,P005928,P009005,5.717,-1,10,11
248,MAD,P005928,P010357,21.066,-5,46,51
248,MAD,P005928,PTGB,18.766,-4,40,44
248,MAD,P006540,P009005,12.449,-9,20,29
248,MAD,P006540,P010357,12.283,-1,24,25
248,MAD,P006540,PCVM,8.599,-8,12,20
248,MAD,P006540,PTGB,5.4,5,15,10
248,MAD,P009005,P010357,6.883,-6,9,15
248,MAD,P009005,PCVM,11.666,-10,16,26
248,MAD,P009005,PTGB,3.05,0,6,6
248,MAD,P010357,PCVM,3.033,-5,1,6
248,MAD,P010357,PTGB,22.616,1,53,52
248,MAD,PCVM,PTGB,1.5,0,4,4
248,ULK,P001932,P002968,17.049,-7,35,42
248,ULK,P001932,P004004,5.217,3,9,6
248,ULK,P001932,P005844,4.75,8,15,7
248,ULK,P001932,P006068,10.567,-2,21,23
248,ULK,P001932,P006661,13.9,7,39,32
248,ULK,P001932,P006961,14.499,11,39,28
248,ULK,P001932,P008962,25.65,6,61,55
248,ULK,P001932,P009849,8.883,-5,16,21
248,ULK,P001932,P011157,4.734,6,12,6
248,ULK,P001932,P011980,0.883,1,1,0
248,ULK,P002968,P004004,1.583,-2,2,4
248,ULK,P002968,P006068,9.216,-5,16,21
248,ULK,P002968,P006661,7.55,-6,17,23
248,ULK,P002968,P006961,8.866,-4,19,23
248,ULK,P002968,P008962,17.199,-9,35,44
248,ULK,P002968,P009849,8.883,-5,16,21
248,ULK,P002968,P011052,1.0,-4,0,4
248,ULK,P002968,P011980,0.85,-2,0,2
248,ULK,P004004,P005844,6.217,-3,7,10
248,ULK,P004004,P006068,0.367,0,0,0
248,ULK,P004004,P006661,10.016,1,19,18
248,ULK,P004004,P006961,15.516,10,32,22
248,ULK,P004004,P008962,10.75,4,22,18
248,ULK,P004004,P011052,4.55,2,12,10
248,ULK,P004004,P011157,10.033,13,27,14
248,ULK,P004004,P011980,7.083,4,14,10
248,ULK,P005844,P006068,0.367,0,0,0
248,ULK,P005844,P006661,10.233,5,22,17
248,ULK,P005844,P006961,10.233,5,22,17
248,ULK,P005844,P008962,5.933,6,15,9
248,ULK,P005844,P011980,4.667,-1,7,8
248,ULK,P006068,P006661,1.317,3,5,2
248,ULK,P006068,P006961,0.333,0,0,0
248,ULK,P006068,P008962,10.567,-2,21,23
248,ULK,P006068,P009849,8.883,-5,16,21
248,ULK,P006068,P011052,0.333,0,0,0
248,ULK,P006068,P011157,1.317,3,5,2
248,ULK,P006068,P011980,0.333,0,0,0
248,ULK,P006661,P006961,19.699,7,47,40
248,ULK,P006661,P008962,16.249,7,43,36
248,ULK,P006661,P011052,1.0,-2,2,4
248,ULK,P006661,P011157,5.183,9,17,8
248,ULK,P006661,P011980,6.717,1,13,12
248,ULK,P006961,P008962,19.549,12,50,38
248,ULK,P006961,P011052,4.917,0,10,10
248,ULK,P006961,P011157,8.383,13,23,10
248,ULK,P006961,P011980,7.933,2,14,12
248,ULK,P008962,P009849,8.883,-5,16,21
248,ULK,P008962,P011052,4.55,2,12,10
248,ULK,P008962,P011157,8.934,11,25,14
248,ULK,P011052,P011157,4.4,4,12,8
248,ULK,P011052,P011980,0.85,-2,0,2
248,ULK,P011157,P011980,2.416,5,7,2
249,BAR,P000925,P002939,24.684,9,51,42
249,BAR,P000925,P003478,1.2,-2,0,2
249,BAR,P000925,P004866,26.017,12,57,45
249,BAR,P000925,P006435,9.1,3,20,17
249,BAR,P000925,P007464,4.05,3,10,7
249,BAR,P000925,P007519,11.2,9,25,16
249,BAR,P000925,P009992,6.917,-2,12,14
249,BAR,P000925,P012745,23.167,7,47,40
249,BAR,P000925,PLFW,2.533,1,6,5
249,BAR,P002939,P003196,0.583,2,2,0
249,BAR,P002939,P003478,1.2,-2,0,2
249,BAR,P002939,P004866,24.067,13,53,40
249,BAR,P002939,P006435,7.9,2,17,15
249,BAR,P002939,P007464,2.717,3,7,4
249,BAR,P002939,P007519,11.783,11,27,16
249,BAR,P002939,P009992,5.584,-2,9,11
249,BAR,P002939,P012745,22.55,8,46,38
249,BAR,P003196,P003478,3.85,-8,5,13
249,BAR,P003196,P004866,6.883,9,21,12
249,BAR,P003196,P006435,11.533,-1,29,30
249,BAR,P003196,P007464,8.783,1,25,24
249,BAR,P003196,P007519,2.35,3,4,1
249,BAR,P003196,P012745,6.05,-2,11,13
249,BAR,P003196,PLFW,11.1,-4,27,31
249,BAR,P003478,P006435,5.05,-10,5,15
249,BAR,P003478,P007464,2.2,-4,3,7
249,BAR,P003478,P012745,2.85,-6,2,8
249,BAR,P003478,PLFW,3.85,-8,5,13
249,BAR,P004866,P006435,13.533,13,39,26
249,BAR,P004866,P007464,8.583,9,27,18
249,BAR,P004866,P007519,13.55,12,29,17
249,BAR,P004866,P009992,6.917,-2,12,14
249,BAR,P004866,P012745,24.317,12,51,39
249,BAR,P004866,PLFW,7.733,6,23,17
249,BAR,P006435,P007464,8.783,1,25,24
249,BAR,P006435,P007519,1.1,2,2,0
249,BAR,P006435,P012745,13.9,0,29,29
249,BAR,P006435,PLFW,11.633,-2,30,32
249,BAR,P007464,P009992,4.05,3,10,7
249,BAR,P007464,P012745,2.05,-1,5,6
249,BAR,P007464,PLFW,10.116,1,28,27
249,BAR,P007519,P012745,13.55,12,29,17
249,BAR,P007519,PLFW,0.667,-1,0,1
249,BAR,P009992,P012745,2.867,-5,2,7
249,BAR,P009992,PLFW,1.333,0,3,3
249,BAR,P012745,PLFW,5.567,-5,10,15
249,PAM,P000556,P005356,6.816,-3,18,21
249,PAM,P000556,P006433,1.583,0,2,2
249,PAM,P000556,P007870,2.716,-3,4,7
249,PAM,P000556,P010393,7.983,-3,22,25
249,PAM,P000556,P010568,2.033,-5,2,7
249,PAM,P000556,P011970,6.983,-3,20,23
249,PAM,P000556,P011982,9.866,0,26,26
249,PAM,P000556,P012795,4.816,-7,10,17
249,PAM,P003960,P005356,9.766,6,22,16
249,PAM,P003960,P006433,13.966,-5,24,29
249,PAM,P003960,P006643,13.666,-13,20,33
249,PAM,P003960,P007870,20.766,-10,33,43
249,PAM,P003960,P010393,6.049,6,13,7
249,PAM,P003960,P010568,26.949,-8,45,53
249,PAM,P003960,P011970,1.3,0,3,3
249,PAM,P003960,P011982,7.649,2,16,14
249,PAM,P003960,P012740,1.25,-1,1,2
249,PAM,P003960,P012795,15.699,7,31,24
249,PAM,P005356,P007870,8.566,1,16,15
249,PAM,P005356,P010393,5.599,2,18,16
249,PAM,P005356,P010568,11.766,1,24,23
249,PAM,P005356,P011970,4.716,0,14,14
249,PAM,P005356,P011982,10.282,3,27,24
249,PAM,P005356,P012795,8.949,2,21,19
249,PAM,P006433,P006643,11.783,-11,18,29
249,PAM,P006433,P007870,11.783,-11,18,29
249,PAM,P006433,P010393,3.766,6,8,2
249,PAM,P006433,P010568,12.983,-9,20,29
249,PAM,P006433,P011982,2.566,4,6,2
249,PAM,P006433,P012795,3.766,6,8,2
249,PAM,P006643,P007870,13.666,-13,20,33
249,PAM,P006643,P010568,13.666,-13,20,33
249,PAM,P006643,P012795,1.883,-2,2,4
249,PAM,P007870,P010568,22.799,-15,35,50
249,PAM,P007870,P011970,0.683,2,2,0
249,PAM,P007870,P011982,4.499,-3,7,10
249,PAM,P007870,P012740,1.25,-1,1,2
249,PAM,P007870,P012795,7.2,1,12,11
249,PAM,P010393,P010568,3.733,2,6,4
249,PAM,P010393,P011970,7.633,-5,21,26
249,PAM,P010393,P011982,10.599,5,29,24
249,PAM,P010393,P012795,10.898,-1,23,24
249,PAM,P010568,P011982,7.366,-7,11,18
249,PAM,P010568,P012740,1.25,-1,1,2
249,PAM,P010568,P012795,13.383,3,24,21
249,PAM,P011970,P011982,7.483,3,23,20
249,PAM,P011970,P012795,4.466,-9,9,18
249,PAM,P011982,P012795,9.882,1,23,22
249,PAM,P012740,P012795,1.25,-1,1,2
250,MIL,P000796,P001518,8.032,-9,15,24
250,MIL,P000796,P002812,11.35,-10,24,34
250,MIL,P000796,P002849,8.533,0,17,17
250,MIL,P000796,P007032,13.6,-8,29,37
250,MIL,P000796,P007201,1.35,6,7,1
250,MIL,P000796,P007831,14.033,9,36,27
250,MIL,P000796,P011205,10.316,3,26,23
250,MIL,P000796,P011224,9.433,10,25,15
250,MIL,P000796,P012800,6.817,-9,13,22
250,MIL,P001518,P002812,6.466,-9,12,21
250,MIL,P001518,P002849,1.566,0,3,3
250,MIL,P001518,P007032,7.949,-9,15,24
250,MIL,P001518,P007831,1.566,0,3,3
250,MIL,P001518,P011205,1.616,0,5,5
250,MIL,P001518,P012800,4.933,-9,7,16
250,MIL,P002812,P002849,0.367,-2,0,2
250,MIL,P002812,P007032,11.35,-10,24,34
250,MIL,P002812,P007831,4.517,1,12,11
250,MIL,P002812,P011205,3.05,-3,7,10
250,MIL,P002812,P011224,1.483,2,4,2
250,MIL,P002812,P012800,6.817,-9,13,22
250,MIL,P002849,P007032,2.617,0,5,5
250,MIL,P002849,P007201,19.133,4,37,33
250,MIL,P002849,P007831,27.299,6,54,48
250,MIL,P002849,P011205,25.049,4,49,45
250,MIL,P002849,P011224,25.733,6,51,45
250,MIL,P002849,P012800,0.367,-2,0,2
250,MIL,P007032,P007831,6.767,3,17,14
250,MIL,P007032,P011205,3.05,-3,7,10
250,MIL,P007032,P011224,2.25,4,6,2
250,MIL,P007032,P012800,6.817,-9,13,22
250,MIL,P007201,P007831,20.483,10,44,34
250,MIL,P007201,P011205,20.483,10,44,34
250,MIL,P007201,P011224,20.483,10,44,34
250,MIL,P007831,P011205,27.916,7,58,51
250,MIL,P007831,P011224,28.566,14,62,48
250,MIL,P007831,P012800,1.517,2,6,4
250,MIL,P011205,P011224,26.316,10,56,46
250,PAR,P000956,P003983,21.233,13,50,37
250,PAR,P000956,P004172,10.633,-2,27,29
250,PAR,P000956,P007673,5.183,3,7,4
250,PAR,P000956,P008987,19.75,13,47,34
250,PAR,P000956,P009862,5.417,12,16,4
250,PAR,P000956,P011051,4.75,-2,10,12
250,PAR,P000956,P012096,15.983,18,40,22
250,PAR,P000956,P012743,1.983,-3,3,6
250,PAR,P003983,P004172,16.467,-7,38,45
250,PAR,P003983,P007673,8.95,-2,14,16
250,PAR,P003983,P008987,31.117,9,70,61
250,PAR,P003983,P009862,13.017,13,32,19
250,PAR,P003983,P011051,6.217,1,14,13
250,PAR,P003983,P012096,19.75,13,47,34
250,PAR,P003983,P012742,5.533,1,12,11
250,PAR,P003983,P012743,8.116,-5,15,20
250,PAR,P004172,P007673,5.534,-14,7,21
250,PAR,P004172,P008987,16.751,-16,35,51
250,PAR,P004172,P009862,8.217,-2,14,16
250,PAR,P004172,P011051,12.767,-7,24,31
250,PAR,P004172,P012096,9.483,-5,24,29
250,PAR,P004172,P012742,7.4,-11,10,21
250,PAR,P004172,P012743,8.216,-8,13,21
250,PAR,P007673,P008987,10.717,-11,14,25
250,PAR,P007673,P009862,0.517,0,0,0
250,PAR,P007673,P011051,0.917,-6,0,6
250,PAR,P007673,P012096,9.283,-5,14,19
250,PAR,P007673,P012742,1.767,-9,0,9
250,PAR,P008987,P009862,13.534,13,32,19
250,PAR,P008987,P011051,5.651,-5,11,16
250,PAR,P008987,P012096,20.083,10,47,37
250,PAR,P008987,P012742,7.3,-8,12,20
250,PAR,P008987,P012743,6.633,-5,12,17
250,PAR,P009862,P011051,7.1,1,14,13
250,PAR,P009862,P012096,5.417,12,16,4
250,PAR,P009862,P012742,11.683,-1,22,23
250,PAR,P009862,P012743,11.766,-4,22,26
250,PAR,P011051,P012742,6.55,-8,10,18
250,PAR,P011051,P012743,7.116,-2,13,15
250,PAR,P012096,P012742,0.333,-3,0,3
250,PAR,P012742,P012743,11.166,-1,22,23
251,ASV,P000229,P002100,2.067,-2,6,8
251,ASV,P000229,P003526,10.084,-8,14,22
251,ASV,P000229,P004194,3.484,-9,6,15
251,ASV,P000229,P005094,15.0,-12,25,37
251,ASV,P000229,P006568,15.433,-10,23,33
251,ASV,P000229,P011386,18.984,-17,31,48
251,ASV,P000229,P012080,1.95,0,4,4
251,ASV,P000229,P012731,5.55,-8,10,18
251,ASV,P000229,PKIR,3.384,-2,5,7
251,ASV,P002100,P003526,6.233,-3,11,14
251,ASV,P002100,P004194,20.682,-4,38,42
251,ASV,P002100,P005094,4.717,-3,7,10
251,ASV,P002100,P006568,2.334,-1,2,3
251,ASV,P002100,P011386,5.6,-4,12,16
251,ASV,P002100,P012080,17.483,1,30,29
251,ASV,P002100,P012731,18.366,0,35,35
251,ASV,P002100,PKIR,14.85,4,27,23
251,ASV,P003526,P004194,6.116,-8,11,19
251,ASV,P003526,P005094,14.734,-13,19,32
251,ASV,P003526,P006568,10.067,-7,10,17
251,ASV,P003526,P011386,13.617,-10,20,30
251,ASV,P003526,P012080,2.633,-3,3,6
251,ASV,P003526,P012731,1.516,0,4,4
251,ASV,P004194,P005094,4.6,-8,7,15
251,ASV,P004194,P011386,6.15,-11,12,23
251,ASV,P004194,P012080,16.683,0,28,28
251,ASV,P004194,P012731,16.899,1,33,32
251,ASV,P004194,PKIR,14.05,3,25,22
251,ASV,P005094,P006568,14.983,-11,21,32
251,ASV,P005094,P011386,17.35,-14,27,41
251,ASV,P005094,P012080,2.883,-2,5,7
251,ASV,P005094,P012731,2.933,-4,6,10
251,ASV,P005094,PKIR,1.4,-1,3,4
251,ASV,P006568,P011386,16.3,-10,23,33
251,ASV,P006568,P012080,2.75,1,6,5
251,ASV,P006568,P012731,5.017,-5,8,13
251,ASV,P006568,PKIR,4.184,-1,7,8
251,ASV,P011386,P012080,1.95,0,4,4
251,ASV,P011386,P012731,6.733,-8,14,22
251,ASV,P011386,PKIR,3.384,-2,5,7
251,ASV,P012080,P012731,15.183,4,27,23
251,ASV,P012080,PKIR,16.217,3,29,26
251,ASV,P012731,PKIR,15.467,4,27,23
251,PAN,P001926,P002328,19.984,18,44,26
251,PAN,P001926,P003842,17.867,15,46,31
251,PAN,P001926,P005161,6.501,-2,8,10
251,PAN,P001926,P007553,4.383,2,8,6
251,PAN,P001926,P007866,12.917,1,22,21
251,PAN,P001926,P011204,18.533,16,46,30
251,PAN,P001926,P011209,0.7,-1,1,2
251,PAN,P001926,P012712,18.801,21,49,28
251,PAN,P001926,P012774,9.65,6,28,22
251,PAN,P002328,P003842,19.05,15,42,27
251,PAN,P002328,P005161,5.617,3,9,6
251,PAN,P002328,P007553,4.383,2,8,6
251,PAN,P002328,P007866,18.184,6,34,28
251,PAN,P002328,P011204,21.183,10,42,32
251,PAN,P002328,P011209,1.35,-4,2,6
251,PAN,P002328,P012712,14.268,13,32,19
251,PAN,P002328,P012774,10.317,5,23,18
251,PAN,P003842,P005161,5.717,-4,6,10
251,PAN,P003842,P006544,0.367,2,2,0
251,PAN,P003842,P007866,12.3,-4,20,24
251,PAN,P003842,P008084,0.367,2,2,0
251,PAN,P003842,P011204,22.266,14,54,40
251,PAN,P003842,P011209,3.516,-3,6,9
251,PAN,P003842,P012712,16.45,19,45,26
251,PAN,P003842,P012774,20.9,8,49,41
251,PAN,P005161,P007866,2.834,-5,3,8
251,PAN,P005161,P011204,0.583,-1,1,2
251,PAN,P005161,P011209,1.283,-2,2,4
251,PAN,P005161,P012712,4.334,5,7,2
251,PAN,P005161,P012774,1.467,-6,0,6
251,PAN,P006544,P007553,0.767,0,0,0
251,PAN,P006544,P008084,1.134,2,2,0
251,PAN,P006544,P011204,0.367,2,2,0
251,PAN,P006544,P011209,0.767,0,0,0
251,PAN,P006544,P012774,1.134,2,2,0
251,PAN,P007553,P007866,4.383,2,8,6
251,PAN,P007553,P008084,0.767,0,0,0
251,PAN,P007553,P011204,4.383,2,8,6
251,PAN,P007553,P011209,0.767,0,0,0
251,PAN,P007553,P012774,0.767,0,0,0
251,PAN,P007866,P011204,17.45,3,30,27
251,PAN,P007866,P011209,2.95,-5,4,9
251,PAN,P007866,P012712,4.451,1,8,7
251,PAN,P007866,P012774,11.867,-7,19,26
251,PAN,P008084,P011204,0.367,2,2,0
251,PAN,P008084,P011209,0.767,0,0,0
251,PAN,P008084,P012774,1.134,2,2,0
251,PAN,P011204,P011209,3.516,-3,6,9
251,PAN,P011204,P012712,15.683,14,41,27
251,PAN,P011204,P012774,17.133,9,40,31
251,PAN,P011209,P012712,0.817,-2,2,4
251,PAN,P011209,P012774,3.767,-4,5,9
251,PAN,P012712,P012774,8.8,9,28,19
252,BAS,P004603,P004761,14.434,11,34,23
252,BAS,P004603,P007230,17.867,9,42,33
252,BAS,P004603,P007946,0.867,2,2,0
252,BAS,P004603,P008850,5.6,-6,10,16
252,BAS,P004603,P009048,19.267,4,42,38
252,BAS,P004603,P011085,6.934,8,18,10
252,BAS,P004603,P011948,8.067,4,16,12
252,BAS,P004603,P012201,7.5,-8,12,20
252,BAS,P004761,P007230,17.568,20,43,23
252,BAS,P004761,P007946,2.067,3,5,2
252,BAS,P004761,P008850,1.8,-3,2,5
252,BAS,P004761,P009048,24.384,22,57,35
252,BAS,P004761,P010444,12.017,14,28,14
252,BAS,P004761,P011085,9.001,9,21,12
252,BAS,P004761,P011948,13.25,14,31,17
252,BAS,P004761,P012201,11.283,10,27,17
252,BAS,P007230,P007946,3.884,-2,8,10
252,BAS,P007230,P008850,5.533,-9,11,20
252,BAS,P007230,P009048,22.35,11,52,41
252,BAS,P007230,P010444,8.367,0,18,18
252,BAS,P007230,P011085,9.751,9,23,14
252,BAS,P007230,P011948,11.467,-2,23,25
252,BAS,P007230,P012201,8.149,0,20,20
252,BAS,P007946,P008850,4.834,2,12,10
252,BAS,P007946,P010444,8.301,1,17,16
252,BAS,P007946,P011085,7.301,4,14,10
252,BAS,P007946,P011948,4.101,-3,7,10
252,BAS,P007946,P012201,5.317,5,11,6
252,BAS,P008850,P009048,5.466,-11,8,19
252,BAS,P008850,P010444,4.7,-3,10,13
252,BAS,P008850,P011085,2.967,3,7,4
252,BAS,P008850,P011948,2.2,-6,3,9
252,BAS,P008850,P012201,8.1,-3,17,20
252,BAS,P009048,P010444,11.566,10,27,17
252,BAS,P009048,P011085,7.334,8,18,10
252,BAS,P009048,P011948,16.366,9,35,26
252,BAS,P009048,P012201,16.599,3,37,34
252,BAS,P010444,P011085,7.701,4,14,10
252,BAS,P010444,P011948,12.4,2,26,24
252,BAS,P010444,P012201,14.416,16,36,20
252,BAS,P011085,P011948,2.634,0,4,4
252,BAS,P011085,P012201,4.917,3,9,6
252,BAS,P011948,P012201,11.383,6,23,17
252,BER,P006251,P007025,4.716,-10,2,12
252,BER,P006251,P007550,2.383,-5,2,7
252,BER,P006251,P008211,2.217,-4,2,6
252,BER,P006251,P008780,7.383,-12,6,18
252,BER,P006251,P008967,5.05,-7,6,13
252,BER,P006251,P010791,1.216,-3,0,3
252,BER,P006251,P011934,8.55,-14,8,22
252,BER,P006251,P012720,7.549,-13,6,19
252,BER,P006919,P007025,9.9,-4,12,16
252,BER,P006919,P007550,8.466,-4,8,12
252,BER,P006919,P008211,11.616,-5,19,24
252,BER,P006919,P008780,16.417,3,39,36
252,BER,P006919,P008967,13.7,4,34,30
252,BER,P006919,P010791,17.567,7,38,31
252,BER,P006919,P011934,7.316,-8,9,17
252,BER,P006919,P012720,14.55,3,29,26
252,BER,P007025,P007550,10.583,-14,9,23
252,BER,P007025,P008211,3.85,-5,5,10
252,BER,P007025,P008780,5.983,-5,8,13
252,BER,P007025,P010791,10.15,-12,13,25
252,BER,P007025,P011631,1.95,-5,3,8
252,BER,P007025,P011934,6.416,-7,4,11
252,BER,P007025,P012720,12.716,-14,12,26
252,BER,P007550,P008211,9.466,1,22,21
252,BER,P007550,P008967,4.333,7,16,9
252,BER,P007550,P010791,9.95,-2,21,23
252,BER,P007550,P011631,5.35,1,16,15
252,BER,P007550,P011934,6.249,-6,5,11
252,BER,P007550,P012720,8.016,-10,5,15
252,BER,P008211,P008780,9.717,-9,15,24
252,BER,P008211,P008967,14.05,-2,31,33
252,BER,P008211,P010791,10.333,4,26,22
252,BER,P008211,P011631,5.35,1,16,15
252,BER,P008211,P011934,8.85,-12,11,23
252,BER,P008211,P012720,1.283,-1,1,2
252,BER,P008780,P008967,17.817,-4,37,41
252,BER,P008780,P010791,14.183,7,33,26
252,BER,P008780,P011934,9.617,-16,12,28
252,BER,P008780,P012720,14.083,0,30,30
252,BER,P008967,P010791,13.983,17,41,24
252,BER,P008967,P011631,3.4,6,13,7
252,BER,P008967,P011934,8.167,-14,12,26
252,BER,P008967,P012720,8.1,5,22,17
252,BER,P010791,P011631,5.35,1,16,15
252,BER,P010791,P012720,13.8,1,28,27
252,BER,P011934,P012720,8.299,-11,7,18
253,BER,P003958,P006251,1.45,-3,1,4
253,BER,P003958,P006919,6.7,-1,11,12
253,BER,P003958,P007025,6.783,0,13,13
253,BER,P003958,P007550,11.2,-2,24,26
253,BER,P003958,P008211,10.767,-2,20,22
253,BER,P003958,P008967,13.734,-1,30,31
253,BER,P003958,P010791,11.866,3,27,24
253,BER,P003958,P011934,7.584,-7,13,20
253,BER,P003958,P012720,17.784,-3,37,40
253,BER,P006251,P006919,9.65,-2,21,23
253,BER,P006251,P007025,0.117,0,0,0
253,BER,P006251,P007550,0.6,0,0,0
253,BER,P006251,P008211,13.9,-4,29,33
253,BER,P006251,P008967,8.267,-1,15,16
253,BER,P006251,P011631,0.117,0,0,0
253,BER,P006251,P011934,12.933,-1,28,29
253,BER,P006251,P012720,10.966,-5,22,27
253,BER,P006919,P007025,9.166,-4,17,21
253,BER,P006919,P007550,8.066,2,17,15
253,BER,P006919,P008211,11.817,-5,24,29
253,BER,P006919,P008967,8.367,7,20,13
253,BER,P006919,P010791,9.166,-4,17,21
253,BER,P006919,P011934,8.2,1,20,19
253,BER,P006919,P012720,8.4,-6,17,23
253,BER,P007025,P007550,9.433,4,20,16
253,BER,P007025,P008211,2.45,-7,3,10
253,BER,P007025,P008967,4.0,3,10,7
253,BER,P007025,P010791,10.799,-4,20,24
253,BER,P007025,P011631,0.117,0,0,0
253,BER,P007025,P011934,0.967,1,3,2
253,BER,P007025,P012720,3.7,-5,6,11
253,BER,P007550,P008967,10.25,0,24,24
253,BER,P007550,P010791,12.783,8,32,24
253,BER,P007550,P011631,0.117,0,0,0
253,BER,P007550,P011934,2.783,-7,2,9
253,BER,P007550,P012720,7.5,-1,17,18
253,BER,P008211,P008967,15.634,1,31,30
253,BER,P008211,P010791,4.066,-8,5,13
253,BER,P008211,P011934,17.734,-1,39,40
253,BER,P008211,P012720,20.9,-10,41,51
253,BER,P008967,P010791,9.933,7,27,20
253,BER,P008967,P011631,0.117,0,0,0
253,BER,P008967,P011934,14.767,-9,25,34
253,BER,P008967,P012720,18.467,-3,38,41
253,BER,P010791,P012720,8.783,-2,20,22
253,BER,P011934,P012720,17.1,-9,34,43
253,MCO,P002581,P004197,2.8,-9,2,11
253,MCO,P002581,P004790,3.733,-6,4,10
253,MCO,P002581,P005985,4.75,-11,4,15
253,MCO,P002581,P011212,4.75,-11,4,15
253,MCO,P002581,P011231,1.017,-5,0,5
253,MCO,P002581,P012515,1.95,-2,2,4
253,MCO,P004197,P004790,1.783,-4,2,6
253,MCO,P004197,P005985,5.05,-10,8,18
253,MCO,P004197,P008099,2.25,-1,6,7
253,MCO,P004197,P011212,2.8,-9,2,11
253,MCO,P004197,P011231,3.267,-6,6,12
253,MCO,P004197,PLCZ,2.25,-1,6,7
253,MCO,P004790,P005985,6.516,1,13,12
253,MCO,P004790,P008099,0.5,2,2,0
253,MCO,P004790,P011196,9.083,20,29,9
253,MCO,P004790,P011212,10.033,7,24,17
253,MCO,P004790,P011231,2.3,7,9,2
253,MCO,P004790,P012515,8.733,11,22,11
253,MCO,P004790,P012709,8.583,18,27,9
253,MCO,P005985,P008099,12.15,2,30,28
253,MCO,P005985,P010588,13.616,-1,29,30
253,MCO,P005985,P011196,11.583,15,29,14
253,MCO,P005985,P011212,15.483,-4,28,32
253,MCO,P005985,P011231,16.017,2,35,33
253,MCO,P005985,P012515,16.533,5,36,31
253,MCO,P005985,P012709,2.283,5,7,2
253,MCO,P005985,PLCZ,12.883,-4,29,33
253,MCO,P008099,P010588,9.4,1,22,21
253,MCO,P008099,P011196,0.5,2,2,0
253,MCO,P008099,P011212,0.7,3,3,0
253,MCO,P008099,P011231,6.667,-1,14,15
253,MCO,P008099,P012515,4.783,0,13,13
253,MCO,P008099,PLCZ,11.65,0,28,28
253,MCO,P010588,P011196,7.466,-3,14,17
253,MCO,P010588,P011212,9.399,-4,18,22
253,MCO,P010588,P011231,9.116,-10,14,24
253,MCO,P010588,P012515,8.283,1,20,19
253,MCO,P010588,P012709,4.483,-5,8,13
253,MCO,P010588,PLCZ,10.633,-3,23,26
253,MCO,P011196,P011212,19.583,16,48,32
253,MCO,P011196,P011231,13.033,5,31,26
253,MCO,P011196,P012515,15.15,24,40,16
253,MCO,P011196,P012709,13.066,13,35,22
253,MCO,P011212,P011231,12.033,-7,22,29
253,MCO,P011212,P012515,17.567,18,43,25
253,MCO,P011212,P012709,10.783,8,28,20
253,MCO,P011212,PLCZ,1.933,-1,4,5
253,MCO,P011231,P012515,5.817,6,14,8
253,MCO,P011231,P012709,6.283,0,15,15
253,MCO,P011231,PLCZ,6.45,-3,12,15
253,MCO,P012515,P012709,6.783,13,20,7
253,MCO,P012515,PLCZ,5.733,-4,14,18
254,BAR,P000925,P002939,17.267,-6,40,46
254,BAR,P000925,P003478,3.35,-7,4,11
254,BAR,P000925,P004866,18.934,8,50,42
254,BAR,P000925,P006435,17.634,-4,39,43
254,BAR,P000925,P007519,9.95,13,27,14
254,BAR,P000925,P011244,7.767,-2,14,16
254,BAR,P000925,P012745,17.167,7,46,39
254,BAR,P000925,PLFW,7.667,11,20,9
254,BAR,P002939,P003196,6.033,5,10,5
254,BAR,P002939,P003478,7.983,1,11,10
254,BAR,P002939,P004866,15.317,-2,39,41
254,BAR,P002939,P006435,19.8,-3,40,43
254,BAR,P002939,P007519,3.5,2,10,8
254,BAR,P002939,P011244,8.25,2,13,11
254,BAR,P002939,P012745,15.05,-3,37,40
254,BAR,P003196,P003478,9.883,13,23,10
254,BAR,P003196,P004866,3.933,-2,7,9
254,BAR,P003196,P006435,6.033,5,10,5
254,BAR,P003196,P007519,7.783,6,20,14
254,BAR,P003196,P011244,10.366,11,23,12
254,BAR,P003196,P012745,3.45,0,7,7
254,BAR,P003196,PLFW,7.783,6,20,14
254,BAR,P003478,P006435,9.2,1,14,13
254,BAR,P003478,P007519,4.55,7,15,8
254,BAR,P003478,P011244,13.15,9,29,20
254,BAR,P003478,P012745,1.117,1,2,1
254,BAR,P003478,PLFW,5.767,7,18,11
254,BAR,P004866,P006435,11.817,-4,29,33
254,BAR,P004866,P007519,11.783,10,30,20
254,BAR,P004866,P011244,3.583,-2,6,8
254,BAR,P004866,P012745,20.75,8,55,47
254,BAR,P004866,PLFW,8.283,8,20,12
254,BAR,P006435,P007519,2.65,4,6,2
254,BAR,P006435,P011244,12.117,6,22,16
254,BAR,P006435,P012745,11.55,-5,27,32
254,BAR,P006435,PLFW,3.867,4,9,5
254,BAR,P007519,P011244,9.916,9,25,16
254,BAR,P007519,P012745,10.317,14,30,16
254,BAR,P007519,PLFW,15.483,19,41,22
254,BAR,P011244,P012745,1.25,2,4,2
254,BAR,P011244,PLFW,11.133,9,28,19
254,BAR,P012745,PLFW,6.817,12,20,8
254,PAR,P000956,P003983,12.084,0,20,20
254,PAR,P000956,P007400,7.683,1,18,17
254,PAR,P000956,P007673,6.867,-6,6,12
254,PAR,P000956,P008987,11.583,-3,20,23
254,PAR,P000956,P009862,1.083,-3,0,3
254,PAR,P000956,P011051,9.917,1,16,15
254,PAR,P000956,P012096,4.633,-6,8,14
254,PAR,P000956,P012742,1.383,-2,4,6
254,PAR,P000956,P012743,2.967,-2,4,6
254,PAR,P003983,P004172,7.367,0,18,18
254,PAR,P003983,P007400,13.066,5,32,27
254,PAR,P003983,P007673,10.084,-2,16,18
254,PAR,P003983,P008987,27.55,5,62,57
254,PAR,P003983,P009862,18.433,3,46,43
254,PAR,P003983,P011051,14.434,3,30,27
254,PAR,P003983,P012096,3.25,-4,4,8
254,PAR,P003983,P012743,15.8,2,36,34
254,PAR,P004172,P007400,4.217,-9,4,13
254,PAR,P004172,P007673,1.55,-4,0,4
254,PAR,P004172,P008987,9.767,-3,20,23
254,PAR,P004172,P009862,12.434,-8,24,32
254,PAR,P004172,P011051,4.55,-7,4,11
254,PAR,P004172,P012096,0.85,1,2,1
254,PAR,P004172,P012742,6.617,-12,6,18
254,PAR,P004172,P012743,8.584,-6,18,24
254,PAR,P007400,P008987,14.849,-1,36,37
254,PAR,P007400,P009862,11.383,-11,22,33
254,PAR,P007400,P011051,12.35,1,28,27
254,PAR,P007400,P012096,2.066,-8,4,12
254,PAR,P007400,P012742,6.0,-15,8,23
254,PAR,P007400,P012743,4.65,-3,8,11
254,PAR,P007673,P008987,9.75,-7,12,19
254,PAR,P007673,P009862,5.383,-2,10,12
254,PAR,P007673,P011051,7.717,-8,6,14
254,PAR,P007673,P012096,2.967,-2,4,6
254,PAR,P007673,P012742,1.55,-4,0,4
254,PAR,P007673,P012743,5.0,-1,10,11
254,PAR,P008987,P009862,20.766,-3,48,51
254,PAR,P008987,P011051,17.067,-4,30,34
254,PAR,P008987,P012096,2.916,-7,6,13
254,PAR,P008987,P012742,4.183,-9,6,15
254,PAR,P008987,P012743,12.833,4,32,28
254,PAR,P009862,P011051,9.683,-7,18,25
254,PAR,P009862,P012096,1.25,-3,2,5
254,PAR,P009862,P012742,5.467,-12,6,18
254,PAR,P009862,P012743,14.05,-2,32,34
254,PAR,P011051,P012742,4.55,-7,4,11
254,PAR,P012096,P012742,2.633,-5,6,11
254,PAR,P012096,P012743,2.967,-2,4,6
254,PAR,P012742,P012743,1.217,-6,0,6
255,OLY,P001255,P007853,0.15,0,0,0
255,OLY,P001255,P007982,6.367,-3,11,14
255,OLY,P001255,P008811,21.733,0,30,30
255,OLY,P001255,P008829,18.067,6,30,24
255,OLY,P001255,P008855,19.2,11,40,29
255,OLY,P001255,P010612,18.367,-1,22,23
255,OLY,P001255,P011194,5.883,0,13,13
255,OLY,P001255,P011965,2.033,4,5,1
255,OLY,P001255,P011983,2.233,1,8,7
255,OLY,P001255,P012878,2.367,6,13,7
255,OLY,P007853,P007982,12.266,0,22,22
255,OLY,P007853,P008811,2.716,-2,3,5
255,OLY,P007853,P008829,8.533,-2,15,17
255,OLY,P007853,P008855,7.416,5,13,8
255,OLY,P007853,P010612,0.783,-3,0,3
255,OLY,P007853,P011194,15.216,0,28,28
255,OLY,P007853,P011965,3.783,0,6,6
255,OLY,P007853,P012878,13.333,2,25,23
255,OLY,P007982,P008811,7.616,-7,6,13
255,OLY,P007982,P008829,13.133,0,26,26
255,OLY,P007982,P008855,4.95,7,15,8
255,OLY,P007982,P010612,5.683,-8,3,11
255,OLY,P007982,P011194,13.05,-5,22,27
255,OLY,P007982,P012878,10.867,4,27,23
255,OLY,P008811,P008829,16.75,4,22,18
255,OLY,P008811,P008855,18.766,6,30,24
255,OLY,P008811,P010612,19.15,-4,22,26
255,OLY,P008811,P011194,7.699,-6,11,17
255,OLY,P008811,P011965,1.133,0,0,0
255,OLY,P008811,P011983,2.233,1,8,7
255,OLY,P008829,P008855,15.467,6,27,21
255,OLY,P008829,P010612,16.75,4,22,18
255,OLY,P008829,P011194,7.85,-2,15,17
255,OLY,P008829,P012878,9.85,0,23,23
255,OLY,P008855,P010612,13.467,4,19,15
255,OLY,P008855,P011194,10.849,10,26,16
255,OLY,P008855,P011965,5.816,4,11,7
255,OLY,P008855,P011983,2.233,1,8,7
255,OLY,P008855,P012878,7.7,10,23,13
255,OLY,P010612,P011194,2.4,-8,0,8
255,OLY,P011194,P011965,5.816,4,11,7
255,OLY,P011194,P011983,2.233,1,8,7
255,OLY,P011194,P012878,13.4,6,30,24
255,OLY,P011965,P012878,4.683,4,11,7
255,PAN,P001926,P002328,7.666,-8,13,21
255,PAN,P001926,P003842,18.067,-5,25,30
255,PAN,P001926,P005161,6.117,-3,5,8
255,PAN,P001926,P007866,18.216,-3,35,38
255,PAN,P001926,P011204,13.3,3,30,27
255,PAN,P001926,P012712,4.617,-5,7,12
255,PAN,P001926,P012774,14.417,-7,25,32
255,PAN,P002328,P003842,10.333,-10,6,16
255,PAN,P002328,P005161,2.533,1,3,2
255,PAN,P002328,P007553,4.733,5,9,4
255,PAN,P002328,P007866,16.999,-4,25,29
255,PAN,P002328,P011204,12.466,-1,22,23
255,PAN,P002328,P012712,2.833,-4,7,11
255,PAN,P002328,P012774,12.833,-7,15,22
255,PAN,P003842,P005161,13.5,-1,21,22
255,PAN,P003842,P007866,27.399,-5,39,44
255,PAN,P003842,P011204,25.433,1,41,40
255,PAN,P003842,P012712,7.417,-6,9,15
255,PAN,P003842,P012774,28.783,-10,43,53
255,PAN,P005161,P007866,9.133,-1,14,15
255,PAN,P005161,P011204,8.8,2,16,14
255,PAN,P005161,P012712,4.367,0,7,7
255,PAN,P005161,P012774,9.55,-2,18,20
255,PAN,P007553,P007866,4.733,5,9,4
255,PAN,P007553,P011204,4.733,5,9,4
255,PAN,P007553,P012774,4.733,5,9,4
255,PAN,P007866,P011204,27.965,5,53,48
255,PAN,P007866,P012712,4.316,-3,9,12
255,PAN,P007866,P012774,29.899,-2,48,50
255,PAN,P011204,P012712,9.05,-4,16,20
255,PAN,P011204,P012774,29.049,5,53,48
255,PAN,P012712,P012774,6.0,-6,9,15
256,BAS,P003198,P004603,1.4,0,3,3
256,BAS,P003198,P004761,3.366,-3,5,8
256,BAS,P003198,P007230,0.833,0,0,0
256,BAS,P003198,P007946,7.383,1,16,15
256,BAS,P003198,P008850,1.117,0,4,4
256,BAS,P003198,P009048,5.533,-2,14,16
256,BAS,P003198,P010444,11.516,-1,27,28
256,BAS,P003198,P011948,9.55,2,25,23
256,BAS,P003198,P012201,10.966,-1,26,27
256,BAS,P004603,P004761,19.983,8,42,34
256,BAS,P004603,P007230,19.983,8,42,34
256,BAS,P004603,P007946,4.433,2,8,6
256,BAS,P004603,P009048,16.95,6,37,31
256,BAS,P004603,P011948,11.683,-5,22,27
256,BAS,P004603,P012201,11.1,13,26,13
256,BAS,P004761,P007230,26.733,15,55,40
256,BAS,P004761,P007946,8.016,1,9,8
256,BAS,P004761,P009048,21.733,11,51,40
256,BAS,P004761,P010444,9.766,4,18,14
256,BAS,P004761,P011948,14.566,2,28,26
256,BAS,P004761,P012201,14.833,10,32,22
256,BAS,P007230,P007946,6.6,4,9,5
256,BAS,P007230,P009048,20.833,12,49,37
256,BAS,P007230,P010444,7.45,8,16,8
256,BAS,P007230,P011948,14.783,3,31,28
256,BAS,P007230,P012201,12.517,14,30,16
256,BAS,P007946,P010444,10.033,3,17,14
256,BAS,P007946,P011948,9.533,8,20,12
256,BAS,P007946,P012201,11.866,1,21,20
256,BAS,P008850,P009048,1.117,0,4,4
256,BAS,P008850,P010444,1.117,0,4,4
256,BAS,P008850,P011948,1.117,0,4,4
256,BAS,P009048,P010444,8.583,4,26,22
256,BAS,P009048,P011948,15.283,-3,36,39
256,BAS,P009048,P012201,12.1,12,35,23
256,BAS,P010444,P011948,13.133,10,34,24
256,BAS,P010444,P012201,12.866,0,30,30
256,BAS,P011948,P012201,9.616,3,24,21
256,MIL,P000796,P002812,1.833,2,2,0
256,MIL,P000796,P002849,22.9,-1,43,44
256,MIL,P000796,P005670,6.917,0,19,19
256,MIL,P000796,P006509,0.483,0,0,0
256,MIL,P000796,P006721,1.917,2,5,3
256,MIL,P000796,P007032,4.433,2,11,9
256,MIL,P000796,P007201,14.884,-5,33,38
256,MIL,P000796,P007831,25.866,-1,51,52
256,MIL,P000796,P011205,20.95,3,42,39
256,MIL,P000796,P011224,20.217,-2,38,40
256,MIL,P002812,P002849,1.867,-3,1,4
256,MIL,P002812,P005670,2.516,-6,0,6
256,MIL,P002812,P006509,4.983,-8,3,11
256,MIL,P002812,P007032,4.116,-3,4,7
256,MIL,P002812,P007201,4.666,-11,2,13
256,MIL,P002812,P007831,5.6,-7,3,10
256,MIL,P002812,P011205,3.633,-3,4,7
256,MIL,P002812,P011224,4.25,-9,1,10
256,MIL,P002849,P005670,1.067,1,3,2
256,MIL,P002849,P006509,1.867,-3,1,4
256,MIL,P002849,P007032,2.817,-3,9,12
256,MIL,P002849,P007201,10.751,-10,17,27
256,MIL,P002849,P007831,24.717,-8,41,49
256,MIL,P002849,P011205,15.467,-4,24,28
256,MIL,P002849,P011224,22.551,-9,37,46
256,MIL,P005670,P006509,2.616,5,9,4
256,MIL,P005670,P006721,4.05,7,14,7
256,MIL,P005670,P007032,0.483,0,0,0
256,MIL,P005670,P007201,10.6,-1,28,29
256,MIL,P005670,P007831,4.716,-7,9,16
256,MIL,P005670,P011205,8.567,5,28,23
256,MIL,P005670,P011224,2.8,-8,2,10
256,MIL,P006509,P006721,2.133,5,9,4
256,MIL,P006509,P007032,2.766,-5,2,7
256,MIL,P006509,P007201,4.766,0,11,11
256,MIL,P006509,P007831,2.217,-3,1,4
256,MIL,P006509,P011205,4.416,0,11,11
256,MIL,P006509,P011224,2.217,-3,1,4
256,MIL,P006721,P007201,4.05,7,14,7
256,MIL,P006721,P011205,4.05,7,14,7
256,MIL,P007032,P007201,2.5,-8,2,10
256,MIL,P007032,P007831,3.95,2,11,9
256,MIL,P007032,P011205,3.85,-6,4,10
256,MIL,P007032,P011224,2.817,-3,9,12
256,MIL,P007201,P007831,14.533,-15,23,38
256,MIL,P007201,P011205,14.467,-8,34,42
256,MIL,P007201,P011224,10.451,-17,12,29
256,MIL,P007831,P011205,18.216,-1,32,33
256,MIL,P007831,P011224,24.717,-12,37,49
256,MIL,P011205,P011224,12.784,-5,19,24
257,RED,P002553,P004720,1.983,0,2,2
257,RED,P002553,P005099,5.083,3,11,8
257,RED,P002553,P006436,17.084,-5,27,32
257,RED,P002553,P009035,16.117,-5,27,32
257,RED,P002553,P011941,2.6,0,2,2
257,RED,P002553,P012044,16.734,-5,27,32
257,RED,P002553,P012801,15.267,-8,20,28
257,RED,P004720,P005099,2.699,-3,2,5
257,RED,P004720,P006436,0.433,-1,0,1
257,RED,P004720,P007960,1.066,-3,0,3
257,RED,P004720,P011941,2.966,-2,2,4
257,RED,P004720,P012044,0.35,-2,0,2
257,RED,P004720,P012801,2.699,-1,2,3
257,RED,P005099,P006436,7.2,2,23,21
257,RED,P005099,P007960,13.283,4,35,31
257,RED,P005099,P008966,3.8,4,9,5
257,RED,P005099,P009035,11.017,7,32,25
257,RED,P005099,P011941,7.266,1,14,13
257,RED,P005099,P011964,2.067,5,5,0
257,RED,P005099,P012044,9.783,-3,23,26
257,RED,P005099,P012801,11.266,8,30,22
257,RED,P006436,P007960,7.934,-5,20,25
257,RED,P006436,P008966,0.783,-2,0,2
257,RED,P006436,P009035,22.701,-4,45,49
257,RED,P006436,P011941,4.534,-5,7,12
257,RED,P006436,P011964,1.517,2,5,3
257,RED,P006436,P012044,24.618,-11,42,53
257,RED,P006436,P012801,22.468,-11,39,50
257,RED,P007960,P008966,5.317,5,14,9
257,RED,P007960,P009035,10.384,2,27,25
257,RED,P007960,P011941,8.517,0,19,19
257,RED,P007960,P011964,2.067,5,5,0
257,RED,P007960,P012044,12.034,-9,25,34
257,RED,P007960,P012801,15.334,5,39,34
257,RED,P008966,P009035,0.567,0,2,2
257,RED,P008966,P011941,5.533,3,12,9
257,RED,P008966,P012044,4.2,-1,8,9
257,RED,P008966,P012801,4.2,3,11,8
257,RED,P009035,P011964,3.584,7,10,3
257,RED,P009035,P012044,23.134,-7,43,50
257,RED,P009035,P012801,24.568,-4,50,54
257,RED,P011941,P012044,7.934,-7,14,21
257,RED,P011941,P012801,8.25,2,14,12
257,RED,P011964,P012044,1.517,2,5,3
257,RED,P011964,P012801,3.584,7,10,3
257,RED,P012044,P012801,23.968,-13,41,54
257,TEL,P005145,P007990,2.9,-1,6,7
257,TEL,P005145,P009622,6.9,-1,11,12
257,TEL,P005145,P009783,9.767,-2,17,19
257,TEL,P005145,P009863,9.767,-2,17,19
257,TEL,P005145,P011199,8.784,-3,15,18
257,TEL,P005145,P011214,0.95,1,2,1
257,TEL,P007990,P009622,10.515,-1,24,25
257,TEL,P007990,P009783,12.398,-3,28,31
257,TEL,P007990,P009863,9.832,-6,23,29
257,TEL,P007990,P011199,11.999,0,29,29
257,TEL,P007990,P011214,5.199,-10,4,14
257,TEL,P007990,P011971,3.949,3,7,4
257,TEL,P007990,P012744,1.6,-2,3,5
257,TEL,P009622,P009783,26.582,8,58,50
257,TEL,P009622,P009863,25.616,12,60,48
257,TEL,P009622,P011193,1.334,-4,0,4
257,TEL,P009622,P011199,26.45,9,60,51
257,TEL,P009622,P011214,7.866,-5,10,15
257,TEL,P009622,P011971,6.134,9,13,4
257,TEL,P009622,P012744,15.467,9,36,27
257,TEL,P009783,P009863,26.215,4,60,56
257,TEL,P009783,P011193,1.25,1,3,2
257,TEL,P009783,P011199,26.216,8,59,51
257,TEL,P009783,P011214,7.832,-8,11,19
257,TEL,P009783,P011971,4.599,4,10,6
257,TEL,P009783,P012744,10.933,8,26,18
257,TEL,P009863,P011193,4.2,-1,9,10
257,TEL,P009863,P011199,23.8,10,59,49
257,TEL,P009863,P011214,10.066,-3,17,20
257,TEL,P009863,P011971,8.083,3,17,14
257,TEL,P009863,P012744,18.017,11,42,31
257,TEL,P011193,P011199,1.334,-4,0,4
257,TEL,P011193,P011214,4.2,-1,9,10
257,TEL,P011193,P011971,5.534,-5,9,14
257,TEL,P011193,P012744,4.284,-6,6,12
257,TEL,P011199,P011214,2.633,-5,2,7
257,TEL,P011199,P011971,5.267,6,12,6
257,TEL,P011199,P012744,13.117,7,32,25
257,TEL,P011214,P011971,6.283,-1,11,12
257,TEL,P011214,P012744,5.767,0,10,10
257,TEL,P011971,P012744,6.351,1,13,12
258,PAM,P003960,P004863,1.683,4,6,2
258,PAM,P003960,P005356,4.534,-4,11,15
258,PAM,P003960,P006433,16.084,-13,29,42
258,PAM,P003960,P007870,19.834,-13,38,51
258,PAM,P003960,P010568,16.267,-13,28,41
258,PAM,P003960,P011970,0.683,0,2,2
258,PAM,P003960,P011982,10.5,-2,20,22
258,PAM,P003960,P012795,9.751,-11,18,29
258,PAM,P004863,P005356,3.666,0,9,9
258,PAM,P004863,P007870,6.299,2,20,18
258,PAM,P004863,P010393,11.15,-9,25,34
258,PAM,P004863,P011970,9.733,-9,19,28
258,PAM,P004863,P011982,4.867,-6,12,18
258,PAM,P004863,P012738,6.534,-7,11,18
258,PAM,P004863,P012795,7.4,5,22,17
258,PAM,P005356,P006433,1.467,-4,4,8
258,PAM,P005356,P006643,5.367,-6,16,22
258,PAM,P005356,P007870,7.2,-8,16,24
258,PAM,P005356,P010393,8.033,-10,21,31
258,PAM,P005356,P010568,2.067,-4,3,7
258,PAM,P005356,P011970,6.85,-9,19,28
258,PAM,P005356,P012738,5.367,-6,16,22
258,PAM,P005356,P012795,5.717,-5,13,18
258,PAM,P006433,P007870,16.584,-15,29,44
258,PAM,P006433,P010393,0.5,-2,0,2
258,PAM,P006433,P010568,14.2,-9,25,34
258,PAM,P006433,P011982,10.317,-4,18,22
258,PAM,P006433,P012795,7.184,-13,11,24
258,PAM,P006643,P010393,8.517,-6,25,31
258,PAM,P006643,P011970,8.517,-6,25,31
258,PAM,P006643,P012738,8.517,-6,25,31
258,PAM,P006643,P012795,3.15,0,9,9
258,PAM,P007870,P010393,5.116,-4,14,18
258,PAM,P007870,P010568,16.267,-13,28,41
258,PAM,P007870,P011970,3.199,-2,8,10
258,PAM,P007870,P011982,11.917,-3,26,29
258,PAM,P007870,P012795,13.384,-12,29,41
258,PAM,P010393,P011970,17.567,-15,42,57
258,PAM,P010393,P011982,4.684,-8,10,18
258,PAM,P010393,P012738,15.051,-13,36,49
258,PAM,P010393,P012795,10.05,-1,27,28
258,PAM,P010568,P011982,9.4,-2,18,20
258,PAM,P010568,P012795,6.867,-11,10,21
258,PAM,P011970,P011982,3.95,-7,6,13
258,PAM,P011970,P012738,15.051,-13,36,49
258,PAM,P011970,P012795,7.45,1,19,18
258,PAM,P011982,P012738,3.267,-7,4,11
258,PAM,P011982,P012795,1.834,-1,6,7
258,PAM,P012738,P012795,6.417,0,16,16
258,ULK,P001932,P002968,9.25,8,23,15
258,ULK,P001932,P004004,3.05,0,9,9
258,ULK,P001932,P005844,3.534,8,15,7
258,ULK,P001932,P006068,15.55,14,41,27
258,ULK,P001932,P006661,4.534,3,15,12
258,ULK,P001932,P008962,17.784,18,51,33
258,ULK,P001932,P009849,16.201,12,44,32
258,ULK,P001932,P011157,5.634,-3,12,15
258,ULK,P001932,P011980,1.467,-4,2,6
258,ULK,P002968,P006068,9.25,8,23,15
258,ULK,P002968,P008962,9.25,8,23,15
258,ULK,P002968,P009849,9.25,8,23,15
258,ULK,P004004,P006068,4.166,-3,11,14
258,ULK,P004004,P006661,10.75,10,32,22
258,ULK,P004004,P006961,7.8,14,27,13
258,ULK,P004004,P008962,9.3,0,24,24
258,ULK,P004004,P009849,1.834,-1,3,4
258,ULK,P004004,P011157,13.8,10,41,31
258,ULK,P004004,P011980,4.5,10,17,7
258,ULK,P005844,P006068,3.317,6,10,4
258,ULK,P005844,P006661,5.334,6,21,15
258,ULK,P005844,P006961,6.55,2,24,22
258,ULK,P005844,P008962,3.067,8,13,5
258,ULK,P005844,P009849,8.901,14,37,23
258,ULK,P005844,P011052,8.517,6,31,25
258,ULK,P005844,P011980,8.984,6,33,27
258,ULK,P006068,P006661,2.983,-4,5,9
258,ULK,P006068,P008962,17.183,9,43,34
258,ULK,P006068,P009849,14.467,16,39,23
258,ULK,P006068,P011052,1.967,4,7,3
258,ULK,P006068,P011157,5.75,-2,14,16
258,ULK,P006068,P011980,1.967,4,7,3
258,ULK,P006661,P006961,12.433,14,38,24
258,ULK,P006661,P008962,9.317,7,28,21
258,ULK,P006661,P009849,5.334,4,18,14
258,ULK,P006661,P011052,4.633,0,11,11
258,ULK,P006661,P011157,13.75,6,34,28
258,ULK,P006661,P011980,10.6,6,30,24
258,ULK,P006961,P008962,3.3,4,10,6
258,ULK,P006961,P009849,3.4,2,15,13
258,ULK,P006961,P011052,8.033,2,26,24
258,ULK,P006961,P011157,9.283,14,29,15
258,ULK,P006961,P011980,12.533,12,43,31
258,ULK,P008962,P009849,16.051,17,45,28
258,ULK,P008962,P011157,10.884,1,27,26
258,ULK,P009849,P011052,5.367,6,22,16
258,ULK,P009849,P011157,3.901,-4,6,10
258,ULK,P009849,P011980,6.834,2,24,22
258,ULK,P011052,P011157,1.483,0,2,2
258,ULK,P011052,P011980,10.0,6,33,27
258,ULK,P011157,P011980,6.983,6,19,13
259,MAD,P003108,P003733,2.433,2,5,3
259,MAD,P003108,P004887,13.233,5,33,28
259,MAD,P003108,P005791,6.016,-3,10,13
259,MAD,P003108,P005928,7.983,5,21,16
259,MAD,P003108,P006540,0.267,0,0,0
259,MAD,P003108,P009005,16.566,1,38,37
259,MAD,P003108,P010357,4.883,5,13,8
259,MAD,P003108,P010623,11.266,-3,22,25
259,MAD,P003108,PTGB,14.349,-4,30,34
259,MAD,P003733,P005791,17.05,10,33,23
259,MAD,P003733,P005928,15.9,11,31,20
259,MAD,P003733,P006540,14.617,8,28,20
259,MAD,P003733,P009005,0.983,-1,2,3
259,MAD,P003733,P010357,16.067,11,31,20
259,MAD,P003733,P010623,1.15,-1,2,3
259,MAD,P004887,P005928,8.0,4,22,18
259,MAD,P004887,P006540,0.467,0,0,0
259,MAD,P004887,P009005,13.983,7,35,28
259,MAD,P004887,P010357,4.05,6,14,8
259,MAD,P004887,P010623,6.533,3,15,12
259,MAD,P004887,PTGB,11.866,3,29,26
259,MAD,P005791,P005928,17.067,9,33,24
259,MAD,P005791,P006540,19.451,11,42,31
259,MAD,P005791,P009005,7.767,0,17,17
259,MAD,P005791,P010357,21.584,12,45,33
259,MAD,P005791,P010623,5.683,-7,11,18
259,MAD,P005791,PTGB,7.25,0,17,17
259,MAD,P005928,P006540,16.251,6,30,24
259,MAD,P005928,P009005,8.617,2,22,20
259,MAD,P005928,P010357,21.117,15,47,32
259,MAD,P005928,PTGB,5.333,0,14,14
259,MAD,P006540,P009005,4.351,4,10,6
259,MAD,P006540,P010357,19.651,11,42,31
259,MAD,P006540,P010623,0.95,-1,4,5
259,MAD,P006540,PTGB,3.667,5,12,7
259,MAD,P009005,P010357,7.384,10,22,12
259,MAD,P009005,P010623,10.416,-1,22,23
259,MAD,P009005,PTGB,16.933,6,40,34
259,MAD,P010357,P010623,1.8,-3,4,7
259,MAD,P010357,PTGB,6.0,5,18,13
259,MAD,P010623,PTGB,11.066,-3,24,27
259,VIR,P001133,P002084,0.6,0,2,2
259,VIR,P001133,P003048,0.95,-5,0,5
259,VIR,P001133,P003527,3.884,-4,6,10
259,VIR,P001133,P004007,5.967,-12,10,22
259,VIR,P001133,P004554,16.934,-9,24,33
259,VIR,P001133,P006739,18.017,-17,24,41
259,VIR,P001133,P008847,5.15,-7,8,15
259,VIR,P001133,P009549,19.534,-11,28,39
259,VIR,P001133,P010781,7.6,-8,14,22
259,VIR,P001133,PBCN,15.9,-11,20,31
259,VIR,P002084,P003048,0.333,2,2,0
259,VIR,P002084,P004007,4.699,3,14,11
259,VIR,P002084,P006739,4.183,1,12,11
259,VIR,P002084,P008847,7.299,3,19,16
259,VIR,P002084,P009549,4.049,4,11,7
259,VIR,P002084,P010781,8.232,5,23,18
259,VIR,P002084,PBCN,3.533,2,9,7
259,VIR,P003048,P004007,3.3,2,6,4
259,VIR,P003048,P005553,5.584,2,13,11
259,VIR,P003048,P008847,5.584,2,13,11
259,VIR,P003048,P009549,1.283,-3,2,5
259,VIR,P003048,P010781,6.867,-1,15,16
259,VIR,P003048,PBCN,3.567,-3,9,12
259,VIR,P003527,P004007,4.983,-5,8,13
259,VIR,P003527,P004554,6.15,-3,12,15
259,VIR,P003527,P006739,5.717,0,12,12
259,VIR,P003527,P009549,3.433,3,10,7
259,VIR,P003527,P010781,0.433,-3,0,3
259,VIR,P004007,P004554,5.866,-7,8,15
259,VIR,P004007,P005553,2.967,0,4,4
259,VIR,P004007,P006739,9.516,-5,22,27
259,VIR,P004007,P008847,10.266,-7,20,27
259,VIR,P004007,P009549,5.532,-1,12,13
259,VIR,P004007,P010781,11.632,-8,24,32
259,VIR,P004554,P006739,17.867,-9,26,35
259,VIR,P004554,P008847,0.883,-2,0,2
259,VIR,P004554,P009549,17.366,-4,28,32
259,VIR,P004554,P010781,2.216,-1,4,5
259,VIR,P004554,PBCN,13.05,-5,18,23
259,VIR,P005553,P008847,5.584,2,13,11
259,VIR,P005553,P010781,5.584,2,13,11
259,VIR,P005553,PBCN,2.617,2,9,7
259,VIR,P006739,P008847,4.966,-3,12,15
259,VIR,P006739,P009549,15.75,-3,24,27
259,VIR,P006739,P010781,5.566,-3,14,17
259,VIR,P006739,PBCN,12.15,-9,14,23
259,VIR,P008847,P009549,8.966,-3,15,18
259,VIR,P008847,P010781,18.916,-4,40,44
259,VIR,P008847,PBCN,8.05,3,20,17
259,VIR,P009549,P010781,11.582,-5,21,26
259,VIR,P009549,PBCN,19.433,-9,29,38
259,VIR,P010781,PBCN,9.9,2,24,22
260,MUN,P001288,P001557,0.717,2,2,0
260,MUN,P001288,P003583,17.617,-2,28,30
260,MUN,P001288,P006760,4.117,-5,6,11
260,MUN,P001288,P007056,23.383,10,41,31
260,MUN,P001288,P007639,5.2,7,9,2
260,MUN,P001288,P007975,0.533,-1,2,3
260,MUN,P001288,P008985,18.017,7,32,25
260,MUN,P001288,P010391,12.184,7,23,16
260,MUN,P001288,P011987,20.3,-1,29,30
260,MUN,P001557,P003583,2.35,5,7,2
260,MUN,P001557,P006760,11.766,-2,19,21
260,MUN,P001557,P007639,10.133,-5,14,19
260,MUN,P001557,P007975,8.283,-9,8,17
260,MUN,P001557,P008985,2.983,5,7,2
260,MUN,P001557,P010391,12.483,0,21,21
260,MUN,P001557,P011987,1.217,4,6,2
260,MUN,P003583,P006760,3.05,-3,5,8
260,MUN,P003583,P007056,15.483,2,26,24
260,MUN,P003583,P007975,0.533,-1,2,3
260,MUN,P003583,P008985,14.217,7,27,20
260,MUN,P003583,P010391,9.65,1,17,16
260,MUN,P003583,P011987,14.1,-5,20,25
260,MUN,P006760,P007056,5.417,3,8,5
260,MUN,P006760,P007639,12.85,-3,16,19
260,MUN,P006760,P007975,9.95,-9,8,17
260,MUN,P006760,P008985,5.516,4,11,7
260,MUN,P006760,P010391,16.6,-2,27,29
260,MUN,P006760,P011987,5.134,-3,8,11
260,MUN,P007056,P007639,7.917,9,11,2
260,MUN,P007056,P007975,2.2,-1,2,3
260,MUN,P007056,P008985,17.016,5,30,25
260,MUN,P007056,P010391,13.184,13,23,10
260,MUN,P007056,P011987,19.8,7,31,24
260,MUN,P007639,P007975,9.95,-9,8,17
260,MUN,P007639,P008985,3.499,2,4,2
260,MUN,P007639,P010391,15.9,2,21,19
260,MUN,P007639,P011987,6.751,13,17,4
260,MUN,P007975,P010391,9.95,-9,8,17
260,MUN,P007975,P011987,0.533,-1,2,3
260,MUN,P008985,P010391,7.616,10,19,9
260,MUN,P008985,P011987,12.8,0,18,18
260,MUN,P010391,P011987,9.101,6,17,11
260,ZAL,P002329,P002676,9.667,-5,8,13
260,ZAL,P002329,P003210,12.051,-4,19,23
260,ZAL,P002329,P003211,5.234,-9,2,11
260,ZAL,P002329,P005504,11.367,-6,11,17
260,ZAL,P002329,P007109,8.517,2,11,9
260,ZAL,P002329,P007513,11.934,-6,12,18
260,ZAL,P002329,P010390,15.651,-11,21,32
260,ZAL,P002329,P011218,24.917,-3,36,39
260,ZAL,P002329,P012715,14.634,-6,23,29
260,ZAL,P002329,P012787,6.9,-8,5,13
260,ZAL,P002676,P003210,11.316,7,22,15
260,ZAL,P002676,P003211,3.05,-2,4,6
260,ZAL,P002676,P005504,8.133,5,14,9
260,ZAL,P002676,P007109,2.6,5,5,0
260,ZAL,P002676,P007513,5.8,-2,9,11
260,ZAL,P002676,P010390,8.716,-7,10,17
260,ZAL,P002676,P011218,9.766,-2,9,11
260,ZAL,P002676,P012715,9.782,8,21,13
260,ZAL,P002676,P012787,8.966,5,14,9
260,ZAL,P003210,P003211,6.05,-9,4,13
260,ZAL,P003210,P005504,4.683,7,12,5
260,ZAL,P003210,P007513,1.95,0,4,4
260,ZAL,P003210,P010390,17.15,-3,28,31
260,ZAL,P003210,P011218,8.383,9,20,11
260,ZAL,P003210,P012715,20.299,5,39,34
260,ZAL,P003210,P012787,5.45,4,12,8
260,ZAL,P003211,P007109,0.6,-2,0,2
260,ZAL,P003211,P007513,0.6,-2,0,2
260,ZAL,P003211,P010390,7.567,-9,6,15
260,ZAL,P003211,P011218,2.117,-2,2,4
260,ZAL,P003211,P012715,7.45,-9,6,15
260,ZAL,P005504,P007109,5.317,-1,6,7
260,ZAL,P005504,P007513,6.067,-1,6,7
260,ZAL,P005504,P011218,11.367,-6,11,17
260,ZAL,P005504,P012715,7.283,4,15,11
260,ZAL,P005504,P012787,9.983,2,17,15
260,ZAL,P007109,P007513,7.684,2,11,9
260,ZAL,P007109,P011218,8.517,2,11,9
260,ZAL,P007109,P012787,0.833,0,0,0
260,ZAL,P007513,P010390,4.033,-7,4,11
260,ZAL,P007513,P011218,10.517,-5,11,16
260,ZAL,P007513,P012715,1.283,1,3,2
260,ZAL,P010390,P011218,11.983,2,22,20
260,ZAL,P010390,P012715,17.133,-2,29,31
260,ZAL,P010390,P012787,0.767,-3,0,3
260,ZAL,P011218,P012715,12.5,6,25,19
260,ZAL,P011218,P012787,6.133,-5,5,10
260,ZAL,P012715,P012787,7.3,1,15,14
261,ASV,P000229,P002100,0.033,0,0,0
261,ASV,P000229,P003526,10.883,9,20,11
261,ASV,P000229,P005094,13.95,6,26,20
261,ASV,P000229,P006568,13.133,4,23,19
261,ASV,P000229,P011225,0.317,-2,0,2
261,ASV,P000229,P011386,14.783,1,26,25
261,ASV,P000229,P012080,3.267,-9,3,12
261,ASV,P000229,P012731,1.967,-5,3,8
261,ASV,P000229,PKIR,2.067,-8,3,11
261,ASV,P002100,P003526,2.583,-2,5,7
261,ASV,P002100,P005094,17.733,4,40,36
261,ASV,P002100,P006568,7.183,1,16,15
261,ASV,P002100,P011225,21.9,2,49,47
261,ASV,P002100,P011386,3.033,3,9,6
261,ASV,P002100,P012080,22.317,7,53,46
261,ASV,P002100,P012731,18.983,2,44,42
261,ASV,P002100,PKIR,5.967,3,16,13
261,ASV,P003526,P005094,13.466,7,25,18
261,ASV,P003526,P006568,13.466,7,25,18
261,ASV,P003526,P011225,2.0,-5,2,7
261,ASV,P003526,P011386,11.466,12,23,11
261,ASV,P005094,P006568,18.883,10,37,27
261,ASV,P005094,P011225,15.767,-3,31,34
261,ASV,P005094,P011386,15.883,13,35,22
261,ASV,P005094,P012080,17.234,4,38,34
261,ASV,P005094,P012731,12.767,0,29,29
261,ASV,P005094,PKIR,0.917,-1,3,4
261,ASV,P006568,P011225,4.183,-2,7,9
261,ASV,P006568,P011386,16.133,7,32,25
261,ASV,P006568,P012080,6.85,-2,14,16
261,ASV,P006568,P012731,1.233,-2,2,4
261,ASV,P006568,PKIR,0.2,-3,0,3
261,ASV,P011225,P012080,20.217,5,47,42
261,ASV,P011225,P012731,18.267,4,44,40
261,ASV,P011225,PKIR,6.217,1,16,15
261,ASV,P011386,P012080,5.367,-7,9,16
261,ASV,P011386,P012731,2.65,-7,3,10
261,ASV,P011386,PKIR,1.817,-6,3,9
261,ASV,P012080,P012731,19.967,-2,44,46
261,ASV,P012080,PKIR,7.117,-4,16,20
261,ASV,P012731,PKIR,7.834,-2,19,21
261,IST,P004888,P006590,19.15,2,45,43
261,IST,P004888,P007200,30.516,-10,56,66
261,IST,P004888,P009513,8.383,-5,11,16
261,IST,P004888,P009664,10.05,-5,16,21
261,IST,P004888,P009846,8.933,12,24,12
261,IST,P004888,P011078,22.833,6,53,47
261,IST,P004888,P011981,17.033,4,40,36
261,IST,P004888,P012710,11.149,-5,16,21
261,IST,P004888,P012788,3.683,4,9,5
261,IST,P004888,PLHK,13.466,-7,18,25
261,IST,P006590,P007200,13.367,-7,29,36
261,IST,P006590,P009664,5.817,-5,13,18
261,IST,P006590,P009846,12.633,9,32,23
261,IST,P006590,P011078,17.767,1,45,44
261,IST,P006590,P011981,20.733,1,48,47
261,IST,P006590,P012710,1.933,-5,0,5
261,IST,P007200,P009513,8.383,-5,11,16
261,IST,P007200,P009664,10.05,-5,16,21
261,IST,P007200,P009846,3.15,3,8,5
261,IST,P007200,P011078,17.05,-3,37,40
261,IST,P007200,P011981,11.25,-5,24,29
261,IST,P007200,P012710,11.149,-5,16,21
261,IST,P007200,P012788,3.683,4,9,5
261,IST,P007200,PLHK,13.466,-7,18,25
261,IST,P009513,P012710,8.383,-5,11,16
261,IST,P009513,P012788,1.383,2,4,2
261,IST,P009513,PLHK,7.0,-7,7,14
261,IST,P009664,P009846,3.7,-3,8,11
261,IST,P009664,P011078,13.75,-8,24,32
261,IST,P009664,P011981,3.7,-3,8,11
261,IST,P009664,P012788,2.3,2,5,3
261,IST,P009664,PLHK,5.633,-5,6,11
261,IST,P009846,P011078,9.483,6,24,18
261,IST,P009846,P011981,12.633,9,32,23
261,IST,P011078,P011981,15.65,3,40,37
261,IST,P011078,P012710,0.833,5,5,0
261,IST,P011078,P012788,2.3,2,5,3
261,IST,P011078,PLHK,6.466,0,11,11
261,IST,P011981,P012710,1.933,-5,0,5
261,IST,P012710,P012788,1.383,2,4,2
261,IST,P012710,PLHK,7.833,-2,12,14
262,BER,P003958,P006251,1.5,-3,3,6
262,BER,P003958,P006919,13.4,-2,23,25
262,BER,P003958,P007025,0.833,-5,0,5
262,BER,P003958,P007550,0.833,-5,0,5
262,BER,P003958,P008211,2.083,3,6,3
262,BER,P003958,P008780,23.933,6,49,43
262,BER,P003958,P008967,25.449,11,55,44
262,BER,P003958,P010791,23.016,15,52,37
262,BER,P003958,P011934,2.333,-8,0,8
262,BER,P003958,P012720,14.016,4,32,28
262,BER,P006251,P006919,10.4,-3,19,22
262,BER,P006251,P007025,8.417,-12,16,28
262,BER,P006251,P007550,3.117,-7,2,9
262,BER,P006251,P008211,9.783,-4,22,26
262,BER,P006251,P008780,1.633,-3,3,6
262,BER,P006251,P008967,1.75,-3,3,6
262,BER,P006251,P010791,4.3,3,8,5
262,BER,P006251,P011934,8.717,-14,16,30
262,BER,P006251,P012720,8.983,-10,16,26
262,BER,P006919,P007025,4.167,-1,8,9
262,BER,P006919,P007550,1.9,-3,2,5
262,BER,P006919,P008211,6.75,3,14,11
262,BER,P006919,P008780,13.533,-2,23,25
262,BER,P006919,P008967,13.083,0,23,23
262,BER,P006919,P010791,15.4,4,28,24
262,BER,P006919,P011934,5.267,-3,8,11
262,BER,P006919,P012720,5.3,-1,8,9
262,BER,P007025,P007550,3.95,-12,2,14
262,BER,P007025,P008211,5.183,-5,14,19
262,BER,P007025,P008967,0.117,0,0,0
262,BER,P007025,P011934,9.25,-17,16,33
262,BER,P007025,P012720,5.083,-16,8,24
262,BER,P007550,P011934,3.95,-12,2,14
262,BER,P007550,P012720,2.05,-9,0,9
262,BER,P008211,P008967,2.083,3,6,3
262,BER,P008211,P010791,5.683,9,14,5
262,BER,P008211,P011934,6.183,-10,14,24
262,BER,P008211,P012720,9.716,-3,22,25
262,BER,P008780,P008967,23.499,8,49,41
262,BER,P008780,P010791,21.633,9,46,37
262,BER,P008780,P011934,0.8,0,0,0
262,BER,P008780,P012720,11.233,6,26,20
262,BER,P008967,P010791,22.449,17,52,35
262,BER,P008967,P011934,1.617,-3,0,3
262,BER,P008967,P012720,12.749,11,32,21
262,BER,P010791,P012720,16.783,15,40,25
262,BER,P011934,P012720,6.083,-21,8,29
262,MAD,P001392,P003108,15.633,-3,30,33
262,MAD,P001392,P005791,15.633,-3,30,33
262,MAD,P001392,P005928,15.0,-5,28,33
262,MAD,P001392,P009213,11.367,-12,14,26
262,MAD,P001392,P010357,4.266,9,16,7
262,MAD,P001392,P010623,0.633,2,2,0
262,MAD,P003108,P003733,8.366,6,24,18
262,MAD,P003108,P004887,5.15,1,13,12
262,MAD,P003108,P005791,21.366,5,47,42
262,MAD,P003108,P005928,20.916,1,47,46
262,MAD,P003108,P009005,2.783,3,6,3
262,MAD,P003108,P009213,11.367,-12,14,26
262,MAD,P003108,P010357,15.282,18,46,28
262,MAD,P003108,P010623,5.733,5,13,8
262,MAD,P003733,P004887,16.55,4,36,32
262,MAD,P003733,P005791,5.033,3,14,11
262,MAD,P003733,P005928,10.199,8,27,19
262,MAD,P003733,P009005,13.483,1,26,25
262,MAD,P003733,P010357,21.716,7,50,43
262,MAD,P003733,P010623,11.517,-1,23,24
262,MAD,P004887,P005928,6.983,3,16,13
262,MAD,P004887,P009005,11.4,3,23,20
262,MAD,P004887,P010357,16.55,4,36,32
262,MAD,P004887,P010623,9.567,1,20,19
262,MAD,P005791,P005928,18.083,0,39,39
262,MAD,P005791,P009005,4.6,1,9,8
262,MAD,P005791,P009213,11.367,-12,14,26
262,MAD,P005791,P010357,11.949,15,36,21
262,MAD,P005791,P010623,5.233,3,11,8
262,MAD,P005928,P009005,4.416,2,8,6
262,MAD,P005928,P009213,11.367,-12,14,26
262,MAD,P005928,P010357,13.832,15,41,26
262,MAD,P009005,P010357,16.133,4,32,28
262,MAD,P009005,P010623,11.717,2,24,22
262,MAD,P010357,P010623,14.8,4,31,27
263,IST,P004888,P006590,5.016,0,9,9
263,IST,P004888,P007200,24.584,6,55,49
263,IST,P004888,P009513,12.517,8,28,20
263,IST,P004888,P009664,5.717,4,15,11
263,IST,P004888,P009846,7.583,8,19,11
263,IST,P004888,P011078,5.85,-8,12,20
263,IST,P004888,P011981,3.233,4,8,4
263,IST,P004888,P012710,14.534,3,33,30
263,IST,P004888,P012788,5.666,-5,9,14
263,IST,P004888,PLHK,16.368,8,40,32
263,IST,P006590,P007200,6.3,1,12,11
263,IST,P006590,P009664,14.734,6,28,22
263,IST,P006590,P009846,18.817,8,37,29
263,IST,P006590,P011078,14.383,3,25,22
263,IST,P006590,P012788,19.75,6,37,31
263,IST,P007200,P009513,12.517,8,28,20
263,IST,P007200,P009664,7.684,6,20,14
263,IST,P007200,P009846,8.867,9,22,13
263,IST,P007200,P011078,5.167,-9,10,19
263,IST,P007200,P011981,3.233,4,8,4
263,IST,P007200,P012710,14.534,3,33,30
263,IST,P007200,P012788,6.95,-4,12,16
263,IST,P007200,PLHK,16.368,8,40,32
263,IST,P009513,P012710,12.517,8,28,20
263,IST,P009513,PLHK,12.517,8,28,20
263,IST,P009664,P009846,18.234,12,38,26
263,IST,P009664,P011078,14.984,2,28,26
263,IST,P009664,P011981,3.233,4,8,4
263,IST,P009664,P012788,14.734,6,28,22
263,IST,P009664,PLHK,2.484,0,7,7
263,IST,P009846,P011078,13.45,5,25,20
263,IST,P009846,P011981,3.233,4,8,4
263,IST,P009846,P012788,18.817,8,37,29
263,IST,P009846,PLHK,0.267,2,2,0
263,IST,P011078,P012710,2.017,-5,5,10
263,IST,P011078,P012788,15.033,-2,25,27
263,IST,P011078,PLHK,3.584,-2,10,12
263,IST,P012710,P012788,0.65,-5,0,5
263,IST,P012710,PLHK,13.884,8,33,25
263,OLY,P001255,P007853,4.917,4,8,4
263,OLY,P001255,P007982,12.5,-4,17,21
263,OLY,P001255,P008811,19.85,5,43,38
263,OLY,P001255,P008829,26.05,3,54,51
263,OLY,P001255,P008855,17.683,7,43,36
263,OLY,P001255,P010612,22.0,7,52,45
263,OLY,P001255,P011194,2.5,4,6,2
263,OLY,P001255,P012878,8.7,2,17,15
263,OLY,P007853,P007982,6.767,-1,8,9
263,OLY,P007853,P008811,2.167,-2,0,2
263,OLY,P007853,P008829,2.417,0,2,2
263,OLY,P007853,P010392,1.85,-5,0,5
263,OLY,P007853,P011194,4.35,-1,6,7
263,OLY,P007853,P012878,4.6,1,8,7
263,OLY,P007982,P008811,6.1,-7,4,11
263,OLY,P007982,P008829,10.0,-8,11,19
263,OLY,P007982,P008855,7.283,-9,10,19
263,OLY,P007982,P010392,7.5,-10,10,20
263,OLY,P007982,P010612,5.95,-4,9,13
263,OLY,P007982,P011194,10.0,-6,16,22
263,OLY,P007982,P012878,13.9,-7,23,30
263,OLY,P008811,P008829,23.8,-5,45,50
263,OLY,P008811,P008855,23.933,-4,49,53
263,OLY,P008811,P010392,2.3,-1,4,5
263,OLY,P008811,P010612,20.0,1,45,44
263,OLY,P008811,P011194,2.3,-1,4,5
263,OLY,P008811,P011983,3.95,-10,2,12
263,OLY,P008829,P008855,21.633,-3,45,48
263,OLY,P008829,P010612,25.95,-3,54,57
263,OLY,P008829,P011983,3.95,-10,2,12
263,OLY,P008829,P012878,6.2,-2,11,13
263,OLY,P008855,P010392,5.65,-5,10,15
263,OLY,P008855,P010612,20.0,1,45,44
263,OLY,P008855,P011194,5.65,-5,10,15
263,OLY,P008855,P011983,3.95,-10,2,12
263,OLY,P008855,P012878,3.35,-4,6,10
263,OLY,P010392,P011194,7.5,-10,10,20
263,OLY,P010392,P012878,5.2,-9,6,15
263,OLY,P010612,P011983,3.95,-10,2,12
263,OLY,P010612,P012878,5.95,-4,9,13
263,OLY,P011194,P012878,7.7,-5,12,17
264,ASV,P000229,P003526,10.267,-1,20,21
264,ASV,P000229,P005094,15.634,-6,30,36
264,ASV,P000229,P006568,14.517,-7,27,34
264,ASV,P000229,P011225,13.584,-3,28,31
264,ASV,P000229,P011386,2.05,-3,2,5
264,ASV,P000229,P012080,3.317,-5,5,10
264,ASV,P000229,P012731,1.117,1,3,2
264,ASV,P000229,PKIR,2.05,0,5,5
264,ASV,P002100,P003526,2.584,-3,4,7
264,ASV,P002100,P004194,15.8,-3,33,36
264,ASV,P002100,P005094,11.316,-11,28,39
264,ASV,P002100,P006568,8.483,2,27,25
264,ASV,P002100,P011225,11.4,-6,33,39
264,ASV,P002100,P011386,12.733,4,27,23
264,ASV,P002100,P012080,18.383,-5,43,48
264,ASV,P002100,P012731,13.017,9,32,23
264,ASV,P002100,PKIR,3.616,5,13,8
264,ASV,P003526,P004194,0.867,-4,0,4
264,ASV,P003526,P005094,12.851,-4,24,28
264,ASV,P003526,P006568,11.984,0,24,24
264,ASV,P003526,P011225,12.851,-4,24,28
264,ASV,P004194,P005094,3.7,-7,6,13
264,ASV,P004194,P011225,4.017,-6,9,15
264,ASV,P004194,P011386,11.583,3,24,21
264,ASV,P004194,P012080,13.65,0,29,29
264,ASV,P004194,P012731,12.1,4,27,23
264,ASV,P004194,PKIR,1.483,1,4,3
264,ASV,P005094,P006568,22.083,-10,49,59
264,ASV,P005094,P011225,24.117,-12,56,68
264,ASV,P005094,P011386,2.899,-5,2,7
264,ASV,P005094,P012080,8.716,-19,16,35
264,ASV,P005094,P012731,1.117,1,3,2
264,ASV,P005094,PKIR,5.499,5,18,13
264,ASV,P006568,P011225,19.8,-3,49,52
264,ASV,P006568,P011386,3.2,-2,5,7
264,ASV,P006568,P012080,8.0,-9,19,28
264,ASV,P006568,P012731,0.917,5,5,0
264,ASV,P006568,PKIR,3.016,4,11,7
264,ASV,P011225,P011386,0.033,0,0,0
264,ASV,P011225,P012080,6.75,-11,19,30
264,ASV,P011225,P012731,2.017,4,8,4
264,ASV,P011225,PKIR,5.499,5,18,13
264,ASV,P011386,P012080,14.816,1,29,28
264,ASV,P011386,P012731,11.917,6,27,21
264,ASV,P011386,PKIR,0.033,0,0,0
264,ASV,P012080,P012731,13.017,9,32,23
264,ASV,P012080,PKIR,0.283,-1,0,1
264,ASV,P012731,PKIR,1.317,1,3,2
264,TEL,P005145,P007990,3.217,-5,7,12
264,TEL,P005145,P009622,9.317,6,25,19
264,TEL,P005145,P009783,9.9,4,25,21
264,TEL,P005145,P009863,9.9,4,25,21
264,TEL,P005145,P011193,0.433,0,0,0
264,TEL,P005145,P011199,6.833,7,18,11
264,TEL,P007990,P009622,6.417,-2,13,15
264,TEL,P007990,P009783,18.467,10,52,42
264,TEL,P007990,P009863,14.517,15,46,31
264,TEL,P007990,P011193,4.0,-8,3,11
264,TEL,P007990,P011199,13.8,18,44,26
264,TEL,P007990,P011214,4.75,-8,3,11
264,TEL,P007990,P011971,7.584,-8,8,16
264,TEL,P007990,P012744,13.916,20,44,24
264,TEL,P009622,P009783,20.3,-2,45,47
264,TEL,P009622,P009863,19.416,-2,45,47
264,TEL,P009622,P011193,0.583,4,6,2
264,TEL,P009622,P011199,17.616,0,36,36
264,TEL,P009622,P011214,1.3,-2,2,4
264,TEL,P009622,P011971,5.033,0,10,10
264,TEL,P009622,P012744,10.282,-6,22,28
264,TEL,P009783,P009863,30.016,14,83,69
264,TEL,P009783,P011193,3.75,-7,5,12
264,TEL,P009783,P011199,27.216,20,74,54
264,TEL,P009783,P011214,4.4,-9,7,16
264,TEL,P009783,P011971,6.134,-7,10,17
264,TEL,P009783,P012744,18.749,13,55,42
264,TEL,P009863,P011193,2.766,3,11,8
264,TEL,P009863,P011199,25.549,16,68,52
264,TEL,P009863,P011214,3.6,-3,7,10
264,TEL,P009863,P011971,4.633,1,12,11
264,TEL,P009863,P012744,20.999,12,59,47
264,TEL,P011193,P011199,0.433,0,0,0
264,TEL,P011193,P011214,5.75,-9,8,17
264,TEL,P011193,P011971,6.333,-5,14,19
264,TEL,P011193,P012744,3.016,2,9,7
264,TEL,P011199,P011971,4.25,-4,4,8
264,TEL,P011199,P012744,19.099,11,52,41
264,TEL,P011214,P011971,6.517,-9,8,17
264,TEL,P011214,P012744,4.083,-4,5,9
264,TEL,P011971,P012744,5.116,0,10,10
265,BAS,P003198,P004603,2.233,1,5,4
265,BAS,P003198,P004761,6.55,-1,15,16
265,BAS,P003198,P007946,5.45,4,13,9
265,BAS,P003198,P008850,0.467,-1,1,2
265,BAS,P003198,P009048,8.417,0,19,19
265,BAS,P003198,P010444,12.817,3,29,26
265,BAS,P003198,P011085,3.634,3,10,7
265,BAS,P003198,P011948,6.466,2,13,11
265,BAS,P003198,P012201,6.983,2,15,13
265,BAS,P003198,P012765,7.183,3,16,13
265,BAS,P004603,P004761,9.051,-8,17,25
265,BAS,P004603,P007230,6.184,-8,9,17
265,BAS,P004603,P007946,4.717,-1,10,11
265,BAS,P004603,P009048,5.267,-5,9,14
265,BAS,P004603,P011948,7.767,-2,16,18
265,BAS,P004603,P012201,4.717,-1,10,11
265,BAS,P004761,P007230,17.117,-15,31,46
265,BAS,P004761,P007946,6.251,-6,12,18
265,BAS,P004761,P008850,0.467,-1,1,2
265,BAS,P004761,P009048,21.584,0,48,48
265,BAS,P004761,P010444,17.5,5,41,36
265,BAS,P004761,P011085,1.55,1,6,5
265,BAS,P004761,P011948,13.251,0,29,29
265,BAS,P004761,P012201,18.301,-7,36,43
265,BAS,P004761,P012765,4.45,8,12,4
265,BAS,P007230,P007946,4.401,-6,4,10
265,BAS,P007230,P009048,13.733,-9,27,36
265,BAS,P007230,P010444,9.483,-4,18,22
265,BAS,P007230,P011085,1.133,1,4,3
265,BAS,P007230,P011948,8.751,-8,13,21
265,BAS,P007230,P012201,11.734,-11,18,29
265,BAS,P007946,P010444,4.234,3,8,5
265,BAS,P007946,P011085,3.217,3,8,5
265,BAS,P007946,P011948,5.984,0,11,11
265,BAS,P007946,P012201,11.418,-1,22,23
265,BAS,P008850,P009048,0.467,-1,1,2
265,BAS,P008850,P010444,0.467,-1,1,2
265,BAS,P009048,P010444,22.134,2,50,48
265,BAS,P009048,P011085,1.55,1,6,5
265,BAS,P009048,P011948,13.851,-1,29,30
265,BAS,P009048,P012201,13.517,-4,26,30
265,BAS,P009048,P012765,9.084,5,21,16
265,BAS,P010444,P011085,4.767,4,14,10
265,BAS,P010444,P011948,10.784,4,22,18
265,BAS,P010444,P012201,17.751,-1,34,35
265,BAS,P010444,P012765,10.267,5,23,18
265,BAS,P011085,P012201,3.217,3,8,5
265,BAS,P011948,P012201,9.618,1,19,18
265,BAS,P011948,P012765,7.6,0,16,16
265,BAS,P012201,P012765,2.484,-1,4,5
265,PAR,P000956,P003983,5.383,-1,14,15
265,PAR,P000956,P007400,2.85,1,8,7
265,PAR,P000956,P007673,3.5,-5,7,12
265,PAR,P000956,P009862,4.416,2,13,11
265,PAR,P000956,P011050,1.4,0,4,4
265,PAR,P000956,P012096,3.983,-1,10,11
265,PAR,P003983,P004172,1.25,-1,2,3
265,PAR,P003983,P007400,9.7,2,19,17
265,PAR,P003983,P007673,4.1,-8,7,15
265,PAR,P003983,P009862,11.916,5,26,21
265,PAR,P003983,P011050,1.4,0,4,4
265,PAR,P003983,P011051,4.933,-3,7,10
265,PAR,P003983,P012096,12.083,-1,23,24
265,PAR,P003983,P012742,1.25,-1,2,3
265,PAR,P003983,P012743,1.917,4,4,0
265,PAR,P004058,P004172,4.35,-2,7,9
265,PAR,P004058,P007400,4.35,-2,7,9
265,PAR,P004058,P012096,4.35,-2,7,9
265,PAR,P004058,P012743,4.35,-2,7,9
265,PAR,P004172,P007400,8.383,-2,15,17
265,PAR,P004172,P007673,4.533,-4,9,13
265,PAR,P004172,P009862,15.249,4,36,32
265,PAR,P004172,P012096,23.316,4,52,48
265,PAR,P004172,P012742,17.633,7,42,35
265,PAR,P004172,P012743,18.55,10,45,35
265,PAR,P007400,P007673,4.3,-2,9,11
265,PAR,P007400,P009862,13.849,4,28,24
265,PAR,P007400,P011051,5.166,-3,7,10
265,PAR,P007400,P012096,21.9,0,44,44
265,PAR,P007400,P012742,6.75,1,15,14
265,PAR,P007400,P012743,11.284,1,24,23
265,PAR,P007673,P009862,3.982,-8,6,14
265,PAR,P007673,P011050,1.4,0,4,4
265,PAR,P007673,P011051,0.233,0,0,0
265,PAR,P007673,P012096,9.783,-8,20,28
265,PAR,P007673,P012742,7.783,-3,17,20
265,PAR,P007673,P012743,6.05,6,17,11
265,PAR,P009862,P011050,1.4,0,4,4
265,PAR,P009862,P011051,5.166,-3,7,10
265,PAR,P009862,P012096,26.582,6,58,52
265,PAR,P009862,P012742,15.616,4,35,31
265,PAR,P009862,P012743,14.684,10,35,25
265,PAR,P011051,P012096,4.933,-3,7,10
265,PAR,P011051,P012742,0.233,0,0,0
265,PAR,P012096,P012742,21.85,7,52,45
265,PAR,P012096,P012743,24.684,14,59,45
265,PAR,P012742,P012743,17.217,13,45,32
266,VIR,P001133,P003048,3.133,3,6,3
266,VIR,P001133,P003527,15.1,-2,34,36
266,VIR,P001133,P004007,9.116,1,20,19
266,VIR,P001133,P004554,11.5,-5,27,32
266,VIR,P001133,P005553,15.1,-2,34,36
266,VIR,P001133,P006739,23.233,-3,55,58
266,VIR,P001133,P008847,11.733,-4,28,32
266,VIR,P001133,P010781,10.917,-4,25,29
266,VIR,P001133,PBCN,16.9,0,39,39
266,VIR,P003048,P003527,7.667,-6,8,14
266,VIR,P003048,P004007,5.85,4,13,9
266,VIR,P003048,P005553,2.983,-5,0,5
266,VIR,P003048,P006739,6.5,4,12,8
266,VIR,P003048,P008847,1.45,-3,2,5
266,VIR,P003048,P010781,5.7,-7,5,12
266,VIR,P003048,PBCN,7.717,-2,10,12
266,VIR,P003527,P004007,4.5,0,11,11
266,VIR,P003527,P005553,20.8,-12,38,50
266,VIR,P003527,P006739,15.967,-4,32,36
266,VIR,P003527,P008847,16.833,-12,36,48
266,VIR,P003527,P010781,12.383,-9,21,30
266,VIR,P003527,PBCN,10.418,-7,12,19
266,VIR,P004007,P004554,6.533,-2,14,16
266,VIR,P004007,P005553,1.25,-1,2,3
266,VIR,P004007,P006739,11.199,6,27,21
266,VIR,P004007,P008847,2.05,-3,6,9
266,VIR,P004007,P010781,2.933,-3,8,11
266,VIR,P004007,PBCN,11.033,2,23,21
266,VIR,P004554,P006739,11.5,-5,27,32
266,VIR,P004554,P010781,4.967,-3,13,16
266,VIR,P004554,PBCN,11.5,-5,27,32
266,VIR,P005553,P006739,12.317,-7,24,31
266,VIR,P005553,P008847,15.583,-10,32,42
266,VIR,P005553,P010781,8.533,-5,14,19
266,VIR,P005553,PBCN,6.634,-6,8,14
266,VIR,P006739,P008847,9.183,-7,20,27
266,VIR,P006739,P010781,7.4,-3,18,21
266,VIR,P006739,PBCN,22.901,-5,45,50
266,VIR,P008847,P010781,8.083,-5,18,23
266,VIR,P008847,PBCN,2.417,-4,2,6
266,VIR,P010781,PBCN,8.484,-9,14,23
266,ZAL,P002329,P002676,16.35,17,43,26
266,ZAL,P002329,P003210,5.167,2,13,11
266,ZAL,P002329,P003211,1.767,-6,4,10
266,ZAL,P002329,P005504,15.551,11,46,35
266,ZAL,P002329,P006860,3.184,0,10,10
266,ZAL,P002329,P007513,21.3,7,53,46
266,ZAL,P002329,P010390,11.5,-4,24,28
266,ZAL,P002329,P011218,21.001,11,60,49
266,ZAL,P002329,P012715,6.75,-7,15,22
266,ZAL,P002329,P012787,5.634,-3,12,15
266,ZAL,P002676,P003210,6.967,3,17,14
266,ZAL,P002676,P003211,5.784,2,13,11
266,ZAL,P002676,P005504,12.018,14,33,19
266,ZAL,P002676,P006860,6.25,8,16,8
266,ZAL,P002676,P007513,15.483,15,38,23
266,ZAL,P002676,P010390,14.233,10,31,21
266,ZAL,P002676,P011218,15.55,13,41,28
266,ZAL,P002676,P012715,1.3,-5,0,5
266,ZAL,P002676,P012784,0.8,1,3,2
266,ZAL,P002676,P012787,10.601,6,21,15
266,ZAL,P003210,P003211,4.217,1,7,6
266,ZAL,P003210,P005504,5.034,4,15,11
266,ZAL,P003210,P006860,1.45,2,2,0
266,ZAL,P003210,P007513,3.1,-3,5,8
266,ZAL,P003210,P010390,6.517,5,10,5
266,ZAL,P003210,P011218,2.583,2,10,8
266,ZAL,P003210,P012715,4.75,0,8,8
266,ZAL,P003210,P012784,0.8,1,3,2
266,ZAL,P003210,P012787,5.951,7,10,3
266,ZAL,P003211,P005504,1.634,0,2,2
266,ZAL,P003211,P006860,3.317,8,13,5
266,ZAL,P003211,P007513,1.85,0,2,2
266,ZAL,P003211,P010390,8.801,3,20,17
266,ZAL,P003211,P011218,1.267,-6,2,8
266,ZAL,P003211,P012715,4.8,-5,5,10
266,ZAL,P003211,P012787,8.635,3,20,17
266,ZAL,P005504,P006860,2.85,-2,6,8
266,ZAL,P005504,P007513,13.984,3,35,32
266,ZAL,P005504,P011218,16.268,11,46,35
266,ZAL,P005504,P012715,6.217,-3,15,18
266,ZAL,P005504,P012787,2.984,2,6,4
266,ZAL,P006860,P007513,3.35,-1,8,9
266,ZAL,P006860,P010390,6.584,10,20,10
266,ZAL,P006860,P011218,4.667,-2,11,13
266,ZAL,P006860,P012787,6.084,9,18,9
266,ZAL,P007513,P010390,9.916,5,23,18
266,ZAL,P007513,P011218,17.784,9,48,39
266,ZAL,P007513,P012715,5.65,-6,12,18
266,ZAL,P007513,P012784,0.8,1,3,2
266,ZAL,P007513,P012787,2.383,2,5,3
266,ZAL,P010390,P011218,7.15,-1,17,18
266,ZAL,P010390,P012715,4.717,-2,5,7
266,ZAL,P010390,P012784,0.8,1,3,2
266,ZAL,P010390,P012787,12.918,5,27,22
266,ZAL,P011218,P012715,4.6,-5,12,17
266,ZAL,P011218,P012787,3.134,-4,5,9
266,ZAL,P012715,P012787,5.284,1,8,7
267,MCO,P002581,P005985,3.567,-2,10,12
267,MCO,P002581,P010588,2.267,3,8,5
267,MCO,P002581,P011212,3.567,-2,10,12
267,MCO,P002581,P011226,3.567,-2,10,12
267,MCO,P002581,P011231,1.3,-5,2,7
267,MCO,P004197,P005985,8.916,-6,14,20
267,MCO,P004197,P009754,8.916,-6,14,20
267,MCO,P004197,P010588,9.999,-5,17,22
267,MCO,P004197,P011196,1.233,0,2,2
267,MCO,P004197,P011212,1.083,1,3,2
267,MCO,P004197,P011231,1.083,1,3,2
267,MCO,P004197,P012709,1.083,1,3,2
267,MCO,P004197,PLCZ,7.683,-6,12,18
267,MCO,P005985,P009754,17.449,-17,28,45
267,MCO,P005985,P010588,20.05,-16,36,52
267,MCO,P005985,P011196,12.333,0,25,25
267,MCO,P005985,P011212,11.417,1,28,27
267,MCO,P005985,P011226,14.451,-10,30,40
267,MCO,P005985,P011231,10.166,-5,22,27
267,MCO,P005985,P012709,4.933,-6,12,18
267,MCO,P005985,PLCZ,11.05,-15,19,34
267,MCO,P009754,P010588,15.416,-17,23,40
267,MCO,P009754,P011196,5.616,0,9,9
267,MCO,P009754,P011212,0.933,2,2,0
267,MCO,P009754,P011226,3.317,-8,2,10
267,MCO,P009754,P011231,2.816,-2,5,7
267,MCO,P009754,P012709,4.283,-5,10,15
267,MCO,P009754,PLCZ,11.05,-15,19,34
267,MCO,P010588,P011196,5.75,-4,7,11
267,MCO,P010588,P011212,9.8,-2,23,25
267,MCO,P010588,P011226,11.101,-13,20,33
267,MCO,P010588,P011231,5.216,-5,10,15
267,MCO,P010588,P012709,6.483,-10,13,23
267,MCO,P010588,PLCZ,11.05,-15,19,34
267,MCO,P011196,P011212,14.833,7,32,25
267,MCO,P011196,P011226,15.967,2,32,30
267,MCO,P011196,P011231,14.416,8,34,26
267,MCO,P011196,P012709,10.516,3,23,20
267,MCO,P011212,P011226,20.817,-1,47,48
267,MCO,P011212,P011231,17.466,1,39,38
267,MCO,P011212,P012709,11.416,1,24,23
267,MCO,P011226,P011231,17.816,-3,38,41
267,MCO,P011226,P012709,10.983,-1,23,24
267,MCO,P011226,PLCZ,1.117,-4,2,6
267,MCO,P011231,P012709,13.449,2,31,29
267,MCO,P012709,PLCZ,2.25,-5,5,10
267,MIL,P000796,P002812,3.433,0,7,7
267,MIL,P000796,P002849,18.95,15,57,42
267,MIL,P000796,P006509,18.883,10,49,39
267,MIL,P000796,P007032,8.383,2,20,18
267,MIL,P000796,P007201,7.117,3,14,11
267,MIL,P000796,P007831,24.6,19,64,45
267,MIL,P000796,P011205,13.484,9,38,29
267,MIL,P000796,P011224,23.15,14,63,49
267,MIL,P002812,P005670,0.55,0,0,0
267,MIL,P002812,P006509,9.95,4,20,16
267,MIL,P002812,P006701,0.55,0,0,0
267,MIL,P002812,P007032,5.883,0,12,12
267,MIL,P002812,P007201,7.617,0,14,14
267,MIL,P002812,P007831,7.584,9,22,13
267,MIL,P002812,P011205,8.217,2,18,16
267,MIL,P002812,P011224,7.084,1,15,14
267,MIL,P002849,P006509,15.034,4,38,34
267,MIL,P002849,P007032,6.333,-4,15,19
267,MIL,P002849,P007201,1.217,-4,0,4
267,MIL,P002849,P007831,14.4,18,45,27
267,MIL,P002849,P011205,8.867,2,26,24
267,MIL,P002849,P011224,15.867,13,47,34
267,MIL,P005670,P006509,0.55,0,0,0
267,MIL,P005670,P006701,0.55,0,0,0
267,MIL,P005670,P011205,0.55,0,0,0
267,MIL,P006509,P006701,0.55,0,0,0
267,MIL,P006509,P007032,8.183,-6,15,21
267,MIL,P006509,P007201,7.7,-2,11,13
267,MIL,P006509,P007831,16.167,17,43,26
267,MIL,P006509,P011205,9.534,-1,20,21
267,MIL,P006509,P011224,19.917,14,52,38
267,MIL,P006701,P011205,0.55,0,0,0
267,MIL,P007032,P007201,10.367,-2,17,19
267,MIL,P007032,P007831,6.5,7,17,10
267,MIL,P007032,P011205,13.45,0,27,27
267,MIL,P007032,P011224,2.833,-5,5,10
267,MIL,P007201,P007831,9.801,6,21,15
267,MIL,P007201,P011205,13.601,-3,24,27
267,MIL,P007201,P011224,6.384,-2,11,13
267,MIL,P007831,P011205,13.701,15,42,27
267,MIL,P007831,P011224,22.251,21,62,41
267,MIL,P011205,P011224,9.718,4,29,25
268,PAN,P001926,P002328,12.534,5,30,25
268,PAN,P001926,P003842,24.067,13,57,44
268,PAN,P001926,P007553,2.667,-3,6,9
268,PAN,P001926,P007866,19.251,7,45,38
268,PAN,P001926,P011204,17.084,6,40,34
268,PAN,P001926,P012712,8.1,3,20,17
268,PAN,P001926,P012774,24.901,9,62,53
268,PAN,P002328,P003842,22.75,15,48,33
268,PAN,P002328,P007553,1.467,-4,3,7
268,PAN,P002328,P007866,24.484,11,53,42
268,PAN,P002328,P011204,14.367,7,28,21
268,PAN,P002328,P011209,0.05,0,0,0
268,PAN,P002328,P012712,0.05,0,0,0
268,PAN,P002328,P012774,22.234,10,50,40
268,PAN,P003842,P007866,28.9,13,61,48
268,PAN,P003842,P011204,28.2,8,59,51
268,PAN,P003842,P011209,0.283,-1,1,2
268,PAN,P003842,P012712,8.45,1,20,19
268,PAN,P003842,P012774,34.55,15,78,63
268,PAN,P006544,P007866,0.067,0,0,0
268,PAN,P006544,P011204,0.067,0,0,0
268,PAN,P006544,P011209,0.067,0,0,0
268,PAN,P006544,P012774,0.067,0,0,0
268,PAN,P007553,P007866,2.667,-3,6,9
268,PAN,P007553,P011204,1.2,1,3,2
268,PAN,P007553,P012774,2.667,-3,6,9
268,PAN,P007866,P011204,21.984,6,44,38
268,PAN,P007866,P011209,0.4,-1,1,2
268,PAN,P007866,P012712,0.8,-2,0,2
268,PAN,P007866,P012774,29.851,9,66,57
268,PAN,P011204,P011209,0.35,-1,1,2
268,PAN,P011204,P012712,8.65,1,20,19
268,PAN,P011204,P012774,27.634,8,61,53
268,PAN,P011209,P012712,0.05,0,0,0
268,PAN,P011209,P012774,0.4,-1,1,2
268,PAN,P012712,P012774,8.7,1,20,19
268,RED,P000848,P002553,4.266,-5,8,13
268,RED,P000848,P004720,1.85,-2,4,6
268,RED,P000848,P005099,8.649,-2,16,18
268,RED,P000848,P006436,7.533,3,18,15
268,RED,P000848,P007960,19.782,-6,38,44
268,RED,P000848,P008966,3.15,-2,9,11
268,RED,P000848,P009035,17.5,2,41,39
268,RED,P000848,P011941,4.783,-4,6,10
268,RED,P000848,P011964,15.633,0,33,33
268,RED,P000848,P012801,0.05,0,0,0
268,RED,P000848,PJDR,16.4,0,39,39
268,RED,P002553,P004720,1.85,-2,4,6
268,RED,P002553,P005099,5.083,-2,9,11
268,RED,P002553,P006436,5.316,-2,9,11
268,RED,P002553,P007960,2.183,-3,4,7
268,RED,P002553,P008966,2.233,-4,4,8
268,RED,P002553,P009035,6.883,-3,13,16
268,RED,P002553,P011964,0.233,0,0,0
268,RED,P002553,P012801,5.083,-2,9,11
268,RED,P002553,PJDR,4.266,-5,8,13
268,RED,P004720,P006436,0.217,0,2,2
268,RED,P004720,P007960,0.217,0,2,2
268,RED,P004720,P008966,1.85,-2,4,6
268,RED,P004720,P009035,0.217,0,2,2
268,RED,P004720,P012801,0.217,0,2,2
268,RED,P004720,PJDR,1.85,-2,4,6
268,RED,P005099,P006436,10.649,-5,18,23
268,RED,P005099,P007960,15.432,3,26,23
268,RED,P005099,P008966,2.15,-7,2,9
268,RED,P005099,P009035,19.732,-7,33,40
268,RED,P005099,P011941,2.833,-1,2,3
268,RED,P005099,P011964,12.066,-1,19,20
268,RED,P005099,P012801,14.116,-4,21,25
268,RED,P005099,PJDR,0.15,2,2,0
268,RED,P006436,P007960,4.483,-1,9,10
268,RED,P006436,P008966,3.067,-5,7,12
268,RED,P006436,P009035,9.817,-4,23,27
268,RED,P006436,P011941,4.783,-4,6,10
268,RED,P006436,P011964,2.3,2,6,4
268,RED,P006436,P012801,7.5,-9,13,22
268,RED,P006436,PJDR,4.267,1,13,12
268,RED,P007960,P008966,0.383,-2,0,2
268,RED,P007960,P009035,23.433,0,46,46
268,RED,P007960,P011941,3.733,-6,2,8
268,RED,P007960,P011964,20.983,-2,37,39
268,RED,P007960,P012801,7.867,0,12,12
268,RED,P007960,PJDR,12.1,-7,24,31
268,RED,P008966,P009035,3.067,-5,7,12
268,RED,P008966,P012801,2.15,-7,2,9
268,RED,P008966,PJDR,3.15,-2,9,11
268,RED,P009035,P011964,22.0,-2,39,41
268,RED,P009035,P012801,15.1,-9,23,32
268,RED,P009035,PJDR,12.651,0,29,29
268,RED,P011941,P011964,1.05,2,4,2
268,RED,P011941,PJDR,1.95,-3,4,7
268,RED,P011964,P012801,7.65,0,10,10
268,RED,P011964,PJDR,11.217,1,24,23
268,RED,P012801,PJDR,0.867,-5,0,5
269,BAR,P000925,P002939,17.516,-9,31,40
269,BAR,P000925,P003478,7.866,3,15,12
269,BAR,P000925,P004866,11.45,-15,12,27
269,BAR,P000925,P006435,13.95,-10,23,33
269,BAR,P000925,P009992,2.883,-2,6,8
269,BAR,P000925,P011244,3.233,-4,5,9
269,BAR,P000925,P012745,16.283,-9,26,35
269,BAR,P000925,PLFW,4.883,-6,6,12
269,BAR,P002939,P003196,6.901,-6,9,15
269,BAR,P002939,P003478,9.2,7,22,15
269,BAR,P002939,P004866,12.867,-16,14,30
269,BAR,P002939,P006435,15.317,-8,27,35
269,BAR,P002939,P007519,0.817,-2,0,2
269,BAR,P002939,P009992,6.817,-5,14,19
269,BAR,P002939,P010641,1.817,0,5,5
269,BAR,P002939,P011244,5.15,2,12,10
269,BAR,P002939,P012745,21.084,-17,33,50
269,BAR,P002939,PLFW,7.45,-6,13,19
269,BAR,P003196,P003478,7.616,-2,15,17
269,BAR,P003196,P004866,5.65,3,13,10
269,BAR,P003196,P006435,5.4,-6,6,12
269,BAR,P003196,P007519,3.483,-5,5,10
269,BAR,P003196,P009992,8.95,8,24,16
269,BAR,P003196,P011244,12.816,8,28,20
269,BAR,P003196,P012745,5.017,-11,7,18
269,BAR,P003196,PLFW,15.499,-1,33,34
269,BAR,P003478,P004866,3.283,0,4,4
269,BAR,P003478,P006435,7.216,0,15,15
269,BAR,P003478,P007519,2.666,-3,5,8
269,BAR,P003478,P009992,4.967,6,14,8
269,BAR,P003478,P010641,2.65,2,8,6
269,BAR,P003478,P011244,8.816,-3,15,18
269,BAR,P003478,P012745,9.316,6,23,17
269,BAR,P003478,PLFW,8.932,-4,16,20
269,BAR,P004866,P006435,8.767,-14,10,24
269,BAR,P004866,P007519,0.817,-2,0,2
269,BAR,P004866,P009992,4.833,5,13,8
269,BAR,P004866,P010641,0.6,1,2,1
269,BAR,P004866,P011244,4.833,5,13,8
269,BAR,P004866,P012745,12.867,-16,14,30
269,BAR,P004866,PLFW,4.833,5,13,8
269,BAR,P006435,P011244,7.083,-9,9,18
269,BAR,P006435,P012745,12.267,-7,20,27
269,BAR,P006435,PLFW,7.4,-10,6,16
269,BAR,P007519,P011244,0.633,0,0,0
269,BAR,P007519,P012745,2.85,-5,5,10
269,BAR,P007519,PLFW,2.666,-3,5,8
269,BAR,P009992,P010641,2.05,1,6,5
269,BAR,P009992,P011244,8.333,13,24,11
269,BAR,P009992,P012745,5.55,-6,12,18
269,BAR,P009992,PLFW,11.149,8,31,23
269,BAR,P010641,P012745,2.65,2,8,6
269,BAR,P010641,PLFW,0.833,2,3,1
269,BAR,P011244,PLFW,13.299,4,26,22
269,BAR,P012745,PLFW,7.916,-9,16,25
269,ULK,P001932,P002968,4.917,4,11,7
269,ULK,P001932,P004004,8.65,-1,16,17
269,ULK,P001932,P005844,0.567,0,0,0
269,ULK,P001932,P006068,4.267,1,10,9
269,ULK,P001932,P006661,13.734,4,32,28
269,ULK,P001932,P006961,13.951,11,34,23
269,ULK,P001932,P008962,21.634,9,44,35
269,ULK,P001932,P009849,8.317,4,14,10
269,ULK,P001932,P010560,7.15,2,12,10
269,ULK,P001932,P011157,20.417,6,43,37
269,ULK,P002968,P004004,13.95,10,34,24
269,ULK,P002968,P006068,3.483,8,10,2
269,ULK,P002968,P006661,10.6,13,29,16
269,ULK,P002968,P006961,8.017,14,23,9
269,ULK,P002968,P008962,10.817,2,24,22
269,ULK,P002968,P009849,1.833,-6,0,6
269,ULK,P002968,P010560,3.583,-5,5,10
269,ULK,P004004,P005844,0.55,0,0,0
269,ULK,P004004,P006068,6.783,8,17,9
269,ULK,P004004,P006661,13.933,9,36,27
269,ULK,P004004,P006961,11.433,13,31,18
269,ULK,P004004,P008962,16.216,-2,33,35
269,ULK,P004004,P009849,4.116,-5,6,11
269,ULK,P004004,P010560,6.216,-4,11,15
269,ULK,P004004,P011157,7.949,-4,16,20
269,ULK,P005844,P006068,0.55,0,0,0
269,ULK,P005844,P006661,0.567,0,0,0
269,ULK,P005844,P006961,1.117,0,0,0
269,ULK,P005844,P008962,1.117,0,0,0
269,ULK,P006068,P006661,8.983,9,25,16
269,ULK,P006068,P006961,8.316,6,23,17
269,ULK,P006068,P008962,0.85,-3,0,3
269,ULK,P006068,P010560,0.3,-3,0,3
269,ULK,P006068,P011157,5.8,-2,15,17
269,ULK,P006661,P006961,15.967,18,47,29
269,ULK,P006661,P008962,13.884,7,35,28
269,ULK,P006661,P010560,2.1,1,5,4
269,ULK,P006661,P011157,11.7,3,31,28
269,ULK,P006961,P008962,14.368,10,34,24
269,ULK,P006961,P009849,1.167,2,2,0
269,ULK,P006961,P010560,0.3,-3,0,3
269,ULK,P006961,P011157,12.7,5,34,29
269,ULK,P008962,P009849,12.433,-1,20,21
269,ULK,P008962,P010560,13.666,-5,23,28
269,ULK,P008962,P011157,19.083,3,39,36
269,ULK,P009849,P010560,11.266,-3,18,21
269,ULK,P009849,P011157,10.6,5,20,15
269,ULK,P010560,P011157,10.083,0,18,18
270,MUN,P001288,P001557,1.25,2,2,0
270,MUN,P001288,P003583,20.516,2,35,33
270,MUN,P001288,P005460,0.25,1,1,0
270,MUN,P001288,P005478,2.984,1,8,7
270,MUN,P001288,P006543,0.401,1,1,0
270,MUN,P001288,P006760,4.517,-9,5,14
270,MUN,P001288,P007056,19.534,-9,30,39
270,MUN,P001288,P007975,10.4,-2,15,17
270,MUN,P001288,P008985,16.633,-3,29,32
270,MUN,P001288,P010391,10.317,1,14,13
270,MUN,P001288,P011987,22.934,-1,40,41
270,MUN,P001557,P003583,0.133,2,2,0
270,MUN,P001557,P005460,6.867,4,16,12
270,MUN,P001557,P005478,2.1,-1,3,4
270,MUN,P001557,P006543,5.733,2,11,9
270,MUN,P001557,P006760,0.517,0,0,0
270,MUN,P001557,P007056,5.683,-3,8,11
270,MUN,P001557,P007975,10.666,3,21,18
270,MUN,P001557,P008985,1.65,1,3,2
270,MUN,P001557,P010391,8.883,0,16,16
270,MUN,P001557,P011987,0.45,2,2,0
270,MUN,P003583,P005478,1.45,-1,4,5
270,MUN,P003583,P007056,13.183,-2,21,23
270,MUN,P003583,P007975,5.633,-3,6,9
270,MUN,P003583,P008985,14.883,5,29,24
270,MUN,P003583,P010391,6.683,1,8,7
270,MUN,P003583,P011987,19.583,4,35,31
270,MUN,P005460,P006543,6.4,6,14,8
270,MUN,P005460,P006760,1.783,3,4,1
270,MUN,P005460,P007056,2.017,0,5,5
270,MUN,P005460,P007975,8.633,7,20,13
270,MUN,P005460,P008985,1.517,1,3,2
270,MUN,P005460,P010391,7.133,6,17,11
270,MUN,P005478,P006543,0.317,0,0,0
270,MUN,P005478,P007056,3.0,1,7,6
270,MUN,P005478,P007975,4.45,0,11,11
270,MUN,P005478,P010391,1.783,-1,3,4
270,MUN,P005478,P011987,2.984,1,8,7
270,MUN,P006543,P006760,2.85,1,4,3
270,MUN,P006543,P007056,1.933,-2,2,4
270,MUN,P006543,P007975,6.949,4,14,10
270,MUN,P006543,P008985,1.65,1,3,2
270,MUN,P006543,P010391,6.683,3,13,10
270,MUN,P006543,P011987,1.684,0,2,2
270,MUN,P006760,P007056,6.084,-11,5,16
270,MUN,P006760,P007975,4.8,1,8,7
270,MUN,P006760,P008985,1.75,-8,0,8
270,MUN,P006760,P010391,6.117,0,9,9
270,MUN,P006760,P011987,3.05,-9,1,10
270,MUN,P007056,P007975,10.35,-5,16,21
270,MUN,P007056,P008985,14.133,-8,21,29
270,MUN,P007056,P010391,10.367,-7,14,21
270,MUN,P007056,P011987,16.584,-6,27,33
270,MUN,P007975,P008985,1.65,1,3,2
270,MUN,P007975,P010391,17.216,-3,24,27
270,MUN,P007975,P011987,5.917,1,10,9
270,MUN,P008985,P010391,2.633,5,8,3
270,MUN,P008985,P011987,16.633,-3,29,32
270,MUN,P010391,P011987,7.117,3,10,7
270,PAM,P000556,P003960,3.0,1,6,5
270,PAM,P000556,P004863,3.25,-2,6,8
270,PAM,P000556,P005356,8.816,-4,15,19
270,PAM,P000556,P006433,6.65,-2,11,13
270,PAM,P000556,P010393,2.283,-1,4,5
270,PAM,P000556,P010568,4.3,1,8,7
270,PAM,P000556,P011982,4.617,-1,8,9
270,PAM,P000556,P012739,7.9,-10,7,17
270,PAM,P000556,P012740,2.9,-1,3,4
270,PAM,P000556,P012795,8.416,-5,12,17
270,PAM,P003960,P004863,16.95,7,34,27
270,PAM,P003960,P005356,3.7,-1,6,7
270,PAM,P003960,P006433,5.3,2,11,9
270,PAM,P003960,P010393,17.816,10,42,32
270,PAM,P003960,P010568,20.499,6,44,38
270,PAM,P003960,P011982,19.25,8,41,33
270,PAM,P003960,P012739,2.249,-4,2,6
270,PAM,P003960,P012740,1.45,1,5,4
270,PAM,P003960,P012795,6.05,-2,9,11
270,PAM,P004863,P005356,4.4,1,6,5
270,PAM,P004863,P010393,23.232,9,44,35
270,PAM,P004863,P010568,21.383,6,40,34
270,PAM,P004863,P011982,25.35,9,45,36
270,PAM,P004863,P012739,1.317,-1,2,3
270,PAM,P004863,P012795,7.25,-1,7,8
270,PAM,P005356,P006433,6.65,-2,11,13
270,PAM,P005356,P010393,4.633,-1,6,7
270,PAM,P005356,P010568,0.533,1,3,2
270,PAM,P005356,P011982,4.85,-1,6,7
270,PAM,P005356,P012739,3.683,-8,2,10
270,PAM,P005356,P012740,0.317,0,0,0
270,PAM,P005356,P012795,9.35,-1,13,14
270,PAM,P006433,P010393,0.867,3,3,0
270,PAM,P006433,P010568,2.616,3,8,5
270,PAM,P006433,P011982,1.15,0,3,3
270,PAM,P006433,P012739,5.466,-10,4,14
270,PAM,P006433,P012795,8.033,-2,13,15
270,PAM,P010393,P010568,21.816,10,46,36
270,PAM,P010393,P011982,25.216,13,51,38
270,PAM,P010393,P012740,1.767,1,5,4
270,PAM,P010393,P012795,6.366,0,7,7
270,PAM,P010568,P011982,25.367,8,49,41
270,PAM,P010568,P012739,6.233,-5,7,12
270,PAM,P010568,P012740,4.667,0,8,8
270,PAM,P010568,P012795,7.782,-2,11,13
270,PAM,P011982,P012739,3.317,-3,4,7
270,PAM,P011982,P012740,3.134,2,7,5
270,PAM,P011982,P012795,6.817,1,6,5
270,PAM,P012739,P012740,2.9,-1,3,4
270,PAM,P012739,P012795,6.599,-10,5,15
270,PAM,P012740,P012795,1.533,-2,1,3
271,BER,P003958,P006919,20.283,9,46,37
271,BER,P003958,P007025,1.533,0,2,2
271,BER,P003958,P008211,1.533,0,2,2
271,BER,P003958,P008780,23.017,9,52,43
271,BER,P003958,P008967,23.017,9,52,43
271,BER,P003958,P010791,19.183,4,39,35
271,BER,P003958,P011934,5.367,5,15,10
271,BER,P003958,P012720,4.267,0,8,8
271,BER,P006251,P006919,1.383,2,6,4
271,BER,P006251,P007025,10.65,-12,17,29
271,BER,P006251,P008211,12.033,-11,20,31
271,BER,P006251,P008780,1.383,2,6,4
271,BER,P006251,P008967,2.766,3,9,6
271,BER,P006251,P010791,0.65,-7,0,7
271,BER,P006251,P011934,12.766,-2,26,28
271,BER,P006251,P012720,12.033,-11,20,31
271,BER,P006919,P007025,3.566,-1,6,7
271,BER,P006919,P008211,3.566,-1,6,7
271,BER,P006919,P008780,20.133,11,50,39
271,BER,P006919,P008967,20.133,11,50,39
271,BER,P006919,P010791,21.216,3,43,40
271,BER,P006919,P011934,2.483,7,13,6
271,BER,P006919,P012720,2.033,-1,4,5
271,BER,P007025,P008211,14.216,-13,23,36
271,BER,P007025,P010791,4.216,-8,6,14
271,BER,P007025,P011934,10.0,-5,17,22
271,BER,P007025,P012720,12.683,-13,21,34
271,BER,P008211,P008967,1.383,1,3,2
271,BER,P008211,P010791,4.216,-8,6,14
271,BER,P008211,P011934,11.383,-4,20,24
271,BER,P008211,P012720,14.066,-12,24,36
271,BER,P008780,P008967,24.4,11,58,47
271,BER,P008780,P010791,17.65,4,37,33
271,BER,P008780,P011934,6.75,7,21,14
271,BER,P008780,P012720,4.267,0,8,8
271,BER,P008967,P010791,17.65,4,37,33
271,BER,P008967,P011934,8.133,8,24,16
271,BER,P008967,P012720,5.65,1,11,10
271,BER,P010791,P012720,2.683,-8,4,12
271,BER,P011934,P012720,15.65,-4,28,32
271,IST,P004888,P006590,8.15,-6,13,19
271,IST,P004888,P007200,10.617,-6,18,24
271,IST,P004888,P009513,12.716,-10,20,30
271,IST,P004888,P009664,7.734,-1,14,15
271,IST,P004888,P009846,6.8,-2,13,15
271,IST,P004888,P011078,6.517,-6,12,18
271,IST,P004888,P011981,7.367,-4,13,17
271,IST,P004888,P012710,14.666,-14,24,38
271,IST,P004888,P012788,3.7,-2,7,9
271,IST,P004888,PLHK,11.333,-9,18,27
271,IST,P006590,P009513,2.899,-8,2,10
271,IST,P006590,P009664,19.567,14,48,34
271,IST,P006590,P009846,17.25,15,43,28
271,IST,P006590,P011078,16.167,15,42,27
271,IST,P006590,P011981,13.717,15,36,21
271,IST,P006590,P012710,2.666,-6,2,8
271,IST,P006590,P012788,7.233,-2,14,16
271,IST,P006590,PLHK,1.283,-5,0,5
271,IST,P007200,P009513,10.05,-4,18,22
271,IST,P007200,P009664,0.533,-3,2,5
271,IST,P007200,P009846,3.516,2,10,8
271,IST,P007200,P011078,4.083,0,10,10
271,IST,P007200,P011981,0.567,-2,0,2
271,IST,P007200,P012710,13.6,-1,26,27
271,IST,P007200,PLHK,13.566,-2,28,30
271,IST,P009513,P009664,0.233,-2,0,2
271,IST,P009513,P009846,0.233,-2,0,2
271,IST,P009513,P011981,0.233,-2,0,2
271,IST,P009513,P012710,12.716,-10,20,30
271,IST,P009513,P012788,1.383,-1,2,3
271,IST,P009513,PLHK,11.333,-9,18,27
271,IST,P009664,P009846,20.033,11,48,37
271,IST,P009664,P011078,18.95,11,47,36
271,IST,P009664,P011981,15.967,14,39,25
271,IST,P009664,P012788,5.85,-1,12,13
271,IST,P009664,PLHK,0.533,-3,2,5
271,IST,P009846,P011078,20.999,15,54,39
271,IST,P009846,P011981,17.35,12,43,31
271,IST,P009846,P012710,4.366,3,12,9
271,IST,P009846,P012788,3.533,0,7,7
271,IST,P009846,PLHK,3.516,2,10,8
271,IST,P011078,P011981,14.517,11,37,26
271,IST,P011078,P012710,4.933,1,12,11
271,IST,P011078,P012788,5.85,-1,12,13
271,IST,P011078,PLHK,3.516,2,10,8
271,IST,P011981,P012710,1.95,-4,4,8
271,IST,P012710,P012788,1.383,-1,2,3
271,IST,P012710,PLHK,14.316,-4,26,30
272,ASV,P000229,P004194,5.55,9,14,5
272,ASV,P000229,P006568,8.283,-7,15,22
272,ASV,P000229,P011225,13.833,2,29,27
272,ASV,P000229,P012080,13.833,2,29,27
272,ASV,P000229,P012729,8.616,-5,17,22
272,ASV,P000229,P012731,5.217,7,12,5
272,ASV,P002100,P004194,12.384,-7,16,23
272,ASV,P002100,P006568,10.699,-5,16,21
272,ASV,P002100,P011225,11.383,-14,12,26
272,ASV,P002100,P011386,11.7,2,20,18
272,ASV,P002100,P012080,10.017,-7,13,20
272,ASV,P002100,P012729,8.45,-6,12,18
272,ASV,P002100,P012731,14.633,-6,20,26
272,ASV,P002100,PKIR,13.066,-5,19,24
272,ASV,P004194,P011225,12.434,-6,17,23
272,ASV,P004194,P011386,7.867,5,16,11
272,ASV,P004194,P012080,17.934,-1,30,31
272,ASV,P004194,P012729,5.55,-3,11,14
272,ASV,P004194,P012731,14.751,2,22,20
272,ASV,P004194,PKIR,4.734,-3,6,9
272,ASV,P006568,P011225,15.866,-12,27,39
272,ASV,P006568,P011386,3.833,-3,4,7
272,ASV,P006568,P012080,9.0,-10,15,25
272,ASV,P006568,P012729,14.483,-14,21,35
272,ASV,P006568,P012731,5.216,-1,10,11
272,ASV,P006568,PKIR,11.416,-8,16,24
272,ASV,P011225,P012080,21.434,-16,32,48
272,ASV,P011225,P012729,16.216,-18,24,42
272,ASV,P011225,P012731,12.084,0,20,20
272,ASV,P011225,PKIR,9.95,-8,15,23
272,ASV,P011386,P012080,5.5,5,13,8
272,ASV,P011386,P012729,3.817,1,8,7
272,ASV,P011386,P012731,7.883,1,12,11
272,ASV,P011386,PKIR,6.2,-3,7,10
272,ASV,P012080,P012729,14.35,-11,26,37
272,ASV,P012080,P012731,12.584,0,19,19
272,ASV,P012080,PKIR,3.084,-6,3,9
272,ASV,P012729,PKIR,8.65,-12,9,21
272,ASV,P012731,PKIR,7.5,1,13,12
272,OLY,P001255,P007982,4.75,-9,5,14
272,OLY,P001255,P008811,18.4,2,31,29
272,OLY,P001255,P008829,20.0,-1,31,32
272,OLY,P001255,P008855,16.567,4,28,24
272,OLY,P001255,P010612,18.683,3,29,26
272,OLY,P001255,P012878,1.6,-3,0,3
272,OLY,P007853,P007982,16.133,16,37,21
272,OLY,P007853,P008811,4.667,9,14,5
272,OLY,P007853,P008829,12.567,11,30,19
272,OLY,P007853,P008855,4.217,-1,12,13
272,OLY,P007853,P010392,19.65,19,49,30
272,OLY,P007853,P011194,7.433,6,19,13
272,OLY,P007853,P012878,15.333,8,35,27
272,OLY,P007982,P008811,7.817,3,19,16
272,OLY,P007982,P008829,15.1,6,31,25
272,OLY,P007982,P008855,1.667,-6,2,8
272,OLY,P007982,P010392,15.783,18,37,19
272,OLY,P007982,P010612,3.433,-5,3,8
272,OLY,P007982,P011194,5.783,1,11,10
272,OLY,P007982,P012878,13.066,4,23,19
272,OLY,P008811,P008829,23.067,11,45,34
272,OLY,P008811,P008855,16.917,2,28,26
272,OLY,P008811,P010392,4.317,11,14,3
272,OLY,P008811,P010612,17.083,6,29,23
272,OLY,P008829,P008855,19.134,-2,32,34
272,OLY,P008829,P010392,12.217,13,30,17
272,OLY,P008829,P010612,18.683,3,29,26
272,OLY,P008829,P012878,9.5,-1,16,17
272,OLY,P008855,P010392,3.867,1,12,11
272,OLY,P008855,P010612,15.25,8,26,18
272,OLY,P008855,P011194,1.65,5,8,3
272,OLY,P008855,P012878,3.867,1,12,11
272,OLY,P010392,P011194,7.433,6,19,13
272,OLY,P010392,P012878,15.333,8,35,27
272,OLY,P010612,P012878,1.6,-3,0,3
272,OLY,P011194,P012878,7.433,6,19,13
273,MAD,P001392,P003108,22.217,18,54,36
273,MAD,P001392,P003733,1.15,-1,4,5
273,MAD,P001392,P004887,13.284,15,28,13
273,MAD,P001392,P005791,9.066,3,26,23
273,MAD,P001392,P005928,14.767,11,39,28
273,MAD,P001392,P006540,0.133,0,0,0
273,MAD,P001392,P009005,11.567,6,19,13
273,MAD,P001392,P010357,10.783,12,35,23
273,MAD,P001392,P010623,3.666,4,4,0
273,MAD,P001392,P011649,2.767,4,7,3
273,MAD,P003108,P003733,10.683,1,29,28
273,MAD,P003108,P004887,17.751,17,41,24
273,MAD,P003108,P005791,10.766,5,32,27
273,MAD,P003108,P005928,20.167,10,50,40
273,MAD,P003108,P006540,2.116,3,7,4
273,MAD,P003108,P009005,17.1,5,33,28
273,MAD,P003108,P010357,17.883,13,52,39
273,MAD,P003108,P010623,5.55,4,11,7
273,MAD,P003108,P011649,2.767,4,7,3
273,MAD,P003733,P004887,7.55,0,19,19
273,MAD,P003733,P005791,8.016,-5,13,18
273,MAD,P003733,P005928,7.333,-2,13,15
273,MAD,P003733,P006540,8.299,-4,14,18
273,MAD,P003733,P009005,8.616,-3,20,23
273,MAD,P003733,P010357,15.349,-7,26,33
273,MAD,P003733,P010623,8.2,-7,14,21
273,MAD,P004887,P005928,10.884,10,22,12
273,MAD,P004887,P006540,0.283,1,1,0
273,MAD,P004887,P009005,14.85,4,27,23
273,MAD,P004887,P010357,6.767,11,18,7
273,MAD,P004887,P010623,4.6,2,9,7
273,MAD,P004887,P011649,2.767,4,7,3
273,MAD,P005791,P005928,7.983,1,24,23
273,MAD,P005791,P006540,8.149,-5,13,18
273,MAD,P005791,P009005,0.95,2,2,0
273,MAD,P005791,P010357,16.132,-4,37,41
273,MAD,P005791,P010623,7.266,-5,9,14
273,MAD,P005928,P009005,9.283,-4,12,16
273,MAD,P005928,P010357,17.983,10,48,38
273,MAD,P006540,P009005,0.283,1,1,0
273,MAD,P006540,P010357,8.149,-5,13,18
273,MAD,P006540,P010623,6.316,-7,7,14
273,MAD,P009005,P010357,5.166,-3,8,11
273,MAD,P009005,P010623,5.55,4,11,7
273,MAD,P009005,P011649,2.767,4,7,3
273,MAD,P010357,P010623,6.316,-7,7,14
273,PAR,P000956,P003983,6.5,4,14,10
273,PAR,P000956,P007400,6.5,4,14,10
273,PAR,P000956,P009862,1.733,3,5,2
273,PAR,P000956,P011051,4.767,1,9,8
273,PAR,P000956,P012096,2.883,3,8,5
273,PAR,P000956,P012743,3.617,1,6,5
273,PAR,P003983,P004172,5.85,-2,12,14
273,PAR,P003983,P007400,26.25,-9,60,69
273,PAR,P003983,P009862,19.466,1,51,50
273,PAR,P003983,P011051,14.051,-13,27,40
273,PAR,P003983,P012096,12.883,-9,31,40
273,PAR,P003983,P012742,2.017,-11,0,11
273,PAR,P003983,P012743,17.983,3,45,42
273,PAR,P004058,P004172,3.533,-6,0,6
273,PAR,P004058,P007400,0.95,-2,0,2
273,PAR,P004058,P009862,3.533,-6,0,6
273,PAR,P004058,P012096,3.533,-6,0,6
273,PAR,P004058,P012743,2.583,-4,0,4
273,PAR,P004172,P007400,9.184,-1,19,20
273,PAR,P004172,P009862,16.784,-4,24,28
273,PAR,P004172,P011051,5.434,-8,7,15
273,PAR,P004172,P012096,8.55,-5,5,10
273,PAR,P004172,P012742,7.401,4,12,8
273,PAR,P004172,P012743,10.4,6,17,11
273,PAR,P007400,P009862,25.617,1,62,61
273,PAR,P007400,P011051,18.035,-16,31,47
273,PAR,P007400,P012096,14.483,-11,31,42
273,PAR,P007400,P012742,7.218,-9,11,20
273,PAR,P007400,P012743,21.367,7,56,49
273,PAR,P009862,P011051,12.151,-8,22,30
273,PAR,P009862,P012096,18.916,-3,33,36
273,PAR,P009862,P012742,10.218,3,16,13
273,PAR,P009862,P012743,24.45,5,55,50
273,PAR,P011051,P012096,4.717,-13,3,16
273,PAR,P011051,P012742,6.901,-16,4,20
273,PAR,P011051,P012743,9.684,1,21,20
273,PAR,P012096,P012742,7.684,-10,5,15
273,PAR,P012096,P012743,14.683,-2,28,30
273,PAR,P012742,P012743,7.501,7,16,9
274,BAS,P003198,P004603,4.467,-2,7,9
274,BAS,P003198,P004761,4.467,-2,7,9
274,BAS,P003198,P007230,8.201,-8,11,19
274,BAS,P003198,P009048,7.234,-8,9,17
274,BAS,P003198,P011948,3.734,-6,4,10
274,BAS,P003198,P012201,4.284,-4,6,10
274,BAS,P003198,P012765,0.417,-2,0,2
274,BAS,P004603,P004761,12.633,-1,30,31
274,BAS,P004603,P007230,9.317,0,18,18
274,BAS,P004603,P009048,12.083,-3,28,31
274,BAS,P004603,P011085,2.966,-2,8,10
274,BAS,P004603,P011948,5.2,3,15,12
274,BAS,P004603,P012201,3.866,1,14,13
274,BAS,P004761,P007230,14.6,-4,28,32
274,BAS,P004761,P009048,27.316,-5,58,63
274,BAS,P004761,P010444,17.533,1,36,35
274,BAS,P004761,P011085,5.149,-5,12,17
274,BAS,P004761,P011948,18.267,5,43,38
274,BAS,P004761,P012201,16.916,2,40,38
274,BAS,P004761,P012765,5.383,1,10,9
274,BAS,P007230,P009048,14.667,-11,24,35
274,BAS,P007230,P010444,4.883,-2,10,12
274,BAS,P007230,P011085,2.566,-5,4,9
274,BAS,P007230,P011948,11.301,-3,21,24
274,BAS,P007230,P012201,4.684,-6,6,12
274,BAS,P007230,P012765,3.117,-1,6,7
274,BAS,P007946,P010444,3.05,-7,2,9
274,BAS,P007946,P011085,3.05,-7,2,9
274,BAS,P007946,P011948,3.05,-7,2,9
274,BAS,P007946,P012201,3.05,-7,2,9
274,BAS,P009048,P010444,14.833,0,30,30
274,BAS,P009048,P011085,5.149,-5,12,17
274,BAS,P009048,P011948,18.884,0,41,41
274,BAS,P009048,P012201,19.683,-4,42,46
274,BAS,P009048,P012765,2.683,0,4,4
274,BAS,P010444,P011085,7.883,-13,10,23
274,BAS,P010444,P011948,18.367,-6,34,40
274,BAS,P010444,P012201,18.35,-7,32,39
274,BAS,P010444,P012765,8.033,-2,14,16
274,BAS,P011085,P011948,5.7,-10,6,16
274,BAS,P011085,P012201,8.283,-10,14,24
274,BAS,P011085,P012765,2.65,-3,4,7
274,BAS,P011948,P012201,20.534,-16,36,52
274,BAS,P011948,P012765,5.767,-4,10,14
274,BAS,P012201,P012765,5.75,-5,8,13
274,ZAL,P002329,P002676,7.034,-3,15,18
274,ZAL,P002329,P003210,5.984,3,12,9
274,ZAL,P002329,P003211,5.384,3,15,12
274,ZAL,P002329,P005504,6.416,1,14,13
274,ZAL,P002329,P006860,4.383,-2,9,11
274,ZAL,P002329,P007513,14.767,-4,29,33
274,ZAL,P002329,P010390,14.201,0,30,30
274,ZAL,P002329,P011218,14.834,-7,27,34
274,ZAL,P002329,P012715,4.216,7,13,6
274,ZAL,P002329,P012787,5.249,6,12,6
274,ZAL,P002676,P003210,7.367,9,21,12
274,ZAL,P002676,P003211,10.15,14,26,12
274,ZAL,P002676,P005504,2.067,2,8,6
274,ZAL,P002676,P007513,12.334,3,30,27
274,ZAL,P002676,P010390,20.417,15,48,33
274,ZAL,P002676,P011218,12.884,5,31,26
274,ZAL,P002676,P012715,10.733,13,27,14
274,ZAL,P002676,P012787,6.95,10,18,8
274,ZAL,P003210,P003211,4.417,-6,6,12
274,ZAL,P003210,P005504,3.417,0,10,10
274,ZAL,P003210,P006860,1.133,-2,2,4
274,ZAL,P003210,P007513,9.067,12,24,12
274,ZAL,P003210,P010390,10.067,6,20,14
274,ZAL,P003210,P011218,7.018,4,17,13
274,ZAL,P003210,P012715,1.65,-2,2,4
274,ZAL,P003210,P012784,1.133,-2,2,4
274,ZAL,P003210,P012787,2.683,2,4,2
274,ZAL,P003211,P005504,3.25,0,7,7
274,ZAL,P003211,P006860,1.133,-2,2,4
274,ZAL,P003211,P007513,0.784,-2,3,5
274,ZAL,P003211,P010390,13.484,13,37,24
274,ZAL,P003211,P011218,5.018,1,12,11
274,ZAL,P003211,P012715,13.55,19,40,21
274,ZAL,P003211,P012784,1.133,-2,2,4
274,ZAL,P003211,P012787,8.633,14,26,12
274,ZAL,P005504,P006860,5.516,-4,11,15
274,ZAL,P005504,P007513,8.717,0,21,21
274,ZAL,P005504,P011218,10.967,3,26,23
274,ZAL,P005504,P012715,4.517,3,9,6
274,ZAL,P005504,P012784,1.133,-2,2,4
274,ZAL,P005504,P012787,2.4,1,4,3
274,ZAL,P006860,P007513,4.383,-2,9,11
274,ZAL,P006860,P011218,4.383,-2,9,11
274,ZAL,P006860,P012784,1.133,-2,2,4
274,ZAL,P007513,P010390,14.451,3,32,29
274,ZAL,P007513,P011218,19.785,-1,46,47
274,ZAL,P007513,P012715,3.684,0,10,10
274,ZAL,P007513,P012787,4.7,3,8,5
274,ZAL,P010390,P011218,13.935,-1,29,30
274,ZAL,P010390,P012715,13.233,16,38,22
274,ZAL,P010390,P012787,11.816,16,30,14
274,ZAL,P011218,P012715,7.884,5,19,14
274,ZAL,P011218,P012787,2.9,1,4,3
274,ZAL,P012715,P012787,11.533,15,30,15
275,MCO,P004790,P005985,9.3,-3,15,18
275,MCO,P004790,P008099,4.267,-4,9,13
275,MCO,P004790,P011196,5.8,-2,6,8
275,MCO,P004790,P011212,1.85,4,4,0
275,MCO,P004790,P011226,5.667,-2,8,10
275,MCO,P004790,P011231,4.883,1,11,10
275,MCO,P004790,P012709,3.283,-3,2,5
275,MCO,P004790,PLCZ,2.35,-3,5,8
275,MCO,P005985,P008099,23.434,8,53,45
275,MCO,P005985,P010588,23.933,16,56,40
275,MCO,P005985,P011196,14.75,3,31,28
275,MCO,P005985,P011212,7.316,8,16,8
275,MCO,P005985,P011226,19.15,1,37,36
275,MCO,P005985,P011231,15.283,14,38,24
275,MCO,P005985,P012709,3.233,-3,2,5
275,MCO,P005985,PLCZ,16.533,8,36,28
275,MCO,P008099,P010588,19.217,12,44,32
275,MCO,P008099,P011196,8.634,-7,20,27
275,MCO,P008099,P011212,0.75,0,0,0
275,MCO,P008099,P011226,13.884,-6,28,34
275,MCO,P008099,P011231,12.934,4,29,25
275,MCO,P008099,P012709,1.117,-6,0,6
275,MCO,P008099,PLCZ,13.967,7,29,22
275,MCO,P010588,P011196,9.0,5,25,20
275,MCO,P010588,P011212,5.866,1,12,11
275,MCO,P010588,P011226,13.883,0,29,29
275,MCO,P010588,P011231,10.45,13,27,14
275,MCO,P010588,P012709,0.4,-3,0,3
275,MCO,P010588,PLCZ,14.583,8,31,23
275,MCO,P011196,P011212,9.25,4,17,13
275,MCO,P011196,P011226,19.784,-8,37,45
275,MCO,P011196,P011231,7.65,-7,10,17
275,MCO,P011196,P012709,9.6,-12,10,22
275,MCO,P011212,P011226,10.783,0,17,17
275,MCO,P011212,P011231,7.433,-1,15,16
275,MCO,P011212,P012709,5.65,-6,8,14
275,MCO,P011212,PLCZ,2.966,-2,7,9
275,MCO,P011226,P011231,7.517,-7,12,19
275,MCO,P011226,P012709,8.667,-17,8,25
275,MCO,P011226,PLCZ,4.133,-5,4,9
275,MCO,P011231,P012709,7.65,-7,10,17
275,MCO,P011231,PLCZ,12.8,10,32,22
275,MCO,P012709,PLCZ,0.4,-3,0,3
275,PAM,P000556,P003960,6.2,1,15,14
275,PAM,P000556,P004863,10.901,6,23,17
275,PAM,P000556,P005356,8.301,-2,14,16
275,PAM,P000556,P010393,6.1,0,6,6
275,PAM,P000556,P010568,6.833,-4,10,14
275,PAM,P000556,P011982,10.751,6,23,17
275,PAM,P000556,P012738,5.134,0,11,11
275,PAM,P000556,P012740,8.833,2,17,15
275,PAM,P000556,P012795,6.683,-5,9,14
275,PAM,P003960,P004863,6.5,12,19,7
275,PAM,P003960,P005356,8.151,0,17,17
275,PAM,P003960,P006433,10.166,-11,14,25
275,PAM,P003960,P010393,5.45,-10,4,14
275,PAM,P003960,P010568,23.366,-10,39,49
275,PAM,P003960,P011982,11.017,16,30,14
275,PAM,P003960,P012738,4.933,0,9,9
275,PAM,P003960,P012740,0.783,3,3,0
275,PAM,P003960,P012795,21.366,-13,34,47
275,PAM,P004863,P005356,5.918,7,16,9
275,PAM,P004863,P006433,0.133,0,0,0
275,PAM,P004863,P010393,6.017,2,8,6
275,PAM,P004863,P010568,6.8,11,18,7
275,PAM,P004863,P011982,18.851,14,45,31
275,PAM,P004863,P012738,8.584,0,20,20
275,PAM,P004863,P012740,7.3,-2,13,15
275,PAM,P004863,P012795,7.268,6,18,12
275,PAM,P005356,P006433,0.2,1,3,2
275,PAM,P005356,P010393,2.167,0,2,2
275,PAM,P005356,P010568,7.551,-4,15,19
275,PAM,P005356,P011982,8.002,10,24,14
275,PAM,P005356,P012738,2.268,0,9,9
275,PAM,P005356,P012795,9.518,-8,16,24
275,PAM,P006433,P010393,6.383,-12,6,18
275,PAM,P006433,P010568,11.299,-12,19,31
275,PAM,P006433,P011982,2.916,1,11,10
275,PAM,P006433,P012738,3.0,-2,7,9
275,PAM,P006433,P012795,11.099,-13,16,29
275,PAM,P010393,P010568,8.5,-8,10,18
275,PAM,P010393,P011982,7.517,0,10,10
275,PAM,P010393,P012740,4.633,0,4,4
275,PAM,P010393,P012795,8.633,-8,10,18
275,PAM,P010568,P011982,12.884,14,34,20
275,PAM,P010568,P012738,5.3,2,13,11
275,PAM,P010568,P012740,2.233,4,4,0
275,PAM,P010568,P012795,24.166,-9,42,51
275,PAM,P011982,P012738,7.951,2,24,22
275,PAM,P011982,P012740,7.867,-2,13,15
275,PAM,P011982,P012795,11.984,7,30,23
275,PAM,P012738,P012740,4.117,-1,10,11
275,PAM,P012738,P012795,5.117,-5,9,14
275,PAM,P012740,P012795,2.366,4,4,0
276,MIL,P000796,P002812,3.05,-2,4,6
276,MIL,P000796,P002849,18.166,1,36,35
276,MIL,P000796,P005670,1.167,5,5,0
276,MIL,P000796,P006509,11.566,-8,22,30
276,MIL,P000796,P006701,1.15,0,0,0
276,MIL,P000796,P007201,1.267,0,3,3
276,MIL,P000796,P007831,26.717,7,55,48
276,MIL,P000796,P009960,4.234,8,12,4
276,MIL,P000796,P011205,16.084,10,35,25
276,MIL,P000796,P011224,23.467,7,48,41
276,MIL,P002812,P007831,3.05,-2,4,6
276,MIL,P002812,P011205,3.05,-2,4,6
276,MIL,P002812,P011224,3.05,-2,4,6
276,MIL,P002849,P006509,17.299,-10,33,43
276,MIL,P002849,P006701,3.75,-2,5,7
276,MIL,P002849,P007201,5.733,-2,11,13
276,MIL,P002849,P007831,21.032,1,44,43
276,MIL,P002849,P011205,10.4,2,19,17
276,MIL,P002849,P011224,19.216,6,40,34
276,MIL,P005670,P006509,4.0,2,8,6
276,MIL,P005670,P007201,7.5,-2,11,13
276,MIL,P005670,P007831,4.384,1,8,7
276,MIL,P005670,P009960,8.667,3,16,13
276,MIL,P005670,P011205,8.667,3,16,13
276,MIL,P005670,P011224,0.283,0,0,0
276,MIL,P006509,P006701,2.6,-2,5,7
276,MIL,P006509,P007201,9.783,-2,19,21
276,MIL,P006509,P007831,14.432,-8,30,38
276,MIL,P006509,P009960,4.05,0,8,8
276,MIL,P006509,P011205,9.0,-7,13,20
276,MIL,P006509,P011224,12.666,-5,26,31
276,MIL,P006701,P007201,2.6,-2,5,7
276,MIL,P006701,P007831,2.883,0,5,5
276,MIL,P006701,P011205,0.867,-2,0,2
276,MIL,P006701,P011224,1.15,0,0,0
276,MIL,P007201,P007831,7.35,-4,14,18
276,MIL,P007201,P009960,7.55,-4,11,15
276,MIL,P007201,P011205,11.684,-6,17,23
276,MIL,P007201,P011224,4.733,-2,9,11
276,MIL,P007831,P009960,7.451,4,15,11
276,MIL,P007831,P011205,19.301,6,38,32
276,MIL,P007831,P011224,24.6,7,51,44
276,MIL,P009960,P011205,11.784,4,23,19
276,MIL,P009960,P011224,3.4,1,7,6
276,MIL,P011205,P011224,15.167,8,31,23
276,ULK,P001932,P002968,2.45,0,4,4
276,ULK,P001932,P004004,10.516,-7,15,22
276,ULK,P001932,P005844,6.633,-3,8,11
276,ULK,P001932,P006068,4.667,-2,10,12
276,ULK,P001932,P006661,12.1,1,23,22
276,ULK,P001932,P006961,16.299,-13,25,38
276,ULK,P001932,P008962,16.05,-16,24,40
276,ULK,P001932,P009849,10.018,2,22,20
276,ULK,P001932,P011157,12.117,-4,26,30
276,ULK,P001932,P011980,6.15,2,11,9
276,ULK,P002968,P004004,4.451,3,8,5
276,ULK,P002968,P006068,0.367,-1,0,1
276,ULK,P002968,P006661,5.167,-1,8,9
276,ULK,P002968,P006961,5.167,-1,8,9
276,ULK,P002968,P009849,0.867,2,2,0
276,ULK,P002968,P011980,5.667,2,10,8
276,ULK,P004004,P005844,1.066,-5,0,5
276,ULK,P004004,P006068,2.0,-6,0,6
276,ULK,P004004,P006661,18.25,6,38,32
276,ULK,P004004,P006961,16.332,-2,32,34
276,ULK,P004004,P008962,15.666,4,34,30
276,ULK,P004004,P009849,12.8,14,30,16
276,ULK,P004004,P011157,15.266,-3,24,27
276,ULK,P004004,P011980,8.717,4,15,11
276,ULK,P005844,P006068,0.083,0,0,0
276,ULK,P005844,P006661,5.567,2,8,6
276,ULK,P005844,P006961,6.633,-3,8,11
276,ULK,P005844,P008962,6.55,-3,8,11
276,ULK,P006068,P006661,3.117,-7,2,9
276,ULK,P006068,P006961,3.083,-7,2,9
276,ULK,P006068,P008962,3.384,-1,8,9
276,ULK,P006068,P009849,3.267,-1,8,9
276,ULK,P006068,P011157,5.9,-7,10,17
276,ULK,P006661,P006961,22.483,10,49,39
276,ULK,P006661,P008962,18.35,14,42,28
276,ULK,P006661,P009849,8.45,15,26,11
276,ULK,P006661,P011157,12.183,2,24,22
276,ULK,P006661,P011980,5.733,-2,8,10
276,ULK,P006961,P008962,18.149,-2,36,38
276,ULK,P006961,P009849,4.617,9,18,9
276,ULK,P006961,P011157,9.633,-7,18,25
276,ULK,P006961,P011980,4.8,0,8,8
276,ULK,P008962,P009849,11.434,5,29,24
276,ULK,P008962,P011157,13.817,-5,27,32
276,ULK,P009849,P011157,13.851,0,28,28
276,ULK,P009849,P011980,5.5,2,9,7
276,ULK,P011157,P011980,4.633,0,7,7
277,RED,P000848,P002553,11.184,5,28,23
277,RED,P000848,P005099,11.3,4,30,26
277,RED,P000848,P006436,7.951,2,20,18
277,RED,P000848,P007960,12.316,6,30,24
277,RED,P000848,P008966,10.45,0,27,27
277,RED,P000848,P009035,17.366,14,49,35
277,RED,P000848,P011964,8.2,1,16,15
277,RED,P000848,P012801,3.333,2,10,8
277,RED,P000848,PJDR,12.3,6,30,24
277,RED,P002553,P004720,0.2,0,0,0
277,RED,P002553,P005099,9.117,3,18,15
277,RED,P002553,P006436,12.801,4,28,24
277,RED,P002553,P007960,5.833,2,14,12
277,RED,P002553,P008966,6.7,0,15,15
277,RED,P002553,P009035,7.8,8,21,13
277,RED,P002553,P011964,3.984,-1,7,8
277,RED,P002553,P012801,5.516,4,14,10
277,RED,P002553,PJDR,11.401,3,27,24
277,RED,P004720,P005099,0.35,0,0,0
277,RED,P004720,P006436,0.2,0,0,0
277,RED,P004720,P007960,0.15,0,0,0
277,RED,P004720,P008966,0.15,0,0,0
277,RED,P004720,P011964,0.2,0,0,0
277,RED,P004720,P012801,0.15,0,0,0
277,RED,P005099,P006436,14.167,4,30,26
277,RED,P005099,P007960,15.533,3,38,35
277,RED,P005099,P008966,11.95,10,37,27
277,RED,P005099,P009035,19.017,2,43,41
277,RED,P005099,P011964,12.5,-3,20,23
277,RED,P005099,P012801,8.55,-4,12,16
277,RED,P005099,PJDR,2.984,5,8,3
277,RED,P006436,P007960,3.333,1,9,8
277,RED,P006436,P008966,9.984,4,28,24
277,RED,P006436,P009035,12.051,15,33,18
277,RED,P006436,P011964,5.534,-1,7,8
277,RED,P006436,P012801,5.717,3,11,8
277,RED,P006436,PJDR,9.002,12,26,14
277,RED,P007960,P008966,7.633,2,21,19
277,RED,P007960,P009035,15.866,3,35,32
277,RED,P007960,P011964,10.15,-1,20,21
277,RED,P007960,P012801,4.167,-4,6,10
277,RED,P007960,PJDR,4.283,0,7,7
277,RED,P008966,P009035,9.667,9,31,22
277,RED,P008966,P011964,1.083,0,2,2
277,RED,P008966,P012801,4.666,4,12,8
277,RED,P008966,PJDR,7.517,7,19,12
277,RED,P009035,P011964,10.617,-1,18,19
277,RED,P009035,P012801,8.818,-3,17,20
277,RED,P009035,PJDR,11.134,17,33,16
277,RED,P011964,P012801,7.284,-3,11,14
277,RED,P011964,PJDR,3.184,1,7,6
277,RED,P012801,PJDR,4.667,5,15,10
277,VIR,P001133,P002084,0.817,0,2,2
277,VIR,P001133,P003048,18.716,-1,41,42
277,VIR,P001133,P003527,13.0,-11,25,36
277,VIR,P001133,P004007,10.75,-11,23,34
277,VIR,P001133,P005553,5.117,-9,5,14
277,VIR,P001133,P006739,17.098,-5,36,41
277,VIR,P001133,P008847,8.233,-8,10,18
277,VIR,P001133,P010781,19.166,-9,36,45
277,VIR,P001133,PBCN,24.499,-6,50,56
277,VIR,P002084,P003048,0.817,-4,1,5
277,VIR,P002084,P003527,11.1,0,24,24
277,VIR,P002084,P004007,1.584,-4,3,7
277,VIR,P002084,P005553,5.283,5,11,6
277,VIR,P002084,P006739,2.05,0,6,6
277,VIR,P002084,P008847,9.683,4,21,17
277,VIR,P002084,P010781,11.317,0,24,24
277,VIR,P002084,PBCN,2.617,-1,4,5
277,VIR,P003048,P003527,7.85,-1,16,17
277,VIR,P003048,P004007,8.434,-6,18,24
277,VIR,P003048,P005553,1.7,-2,3,5
277,VIR,P003048,P006739,11.716,-1,26,27
277,VIR,P003048,P010781,11.583,-3,25,28
277,VIR,P003048,PBCN,17.316,-2,38,40
277,VIR,P003527,P004007,3.484,-10,7,17
277,VIR,P003527,P005553,6.95,-1,11,12
277,VIR,P003527,P006739,5.466,-1,15,16
277,VIR,P003527,P008847,13.183,-4,25,29
277,VIR,P003527,P010781,22.049,-13,43,56
277,VIR,P003527,PBCN,10.65,-3,22,25
277,VIR,P004007,P006739,9.3,-9,19,28
277,VIR,P004007,P008847,0.783,-3,0,3
277,VIR,P004007,P010781,2.75,-10,7,17
277,VIR,P004007,PBCN,9.183,-7,19,26
277,VIR,P005553,P006739,0.716,-3,0,3
277,VIR,P005553,P008847,8.85,-2,13,15
277,VIR,P005553,P010781,9.834,-1,16,17
277,VIR,P005553,PBCN,3.75,-3,5,8
277,VIR,P006739,P008847,6.532,0,14,14
277,VIR,P006739,P010781,8.965,1,21,20
277,VIR,P006739,PBCN,14.749,-2,31,33
277,VIR,P008847,P010781,16.25,0,27,27
277,VIR,P008847,PBCN,8.75,-3,14,17
277,VIR,P010781,PBCN,17.35,-1,33,34
278,MUN,P001288,P001557,15.118,6,29,23
278,MUN,P001288,P003583,26.117,-3,43,46
278,MUN,P001288,P005460,1.567,3,5,2
278,MUN,P001288,P005478,4.1,-5,6,11
278,MUN,P001288,P006760,6.534,-3,12,15
278,MUN,P001288,P007975,5.417,-5,5,10
278,MUN,P001288,P008985,21.217,-9,39,48
278,MUN,P001288,P010391,14.934,1,21,20
278,MUN,P001288,P011987,24.0,-13,40,53
278,MUN,P001557,P003583,15.118,6,29,23
278,MUN,P001557,P007975,0.217,0,0,0
278,MUN,P001557,P008985,9.551,-1,18,19
278,MUN,P001557,P010391,7.684,8,14,6
278,MUN,P001557,P011987,12.784,5,26,21
278,MUN,P003583,P005478,2.033,2,4,2
278,MUN,P003583,P006543,0.267,-5,0,5
278,MUN,P003583,P006760,3.167,-4,5,9
278,MUN,P003583,P007975,5.684,-10,5,15
278,MUN,P003583,P008985,17.583,-5,32,37
278,MUN,P003583,P010391,15.201,-4,21,25
278,MUN,P003583,P011987,20.366,-9,33,42
278,MUN,P005460,P006543,9.184,3,24,21
278,MUN,P005460,P006760,10.751,6,29,23
278,MUN,P005460,P007975,7.567,-1,18,19
278,MUN,P005460,P008985,6.317,11,22,11
278,MUN,P005460,P010391,1.117,-2,2,4
278,MUN,P005460,P011987,6.501,4,16,12
278,MUN,P005478,P006543,0.8,-6,0,6
278,MUN,P005478,P006760,2.867,-13,2,15
278,MUN,P005478,P007975,0.8,-6,0,6
278,MUN,P005478,P008985,4.1,-5,6,11
278,MUN,P005478,P010391,1.0,2,2,0
278,MUN,P005478,P011987,3.9,-13,4,17
278,MUN,P006543,P006760,10.251,-8,24,32
278,MUN,P006543,P007975,8.634,-12,18,30
278,MUN,P006543,P008985,4.75,8,17,9
278,MUN,P006543,P010391,1.384,-7,2,9
278,MUN,P006543,P011987,5.734,-5,11,16
278,MUN,P006760,P007975,11.051,-9,23,32
278,MUN,P006760,P008985,10.517,5,29,24
278,MUN,P006760,P010391,2.151,-7,2,9
278,MUN,P006760,P011987,9.851,-11,18,29
278,MUN,P007975,P008985,5.583,4,16,12
278,MUN,P007975,P010391,4.351,-12,2,14
278,MUN,P007975,P011987,6.9,-17,5,22
278,MUN,P008985,P010391,6.4,-1,10,11
278,MUN,P008985,P011987,17.85,-11,35,46
278,MUN,P010391,P011987,11.05,-2,16,18
278,TEL,P005145,P009622,7.35,-4,9,13
278,TEL,P005145,P009783,5.567,1,9,8
278,TEL,P005145,P009863,7.35,-4,9,13
278,TEL,P005145,P011199,7.35,-4,9,13
278,TEL,P005145,P012744,1.783,-5,0,5
278,TEL,P007990,P009622,2.717,9,11,2
278,TEL,P007990,P009783,9.984,10,28,18
278,TEL,P007990,P009863,0.233,2,2,0
278,TEL,P007990,P011193,9.284,5,27,22
278,TEL,P007990,P011199,4.484,9,17,8
278,TEL,P007990,P011214,7.517,5,21,16
278,TEL,P007990,P011971,12.001,14,38,24
278,TEL,P007990,P012744,1.784,2,8,6
278,TEL,P009622,P009783,24.267,18,54,36
278,TEL,P009622,P009863,25.249,8,49,41
278,TEL,P009622,P011199,24.65,14,52,38
278,TEL,P009622,P011214,3.083,1,6,5
278,TEL,P009622,P011971,9.533,4,20,16
278,TEL,P009622,P012744,14.083,10,31,21
278,TEL,P009783,P009863,24.367,7,47,40
278,TEL,P009783,P011193,10.084,-1,21,22
278,TEL,P009783,P011199,25.301,19,58,39
278,TEL,P009783,P011214,9.05,-2,17,19
278,TEL,P009783,P011971,16.884,3,37,34
278,TEL,P009783,P012744,11.9,13,29,16
278,TEL,P009863,P011193,2.984,-5,4,9
278,TEL,P009863,P011199,23.633,5,43,38
278,TEL,P009863,P011214,4.6,-2,10,12
278,TEL,P009863,P011971,8.983,-6,15,21
278,TEL,P009863,P012744,15.533,7,33,26
278,TEL,P011193,P011199,3.467,0,8,8
278,TEL,P011193,P011214,8.801,0,23,23
278,TEL,P011193,P011971,11.218,2,31,29
278,TEL,P011193,P012744,3.234,-1,10,11
278,TEL,P011199,P011971,10.817,2,24,22
278,TEL,P011199,P012744,12.766,11,29,18
278,TEL,P011214,P011971,9.934,4,27,23
278,TEL,P011214,P012744,4.551,-2,12,14
278,TEL,P011971,P012744,3.634,1,12,11
279,BAR,P000925,P002939,21.183,-7,39,46
279,BAR,P000925,P003478,6.082,-7,10,17
279,BAR,P000925,P004866,19.218,-4,35,39
279,BAR,P000925,P006435,9.034,-8,13,21
279,BAR,P000925,P007519,14.517,0,29,29
279,BAR,P000925,P011244,3.067,4,8,4
279,BAR,P000925,P012745,22.233,-15,37,52
279,BAR,P000925,PLFW,5.866,-7,9,16
279,BAR,P002939,P003196,6.683,2,19,17
279,BAR,P002939,P003478,10.282,-2,24,26
279,BAR,P002939,P004866,17.584,-3,34,37
279,BAR,P002939,P006435,9.517,-5,18,23
279,BAR,P002939,P007519,14.516,-2,29,31
279,BAR,P002939,P011244,4.6,6,14,8
279,BAR,P002939,P012745,22.833,-8,44,52
279,BAR,P002939,PLFW,4.266,-1,11,12
279,BAR,P003196,P003478,9.833,11,29,18
279,BAR,P003196,P004866,4.866,-8,7,15
279,BAR,P003196,P006435,12.316,1,28,27
279,BAR,P003196,P007519,1.166,-3,2,5
279,BAR,P003196,P011244,10.033,0,22,22
279,BAR,P003196,P012745,4.233,6,14,8
279,BAR,P003196,PLFW,9.666,3,23,20
279,BAR,P003478,P006435,9.516,7,24,17
279,BAR,P003478,P007519,2.133,-2,4,6
279,BAR,P003478,P011244,8.25,6,21,15
279,BAR,P003478,P012745,7.665,-2,18,20
279,BAR,P003478,PLFW,9.899,5,26,21
279,BAR,P004866,P006435,11.834,-14,17,31
279,BAR,P004866,P007519,13.55,-1,27,28
279,BAR,P004866,P011244,4.85,-2,9,11
279,BAR,P004866,P012745,18.801,-7,33,40
279,BAR,P004866,PLFW,5.633,-9,6,15
279,BAR,P006435,P007519,1.3,-3,2,5
279,BAR,P006435,P011244,9.384,1,19,18
279,BAR,P006435,P012745,11.533,-5,22,27
279,BAR,P006435,PLFW,10.966,-2,21,23
279,BAR,P007519,P011244,1.6,0,4,4
279,BAR,P007519,P012745,13.65,0,27,27
279,BAR,P007519,PLFW,0.3,-1,0,1
279,BAR,P011244,PLFW,10.616,1,23,22
279,BAR,P012745,PLFW,4.916,-5,9,14
279,PAN,P001926,P002328,22.733,14,54,40
279,PAN,P001926,P003842,29.184,14,70,56
279,PAN,P001926,P007553,2.767,1,5,4
279,PAN,P001926,P007866,31.3,28,81,53
279,PAN,P001926,P011204,17.634,17,46,29
279,PAN,P001926,P012712,3.5,-3,4,7
279,PAN,P001926,P012774,26.95,13,64,51
279,PAN,P002328,P003842,24.284,-1,51,52
279,PAN,P002328,P007553,3.367,-4,5,9
279,PAN,P002328,P007866,29.217,1,62,61
279,PAN,P002328,P007947,0.967,-2,2,4
279,PAN,P002328,P011204,13.284,-1,27,28
279,PAN,P002328,P011209,3.067,-6,3,9
279,PAN,P002328,P012712,1.333,2,4,2
279,PAN,P002328,P012774,18.616,1,40,39
279,PAN,P003842,P007866,32.851,13,78,65
279,PAN,P003842,P007947,0.967,-2,2,4
279,PAN,P003842,P011204,23.185,9,52,43
279,PAN,P003842,P011209,2.467,-1,3,4
279,PAN,P003842,P012712,2.267,-9,0,9
279,PAN,P003842,P012774,25.067,1,56,55
279,PAN,P007553,P007866,3.367,-4,5,9
279,PAN,P007553,P011204,0.6,-5,0,5
279,PAN,P007553,P011209,0.6,-5,0,5
279,PAN,P007553,P012774,2.767,1,5,4
279,PAN,P007866,P007947,0.967,-2,2,4
279,PAN,P007866,P011204,21.851,13,54,41
279,PAN,P007866,P011209,3.067,-6,3,9
279,PAN,P007866,P012712,1.333,2,4,2
279,PAN,P007866,P012774,27.183,15,67,52
279,PAN,P007947,P011204,0.967,-2,2,4
279,PAN,P011204,P011209,3.067,-6,3,9
279,PAN,P011204,P012712,2.217,-7,0,7
279,PAN,P011204,P012774,13.467,6,32,26
279,PAN,P012712,P012774,3.55,-5,4,9
280,BAR,P000925,P002939,12.167,-2,24,26
280,BAR,P000925,P003478,6.25,-8,12,20
280,BAR,P000925,P004866,14.3,1,26,25
280,BAR,P000925,P006435,18.483,-2,38,40
280,BAR,P000925,P007519,3.066,-3,4,7
280,BAR,P000925,P009992,2.067,-5,0,5
280,BAR,P000925,P011244,11.916,-6,19,25
280,BAR,P000925,P012745,8.634,-1,19,20
280,BAR,P000925,PLFW,5.317,-2,10,12
280,BAR,P002939,P003196,9.118,13,25,12
280,BAR,P002939,P003478,11.901,6,30,24
280,BAR,P002939,P004866,7.117,5,15,10
280,BAR,P002939,P006435,12.584,1,27,26
280,BAR,P002939,P009992,8.701,10,22,12
280,BAR,P002939,P011244,12.867,4,28,24
280,BAR,P002939,P012745,8.418,7,21,14
280,BAR,P002939,PLFW,2.267,0,4,4
280,BAR,P003196,P003478,10.901,13,30,17
280,BAR,P003196,P004866,6.283,2,15,13
280,BAR,P003196,P006435,2.234,0,5,5
280,BAR,P003196,P007519,5.083,-1,9,10
280,BAR,P003196,P009992,13.184,14,35,21
280,BAR,P003196,P011244,5.067,5,13,8
280,BAR,P003196,P012745,14.384,10,36,26
280,BAR,P003196,PLFW,11.55,4,28,24
280,BAR,P003478,P006435,7.067,-7,14,21
280,BAR,P003478,P007519,1.333,-4,0,4
280,BAR,P003478,P009992,10.084,12,28,16
280,BAR,P003478,P011244,8.267,-3,17,20
280,BAR,P003478,P012745,8.884,8,25,17
280,BAR,P003478,PLFW,3.917,3,12,9
280,BAR,P004866,P006435,13.65,5,29,24
280,BAR,P004866,P007519,6.816,0,13,13
280,BAR,P004866,P009992,2.9,-3,3,6
280,BAR,P004866,P011244,7.766,0,13,13
280,BAR,P004866,P012745,12.817,3,28,25
280,BAR,P004866,PLFW,10.683,-1,22,23
280,BAR,P006435,P007519,4.116,-5,4,9
280,BAR,P006435,P011244,12.466,-6,19,25
280,BAR,P006435,P012745,8.251,4,24,20
280,BAR,P006435,PLFW,4.017,2,12,10
280,BAR,P007519,P011244,4.116,-5,4,9
280,BAR,P007519,P012745,4.033,1,9,8
280,BAR,P007519,PLFW,4.033,1,9,8
280,BAR,P009992,P011244,4.517,5,13,8
280,BAR,P009992,P012745,10.734,4,22,18
280,BAR,P009992,PLFW,8.817,-1,17,18
280,BAR,P011244,PLFW,0.95,2,2,0
280,BAR,P012745,PLFW,15.917,0,36,36
280,MUN,P001288,P003583,25.1,-7,43,50
280,MUN,P001288,P005460,4.484,-2,12,14
280,MUN,P001288,P005478,1.333,-2,0,2
280,MUN,P001288,P006543,2.401,4,10,6
280,MUN,P001288,P006760,25.033,-11,43,54
280,MUN,P001288,P007975,10.201,2,23,21
280,MUN,P001288,P008985,17.0,-9,27,36
280,MUN,P001288,P010391,9.684,-3,22,25
280,MUN,P001288,P011987,23.1,-8,40,48
280,MUN,P003583,P005478,1.333,-2,0,2
280,MUN,P003583,P006543,2.734,3,7,4
280,MUN,P003583,P006760,21.166,-10,34,44
280,MUN,P003583,P007975,7.317,1,12,11
280,MUN,P003583,P008985,17.0,-9,27,36
280,MUN,P003583,P010391,6.15,-3,10,13
280,MUN,P003583,P011987,22.45,-7,39,46
280,MUN,P003583,P012123,0.95,-2,0,2
280,MUN,P005460,P005478,1.9,-5,0,5
280,MUN,P005460,P006543,7.05,-4,18,22
280,MUN,P005460,P006760,4.9,3,15,12
280,MUN,P005460,P007975,10.267,-4,26,30
280,MUN,P005460,P010391,10.917,-5,27,32
280,MUN,P005460,P011987,1.167,-1,3,4
280,MUN,P005460,P012123,2.983,-2,7,9
280,MUN,P005478,P006543,4.933,1,9,8
280,MUN,P005478,P007975,6.266,-1,9,10
280,MUN,P005478,P010391,6.266,-1,9,10
280,MUN,P005478,P012123,3.033,6,9,3
280,MUN,P006543,P006760,1.033,4,6,2
280,MUN,P006543,P007975,12.817,5,34,29
280,MUN,P006543,P010391,12.35,2,31,29
280,MUN,P006543,P011987,0.984,3,5,2
280,MUN,P006543,P012123,6.966,2,16,14
280,MUN,P006760,P007975,6.683,4,17,13
280,MUN,P006760,P008985,17.0,-9,27,36
280,MUN,P006760,P010391,6.633,2,19,17
280,MUN,P006760,P011987,21.816,-11,35,46
280,MUN,P007975,P010391,17.717,0,41,41
280,MUN,P007975,P011987,4.234,3,10,7
280,MUN,P007975,P012123,6.966,2,16,14
280,MUN,P008985,P011987,17.0,-9,27,36
280,MUN,P010391,P011987,3.717,-2,9,11
280,MUN,P010391,P012123,6.966,2,16,14
281,ASV,P000229,P002100,1.85,-4,4,8
281,ASV,P000229,P003526,9.733,4,19,15
281,ASV,P000229,P004194,16.866,-6,33,39
281,ASV,P000229,P006568,3.65,-4,4,8
281,ASV,P000229,P011225,19.133,-10,34,44
281,ASV,P000229,P011386,1.1,3,3,0
281,ASV,P000229,P012080,9.216,-13,14,27
281,ASV,P000229,P012729,5.133,-6,4,10
281,ASV,P000229,P012731,9.817,5,23,18
281,ASV,P000229,PKIR,5.566,-9,10,19
281,ASV,P002100,P004194,5.217,-6,14,20
281,ASV,P002100,P006568,15.184,8,30,22
281,ASV,P002100,P011225,8.684,-5,22,27
281,ASV,P002100,P011386,12.65,1,22,21
281,ASV,P002100,P012080,19.484,0,40,40
281,ASV,P002100,P012729,0.35,-2,0,2
281,ASV,P002100,P012731,13.767,-8,21,29
281,ASV,P002100,PKIR,8.15,0,23,23
281,ASV,P003526,P004194,9.733,4,19,15
281,ASV,P003526,P011225,9.45,7,19,12
281,ASV,P003526,P012080,0.283,-3,0,3
281,ASV,P003526,P012729,4.783,-4,4,8
281,ASV,P003526,P012731,4.667,11,15,4
281,ASV,P003526,PKIR,0.283,-3,0,3
281,ASV,P004194,P011225,17.05,-6,38,44
281,ASV,P004194,P011386,2.9,1,5,4
281,ASV,P004194,P012080,8.933,-11,20,31
281,ASV,P004194,P012729,5.133,-6,4,10
281,ASV,P004194,P012731,6.167,9,19,10
281,ASV,P004194,PKIR,8.933,-11,20,31
281,ASV,P006568,P011225,7.984,1,14,13
281,ASV,P006568,P011386,10.85,3,20,17
281,ASV,P006568,P012080,18.834,4,34,30
281,ASV,P006568,P012731,14.984,-4,21,25
281,ASV,P006568,PKIR,3.85,8,13,5
281,ASV,P011225,P012080,14.667,-14,29,43
281,ASV,P011225,P012729,5.133,-6,4,10
281,ASV,P011225,P012731,14.267,3,30,27
281,ASV,P011225,PKIR,7.5,-14,18,32
281,ASV,P011386,P012080,13.75,4,25,21
281,ASV,P011386,P012731,7.817,-4,10,14
281,ASV,P011386,PKIR,5.933,8,15,7
281,ASV,P012080,P012731,15.917,-10,21,31
281,ASV,P012080,PKIR,13.716,-9,33,42
281,ASV,P012731,PKIR,0.933,-6,0,6
281,MCO,P002581,P005985,3.534,2,8,6
281,MCO,P002581,P009754,0.167,-1,1,2
281,MCO,P002581,P011212,5.217,-3,7,10
281,MCO,P002581,P011226,5.384,-4,8,12
281,MCO,P002581,P011231,5.384,-4,8,12
281,MCO,P002581,P012709,1.85,-6,0,6
281,MCO,P004197,P005985,8.317,-7,10,17
281,MCO,P004197,P009754,8.317,-7,10,17
281,MCO,P004197,P010588,8.317,-7,10,17
281,MCO,P004197,PLCZ,8.317,-7,10,17
281,MCO,P005985,P009754,14.434,-3,29,32
281,MCO,P005985,P010588,17.249,4,40,36
281,MCO,P005985,P011196,10.016,11,27,16
281,MCO,P005985,P011212,15.299,23,46,23
281,MCO,P005985,P011226,19.15,27,61,34
281,MCO,P005985,P011231,13.684,21,44,23
281,MCO,P005985,PLCZ,12.717,2,27,25
281,MCO,P009754,P010588,11.883,-5,19,24
281,MCO,P009754,P011196,9.783,1,19,18
281,MCO,P009754,P011212,7.516,1,12,11
281,MCO,P009754,P011226,11.367,5,27,22
281,MCO,P009754,P011231,8.934,3,20,17
281,MCO,P009754,PLCZ,10.867,-2,19,21
281,MCO,P010588,P011196,3.616,2,9,7
281,MCO,P010588,P011212,6.499,9,23,14
281,MCO,P010588,P011226,7.799,11,28,17
281,MCO,P010588,P011231,2.333,5,11,6
281,MCO,P010588,PLCZ,11.3,-3,20,23
281,MCO,P011196,P011212,16.166,7,32,25
281,MCO,P011196,P011226,19.566,7,41,34
281,MCO,P011196,P011231,15.95,5,32,27
281,MCO,P011196,P012709,3.167,-5,4,9
281,MCO,P011212,P011226,25.566,13,58,45
281,MCO,P011212,P011231,22.533,9,48,39
281,MCO,P011212,P012709,5.017,-11,4,15
281,MCO,P011212,PLCZ,2.983,4,10,6
281,MCO,P011226,P011231,25.084,11,58,47
281,MCO,P011226,P012709,5.017,-11,4,15
281,MCO,P011226,PLCZ,3.267,9,15,6
281,MCO,P011231,P012709,5.017,-11,4,15
281,MCO,P011231,PLCZ,1.417,5,7,2
282,BAS,P003198,P004761,11.483,1,25,24
282,BAS,P003198,P007230,4.15,-5,9,14
282,BAS,P003198,P009048,11.483,1,25,24
282,BAS,P003198,P010444,7.333,6,16,10
282,BAS,P003198,P011085,5.283,-3,10,13
282,BAS,P003198,P011948,6.2,4,15,11
282,BAS,P004603,P004761,10.082,-21,10,31
282,BAS,P004603,P007230,15.167,-19,24,43
282,BAS,P004603,P009048,10.25,-9,18,27
282,BAS,P004603,P010444,3.333,-6,4,10
282,BAS,P004603,P011085,7.95,-2,16,18
282,BAS,P004603,P011948,18.783,-16,36,52
282,BAS,P004603,P012201,14.084,-8,30,38
282,BAS,P004603,P012765,12.883,-15,22,37
282,BAS,P004761,P007230,14.833,-15,24,39
282,BAS,P004761,P009048,17.933,-1,34,35
282,BAS,P004761,P010444,15.633,0,29,29
282,BAS,P004761,P011085,14.333,-11,23,34
282,BAS,P004761,P011948,12.199,-9,21,30
282,BAS,P004761,P012201,1.033,-5,0,5
282,BAS,P004761,P012765,8.599,-19,10,29
282,BAS,P007230,P009048,19.367,-14,36,50
282,BAS,P007230,P010444,4.967,0,9,9
282,BAS,P007230,P011085,8.434,-6,14,20
282,BAS,P007230,P011948,15.85,-18,28,46
282,BAS,P007230,P012201,9.451,-9,18,27
282,BAS,P007230,P012765,4.917,-10,6,16
282,BAS,P009048,P010444,12.3,6,25,19
282,BAS,P009048,P011085,11.417,-3,21,24
282,BAS,P009048,P011948,16.117,-1,35,36
282,BAS,P009048,P012201,9.184,-5,20,25
282,BAS,P009048,P012765,0.417,2,2,0
282,BAS,P010444,P011085,11.133,-5,18,23
282,BAS,P010444,P011948,4.5,5,11,6
282,BAS,P010444,P012765,3.333,-6,4,10
282,BAS,P011085,P011948,4.017,8,14,6
282,BAS,P011085,P012201,4.284,8,14,6
282,BAS,P011085,P012765,7.617,2,18,16
282,BAS,P011948,P012201,14.234,-6,32,38
282,BAS,P011948,P012765,9.7,-7,20,27
282,BAS,P012201,P012765,5.734,1,14,13
282,IST,P004888,P006372,0.417,-2,0,2
282,IST,P004888,P006590,5.167,-3,12,15
282,IST,P004888,P007200,26.551,27,75,48
282,IST,P004888,P009513,16.501,28,49,21
282,IST,P004888,P009664,3.334,-6,6,12
282,IST,P004888,P009846,5.117,-9,9,18
282,IST,P004888,P011078,10.951,-6,23,29
282,IST,P004888,P011981,12.517,15,36,21
282,IST,P004888,P012710,21.434,29,60,31
282,IST,P004888,P012788,3.017,-6,4,10
282,IST,P004888,PLHK,13.734,13,38,25
282,IST,P006372,P009513,0.417,-2,0,2
282,IST,P006372,P009664,0.417,-2,0,2
282,IST,P006372,P011078,0.417,-2,0,2
282,IST,P006590,P007200,4.25,3,13,10
282,IST,P006590,P009664,7.45,1,14,13
282,IST,P006590,P009846,12.784,-4,22,26
282,IST,P006590,P011078,13.784,-2,29,31
282,IST,P006590,P011981,9.033,1,19,18
282,IST,P006590,P012710,3.117,0,5,5
282,IST,P006590,P012788,6.351,-4,10,14
282,IST,P007200,P009513,16.084,30,49,19
282,IST,P007200,P009664,4.617,-4,8,12
282,IST,P007200,P009846,4.45,-3,10,13
282,IST,P007200,P011078,7.917,2,22,20
282,IST,P007200,P011981,12.867,17,35,18
282,IST,P007200,P012710,21.284,30,62,32
282,IST,P007200,P012788,1.65,-3,4,7
282,IST,P007200,PLHK,13.734,13,38,25
282,IST,P009513,P009664,0.417,-2,0,2
282,IST,P009513,P011078,0.417,-2,0,2
282,IST,P009513,P011981,5.267,13,17,4
282,IST,P009513,P012710,16.084,30,49,19
282,IST,P009513,PLHK,10.817,17,32,15
282,IST,P009664,P009846,10.1,-3,20,23
282,IST,P009664,P011078,6.434,-1,12,13
282,IST,P009664,P011981,5.233,1,7,6
282,IST,P009664,P012788,2.217,0,7,7
282,IST,P009664,PLHK,2.917,-4,6,10
282,IST,P009846,P011078,11.084,-4,20,24
282,IST,P009846,P011981,6.583,-1,10,11
282,IST,P009846,P012710,2.867,0,5,5
282,IST,P009846,P012788,6.101,-4,10,14
282,IST,P009846,PLHK,2.65,-4,6,10
282,IST,P011078,P011981,10.783,3,24,21
282,IST,P011078,P012710,8.217,-1,16,17
282,IST,P011078,P012788,8.001,-7,14,21
282,IST,P011078,PLHK,0.267,0,0,0
282,IST,P011981,P012710,8.717,15,24,9
282,IST,P012710,P012788,4.667,-4,7,11
282,IST,P012710,PLHK,10.817,17,32,15
283,PAM,P000556,P003960,2.283,-1,5,6
283,PAM,P000556,P004863,4.367,-5,8,13
283,PAM,P000556,P005356,8.099,1,18,17
283,PAM,P000556,P006433,6.566,4,16,12
283,PAM,P000556,P010393,8.716,0,19,19
283,PAM,P000556,P010568,2.867,-2,6,8
283,PAM,P000556,P012740,8.066,1,18,17
283,PAM,P000556,P012795,2.9,-2,6,8
283,PAM,P003960,P004863,17.35,5,37,32
283,PAM,P003960,P005356,7.749,-4,14,18
283,PAM,P003960,P006433,4.783,-8,8,16
283,PAM,P003960,P010393,4.366,-6,4,10
283,PAM,P003960,P010568,17.783,-1,36,37
283,PAM,P003960,P011982,17.583,2,40,38
283,PAM,P003960,P012740,6.383,-4,13,17
283,PAM,P003960,P012795,18.516,-3,39,42
283,PAM,P004863,P005356,6.483,-3,13,16
283,PAM,P004863,P010393,7.483,-12,7,19
283,PAM,P004863,P010568,16.067,0,30,30
283,PAM,P004863,P011982,11.8,10,28,18
283,PAM,P004863,P012740,4.433,-1,10,11
283,PAM,P004863,P012795,14.017,2,27,25
283,PAM,P005356,P006433,11.033,-3,22,25
283,PAM,P005356,P010393,9.033,1,21,20
283,PAM,P005356,P010568,5.266,0,11,11
283,PAM,P005356,P011982,11.483,-9,21,30
283,PAM,P005356,P012738,2.833,-5,4,9
283,PAM,P005356,P012740,13.883,-5,28,33
283,PAM,P005356,P012795,2.466,-5,4,9
283,PAM,P006433,P010393,9.817,1,24,23
283,PAM,P006433,P010568,2.85,-5,6,11
283,PAM,P006433,P011982,10.867,-16,20,36
283,PAM,P006433,P012738,2.833,-5,4,9
283,PAM,P006433,P012740,14.183,-4,30,34
283,PAM,P006433,P012795,6.8,-12,14,26
283,PAM,P010393,P010568,7.5,-12,8,20
283,PAM,P010393,P011982,4.284,-5,8,13
283,PAM,P010393,P012740,9.8,1,23,22
283,PAM,P010393,P012795,8.333,-12,10,22
283,PAM,P010568,P011982,13.75,1,30,29
283,PAM,P010568,P012795,17.717,-9,33,42
283,PAM,P011982,P012738,2.833,-5,4,9
283,PAM,P011982,P012740,10.55,-6,22,28
283,PAM,P011982,P012795,15.65,-4,35,39
283,PAM,P012738,P012740,2.433,-2,4,6
283,PAM,P012738,P012795,0.4,-3,0,3
283,PAM,P012740,P012795,4.733,0,12,12
283,TEL,P005145,P007990,3.233,0,7,7
283,TEL,P005145,P009622,7.917,4,16,12
283,TEL,P005145,P009783,10.617,8,24,16
283,TEL,P005145,P009863,9.501,11,24,13
283,TEL,P005145,P011193,4.817,7,15,8
283,TEL,P005145,P011199,8.334,7,19,12
283,TEL,P005145,P011214,4.4,4,12,8
283,TEL,P005145,P012744,2.117,3,7,4
283,TEL,P007990,P009622,1.85,3,7,4
283,TEL,P007990,P009783,5.516,-6,9,15
283,TEL,P007990,P011193,9.632,-3,20,23
283,TEL,P007990,P011199,2.916,-1,6,7
283,TEL,P007990,P011214,11.482,0,27,27
283,TEL,P007990,P011971,3.983,6,14,8
283,TEL,P007990,P012095,1.85,3,7,4
283,TEL,P007990,P012744,5.466,-2,11,13
283,TEL,P009622,P009783,24.883,11,56,45
283,TEL,P009622,P009863,25.833,10,58,48
283,TEL,P009622,P011199,23.75,15,58,43
283,TEL,P009622,P011214,3.933,-2,7,9
283,TEL,P009622,P011971,8.7,14,24,10
283,TEL,P009622,P012095,3.933,-2,7,9
283,TEL,P009622,P012744,9.933,-1,27,28
283,TEL,P009783,P009863,26.1,11,59,48
283,TEL,P009783,P011193,6.7,-6,12,18
283,TEL,P009783,P011199,24.183,18,61,43
283,TEL,P009783,P011214,8.366,-14,9,23
283,TEL,P009783,P011971,6.85,11,17,6
283,TEL,P009783,P012095,2.116,-5,0,5
283,TEL,P009783,P012744,11.133,-8,25,33
283,TEL,P009863,P011193,2.618,6,10,4
283,TEL,P009863,P011199,24.233,17,61,44
283,TEL,P009863,P011214,4.317,-3,7,10
283,TEL,P009863,P011971,7.117,13,19,6
283,TEL,P009863,P012095,2.149,-6,0,6
283,TEL,P009863,P012744,12.2,1,34,33
283,TEL,P011193,P011199,3.333,2,9,7
283,TEL,P011193,P011214,11.833,0,27,27
283,TEL,P011193,P011971,2.4,5,9,4
283,TEL,P011193,P012744,7.667,1,18,17
283,TEL,P011199,P011214,2.949,-2,6,8
283,TEL,P011199,P011971,6.85,11,17,6
283,TEL,P011199,P012095,0.066,-1,0,1
283,TEL,P011199,P012744,11.982,-2,31,33
283,TEL,P011214,P011971,4.25,8,16,8
283,TEL,P011214,P012095,3.966,-3,7,10
283,TEL,P011214,P012744,7.7,0,18,18
283,TEL,P011971,P012095,1.85,3,7,4
283,TEL,P011971,P012744,2.4,5,9,4
283,TEL,P012095,P012744,0.066,-1,0,1
284,OLY,P001255,P006589,0.917,2,4,2
284,OLY,P001255,P007853,2.783,-1,5,6
284,OLY,P001255,P007982,13.75,18,37,19
284,OLY,P001255,P008811,30.0,8,59,51
284,OLY,P001255,P008829,13.467,-9,17,26
284,OLY,P001255,P008855,29.083,6,55,49
284,OLY,P001255,P010392,10.0,18,28,10
284,OLY,P001255,P010612,20.0,-10,31,41
284,OLY,P006589,P007853,9.683,1,13,12
284,OLY,P006589,P007982,10.6,3,17,14
284,OLY,P006589,P008811,0.917,2,4,2
284,OLY,P006589,P010392,9.683,1,13,12
284,OLY,P006589,P010612,0.917,2,4,2
284,OLY,P006589,P012878,9.683,1,13,12
284,OLY,P007853,P007982,9.999,-3,15,18
284,OLY,P007853,P008811,2.783,-1,5,6
284,OLY,P007853,P008829,0.316,-4,2,6
284,OLY,P007853,P008855,2.783,-1,5,6
284,OLY,P007853,P010392,9.866,-5,13,18
284,OLY,P007853,P010612,2.916,1,7,6
284,OLY,P007853,P012878,9.999,-3,15,18
284,OLY,P007982,P008811,13.75,18,37,19
284,OLY,P007982,P008829,0.316,-4,2,6
284,OLY,P007982,P008855,12.833,16,33,17
284,OLY,P007982,P010392,19.866,13,41,28
284,OLY,P007982,P010612,3.883,2,11,9
284,OLY,P007982,P012878,9.999,-3,15,18
284,OLY,P008811,P008829,13.467,-9,17,26
284,OLY,P008811,P008855,29.083,6,55,49
284,OLY,P008811,P010392,10.0,18,28,10
284,OLY,P008811,P010612,20.0,-10,31,41
284,OLY,P008829,P008855,13.467,-9,17,26
284,OLY,P008829,P010392,0.183,-6,0,6
284,OLY,P008829,P010612,13.6,-7,19,26
284,OLY,P008829,P012878,0.316,-4,2,6
284,OLY,P008855,P010392,10.0,18,28,10
284,OLY,P008855,P010612,19.083,-12,27,39
284,OLY,P010392,P012878,9.866,-5,13,18
284,OLY,P010612,P012878,0.133,2,2,0
284,PAR,P003983,P004172,2.5,-3,2,5
284,PAR,P003983,P007400,3.117,-3,3,6
284,PAR,P003983,P009862,5.617,-6,5,11
284,PAR,P003983,P011050,1.25,-1,2,3
284,PAR,P003983,P011051,3.117,-3,3,6
284,PAR,P003983,P012096,2.5,-3,2,5
284,PAR,P003983,P012742,0.2,-2,0,2
284,PAR,P003983,P012743,4.167,-3,3,6
284,PAR,P004172,P007400,5.65,8,18,10
284,PAR,P004172,P009862,24.7,5,50,45
284,PAR,P004172,P011051,2.683,4,8,4
284,PAR,P004172,P012096,21.6,1,38,37
284,PAR,P004172,P012742,24.95,10,54,44
284,PAR,P004172,P012743,26.917,11,54,43
284,PAR,P007400,P007673,3.35,-9,2,11
284,PAR,P007400,P009862,13.2,-10,20,30
284,PAR,P007400,P011050,4.283,-1,5,6
284,PAR,P007400,P011051,9.433,-1,14,15
284,PAR,P007400,P012096,3.167,-11,0,11
284,PAR,P007400,P012742,10.533,4,23,19
284,PAR,P007400,P012743,10.267,-1,19,20
284,PAR,P007673,P009862,6.0,-9,7,16
284,PAR,P007673,P012096,5.817,-11,5,16
284,PAR,P007673,P012742,3.9,-2,7,9
284,PAR,P007673,P012743,4.933,-5,7,12
284,PAR,P009862,P011050,4.283,-1,5,6
284,PAR,P009862,P011051,6.883,-5,8,13
284,PAR,P009862,P012096,27.417,-10,43,53
284,PAR,P009862,P012742,29.933,2,58,56
284,PAR,P009862,P012743,31.767,-2,56,58
284,PAR,P011050,P011051,4.283,-1,5,6
284,PAR,P011050,P012742,3.033,0,3,3
284,PAR,P011051,P012742,6.316,2,11,9
284,PAR,P011051,P012743,5.017,0,7,7
284,PAR,P012096,P012742,23.017,-2,41,43
284,PAR,P012096,P012743,26.15,-4,43,47
284,PAR,P012742,P012743,28.05,12,59,47
285,MIL,P000796,P002849,18.199,-12,27,39
285,MIL,P000796,P006509,19.017,-12,27,39
285,MIL,P000796,P007032,5.499,0,11,11
285,MIL,P000796,P007201,2.5,2,6,4
285,MIL,P000796,P007831,22.8,-10,36,46
285,MIL,P000796,P009960,4.867,-2,10,12
285,MIL,P000796,P011205,7.416,-2,19,21
285,MIL,P000796,P011224,21.966,-12,36,48
285,MIL,P002812,P002849,3.8,1,9,8
285,MIL,P002812,P006509,1.983,1,6,5
285,MIL,P002812,P007032,1.817,0,3,3
285,MIL,P002812,P007831,3.8,1,9,8
285,MIL,P002812,P011205,2.75,-3,3,6
285,MIL,P002812,P011224,1.05,4,6,2
285,MIL,P002849,P006509,17.266,-7,25,32
285,MIL,P002849,P007032,9.166,-4,16,20
285,MIL,P002849,P007201,5.483,0,10,10
285,MIL,P002849,P007831,25.049,-11,41,52
285,MIL,P002849,P011205,11.599,-7,21,28
285,MIL,P002849,P011224,19.366,-4,35,39
285,MIL,P005670,P007032,1.617,-3,0,3
285,MIL,P005670,P007201,1.617,-3,0,3
285,MIL,P005670,P009960,1.617,-3,0,3
285,MIL,P005670,P011205,1.617,-3,0,3
285,MIL,P006509,P007032,0.6,-1,0,1
285,MIL,P006509,P007201,1.05,-1,0,1
285,MIL,P006509,P007831,21.45,-11,33,44
285,MIL,P006509,P009960,4.784,-5,8,13
285,MIL,P006509,P011205,2.85,-6,3,9
285,MIL,P006509,P011224,19.2,-6,30,36
285,MIL,P007032,P007201,12.683,-1,27,28
285,MIL,P007032,P007831,9.316,0,17,17
285,MIL,P007032,P009960,5.833,-1,13,14
285,MIL,P007032,P011205,17.499,-3,35,38
285,MIL,P007032,P011224,5.966,1,18,17
285,MIL,P007201,P007831,6.333,0,12,12
285,MIL,P007201,P009960,5.15,-3,11,14
285,MIL,P007201,P011205,13.133,-1,27,28
285,MIL,P007201,P011224,4.583,3,15,12
285,MIL,P007831,P009960,5.65,-2,12,14
285,MIL,P007831,P011205,12.616,-5,25,30
285,MIL,P007831,P011224,20.25,-6,35,41
285,MIL,P009960,P011205,6.7,-3,16,19
285,MIL,P009960,P011224,5.467,-1,14,15
285,MIL,P011205,P011224,7.016,1,23,22
285,ZAL,P002329,P002676,25.249,13,54,41
285,ZAL,P002329,P003210,1.75,-4,2,6
285,ZAL,P002329,P003211,0.683,3,3,0
285,ZAL,P002329,P005504,18.766,2,35,33
285,ZAL,P002329,P007513,17.75,2,25,23
285,ZAL,P002329,P010390,6.483,11,19,8
285,ZAL,P002329,P011218,24.799,13,54,41
285,ZAL,P002329,P012787,5.516,12,24,12
285,ZAL,P002676,P003210,5.884,-2,12,14
285,ZAL,P002676,P003211,1.8,1,3,2
285,ZAL,P002676,P005504,18.766,2,35,33
285,ZAL,P002676,P007513,19.334,1,28,27
285,ZAL,P002676,P010390,11.734,11,29,18
285,ZAL,P002676,P011218,24.799,13,54,41
285,ZAL,P002676,P012715,5.251,0,10,10
285,ZAL,P002676,P012787,9.183,13,31,18
285,ZAL,P003210,P003211,4.766,3,12,9
285,ZAL,P003210,P005504,1.75,-4,2,6
285,ZAL,P003210,P006860,0.6,1,1,0
285,ZAL,P003210,P007513,2.517,3,10,7
285,ZAL,P003210,P010184,0.6,1,1,0
285,ZAL,P003210,P010390,8.517,4,21,17
285,ZAL,P003210,P011218,1.75,-4,2,6
285,ZAL,P003210,P012715,8.517,4,21,17
285,ZAL,P003210,P012787,6.817,2,12,10
285,ZAL,P003211,P005504,0.233,3,3,0
285,ZAL,P003211,P006860,0.383,1,1,0
285,ZAL,P003211,P007513,6.533,-4,13,17
285,ZAL,P003211,P010184,0.383,1,1,0
285,ZAL,P003211,P010390,10.466,-2,22,24
285,ZAL,P003211,P011218,3.366,1,10,9
285,ZAL,P003211,P012715,10.016,-2,22,24
285,ZAL,P003211,P012787,5.699,3,14,11
285,ZAL,P005504,P007513,14.55,0,20,20
285,ZAL,P005504,P011218,18.766,2,35,33
285,ZAL,P005504,P012787,2.233,3,10,7
285,ZAL,P006860,P007513,0.6,1,1,0
285,ZAL,P006860,P010184,0.6,1,1,0
285,ZAL,P006860,P012787,0.217,0,0,0
285,ZAL,P007513,P010184,0.6,1,1,0
285,ZAL,P007513,P010390,9.367,-2,20,22
285,ZAL,P007513,P011218,19.05,-2,27,29
285,ZAL,P007513,P012715,6.167,-4,15,19
285,ZAL,P007513,P012787,1.6,0,4,4
285,ZAL,P010184,P012787,0.217,0,0,0
285,ZAL,P010390,P011218,9.166,9,26,17
285,ZAL,P010390,P012715,14.15,0,32,32
285,ZAL,P010390,P012787,12.649,13,35,22
285,ZAL,P011218,P012715,3.133,-2,7,9
285,ZAL,P011218,P012787,6.899,14,29,15
285,ZAL,P012715,P012787,9.366,4,21,17
286,BER,P006251,P006819,6.917,-22,6,28
286,BER,P006251,P006919,16.401,-29,23,52
286,BER,P006251,P007025,6.267,-8,7,15
286,BER,P006251,P007550,4.384,-11,4,15
286,BER,P006251,P008211,3.75,-5,5,10
286,BER,P006251,P008780,11.033,-13,19,32
286,BER,P006251,P008967,10.233,-11,19,30
286,BER,P006251,P010791,8.684,-5,17,22
286,BER,P006251,P012720,6.233,-12,7,19
286,BER,P006251,P012721,2.766,0,5,5
286,BER,P006819,P006919,6.917,-22,6,28
286,BER,P006819,P007025,4.784,-4,10,14
286,BER,P006819,P007550,4.301,-6,9,15
286,BER,P006819,P008211,5.585,-8,7,15
286,BER,P006819,P008780,3.883,-10,4,14
286,BER,P006819,P008967,6.917,-13,11,24
286,BER,P006819,P012720,5.668,-12,7,19
286,BER,P006819,P012721,5.768,-3,12,15
286,BER,P006919,P007025,6.034,-9,8,17
286,BER,P006919,P007550,4.384,-11,4,15
286,BER,P006919,P008211,2.167,-6,2,8
286,BER,P006919,P008780,13.417,-7,29,36
286,BER,P006919,P008967,11.267,-5,25,30
286,BER,P006919,P010791,12.251,0,29,29
286,BER,P006919,P012720,4.817,-12,6,18
286,BER,P006919,P012721,2.217,5,8,3
286,BER,P007025,P007550,6.234,-8,11,19
286,BER,P007025,P008211,8.567,-1,12,13
286,BER,P007025,P008780,4.067,2,8,6
286,BER,P007025,P008967,2.35,-1,7,8
286,BER,P007025,P010791,9.784,-6,14,20
286,BER,P007025,P012720,8.8,-7,12,19
286,BER,P007025,P012721,10.917,-2,19,21
286,BER,P007550,P008211,1.601,-4,2,6
286,BER,P007550,P008967,4.517,-2,10,12
286,BER,P007550,P010791,5.784,-11,7,18
286,BER,P007550,P012720,3.434,-9,5,14
286,BER,P007550,P012721,5.701,-6,12,18
286,BER,P008211,P008780,1.917,4,4,0
286,BER,P008211,P008967,1.101,0,2,2
286,BER,P008211,P010791,5.851,-4,8,12
286,BER,P008211,P012720,10.685,-15,14,29
286,BER,P008211,P012721,10.852,-5,16,21
286,BER,P008780,P008967,16.35,-9,32,41
286,BER,P008780,P010791,14.551,6,34,28
286,BER,P008780,P012720,7.233,-6,11,17
286,BER,P008780,P012721,9.217,5,19,14
286,BER,P008967,P010791,13.451,3,31,28
286,BER,P008967,P012720,7.517,-5,12,17
286,BER,P008967,P012721,12.501,-1,27,28
286,BER,P010791,P012720,10.934,-12,16,28
286,BER,P010791,P012721,13.718,-3,24,27
286,BER,P012720,P012721,15.351,-14,22,36
286,ULK,P001932,P002968,11.983,7,28,21
286,ULK,P001932,P006661,3.733,-2,5,7
286,ULK,P001932,P006961,2.35,0,5,5
286,ULK,P001932,P008962,17.633,14,47,33
286,ULK,P001932,P009849,15.883,15,45,30
286,ULK,P001932,P010560,17.266,13,45,32
286,ULK,P001932,P011157,7.633,6,22,16
286,ULK,P001932,P011980,1.983,-1,3,4
286,ULK,P002968,P006661,3.333,-1,7,8
286,ULK,P002968,P006961,1.35,0,4,4
286,ULK,P002968,P008962,10.0,8,25,17
286,ULK,P002968,P009849,10.0,8,25,17
286,ULK,P002968,P010560,11.983,7,28,21
286,ULK,P002968,P011052,1.35,0,4,4
286,ULK,P002968,P011980,3.333,-1,7,8
286,ULK,P005844,P006661,9.3,10,20,10
286,ULK,P005844,P006961,6.5,5,13,8
286,ULK,P005844,P008962,11.133,15,30,15
286,ULK,P005844,P011052,9.75,6,23,17
286,ULK,P005844,P011201,6.667,4,17,13
286,ULK,P005844,P011980,7.65,4,17,13
286,ULK,P006661,P006961,14.8,18,37,19
286,ULK,P006661,P008962,11.017,21,32,11
286,ULK,P006661,P010560,1.983,-1,3,4
286,ULK,P006661,P011052,13.934,16,36,20
286,ULK,P006661,P011157,8.034,10,21,11
286,ULK,P006661,P011201,3.884,2,8,6
286,ULK,P006661,P011980,12.65,3,23,20
286,ULK,P006961,P008962,8.4,19,28,9
286,ULK,P006961,P009849,0.6,1,3,2
286,ULK,P006961,P011052,13.467,17,35,18
286,ULK,P006961,P011157,7.967,12,23,11
286,ULK,P006961,P011201,0.417,-2,0,2
286,ULK,P006961,P011980,7.417,-2,12,14
286,ULK,P008962,P009849,15.883,15,45,30
286,ULK,P008962,P010560,15.283,14,42,28
286,ULK,P008962,P011052,9.3,20,33,13
286,ULK,P008962,P011157,8.8,16,32,16
286,ULK,P008962,P011201,6.25,6,17,11
286,ULK,P008962,P011980,6.033,8,17,9
286,ULK,P009849,P010560,15.283,14,42,28
286,ULK,P009849,P011157,5.883,7,20,13
286,ULK,P010560,P011157,5.283,6,17,11
286,ULK,P010560,P011980,1.983,-1,3,4
286,ULK,P011052,P011157,6.284,11,19,8
286,ULK,P011052,P011201,4.334,-2,11,13
286,ULK,P011052,P011980,11.117,0,23,23
286,ULK,P011157,P011201,0.667,-1,1,2
286,ULK,P011157,P011980,5.117,1,9,8
286,ULK,P011201,P011980,7.117,5,18,13
287,MAD,P001392,P003108,2.7,0,9,9
287,MAD,P001392,P003733,5.55,-7,9,16
287,MAD,P001392,P005791,1.183,-2,0,2
287,MAD,P001392,P009213,4.367,-5,9,14
287,MAD,P001392,P010357,2.85,-7,0,7
287,MAD,P001392,P010623,2.7,0,9,9
287,MAD,P001392,PTGB,2.85,-7,0,7
287,MAD,P003108,P003733,2.7,0,9,9
287,MAD,P003108,P005791,12.467,16,42,26
287,MAD,P003108,P006540,14.466,21,50,29
287,MAD,P003108,P009213,7.716,-1,21,22
287,MAD,P003108,P010357,21.7,23,68,45
287,MAD,P003108,P010623,2.7,0,9,9
287,MAD,P003108,PBMT,17.084,8,44,36
287,MAD,P003108,PCVM,12.417,0,27,27
287,MAD,P003108,PTGB,11.05,21,41,20
287,MAD,P003733,P005791,1.183,-2,0,2
287,MAD,P003733,P009213,4.367,-5,9,14
287,MAD,P003733,P010357,2.85,-7,0,7
287,MAD,P003733,P010623,2.7,0,9,9
287,MAD,P003733,PTGB,2.85,-7,0,7
287,MAD,P005791,P006540,17.333,2,45,43
287,MAD,P005791,P009213,5.733,1,11,10
287,MAD,P005791,P010357,16.967,6,49,43
287,MAD,P005791,P010623,5.733,1,11,10
287,MAD,P005791,P011649,8.883,-6,16,22
287,MAD,P005791,PBMT,9.901,3,26,23
287,MAD,P005791,PCVM,2.367,-3,3,6
287,MAD,P005791,PTGB,16.45,8,49,41
287,MAD,P006540,P009213,7.699,5,20,15
287,MAD,P006540,P010357,17.783,13,57,44
287,MAD,P006540,P010623,5.733,1,11,10
287,MAD,P006540,P011649,8.883,-6,16,22
287,MAD,P006540,PBMT,10.017,5,28,23
287,MAD,P006540,PCVM,8.85,7,24,17
287,MAD,P006540,PTGB,10.7,4,33,29
287,MAD,P009213,P010357,6.683,-6,12,18
287,MAD,P009213,P010623,8.433,1,20,19
287,MAD,P009213,P011649,5.733,1,11,10
287,MAD,P009213,PBMT,3.133,-4,6,10
287,MAD,P009213,PCVM,4.933,-2,9,11
287,MAD,P009213,PTGB,1.667,-5,0,5
287,MAD,P010357,P011649,3.15,-7,5,12
287,MAD,P010357,PBMT,17.251,7,46,39
287,MAD,P010357,PCVM,10.567,1,24,23
287,MAD,P010357,PTGB,19.067,5,51,46
287,MAD,P010623,P011649,5.733,1,11,10
287,MAD,P011649,PTGB,3.15,-7,5,12
287,MAD,PBMT,PCVM,10.534,-3,21,24
287,MAD,PBMT,PTGB,8.484,8,25,17
287,RED,P000848,P002553,10.451,4,27,23
287,RED,P000848,P004720,0.533,-2,0,2
287,RED,P000848,P005099,22.166,5,53,48
287,RED,P000848,P006436,14.033,-1,38,39
287,RED,P000848,P007960,13.65,-2,34,36
287,RED,P000848,P008966,5.016,-4,11,15
287,RED,P000848,P009035,16.55,-5,36,41
287,RED,P000848,P011941,11.383,11,32,21
287,RED,P000848,P011964,11.383,0,28,28
287,RED,P000848,P012801,10.1,-9,26,35
287,RED,P000848,PLUO,12.267,-1,27,28
287,RED,P002553,P005099,6.5,2,12,10
287,RED,P002553,P006436,3.4,-5,9,14
287,RED,P002553,P007960,7.55,3,22,19
287,RED,P002553,P009035,2.6,-5,3,8
287,RED,P002553,P011941,6.484,2,15,13
287,RED,P002553,P012801,5.317,-7,15,22
287,RED,P002553,PLUO,4.034,-6,5,11
287,RED,P004720,P005099,4.05,4,13,9
287,RED,P004720,P006436,0.2,0,0,0
287,RED,P004720,P007960,2.583,-2,4,6
287,RED,P004720,P008966,0.533,-2,0,2
287,RED,P004720,P009035,0.2,0,0,0
287,RED,P004720,P011941,4.05,4,13,9
287,RED,P004720,P011964,2.2,4,9,5
287,RED,P004720,P012801,4.783,2,13,11
287,RED,P005099,P006436,13.516,-10,29,39
287,RED,P005099,P007960,10.416,6,25,19
287,RED,P005099,P008966,2.499,-6,4,10
287,RED,P005099,P009035,19.583,-13,39,52
287,RED,P005099,P011941,9.883,17,29,12
287,RED,P005099,P011964,14.2,4,37,33
287,RED,P005099,P012801,7.399,-4,17,21
287,RED,P005099,PLUO,10.116,-9,18,27
287,RED,P006436,P007960,2.7,0,9,9
287,RED,P006436,P008966,0.383,-3,1,4
287,RED,P006436,P009035,10.8,-9,21,30
287,RED,P006436,P011941,2.3,4,7,3
287,RED,P006436,P011964,12.0,0,28,28
287,RED,P006436,P012801,3.7,-3,10,13
287,RED,P006436,PLUO,0.9,-5,0,5
287,RED,P007960,P008966,1.3,-6,0,6
287,RED,P007960,P009035,5.233,-1,12,13
287,RED,P007960,P011941,6.9,3,17,14
287,RED,P007960,P012801,7.6,-12,17,29
287,RED,P007960,PLUO,5.8,-5,12,17
287,RED,P008966,P009035,1.883,-3,3,6
287,RED,P008966,P011941,3.566,5,10,5
287,RED,P008966,P012801,7.132,-7,14,21
287,RED,P008966,PLUO,6.216,-2,13,15
287,RED,P009035,P011964,10.067,-4,21,25
287,RED,P009035,P012801,2.7,-3,3,6
287,RED,P009035,PLUO,9.516,-9,18,27
287,RED,P011941,P011964,4.133,8,16,8
287,RED,P011941,P012801,10.433,2,29,27
287,RED,P011941,PLUO,5.0,4,12,8
287,RED,P011964,P012801,2.817,4,9,5
287,RED,P012801,PLUO,7.283,-3,15,18
288,PAN,P001926,P002328,12.084,9,29,20
288,PAN,P001926,P003842,27.234,7,61,54
288,PAN,P001926,P005161,3.867,5,11,6
288,PAN,P001926,P007866,25.483,10,59,49
288,PAN,P001926,P011204,19.016,7,44,37
288,PAN,P001926,P011221,4.7,7,12,5
288,PAN,P001926,P012712,6.834,4,14,10
288,PAN,P001926,P012774,30.05,7,62,55
288,PAN,P002328,P003842,12.601,4,29,25
288,PAN,P002328,P007866,12.067,7,29,22
288,PAN,P002328,P011204,6.0,4,15,11
288,PAN,P002328,P011221,2.45,2,4,2
288,PAN,P002328,P012712,3.367,-1,4,5
288,PAN,P002328,P012774,13.167,-1,22,23
288,PAN,P003842,P005161,7.167,1,15,14
288,PAN,P003842,P007866,27.067,1,55,54
288,PAN,P003842,P011204,23.4,-6,44,50
288,PAN,P003842,P011209,1.533,-5,0,5
288,PAN,P003842,P012712,7.517,-4,14,18
288,PAN,P003842,P012774,31.817,-10,58,68
288,PAN,P005161,P007866,2.0,3,6,3
288,PAN,P005161,P011204,3.3,-4,4,8
288,PAN,P005161,P011209,0.5,0,0,0
288,PAN,P005161,P012712,5.167,-2,9,11
288,PAN,P005161,P012774,6.667,1,15,14
288,PAN,P007866,P011204,22.799,-4,43,47
288,PAN,P007866,P011209,1.533,-5,0,5
288,PAN,P007866,P011221,2.916,1,8,7
288,PAN,P007866,P012774,27.599,-5,52,57
288,PAN,P011204,P011209,1.533,-5,0,5
288,PAN,P011204,P011221,2.916,1,8,7
288,PAN,P011204,P012712,3.9,-1,9,10
288,PAN,P011204,P012774,23.932,-12,41,53
288,PAN,P011209,P012774,1.033,-5,0,5
288,PAN,P011221,P012712,2.117,4,4,0
288,PAN,P011221,P012774,5.033,5,12,7
288,PAN,P012712,P012774,9.634,0,18,18
288,VIR,P001133,P001844,6.499,0,12,12
288,VIR,P001133,P003048,19.3,-2,41,43
288,VIR,P001133,P003527,0.95,-3,2,5
288,VIR,P001133,P004007,23.366,-3,44,47
288,VIR,P001133,P004554,3.333,0,7,7
288,VIR,P001133,P006739,22.35,-3,46,49
288,VIR,P001133,P008847,6.433,-2,10,12
288,VIR,P001133,P010781,11.95,0,25,25
288,VIR,P001133,PBCN,22.683,-3,45,48
288,VIR,P001844,P002084,5.25,-7,8,15
288,VIR,P001844,P003048,0.683,0,2,2
288,VIR,P001844,P003527,4.517,-7,6,13
288,VIR,P001844,P004007,7.849,0,14,14
288,VIR,P001844,P004554,5.867,-7,8,15
288,VIR,P001844,P008847,6.283,0,10,10
288,VIR,P001844,P010781,10.8,-6,16,22
288,VIR,P001844,PBCN,1.716,-1,4,5
288,VIR,P002084,P003048,0.3,0,0,0
288,VIR,P002084,P003527,7.467,-3,14,17
288,VIR,P002084,P004007,0.883,0,2,2
288,VIR,P002084,P004554,8.05,-3,16,19
288,VIR,P002084,P006739,3.1,4,8,4
288,VIR,P002084,P010781,8.35,-3,16,19
288,VIR,P003048,P003527,1.1,-3,2,5
288,VIR,P003048,P004007,16.933,-1,34,35
288,VIR,P003048,P006739,18.55,-1,39,40
288,VIR,P003048,P010781,3.984,-1,10,11
288,VIR,P003048,PBCN,17.55,0,36,36
288,VIR,P003527,P004554,7.167,-3,14,17
288,VIR,P003527,P006739,3.9,1,10,9
288,VIR,P003527,P010781,8.417,-6,16,22
288,VIR,P003527,PBCN,0.15,0,0,0
288,VIR,P004007,P004554,1.5,0,2,2
288,VIR,P004007,P006739,16.65,-2,32,34
288,VIR,P004007,P008847,7.05,-2,10,12
288,VIR,P004007,P010781,7.6,1,13,12
288,VIR,P004007,PBCN,17.633,-5,33,38
288,VIR,P004554,P006739,7.95,9,20,11
288,VIR,P004554,P008847,2.434,5,5,0
288,VIR,P004554,P010781,13.817,2,28,26
288,VIR,P004554,PBCN,5.15,5,12,7
288,VIR,P006739,P008847,2.584,3,5,2
288,VIR,P006739,P010781,11.567,9,30,21
288,VIR,P006739,PBCN,22.417,4,46,42
288,VIR,P008847,P010781,7.217,6,13,7
288,VIR,P008847,PBCN,3.467,2,7,5
288,VIR,P010781,PBCN,7.234,6,17,11
289,BER,P003958,P007025,6.584,-5,12,17
289,BER,P003958,P007550,7.75,-5,12,17
289,BER,P003958,P008211,3.367,3,10,7
289,BER,P003958,P008780,19.217,9,57,48
289,BER,P003958,P008967,20.95,7,59,52
289,BER,P003958,P010791,8.783,-8,14,22
289,BER,P003958,P011934,16.267,10,48,38
289,BER,P003958,P012720,20.733,0,52,52
289,BER,P003958,P012721,4.217,5,12,7
289,BER,P006251,P007025,2.533,-2,5,7
289,BER,P006251,P007550,2.15,-2,5,7
289,BER,P006251,P008211,7.284,-11,7,18
289,BER,P006251,P008780,7.434,-9,6,15
289,BER,P006251,P008967,6.034,-13,4,17
289,BER,P006251,P010791,2.533,-2,5,7
289,BER,P006251,P011934,8.751,-13,9,22
289,BER,P006251,P012720,5.25,-2,10,12
289,BER,P006251,P012721,3.167,-6,5,11
289,BER,P007025,P007550,8.8,-5,12,17
289,BER,P007025,P008211,2.267,5,5,0
289,BER,P007025,P008780,2.067,-2,5,7
289,BER,P007025,P008967,0.567,-2,2,4
289,BER,P007025,P010791,9.783,-10,10,20
289,BER,P007025,P012720,8.6,-12,12,24
289,BER,P007025,P012721,2.267,5,5,0
289,BER,P007550,P008211,5.117,3,10,7
289,BER,P007550,P008967,2.85,-2,5,7
289,BER,P007550,P010791,8.283,-10,7,17
289,BER,P007550,P011934,2.017,-1,5,6
289,BER,P007550,P012720,6.533,-10,7,17
289,BER,P007550,P012721,3.1,4,5,1
289,BER,P008211,P008780,5.584,-7,4,11
289,BER,P008211,P008967,7.417,-13,7,20
289,BER,P008211,P010791,1.75,0,0,0
289,BER,P008211,P011934,9.301,-12,12,24
289,BER,P008211,P012720,2.717,0,5,5
289,BER,P008211,P012721,4.8,0,8,8
289,BER,P008780,P008967,23.784,0,58,58
289,BER,P008780,P010791,4.783,0,12,12
289,BER,P008780,P011934,21.301,2,49,47
289,BER,P008780,P012720,18.1,8,52,44
289,BER,P008780,P012721,4.334,-1,9,10
289,BER,P008967,P010791,3.283,0,9,9
289,BER,P008967,P011934,22.301,-3,52,55
289,BER,P008967,P012720,15.233,8,47,39
289,BER,P008967,P012721,5.517,-6,9,15
289,BER,P010791,P012720,9.516,-11,14,25
289,BER,P010791,P012721,3.55,1,5,4
289,BER,P011934,P012720,15.9,11,46,35
289,BER,P011934,P012721,4.234,-6,7,13
289,BER,P012720,P012721,1.35,0,3,3
289,PAR,P000956,P007400,9.133,0,19,19
289,PAR,P000956,P008987,5.116,4,13,9
289,PAR,P000956,P009862,2.85,2,7,5
289,PAR,P000956,P011051,6.9,-1,13,14
289,PAR,P000956,P012096,6.25,-3,12,15
289,PAR,P000956,P012742,6.283,-2,12,14
289,PAR,P003983,P007400,15.884,8,37,29
289,PAR,P003983,P008987,10.284,2,22,20
289,PAR,P003983,P009862,12.534,5,32,27
289,PAR,P003983,P011050,3.35,3,5,2
289,PAR,P003983,P012096,9.917,8,26,18
289,PAR,P003983,P012742,3.917,5,9,4
289,PAR,P003983,P012743,7.65,1,17,16
289,PAR,P007400,P008987,23.283,8,58,50
289,PAR,P007400,P009862,23.267,9,62,53
289,PAR,P007400,P011050,7.3,6,17,11
289,PAR,P007400,P011051,6.9,-1,13,14
289,PAR,P007400,P012096,16.167,5,38,33
289,PAR,P007400,P012742,18.083,5,44,39
289,PAR,P007400,P012743,11.583,0,28,28
289,PAR,P008987,P009862,24.15,3,61,58
289,PAR,P008987,P011050,7.3,6,17,11
289,PAR,P008987,P011051,9.983,4,22,18
289,PAR,P008987,P012096,6.55,3,17,14
289,PAR,P008987,P012742,21.783,11,54,43
289,PAR,P008987,P012743,13.083,-5,28,33
289,PAR,P009862,P011050,3.95,3,12,9
289,PAR,P009862,P011051,7.717,2,16,14
289,PAR,P009862,P012096,12.767,10,33,23
289,PAR,P009862,P012742,15.55,5,42,37
289,PAR,P009862,P012743,18.683,1,43,42
289,PAR,P011050,P012742,7.3,6,17,11
289,PAR,P011051,P012096,4.017,-4,6,10
289,PAR,P011051,P012742,13.383,-1,27,28
289,PAR,P011051,P012743,7.1,1,15,14
289,PAR,P012096,P012742,3.4,-5,5,10
289,PAR,P012096,P012743,5.6,6,15,9
289,PAR,P012742,P012743,11.033,0,26,26
290,MCO,P005985,P008099,11.967,4,16,12
290,MCO,P005985,P009754,10.75,7,24,17
290,MCO,P005985,P010588,26.084,3,43,40
290,MCO,P005985,P011196,7.783,-2,12,14
290,MCO,P005985,P011212,14.234,6,27,21
290,MCO,P005985,P011226,15.018,-5,25,30
290,MCO,P005985,P011231,16.284,3,29,26
290,MCO,P005985,PLCZ,19.484,16,36,20
290,MCO,P008099,P010588,12.467,4,16,12
290,MCO,P008099,P011212,0.5,0,0,0
290,MCO,P008099,P011226,3.05,0,2,2
290,MCO,P008099,P011231,9.417,4,14,10
290,MCO,P008099,PLCZ,12.467,4,16,12
290,MCO,P009754,P010588,8.2,-1,16,17
290,MCO,P009754,P011196,11.233,3,24,21
290,MCO,P009754,P011212,15.65,4,30,26
290,MCO,P009754,P011226,13.884,-7,26,33
290,MCO,P009754,P011231,13.4,-6,26,32
290,MCO,P009754,PLCZ,6.283,8,14,6
290,MCO,P010588,P011196,4.333,-7,2,9
290,MCO,P010588,P011212,12.184,-2,19,21
290,MCO,P010588,P011226,16.868,-8,27,35
290,MCO,P010588,P011231,13.701,-5,21,26
290,MCO,P010588,PLCZ,19.567,16,36,20
290,MCO,P011196,P011212,14.733,-4,26,30
290,MCO,P011196,P011226,10.45,-9,16,25
290,MCO,P011196,P011231,10.4,3,24,21
290,MCO,P011212,P011226,17.868,-8,29,37
290,MCO,P011212,P011231,14.667,0,31,31
290,MCO,P011212,PLCZ,5.5,8,10,2
290,MCO,P011226,P011231,11.617,-11,21,32
290,MCO,P011226,PLCZ,9.717,8,18,10
290,MCO,P011231,PLCZ,10.25,4,14,10
290,ZAL,P002329,P002676,9.716,-3,16,19
290,ZAL,P002329,P003210,11.967,3,23,20
290,ZAL,P002329,P003211,5.167,-2,7,9
290,ZAL,P002329,P005504,2.7,-5,2,7
290,ZAL,P002329,P006860,0.5,0,0,0
290,ZAL,P002329,P007109,6.217,3,16,13
290,ZAL,P002329,P007513,19.3,3,32,29
290,ZAL,P002329,P010390,18.567,4,30,26
290,ZAL,P002329,P011218,26.45,-1,43,44
290,ZAL,P002329,P012715,18.951,1,38,37
290,ZAL,P002329,P012787,16.201,-3,29,32
290,ZAL,P002676,P005504,2.7,-5,2,7
290,ZAL,P002676,P007513,7.233,-5,8,13
290,ZAL,P002676,P010390,4.533,0,6,6
290,ZAL,P002676,P011218,10.666,-3,18,21
290,ZAL,P002676,P012715,4.383,2,12,10
290,ZAL,P002676,P012787,3.433,2,10,8
290,ZAL,P003210,P003211,2.933,3,7,4
290,ZAL,P003210,P007109,6.5,3,16,13
290,ZAL,P003210,P007513,6.6,4,11,7
290,ZAL,P003210,P010390,6.6,4,11,7
290,ZAL,P003210,P011218,7.867,3,12,9
290,ZAL,P003210,P012715,7.234,2,15,13
290,ZAL,P003210,P012787,7.767,2,17,15
290,ZAL,P003211,P007109,2.933,3,7,4
290,ZAL,P003211,P007513,0.683,-2,0,2
290,ZAL,P003211,P010390,2.483,-4,0,4
290,ZAL,P003211,P011218,2.466,-5,0,5
290,ZAL,P003211,P012715,4.016,-7,0,7
290,ZAL,P003211,P012787,5.983,-2,7,9
290,ZAL,P005504,P007513,2.7,-5,2,7
290,ZAL,P005504,P011218,2.7,-5,2,7
290,ZAL,P006860,P011218,0.5,0,0,0
290,ZAL,P006860,P012715,0.5,0,0,0
290,ZAL,P006860,P012787,0.5,0,0,0
290,ZAL,P007109,P007513,1.5,-4,0,4
290,ZAL,P007109,P011218,1.5,-4,0,4
290,ZAL,P007109,P012715,5.35,-4,9,13
290,ZAL,P007109,P012787,8.0,-1,16,17
290,ZAL,P007513,P010390,20.35,9,37,28
290,ZAL,P007513,P011218,24.55,0,39,39
290,ZAL,P007513,P012715,12.217,4,25,21
290,ZAL,P007513,P012787,3.067,-4,2,6
290,ZAL,P010390,P011218,21.583,7,37,30
290,ZAL,P010390,P012715,13.217,4,25,21
290,ZAL,P010390,P012787,4.067,-4,2,6
290,ZAL,P011218,P012715,19.9,0,36,36
290,ZAL,P011218,P012787,10.75,-8,13,21
290,ZAL,P012715,P012787,14.3,-10,20,30
291,OLY,P001255,P007853,0.117,0,0,0
291,OLY,P001255,P007982,11.217,11,37,26
291,OLY,P001255,P008811,20.0,5,44,39
291,OLY,P001255,P008829,15.233,6,33,27
291,OLY,P001255,P008855,27.833,1,59,58
291,OLY,P001255,P010392,8.383,4,19,15
291,OLY,P001255,P010612,14.85,4,31,27
291,OLY,P001255,P011965,12.467,1,31,30
291,OLY,P001255,P012878,9.9,4,26,22
291,OLY,P006589,P007853,10.001,-6,19,25
291,OLY,P006589,P007982,6.167,-2,12,14
291,OLY,P006589,P008811,2.217,-3,3,6
291,OLY,P006589,P008829,1.117,1,4,3
291,OLY,P006589,P008855,3.834,-4,7,11
291,OLY,P006589,P010392,4.367,-2,7,9
291,OLY,P006589,P011983,5.634,-4,12,16
291,OLY,P006589,P012878,6.667,-4,12,16
291,OLY,P007853,P007982,6.167,-2,12,14
291,OLY,P007853,P008811,2.217,-3,3,6
291,OLY,P007853,P008829,1.117,1,4,3
291,OLY,P007853,P008855,3.951,-4,7,11
291,OLY,P007853,P010392,4.367,-2,7,9
291,OLY,P007853,P011965,0.117,0,0,0
291,OLY,P007853,P011983,5.634,-4,12,16
291,OLY,P007853,P012878,6.784,-4,12,16
291,OLY,P007982,P008811,4.567,10,17,7
291,OLY,P007982,P008829,2.267,8,11,3
291,OLY,P007982,P008855,9.05,3,26,23
291,OLY,P007982,P010392,6.534,6,18,12
291,OLY,P007982,P010612,2.4,2,6,4
291,OLY,P007982,P011965,6.65,1,20,19
291,OLY,P007982,P011983,1.8,0,5,5
291,OLY,P007982,P012878,12.717,-1,32,33
291,OLY,P008811,P008829,15.133,6,33,27
291,OLY,P008811,P008855,20.05,-6,36,42
291,OLY,P008811,P010392,5.15,1,13,12
291,OLY,P008811,P010612,14.85,4,31,27
291,OLY,P008811,P011965,2.467,-3,5,8
291,OLY,P008811,P011983,2.217,-3,3,6
291,OLY,P008829,P008855,14.183,-1,26,27
291,OLY,P008829,P010392,5.15,1,13,12
291,OLY,P008829,P010612,9.983,5,20,15
291,OLY,P008829,P011965,0.1,0,0,0
291,OLY,P008829,P011983,1.117,1,4,3
291,OLY,P008855,P010392,6.216,-4,8,12
291,OLY,P008855,P010612,14.85,4,31,27
291,OLY,P008855,P011965,12.467,1,31,30
291,OLY,P008855,P011983,3.834,-4,7,11
291,OLY,P008855,P012878,10.4,2,26,24
291,OLY,P010392,P011965,3.233,3,6,3
291,OLY,P010392,P012878,7.6,1,13,12
291,OLY,P010612,P011965,2.467,-3,5,8
291,OLY,P011965,P012878,9.9,4,26,22
291,OLY,P011983,P012878,2.3,-2,5,7
291,RED,P000848,P002553,8.517,4,20,16
291,RED,P000848,P005099,25.5,-9,52,61
291,RED,P000848,P006436,19.534,9,52,43
291,RED,P000848,P007960,5.95,-8,8,16
291,RED,P000848,P009035,24.417,-5,52,57
291,RED,P000848,P011941,1.5,-2,3,5
291,RED,P000848,P011964,14.0,-3,27,30
291,RED,P000848,PJDR,13.717,0,32,32
291,RED,P000848,PLUO,3.733,-6,2,8
291,RED,P002553,P005099,5.5,-2,10,12
291,RED,P002553,P006436,14.251,-2,32,34
291,RED,P002553,P007960,0.683,0,0,0
291,RED,P002553,P009035,9.184,0,22,22
291,RED,P002553,P011941,2.45,-4,3,7
291,RED,P002553,P011964,2.617,2,7,5
291,RED,P002553,P012044,5.717,-4,12,16
291,RED,P002553,PJDR,10.817,-2,22,24
291,RED,P005099,P006436,18.717,11,52,41
291,RED,P005099,P007960,6.567,-5,11,16
291,RED,P005099,P009035,24.017,-3,52,55
291,RED,P005099,P011941,2.2,-4,3,7
291,RED,P005099,P011964,16.7,0,34,34
291,RED,P005099,PJDR,14.017,0,32,32
291,RED,P005099,PLUO,4.85,-8,2,10
291,RED,P006436,P007960,0.617,3,3,0
291,RED,P006436,P009035,24.134,15,66,51
291,RED,P006436,P011941,2.45,-4,3,7
291,RED,P006436,P011964,12.033,11,31,20
291,RED,P006436,P012044,6.767,-2,14,16
291,RED,P006436,PJDR,18.301,11,51,40
291,RED,P007960,P009035,5.884,-5,11,16
291,RED,P007960,P011964,0.867,-1,3,4
291,RED,P007960,PJDR,5.7,-4,8,12
291,RED,P009035,P011964,15.133,0,29,29
291,RED,P009035,P012044,6.517,-2,14,16
291,RED,P009035,PJDR,22.868,4,56,52
291,RED,P009035,PLUO,4.85,-8,2,10
291,RED,P011941,P012044,0.25,0,0,0
291,RED,P011941,PJDR,0.95,-2,0,2
291,RED,P011964,P012044,1.05,2,2,0
291,RED,P011964,PJDR,3.75,5,9,4
291,RED,P011964,PLUO,4.85,-8,2,10
291,RED,P012044,PJDR,6.767,-2,14,16
291,RED,PJDR,PLUO,1.117,-2,0,2
292,BAR,P000925,P002939,23.001,16,53,37
292,BAR,P000925,P003478,13.517,5,35,30
292,BAR,P000925,P004866,15.584,5,29,24
292,BAR,P000925,P006435,22.333,18,58,40
292,BAR,P000925,P007519,1.4,-3,2,5
292,BAR,P000925,P011244,9.767,9,23,14
292,BAR,P000925,P012745,16.083,5,39,34
292,BAR,P000925,PLFW,3.783,-3,9,12
292,BAR,P002939,P003196,2.983,-5,7,12
292,BAR,P002939,P003478,14.284,6,34,28
292,BAR,P002939,P004866,19.134,10,38,28
292,BAR,P002939,P006435,21.567,19,55,36
292,BAR,P002939,P010641,2.35,4,5,1
292,BAR,P002939,P011244,12.667,6,26,20
292,BAR,P002939,P012745,15.15,10,39,29
292,BAR,P002939,PLFW,2.2,-6,3,9
292,BAR,P003196,P003478,5.099,-13,8,21
292,BAR,P003196,P004866,7.866,-4,20,24
292,BAR,P003196,P006435,4.033,6,13,7
292,BAR,P003196,P007519,3.783,-11,6,17
292,BAR,P003196,P011244,6.299,-4,15,19
292,BAR,P003196,P012745,4.983,-10,10,20
292,BAR,P003196,PLFW,10.082,-15,21,36
292,BAR,P003478,P004866,6.767,-2,10,12
292,BAR,P003478,P006435,9.483,10,31,21
292,BAR,P003478,P007519,3.033,-7,4,11
292,BAR,P003478,P010641,2.35,4,5,1
292,BAR,P003478,P011244,9.266,1,25,24
292,BAR,P003478,P012745,11.183,-4,23,27
292,BAR,P003478,PLFW,8.882,-16,17,33
292,BAR,P004866,P006435,17.4,13,40,27
292,BAR,P004866,P007519,2.15,-7,4,11
292,BAR,P004866,P010641,2.35,4,5,1
292,BAR,P004866,P011244,13.183,9,26,17
292,BAR,P004866,P012745,12.1,-3,28,31
292,BAR,P004866,PLFW,6.666,-5,16,21
292,BAR,P006435,P011244,12.6,14,32,18
292,BAR,P006435,P012745,13.249,11,39,28
292,BAR,P006435,PLFW,4.799,5,16,11
292,BAR,P007519,P012745,5.183,-14,8,22
292,BAR,P007519,PLFW,5.183,-14,8,22
292,BAR,P010641,P011244,2.35,4,5,1
292,BAR,P011244,PLFW,7.532,-3,20,23
292,BAR,P012745,PLFW,6.333,-15,10,25
292,TEL,P005145,P009622,6.317,-3,6,9
292,TEL,P005145,P009783,6.317,-3,6,9
292,TEL,P005145,P009863,6.317,-3,6,9
292,TEL,P005145,P011199,6.317,-3,6,9
292,TEL,P007990,P009622,1.434,5,5,0
292,TEL,P007990,P009783,7.583,13,23,10
292,TEL,P007990,P009863,5.967,15,22,7
292,TEL,P007990,P011193,15.516,18,48,30
292,TEL,P007990,P011199,1.884,1,3,2
292,TEL,P007990,P011214,15.7,23,51,28
292,TEL,P007990,P011219,5.233,-3,12,15
292,TEL,P007990,P011971,4.383,11,17,6
292,TEL,P007990,P012744,10.1,9,31,22
292,TEL,P009622,P009783,22.701,-23,35,58
292,TEL,P009622,P009863,23.685,-24,36,60
292,TEL,P009622,P011193,2.8,0,7,7
292,TEL,P009622,P011199,21.418,-26,32,58
292,TEL,P009622,P011214,3.368,-2,5,7
292,TEL,P009622,P011219,2.567,-5,4,9
292,TEL,P009622,P011971,6.617,-11,11,22
292,TEL,P009622,P012744,3.833,-7,3,10
292,TEL,P009783,P009863,28.034,-10,57,67
292,TEL,P009783,P011193,9.799,14,31,17
292,TEL,P009783,P011199,21.684,-25,33,58
292,TEL,P009783,P011214,8.6,11,26,15
292,TEL,P009783,P011219,3.45,-6,4,10
292,TEL,P009783,P011971,7.417,-8,16,24
292,TEL,P009783,P012744,5.083,-7,5,12
292,TEL,P009863,P011193,8.133,13,29,16
292,TEL,P009863,P011199,21.418,-26,32,58
292,TEL,P009863,P011214,8.701,11,27,16
292,TEL,P009863,P011219,2.567,-5,4,9
292,TEL,P009863,P011971,7.417,-8,16,24
292,TEL,P009863,P012744,3.833,-7,3,10
292,TEL,P011193,P011199,4.167,0,9,9
292,TEL,P011193,P011214,15.533,19,51,32
292,TEL,P011193,P011219,5.233,-3,12,15
292,TEL,P011193,P011971,5.183,14,22,8
292,TEL,P011193,P012744,10.1,9,31,22
292,TEL,P011199,P011214,1.218,-4,1,5
292,TEL,P011199,P011219,2.567,-5,4,9
292,TEL,P011199,P011971,6.617,-11,11,22
292,TEL,P011199,P012744,3.85,-5,5,10
292,TEL,P011214,P011219,5.233,-3,12,15
292,TEL,P011214,P011971,5.183,14,22,8
292,TEL,P011214,P012744,10.2,7,29,22
292,TEL,P011219,P012744,4.35,-2,12,14
292,TEL,P011971,P012744,4.383,11,17,6
293,ASV,P000229,P003526,11.999,0,25,25
293,ASV,P000229,P004194,15.482,7,39,32
293,ASV,P000229,P005094,10.716,8,28,20
293,ASV,P000229,P006568,6.084,-7,7,14
293,ASV,P000229,P011225,12.167,7,34,27
293,ASV,P000229,P011386,12.516,-2,26,28
293,ASV,P000229,P012731,2.533,-2,4,6
293,ASV,P000229,PKIR,8.567,1,21,20
293,ASV,P002100,P003526,6.217,3,14,11
293,ASV,P002100,P004194,6.7,10,16,6
293,ASV,P002100,P005094,18.416,26,52,26
293,ASV,P002100,P006568,14.85,16,36,20
293,ASV,P002100,P011225,14.483,16,38,22
293,ASV,P002100,P011386,5.5,10,14,4
293,ASV,P002100,PKIR,13.766,23,38,15
293,ASV,P003526,P004194,16.166,8,35,27
293,ASV,P003526,P005094,12.016,10,35,25
293,ASV,P003526,P006568,5.167,-8,4,12
293,ASV,P003526,P011225,7.133,5,21,16
293,ASV,P003526,P011386,11.083,-2,18,20
293,ASV,P003526,P012731,2.533,-2,4,6
293,ASV,P003526,PKIR,0.55,-2,0,2
293,ASV,P004194,P005094,13.332,19,39,20
293,ASV,P004194,P006568,3.667,-5,0,5
293,ASV,P004194,P011225,9.383,9,29,20
293,ASV,P004194,P011386,15.999,11,38,27
293,ASV,P004194,P012731,1.983,0,4,4
293,ASV,P004194,PKIR,6.016,9,20,11
293,ASV,P005094,P006568,15.8,15,41,26
293,ASV,P005094,P011225,20.333,19,54,35
293,ASV,P005094,P011386,8.799,15,26,11
293,ASV,P005094,PKIR,17.116,24,45,21
293,ASV,P006568,P011225,17.267,14,43,29
293,ASV,P006568,P011386,5.134,-6,2,8
293,ASV,P006568,PKIR,15.767,17,39,22
293,ASV,P011225,P011386,4.667,2,14,12
293,ASV,P011225,P012731,1.65,2,4,2
293,ASV,P011225,PKIR,19.517,18,51,33
293,ASV,P011386,P012731,0.883,-4,0,4
293,ASV,P011386,PKIR,7.483,8,22,14
293,ASV,P012731,PKIR,0.55,-2,0,2
293,PAM,P000556,P003960,4.583,-16,2,18
293,PAM,P000556,P004863,7.134,0,19,19
293,PAM,P000556,P005356,7.367,-18,9,27
293,PAM,P000556,P007870,2.567,0,7,7
293,PAM,P000556,P010393,9.15,-16,14,30
293,PAM,P000556,P010568,0.8,0,0,0
293,PAM,P000556,P011970,10.917,-16,21,37
293,PAM,P000556,P012795,4.35,2,12,10
293,PAM,P003960,P004863,2.367,-1,4,5
293,PAM,P003960,P005356,8.95,-19,7,26
293,PAM,P003960,P007870,10.067,-16,15,31
293,PAM,P003960,P010393,8.333,-11,9,20
293,PAM,P003960,P010568,13.817,-11,22,33
293,PAM,P003960,P011970,6.683,-11,7,18
293,PAM,P003960,P011982,9.35,-15,13,28
293,PAM,P003960,P012740,4.933,-6,11,17
293,PAM,P003960,P012795,4.517,-2,6,8
293,PAM,P004863,P005356,3.934,0,9,9
293,PAM,P004863,P007870,7.751,-8,11,19
293,PAM,P004863,P010393,6.217,0,14,14
293,PAM,P004863,P010568,7.634,-8,6,14
293,PAM,P004863,P011970,6.334,0,19,19
293,PAM,P004863,P011982,4.467,-7,2,9
293,PAM,P004863,P012795,10.034,-8,16,24
293,PAM,P005356,P007870,6.801,-3,12,15
293,PAM,P005356,P010393,9.85,-16,16,32
293,PAM,P005356,P010568,6.317,-1,7,8
293,PAM,P005356,P011970,12.434,-13,26,39
293,PAM,P005356,P011982,7.184,-6,14,20
293,PAM,P005356,P012795,3.767,0,12,12
293,PAM,P007870,P010393,2.783,0,3,3
293,PAM,P007870,P010568,21.567,-18,29,47
293,PAM,P007870,P011970,4.667,2,13,11
293,PAM,P007870,P011982,18.084,-14,27,41
293,PAM,P007870,P012740,9.083,0,20,20
293,PAM,P007870,P012795,13.234,-3,19,22
293,PAM,P010393,P010568,6.533,5,10,5
293,PAM,P010393,P011970,14.2,-14,28,42
293,PAM,P010393,P011982,2.95,-3,9,12
293,PAM,P010393,P012740,2.783,0,3,3
293,PAM,P010393,P012795,11.733,-1,26,27
293,PAM,P010568,P011970,4.183,4,8,4
293,PAM,P010568,P011982,17.267,-17,24,41
293,PAM,P010568,P012740,9.083,0,20,20
293,PAM,P010568,P012795,14.067,-6,18,24
293,PAM,P011970,P011982,5.85,-1,15,16
293,PAM,P011970,P012795,10.2,1,27,26
293,PAM,P011982,P012740,6.3,0,17,17
293,PAM,P011982,P012795,12.684,-5,23,28
293,PAM,P012740,P012795,4.15,6,9,3
294,MIL,P000796,P001518,2.4,-1,2,3
294,MIL,P000796,P002812,1.9,1,3,2
294,MIL,P000796,P002849,13.55,11,33,22
294,MIL,P000796,P006509,14.9,21,39,18
294,MIL,P000796,P007032,3.249,1,5,4
294,MIL,P000796,P007831,25.416,27,64,37
294,MIL,P000796,P009960,11.666,14,30,16
294,MIL,P000796,P011205,11.516,5,27,22
294,MIL,P000796,P011224,23.867,25,61,36
294,MIL,P001518,P002812,3.85,-3,9,12
294,MIL,P001518,P002849,2.4,-1,2,3
294,MIL,P001518,P006509,5.516,-6,11,17
294,MIL,P001518,P007032,6.116,-2,13,15
294,MIL,P001518,P007831,2.65,2,4,2
294,MIL,P001518,P009960,3.616,-1,6,7
294,MIL,P001518,P011205,9.166,-5,17,22
294,MIL,P001518,P011224,3.75,-3,4,7
294,MIL,P002812,P006509,3.3,-5,7,12
294,MIL,P002812,P007032,4.983,-5,9,14
294,MIL,P002812,P007831,2.45,3,5,2
294,MIL,P002812,P011205,5.75,-2,12,14
294,MIL,P002812,P011224,0.767,3,3,0
294,MIL,P002849,P006509,12.817,8,30,22
294,MIL,P002849,P007032,3.25,0,7,7
294,MIL,P002849,P007201,3.067,0,7,7
294,MIL,P002849,P007831,11.85,12,31,19
294,MIL,P002849,P011205,6.167,3,17,14
294,MIL,P002849,P011224,13.367,11,33,22
294,MIL,P006509,P007032,8.25,-6,16,22
294,MIL,P006509,P007201,3.067,0,7,7
294,MIL,P006509,P007831,14.9,21,39,18
294,MIL,P006509,P009960,7.366,12,20,8
294,MIL,P006509,P011205,8.583,-6,18,24
294,MIL,P006509,P011224,15.233,21,41,20
294,MIL,P007032,P007201,5.417,-7,9,16
294,MIL,P007032,P007831,6.532,-2,11,13
294,MIL,P007032,P009960,6.549,-3,11,14
294,MIL,P007032,P011205,14.782,-8,27,35
294,MIL,P007201,P007831,2.35,-7,2,9
294,MIL,P007201,P009960,2.35,-7,2,9
294,MIL,P007201,P011205,5.417,-7,9,16
294,MIL,P007831,P009960,15.416,7,34,27
294,MIL,P007831,P011205,14.116,1,31,30
294,MIL,P007831,P011224,23.184,24,59,35
294,MIL,P009960,P011205,12.482,-7,22,29
294,MIL,P009960,P011224,11.083,9,27,18
294,MIL,P011205,P011224,9.617,2,24,22
294,VIR,P001133,P001844,11.217,-11,23,34
294,VIR,P001133,P002084,1.15,-4,0,4
294,VIR,P001133,P003048,13.067,-2,28,30
294,VIR,P001133,P003527,9.05,-9,14,23
294,VIR,P001133,P004007,11.801,-5,22,27
294,VIR,P001133,P004554,4.399,-12,3,15
294,VIR,P001133,P005553,0.217,-1,1,2
294,VIR,P001133,P006739,14.533,-26,18,44
294,VIR,P001133,P008847,5.084,-10,8,18
294,VIR,P001133,P010781,10.416,-17,15,32
294,VIR,P001133,PBCN,13.866,-15,24,39
294,VIR,P001844,P002084,6.25,0,11,11
294,VIR,P001844,P003048,5.233,1,15,14
294,VIR,P001844,P003527,10.2,-5,19,24
294,VIR,P001844,P004007,3.617,0,9,9
294,VIR,P001844,P004554,0.133,0,0,0
294,VIR,P001844,P006739,3.717,-7,6,13
294,VIR,P001844,P008847,10.567,-8,19,27
294,VIR,P001844,P010781,9.933,-5,19,24
294,VIR,P001844,PBCN,5.933,-1,15,16
294,VIR,P002084,P003048,2.683,4,7,3
294,VIR,P002084,P003527,5.483,2,11,9
294,VIR,P002084,P004007,1.35,4,5,1
294,VIR,P002084,P004554,6.334,4,15,11
294,VIR,P002084,P005553,6.65,2,15,13
294,VIR,P002084,P006739,11.967,7,25,18
294,VIR,P002084,P008847,7.283,5,14,9
294,VIR,P002084,P010781,8.683,5,16,11
294,VIR,P002084,PBCN,11.967,7,25,18
294,VIR,P003048,P003527,1.717,3,3,0
294,VIR,P003048,P004007,12.234,4,27,23
294,VIR,P003048,P005553,1.55,-1,3,4
294,VIR,P003048,P006739,11.033,-3,22,25
294,VIR,P003048,P010781,1.667,2,4,2
294,VIR,P003048,PBCN,13.816,0,31,31
294,VIR,P003527,P004007,1.717,3,3,0
294,VIR,P003527,P004554,3.016,-5,3,8
294,VIR,P003527,P006739,2.883,-5,3,8
294,VIR,P003527,P008847,9.8,-5,19,24
294,VIR,P003527,P010781,14.266,-7,25,32
294,VIR,P004007,P004554,0.35,-2,0,2
294,VIR,P004007,P005553,0.217,-1,1,2
294,VIR,P004007,P006739,8.434,-6,14,20
294,VIR,P004007,P008847,0.567,-3,0,3
294,VIR,P004007,P010781,1.667,2,4,2
294,VIR,P004007,PBCN,10.65,0,23,23
294,VIR,P004554,P005553,5.317,2,13,11
294,VIR,P004554,P006739,10.6,-8,18,26
294,VIR,P004554,P010781,5.066,-8,5,13
294,VIR,P004554,PBCN,7.717,-3,15,18
294,VIR,P005553,P006739,6.65,2,15,13
294,VIR,P005553,P010781,0.217,-1,1,2
294,VIR,P005553,PBCN,6.65,2,15,13
294,VIR,P006739,P008847,2.567,0,3,3
294,VIR,P006739,P010781,7.116,-7,8,15
294,VIR,P006739,PBCN,21.9,-7,40,47
294,VIR,P008847,P010781,11.6,-2,22,24
294,VIR,P008847,PBCN,2.0,3,3,0
294,VIR,P010781,PBCN,4.233,-2,5,7
295,MUN,P001288,P003583,21.417,-6,40,46
295,MUN,P001288,P005460,3.9,-2,5,7
295,MUN,P001288,P006543,2.3,-2,2,4
295,MUN,P001288,P006760,20.717,-7,38,45
295,MUN,P001288,P007639,0.017,0,0,0
295,MUN,P001288,P007975,2.383,-4,4,8
295,MUN,P001288,P008985,14.967,1,29,28
295,MUN,P001288,P010391,13.133,-8,21,29
295,MUN,P001288,P011987,22.434,-4,41,45
295,MUN,P001557,P003583,3.201,5,9,4
295,MUN,P001557,P005460,6.066,-3,11,14
295,MUN,P001557,P006543,6.099,0,12,12
295,MUN,P001557,P006760,5.934,5,14,9
295,MUN,P001557,P007639,3.733,-2,6,8
295,MUN,P001557,P007975,9.75,-8,16,24
295,MUN,P001557,P008985,0.867,3,5,2
295,MUN,P001557,P010391,13.0,0,26,26
295,MUN,P001557,P011987,3.35,0,5,5
295,MUN,P003583,P006760,24.001,-1,48,49
295,MUN,P003583,P007639,0.017,0,0,0
295,MUN,P003583,P007975,2.317,0,6,6
295,MUN,P003583,P008985,17.517,5,38,33
295,MUN,P003583,P010391,14.117,0,29,29
295,MUN,P003583,P011987,22.617,-3,42,45
295,MUN,P005460,P006543,6.316,-2,11,13
295,MUN,P005460,P006760,3.65,-3,5,8
295,MUN,P005460,P007975,6.766,-7,11,18
295,MUN,P005460,P010391,9.966,-5,16,21
295,MUN,P005460,P011987,3.2,2,5,3
295,MUN,P006543,P007639,2.083,0,3,3
295,MUN,P006543,P007975,6.799,-4,12,16
295,MUN,P006543,P010391,8.399,-2,14,16
295,MUN,P006543,P011987,1.6,2,2,0
295,MUN,P006760,P007639,0.7,3,3,0
295,MUN,P006760,P007975,4.367,-3,8,11
295,MUN,P006760,P008985,15.217,4,33,29
295,MUN,P006760,P010391,16.15,-1,32,33
295,MUN,P006760,P011987,22.6,-1,43,44
295,MUN,P007639,P007975,3.05,-5,3,8
295,MUN,P007639,P010391,3.733,-2,6,8
295,MUN,P007639,P011987,1.667,-2,3,5
295,MUN,P007975,P010391,12.133,-12,20,32
295,MUN,P007975,P011987,0.967,-5,0,5
295,MUN,P008985,P010391,5.35,5,14,9
295,MUN,P008985,P011987,16.15,2,33,31
295,MUN,P010391,P011987,15.283,-3,26,29
295,PAN,P001926,P002328,4.65,0,8,8
295,PAN,P001926,P003842,11.15,4,24,20
295,PAN,P001926,P005161,15.466,-3,29,32
295,PAN,P001926,P007866,8.45,-2,12,14
295,PAN,P001926,P011204,10.05,6,22,16
295,PAN,P001926,P011221,8.533,-3,14,17
295,PAN,P001926,P012712,15.033,3,32,29
295,PAN,P001926,P012774,13.0,-1,23,24
295,PAN,P002328,P003842,10.833,2,23,21
295,PAN,P002328,P007866,7.818,-2,9,11
295,PAN,P002328,P011204,13.101,5,25,20
295,PAN,P002328,P011221,3.484,0,5,5
295,PAN,P002328,P012712,8.567,2,19,17
295,PAN,P002328,P012774,12.951,-3,23,26
295,PAN,P003842,P005161,14.534,4,33,29
295,PAN,P003842,P007866,7.134,-4,8,12
295,PAN,P003842,P007947,4.267,10,16,6
295,PAN,P003842,P011204,20.767,6,45,39
295,PAN,P003842,P012712,19.7,14,52,38
295,PAN,P003842,P012774,18.951,4,39,35
295,PAN,P005161,P007866,9.133,-6,14,20
295,PAN,P005161,P007947,5.25,10,19,9
295,PAN,P005161,P011204,10.833,-3,24,27
295,PAN,P005161,P011221,6.783,-3,11,14
295,PAN,P005161,P012712,15.916,9,42,33
295,PAN,P005161,P012774,14.817,0,28,28
295,PAN,P007866,P007947,0.983,0,3,3
295,PAN,P007866,P011204,10.401,-6,14,20
295,PAN,P007866,P011221,6.917,-4,9,13
295,PAN,P007866,P012712,2.9,0,6,6
295,PAN,P007866,P012774,14.068,-8,17,25
295,PAN,P007947,P011204,2.183,4,9,5
295,PAN,P007947,P012712,5.25,10,19,9
295,PAN,P007947,P012774,3.067,6,10,4
295,PAN,P011204,P011221,1.734,0,2,2
295,PAN,P011204,P012712,17.9,12,45,33
295,PAN,P011204,P012774,14.635,0,26,26
295,PAN,P011221,P012712,3.35,1,7,6
295,PAN,P011221,P012774,10.267,-3,16,19
295,PAN,P012712,P012774,15.184,9,38,29
296,IST,P004888,P006590,14.317,4,40,36
296,IST,P004888,P007200,31.45,9,71,62
296,IST,P004888,P009513,16.55,12,34,22
296,IST,P004888,P009664,0.8,-3,0,3
296,IST,P004888,P009846,12.4,2,34,32
296,IST,P004888,P011078,2.683,-4,3,7
296,IST,P004888,P011981,2.517,-2,3,5
296,IST,P004888,P012710,20.5,7,40,33
296,IST,P004888,P012788,12.917,2,37,35
296,IST,P004888,PLHK,17.466,9,34,25
296,IST,P006590,P007200,12.867,4,37,33
296,IST,P006590,P009513,1.45,0,3,3
296,IST,P006590,P009664,7.1,-7,8,15
296,IST,P006590,P009846,18.7,-2,42,44
296,IST,P006590,P011078,7.1,-7,8,15
296,IST,P006590,P011981,9.017,-9,11,20
296,IST,P006590,P012710,2.717,-1,6,7
296,IST,P006590,P012788,11.067,6,34,28
296,IST,P006590,PLHK,1.333,0,3,3
296,IST,P007200,P009513,15.1,12,31,19
296,IST,P007200,P009664,0.8,-3,0,3
296,IST,P007200,P009846,12.283,2,34,32
296,IST,P007200,P011078,2.683,-4,3,7
296,IST,P007200,P011981,2.517,-2,3,5
296,IST,P007200,P012710,19.167,7,37,30
296,IST,P007200,P012788,12.8,2,37,35
296,IST,P007200,PLHK,16.133,9,31,22
296,IST,P009513,P009846,0.117,0,0,0
296,IST,P009513,P011981,0.6,0,0,0
296,IST,P009513,P012710,16.433,12,34,22
296,IST,P009513,P012788,0.117,0,0,0
296,IST,P009513,PLHK,15.833,12,34,22
296,IST,P009664,P009846,7.9,-10,8,18
296,IST,P009664,P011078,7.1,-7,8,15
296,IST,P009664,P011981,7.1,-7,8,15
296,IST,P009664,PLHK,0.8,-3,0,3
296,IST,P009846,P011078,7.1,-7,8,15
296,IST,P009846,P011981,8.3,-5,11,16
296,IST,P009846,P012788,10.4,3,31,28
296,IST,P009846,PLHK,0.8,-3,0,3
296,IST,P011078,P011981,7.1,-7,8,15
296,IST,P011078,P012710,2.683,-4,3,7
296,IST,P011078,P012788,1.85,-4,3,7
296,IST,P011078,PLHK,0.833,0,0,0
296,IST,P011981,P012710,1.317,-4,0,4
296,IST,P012710,P012788,2.517,-1,6,7
296,IST,P012710,PLHK,16.666,12,34,22
296,ULK,P001932,P002968,6.767,-3,5,8
296,ULK,P001932,P004004,3.817,-6,8,14
296,ULK,P001932,P005844,9.149,1,21,20
296,ULK,P001932,P006661,13.433,0,32,32
296,ULK,P001932,P006961,9.5,-4,14,18
296,ULK,P001932,P008962,24.216,-8,43,51
296,ULK,P001932,P009849,8.9,-6,8,14
296,ULK,P001932,P010560,13.266,-1,24,25
296,ULK,P001932,P011157,8.467,-5,17,22
296,ULK,P001932,P011980,0.217,0,0,0
296,ULK,P002968,P006961,6.167,-3,5,8
296,ULK,P002968,P008962,6.767,-3,5,8
296,ULK,P002968,P009849,6.767,-3,5,8
296,ULK,P002968,P010560,0.6,0,0,0
296,ULK,P004004,P005844,7.783,2,20,18
296,ULK,P004004,P006661,17.0,2,42,40
296,ULK,P004004,P006961,10.6,-3,22,25
296,ULK,P004004,P008962,8.317,-8,24,32
296,ULK,P004004,P010560,7.399,6,18,12
296,ULK,P004004,P011157,11.55,-1,25,26
296,ULK,P004004,P011980,11.066,8,21,13
296,ULK,P005844,P006661,14.516,6,38,32
296,ULK,P005844,P006961,8.366,1,23,22
296,ULK,P005844,P008962,11.299,1,31,30
296,ULK,P005844,P009849,2.133,-3,3,6
296,ULK,P005844,P010560,8.849,2,18,16
296,ULK,P005844,P011980,5.633,2,10,8
296,ULK,P006661,P006961,8.75,0,22,22
296,ULK,P006661,P008962,17.933,-2,48,50
296,ULK,P006661,P010560,18.299,9,42,33
296,ULK,P006661,P011157,14.15,1,31,30
296,ULK,P006661,P011980,10.783,8,21,13
296,ULK,P006961,P008962,11.65,-4,24,28
296,ULK,P006961,P009849,6.817,-2,8,10
296,ULK,P006961,P010560,0.283,0,0,0
296,ULK,P006961,P011157,3.367,-1,5,6
296,ULK,P006961,P011980,6.3,0,9,9
296,ULK,P008962,P009849,8.683,-6,8,14
296,ULK,P008962,P010560,15.399,-3,30,33
296,ULK,P008962,P011157,10.6,-7,23,30
296,ULK,P009849,P010560,2.083,-4,0,4
296,ULK,P009849,P011980,0.217,0,0,0
296,ULK,P010560,P011157,11.216,3,24,21
296,ULK,P010560,P011980,5.266,8,12,4
296,ULK,P011157,P011980,5.65,6,11,5
297,BAS,P003198,P004603,5.5,-10,10,20
297,BAS,P003198,P004761,4.05,-5,7,12
297,BAS,P003198,P007230,3.15,-7,8,15
297,BAS,P003198,P009048,7.617,-15,12,27
297,BAS,P003198,P010444,4.5,0,7,7
297,BAS,P003198,P011948,5.95,-5,10,15
297,BAS,P003198,P012201,6.85,-3,9,12
297,BAS,P003198,P012765,2.383,5,5,0
297,BAS,P004603,P004761,4.05,-5,7,12
297,BAS,P004603,P007230,6.133,-12,12,24
297,BAS,P004603,P009048,6.9,-10,12,22
297,BAS,P004603,P011085,2.983,-5,4,9
297,BAS,P004603,P011948,1.45,-5,3,8
297,BAS,P004603,P012201,5.333,-8,6,14
297,BAS,P004603,P012765,1.583,-5,2,7
297,BAS,P004761,P007230,1.7,-2,5,7
297,BAS,P004761,P009048,4.05,-5,7,12
297,BAS,P004761,P012201,2.35,-3,2,5
297,BAS,P007230,P009048,26.699,14,72,58
297,BAS,P007230,P010444,23.183,19,66,47
297,BAS,P007230,P011085,11.716,-5,28,33
297,BAS,P007230,P011948,25.299,17,69,52
297,BAS,P007230,P012201,28.266,11,70,59
297,BAS,P007230,P012765,6.45,-7,14,21
297,BAS,P009048,P010444,20.433,16,56,40
297,BAS,P009048,P011085,8.216,1,21,20
297,BAS,P009048,P011948,24.466,13,64,51
297,BAS,P009048,P012201,26.283,10,60,50
297,BAS,P010444,P011085,4.9,0,16,16
297,BAS,P010444,P011948,24.516,22,65,43
297,BAS,P010444,P012201,25.95,16,65,49
297,BAS,P010444,P012765,7.25,3,17,14
297,BAS,P011085,P011948,5.566,3,16,13
297,BAS,P011085,P012201,9.983,-8,20,28
297,BAS,P011085,P012765,3.5,-6,7,13
297,BAS,P011948,P012201,26.616,19,65,46
297,BAS,P011948,P012765,5.333,4,12,8
297,BAS,P012201,P012765,8.833,-2,19,21
297,MAD,P001392,P003108,17.233,5,37,32
297,MAD,P001392,P004887,4.033,0,7,7
297,MAD,P001392,P005791,13.2,5,30,25
297,MAD,P001392,P005928,14.967,7,37,30
297,MAD,P001392,P006540,0.117,-3,0,3
297,MAD,P001392,P009005,2.5,-8,0,8
297,MAD,P001392,P010357,14.967,7,37,30
297,MAD,P001392,PCVM,2.383,-5,0,5
297,MAD,P003108,P004887,5.2,1,15,14
297,MAD,P003108,P005791,18.383,3,40,37
297,MAD,P003108,P005928,21.333,7,55,48
297,MAD,P003108,P006540,5.633,0,18,18
297,MAD,P003108,P009005,3.366,-10,0,10
297,MAD,P003108,P010357,20.483,10,55,45
297,MAD,P003108,PCVM,2.383,-5,0,5
297,MAD,P003108,PTGB,0.85,-3,0,3
297,MAD,P004887,P005928,2.817,6,15,9
297,MAD,P004887,P006540,11.484,-6,27,33
297,MAD,P004887,P009005,12.7,-12,19,31
297,MAD,P004887,P010357,2.817,6,15,9
297,MAD,P004887,PCVM,12.7,-12,19,31
297,MAD,P004887,PTGB,10.317,-7,19,26
297,MAD,P005791,P005928,18.4,5,42,37
297,MAD,P005791,P006540,5.283,1,14,13
297,MAD,P005791,P009005,1.8,-3,4,7
297,MAD,P005791,P010357,17.533,6,40,34
297,MAD,P005791,PCVM,0.933,-2,2,4
297,MAD,P005791,PTGB,1.8,-3,4,7
297,MAD,P005928,P006540,10.667,3,33,30
297,MAD,P005928,P009005,6.017,-2,15,17
297,MAD,P005928,P010357,25.5,11,68,57
297,MAD,P005928,PTGB,5.767,3,15,12
297,MAD,P006540,P009005,16.417,-8,36,44
297,MAD,P006540,P010357,10.65,1,31,30
297,MAD,P006540,PCVM,11.25,-9,21,30
297,MAD,P006540,PTGB,16.167,-3,36,39
297,MAD,P009005,P010357,5.15,-1,13,14
297,MAD,P009005,PCVM,13.633,-14,21,35
297,MAD,P009005,PTGB,17.017,-6,36,42
297,MAD,P010357,PTGB,4.9,4,13,9
297,MAD,PCVM,PTGB,11.25,-9,21,30
298,IST,P004888,P006590,3.534,1,4,3
298,IST,P004888,P007200,16.75,15,38,23
298,IST,P004888,P009513,14.383,12,31,19
298,IST,P004888,P009664,2.317,3,7,4
298,IST,P004888,P009846,2.317,3,7,4
298,IST,P004888,P011078,3.534,1,4,3
298,IST,P004888,P012710,17.917,13,35,22
298,IST,P004888,P012788,5.317,8,16,8
298,IST,P004888,PLHK,14.867,8,26,18
298,IST,P006372,P006590,0.6,2,2,0
298,IST,P006372,P009513,6.783,1,12,11
298,IST,P006372,P009664,8.55,8,19,11
298,IST,P006372,P009846,7.95,6,17,11
298,IST,P006372,P011078,1.767,7,7,0
298,IST,P006372,P011981,1.767,7,7,0
298,IST,P006372,P012788,6.783,1,12,11
298,IST,P006590,P007200,0.05,0,0,0
298,IST,P006590,P009664,6.3,18,23,5
298,IST,P006590,P009846,8.367,23,32,9
298,IST,P006590,P011078,12.501,26,38,12
298,IST,P006590,P011981,2.05,7,7,0
298,IST,P006590,P012710,6.201,8,15,7
298,IST,P006590,P012788,8.784,19,31,12
298,IST,P006590,PLHK,1.617,0,0,0
298,IST,P007200,P009513,14.45,10,31,21
298,IST,P007200,P009664,4.0,1,9,8
298,IST,P007200,P009846,5.1,3,14,11
298,IST,P007200,P011078,2.9,-2,7,9
298,IST,P007200,P011981,2.85,-2,7,9
298,IST,P007200,P012710,15.6,12,36,24
298,IST,P007200,P012788,3.45,7,12,5
298,IST,P007200,PLHK,13.25,8,26,18
298,IST,P009513,P009664,6.783,1,12,11
298,IST,P009513,P009846,6.783,1,12,11
298,IST,P009513,P011078,0.067,-2,0,2
298,IST,P009513,P011981,0.067,-2,0,2
298,IST,P009513,P012710,14.45,10,31,21
298,IST,P009513,P012788,7.916,5,17,12
298,IST,P009513,PLHK,13.25,8,26,18
298,IST,P009664,P009846,17.65,23,47,24
298,IST,P009664,P011078,9.15,21,30,9
298,IST,P009664,P011981,4.9,10,14,4
298,IST,P009664,P012788,13.35,15,35,20
298,IST,P009846,P011078,12.317,28,44,16
298,IST,P009846,P011981,5.4,10,17,7
298,IST,P009846,P012710,3.767,9,16,7
298,IST,P009846,P012788,16.017,22,46,24
298,IST,P011078,P011981,6.067,10,19,9
298,IST,P011078,P012710,7.368,8,20,12
298,IST,P011078,P012788,8.784,19,31,12
298,IST,P011078,PLHK,1.617,0,0,0
298,IST,P011981,P012710,1.167,0,5,5
298,IST,P012710,P012788,5.667,12,20,8
298,IST,P012710,PLHK,14.867,8,26,18
298,RED,P000848,P002553,17.916,-13,28,41
298,RED,P000848,P005099,11.65,-7,21,28
298,RED,P000848,P005836,3.167,-5,5,10
298,RED,P000848,P006436,15.833,-7,25,32
298,RED,P000848,P009035,16.116,-9,25,34
298,RED,P000848,P011964,1.367,-1,2,3
298,RED,P000848,P012044,7.633,-7,9,16
298,RED,P000848,PJDR,3.45,-7,5,12
298,RED,P002553,P005099,11.916,-13,20,33
298,RED,P002553,P005836,4.8,-12,6,18
298,RED,P002553,P006436,15.983,-6,27,33
298,RED,P002553,P008966,3.184,0,4,4
298,RED,P002553,P009035,14.749,-8,23,31
298,RED,P002553,P011964,1.0,-3,0,3
298,RED,P002553,P012044,11.817,-10,13,23
298,RED,P002553,P012801,1.533,-7,0,7
298,RED,P002553,PJDR,7.734,-10,10,20
298,RED,P002553,PLUO,4.3,-10,1,11
298,RED,P005099,P005836,4.8,-12,6,18
298,RED,P005099,P006436,13.484,-1,25,26
298,RED,P005099,P008966,5.017,1,9,8
298,RED,P005099,P009035,8.75,-4,16,20
298,RED,P005099,P011964,6.651,-2,11,13
298,RED,P005099,P012044,0.267,-2,0,2
298,RED,P005099,P012801,5.55,-3,9,12
298,RED,P005099,PJDR,4.55,-10,6,16
298,RED,P005099,PLUO,1.633,-7,1,8
298,RED,P005836,P006436,2.667,-2,6,8
298,RED,P005836,P008966,2.7,-5,3,8
298,RED,P005836,P009035,2.667,-2,6,8
298,RED,P005836,P012044,5.367,-7,9,16
298,RED,P005836,P012801,0.533,-4,0,4
298,RED,P005836,PJDR,9.634,-15,15,30
298,RED,P005836,PLUO,4.333,-12,4,16
298,RED,P006436,P008966,6.534,1,13,12
298,RED,P006436,P009035,19.034,-13,31,44
298,RED,P006436,P011964,6.918,-4,11,15
298,RED,P006436,P012044,12.351,-13,19,32
298,RED,P006436,P012801,5.017,1,9,8
298,RED,P006436,PJDR,4.451,-4,10,14
298,RED,P008966,P011964,6.784,-1,11,12
298,RED,P008966,P012044,7.651,-7,9,16
298,RED,P008966,P012801,6.784,-1,11,12
298,RED,P008966,PJDR,5.884,-5,7,12
298,RED,P008966,PLUO,6.134,-7,5,12
298,RED,P009035,P011964,4.118,-14,2,16
298,RED,P009035,P012044,13.051,-22,15,37
298,RED,P009035,P012801,2.217,-9,0,9
298,RED,P009035,PJDR,3.217,-6,6,12
298,RED,P009035,PLUO,2.217,-9,0,9
298,RED,P011964,P012044,5.518,-18,2,20
298,RED,P011964,P012801,10.001,-13,11,24
298,RED,P011964,PJDR,0.267,-2,0,2
298,RED,P011964,PLUO,4.984,-14,2,16
298,RED,P012044,P012801,4.984,-14,2,16
298,RED,P012044,PJDR,8.818,-9,13,22
298,RED,P012044,PLUO,9.351,-19,5,24
298,RED,P012801,PLUO,5.517,-18,2,20
298,RED,PJDR,PLUO,5.467,-8,4,12
299,MCO,P002581,P005985,1.334,2,7,5
299,MCO,P002581,P009754,1.334,2,7,5
299,MCO,P002581,P010588,1.334,2,7,5
299,MCO,P002581,P011231,0.067,0,0,0
299,MCO,P002581,P012709,1.267,2,7,5
299,MCO,P004197,P005985,11.917,5,32,27
299,MCO,P004197,P010588,11.917,5,32,27
299,MCO,P004197,P011226,11.917,5,32,27
299,MCO,P004197,PLCZ,11.917,5,32,27
299,MCO,P004790,P005985,5.65,5,12,7
299,MCO,P004790,P009754,4.883,1,8,7
299,MCO,P004790,P011196,3.383,3,5,2
299,MCO,P004790,P011212,3.033,3,5,2
299,MCO,P004790,P011231,5.033,4,8,4
299,MCO,P004790,P012709,4.75,2,9,7
299,MCO,P004790,PLCZ,4.4,2,9,7
299,MCO,P005985,P009754,15.134,-4,35,39
299,MCO,P005985,P010588,20.534,9,57,48
299,MCO,P005985,P011196,8.85,-5,14,19
299,MCO,P005985,P011212,6.1,-2,11,13
299,MCO,P005985,P011226,18.167,3,46,43
299,MCO,P005985,P011231,9.251,-4,19,23
299,MCO,P005985,P012709,6.017,4,16,12
299,MCO,P005985,PLCZ,17.65,7,43,36
299,MCO,P009754,P010588,8.417,4,25,21
299,MCO,P009754,P011196,13.65,-3,24,27
299,MCO,P009754,P011212,14.85,-6,24,30
299,MCO,P009754,P011226,13.767,-3,28,31
299,MCO,P009754,P011231,16.201,-9,29,38
299,MCO,P009754,P012709,4.017,3,13,10
299,MCO,P009754,PLCZ,7.683,-5,11,16
299,MCO,P010588,P011196,3.633,1,7,6
299,MCO,P010588,P011212,1.233,4,4,0
299,MCO,P010588,P011226,18.167,3,46,43
299,MCO,P010588,P011231,2.384,1,9,8
299,MCO,P010588,P012709,1.267,2,7,5
299,MCO,P010588,PLCZ,13.25,5,34,29
299,MCO,P011196,P011212,11.95,3,24,21
299,MCO,P011196,P011226,6.517,2,14,12
299,MCO,P011196,P011231,11.267,-1,20,21
299,MCO,P011196,P012709,0.35,0,0,0
299,MCO,P011212,P011226,7.917,-1,14,15
299,MCO,P011212,P011231,14.717,-7,23,30
299,MCO,P011212,PLCZ,4.0,-6,3,9
299,MCO,P011226,P011231,10.034,0,23,23
299,MCO,P011226,PLCZ,17.05,-1,37,38
299,MCO,P011231,P012709,2.0,1,3,2
299,MCO,P011231,PLCZ,5.45,-5,6,11
299,MCO,P012709,PLCZ,4.4,2,9,7
299,MUN,P001288,P005478,7.85,4,23,19
299,MUN,P001288,P006543,2.817,-3,5,8
299,MUN,P001288,P006760,7.817,11,27,16
299,MUN,P001288,P007056,18.817,-6,43,49
299,MUN,P001288,P007639,11.017,-1,27,28
299,MUN,P001288,P007975,11.3,12,35,23
299,MUN,P001288,P008985,12.667,-2,28,30
299,MUN,P001288,P010391,6.967,-4,16,20
299,MUN,P001288,P011987,26.084,5,68,63
299,MUN,P001557,P005478,3.267,-7,2,9
299,MUN,P001557,P006760,8.584,-13,6,19
299,MUN,P001557,P007056,4.267,-3,4,7
299,MUN,P001557,P007639,1.05,-3,0,3
299,MUN,P001557,P007975,3.267,-7,2,9
299,MUN,P001557,P008985,5.317,-6,4,10
299,MUN,P001557,P010391,7.534,-10,6,16
299,MUN,P001557,P011987,1.05,-3,0,3
299,MUN,P005478,P006543,0.267,-1,1,2
299,MUN,P005478,P006760,10.7,7,26,19
299,MUN,P005478,P007056,2.883,-8,2,10
299,MUN,P005478,P007975,9.783,5,21,16
299,MUN,P005478,P008985,1.767,-1,3,4
299,MUN,P005478,P010391,8.3,-12,11,23
299,MUN,P005478,P011987,10.583,5,27,22
299,MUN,P006543,P006760,2.55,-2,4,6
299,MUN,P006543,P008985,2.483,-2,4,6
299,MUN,P006543,P010391,0.334,-1,1,2
299,MUN,P006543,P011987,2.817,-3,5,8
299,MUN,P006760,P007056,7.184,1,14,13
299,MUN,P006760,P007639,1.05,-3,0,3
299,MUN,P006760,P007975,11.75,9,29,20
299,MUN,P006760,P008985,8.667,-5,11,16
299,MUN,P006760,P010391,13.934,-7,21,28
299,MUN,P006760,P011987,13.7,14,38,24
299,MUN,P007056,P007639,11.017,-1,27,28
299,MUN,P007056,P007975,10.817,5,29,24
299,MUN,P007056,P008985,13.584,-6,25,31
299,MUN,P007056,P010391,12.25,-1,22,23
299,MUN,P007056,P011987,20.917,-1,50,51
299,MUN,P007639,P007975,2.6,-2,6,8
299,MUN,P007639,P008985,9.467,-2,21,23
299,MUN,P007639,P011987,12.067,-4,27,31
299,MUN,P007975,P010391,12.95,0,24,24
299,MUN,P007975,P011987,16.133,18,46,28
299,MUN,P008985,P010391,4.267,-3,4,7
299,MUN,P008985,P011987,13.717,-5,28,33
299,MUN,P010391,P011987,11.8,2,27,25
300,MIL,P000796,P001518,1.417,1,3,2
300,MIL,P000796,P002812,7.149,6,21,15
300,MIL,P000796,P002849,12.734,-9,28,37
300,MIL,P000796,P005670,2.733,3,7,4
300,MIL,P000796,P006509,14.266,-6,35,41
300,MIL,P000796,P007032,3.533,-1,5,6
300,MIL,P000796,P007201,0.033,-3,0,3
300,MIL,P000796,P007831,18.667,-5,47,52
300,MIL,P000796,P009960,9.884,-8,17,25
300,MIL,P000796,P011224,18.384,-2,45,47
300,MIL,P001518,P002812,6.534,-5,9,14
300,MIL,P001518,P006509,4.267,-2,9,11
300,MIL,P001518,P006701,7.317,-1,11,12
300,MIL,P001518,P007032,11.668,-3,20,23
300,MIL,P001518,P007201,11.018,-3,20,23
300,MIL,P001518,P007831,1.85,1,3,2
300,MIL,P001518,P009960,6.984,3,14,11
300,MIL,P001518,P011224,3.017,1,3,2
300,MIL,P002812,P005670,2.733,3,7,4
300,MIL,P002812,P006509,11.416,4,30,26
300,MIL,P002812,P006701,2.267,-3,0,3
300,MIL,P002812,P007032,8.367,-2,14,16
300,MIL,P002812,P007201,6.567,-8,9,17
300,MIL,P002812,P007831,5.316,3,16,13
300,MIL,P002812,P011224,4.383,6,14,8
300,MIL,P002849,P006509,6.217,-8,14,22
300,MIL,P002849,P007032,1.05,-4,0,4
300,MIL,P002849,P007831,11.684,-5,28,33
300,MIL,P002849,P009960,7.567,-5,14,19
300,MIL,P002849,P011224,11.684,-5,28,33
300,MIL,P005670,P006509,2.733,3,7,4
300,MIL,P005670,P007032,1.833,3,5,2
300,MIL,P005670,P007831,0.9,0,2,2
300,MIL,P006509,P006701,0.883,-1,3,4
300,MIL,P006509,P007032,8.033,-4,17,21
300,MIL,P006509,P007201,5.183,-6,12,18
300,MIL,P006509,P007831,11.383,-5,30,35
300,MIL,P006509,P009960,2.833,-9,3,12
300,MIL,P006509,P011224,10.45,-2,28,30
300,MIL,P006701,P007032,7.117,-2,14,16
300,MIL,P006701,P007201,11.934,2,25,23
300,MIL,P006701,P007831,5.9,4,11,7
300,MIL,P006701,P009960,10.75,5,25,20
300,MIL,P006701,P011224,5.9,4,11,7
300,MIL,P007032,P007201,11.901,-4,23,27
300,MIL,P007032,P009960,7.067,-3,14,17
300,MIL,P007032,P011224,1.167,0,0,0
300,MIL,P007201,P007831,4.85,1,11,10
300,MIL,P007201,P009960,10.184,5,25,20
300,MIL,P007201,P011224,5.334,4,11,7
300,MIL,P007831,P009960,14.084,0,28,28
300,MIL,P007831,P011224,23.634,2,56,54
300,MIL,P009960,P011224,15.251,0,28,28
300,TEL,P004233,P009622,9.6,-7,15,22
300,TEL,P004233,P009783,4.333,1,11,10
300,TEL,P004233,P009863,12.166,-5,24,29
300,TEL,P004233,P011193,3.283,2,9,7
300,TEL,P004233,P011199,7.433,-4,15,19
300,TEL,P004233,P011214,3.8,-1,2,3
300,TEL,P004233,P011219,8.166,-4,15,19
300,TEL,P004233,P011971,1.183,0,2,2
300,TEL,P004233,P012095,0.75,0,0,0
300,TEL,P004233,P012744,0.95,-2,3,5
300,TEL,P005145,P009622,9.467,7,29,22
300,TEL,P005145,P009783,9.467,7,29,22
300,TEL,P005145,P009863,11.001,8,33,25
300,TEL,P005145,P011193,1.534,1,4,3
300,TEL,P005145,P011199,9.934,7,29,22
300,TEL,P005145,P011214,1.067,1,4,3
300,TEL,P005145,P012744,1.534,1,4,3
300,TEL,P009622,P009783,16.5,6,42,36
300,TEL,P009622,P009863,21.05,4,48,44
300,TEL,P009622,P011193,1.417,-1,2,3
300,TEL,P009622,P011199,18.883,7,48,41
300,TEL,P009622,P011214,3.584,-4,2,6
300,TEL,P009622,P011219,5.533,-9,6,15
300,TEL,P009622,P011971,4.15,0,8,8
300,TEL,P009622,P012095,0.683,-3,0,3
300,TEL,P009622,P012744,1.733,0,0,0
300,TEL,P009783,P009863,15.783,12,44,32
300,TEL,P009783,P011193,4.35,3,16,13
300,TEL,P009783,P011199,15.05,10,40,30
300,TEL,P009783,P011214,1.1,-3,2,5
300,TEL,P009783,P011219,4.266,1,14,13
300,TEL,P009783,P011971,4.867,4,16,12
300,TEL,P009783,P012095,3.533,-1,10,11
300,TEL,P009783,P012744,1.083,0,0,0
300,TEL,P009863,P011193,4.817,3,15,12
300,TEL,P009863,P011199,19.35,7,48,41
300,TEL,P009863,P011214,4.867,0,8,8
300,TEL,P009863,P011219,8.166,-4,17,21
300,TEL,P009863,P011971,2.083,4,6,2
300,TEL,P009863,P012095,0.75,0,2,2
300,TEL,P009863,P012744,3.567,-1,7,8
300,TEL,P011193,P011199,0.467,0,0,0
300,TEL,P011193,P011214,13.566,1,27,26
300,TEL,P011193,P011219,10.416,6,30,24
300,TEL,P011193,P011971,12.3,4,29,25
300,TEL,P011193,P012095,12.716,3,29,26
300,TEL,P011193,P012744,7.934,-2,15,17
300,TEL,P011199,P011219,2.683,-3,6,9
300,TEL,P011199,P011971,2.05,4,6,2
300,TEL,P011199,P012744,1.55,0,0,0
300,TEL,P011214,P011219,8.449,-1,13,14
300,TEL,P011214,P011971,9.816,0,19,19
300,TEL,P011214,P012095,10.232,-1,19,20
300,TEL,P011214,P012744,6.583,0,12,12
300,TEL,P011219,P011971,6.799,3,19,16
300,TEL,P011219,P012095,8.599,1,21,20
300,TEL,P011219,P012744,0.983,-2,3,5
300,TEL,P011971,P012095,11.599,2,27,25
300,TEL,P011971,P012744,5.549,-1,8,9
300,TEL,P012095,P012744,4.866,-1,8,9
301,BER,P006251,P006919,5.867,-3,8,11
301,BER,P006251,P007550,8.933,-6,17,23
301,BER,P006251,P008211,6.4,0,9,9
301,BER,P006251,P008780,7.967,6,16,10
301,BER,P006251,P008967,15.966,0,30,30
301,BER,P006251,P010791,19.016,-2,34,36
301,BER,P006251,P011934,0.617,2,2,0
301,BER,P006251,P012720,13.766,3,28,25
301,BER,P006819,P007550,2.5,-2,3,5
301,BER,P006819,P008780,0.9,2,5,3
301,BER,P006819,P008967,3.4,0,8,8
301,BER,P006819,P012720,3.4,0,8,8
301,BER,P006819,P012721,3.4,0,8,8
301,BER,P006919,P007550,8.434,-11,15,26
301,BER,P006919,P008211,10.634,8,25,17
301,BER,P006919,P008780,3.067,-1,4,5
301,BER,P006919,P008967,7.083,-1,11,12
301,BER,P006919,P010791,8.717,-11,8,19
301,BER,P006919,P011631,2.901,4,13,9
301,BER,P006919,P011934,8.784,5,24,19
301,BER,P006919,P012720,6.083,-13,2,15
301,BER,P006919,P012721,8.434,-1,18,19
301,BER,P007550,P008211,5.184,0,14,14
301,BER,P007550,P008780,2.0,-1,2,3
301,BER,P007550,P008967,9.033,-9,16,25
301,BER,P007550,P010791,11.083,-14,17,31
301,BER,P007550,P011631,1.384,3,9,6
301,BER,P007550,P011934,6.701,-4,15,19
301,BER,P007550,P012720,15.6,-22,20,42
301,BER,P007550,P012721,10.284,-14,12,26
301,BER,P008211,P008780,0.867,2,2,0
301,BER,P008211,P008967,7.216,5,12,7
301,BER,P008211,P010791,6.983,0,9,9
301,BER,P008211,P011631,1.984,2,8,6
301,BER,P008211,P011934,7.601,6,21,15
301,BER,P008211,P012720,6.083,-4,5,9
301,BER,P008211,P012721,5.384,5,15,10
301,BER,P008780,P008967,10.117,3,22,19
301,BER,P008780,P010791,7.467,4,14,10
301,BER,P008780,P011934,4.617,-2,7,9
301,BER,P008780,P012720,9.917,5,22,17
301,BER,P008780,P012721,5.017,-2,10,12
301,BER,P008967,P010791,16.166,-2,28,30
301,BER,P008967,P011631,0.4,-3,0,3
301,BER,P008967,P011934,6.8,1,14,13
301,BER,P008967,P012720,21.416,-2,39,41
301,BER,P008967,P012721,7.867,4,20,16
301,BER,P010791,P012720,16.233,-7,26,33
301,BER,P010791,P012721,2.267,-8,0,8
301,BER,P011631,P011934,2.901,4,13,9
301,BER,P011631,P012720,0.2,2,2,0
301,BER,P011631,P012721,1.834,4,7,3
301,BER,P011934,P012720,8.95,-9,11,20
301,BER,P011934,P012721,11.501,1,25,24
301,BER,P012720,P012721,12.684,-17,17,34
301,PAN,P001926,P002328,22.433,22,51,29
301,PAN,P001926,P003842,19.633,6,47,41
301,PAN,P001926,P005161,3.8,1,10,9
301,PAN,P001926,P007866,12.333,4,29,25
301,PAN,P001926,P007947,5.7,3,14,11
301,PAN,P001926,P011204,4.8,-4,11,15
301,PAN,P001926,P011221,10.083,12,22,10
301,PAN,P001926,P012712,17.383,14,40,26
301,PAN,P001926,P012774,22.699,14,52,38
301,PAN,P002328,P003842,17.933,1,36,35
301,PAN,P002328,P007553,3.967,-5,5,10
301,PAN,P002328,P007866,15.733,3,34,31
301,PAN,P002328,P007947,7.35,-4,14,18
301,PAN,P002328,P011204,7.517,-2,13,15
301,PAN,P002328,P011221,9.083,16,22,6
301,PAN,P002328,P012712,15.25,9,29,20
301,PAN,P002328,P012774,24.666,8,48,40
301,PAN,P003842,P005161,4.617,4,10,6
301,PAN,P003842,P007866,9.166,5,23,18
301,PAN,P003842,P007947,9.767,-3,19,22
301,PAN,P003842,P011204,3.333,-4,9,13
301,PAN,P003842,P011209,1.717,1,3,2
301,PAN,P003842,P012712,14.967,-5,29,34
301,PAN,P003842,P012774,15.399,-5,32,37
301,PAN,P005161,P007866,0.9,-2,3,5
301,PAN,P005161,P007947,2.417,1,5,4
301,PAN,P005161,P011209,1.717,1,3,2
301,PAN,P005161,P011221,0.9,-2,3,5
301,PAN,P005161,P012712,4.617,4,10,6
301,PAN,P005161,P012774,3.1,1,8,7
301,PAN,P007553,P007866,3.967,-5,5,10
301,PAN,P007553,P011204,3.967,-5,5,10
301,PAN,P007553,P012774,3.967,-5,5,10
301,PAN,P007866,P007947,2.033,3,6,3
301,PAN,P007866,P011204,8.117,-3,12,15
301,PAN,P007866,P011221,5.417,1,11,10
301,PAN,P007866,P012712,0.017,0,0,0
301,PAN,P007866,P012774,16.517,-2,33,35
301,PAN,P007947,P011209,1.717,1,3,2
301,PAN,P007947,P012712,7.734,-6,13,19
301,PAN,P007947,P012774,2.35,-7,2,9
301,PAN,P011204,P011221,3.717,2,7,5
301,PAN,P011204,P012712,2.917,-4,9,13
301,PAN,P011204,P012774,9.7,-8,18,26
301,PAN,P011209,P012712,1.717,1,3,2
301,PAN,P011221,P012712,6.5,13,16,3
301,PAN,P011221,P012774,11.9,14,27,13
301,PAN,P012712,P012774,14.766,6,31,25
302,MAD,P001392,P003108,14.8,0,28,28
302,MAD,P001392,P004887,14.05,0,28,28
302,MAD,P001392,P005791,0.75,0,0,0
302,MAD,P001392,P009005,1.217,0,2,2
302,MAD,P001392,P010357,13.583,0,26,26
302,MAD,P001392,P010623,10.05,-2,20,22
302,MAD,P001392,PTGB,4.75,2,8,6
302,MAD,P003108,P003733,0.283,-3,0,3
302,MAD,P003108,P004887,19.05,-4,32,36
302,MAD,P003108,P005791,6.333,4,10,6
302,MAD,P003108,P006540,8.683,6,12,6
302,MAD,P003108,P009005,8.034,1,14,13
302,MAD,P003108,P010357,17.349,-1,28,29
302,MAD,P003108,P010623,12.8,-5,22,27
302,MAD,P003108,PTGB,14.2,2,22,20
302,MAD,P003733,P005791,14.899,-1,22,23
302,MAD,P003733,P006540,14.616,2,22,20
302,MAD,P003733,P009005,13.049,-1,18,19
302,MAD,P003733,P010357,1.85,0,4,4
302,MAD,P003733,P010623,7.166,-1,10,11
302,MAD,P003733,PTGB,7.733,0,12,12
302,MAD,P004887,P006540,3.383,-1,2,3
302,MAD,P004887,P009005,2.834,-3,4,7
302,MAD,P004887,P010357,16.216,-1,28,29
302,MAD,P004887,P010623,12.417,-5,22,27
302,MAD,P004887,PTGB,8.25,-2,12,14
302,MAD,P005791,P006540,19.916,9,32,23
302,MAD,P005791,P009005,17.966,6,28,22
302,MAD,P005791,P010357,2.983,0,4,4
302,MAD,P005791,P010623,7.549,-1,10,11
302,MAD,P005791,PTGB,13.4,7,22,15
302,MAD,P006540,P009005,17.683,9,28,19
302,MAD,P006540,P010357,5.616,-1,6,7
302,MAD,P006540,P010623,8.299,-1,10,11
302,MAD,P006540,PTGB,15.0,9,24,15
302,MAD,P009005,P010623,9.567,-2,14,16
302,MAD,P009005,PTGB,12.85,2,20,18
302,MAD,P010357,P010623,10.399,-4,18,22
302,MAD,P010357,PTGB,8.8,3,14,11
302,MAD,P010623,PTGB,1.617,-3,2,5
302,ZAL,P002329,P003210,7.883,-9,9,18
302,ZAL,P002329,P005504,10.317,-5,17,22
302,ZAL,P002329,P006860,4.134,-4,4,8
302,ZAL,P002329,P007109,12.485,-8,14,22
302,ZAL,P002329,P007513,25.535,6,44,38
302,ZAL,P002329,P010184,3.017,2,4,2
302,ZAL,P002329,P010390,17.768,8,35,27
302,ZAL,P002329,P011218,25.102,3,42,39
302,ZAL,P002329,P012715,19.934,5,38,33
302,ZAL,P002329,P012787,9.101,-2,17,19
302,ZAL,P003210,P005504,5.033,-1,9,10
302,ZAL,P003210,P006860,3.1,0,4,4
302,ZAL,P003210,P007109,5.033,-3,6,9
302,ZAL,P003210,P007513,1.983,-4,2,6
302,ZAL,P003210,P010184,2.183,5,6,1
302,ZAL,P003210,P010390,1.933,-3,2,5
302,ZAL,P003210,P011218,1.25,0,0,0
302,ZAL,P003210,P012715,5.033,-1,9,10
302,ZAL,P003210,P012787,6.833,0,13,13
302,ZAL,P005504,P007513,7.534,-2,12,14
302,ZAL,P005504,P010184,2.117,5,6,1
302,ZAL,P005504,P011218,6.467,-3,10,13
302,ZAL,P005504,P012715,11.5,-4,19,23
302,ZAL,P005504,P012787,4.9,2,11,9
302,ZAL,P006860,P007109,3.717,-2,4,6
302,ZAL,P006860,P007513,1.65,-2,2,4
302,ZAL,P006860,P010184,0.616,2,2,0
302,ZAL,P006860,P010390,1.033,0,2,2
302,ZAL,P006860,P011218,2.817,-2,2,4
302,ZAL,P006860,P012787,1.933,0,4,4
302,ZAL,P007109,P007513,8.517,-7,7,14
302,ZAL,P007109,P010184,6.999,-4,4,8
302,ZAL,P007109,P010390,9.134,-7,10,17
302,ZAL,P007109,P011218,12.334,-9,10,19
302,ZAL,P007109,P012715,1.55,-3,0,3
302,ZAL,P007109,P012787,7.967,-5,9,14
302,ZAL,P007513,P010184,4.633,-1,4,5
302,ZAL,P007513,P010390,14.917,10,30,20
302,ZAL,P007513,P011218,23.001,2,37,35
302,ZAL,P007513,P012715,18.667,5,33,28
302,ZAL,P007513,P012787,2.167,5,5,0
302,ZAL,P010184,P010390,2.466,-3,0,3
302,ZAL,P010184,P011218,6.466,-6,2,8
302,ZAL,P010184,P012715,3.183,0,4,4
302,ZAL,P010184,P012787,5.116,4,8,4
302,ZAL,P010390,P011218,16.601,5,30,25
302,ZAL,P010390,P012715,10.084,12,23,11
302,ZAL,P010390,P012787,7.0,-2,8,10
302,ZAL,P011218,P012715,17.284,3,30,27
302,ZAL,P011218,P012787,4.75,-5,5,10
302,ZAL,P012715,P012787,5.233,3,12,9
303,BAS,P004603,P004761,14.483,-9,28,37
303,BAS,P004603,P007230,0.9,-2,0,2
303,BAS,P004603,P008850,5.883,-3,10,13
303,BAS,P004603,P009048,14.316,-9,28,37
303,BAS,P004603,P011948,8.6,-6,18,24
303,BAS,P004603,P012201,13.583,-7,28,35
303,BAS,P004603,P012765,0.167,0,0,0
303,BAS,P004761,P007230,16.65,18,50,32
303,BAS,P004761,P008850,6.1,-6,10,16
303,BAS,P004761,P009048,32.199,9,78,69
303,BAS,P004761,P010444,21.316,15,59,44
303,BAS,P004761,P011948,28.532,12,74,62
303,BAS,P004761,P012201,20.316,-12,40,52
303,BAS,P004761,P012765,3.6,-3,9,12
303,BAS,P007230,P007946,2.117,0,6,6
303,BAS,P007230,P008850,0.884,-1,4,5
303,BAS,P007230,P009048,17.15,17,48,31
303,BAS,P007230,P010444,19.5,18,56,38
303,BAS,P007230,P011085,1.15,-2,0,2
303,BAS,P007230,P011948,18.349,17,49,32
303,BAS,P007230,P012201,3.767,0,9,9
303,BAS,P007230,P012765,1.133,-1,2,3
303,BAS,P007946,P008850,0.667,2,4,2
303,BAS,P007946,P010444,2.117,0,6,6
303,BAS,P007946,P011948,1.45,-2,2,4
303,BAS,P007946,P012201,2.117,0,6,6
303,BAS,P008850,P009048,5.883,-3,10,13
303,BAS,P008850,P010444,0.884,-1,4,5
303,BAS,P008850,P012201,6.55,-1,14,15
303,BAS,P008850,P012765,0.217,-3,0,3
303,BAS,P009048,P010444,19.483,16,52,36
303,BAS,P009048,P011085,1.6,-2,2,4
303,BAS,P009048,P011948,26.749,10,67,57
303,BAS,P009048,P012201,17.816,-10,35,45
303,BAS,P010444,P011085,1.6,-2,2,4
303,BAS,P010444,P011948,23.465,14,60,46
303,BAS,P010444,P012201,9.783,-5,20,25
303,BAS,P010444,P012765,3.916,-3,9,12
303,BAS,P011085,P011948,1.6,-2,2,4
303,BAS,P011085,P012201,0.45,0,2,2
303,BAS,P011948,P012201,15.649,-11,31,42
303,BAS,P011948,P012765,3.866,0,9,9
303,BAS,P012201,P012765,3.433,-2,7,9
303,VIR,P001133,P001844,18.934,-4,39,43
303,VIR,P001133,P003048,10.517,-1,21,22
303,VIR,P001133,P003527,3.433,4,8,4
303,VIR,P001133,P004007,4.067,-12,4,16
303,VIR,P001133,P004554,7.918,-6,16,22
303,VIR,P001133,P006739,3.901,-4,6,10
303,VIR,P001133,P008847,3.95,1,8,7
303,VIR,P001133,P009549,11.767,1,26,25
303,VIR,P001133,P010781,8.918,1,19,18
303,VIR,P001133,PBCN,16.135,-4,33,37
303,VIR,P001844,P002084,6.584,-2,19,21
303,VIR,P001844,P003048,13.384,0,30,30
303,VIR,P001844,P003527,5.1,7,14,7
303,VIR,P001844,P004007,7.467,-11,15,26
303,VIR,P001844,P004554,8.184,-7,20,27
303,VIR,P001844,P006739,0.45,-2,0,2
303,VIR,P001844,P008847,3.95,1,8,7
303,VIR,P001844,P009549,11.767,1,26,25
303,VIR,P001844,P010781,10.634,6,31,25
303,VIR,P001844,PBCN,15.618,-13,30,43
303,VIR,P002084,P003048,4.951,8,16,8
303,VIR,P002084,P003527,10.084,7,26,19
303,VIR,P002084,P004007,7.534,-5,20,25
303,VIR,P002084,P004554,4.017,-4,11,15
303,VIR,P002084,P006739,10.367,6,25,19
303,VIR,P002084,P008847,8.65,-2,19,21
303,VIR,P002084,P010781,16.201,7,45,38
303,VIR,P002084,PBCN,2.084,-7,3,10
303,VIR,P003048,P003527,3.084,8,11,3
303,VIR,P003048,P004007,1.867,0,5,5
303,VIR,P003048,P006739,2.534,5,7,2
303,VIR,P003048,P009549,9.4,-1,19,20
303,VIR,P003048,P010781,5.618,10,18,8
303,VIR,P003048,PBCN,10.517,-1,21,22
303,VIR,P003527,P006739,7.75,6,18,12
303,VIR,P003527,P008847,10.433,3,23,20
303,VIR,P003527,P010781,13.517,11,34,23
303,VIR,P003527,PBCN,0.667,-2,2,4
303,VIR,P004007,P004554,8.084,-16,15,31
303,VIR,P004007,P006739,4.134,-6,9,15
303,VIR,P004007,P008847,1.65,-1,4,5
303,VIR,P004007,P010781,8.934,-6,23,29
303,VIR,P004007,PBCN,2.667,-11,1,12
303,VIR,P004554,P006739,3.751,-3,7,10
303,VIR,P004554,P009549,2.367,2,7,5
303,VIR,P004554,P010781,6.901,-1,19,20
303,VIR,P004554,PBCN,6.518,-5,13,18
303,VIR,P006739,P008847,7.983,0,17,17
303,VIR,P006739,P010781,13.818,4,31,27
303,VIR,P006739,PBCN,2.384,2,4,2
303,VIR,P008847,P010781,12.6,-1,27,28
303,VIR,P008847,PBCN,1.184,-5,2,7
303,VIR,P009549,PBCN,11.767,1,26,25
303,VIR,P010781,PBCN,3.335,1,9,8
304,ASV,P000229,P002100,-0.017,0,0,0
304,ASV,P000229,P003526,1.016,-2,0,2
304,ASV,P000229,P004194,12.866,10,27,17
304,ASV,P000229,P005094,2.816,-4,3,7
304,ASV,P000229,P006568,0.8,-2,0,2
304,ASV,P000229,P011225,4.749,-5,9,14
304,ASV,P000229,P011386,10.3,12,21,9
304,ASV,P000229,P012080,14.033,9,30,21
304,ASV,P000229,P012731,13.633,10,30,20
304,ASV,P002100,P003526,12.301,6,26,20
304,ASV,P002100,P004194,4.084,2,12,10
304,ASV,P002100,P005094,16.501,4,32,28
304,ASV,P002100,P006568,19.75,-3,34,37
304,ASV,P002100,P011225,20.4,3,42,39
304,ASV,P002100,P011386,3.501,-4,4,8
304,ASV,P002100,P012080,11.6,-7,20,27
304,ASV,P002100,P012731,7.484,-5,14,19
304,ASV,P003526,P004194,0.65,-1,0,1
304,ASV,P003526,P005094,14.35,2,26,24
304,ASV,P003526,P006568,12.6,5,26,21
304,ASV,P003526,P011225,12.75,3,26,23
304,ASV,P003526,P011386,1.6,-1,0,1
304,ASV,P003526,P012731,1.1,-2,0,2
304,ASV,P003526,PKIR,1.033,-2,0,2
304,ASV,P004194,P005094,1.067,-2,0,2
304,ASV,P004194,P011225,5.833,4,16,12
304,ASV,P004194,P011386,11.134,8,23,15
304,ASV,P004194,P012080,16.317,13,39,26
304,ASV,P004194,P012731,15.917,14,39,25
304,ASV,P005094,P006568,16.8,3,32,29
304,ASV,P005094,P011225,16.616,0,33,33
304,ASV,P005094,P011386,3.734,-2,2,4
304,ASV,P005094,P012080,6.0,-4,9,13
304,ASV,P005094,P012731,2.483,-3,3,6
304,ASV,P005094,PKIR,1.033,-2,0,2
304,ASV,P006568,P011225,17.883,-5,32,37
304,ASV,P006568,P011386,2.667,0,2,2
304,ASV,P006568,P012080,7.95,-10,8,18
304,ASV,P006568,P012731,3.75,-8,2,10
304,ASV,P011225,P012080,13.449,-7,25,32
304,ASV,P011225,P012731,12.083,-7,21,28
304,ASV,P011225,PKIR,1.033,-2,0,2
304,ASV,P011386,P012080,12.201,9,25,16
304,ASV,P011386,P012731,10.067,10,23,13
304,ASV,P012080,P012731,21.05,5,44,39
304,ASV,P012731,PKIR,1.033,-2,0,2
304,BAR,P000925,P002939,5.233,-1,12,13
304,BAR,P000925,P003204,1.967,2,6,4
304,BAR,P000925,P003478,9.55,3,17,14
304,BAR,P000925,P004866,5.833,-1,12,13
304,BAR,P000925,P007464,0.817,3,5,2
304,BAR,P000925,P007519,9.55,3,17,14
304,BAR,P000925,P009992,6.65,2,17,15
304,BAR,P000925,P011244,8.367,3,15,12
304,BAR,P000925,P012745,7.833,2,19,17
304,BAR,P000925,PLFW,9.0,4,16,12
304,BAR,P002939,P004866,5.233,-1,12,13
304,BAR,P002939,P007464,6.383,-6,7,13
304,BAR,P002939,P009992,11.616,-7,19,26
304,BAR,P002939,P010641,6.383,-6,7,13
304,BAR,P002939,P011244,1.6,-2,0,2
304,BAR,P002939,P012745,10.016,-5,19,24
304,BAR,P003204,P003478,7.85,2,16,14
304,BAR,P003204,P004866,3.033,3,6,3
304,BAR,P003204,P007464,3.249,-6,4,10
304,BAR,P003204,P007519,5.3,-3,11,14
304,BAR,P003204,P010641,10.366,0,18,18
304,BAR,P003204,P011244,6.634,5,14,9
304,BAR,P003204,P012745,2.483,3,6,3
304,BAR,P003204,PLFW,8.582,2,15,13
304,BAR,P003478,P007464,4.633,-1,10,11
304,BAR,P003478,P007519,14.95,2,29,27
304,BAR,P003478,P010641,9.4,1,19,18
304,BAR,P003478,P011244,11.567,7,24,17
304,BAR,P003478,P012745,2.783,-2,2,4
304,BAR,P003478,PLFW,15.199,4,27,23
304,BAR,P004866,P009992,6.85,2,15,13
304,BAR,P004866,P010641,4.05,6,9,3
304,BAR,P004866,P011244,2.15,-2,0,2
304,BAR,P004866,P012745,7.733,7,21,14
304,BAR,P004866,PLFW,4.65,6,9,3
304,BAR,P007464,P007519,5.983,-6,10,16
304,BAR,P007464,P009992,8.05,-5,13,18
304,BAR,P007464,P010641,14.916,-17,20,37
304,BAR,P007464,P012745,9.65,-10,13,23
304,BAR,P007464,PLFW,9.383,-8,18,26
304,BAR,P007519,P010641,8.45,-9,14,23
304,BAR,P007519,P011244,9.267,2,19,17
304,BAR,P007519,P012745,4.383,-7,2,9
304,BAR,P007519,PLFW,14.249,-6,22,28
304,BAR,P009992,P010641,8.25,-5,11,16
304,BAR,P009992,P011244,1.6,-2,0,2
304,BAR,P009992,P012745,13.3,-1,28,29
304,BAR,P009992,PLFW,3.284,4,9,5
304,BAR,P010641,P011244,5.35,2,9,7
304,BAR,P010641,P012745,12.333,-7,17,24
304,BAR,P010641,PLFW,15.566,-1,28,29
304,BAR,P011244,PLFW,8.333,7,15,8
304,BAR,P012745,PLFW,10.15,0,17,17
305,OLY,P001255,P006589,10.884,-3,18,21
305,OLY,P001255,P007853,7.784,-1,16,17
305,OLY,P001255,P007982,3.65,-5,1,6
305,OLY,P001255,P008811,21.684,0,40,40
305,OLY,P001255,P008829,9.45,-8,10,18
305,OLY,P001255,P008855,23.618,-1,44,45
305,OLY,P001255,P010612,23.884,-5,43,48
305,OLY,P001255,P012878,4.25,-5,4,9
305,OLY,P003941,P007853,4.45,-2,7,9
305,OLY,P003941,P007982,2.633,-3,4,7
305,OLY,P003941,P008829,4.45,-2,7,9
305,OLY,P003941,P008855,4.45,-2,7,9
305,OLY,P003941,P010612,1.817,1,3,2
305,OLY,P006589,P007853,10.1,4,18,14
305,OLY,P006589,P007982,12.449,6,24,18
305,OLY,P006589,P008811,10.933,10,28,18
305,OLY,P006589,P008855,9.234,5,20,15
305,OLY,P006589,P010392,8.733,10,22,12
305,OLY,P006589,P010612,10.917,3,24,21
305,OLY,P006589,P012878,9.35,1,14,13
305,OLY,P007853,P007982,17.816,4,32,28
305,OLY,P007853,P008811,13.75,5,31,26
305,OLY,P007853,P008829,8.933,-2,16,18
305,OLY,P007853,P008855,13.817,3,31,28
305,OLY,P007853,P010392,9.733,6,19,13
305,OLY,P007853,P010612,7.267,4,20,16
305,OLY,P007853,P012878,6.35,3,10,7
305,OLY,P007982,P008811,10.233,5,22,17
305,OLY,P007982,P008829,7.116,-3,13,16
305,OLY,P007982,P008855,6.633,1,13,12
305,OLY,P007982,P010392,11.216,9,25,16
305,OLY,P007982,P010612,2.799,2,8,6
305,OLY,P007982,P012878,7.583,0,10,10
305,OLY,P008811,P008829,13.85,-10,17,27
305,OLY,P008811,P008855,23.401,-1,44,45
305,OLY,P008811,P010392,7.149,5,17,12
305,OLY,P008811,P010612,22.0,2,45,43
305,OLY,P008829,P008855,15.9,-9,23,32
305,OLY,P008829,P010392,2.483,-1,3,4
305,OLY,P008829,P010612,11.35,-5,15,20
305,OLY,P008855,P010612,24.551,1,48,47
305,OLY,P008855,P012878,2.8,3,6,3
305,OLY,P010392,P010612,1.483,3,6,3
305,OLY,P010392,P012878,4.067,4,8,4
305,OLY,P010612,P012878,3.0,-2,4,6
305,ULK,P001932,P002968,15.767,6,29,23
305,ULK,P001932,P004004,9.783,1,21,20
305,ULK,P001932,P005844,13.45,-8,20,28
305,ULK,P001932,P006068,5.867,-7,5,12
305,ULK,P001932,P006661,13.933,-12,23,35
305,ULK,P001932,P006961,6.916,-4,13,17
305,ULK,P001932,P008962,24.2,7,50,43
305,ULK,P001932,P009849,14.818,11,29,18
305,ULK,P001932,P010560,14.784,5,27,22
305,ULK,P001932,P011980,0.75,1,3,2
305,ULK,P002968,P004004,5.05,2,9,7
305,ULK,P002968,P006068,1.067,-1,0,1
305,ULK,P002968,P006661,8.917,-9,8,17
305,ULK,P002968,P006961,4.716,-1,5,6
305,ULK,P002968,P008962,20.783,6,38,32
305,ULK,P002968,P009849,11.7,11,27,16
305,ULK,P002968,P010560,13.317,7,27,20
305,ULK,P002968,P011052,6.083,-1,9,10
305,ULK,P004004,P005844,12.366,-3,25,28
305,ULK,P004004,P006068,7.733,-1,16,17
305,ULK,P004004,P006661,16.283,-3,34,37
305,ULK,P004004,P006961,9.066,3,22,19
305,ULK,P004004,P008962,9.783,1,21,20
305,ULK,P005844,P006068,12.9,-7,21,28
305,ULK,P005844,P006661,16.466,-9,30,39
305,ULK,P005844,P006961,11.583,-5,21,26
305,ULK,P005844,P008962,9.4,-3,16,19
305,ULK,P005844,P009849,5.834,-1,7,8
305,ULK,P005844,P010560,6.084,-3,7,10
305,ULK,P005844,P011052,1.117,-1,1,2
305,ULK,P006068,P006661,12.9,-8,21,29
305,ULK,P006068,P006961,12.65,-6,21,27
305,ULK,P006068,P009849,1.067,0,0,0
305,ULK,P006068,P010560,1.317,-2,0,2
305,ULK,P006068,P011052,0.367,0,0,0
305,ULK,P006661,P006961,15.166,-8,26,34
305,ULK,P006661,P008962,12.583,-9,20,29
305,ULK,P006661,P010560,1.867,-6,0,6
305,ULK,P006661,P011052,3.817,-4,2,6
305,ULK,P006961,P008962,4.199,1,10,9
305,ULK,P006961,P009849,0.367,2,2,0
305,ULK,P006961,P010560,0.083,-2,0,2
305,ULK,P006961,P011052,2.2,0,2,2
305,ULK,P006961,P011980,0.45,0,2,2
305,ULK,P008962,P009849,17.134,13,37,24
305,ULK,P008962,P010560,18.467,5,35,30
305,ULK,P008962,P011052,6.833,-2,10,12
305,ULK,P008962,P011980,0.75,1,3,2
305,ULK,P009849,P010560,17.834,11,35,24
305,ULK,P009849,P011052,3.383,2,8,6
305,ULK,P009849,P011980,0.667,3,3,0
305,ULK,P010560,P011052,5.0,-2,8,10
305,ULK,P010560,P011980,0.383,-1,1,2
306,PAM,P000556,P005356,5.217,2,9,7
306,PAM,P000556,P006643,6.317,-8,8,16
306,PAM,P000556,P007870,9.583,-2,17,19
306,PAM,P000556,P010393,4.484,-1,6,7
306,PAM,P000556,P010568,5.1,8,16,8
306,PAM,P000556,P010750,11.817,-3,19,22
306,PAM,P000556,P011970,13.583,-4,24,28
306,PAM,P000556,P011982,9.583,-2,17,19
306,PAM,P000556,P012738,5.833,1,14,13
306,PAM,P000556,P012740,4.083,-7,6,13
306,PAM,P000556,P012795,4.0,8,12,4
306,PAM,P005356,P006643,5.95,-5,7,12
306,PAM,P005356,P007870,2.183,5,7,2
306,PAM,P005356,P010393,14.617,-13,18,31
306,PAM,P005356,P010568,8.667,-8,11,19
306,PAM,P005356,P010750,6.683,-2,10,12
306,PAM,P005356,P011970,1.45,2,4,2
306,PAM,P005356,P011982,2.183,5,7,2
306,PAM,P005356,P012738,7.05,-10,7,17
306,PAM,P005356,P012795,13.2,-8,20,28
306,PAM,P006643,P007870,3.017,-3,4,7
306,PAM,P006643,P010393,10.383,-5,14,19
306,PAM,P006643,P010568,6.383,-8,8,16
306,PAM,P006643,P010750,6.517,-3,9,12
306,PAM,P006643,P011970,4.517,0,9,9
306,PAM,P006643,P011982,4.617,0,9,9
306,PAM,P006643,P012738,6.283,-8,8,16
306,PAM,P006643,P012740,10.333,-10,15,25
306,PAM,P006643,P012795,3.083,-2,5,7
306,PAM,P007870,P010568,2.45,-5,2,7
306,PAM,P007870,P010750,10.584,4,21,17
306,PAM,P007870,P011970,11.934,1,22,21
306,PAM,P007870,P011982,15.117,-1,27,28
306,PAM,P007870,P012740,3.083,-7,2,9
306,PAM,P007870,P012795,2.517,4,6,2
306,PAM,P010393,P010568,11.5,-11,13,24
306,PAM,P010393,P010750,5.95,-5,7,12
306,PAM,P010393,P011970,1.6,3,5,2
306,PAM,P010393,P011982,1.6,3,5,2
306,PAM,P010393,P012738,9.883,-13,9,22
306,PAM,P010393,P012740,4.433,0,7,7
306,PAM,P010393,P012795,11.75,-10,16,26
306,PAM,P010568,P011970,2.383,6,8,2
306,PAM,P010568,P011982,2.45,-5,2,7
306,PAM,P010568,P012738,13.366,-7,21,28
306,PAM,P010568,P012740,6.383,-8,8,16
306,PAM,P010568,P012795,11.05,-2,19,21
306,PAM,P010750,P011970,9.851,1,18,17
306,PAM,P010750,P011982,10.584,4,21,17
306,PAM,P010750,P012795,4.15,0,7,7
306,PAM,P011970,P011982,13.534,4,27,23
306,PAM,P011970,P012738,4.733,1,10,9
306,PAM,P011970,P012740,4.583,-4,7,11
306,PAM,P011970,P012795,4.9,10,14,4
306,PAM,P011982,P012740,4.683,-4,7,11
306,PAM,P011982,P012795,2.517,4,6,2
306,PAM,P012738,P012740,6.283,-8,8,16
306,PAM,P012738,P012795,9.433,-4,15,19
306,PAR,P000956,P003983,5.317,-2,8,10
306,PAR,P000956,P007400,6.317,-2,10,12
306,PAR,P000956,P008987,6.317,-2,10,12
306,PAR,P000956,P009862,1.0,0,2,2
306,PAR,P000956,P011051,0.217,1,1,0
306,PAR,P000956,P012743,6.1,-3,9,12
306,PAR,P003983,P004172,13.867,8,29,21
306,PAR,P003983,P007400,5.384,0,10,10
306,PAR,P003983,P008987,11.383,-4,15,19
306,PAR,P003983,P009862,10.8,6,22,16
306,PAR,P003983,P011192,13.767,8,29,21
306,PAR,P003983,P012096,9.733,8,20,12
306,PAR,P003983,P012743,9.017,0,15,15
306,PAR,P004172,P007400,10.817,4,25,21
306,PAR,P004172,P008987,8.45,-6,12,18
306,PAR,P004172,P009862,20.917,8,45,37
306,PAR,P004172,P011051,2.95,-4,5,9
306,PAR,P004172,P011192,20.934,14,47,33
306,PAR,P004172,P012096,9.1,8,20,12
306,PAR,P004172,P012743,11.433,8,25,17
306,PAR,P007400,P008987,17.767,-1,32,33
306,PAR,P007400,P009862,20.25,9,44,35
306,PAR,P007400,P011051,3.167,-3,6,9
306,PAR,P007400,P011192,16.3,13,37,24
306,PAR,P007400,P012096,7.35,1,13,12
306,PAR,P007400,P012743,14.916,7,31,24
306,PAR,P008987,P009862,14.816,-3,24,27
306,PAR,P008987,P011051,3.167,-3,6,9
306,PAR,P008987,P011192,13.833,3,24,21
306,PAR,P008987,P012096,8.716,1,13,12
306,PAR,P008987,P012743,10.883,3,20,17
306,PAR,P009862,P011051,3.167,-3,6,9
306,PAR,P009862,P011192,26.3,17,57,40
306,PAR,P009862,P012096,17.083,9,33,24
306,PAR,P009862,P012743,9.599,9,23,14
306,PAR,P011192,P012096,16.35,9,33,24
306,PAR,P011192,P012743,12.516,12,29,17
307,BAS,P003198,P004603,4.15,-1,9,10
307,BAS,P003198,P004761,0.55,-4,0,4
307,BAS,P003198,P007230,4.15,-1,9,10
307,BAS,P003198,P008850,0.6,2,2,0
307,BAS,P003198,P009048,5.95,1,15,14
307,BAS,P003198,P010444,2.35,-2,6,8
307,BAS,P003198,P011085,4.233,-6,10,16
307,BAS,P003198,P011948,1.667,1,3,2
307,BAS,P003198,P012765,2.35,-2,6,8
307,BAS,P004603,P004761,11.083,-18,15,33
307,BAS,P004603,P007230,23.366,-7,51,58
307,BAS,P004603,P007946,4.2,5,13,8
307,BAS,P004603,P008850,0.6,2,2,0
307,BAS,P004603,P009048,25.666,-11,56,67
307,BAS,P004603,P011085,10.033,0,26,26
307,BAS,P004603,P011948,16.333,-5,42,47
307,BAS,P004603,P012201,7.233,-9,10,19
307,BAS,P004761,P007230,15.766,-24,22,46
307,BAS,P004761,P007946,3.75,-4,9,13
307,BAS,P004761,P009048,14.383,-21,23,44
307,BAS,P004761,P010444,8.867,-13,17,30
307,BAS,P004761,P011085,2.984,-3,3,6
307,BAS,P004761,P011948,12.033,-23,24,47
307,BAS,P004761,P012201,8.567,-8,15,23
307,BAS,P004761,P012765,1.817,-6,0,6
307,BAS,P007230,P007946,7.95,1,22,21
307,BAS,P007230,P008850,0.767,2,2,0
307,BAS,P007230,P009048,26.366,-14,54,68
307,BAS,P007230,P010444,10.65,-16,18,34
307,BAS,P007230,P011085,13.7,-6,32,38
307,BAS,P007230,P011948,24.516,-17,55,72
307,BAS,P007230,P012201,4.933,-5,5,10
307,BAS,P007230,P012765,3.9,-5,6,11
307,BAS,P007946,P009048,4.2,5,13,8
307,BAS,P007946,P010444,3.75,-4,9,13
307,BAS,P007946,P011948,7.95,1,22,21
307,BAS,P008850,P009048,0.6,2,2,0
307,BAS,P008850,P010444,0.167,0,0,0
307,BAS,P008850,P011085,0.167,0,0,0
307,BAS,P008850,P012765,0.167,0,0,0
307,BAS,P009048,P010444,5.617,-4,14,18
307,BAS,P009048,P011085,12.35,-1,32,33
307,BAS,P009048,P011948,20.15,-11,50,61
307,BAS,P009048,P012201,8.05,-8,15,23
307,BAS,P009048,P012765,1.8,2,6,4
307,BAS,P010444,P011085,6.534,-8,12,20
307,BAS,P010444,P011948,11.3,-15,23,38
307,BAS,P010444,P012201,1.334,1,5,4
307,BAS,P010444,P012765,6.767,-7,12,19
307,BAS,P011085,P011948,9.733,-3,25,28
307,BAS,P011085,P012201,0.517,0,0,0
307,BAS,P011085,P012765,6.017,-5,12,17
307,BAS,P011948,P012201,3.117,-3,10,13
307,BAS,P011948,P012765,3.733,-5,6,11
307,BAS,P012201,P012765,0.517,0,0,0
307,TEL,P005145,P009622,12.233,8,30,22
307,TEL,P005145,P009783,12.233,8,30,22
307,TEL,P005145,P009863,12.233,8,30,22
307,TEL,P005145,P011193,1.917,-1,2,3
307,TEL,P005145,P011199,12.233,8,30,22
307,TEL,P005145,P011214,1.917,-1,2,3
307,TEL,P005145,P012095,1.917,-1,2,3
307,TEL,P005145,P012744,1.917,-1,2,3
307,TEL,P009622,P009783,22.233,28,70,42
307,TEL,P009622,P009863,22.316,26,66,40
307,TEL,P009622,P011193,9.884,14,33,19
307,TEL,P009622,P011199,22.3,28,72,44
307,TEL,P009622,P011214,7.401,4,15,11
307,TEL,P009622,P011971,11.985,10,33,23
307,TEL,P009622,P012744,10.384,10,29,19
307,TEL,P009783,P009863,23.632,21,69,48
307,TEL,P009783,P011193,5.9,3,19,16
307,TEL,P009783,P011199,24.216,21,73,52
307,TEL,P009783,P011214,0.7,0,0,0
307,TEL,P009783,P011971,7.217,-1,19,20
307,TEL,P009783,P012744,3.533,4,12,8
307,TEL,P009863,P011193,10.933,5,36,31
307,TEL,P009863,P011199,23.099,21,69,48
307,TEL,P009863,P011214,7.617,2,21,19
307,TEL,P009863,P011971,14.134,1,40,39
307,TEL,P009863,P012744,8.9,8,29,21
307,TEL,P011193,P011199,6.483,3,21,18
307,TEL,P011193,P011214,13.718,7,38,31
307,TEL,P011193,P011971,15.234,1,41,40
307,TEL,P011193,P012095,1.917,-1,2,3
307,TEL,P011193,P012744,14.818,9,44,35
307,TEL,P011199,P011214,0.017,0,0,0
307,TEL,P011199,P011971,7.817,-1,21,22
307,TEL,P011199,P012744,3.767,4,14,10
307,TEL,P011214,P011971,12.585,8,36,28
307,TEL,P011214,P012095,1.917,-1,2,3
307,TEL,P011214,P012744,14.268,9,38,29
307,TEL,P011971,P012744,12.568,10,38,28
307,TEL,P012095,P012744,1.917,-1,2,3
308,IST,P004888,P006590,13.133,2,20,18
308,IST,P004888,P007200,25.849,4,47,43
308,IST,P004888,P009513,15.916,3,32,29
308,IST,P004888,P009664,5.683,-2,6,8
308,IST,P004888,P009846,3.916,2,7,5
308,IST,P004888,P011078,3.2,1,5,4
308,IST,P004888,P011981,10.066,2,17,15
308,IST,P004888,P012710,11.45,2,25,23
308,IST,P004888,P012788,5.95,-6,4,10
308,IST,P004888,PLHK,21.033,12,45,33
308,IST,P006590,P007200,11.5,-3,15,18
308,IST,P006590,P009664,9.716,0,10,10
308,IST,P006590,P009846,12.083,-6,13,19
308,IST,P006590,P011078,9.8,-3,11,14
308,IST,P006590,P011981,7.317,-6,10,16
308,IST,P006590,P012710,2.417,-3,2,5
308,IST,P006590,P012788,9.983,-4,8,12
308,IST,P006590,PLHK,9.251,-1,15,16
308,IST,P007200,P009513,15.916,3,32,29
308,IST,P007200,P009664,6.383,2,12,10
308,IST,P007200,P009846,8.266,-2,13,15
308,IST,P007200,P011078,2.783,0,6,6
308,IST,P007200,P011981,13.299,-7,18,25
308,IST,P007200,P012710,11.45,2,25,23
308,IST,P007200,P012788,4.7,-4,4,8
308,IST,P007200,PLHK,20.65,5,40,35
308,IST,P009513,P011981,6.883,-2,9,11
308,IST,P009513,P012710,9.033,5,23,18
308,IST,P009513,PLHK,15.916,3,32,29
308,IST,P009664,P009846,6.816,2,10,8
308,IST,P009664,P011078,8.899,-2,10,12
308,IST,P009664,P011981,3.916,1,9,8
308,IST,P009664,P012788,5.283,0,4,4
308,IST,P009664,PLHK,3.3,-1,3,4
308,IST,P009846,P011078,9.383,-4,12,16
308,IST,P009846,P011981,7.05,-10,8,18
308,IST,P009846,P012788,7.766,1,8,7
308,IST,P009846,PLHK,4.184,-7,5,12
308,IST,P011078,P011981,6.467,-1,13,14
308,IST,P011078,P012788,5.283,0,4,4
308,IST,P011078,PLHK,4.517,-3,7,10
308,IST,P011981,P012710,0.8,-2,0,2
308,IST,P011981,PLHK,12.134,-7,16,23
308,IST,P012710,P012788,0.967,-3,0,3
308,IST,P012710,PLHK,9.683,7,25,18
308,VIR,P001133,P001844,12.482,-18,17,35
308,VIR,P001133,P002084,2.0,-5,0,5
308,VIR,P001133,P003048,17.433,-4,33,37
308,VIR,P001133,P003527,5.65,3,9,6
308,VIR,P001133,P006739,13.134,7,28,21
308,VIR,P001133,P008847,2.567,5,5,0
308,VIR,P001133,P009549,5.5,-5,7,12
308,VIR,P001133,P010781,13.15,8,24,16
308,VIR,P001133,PBCN,16.616,-7,29,36
308,VIR,P001844,P002084,12.1,0,19,19
308,VIR,P001844,P003048,12.766,-14,19,33
308,VIR,P001844,P003527,14.733,-2,21,23
308,VIR,P001844,P004554,10.567,4,19,15
308,VIR,P001844,P006739,3.483,-7,7,14
308,VIR,P001844,P008847,0.933,-2,0,2
308,VIR,P001844,P009549,5.5,-5,7,12
308,VIR,P001844,P010781,16.016,-2,24,26
308,VIR,P001844,PBCN,11.416,-10,19,29
308,VIR,P002084,P003527,15.933,-1,23,24
308,VIR,P002084,P004554,12.5,5,23,18
308,VIR,P002084,P006739,3.25,-5,0,5
308,VIR,P002084,P008847,2.783,-4,0,4
308,VIR,P002084,P009549,1.933,1,4,3
308,VIR,P002084,P010781,17.283,-4,23,27
308,VIR,P002084,PBCN,1.35,-3,0,3
308,VIR,P003048,P003527,4.884,6,10,4
308,VIR,P003048,P006739,10.734,9,27,18
308,VIR,P003048,P009549,5.5,-5,7,12
308,VIR,P003048,P010781,11.034,14,25,11
308,VIR,P003048,PBCN,17.717,2,35,33
308,VIR,P003527,P004554,12.5,5,23,18
308,VIR,P003527,P006739,6.851,11,13,2
308,VIR,P003527,P008847,5.35,1,5,4
308,VIR,P003527,P009549,1.933,1,4,3
308,VIR,P003527,P010781,23.517,10,38,28
308,VIR,P003527,PBCN,2.717,6,6,0
308,VIR,P004554,P009549,1.933,1,4,3
308,VIR,P004554,P010781,12.5,5,23,18
308,VIR,P006739,P008847,4.417,3,5,2
308,VIR,P006739,P010781,13.068,16,25,9
308,VIR,P006739,PBCN,11.267,2,23,21
308,VIR,P008847,P010781,5.35,1,5,4
308,VIR,P009549,P010781,1.933,1,4,3
308,VIR,P009549,PBCN,5.5,-5,7,12
308,VIR,P010781,PBCN,10.217,11,21,10
309,BAS,P003198,P004761,0.717,-2,0,2
309,BAS,P003198,P008850,3.75,-5,5,10
309,BAS,P003198,P009048,3.75,-5,5,10
309,BAS,P003198,P010444,3.75,-5,5,10
309,BAS,P003198,P011948,3.033,-3,5,8
309,BAS,P004603,P004761,9.3,-2,20,22
309,BAS,P004603,P007230,16.933,13,43,30
309,BAS,P004603,P008850,3.15,0,6,6
309,BAS,P004603,P009048,15.383,17,43,26
309,BAS,P004603,P010444,0.5,3,3,0
309,BAS,P004603,P011085,11.483,11,29,18
309,BAS,P004603,P011948,10.933,23,37,14
309,BAS,P004603,P012765,2.05,-1,3,4
309,BAS,P004761,P007230,22.366,-4,49,53
309,BAS,P004761,P008850,2.5,-10,0,10
309,BAS,P004761,P009048,22.583,-2,49,51
309,BAS,P004761,P010444,13.783,-4,29,33
309,BAS,P004761,P011085,9.933,0,19,19
309,BAS,P004761,P011948,10.65,4,30,26
309,BAS,P004761,P012765,0.5,-4,0,4
309,BAS,P007230,P008850,6.05,-3,7,10
309,BAS,P007230,P009048,31.083,13,73,60
309,BAS,P007230,P010444,18.817,1,38,37
309,BAS,P007230,P011085,21.767,15,48,33
309,BAS,P007230,P011948,21.317,20,58,38
309,BAS,P007230,P012765,4.667,1,8,7
309,BAS,P008850,P009048,8.25,-4,12,16
309,BAS,P008850,P010444,7.65,-2,12,14
309,BAS,P008850,P011085,2.717,2,4,2
309,BAS,P008850,P011948,5.083,3,11,8
309,BAS,P008850,P012765,2.05,-1,3,4
309,BAS,P009048,P010444,20.45,-3,41,44
309,BAS,P009048,P011085,19.15,13,43,30
309,BAS,P009048,P011948,20.683,15,58,43
309,BAS,P010444,P011085,10.284,4,19,15
309,BAS,P010444,P011948,14.417,0,32,32
309,BAS,P010444,P012765,2.617,2,5,3
309,BAS,P011085,P011948,9.117,13,25,12
309,BAS,P011085,P012765,2.617,2,5,3
309,BAS,P011948,P012765,4.167,5,8,3
309,VIR,P001133,P001844,17.802,-13,26,39
309,VIR,P001133,P002084,1.533,2,4,2
309,VIR,P001133,P003048,10.084,-15,12,27
309,VIR,P001133,P003527,5.968,3,12,9
309,VIR,P001133,P004554,7.917,-5,18,23
309,VIR,P001133,P006739,11.134,-6,20,26
309,VIR,P001133,P008847,0.317,0,0,0
309,VIR,P001133,P009549,14.567,-19,17,36
309,VIR,P001133,P010781,6.417,-3,14,17
309,VIR,P001133,PBCN,15.001,-12,25,37
309,VIR,P001844,P002084,5.25,-2,9,11
309,VIR,P001844,P003048,12.267,-13,19,32
309,VIR,P001844,P003527,9.051,-1,15,16
309,VIR,P001844,P004554,3.034,-1,7,8
309,VIR,P001844,P006739,6.251,-2,9,11
309,VIR,P001844,P008847,4.034,-4,5,9
309,VIR,P001844,P009549,15.651,-12,24,36
309,VIR,P001844,P010781,3.917,-2,6,8
309,VIR,P001844,PBCN,17.551,-10,32,42
309,VIR,P002084,P003527,12.333,-2,25,27
309,VIR,P002084,P004007,0.483,-1,1,2
309,VIR,P002084,P004554,3.85,5,10,5
309,VIR,P002084,P006739,5.916,2,13,11
309,VIR,P002084,P008847,10.2,-3,20,23
309,VIR,P002084,P009549,7.767,4,19,15
309,VIR,P002084,P010781,13.199,2,29,27
309,VIR,P002084,PBCN,3.733,5,10,5
309,VIR,P003048,P003527,3.15,4,9,5
309,VIR,P003048,P006739,3.217,-3,5,8
309,VIR,P003048,P009549,8.433,-9,13,22
309,VIR,P003048,P010781,1.817,3,5,2
309,VIR,P003048,PBCN,12.5,-11,21,32
309,VIR,P003527,P004007,0.483,-1,1,2
309,VIR,P003527,P004554,4.467,4,13,9
309,VIR,P003527,P006739,10.483,3,23,20
309,VIR,P003527,P008847,10.15,-3,20,23
309,VIR,P003527,P009549,9.651,4,21,17
309,VIR,P003527,P010781,15.1,3,34,31
309,VIR,P003527,PBCN,3.5,6,11,5
309,VIR,P004007,P006739,0.483,-1,1,2
309,VIR,P004007,P010781,0.483,-1,1,2
309,VIR,P004554,P006739,5.9,-2,14,16
309,VIR,P004554,P009549,8.3,-4,16,20
309,VIR,P004554,P010781,8.733,1,21,20
309,VIR,P004554,PBCN,4.867,2,13,11
309,VIR,P006739,P008847,5.333,3,12,9
309,VIR,P006739,P009549,4.55,-7,3,10
309,VIR,P006739,P010781,10.799,-2,24,26
309,VIR,P006739,PBCN,4.134,-1,8,9
309,VIR,P008847,P009549,2.484,-3,5,8
309,VIR,P008847,P010781,9.183,-2,18,20
309,VIR,P008847,PBCN,0.367,0,0,0
309,VIR,P009549,P010781,7.933,-1,17,18
309,VIR,P009549,PBCN,15.0,-5,29,34
309,VIR,P010781,PBCN,3.283,6,11,5
310,BAS,P003198,P004603,5.85,0,8,8
310,BAS,P003198,P004761,5.916,-3,10,13
310,BAS,P003198,P008850,7.3,2,13,11
310,BAS,P003198,P009048,1.333,0,2,2
310,BAS,P003198,P010444,7.916,-6,15,21
310,BAS,P003198,P011085,7.85,-3,13,16
310,BAS,P003198,P011948,6.466,-8,10,18
310,BAS,P003198,P012765,12.433,-6,21,27
310,BAS,P004603,P004761,7.433,-10,9,19
310,BAS,P004603,P007230,7.883,-4,14,18
310,BAS,P004603,P008850,4.167,4,8,4
310,BAS,P004603,P009048,7.883,-4,14,18
310,BAS,P004603,P011085,10.333,2,17,15
310,BAS,P004603,P011948,3.4,-6,5,11
310,BAS,P004603,P012765,7.983,2,13,11
310,BAS,P004761,P007230,22.417,-3,45,48
310,BAS,P004761,P008850,0.267,1,1,0
310,BAS,P004761,P009048,22.417,-3,45,48
310,BAS,P004761,P010444,20.9,4,46,42
310,BAS,P004761,P011085,10.866,-1,27,28
310,BAS,P004761,P011948,17.2,-6,27,33
310,BAS,P004761,P012765,5.916,-3,10,13
310,BAS,P007230,P008850,0.267,1,1,0
310,BAS,P007230,P009048,26.233,-10,51,61
310,BAS,P007230,P010444,18.35,-6,37,43
310,BAS,P007230,P011085,14.682,-8,33,41
310,BAS,P007230,P011948,12.217,-12,18,30
310,BAS,P007230,P012765,2.883,2,5,3
310,BAS,P008850,P009048,1.6,1,3,2
310,BAS,P008850,P010444,3.4,-1,6,7
310,BAS,P008850,P011085,7.3,2,13,11
310,BAS,P008850,P012765,5.967,2,11,9
310,BAS,P009048,P010444,19.683,-6,39,45
310,BAS,P009048,P011085,16.015,-8,35,43
310,BAS,P009048,P011948,12.217,-12,18,30
310,BAS,P009048,P012765,2.883,2,5,3
310,BAS,P010444,P011085,12.199,-13,29,42
310,BAS,P010444,P011948,15.283,-14,23,37
310,BAS,P010444,P012765,7.333,-6,13,19
310,BAS,P011085,P011948,1.483,-14,1,15
310,BAS,P011085,P012765,9.4,-1,16,17
310,BAS,P011948,P012765,6.466,-8,10,18
310,MAD,P001392,P003108,0.033,0,0,0
310,MAD,P001392,P004887,0.083,-2,0,2
310,MAD,P001392,P009005,0.083,-2,0,2
310,MAD,P001392,PCVM,0.083,-2,0,2
310,MAD,P001392,PTGB,0.05,-2,0,2
310,MAD,P003108,P004887,2.833,-4,0,4
310,MAD,P003108,P005791,11.2,12,32,20
310,MAD,P003108,P005928,11.383,9,28,19
310,MAD,P003108,P006540,10.483,11,29,18
310,MAD,P003108,P009005,3.45,-4,0,4
310,MAD,P003108,P010357,10.85,12,32,20
310,MAD,P003108,PCVM,3.184,-1,4,5
310,MAD,P003108,PTGB,3.784,-3,3,6
310,MAD,P003733,P004887,12.601,-3,24,27
310,MAD,P003733,P005791,0.533,-2,0,2
310,MAD,P003733,P009005,5.85,0,8,8
310,MAD,P003733,P010357,10.417,-9,20,29
310,MAD,P003733,PBMT,5.567,-7,9,16
310,MAD,P003733,PCVM,10.784,-4,21,25
310,MAD,P003733,PTGB,6.784,5,14,9
310,MAD,P004887,P005928,2.183,-4,0,4
310,MAD,P004887,P006540,1.483,-2,0,2
310,MAD,P004887,P009005,13.85,1,24,23
310,MAD,P004887,P010357,9.884,-7,20,27
310,MAD,P004887,PBMT,11.217,-2,25,27
310,MAD,P004887,PCVM,16.601,1,37,36
310,MAD,P004887,PTGB,13.801,6,30,24
310,MAD,P005791,P005928,15.8,23,46,23
310,MAD,P005791,P006540,15.6,23,47,24
310,MAD,P005791,P009005,8.017,8,18,10
310,MAD,P005791,P010357,17.983,20,50,30
310,MAD,P005791,PCVM,2.8,-3,4,7
310,MAD,P005791,PTGB,2.467,-1,3,4
310,MAD,P005928,P006540,15.7,22,43,21
310,MAD,P005928,P009005,9.05,6,18,12
310,MAD,P005928,P010357,16.067,23,46,23
310,MAD,P005928,PCVM,0.267,0,0,0
310,MAD,P005928,PTGB,2.55,-3,3,6
310,MAD,P006540,P009005,8.35,8,18,10
310,MAD,P006540,P010357,15.867,23,47,24
310,MAD,P006540,PCVM,1.917,-1,4,5
310,MAD,P009005,P010357,10.0,6,22,16
310,MAD,P009005,PBMT,5.65,5,16,11
310,MAD,P009005,PCVM,12.817,3,24,21
310,MAD,P009005,PTGB,10.351,5,20,15
310,MAD,P010357,PBMT,5.567,-7,9,16
310,MAD,P010357,PCVM,9.984,-9,21,30
310,MAD,P010357,PTGB,5.917,0,13,13
310,MAD,PBMT,PCVM,8.867,-1,22,23
310,MAD,PBMT,PTGB,8.0,4,19,15
310,MAD,PCVM,PTGB,11.368,9,27,18
311,BAR,P000925,P002939,12.366,-10,15,25
311,BAR,P000925,P003478,2.866,-4,5,9
311,BAR,P000925,P004866,17.767,-5,27,32
311,BAR,P000925,P006435,17.633,-7,28,35
311,BAR,P000925,P007519,3.0,-2,4,6
311,BAR,P000925,P011244,1.283,-3,2,5
311,BAR,P000925,P012745,19.35,-6,30,36
311,BAR,P000925,PLFW,8.267,1,17,16
311,BAR,P002939,P003196,9.533,5,14,9
311,BAR,P002939,P003478,9.799,4,15,11
311,BAR,P002939,P004866,12.533,-9,14,23
311,BAR,P002939,P006435,16.9,-5,22,27
311,BAR,P002939,P007519,4.566,0,7,7
311,BAR,P002939,P011244,6.683,2,12,10
311,BAR,P002939,P012745,15.216,-7,17,24
311,BAR,P003196,P003478,15.149,4,34,30
311,BAR,P003196,P004866,4.65,3,9,6
311,BAR,P003196,P006435,7.934,7,15,8
311,BAR,P003196,P007519,10.999,0,28,28
311,BAR,P003196,P011244,10.383,5,24,19
311,BAR,P003196,P012745,8.983,2,19,17
311,BAR,P003196,PLFW,9.833,2,29,27
311,BAR,P003478,P004866,0.433,0,0,0
311,BAR,P003478,P006435,6.8,3,14,11
311,BAR,P003478,P007519,10.782,-3,25,28
311,BAR,P003478,P011244,11.666,2,26,24
311,BAR,P003478,P012745,6.349,-2,13,15
311,BAR,P003478,PLFW,8.216,-4,24,28
311,BAR,P004866,P006435,18.767,-3,29,32
311,BAR,P004866,P007519,3.217,1,7,6
311,BAR,P004866,P012745,22.417,-2,36,38
311,BAR,P004866,PLFW,9.884,7,22,15
311,BAR,P006435,P011244,4.967,3,8,5
311,BAR,P006435,P012745,20.6,-3,35,38
311,BAR,P006435,PLFW,8.667,5,21,16
311,BAR,P007519,P011244,6.699,-1,18,19
311,BAR,P007519,P012745,7.3,-1,14,15
311,BAR,P007519,PLFW,9.433,-2,25,27
311,BAR,P011244,PLFW,4.983,0,14,14
311,BAR,P012745,PLFW,13.117,3,32,29
311,OLY,P003941,P007853,5.1,-3,10,13
311,OLY,P003941,P007982,3.467,-1,9,10
311,OLY,P003941,P008829,5.1,-3,10,13
311,OLY,P003941,P008855,1.733,-4,1,5
311,OLY,P003941,P010612,5.0,-1,10,11
311,OLY,P006589,P007853,8.75,1,16,15
311,OLY,P006589,P007982,10.434,-3,20,23
311,OLY,P006589,P008811,17.417,4,31,27
311,OLY,P006589,P008829,8.95,6,13,7
311,OLY,P006589,P008855,10.7,3,18,15
311,OLY,P006589,P010612,8.933,8,17,9
311,OLY,P006589,P011983,4.484,-3,9,12
311,OLY,P007853,P007982,15.566,-6,27,33
311,OLY,P007853,P008811,11.499,5,22,17
311,OLY,P007853,P008829,11.866,-1,23,24
311,OLY,P007853,P008855,6.349,-2,8,10
311,OLY,P007853,P010392,0.583,-3,0,3
311,OLY,P007853,P010612,16.948,-4,28,32
311,OLY,P007853,P011194,6.116,-4,5,9
311,OLY,P007853,P012878,4.483,-7,1,8
311,OLY,P007982,P008811,12.7,-2,28,30
311,OLY,P007982,P008829,7.0,0,17,17
311,OLY,P007982,P008855,3.817,-6,7,13
311,OLY,P007982,P010392,2.516,1,9,8
311,OLY,P007982,P010612,19.599,-3,44,47
311,OLY,P007982,P011194,10.066,-6,20,26
311,OLY,P007982,P011983,7.884,-8,17,25
311,OLY,P007982,P012878,8.483,-6,14,20
311,OLY,P008811,P008829,10.216,9,17,8
311,OLY,P008811,P008855,12.516,4,20,16
311,OLY,P008811,P010392,0.1,0,0,0
311,OLY,P008811,P010612,13.015,10,27,17
311,OLY,P008811,P011194,2.716,-1,6,7
311,OLY,P008811,P011983,5.817,-5,13,18
311,OLY,P008829,P008855,9.149,3,12,9
311,OLY,P008829,P010392,0.483,-3,0,3
311,OLY,P008829,P010612,11.182,7,22,15
311,OLY,P008829,P011194,0.25,2,2,0
311,OLY,P008855,P010392,4.183,6,10,4
311,OLY,P008855,P010612,11.815,11,19,8
311,OLY,P008855,P011194,5.566,7,12,5
311,OLY,P008855,P011983,3.717,-4,7,11
311,OLY,P008855,P012878,4.183,6,10,4
311,OLY,P010392,P010612,6.699,7,19,12
311,OLY,P010392,P011194,6.116,10,19,9
311,OLY,P010392,P012878,6.116,10,19,9
311,OLY,P010612,P011194,15.632,1,32,31
311,OLY,P010612,P011983,4.167,-4,10,14
311,OLY,P010612,P012878,12.666,0,24,24
311,OLY,P011194,P011983,3.4,-5,8,13
311,OLY,P011194,P012878,12.666,0,24,24
311,OLY,P011983,P012878,2.067,-3,4,7
312,MCO,P004790,P005985,0.183,0,0,0
312,MCO,P004790,P011212,0.183,0,0,0
312,MCO,P004790,P011231,0.183,0,0,0
312,MCO,P004790,PLCZ,0.183,0,0,0
312,MCO,P005985,P009754,23.617,-7,49,56
312,MCO,P005985,P010588,30.934,-6,62,68
312,MCO,P005985,P011196,3.483,-2,5,7
312,MCO,P005985,P011212,26.832,-9,50,59
312,MCO,P005985,P011226,23.099,-10,43,53
312,MCO,P005985,P011231,31.233,2,61,59
312,MCO,P005985,PLCZ,21.083,4,46,42
312,MCO,P008099,P009754,0.717,-2,0,2
312,MCO,P008099,P011196,4.25,1,8,7
312,MCO,P008099,P011212,3.533,3,8,5
312,MCO,P008099,P011226,4.25,1,8,7
312,MCO,P008099,P011231,4.25,1,8,7
312,MCO,P009754,P010588,18.617,-7,41,48
312,MCO,P009754,P011196,0.717,-2,0,2
312,MCO,P009754,P011212,10.966,-7,24,31
312,MCO,P009754,P011226,10.2,-7,22,29
312,MCO,P009754,P011231,19.934,-2,42,44
312,MCO,P009754,PLCZ,15.1,6,34,28
312,MCO,P010588,P011196,2.75,-2,3,5
312,MCO,P010588,P011212,18.283,-6,37,43
312,MCO,P010588,P011226,20.166,-6,39,45
312,MCO,P010588,P011231,22.251,4,47,43
312,MCO,P010588,PLCZ,13.267,7,35,28
312,MCO,P011196,P011212,7.016,1,13,12
312,MCO,P011196,P011226,7.733,-1,13,14
312,MCO,P011196,P011231,4.983,1,10,9
312,MCO,P011212,P011226,20.948,-6,37,43
312,MCO,P011212,P011231,23.349,4,47,43
312,MCO,P011212,PLCZ,12.882,4,32,28
312,MCO,P011226,P011231,18.466,0,33,33
312,MCO,P011226,PLCZ,6.266,-3,13,16
312,MCO,P011231,PLCZ,18.083,6,40,34
312,ULK,P001932,P002968,5.133,-6,7,13
312,ULK,P001932,P004004,19.2,16,43,27
312,ULK,P001932,P005844,2.733,-7,4,11
312,ULK,P001932,P006068,0.583,-2,0,2
312,ULK,P001932,P006661,4.066,-4,6,10
312,ULK,P001932,P006961,10.783,-12,19,31
312,ULK,P001932,P008962,30.883,1,63,62
312,ULK,P001932,P009849,27.1,5,60,55
312,ULK,P001932,P010560,2.25,-3,4,7
312,ULK,P001932,P011052,1.067,0,0,0
312,ULK,P001932,P011980,25.134,16,58,42
312,ULK,P002968,P004004,1.35,1,4,3
312,ULK,P002968,P006961,6.883,-6,13,19
312,ULK,P002968,P008962,3.833,-6,4,10
312,ULK,P002968,P009849,6.183,-3,13,16
312,ULK,P002968,P011052,1.1,-4,2,6
312,ULK,P002968,P011980,3.05,0,9,9
312,ULK,P004004,P005844,6.483,1,12,11
312,ULK,P004004,P006068,4.266,-3,7,10
312,ULK,P004004,P006661,8.399,1,14,13
312,ULK,P004004,P006961,3.3,5,10,5
312,ULK,P004004,P008962,24.333,21,55,34
312,ULK,P004004,P009849,17.55,19,46,27
312,ULK,P004004,P010560,6.433,1,12,11
312,ULK,P004004,P011052,4.2,0,7,7
312,ULK,P004004,P011980,22.15,22,54,32
312,ULK,P005844,P006068,3.683,-1,7,8
312,ULK,P005844,P006661,8.533,-3,16,19
312,ULK,P005844,P006961,2.683,-7,4,11
312,ULK,P005844,P008962,5.433,-5,9,14
312,ULK,P005844,P009849,0.633,-3,0,3
312,ULK,P005844,P010560,6.433,1,12,11
312,ULK,P005844,P011980,0.05,0,0,0
312,ULK,P006068,P006661,4.266,-3,7,10
312,ULK,P006068,P008962,0.583,-2,0,2
312,ULK,P006068,P010560,3.683,-1,7,8
312,ULK,P006661,P006961,2.1,-4,4,8
312,ULK,P006661,P008962,8.966,-3,15,18
312,ULK,P006661,P009849,2.15,-1,4,5
312,ULK,P006661,P010560,8.583,0,16,16
312,ULK,P006661,P011980,3.533,1,6,5
312,ULK,P006961,P008962,11.433,-8,22,30
312,ULK,P006961,P009849,9.983,-5,21,26
312,ULK,P006961,P011052,3.05,0,8,8
312,ULK,P006961,P011980,7.717,5,23,18
312,ULK,P008962,P009849,28.633,3,62,59
312,ULK,P008962,P010560,7.15,-2,13,15
312,ULK,P008962,P011052,3.5,3,7,4
312,ULK,P008962,P011980,28.117,18,66,48
312,ULK,P009849,P010560,4.4,-4,8,12
312,ULK,P009849,P011052,1.133,-2,3,5
312,ULK,P009849,P011980,26.367,15,67,52
312,ULK,P010560,P011980,4.4,-4,8,12
312,ULK,P011052,P011980,4.35,-1,9,10
313,PAN,P001926,P002328,21.784,-5,47,52
313,PAN,P001926,P003842,27.684,-16,54,70
313,PAN,P001926,P005161,2.734,1,4,3
313,PAN,P001926,P007866,21.0,-13,46,59
313,PAN,P001926,P007947,2.267,-6,5,11
313,PAN,P001926,P011204,17.534,-1,33,34
313,PAN,P001926,P011209,3.233,-7,6,13
313,PAN,P001926,P011221,2.967,0,9,9
313,PAN,P001926,P012712,12.951,-3,21,24
313,PAN,P001926,P012774,17.05,-14,35,49
313,PAN,P002328,P003842,20.867,1,46,45
313,PAN,P002328,P007866,16.2,-5,38,43
313,PAN,P002328,P007947,3.75,-1,9,10
313,PAN,P002328,P011204,12.916,7,29,22
313,PAN,P002328,P011221,2.967,0,9,9
313,PAN,P002328,P012712,8.783,2,17,15
313,PAN,P002328,P012774,10.533,-3,25,28
313,PAN,P003842,P005161,1.617,-1,2,3
313,PAN,P003842,P007866,16.383,-13,35,48
313,PAN,P003842,P007947,8.567,3,24,21
313,PAN,P003842,P011204,22.717,6,50,44
313,PAN,P003842,P011209,3.233,-7,6,13
313,PAN,P003842,P012712,17.601,6,38,32
313,PAN,P003842,P012774,17.267,-7,37,44
313,PAN,P005161,P007866,1.117,2,2,0
313,PAN,P005161,P011204,2.734,1,4,3
313,PAN,P005161,P012712,2.734,1,4,3
313,PAN,P007866,P007947,1.4,-2,5,7
313,PAN,P007866,P011204,7.75,-1,16,17
313,PAN,P007866,P011209,3.233,-7,6,13
313,PAN,P007866,P011221,2.967,0,9,9
313,PAN,P007866,P012712,1.65,0,2,2
313,PAN,P007866,P012774,12.3,-13,25,38
313,PAN,P007947,P011204,7.7,12,22,10
313,PAN,P007947,P011209,2.5,2,7,5
313,PAN,P007947,P011221,1.317,3,3,0
313,PAN,P007947,P012712,8.567,8,22,14
313,PAN,P007947,P012774,3.8,5,11,6
313,PAN,P011204,P011209,1.317,3,3,0
313,PAN,P011204,P011221,1.317,3,3,0
313,PAN,P011204,P012712,18.601,14,41,27
313,PAN,P011204,P012774,8.35,0,19,19
313,PAN,P011209,P011221,1.317,3,3,0
313,PAN,P011209,P012712,1.317,3,3,0
313,PAN,P011209,P012774,2.05,-6,2,8
313,PAN,P011221,P012712,1.317,3,3,0
313,PAN,P011221,P012774,2.967,0,9,9
313,PAN,P012712,P012774,9.083,2,21,19
313,TEL,P005145,P009622,12.733,-1,30,31
313,TEL,P005145,P009783,12.733,-1,30,31
313,TEL,P005145,P009863,11.7,2,28,26
313,TEL,P005145,P011193,1.033,-3,2,5
313,TEL,P005145,P011199,12.733,-1,30,31
313,TEL,P007990,P009622,3.2,-7,3,10
313,TEL,P007990,P009783,3.2,-7,3,10
313,TEL,P007990,P009863,3.2,-7,3,10
313,TEL,P007990,P011193,0.083,0,0,0
313,TEL,P007990,P011199,3.283,-7,3,10
313,TEL,P007990,P011971,0.083,0,0,0
313,TEL,P007990,P012744,0.083,0,0,0
313,TEL,P009622,P009783,27.799,-5,57,62
313,TEL,P009622,P009863,19.866,-11,39,50
313,TEL,P009622,P011193,15.683,1,33,32
313,TEL,P009622,P011199,22.932,-9,48,57
313,TEL,P009622,P011214,10.917,6,25,19
313,TEL,P009622,P011219,2.75,3,8,5
313,TEL,P009622,P011971,7.917,1,15,14
313,TEL,P009622,P012744,11.667,10,30,20
313,TEL,P009783,P009863,23.483,-8,49,57
313,TEL,P009783,P011193,13.233,2,28,26
313,TEL,P009783,P011199,22.582,-8,48,56
313,TEL,P009783,P011214,7.35,9,20,11
313,TEL,P009783,P011219,3.867,1,8,7
313,TEL,P009783,P011971,2.683,-2,0,2
313,TEL,P009783,P012744,8.734,11,25,14
313,TEL,P009863,P011193,7.783,0,19,19
313,TEL,P009863,P011199,18.416,-8,38,46
313,TEL,P009863,P011214,5.233,3,17,14
313,TEL,P009863,P011219,4.4,3,10,7
313,TEL,P009863,P011971,3.399,2,9,7
313,TEL,P009863,P012744,6.184,8,20,12
313,TEL,P011193,P011199,5.699,-6,10,16
313,TEL,P011193,P011214,15.067,15,42,27
313,TEL,P011193,P011219,1.65,0,2,2
313,TEL,P011193,P011971,10.383,7,24,17
313,TEL,P011193,P012744,16.65,16,48,32
313,TEL,P011199,P011214,0.6,1,2,1
313,TEL,P011199,P011219,2.133,2,7,5
313,TEL,P011199,P011971,0.366,0,0,0
313,TEL,P011199,P012744,3.316,0,6,6
313,TEL,P011214,P011971,10.017,3,22,19
313,TEL,P011214,P012744,12.084,15,40,25
313,TEL,P011219,P011971,0.533,2,2,0
313,TEL,P011219,P012744,2.267,1,3,2
313,TEL,P011971,P012744,8.283,7,24,17
314,BAS,P003198,P004603,1.733,-3,2,5
314,BAS,P003198,P004761,8.967,9,28,19
314,BAS,P003198,P007230,1.917,1,4,3
314,BAS,P003198,P008850,1.733,-3,2,5
314,BAS,P003198,P009048,10.7,6,30,24
314,BAS,P003198,P010444,8.967,9,28,19
314,BAS,P003198,P011085,6.833,10,24,14
314,BAS,P003198,P011948,1.95,-5,2,7
314,BAS,P004603,P004761,14.367,-1,33,34
314,BAS,P004603,P007230,16.901,-10,34,44
314,BAS,P004603,P007946,1.467,-5,0,5
314,BAS,P004603,P008850,6.25,-8,11,19
314,BAS,P004603,P009048,13.117,-15,23,38
314,BAS,P004603,P011085,0.917,-3,0,3
314,BAS,P004603,P011948,11.684,-11,22,33
314,BAS,P004603,P012765,8.1,4,19,15
314,BAS,P004761,P007230,25.65,-3,58,61
314,BAS,P004761,P007946,1.467,-5,0,5
314,BAS,P004761,P008850,4.95,-1,13,14
314,BAS,P004761,P009048,27.183,3,69,66
314,BAS,P004761,P010444,18.333,6,49,43
314,BAS,P004761,P011085,12.666,12,37,25
314,BAS,P004761,P011948,9.117,-4,22,26
314,BAS,P004761,P012765,8.1,4,19,15
314,BAS,P007230,P007946,1.467,-5,0,5
314,BAS,P007230,P008850,9.6,-11,19,30
314,BAS,P007230,P009048,25.7,-18,51,69
314,BAS,P007230,P010444,14.316,-6,30,36
314,BAS,P007230,P011085,6.75,-1,13,14
314,BAS,P007230,P011948,14.467,-15,28,43
314,BAS,P007230,P012765,8.1,4,19,15
314,BAS,P007946,P011948,1.467,-5,0,5
314,BAS,P008850,P009048,11.333,-14,21,35
314,BAS,P008850,P010444,5.083,-6,10,16
314,BAS,P008850,P011948,6.383,-13,8,21
314,BAS,P009048,P010444,21.366,2,54,52
314,BAS,P009048,P011085,13.583,9,37,28
314,BAS,P009048,P011948,10.9,-22,17,39
314,BAS,P009048,P012765,4.05,-3,6,9
314,BAS,P010444,P011085,12.666,12,37,25
314,BAS,P010444,P011948,4.733,-9,8,17
314,BAS,P011085,P011948,0.917,-3,0,3
314,BAS,P011948,P012765,4.05,7,13,6
314,MAD,P003108,P004887,11.117,4,25,21
314,MAD,P003108,P005791,16.183,6,42,36
314,MAD,P003108,P005928,21.4,9,53,44
314,MAD,P003108,P006540,16.75,-1,37,38
314,MAD,P003108,P009005,5.2,0,11,11
314,MAD,P003108,P010357,18.05,9,47,38
314,MAD,P003108,PBMT,5.984,-6,11,17
314,MAD,P003108,PCVM,5.917,1,14,13
314,MAD,P003108,PTGB,8.667,18,28,10
314,MAD,P004887,P005928,8.766,-2,19,21
314,MAD,P004887,P006540,4.717,-2,9,11
314,MAD,P004887,P009005,11.55,-6,27,33
314,MAD,P004887,P010357,3.517,6,10,4
314,MAD,P004887,PBMT,13.533,-13,28,41
314,MAD,P004887,PCVM,13.7,-4,33,37
314,MAD,P004887,PTGB,8.7,13,25,12
314,MAD,P005791,P005928,18.133,4,46,42
314,MAD,P005791,P006540,12.683,-2,28,30
314,MAD,P005791,P009005,4.9,6,15,9
314,MAD,P005791,P010357,21.083,12,57,45
314,MAD,P005791,PCVM,2.95,8,11,3
314,MAD,P005791,PTGB,8.4,14,29,15
314,MAD,P005928,P006540,16.75,-1,37,38
314,MAD,P005928,P009005,4.083,-8,9,17
314,MAD,P005928,P010357,20.716,7,51,44
314,MAD,P005928,PBMT,7.633,-4,17,21
314,MAD,P005928,PCVM,3.566,-5,8,13
314,MAD,P005928,PTGB,6.617,8,20,12
314,MAD,P006540,P009005,0.667,-3,0,3
314,MAD,P006540,P010357,12.683,-2,28,30
314,MAD,P006540,PBMT,4.734,-2,9,11
314,MAD,P006540,PCVM,0.667,-3,0,3
314,MAD,P006540,PTGB,0.017,0,0,0
314,MAD,P009005,P010357,5.117,8,17,9
314,MAD,P009005,PBMT,8.05,-15,16,31
314,MAD,P009005,PCVM,14.5,2,38,36
314,MAD,P009005,PTGB,11.733,16,35,19
314,MAD,P010357,PBMT,1.433,1,3,2
314,MAD,P010357,PCVM,5.317,12,19,7
314,MAD,P010357,PTGB,10.484,19,36,17
314,MAD,PBMT,PCVM,9.483,-14,19,33
314,MAD,PBMT,PTGB,3.35,1,9,8
314,MAD,PCVM,PTGB,10.5,19,34,15
315,BAR,P000925,P002939,10.717,-2,17,19
315,BAR,P000925,P003478,4.434,0,6,6
315,BAR,P000925,P004866,18.183,2,34,32
315,BAR,P000925,P006435,16.5,2,32,30
315,BAR,P000925,P007519,4.0,-1,7,8
315,BAR,P000925,P011244,1.667,3,3,0
315,BAR,P000925,P012745,20.95,-1,37,38
315,BAR,P000925,PLFW,14.017,5,24,19
315,BAR,P002939,P003196,11.55,9,31,22
315,BAR,P002939,P003478,13.401,7,28,21
315,BAR,P002939,P004866,8.616,5,20,15
315,BAR,P002939,P006435,7.583,-6,15,21
315,BAR,P002939,P007519,12.567,12,32,20
315,BAR,P002939,P011244,2.75,-5,7,12
315,BAR,P002939,P012745,19.517,12,41,29
315,BAR,P002939,PLFW,2.367,-4,1,5
315,BAR,P003196,P003478,12.417,7,24,17
315,BAR,P003196,P004866,4.717,4,13,9
315,BAR,P003196,P006435,2.267,-9,4,13
315,BAR,P003196,P007519,15.117,15,33,18
315,BAR,P003196,P011244,6.2,-5,9,14
315,BAR,P003196,P012745,11.184,11,28,17
315,BAR,P003196,PLFW,6.084,-8,6,14
315,BAR,P003478,P006435,1.05,1,4,3
315,BAR,P003478,P007519,13.684,5,25,20
315,BAR,P003478,P011244,5.95,0,9,9
315,BAR,P003478,P012745,10.901,7,21,14
315,BAR,P003478,PLFW,5.567,1,3,2
315,BAR,P004866,P006435,17.467,-3,32,35
315,BAR,P004866,P007519,5.433,9,15,6
315,BAR,P004866,P011244,1.667,3,3,0
315,BAR,P004866,P012745,21.233,3,44,41
315,BAR,P004866,PLFW,14.284,1,27,26
315,BAR,P006435,P011244,2.967,-1,7,8
315,BAR,P006435,P012745,15.8,-6,29,35
315,BAR,P006435,PLFW,11.434,-6,21,27
315,BAR,P007519,P011244,4.9,-1,5,6
315,BAR,P007519,P012745,14.217,15,35,20
315,BAR,P007519,PLFW,6.55,2,8,6
315,BAR,P011244,PLFW,5.367,-2,5,7
315,BAR,P012745,PLFW,14.734,-1,25,26
315,OLY,P003941,P006589,0.967,5,5,0
315,OLY,P003941,P007853,6.867,-8,6,14
315,OLY,P003941,P007982,4.284,1,7,6
315,OLY,P003941,P008829,7.267,-3,11,14
315,OLY,P003941,P008855,7.267,-3,11,14
315,OLY,P003941,P010612,0.567,0,0,0
315,OLY,P003941,P011194,4.117,-4,4,8
315,OLY,P006589,P007982,5.033,4,13,9
315,OLY,P006589,P008811,14.666,-9,25,34
315,OLY,P006589,P008829,16.366,-2,32,34
315,OLY,P006589,P008855,14.5,3,30,27
315,OLY,P006589,P010612,13.199,-11,21,32
315,OLY,P006589,P012878,0.733,2,2,0
315,OLY,P007853,P007982,9.667,1,18,17
315,OLY,P007853,P008811,0.967,2,2,0
315,OLY,P007853,P008829,8.15,-10,8,18
315,OLY,P007853,P008855,11.8,-8,15,23
315,OLY,P007853,P010392,6.85,4,16,12
315,OLY,P007853,P010612,4.6,-1,7,8
315,OLY,P007853,P011194,15.084,5,29,24
315,OLY,P007853,P012878,10.883,3,23,20
315,OLY,P007982,P008811,8.25,-6,12,18
315,OLY,P007982,P008829,13.583,-7,21,28
315,OLY,P007982,P008855,10.834,2,19,17
315,OLY,P007982,P010392,5.467,9,16,7
315,OLY,P007982,P010612,3.316,-9,2,11
315,OLY,P007982,P011194,10.951,6,22,16
315,OLY,P007982,P012878,7.083,7,18,11
315,OLY,P008811,P008829,20.55,-10,33,43
315,OLY,P008811,P008855,19.417,-3,33,36
315,OLY,P008811,P010612,12.466,-13,19,32
315,OLY,P008811,P011194,5.884,-1,8,9
315,OLY,P008829,P008855,26.684,-6,44,50
315,OLY,P008829,P010612,14.082,-15,21,36
315,OLY,P008829,P011194,9.434,-5,12,17
315,OLY,P008829,P012878,1.616,-2,2,4
315,OLY,P008855,P010392,1.383,-5,0,5
315,OLY,P008855,P010612,14.483,-3,26,29
315,OLY,P008855,P011194,13.967,-7,19,26
315,OLY,P008855,P012878,4.533,-2,7,9
315,OLY,P010392,P011194,6.85,4,16,12
315,OLY,P010392,P012878,6.85,4,16,12
315,OLY,P010612,P011194,3.717,3,7,4
315,OLY,P010612,P012878,4.766,1,9,8
315,OLY,P011194,P012878,10.0,7,23,16
316,MCO,P002581,P005985,6.033,12,17,5
316,MCO,P002581,P009754,12.666,4,22,18
316,MCO,P002581,P011212,12.666,4,22,18
316,MCO,P002581,P011226,7.733,-7,10,17
316,MCO,P002581,P011231,11.566,3,17,14
316,MCO,P005985,P008099,11.4,-7,26,33
316,MCO,P005985,P009754,12.7,21,38,17
316,MCO,P005985,P010588,18.25,-5,43,48
316,MCO,P005985,P011196,5.45,-2,15,17
316,MCO,P005985,P011212,16.733,15,46,31
316,MCO,P005985,P011226,8.066,-8,20,28
316,MCO,P005985,P011231,17.25,8,43,35
316,MCO,P005985,PLCZ,16.65,-2,40,42
316,MCO,P008099,P009754,1.7,2,7,5
316,MCO,P008099,P010588,11.683,-3,31,34
316,MCO,P008099,P011196,2.4,-6,4,10
316,MCO,P008099,P011226,1.266,0,7,7
316,MCO,P008099,P011231,9.0,-1,22,23
316,MCO,P008099,PLCZ,9.283,3,27,24
316,MCO,P009754,P010588,9.05,8,27,19
316,MCO,P009754,P011196,3.817,3,11,8
316,MCO,P009754,P011212,22.866,16,52,36
316,MCO,P009754,P011226,13.499,1,29,28
316,MCO,P009754,P011231,16.033,1,26,25
316,MCO,P009754,PLCZ,5.933,16,24,8
316,MCO,P010588,P011196,5.45,-2,15,17
316,MCO,P010588,P011212,11.8,3,28,25
316,MCO,P010588,P011226,10.666,-2,26,28
316,MCO,P010588,P011231,11.15,-6,24,30
316,MCO,P010588,PLCZ,15.883,7,42,35
316,MCO,P011196,P011212,3.05,4,11,7
316,MCO,P011196,P011226,1.633,-5,4,9
316,MCO,P011212,P011226,18.666,-11,34,45
316,MCO,P011212,P011231,17.033,-4,28,32
316,MCO,P011212,PLCZ,10.45,5,27,22
316,MCO,P011226,P011231,9.783,-18,9,27
316,MCO,P011226,PLCZ,8.416,6,25,19
316,MCO,P011231,PLCZ,12.317,-3,31,34
316,ULK,P001932,P002968,3.767,-6,5,11
316,ULK,P001932,P004004,10.634,0,25,25
316,ULK,P001932,P005844,14.2,5,37,32
316,ULK,P001932,P006661,9.717,-1,24,25
316,ULK,P001932,P006961,5.567,-2,12,14
316,ULK,P001932,P008962,17.118,-4,38,42
316,ULK,P001932,P009849,19.751,-10,43,53
316,ULK,P001932,P010560,5.05,6,12,6
316,ULK,P001932,P011980,12.6,-8,24,32
316,ULK,P002968,P006961,3.767,-6,5,11
316,ULK,P002968,P008962,3.767,-6,5,11
316,ULK,P002968,P009849,3.767,-6,5,11
316,ULK,P004004,P005844,12.483,-4,21,25
316,ULK,P004004,P006661,13.184,11,32,21
316,ULK,P004004,P008962,8.334,4,20,16
316,ULK,P004004,P009849,6.367,-7,13,20
316,ULK,P004004,P010560,9.7,7,18,11
316,ULK,P004004,P011980,16.034,5,35,30
316,ULK,P005844,P006661,14.15,-4,32,36
316,ULK,P005844,P006961,6.533,11,23,12
316,ULK,P005844,P008962,14.15,0,37,37
316,ULK,P005844,P009849,17.1,-4,44,48
316,ULK,P005844,P010560,10.534,-4,17,21
316,ULK,P005844,P011980,10.85,0,21,21
316,ULK,P006661,P006961,4.733,7,16,9
316,ULK,P006661,P008962,19.05,-4,45,49
316,ULK,P006661,P009849,14.033,-11,31,42
316,ULK,P006661,P010560,10.084,-5,17,22
316,ULK,P006661,P011980,15.517,3,31,28
316,ULK,P006961,P008962,10.3,5,28,23
316,ULK,P006961,P009849,10.3,5,28,23
316,ULK,P008962,P009849,24.134,-12,53,65
316,ULK,P008962,P010560,10.034,-1,23,24
316,ULK,P008962,P011980,9.717,-2,19,21
316,ULK,P009849,P010560,5.434,-6,11,17
316,ULK,P009849,P011980,7.85,-13,12,25
316,ULK,P010560,P011980,9.7,7,18,11
317,PAN,P001926,P002328,10.667,-1,18,19
317,PAN,P001926,P003842,23.966,25,60,35
317,PAN,P001926,P005161,24.45,29,69,40
317,PAN,P001926,P007866,24.266,21,60,39
317,PAN,P001926,P007947,6.35,2,14,12
317,PAN,P001926,P011204,5.133,6,15,9
317,PAN,P001926,P011209,2.0,1,5,4
317,PAN,P001926,P011221,5.417,0,14,14
317,PAN,P001926,P012774,15.283,17,41,24
317,PAN,P002328,P003842,16.317,-3,32,35
317,PAN,P002328,P005161,6.284,1,13,12
317,PAN,P002328,P007866,14.567,-9,25,34
317,PAN,P002328,P007947,4.1,-1,9,10
317,PAN,P002328,P011204,6.867,-3,16,19
317,PAN,P002328,P011221,1.217,-1,2,3
317,PAN,P002328,P012774,10.717,-7,21,28
317,PAN,P003842,P005161,20.133,30,60,30
317,PAN,P003842,P007866,30.033,19,74,55
317,PAN,P003842,P007947,3.616,-2,7,9
317,PAN,P003842,P011204,12.617,8,36,28
317,PAN,P003842,P012774,21.05,15,55,40
317,PAN,P005161,P007866,22.75,19,60,41
317,PAN,P005161,P007947,6.167,-4,14,18
317,PAN,P005161,P011204,7.5,8,20,12
317,PAN,P005161,P011209,2.0,1,5,4
317,PAN,P005161,P011221,7.584,-5,14,19
317,PAN,P005161,P012774,14.6,13,41,28
317,PAN,P007866,P007947,2.283,-10,0,10
317,PAN,P007866,P011204,14.367,5,36,31
317,PAN,P007866,P011221,4.367,-5,7,12
317,PAN,P007866,P012774,25.567,8,62,54
317,PAN,P007947,P011209,2.0,1,5,4
317,PAN,P007947,P011221,3.634,-2,7,9
317,PAN,P007947,P012774,1.45,-8,0,8
317,PAN,P008084,P011204,0.333,0,0,0
317,PAN,P008084,P011209,0.333,0,0,0
317,PAN,P008084,P011221,0.333,0,0,0
317,PAN,P008084,P012774,0.333,0,0,0
317,PAN,P011204,P011209,0.333,0,0,0
317,PAN,P011204,P011221,2.083,-3,0,3
317,PAN,P011204,P012774,9.567,-1,21,22
317,PAN,P011209,P011221,2.333,1,5,4
317,PAN,P011209,P012774,0.333,0,0,0
317,PAN,P011221,P012774,4.7,-5,7,12
317,TEL,P005145,P007990,10.8,-3,22,25
317,TEL,P005145,P009622,11.133,-5,22,27
317,TEL,P005145,P009783,10.8,-3,22,25
317,TEL,P005145,P011193,0.333,-2,0,2
317,TEL,P005145,P011199,10.8,-3,22,25
317,TEL,P005145,P011971,0.333,-2,0,2
317,TEL,P005145,P012744,0.333,-2,0,2
317,TEL,P007990,P009622,15.616,-7,27,34
317,TEL,P007990,P009783,16.083,-7,28,35
317,TEL,P007990,P011193,1.15,-1,1,2
317,TEL,P007990,P011199,12.85,-7,24,31
317,TEL,P007990,P011214,3.65,-1,4,5
317,TEL,P007990,P011219,1.017,-1,1,2
317,TEL,P007990,P011971,2.183,-4,2,6
317,TEL,P007990,P012744,3.183,-1,3,4
317,TEL,P009622,P009783,27.882,-19,51,70
317,TEL,P009622,P011193,13.665,-15,24,39
317,TEL,P009622,P011199,19.316,-15,35,50
317,TEL,P009622,P011214,8.949,-1,16,17
317,TEL,P009622,P011219,2.983,-11,2,13
317,TEL,P009622,P011971,8.166,-15,11,26
317,TEL,P009622,P012744,8.882,0,16,16
317,TEL,P009783,P011193,20.233,-6,44,50
317,TEL,P009783,P011199,18.766,-14,35,49
317,TEL,P009783,P011214,15.85,6,36,30
317,TEL,P009783,P011219,3.617,-12,3,15
317,TEL,P009783,P011971,13.55,-4,30,34
317,TEL,P009783,P012744,13.883,11,35,24
317,TEL,P011193,P011199,6.466,-8,11,19
317,TEL,P011193,P011214,17.167,5,41,36
317,TEL,P011193,P011219,7.567,-13,11,24
317,TEL,P011193,P011971,15.95,-4,36,40
317,TEL,P011193,P012744,15.533,8,40,32
317,TEL,P011199,P011214,0.2,0,0,0
317,TEL,P011199,P011219,1.533,-3,2,5
317,TEL,P011199,P011971,5.85,-13,7,20
317,TEL,P011199,P012744,1.483,3,4,1
317,TEL,P011214,P011219,6.034,-10,9,19
317,TEL,P011214,P011971,11.067,11,31,20
317,TEL,P011214,P012744,16.283,10,39,29
317,TEL,P011219,P011971,3.567,-1,8,9
317,TEL,P011219,P012744,3.95,-1,8,9
317,TEL,P011971,P012744,11.334,0,27,27
318,BAS,P003198,P004603,7.834,2,21,19
318,BAS,P003198,P004761,9.384,3,22,19
318,BAS,P003198,P007230,0.567,0,0,0
318,BAS,P003198,P008850,3.15,8,15,7
318,BAS,P003198,P009048,16.984,7,44,37
318,BAS,P003198,P010444,9.15,5,23,18
318,BAS,P003198,P011085,11.1,6,26,20
318,BAS,P003198,P011948,9.767,-3,25,28
318,BAS,P004603,P004761,7.45,-5,18,23
318,BAS,P004603,P007230,5.117,1,12,11
318,BAS,P004603,P008850,3.15,8,15,7
318,BAS,P004603,P009048,12.384,3,33,30
318,BAS,P004603,P011085,4.467,4,10,6
318,BAS,P004603,P011948,9.134,-1,23,24
318,BAS,P004761,P007230,12.866,-11,32,43
318,BAS,P004761,P008850,0.65,-4,0,4
318,BAS,P004761,P009048,22.617,1,59,58
318,BAS,P004761,P010444,19.183,1,51,50
318,BAS,P004761,P011085,19.416,13,54,41
318,BAS,P004761,P011948,10.95,-9,30,39
318,BAS,P004761,P012765,4.016,-5,10,15
318,BAS,P007230,P008850,0.017,0,0,0
318,BAS,P007230,P009048,16.167,-9,32,41
318,BAS,P007230,P010444,14.083,-16,27,43
318,BAS,P007230,P011085,13.583,-5,27,32
318,BAS,P007230,P011948,11.367,-14,19,33
318,BAS,P007230,P012765,3.033,-6,7,13
318,BAS,P008850,P009048,3.817,4,15,11
318,BAS,P008850,P010444,0.667,-4,0,4
318,BAS,P008850,P011085,0.667,-4,0,4
318,BAS,P008850,P011948,3.15,8,15,7
318,BAS,P009048,P010444,23.6,-2,55,57
318,BAS,P009048,P011085,27.9,4,65,61
318,BAS,P009048,P011948,20.467,-4,49,53
318,BAS,P010444,P011085,24.599,1,58,57
318,BAS,P010444,P011948,15.166,-8,36,44
318,BAS,P010444,P012765,4.016,-5,10,15
318,BAS,P011085,P011948,13.366,0,29,29
318,BAS,P011085,P012765,1.166,1,3,2
318,BAS,P011948,P012765,3.833,-5,10,15
318,MAD,P003108,P004887,4.317,-6,11,17
318,MAD,P003108,P005791,26.185,1,62,61
318,MAD,P003108,P005928,24.652,-5,55,60
318,MAD,P003108,P006540,12.267,-7,24,31
318,MAD,P003108,P009005,13.235,0,34,34
318,MAD,P003108,P010357,24.269,4,58,54
318,MAD,P003108,PBMT,0.217,-2,0,2
318,MAD,P003108,PCVM,6.167,4,20,16
318,MAD,P003108,PTGB,12.835,-1,36,37
318,MAD,P004887,P005928,5.35,-7,13,20
318,MAD,P004887,P009005,8.95,-8,24,32
318,MAD,P004887,P010357,2.333,-4,6,10
318,MAD,P004887,PBMT,3.6,-1,11,12
318,MAD,P004887,PCVM,3.6,-1,11,12
318,MAD,P004887,PTGB,7.65,-5,20,25
318,MAD,P005791,P005928,21.268,3,46,43
318,MAD,P005791,P006540,12.267,-7,24,31
318,MAD,P005791,P009005,12.434,11,33,22
318,MAD,P005791,P010357,28.068,11,70,59
318,MAD,P005791,PBMT,3.25,5,12,7
318,MAD,P005791,PCVM,9.316,11,32,21
318,MAD,P005791,PTGB,9.284,5,25,20
318,MAD,P005928,P006540,12.267,-7,24,31
318,MAD,P005928,P009005,14.068,-1,31,32
318,MAD,P005928,P010357,21.051,3,45,42
318,MAD,P005928,PCVM,0.283,2,2,0
318,MAD,P005928,PTGB,9.001,-4,20,24
318,MAD,P006540,P010357,12.267,-7,24,31
318,MAD,P009005,P010357,12.851,10,35,25
318,MAD,P009005,PBMT,6.85,4,23,19
318,MAD,P009005,PCVM,7.633,8,28,20
318,MAD,P009005,PTGB,11.651,-4,28,32
318,MAD,P010357,PBMT,4.55,2,16,14
318,MAD,P010357,PCVM,9.95,10,35,25
318,MAD,P010357,PTGB,8.401,7,23,16
318,MAD,PBMT,PCVM,6.633,6,23,17
318,MAD,PBMT,PTGB,2.3,2,7,5
318,MAD,PCVM,PTGB,8.75,8,29,21
319,BAR,P000925,P002939,18.717,1,37,36
319,BAR,P000925,P003478,11.199,2,24,22
319,BAR,P000925,P004866,22.616,-1,35,36
319,BAR,P000925,P006435,21.35,5,43,38
319,BAR,P000925,P007519,3.566,-4,5,9
319,BAR,P000925,P009992,3.45,0,7,7
319,BAR,P000925,P011244,0.083,0,0,0
319,BAR,P000925,P012745,30.966,1,57,56
319,BAR,P000925,PLFW,12.249,0,20,20
319,BAR,P002939,P003196,9.466,1,16,15
319,BAR,P002939,P003478,16.783,7,35,28
319,BAR,P002939,P004866,14.083,-5,20,25
319,BAR,P002939,P006435,20.967,4,46,42
319,BAR,P002939,P007519,4.533,-2,5,7
319,BAR,P002939,P011244,6.95,0,14,14
319,BAR,P002939,P012745,21.233,2,39,37
319,BAR,P003196,P003478,13.716,1,25,24
319,BAR,P003196,P004866,0.3,0,0,0
319,BAR,P003196,P006435,8.516,-1,16,17
319,BAR,P003196,P007519,5.433,2,9,7
319,BAR,P003196,P011244,7.017,0,14,14
319,BAR,P003196,P012745,6.932,1,11,10
319,BAR,P003196,PLFW,4.416,0,9,9
319,BAR,P003478,P004866,2.833,0,2,2
319,BAR,P003478,P006435,16.716,3,38,35
319,BAR,P003478,P007519,5.283,2,9,7
319,BAR,P003478,P009992,0.233,-2,0,2
319,BAR,P003478,P011244,7.1,0,14,14
319,BAR,P003478,P012745,17.815,3,35,32
319,BAR,P003478,PLFW,7.982,-4,14,18
319,BAR,P004866,P006435,13.15,1,21,20
319,BAR,P004866,P007519,3.866,-4,5,9
319,BAR,P004866,P009992,3.217,2,7,5
319,BAR,P004866,P011244,0.15,0,0,0
319,BAR,P004866,P012745,22.766,-1,35,36
319,BAR,P004866,PLFW,8.683,4,15,11
319,BAR,P006435,P011244,6.95,0,14,14
319,BAR,P006435,P012745,22.916,4,45,41
319,BAR,P006435,PLFW,8.899,0,13,13
319,BAR,P007519,P011244,0.15,0,0,0
319,BAR,P007519,P012745,8.849,-2,14,16
319,BAR,P007519,PLFW,4.316,0,9,9
319,BAR,P009992,P012745,3.45,0,7,7
319,BAR,P009992,PLFW,3.45,0,7,7
319,BAR,P012745,PLFW,16.665,0,29,29
319,OLY,P006589,P008811,5.2,-4,4,8
319,OLY,P006589,P008829,5.2,-4,4,8
319,OLY,P006589,P008855,5.2,-4,4,8
319,OLY,P006589,P010612,5.2,-4,4,8
319,OLY,P007853,P007982,25.434,7,50,43
319,OLY,P007853,P008811,5.984,-7,7,14
319,OLY,P007853,P008829,0.083,0,0,0
319,OLY,P007853,P008855,17.884,2,34,32
319,OLY,P007853,P010392,7.0,7,19,12
319,OLY,P007853,P010612,2.75,-2,3,5
319,OLY,P007853,P011194,26.534,7,53,46
319,OLY,P007853,P012878,20.467,14,46,32
319,OLY,P007982,P008811,7.75,-9,7,16
319,OLY,P007982,P008829,4.367,-6,6,12
319,OLY,P007982,P008855,20.985,-4,37,41
319,OLY,P007982,P010392,11.084,1,25,24
319,OLY,P007982,P010612,1.883,-2,0,2
319,OLY,P007982,P011194,25.851,7,50,43
319,OLY,P007982,P012878,22.118,10,49,39
319,OLY,P008811,P008829,16.817,-5,24,29
319,OLY,P008811,P008855,20.918,-10,31,41
319,OLY,P008811,P010392,8.467,-7,11,18
319,OLY,P008811,P010612,16.934,-5,24,29
319,OLY,P008811,P011194,9.134,-1,16,17
319,OLY,P008829,P008855,18.251,-9,27,36
319,OLY,P008829,P010392,9.934,-11,14,25
319,OLY,P008829,P010612,14.35,-3,21,24
319,OLY,P008829,P011194,3.35,6,9,3
319,OLY,P008829,P012878,1.584,-4,3,7
319,OLY,P008855,P010392,10.001,-11,14,25
319,OLY,P008855,P010612,15.134,-3,24,27
319,OLY,P008855,P011194,20.985,8,43,35
319,OLY,P008855,P012878,15.118,3,30,27
319,OLY,P010392,P010612,5.917,-5,8,13
319,OLY,P010392,P011194,7.067,7,19,12
319,OLY,P010392,P012878,8.534,3,22,19
319,OLY,P010612,P011194,5.9,4,12,8
319,OLY,P011194,P012878,20.651,14,46,32
320,MCO,P002581,P005985,5.55,-6,11,17
320,MCO,P002581,P008099,4.633,-2,10,12
320,MCO,P002581,P009754,6.0,-2,11,13
320,MCO,P002581,P011212,7.451,-7,16,23
320,MCO,P002581,P011226,10.067,-7,19,26
320,MCO,P002581,P011231,9.767,-8,17,25
320,MCO,P004790,P005985,11.55,0,20,20
320,MCO,P004790,P008099,6.967,-2,12,14
320,MCO,P004790,P009754,3.65,3,6,3
320,MCO,P004790,P011212,1.133,-1,2,3
320,MCO,P004790,P011226,11.35,0,20,20
320,MCO,P004790,PLCZ,11.55,0,20,20
320,MCO,P005985,P008099,8.933,-4,17,21
320,MCO,P005985,P009754,17.699,6,39,33
320,MCO,P005985,P011196,3.05,4,9,5
320,MCO,P005985,P011212,12.983,0,32,32
320,MCO,P005985,P011226,25.417,-6,48,54
320,MCO,P005985,P011231,19.316,-2,42,44
320,MCO,P005985,PLCZ,23.366,0,46,46
320,MCO,P008099,P009754,5.233,-3,10,13
320,MCO,P008099,P011212,1.217,-1,5,6
320,MCO,P008099,P011226,11.217,-4,22,26
320,MCO,P008099,P011231,4.683,-4,9,13
320,MCO,P008099,PLCZ,8.117,-4,15,19
320,MCO,P009754,P011196,5.15,-2,9,11
320,MCO,P009754,P011212,10.167,-1,23,24
320,MCO,P009754,P011226,18.717,-7,31,38
320,MCO,P009754,P011231,21.733,-7,44,51
320,MCO,P009754,PLCZ,14.583,1,31,30
320,MCO,P011196,P011212,5.15,-2,9,11
320,MCO,P011196,P011226,2.1,-6,0,6
320,MCO,P011196,P011231,5.15,-2,9,11
320,MCO,P011212,P011226,11.717,-13,19,32
320,MCO,P011212,P011231,15.784,-5,33,38
320,MCO,P011212,PLCZ,5.066,2,13,11
320,MCO,P011226,P011231,20.534,-15,34,49
320,MCO,P011226,PLCZ,20.817,-2,39,41
320,MCO,P011231,PLCZ,12.433,-1,28,29
320,ULK,P001932,P004004,7.618,-1,14,15
320,ULK,P001932,P005844,20.717,3,41,38
320,ULK,P001932,P006068,3.217,-2,8,10
320,ULK,P001932,P006661,10.717,-6,22,28
320,ULK,P001932,P006961,7.883,8,19,11
320,ULK,P001932,P008962,25.518,5,52,47
320,ULK,P001932,P009849,14.033,3,27,24
320,ULK,P001932,P010560,17.333,5,37,32
320,ULK,P001932,P011980,3.7,1,8,7
320,ULK,P002968,P004004,2.616,-5,3,8
320,ULK,P002968,P006661,3.583,-3,6,9
320,ULK,P002968,P006961,3.583,-3,6,9
320,ULK,P002968,P008962,3.05,-4,5,9
320,ULK,P002968,P009849,0.967,2,3,1
320,ULK,P002968,P011980,0.533,1,1,0
320,ULK,P004004,P005844,4.917,0,10,10
320,ULK,P004004,P006068,6.617,6,18,12
320,ULK,P004004,P006661,14.467,0,33,33
320,ULK,P004004,P006961,14.083,13,35,22
320,ULK,P004004,P008962,12.651,-2,24,26
320,ULK,P004004,P009849,1.117,3,6,3
320,ULK,P004004,P010560,0.467,0,2,2
320,ULK,P004004,P011980,7.783,10,19,9
320,ULK,P005844,P006661,5.85,-8,14,22
320,ULK,P005844,P006961,8.483,7,23,16
320,ULK,P005844,P008962,20.517,0,40,40
320,ULK,P005844,P009849,15.333,2,33,31
320,ULK,P005844,P010560,13.583,4,27,23
320,ULK,P006068,P006661,6.433,4,16,12
320,ULK,P006068,P006961,4.15,6,12,6
320,ULK,P006068,P008962,2.467,0,6,6
320,ULK,P006068,P010560,0.75,-2,2,4
320,ULK,P006068,P011980,3.966,4,10,6
320,ULK,P006661,P006961,15.616,7,40,33
320,ULK,P006661,P008962,17.101,-4,39,43
320,ULK,P006661,P009849,3.65,2,11,9
320,ULK,P006661,P010560,3.749,1,8,7
320,ULK,P006661,P011980,10.966,11,27,16
320,ULK,P006961,P008962,13.117,6,31,25
320,ULK,P006961,P009849,4.15,4,14,10
320,ULK,P006961,P010560,1.533,2,5,3
320,ULK,P006961,P011980,7.266,10,19,9
320,ULK,P008962,P009849,14.834,4,31,27
320,ULK,P008962,P010560,15.75,5,32,27
320,ULK,P008962,P011980,6.467,6,16,10
320,ULK,P009849,P010560,13.916,4,27,23
320,ULK,P010560,P011980,3.183,1,8,7
321,PAN,P001926,P002328,3.75,-6,2,8
321,PAN,P001926,P003842,15.516,6,34,28
321,PAN,P001926,P005161,15.4,2,28,26
321,PAN,P001926,P007553,3.75,-6,2,8
321,PAN,P001926,P007866,10.599,-2,20,22
321,PAN,P001926,P007947,5.417,1,11,10
321,PAN,P001926,P011204,13.549,7,31,24
321,PAN,P001926,P011221,0.75,-2,0,2
321,PAN,P001926,P012774,12.533,4,28,24
321,PAN,P002328,P003842,2.65,-7,2,9
321,PAN,P002328,P005161,6.434,-1,12,13
321,PAN,P002328,P007553,6.3,-3,10,13
321,PAN,P002328,P007866,2.516,-9,0,9
321,PAN,P002328,P007947,5.667,1,12,11
321,PAN,P002328,P011204,1.633,-7,0,7
321,PAN,P002328,P012774,6.85,-8,10,18
321,PAN,P003842,P005161,22.0,12,51,39
321,PAN,P003842,P007866,19.465,-17,32,49
321,PAN,P003842,P007947,13.734,4,35,31
321,PAN,P003842,P011204,28.615,0,62,62
321,PAN,P003842,P011209,0.75,3,3,0
321,PAN,P003842,P011221,0.15,0,0,0
321,PAN,P003842,P012774,27.716,-1,61,62
321,PAN,P005161,P007553,5.817,-1,10,11
321,PAN,P005161,P007866,9.716,-7,13,20
321,PAN,P005161,P007947,13.651,8,34,26
321,PAN,P005161,P011204,19.116,10,43,33
321,PAN,P005161,P011209,0.6,3,3,0
321,PAN,P005161,P011221,0.75,-2,0,2
321,PAN,P005161,P012774,20.784,12,50,38
321,PAN,P007553,P007866,0.483,-2,0,2
321,PAN,P007553,P007947,4.65,1,10,9
321,PAN,P007553,P012774,4.2,-1,8,9
321,PAN,P007866,P007947,5.033,0,14,14
321,PAN,P007866,P011204,20.115,-16,35,51
321,PAN,P007866,P011221,0.75,-2,0,2
321,PAN,P007866,P012774,15.315,-17,26,43
321,PAN,P007947,P011204,10.0,7,30,23
321,PAN,P007947,P012774,16.584,10,46,36
321,PAN,P011204,P011209,0.75,3,3,0
321,PAN,P011204,P011221,0.9,-2,0,2
321,PAN,P011204,P012774,23.982,2,56,54
321,PAN,P011209,P011221,0.15,0,0,0
321,PAN,P011209,P012774,0.75,3,3,0
321,PAN,P011221,P012774,0.15,0,0,0
321,TEL,P005145,P007990,9.5,12,22,10
321,TEL,P005145,P009622,12.5,8,27,19
321,TEL,P005145,P009783,12.35,8,27,19
321,TEL,P005145,P011193,1.867,-4,2,6
321,TEL,P005145,P011199,12.35,8,27,19
321,TEL,P005145,P011219,0.15,0,0,0
321,TEL,P005145,P012744,1.283,0,3,3
321,TEL,P007990,P009622,11.817,15,29,14
321,TEL,P007990,P009783,11.667,15,29,14
321,TEL,P007990,P011193,0.5,3,3,0
321,TEL,P007990,P011199,11.667,15,29,14
321,TEL,P007990,P011219,0.15,0,0,0
321,TEL,P007990,P011971,1.967,0,4,4
321,TEL,P009622,P009783,26.118,1,59,58
321,TEL,P009622,P011193,11.184,-16,20,36
321,TEL,P009622,P011199,26.151,3,60,57
321,TEL,P009622,P011214,7.734,3,15,12
321,TEL,P009622,P011219,3.917,-2,6,8
321,TEL,P009622,P011971,12.401,-1,27,28
321,TEL,P009622,P012744,17.518,-7,37,44
321,TEL,P009783,P011193,10.901,-20,19,39
321,TEL,P009783,P011199,28.734,-3,64,67
321,TEL,P009783,P011214,5.434,1,11,10
321,TEL,P009783,P011219,2.734,-7,2,9
321,TEL,P009783,P011971,9.534,-5,20,25
321,TEL,P009783,P012744,16.268,-14,33,47
321,TEL,P011193,P011199,9.334,-15,19,34
321,TEL,P011193,P011214,12.017,2,23,21
321,TEL,P011193,P011219,8.367,-5,12,17
321,TEL,P011193,P011971,5.85,4,12,8
321,TEL,P011193,P012744,15.384,-9,30,39
321,TEL,P011199,P011214,4.35,7,12,5
321,TEL,P011199,P011219,1.05,-5,0,5
321,TEL,P011199,P011971,10.134,-1,23,24
321,TEL,P011199,P012744,15.634,-9,34,43
321,TEL,P011214,P011219,7.734,2,14,12
321,TEL,P011214,P011971,6.267,13,17,4
321,TEL,P011214,P012744,13.868,8,28,20
321,TEL,P011219,P011971,2.85,8,8,0
321,TEL,P011219,P012744,8.784,-3,14,17
321,TEL,P011971,P012744,12.001,10,29,19
323,BAR,P000925,P002939,7.249,-9,5,14
323,BAR,P000925,P003478,6.333,-8,8,16
323,BAR,P000925,P004866,10.0,-5,19,24
323,BAR,P000925,P006435,11.816,2,24,22
323,BAR,P000925,P007519,1.95,-11,0,11
323,BAR,P000925,P009992,2.567,-4,3,7
323,BAR,P000925,P011244,1.216,-3,0,3
323,BAR,P000925,P012745,15.117,-10,27,37
323,BAR,P000925,PLFW,9.084,-4,22,26
323,BAR,P002939,P003196,8.517,-4,13,17
323,BAR,P002939,P003478,5.933,-5,7,12
323,BAR,P002939,P004866,9.85,-8,11,19
323,BAR,P002939,P006435,9.365,-6,7,13
323,BAR,P002939,P007519,3.517,-10,2,12
323,BAR,P002939,P009992,2.867,3,9,6
323,BAR,P002939,P011244,6.849,-10,4,14
323,BAR,P002939,P012745,8.917,-3,14,17
323,BAR,P003196,P003478,9.133,-14,8,22
323,BAR,P003196,P004866,9.633,-4,15,19
323,BAR,P003196,P006435,4.266,-3,2,5
323,BAR,P003196,P007519,5.283,-8,4,12
323,BAR,P003196,P009992,12.199,-11,19,30
323,BAR,P003196,P011244,14.982,-19,12,31
323,BAR,P003196,P012745,3.767,1,11,10
323,BAR,P003196,PLFW,7.216,-10,8,18
323,BAR,P003478,P004866,0.017,0,0,0
323,BAR,P003478,P006435,2.799,5,5,0
323,BAR,P003478,P007519,5.0,-17,2,19
323,BAR,P003478,P009992,8.433,-12,9,21
323,BAR,P003478,P011244,10.332,-17,8,25
323,BAR,P003478,P012745,5.134,-5,8,13
323,BAR,P003478,PLFW,8.75,-15,9,24
323,BAR,P004866,P006435,13.283,-6,21,27
323,BAR,P004866,P007519,7.15,-5,10,15
323,BAR,P004866,P009992,11.25,-6,21,27
323,BAR,P004866,P010641,4.917,-3,8,11
323,BAR,P004866,P011244,10.783,-8,12,20
323,BAR,P004866,P012745,13.767,-4,30,34
323,BAR,P004866,PLFW,7.55,1,21,20
323,BAR,P006435,P011244,4.999,-3,2,5
323,BAR,P006435,P012745,11.083,2,24,22
323,BAR,P006435,PLFW,6.717,5,19,14
323,BAR,P007519,P009992,7.933,-7,10,17
323,BAR,P007519,P010641,4.917,-3,8,11
323,BAR,P007519,P011244,10.683,-14,12,26
323,BAR,P007519,P012745,1.467,-8,0,8
323,BAR,P007519,PLFW,0.7,-5,0,5
323,BAR,P009992,P010641,4.917,-3,8,11
323,BAR,P009992,P011244,13.366,-15,16,31
323,BAR,P009992,P012745,6.317,-3,14,17
323,BAR,P009992,PLFW,8.883,-14,11,25
323,BAR,P010641,P011244,4.917,-3,8,11
323,BAR,P011244,PLFW,6.333,-8,6,14
323,BAR,P012745,PLFW,9.967,-6,24,30
323,OLY,P001255,P003941,4.083,8,11,3
323,OLY,P001255,P007853,6.616,10,16,6
323,OLY,P001255,P007982,8.766,5,13,8
323,OLY,P001255,P008811,15.333,0,27,27
323,OLY,P001255,P008829,12.567,-2,22,24
323,OLY,P001255,P008855,10.65,3,25,22
323,OLY,P001255,P010612,12.8,-2,22,24
323,OLY,P001255,P011194,6.849,10,16,6
323,OLY,P003941,P007853,21.782,31,60,29
323,OLY,P003941,P007982,13.966,23,41,18
323,OLY,P003941,P008829,7.166,-1,16,17
323,OLY,P003941,P008855,10.266,21,29,8
323,OLY,P003941,P010392,1.817,8,8,0
323,OLY,P003941,P010612,4.666,0,10,10
323,OLY,P003941,P011194,14.616,32,44,12
323,OLY,P003941,P011965,8.766,2,21,19
323,OLY,P007853,P007982,16.499,25,46,21
323,OLY,P007853,P008811,5.416,5,10,5
323,OLY,P007853,P008829,10.049,2,21,19
323,OLY,P007853,P008855,13.149,24,34,10
323,OLY,P007853,P010392,1.817,8,8,0
323,OLY,P007853,P010612,7.549,3,15,12
323,OLY,P007853,P011194,17.149,34,49,15
323,OLY,P007853,P011965,8.766,2,21,19
323,OLY,P007982,P008811,8.766,5,13,8
323,OLY,P007982,P008829,9.433,2,16,14
323,OLY,P007982,P008855,6.183,13,18,5
323,OLY,P007982,P010392,1.817,8,8,0
323,OLY,P007982,P010612,7.166,3,10,7
323,OLY,P007982,P011194,13.299,26,38,12
323,OLY,P007982,P011965,5.033,2,13,11
323,OLY,P008811,P008829,15.45,1,27,26
323,OLY,P008811,P008855,9.45,-2,19,21
323,OLY,P008811,P010612,15.683,1,27,26
323,OLY,P008811,P011194,2.766,2,5,3
323,OLY,P008829,P008855,9.45,-2,19,21
323,OLY,P008829,P010612,19.733,1,37,36
323,OLY,P008829,P011965,6.616,-1,14,15
323,OLY,P008855,P010612,9.45,-2,19,21
323,OLY,P008855,P011194,10.266,21,29,8
323,OLY,P010392,P011194,1.817,8,8,0
323,OLY,P010612,P011194,0.616,0,0,0
323,OLY,P010612,P011965,3.733,0,8,8
323,OLY,P011194,P011965,2.15,3,7,4
324,MCO,P002581,P005985,3.534,1,7,6
324,MCO,P002581,P009754,1.95,-4,2,6
324,MCO,P002581,P011212,5.484,-3,9,12
324,MCO,P002581,P011226,5.484,-3,9,12
324,MCO,P002581,P011231,2.267,0,5,5
324,MCO,P002581,PLCZ,3.217,-3,4,7
324,MCO,P004197,P005985,14.283,3,23,20
324,MCO,P004197,P009754,12.25,3,20,17
324,MCO,P004197,P011196,2.166,0,3,3
324,MCO,P004197,P011212,2.166,0,3,3
324,MCO,P004197,P011231,14.15,3,23,20
324,MCO,P004197,PLCZ,12.117,3,20,17
324,MCO,P005985,P009754,20.317,10,42,32
324,MCO,P005985,P011196,14.75,7,29,22
324,MCO,P005985,P011212,19.4,14,40,26
324,MCO,P005985,P011226,18.868,8,39,31
324,MCO,P005985,P011231,24.351,-2,38,40
324,MCO,P005985,PLCZ,17.101,3,30,27
324,MCO,P009754,P011196,11.0,0,17,17
324,MCO,P009754,P011212,13.416,5,23,18
324,MCO,P009754,P011226,14.917,-1,25,26
324,MCO,P009754,P011231,12.784,-2,20,22
324,MCO,P009754,PLCZ,22.034,-3,31,34
324,MCO,P011196,P011212,18.016,9,28,19
324,MCO,P011196,P011226,17.484,3,27,24
324,MCO,P011196,P011231,9.317,-2,13,15
324,MCO,P011196,PLCZ,5.867,-5,3,8
324,MCO,P011212,P011226,24.084,6,40,34
324,MCO,P011212,P011231,11.567,0,18,18
324,MCO,P011212,PLCZ,10.867,-7,11,18
324,MCO,P011226,P011231,10.201,-5,15,20
324,MCO,P011226,PLCZ,11.834,-8,13,21
324,MCO,P011231,PLCZ,12.767,0,20,20
324,ULK,P001932,P002968,0.65,3,3,0
324,ULK,P001932,P004004,3.95,0,11,11
324,ULK,P001932,P005844,21.917,-4,36,40
324,ULK,P001932,P006661,13.317,-5,24,29
324,ULK,P001932,P006961,10.05,-7,11,18
324,ULK,P001932,P008962,25.1,-8,39,47
324,ULK,P001932,P009849,11.9,-3,15,18
324,ULK,P001932,P010560,11.3,-3,17,20
324,ULK,P001932,P011980,2.684,-5,0,5
324,ULK,P002968,P004004,4.167,-1,6,7
324,ULK,P002968,P006661,4.167,-1,6,7
324,ULK,P002968,P006961,4.817,2,9,7
324,ULK,P002968,P008962,2.917,3,8,5
324,ULK,P002968,P009849,0.65,3,3,0
324,ULK,P002968,P011980,1.9,-1,1,2
324,ULK,P004004,P005844,14.484,8,28,20
324,ULK,P004004,P006661,16.534,4,31,27
324,ULK,P004004,P006961,14.534,3,23,20
324,ULK,P004004,P008962,12.034,5,24,19
324,ULK,P004004,P009849,2.2,1,3,2
324,ULK,P004004,P010560,1.833,0,0,0
324,ULK,P004004,P011980,5.2,0,10,10
324,ULK,P005844,P006661,19.084,7,38,31
324,ULK,P005844,P006961,17.034,3,25,22
324,ULK,P005844,P008962,27.617,1,44,43
324,ULK,P005844,P009849,13.45,-5,15,20
324,ULK,P005844,P010560,13.133,-3,17,20
324,ULK,P005844,P011980,3.417,1,9,8
324,ULK,P006661,P006961,15.334,-1,22,23
324,ULK,P006661,P008962,19.084,-1,34,35
324,ULK,P006661,P010560,8.2,-2,11,13
324,ULK,P006661,P011980,7.884,-5,10,15
324,ULK,P006961,P008962,18.134,-2,24,26
324,ULK,P006961,P009849,9.167,-1,12,13
324,ULK,P006961,P010560,1.5,0,0,0
324,ULK,P006961,P011980,7.434,-5,10,15
324,ULK,P008962,P009849,14.1,-2,18,20
324,ULK,P008962,P010560,11.183,-3,17,20
324,ULK,P008962,P011980,2.567,-5,0,5
324,ULK,P009849,P010560,4.933,-1,6,7
324,ULK,P010560,P011980,0.45,0,0,0
325,PAN,P001926,P002328,12.701,1,31,30
325,PAN,P001926,P003842,33.734,11,84,73
325,PAN,P001926,P005161,25.684,13,69,56
325,PAN,P001926,P007866,31.017,11,80,69
325,PAN,P001926,P011204,5.033,-5,7,12
325,PAN,P001926,P011209,0.367,0,0,0
325,PAN,P001926,P012774,27.268,17,77,60
325,PAN,P002328,P003842,12.701,0,28,28
325,PAN,P002328,P005161,5.484,1,15,14
325,PAN,P002328,P007866,11.684,-6,26,32
325,PAN,P002328,P011204,5.234,-7,7,14
325,PAN,P002328,P011209,0.217,0,0,0
325,PAN,P002328,P011221,1.7,-6,2,8
325,PAN,P002328,P012774,8.751,-3,23,26
325,PAN,P003842,P005161,25.984,12,66,54
325,PAN,P003842,P007866,34.684,11,83,72
325,PAN,P003842,P011204,8.4,-4,13,17
325,PAN,P003842,P011209,4.251,1,6,5
325,PAN,P003842,P012774,30.718,17,80,63
325,PAN,P005161,P007866,23.734,12,62,50
325,PAN,P005161,P011204,3.317,-4,5,9
325,PAN,P005161,P011209,0.984,0,0,0
325,PAN,P005161,P011221,0.467,0,0,0
325,PAN,P005161,P012774,21.018,18,59,41
325,PAN,P007866,P011204,8.75,-9,10,19
325,PAN,P007866,P011209,4.718,1,6,5
325,PAN,P007866,P011221,2.167,-6,2,8
325,PAN,P007866,P012774,31.518,10,83,73
325,PAN,P011204,P011209,3.834,1,6,5
325,PAN,P011204,P011221,2.167,-6,2,8
325,PAN,P011204,P012774,5.533,-6,10,16
325,PAN,P011209,P011221,0.467,0,0,0
325,PAN,P011209,P012774,4.034,1,6,5
325,PAN,P011221,P012774,1.7,-6,2,8
325,TEL,P005145,P009622,6.066,-9,11,20
325,TEL,P005145,P009783,5.933,-10,10,20
325,TEL,P005145,P009863,7.066,-6,16,22
325,TEL,P005145,P011193,1.766,-1,5,6
325,TEL,P005145,P011199,7.449,-8,16,24
325,TEL,P005145,P012744,1.516,2,6,4
325,TEL,P007990,P009622,8.5,-12,11,23
325,TEL,P007990,P009783,9.367,-10,16,26
325,TEL,P007990,P011193,7.284,7,17,10
325,TEL,P007990,P011199,7.167,-12,9,21
325,TEL,P007990,P011214,7.017,10,21,11
325,TEL,P007990,P011971,11.034,3,26,23
325,TEL,P007990,P012744,6.367,6,20,14
325,TEL,P009622,P009783,29.183,-14,55,69
325,TEL,P009622,P009863,5.683,-7,11,18
325,TEL,P009622,P011193,17.65,-2,35,37
325,TEL,P009622,P011199,27.066,-8,52,60
325,TEL,P009622,P011214,11.283,-2,24,26
325,TEL,P009622,P011219,4.684,0,11,11
325,TEL,P009622,P011971,7.533,-4,12,16
325,TEL,P009622,P012744,5.216,-6,10,16
325,TEL,P009783,P009863,5.55,-8,10,18
325,TEL,P009783,P011193,18.766,3,42,39
325,TEL,P009783,P011199,27.7,-9,56,65
325,TEL,P009783,P011214,11.716,2,28,26
325,TEL,P009783,P011219,5.283,2,15,13
325,TEL,P009783,P011971,8.4,-2,17,19
325,TEL,P009783,P012744,5.766,-6,15,21
325,TEL,P009863,P011193,1.733,0,5,5
325,TEL,P009863,P011199,7.066,-6,16,22
325,TEL,P009863,P011214,0.35,-1,0,1
325,TEL,P009863,P011971,0.35,-1,0,1
325,TEL,P009863,P012744,1.866,1,6,5
325,TEL,P011193,P011199,17.399,7,41,34
325,TEL,P011193,P011214,16.25,6,39,33
325,TEL,P011193,P011219,6.55,-1,17,18
325,TEL,P011193,P011971,8.0,13,22,9
325,TEL,P011193,P012744,11.466,0,29,29
325,TEL,P011199,P011214,7.633,6,18,12
325,TEL,P011199,P011219,4.1,4,12,8
325,TEL,P011199,P011971,7.75,-5,14,19
325,TEL,P011199,P012744,4.066,3,14,11
325,TEL,P011214,P011219,2.45,-5,5,10
325,TEL,P011214,P011971,5.817,10,17,7
325,TEL,P011214,P012744,10.616,-2,24,26
325,TEL,P011219,P012744,3.133,-4,8,12
325,TEL,P011971,P012744,5.384,6,16,10
327,BAR,P000925,P002939,24.184,-6,38,44
327,BAR,P000925,P003478,12.384,-3,25,28
327,BAR,P000925,P004866,17.016,-4,19,23
327,BAR,P000925,P006435,20.9,1,35,34
327,BAR,P000925,P007519,0.867,-2,0,2
327,BAR,P000925,P011244,4.267,0,10,10
327,BAR,P000925,P012745,23.35,-7,32,39
327,BAR,P000925,PLFW,7.5,-7,9,16
327,BAR,P002939,P003196,2.217,-4,0,4
327,BAR,P002939,P003478,12.818,-7,23,30
327,BAR,P002939,P004866,13.583,-3,15,18
327,BAR,P002939,P006435,19.25,2,33,31
327,BAR,P002939,P007519,0.867,-2,0,2
327,BAR,P002939,P011244,3.434,-2,8,10
327,BAR,P002939,P012745,22.967,-8,30,38
327,BAR,P002939,PLFW,6.284,-10,5,15
327,BAR,P003196,P003478,10.284,-2,12,14
327,BAR,P003196,P004866,2.1,5,5,0
327,BAR,P003196,P006435,4.317,5,7,2
327,BAR,P003196,P007519,5.85,2,10,8
327,BAR,P003196,P011244,4.884,3,7,4
327,BAR,P003196,P012745,7.5,0,10,10
327,BAR,P003196,PLFW,12.384,3,17,14
327,BAR,P003478,P004866,1.783,0,2,2
327,BAR,P003478,P006435,8.434,1,20,19
327,BAR,P003478,P007519,6.717,0,10,10
327,BAR,P003478,P011244,6.318,-1,9,10
327,BAR,P003478,P012745,16.35,-4,28,32
327,BAR,P003478,PLFW,15.584,-4,19,23
327,BAR,P004866,P006435,16.783,5,22,17
327,BAR,P004866,P011244,2.833,4,8,4
327,BAR,P004866,P012745,16.283,-3,16,19
327,BAR,P004866,PLFW,6.083,0,9,9
327,BAR,P006435,P011244,6.167,5,15,10
327,BAR,P006435,P012745,19.05,1,27,26
327,BAR,P006435,PLFW,5.967,4,9,5
327,BAR,P007519,P011244,2.984,-2,2,4
327,BAR,P007519,P012745,3.733,2,8,6
327,BAR,P007519,PLFW,5.85,2,10,8
327,BAR,P011244,PLFW,5.717,5,9,4
327,BAR,P012745,PLFW,14.167,-9,17,26
327,OLY,P001255,P003941,15.734,4,29,25
327,OLY,P001255,P007853,12.684,4,25,21
327,OLY,P001255,P007982,16.201,2,29,27
327,OLY,P001255,P008811,12.3,-2,15,17
327,OLY,P001255,P008829,6.717,-6,2,8
327,OLY,P001255,P008855,18.0,6,33,27
327,OLY,P001255,P010612,15.767,-2,19,21
327,OLY,P001255,P011194,15.984,2,24,22
327,OLY,P001255,P012878,0.417,0,0,0
327,OLY,P003941,P007853,19.967,-3,32,35
327,OLY,P003941,P007982,20.017,-1,34,35
327,OLY,P003941,P008829,6.866,1,12,11
327,OLY,P003941,P008855,11.134,5,23,18
327,OLY,P003941,P010392,5.833,-4,6,10
327,OLY,P003941,P010612,7.033,10,18,8
327,OLY,P003941,P011194,14.484,4,22,18
327,OLY,P007853,P007982,22.367,3,41,38
327,OLY,P007853,P008811,1.833,7,8,1
327,OLY,P007853,P008829,9.3,3,16,13
327,OLY,P007853,P008855,9.534,8,22,14
327,OLY,P007853,P010392,5.833,-4,6,10
327,OLY,P007853,P010612,3.75,5,10,5
327,OLY,P007853,P011194,9.234,-1,12,13
327,OLY,P007853,P012878,2.434,2,4,2
327,OLY,P007982,P008811,5.3,3,10,7
327,OLY,P007982,P008829,12.767,-1,18,19
327,OLY,P007982,P008855,7.717,7,21,14
327,OLY,P007982,P010392,5.833,-4,6,10
327,OLY,P007982,P010612,9.134,6,17,11
327,OLY,P007982,P011194,9.234,-1,12,13
327,OLY,P007982,P012878,2.434,2,4,2
327,OLY,P008811,P008829,6.3,-6,2,8
327,OLY,P008811,P008855,8.833,2,13,11
327,OLY,P008811,P010612,10.467,-9,7,16
327,OLY,P008811,P011194,4.167,-3,5,8
327,OLY,P008829,P008855,2.833,-2,0,2
327,OLY,P008829,P010392,5.133,-2,6,8
327,OLY,P008829,P010612,10.05,-1,12,13
327,OLY,P008829,P012878,2.434,2,4,2
327,OLY,P008855,P010612,10.433,-1,14,15
327,OLY,P008855,P011194,11.384,3,18,15
327,OLY,P010392,P011194,0.7,-2,0,2
327,OLY,P010612,P011194,9.417,2,15,13
327,OLY,P010612,P012878,2.017,2,4,2
328,MCO,P004197,P005985,10.5,-6,10,16
328,MCO,P004197,P009754,10.5,-6,10,16
328,MCO,P004197,P010588,10.5,-6,10,16
328,MCO,P004197,PLCZ,10.5,-6,10,16
328,MCO,P005985,P009754,18.202,-11,20,31
328,MCO,P005985,P010588,28.635,-5,45,50
328,MCO,P005985,P011196,5.35,-4,9,13
328,MCO,P005985,P011212,25.935,0,50,50
328,MCO,P005985,P011226,22.735,11,50,39
328,MCO,P005985,P011231,15.101,-5,27,32
328,MCO,P005985,PLCZ,27.018,4,45,41
328,MCO,P009754,P010588,16.818,-9,17,26
328,MCO,P009754,P011196,3.8,4,12,8
328,MCO,P009754,P011212,12.401,-4,21,25
328,MCO,P009754,P011226,9.584,4,21,17
328,MCO,P009754,P011231,8.434,1,18,17
328,MCO,P009754,PLCZ,19.601,-11,21,32
328,MCO,P010588,P011212,16.668,-1,33,34
328,MCO,P010588,P011226,13.918,8,32,24
328,MCO,P010588,P011231,5.367,-6,8,14
328,MCO,P010588,PLCZ,22.634,-1,35,36
328,MCO,P011196,P011212,9.15,0,21,21
328,MCO,P011196,P011226,9.15,0,21,21
328,MCO,P011196,P011231,9.15,0,21,21
328,MCO,P011212,P011226,27.434,12,61,49
328,MCO,P011212,P011231,21.267,-2,40,42
328,MCO,P011212,PLCZ,17.417,7,34,27
328,MCO,P011226,P011231,20.017,3,41,38
328,MCO,P011226,PLCZ,14.634,18,34,16
328,MCO,P011231,PLCZ,7.6,1,13,12
328,ULK,P001932,P002968,2.517,-1,5,6
328,ULK,P001932,P004004,20.434,-3,37,40
328,ULK,P001932,P005844,20.15,-8,30,38
328,ULK,P001932,P006661,28.634,4,50,46
328,ULK,P001932,P006961,12.434,0,19,19
328,ULK,P001932,P008962,34.618,-1,61,62
328,ULK,P001932,P009849,2.517,-1,5,6
328,ULK,P001932,P010560,12.217,2,19,17
328,ULK,P001932,P011157,8.767,9,16,7
328,ULK,P001932,P011980,8.984,3,18,15
328,ULK,P002968,P004004,1.95,1,6,5
328,ULK,P002968,P006661,0.9,6,6,0
328,ULK,P002968,P006961,4.467,0,11,11
328,ULK,P002968,P008962,3.884,-6,5,11
328,ULK,P002968,P009849,3.567,-6,5,11
328,ULK,P002968,P011980,0.583,6,6,0
328,ULK,P004004,P005844,17.617,0,30,30
328,ULK,P004004,P006661,19.901,4,42,38
328,ULK,P004004,P006961,12.351,2,22,20
328,ULK,P004004,P008962,21.118,-10,37,47
328,ULK,P004004,P009849,1.05,-5,0,5
328,ULK,P004004,P010560,2.1,-4,3,7
328,ULK,P004004,P011157,1.167,-5,0,5
328,ULK,P004004,P011980,12.784,8,31,23
328,ULK,P005844,P006661,18.517,-4,27,31
328,ULK,P005844,P006961,11.6,7,21,14
328,ULK,P005844,P008962,16.95,-10,26,36
328,ULK,P005844,P010560,3.45,-7,3,10
328,ULK,P005844,P011980,6.584,6,11,5
328,ULK,P006661,P006961,11.484,4,22,18
328,ULK,P006661,P008962,27.251,4,50,46
328,ULK,P006661,P010560,10.117,6,16,10
328,ULK,P006661,P011157,9.934,4,16,12
328,ULK,P006661,P011980,12.334,8,31,23
328,ULK,P006961,P008962,11.101,-7,17,24
328,ULK,P006961,P009849,3.567,-6,5,11
328,ULK,P006961,P011157,1.167,-5,0,5
328,ULK,P006961,P011980,10.301,5,19,14
328,ULK,P008962,P009849,3.567,-6,5,11
328,ULK,P008962,P010560,12.217,2,19,17
328,ULK,P008962,P011157,8.767,9,16,7
328,ULK,P008962,P011980,6.467,1,16,15
328,ULK,P010560,P011157,8.767,9,16,7
328,ULK,P011157,P011980,1.167,-5,0,5
329,PAN,P001926,P002328,1.517,1,4,3
329,PAN,P001926,P003842,16.15,-1,33,34
329,PAN,P001926,P005161,14.116,-1,26,27
329,PAN,P001926,P007866,9.199,-8,14,22
329,PAN,P001926,P011204,1.534,0,3,3
329,PAN,P001926,P011209,4.366,-3,8,11
329,PAN,P001926,P011221,2.583,1,5,4
329,PAN,P001926,P012712,11.101,4,24,20
329,PAN,P001926,P012774,17.966,-1,35,36
329,PAN,P002328,P003842,4.667,2,12,10
329,PAN,P002328,P007866,2.25,1,6,5
329,PAN,P002328,P011204,2.65,1,8,7
329,PAN,P002328,P011209,2.917,4,4,0
329,PAN,P002328,P011221,2.417,4,4,0
329,PAN,P002328,P012712,4.834,5,10,5
329,PAN,P002328,P012774,7.084,6,16,10
329,PAN,P003842,P005161,26.5,8,54,46
329,PAN,P003842,P007866,23.283,0,46,46
329,PAN,P003842,P011204,14.001,6,30,24
329,PAN,P003842,P011209,10.683,4,24,20
329,PAN,P003842,P012712,11.101,6,26,20
329,PAN,P003842,P012774,34.283,7,71,64
329,PAN,P005161,P007866,22.916,-2,43,45
329,PAN,P005161,P011204,10.934,6,22,16
329,PAN,P005161,P011209,6.316,1,14,13
329,PAN,P005161,P011221,1.516,-1,3,4
329,PAN,P005161,P012712,6.117,3,12,9
329,PAN,P005161,P012774,27.249,6,54,48
329,PAN,P007866,P011204,12.034,5,26,21
329,PAN,P007866,P011209,6.299,-3,12,15
329,PAN,P007866,P011221,1.516,-1,3,4
329,PAN,P007866,P012712,0.9,-2,0,2
329,PAN,P007866,P012774,24.399,-2,46,48
329,PAN,P011204,P011209,0.55,2,2,0
329,PAN,P011204,P012712,1.184,-1,2,3
329,PAN,P011204,P012774,13.117,5,27,22
329,PAN,P011209,P011221,2.133,0,2,2
329,PAN,P011209,P012712,5.967,5,12,7
329,PAN,P011209,P012774,12.033,6,26,20
329,PAN,P011221,P012712,2.417,4,4,0
329,PAN,P011221,P012774,3.15,5,7,2
329,PAN,P012712,P012774,14.051,8,30,22
329,TEL,P005145,P007990,12.733,6,25,19
329,TEL,P005145,P009622,16.116,4,31,27
329,TEL,P005145,P009783,15.333,2,29,27
329,TEL,P005145,P011193,3.383,-2,6,8
329,TEL,P005145,P011199,16.116,4,31,27
329,TEL,P005145,P012744,0.783,2,2,0
329,TEL,P007990,P009622,20.383,2,37,35
329,TEL,P007990,P009783,19.2,-2,32,34
329,TEL,P007990,P011193,6.2,-5,10,15
329,TEL,P007990,P011199,21.049,3,42,39
329,TEL,P007990,P011214,7.751,-5,12,17
329,TEL,P007990,P011971,8.15,-1,15,16
329,TEL,P007990,P012744,8.334,-2,15,17
329,TEL,P009622,P009783,27.684,-7,48,55
329,TEL,P009622,P011193,13.951,-11,22,33
329,TEL,P009622,P011199,27.383,1,50,49
329,TEL,P009622,P011214,8.252,-7,13,20
329,TEL,P009622,P011971,9.584,-3,17,20
329,TEL,P009622,P012744,11.451,-7,18,25
329,TEL,P009783,P011193,14.55,-4,27,31
329,TEL,P009783,P011199,25.033,-1,45,46
329,TEL,P009783,P011214,8.601,-1,16,17
329,TEL,P009783,P011971,6.5,-1,13,14
329,TEL,P009783,P012744,6.167,-6,10,16
329,TEL,P011193,P011199,12.2,-4,22,26
329,TEL,P011193,P011214,12.918,-9,24,33
329,TEL,P011193,P011971,7.518,-5,11,16
329,TEL,P011193,P012744,10.284,-12,18,30
329,TEL,P011199,P011214,4.95,0,11,11
329,TEL,P011199,P011971,7.1,1,13,12
329,TEL,P011199,P012744,7.433,-4,14,18
329,TEL,P011214,P011971,5.768,-5,10,15
329,TEL,P011214,P012744,9.968,-9,18,27
329,TEL,P011971,P012744,7.184,-2,13,15
330,MAD,P001392,P003108,1.184,-3,0,3
330,MAD,P001392,P003733,0.117,0,0,0
330,MAD,P001392,P004887,5.133,8,19,11
330,MAD,P001392,P005791,1.184,-3,0,3
330,MAD,P001392,P010357,6.317,5,19,14
330,MAD,P001392,PBMT,5.133,8,19,11
330,MAD,P001392,PCVM,6.2,5,19,14
330,MAD,P003108,P003733,0.184,-3,0,3
330,MAD,P003108,P004887,10.818,-8,20,28
330,MAD,P003108,P005791,22.5,10,45,35
330,MAD,P003108,P005928,28.367,10,62,52
330,MAD,P003108,P006540,24.6,12,51,39
330,MAD,P003108,P009213,10.567,-2,20,22
330,MAD,P003108,P010357,16.051,4,32,28
330,MAD,P003108,PBMT,0.4,-3,0,3
330,MAD,P003108,PCVM,9.434,-7,11,18
330,MAD,P003108,PTGB,9.167,-2,19,21
330,MAD,P003733,P004887,0.067,-3,0,3
330,MAD,P003733,P005791,0.117,0,0,0
330,MAD,P003733,P005928,0.067,-3,0,3
330,MAD,P003733,P009213,0.067,-3,0,3
330,MAD,P003733,P010357,0.117,0,0,0
330,MAD,P004887,P005928,10.051,-1,23,24
330,MAD,P004887,P006540,7.917,1,16,15
330,MAD,P004887,P009213,0.067,-3,0,3
330,MAD,P004887,P010357,11.234,4,29,25
330,MAD,P004887,PBMT,5.533,5,19,14
330,MAD,P004887,PCVM,9.917,3,23,20
330,MAD,P004887,PTGB,9.267,-2,19,21
330,MAD,P005791,P005928,19.866,12,42,30
330,MAD,P005791,P006540,18.233,12,38,26
330,MAD,P005791,P009213,10.5,1,20,19
330,MAD,P005791,P010357,11.5,9,25,16
330,MAD,P005791,PCVM,4.65,-2,7,9
330,MAD,P005791,PTGB,1.45,1,3,2
330,MAD,P005928,P006540,26.15,13,54,41
330,MAD,P005928,P009213,10.567,-2,20,22
330,MAD,P005928,P010357,13.05,10,32,22
330,MAD,P005928,PCVM,4.6,1,8,7
330,MAD,P005928,PTGB,6.95,4,19,15
330,MAD,P006540,P009213,10.5,1,20,19
330,MAD,P006540,P010357,9.35,9,21,12
330,MAD,P006540,PCVM,2.967,1,4,3
330,MAD,P006540,PTGB,4.883,3,12,9
330,MAD,P010357,PBMT,5.133,8,19,11
330,MAD,P010357,PCVM,11.2,3,26,23
330,MAD,P010357,PTGB,6.984,0,13,13
330,MAD,PBMT,PCVM,5.533,5,19,14
330,MAD,PBMT,PTGB,0.4,-3,0,3
330,MAD,PCVM,PTGB,3.767,-5,3,8
330,OLY,P001255,P003941,3.6,4,9,5
330,OLY,P001255,P007853,7.683,1,17,16
330,OLY,P001255,P007982,14.9,2,33,31
330,OLY,P001255,P008811,17.983,-3,37,40
330,OLY,P001255,P008829,18.15,3,38,35
330,OLY,P001255,P008855,14.85,3,32,29
330,OLY,P001255,P010612,9.166,-6,18,24
330,OLY,P003941,P007853,10.167,2,17,15
330,OLY,P003941,P007982,8.817,-1,14,15
330,OLY,P003941,P008829,4.75,7,12,5
330,OLY,P003941,P008855,6.367,-2,8,10
330,OLY,P003941,P010612,1.55,3,3,0
330,OLY,P003941,P011194,5.417,-5,5,10
330,OLY,P007853,P007982,21.733,-9,42,51
330,OLY,P007853,P008811,13.45,-9,24,33
330,OLY,P007853,P008829,14.767,0,28,28
330,OLY,P007853,P008855,12.801,-5,20,25
330,OLY,P007853,P010612,13.416,-11,23,34
330,OLY,P007853,P011194,7.9,-9,11,20
330,OLY,P007853,P012878,2.483,-4,6,10
330,OLY,P007982,P008811,18.6,0,41,41
330,OLY,P007982,P008829,18.967,6,42,36
330,OLY,P007982,P008855,16.601,1,34,33
330,OLY,P007982,P010612,9.999,-6,21,27
330,OLY,P007982,P011194,7.5,-9,11,20
330,OLY,P007982,P012878,2.483,-4,6,10
330,OLY,P008811,P008829,23.917,-7,45,52
330,OLY,P008811,P008855,20.334,-3,41,44
330,OLY,P008811,P010612,15.116,-14,24,38
330,OLY,P008829,P008855,21.284,0,44,44
330,OLY,P008829,P010612,12.833,-9,19,28
330,OLY,P008855,P010612,9.15,-9,12,21
330,OLY,P008855,P011194,5.417,-5,5,10
330,OLY,P010612,P011194,2.883,-4,6,10
330,OLY,P010612,P012878,2.483,-4,6,10
330,OLY,P011194,P012878,2.483,-4,6,10
331,PAN,P001926,P002328,13.466,3,26,23
331,PAN,P001926,P003842,15.149,-1,25,26
331,PAN,P001926,P005161,4.7,5,10,5
331,PAN,P001926,P007866,11.283,-7,17,24
331,PAN,P001926,P011204,4.783,9,9,0
331,PAN,P001926,P011221,1.583,3,5,2
331,PAN,P001926,P012712,2.866,3,7,4
331,PAN,P001926,P012774,17.166,5,33,28
331,PAN,P002328,P003842,13.666,0,23,23
331,PAN,P002328,P005161,1.017,3,3,0
331,PAN,P002328,P007866,13.65,0,23,23
331,PAN,P002328,P011204,5.667,6,10,4
331,PAN,P002328,P011209,3.734,5,7,2
331,PAN,P002328,P011221,2.85,3,7,4
331,PAN,P002328,P012712,2.866,3,7,4
331,PAN,P002328,P012774,13.216,1,26,25
331,PAN,P003842,P005161,18.117,14,35,21
331,PAN,P003842,P007866,23.95,9,46,37
331,PAN,P003842,P011204,19.8,21,39,18
331,PAN,P003842,P011209,5.234,4,9,5
331,PAN,P003842,P012712,1.883,0,2,2
331,PAN,P003842,P012774,29.333,9,53,44
331,PAN,P005161,P007866,12.167,9,25,16
331,PAN,P005161,P011204,21.784,17,42,25
331,PAN,P005161,P011209,4.484,-4,4,8
331,PAN,P005161,P011221,3.75,-4,5,9
331,PAN,P005161,P012712,3.75,-4,5,9
331,PAN,P005161,P012774,21.767,16,43,27
331,PAN,P007866,P011204,16.317,16,31,15
331,PAN,P007866,P011209,3.734,5,7,2
331,PAN,P007866,P011221,2.467,0,2,2
331,PAN,P007866,P012774,22.1,4,41,37
331,PAN,P011204,P011209,8.218,1,11,10
331,PAN,P011204,P011221,6.217,-4,7,11
331,PAN,P011204,P012712,3.75,-4,5,9
331,PAN,P011204,P012774,21.6,18,42,24
331,PAN,P011209,P011221,2.984,-3,2,5
331,PAN,P011209,P012712,1.117,-3,0,3
331,PAN,P011209,P012774,3.367,-1,4,5
331,PAN,P011221,P012712,4.733,-1,10,11
331,PAN,P011221,P012774,4.216,2,10,8
331,PAN,P012712,P012774,5.499,2,12,10
331,ULK,P001932,P002968,16.983,-1,34,35
331,ULK,P001932,P004004,22.149,-2,30,32
331,ULK,P001932,P005844,2.267,1,3,2
331,ULK,P001932,P006661,18.534,-20,19,39
331,ULK,P001932,P006961,16.083,3,32,29
331,ULK,P001932,P008962,30.733,-10,44,54
331,ULK,P001932,P009849,3.567,1,5,4
331,ULK,P001932,P010560,7.067,-8,8,16
331,ULK,P001932,P011157,3.367,-8,0,8
331,ULK,P001932,P011980,14.05,-8,13,21
331,ULK,P002968,P004004,13.482,1,23,22
331,ULK,P002968,P006661,11.067,-7,15,22
331,ULK,P002968,P006961,14.633,9,35,26
331,ULK,P002968,P008962,16.449,4,37,33
331,ULK,P002968,P009849,5.65,-4,5,9
331,ULK,P002968,P010560,1.833,-1,5,6
331,ULK,P002968,P011980,4.767,-5,2,7
331,ULK,P004004,P005844,0.717,0,0,0
331,ULK,P004004,P006661,9.899,-9,7,16
331,ULK,P004004,P006961,12.066,2,21,19
331,ULK,P004004,P008962,22.182,1,33,32
331,ULK,P004004,P009849,5.399,1,8,7
331,ULK,P004004,P010560,0.317,0,0,0
331,ULK,P004004,P011980,13.449,-10,10,20
331,ULK,P005844,P006661,3.617,-2,8,10
331,ULK,P005844,P006961,0.4,0,0,0
331,ULK,P005844,P008962,0.717,0,0,0
331,ULK,P005844,P009849,2.067,-3,5,8
331,ULK,P005844,P010560,3.934,-2,8,10
331,ULK,P005844,P011980,3.617,-2,8,10
331,ULK,P006661,P006961,5.334,1,11,10
331,ULK,P006661,P008962,16.417,-19,16,35
331,ULK,P006661,P009849,6.351,-6,7,13
331,ULK,P006661,P010560,7.784,-14,8,22
331,ULK,P006661,P011157,3.367,-8,0,8
331,ULK,P006661,P011980,13.434,-12,13,25
331,ULK,P006961,P008962,16.966,4,35,31
331,ULK,P006961,P009849,2.35,3,5,2
331,ULK,P006961,P010560,1.033,3,5,2
331,ULK,P006961,P011980,4.867,-1,4,5
331,ULK,P008962,P009849,3.033,6,8,2
331,ULK,P008962,P010560,5.517,-9,5,14
331,ULK,P008962,P011157,3.367,-8,0,8
331,ULK,P008962,P011980,11.083,-5,10,15
331,ULK,P009849,P010560,2.067,-3,5,8
331,ULK,P009849,P011980,8.984,-3,12,15
331,ULK,P010560,P011157,3.367,-8,0,8
331,ULK,P010560,P011980,3.617,-2,8,10
332,OLY,P001255,P003941,6.367,3,19,16
332,OLY,P001255,P007853,3.25,12,17,5
332,OLY,P001255,P007982,4.917,4,16,12
332,OLY,P001255,P008811,10.95,-4,15,19
332,OLY,P001255,P008829,15.383,-1,30,31
332,OLY,P001255,P008855,12.133,-3,18,21
332,OLY,P001255,P010392,0.367,1,3,2
332,OLY,P001255,P010612,13.9,-8,20,28
332,OLY,P001255,P011194,1.767,5,7,2
332,OLY,P001255,P011965,0.367,1,3,2
332,OLY,P001255,P012878,0.267,-2,0,2
332,OLY,P003941,P007853,9.15,12,29,17
332,OLY,P003941,P007982,17.784,13,49,36
332,OLY,P003941,P008829,10.8,3,32,29
332,OLY,P003941,P008855,4.533,1,13,12
332,OLY,P003941,P010392,14.117,7,35,28
332,OLY,P003941,P010612,2.95,-4,5,9
332,OLY,P003941,P011194,3.667,5,10,5
332,OLY,P003941,P011965,5.75,4,12,8
332,OLY,P003941,P012878,5.75,4,12,8
332,OLY,P007853,P007982,16.317,4,41,37
332,OLY,P007853,P008829,11.483,6,31,25
332,OLY,P007853,P010392,13.267,-2,30,32
332,OLY,P007853,P011194,4.934,1,13,12
332,OLY,P007853,P011965,0.1,3,3,0
332,OLY,P007853,P012878,7.167,-8,12,20
332,OLY,P007982,P008811,0.583,0,0,0
332,OLY,P007982,P008829,16.1,-2,38,40
332,OLY,P007982,P008855,2.95,0,8,8
332,OLY,P007982,P010392,21.6,1,48,47
332,OLY,P007982,P010612,1.767,-5,2,7
332,OLY,P007982,P011194,5.917,1,16,15
332,OLY,P007982,P011965,5.483,6,13,7
332,OLY,P007982,P012878,12.65,-2,25,27
332,OLY,P008811,P008829,11.533,-4,15,19
332,OLY,P008811,P008855,11.533,-4,15,19
332,OLY,P008811,P010392,0.583,0,0,0
332,OLY,P008811,P010612,10.95,-4,15,19
332,OLY,P008829,P008855,15.083,-3,26,29
332,OLY,P008829,P010392,13.05,2,32,30
332,OLY,P008829,P010612,13.9,-8,20,28
332,OLY,P008829,P011965,0.1,3,3,0
332,OLY,P008829,P012878,5.9,-4,9,13
332,OLY,P008855,P010392,3.933,0,10,10
332,OLY,P008855,P010612,12.133,-3,18,21
332,OLY,P008855,P011965,0.983,0,2,2
332,OLY,P008855,P012878,0.983,0,2,2
332,OLY,P010392,P011194,4.15,-4,9,13
332,OLY,P010392,P011965,6.833,7,18,11
332,OLY,P010392,P012878,13.9,-4,27,31
332,OLY,P011194,P011965,0.983,0,3,3
332,OLY,P011194,P012878,2.25,-4,6,10
332,OLY,P011965,P012878,6.733,4,15,11
332,ULK,P001932,P002968,16.95,6,31,25
332,ULK,P001932,P004004,5.233,-1,11,12
332,ULK,P001932,P005844,4.983,-5,8,13
332,ULK,P001932,P006661,23.65,5,47,42
332,ULK,P001932,P008962,18.684,14,43,29
332,ULK,P001932,P009849,5.233,-1,11,12
332,ULK,P001932,P010560,21.15,8,44,36
332,ULK,P001932,P011157,6.95,3,19,16
332,ULK,P001932,P011201,2.5,-3,3,6
332,ULK,P001932,P011980,10.199,-10,15,25
332,ULK,P002968,P004004,1.967,5,8,3
332,ULK,P002968,P006661,18.917,11,39,28
332,ULK,P002968,P008962,17.584,16,39,23
332,ULK,P002968,P009849,0.0,0,0,0
332,ULK,P002968,P010560,18.917,11,39,28
332,ULK,P002968,P011980,1.333,-5,0,5
332,ULK,P004004,P006661,3.15,4,11,7
332,ULK,P004004,P008962,5.5,-4,13,17
332,ULK,P004004,P009849,12.0,-7,26,33
332,ULK,P004004,P010560,3.15,4,11,7
332,ULK,P004004,P011052,6.117,-4,15,19
332,ULK,P004004,P011157,13.183,-8,29,37
332,ULK,P004004,P011980,10.3,-1,24,25
332,ULK,P005844,P006661,4.983,-5,8,13
332,ULK,P005844,P008962,1.35,-1,4,5
332,ULK,P005844,P009849,0.867,-2,0,2
332,ULK,P005844,P010560,2.483,-2,5,7
332,ULK,P005844,P011052,0.867,-2,0,2
332,ULK,P005844,P011201,3.367,-5,3,8
332,ULK,P005844,P011980,4.5,-6,4,10
332,ULK,P006661,P008962,21.834,18,54,36
332,ULK,P006661,P009849,0.0,0,0,0
332,ULK,P006661,P010560,24.3,12,55,43
332,ULK,P006661,P011157,2.9,3,11,8
332,ULK,P006661,P011201,2.5,-3,3,6
332,ULK,P006661,P011980,4.966,-9,4,13
332,ULK,P008962,P009849,2.683,-11,2,13
332,ULK,P008962,P010560,21.834,18,54,36
332,ULK,P008962,P011052,1.7,-6,2,8
332,ULK,P008962,P011157,5.583,-8,13,21
332,ULK,P008962,P011201,0.333,-3,0,3
332,ULK,P008962,P011980,0.983,-5,0,5
332,ULK,P009849,P011052,6.984,-6,15,21
332,ULK,P009849,P011157,12.333,-10,26,36
332,ULK,P009849,P011201,1.2,-5,0,5
332,ULK,P009849,P011980,11.5,-6,24,30
332,ULK,P010560,P011157,2.9,3,11,8
332,ULK,P010560,P011980,2.466,-6,1,7
332,ULK,P011052,P011157,6.117,-4,15,19
332,ULK,P011052,P011201,0.867,-2,0,2
332,ULK,P011052,P011980,5.284,0,13,13
332,ULK,P011157,P011201,0.333,-3,0,3
332,ULK,P011157,P011980,10.633,-4,24,28
332,ULK,P011201,P011980,3.7,-8,3,11
333,MAD,P001392,P003108,0.35,-2,0,2
333,MAD,P001392,P004887,3.617,2,9,7
333,MAD,P001392,P005791,0.033,0,0,0
333,MAD,P001392,P006540,0.317,-2,0,2
333,MAD,P001392,P009213,0.35,0,2,2
333,MAD,P001392,P010357,3.984,1,9,8
333,MAD,P001392,PBMT,4.1,4,11,7
333,MAD,P001392,PCVM,4.034,2,9,7
333,MAD,P001392,PTGB,0.883,3,4,1
333,MAD,P003108,P004887,11.15,5,32,27
333,MAD,P003108,P005791,18.849,-4,33,37
333,MAD,P003108,P005928,20.65,4,52,48
333,MAD,P003108,P006540,25.867,2,60,58
333,MAD,P003108,P009213,7.15,6,25,19
333,MAD,P003108,P010357,12.1,-10,15,25
333,MAD,P003108,PBMT,4.699,-5,6,11
333,MAD,P003108,PCVM,10.816,-6,16,22
333,MAD,P003108,PTGB,15.633,-6,33,39
333,MAD,P004887,P005928,7.317,8,26,18
333,MAD,P004887,P006540,8.6,10,30,20
333,MAD,P004887,P009213,2.8,3,14,11
333,MAD,P004887,P010357,8.883,-3,17,20
333,MAD,P004887,PBMT,6.45,-8,9,17
333,MAD,P004887,PCVM,8.95,-9,13,22
333,MAD,P004887,PTGB,7.433,-4,14,18
333,MAD,P005791,P005928,14.85,-8,26,34
333,MAD,P005791,P006540,18.067,-12,28,40
333,MAD,P005791,P009213,3.333,4,10,6
333,MAD,P005791,P010357,8.734,-16,3,19
333,MAD,P005791,PBMT,3.366,-1,6,7
333,MAD,P005791,PCVM,6.55,-5,8,13
333,MAD,P005791,PTGB,11.95,-10,22,32
333,MAD,P005928,P006540,20.917,1,50,49
333,MAD,P005928,P009213,6.1,5,22,17
333,MAD,P005928,P010357,8.35,-10,8,18
333,MAD,P005928,PTGB,10.484,0,24,24
333,MAD,P006540,P009213,7.15,6,25,19
333,MAD,P006540,P010357,13.467,-18,14,32
333,MAD,P006540,PCVM,7.25,-6,11,17
333,MAD,P006540,PTGB,12.301,-9,26,35
333,MAD,P009213,P010357,1.05,1,3,2
333,MAD,P009213,PBMT,0.033,2,2,0
333,MAD,P009213,PCVM,0.733,3,3,0
333,MAD,P009213,PTGB,0.033,2,2,0
333,MAD,P010357,PBMT,5.167,-3,9,12
333,MAD,P010357,PCVM,11.217,-10,17,27
333,MAD,P010357,PTGB,6.584,-20,5,25
333,MAD,PBMT,PCVM,10.2,-9,15,24
333,MAD,PBMT,PTGB,7.049,-8,10,18
333,MAD,PCVM,PTGB,10.05,-20,12,32
333,PAN,P001926,P002328,6.267,-4,11,15
333,PAN,P001926,P003842,19.634,4,43,39
333,PAN,P001926,P005161,8.817,6,17,11
333,PAN,P001926,P007866,10.634,15,34,19
333,PAN,P001926,P007947,5.884,-3,10,13
333,PAN,P001926,P011204,17.634,12,42,30
333,PAN,P001926,P011209,3.1,2,6,4
333,PAN,P001926,P011221,2.767,-1,4,5
333,PAN,P001926,P012712,12.034,-6,20,26
333,PAN,P001926,P012774,13.233,11,37,26
333,PAN,P002328,P003842,3.5,-3,7,10
333,PAN,P002328,P005161,0.167,-2,0,2
333,PAN,P002328,P007866,1.433,0,2,2
333,PAN,P002328,P011204,3.167,-2,5,7
333,PAN,P002328,P011209,0.85,-1,3,4
333,PAN,P002328,P011221,3.167,-2,5,7
333,PAN,P002328,P012712,5.234,-5,10,15
333,PAN,P002328,P012774,2.883,-1,5,6
333,PAN,P003842,P005161,15.484,4,36,32
333,PAN,P003842,P007866,14.0,3,41,38
333,PAN,P003842,P007947,12.517,10,28,18
333,PAN,P003842,P011204,25.883,18,67,49
333,PAN,P003842,P011209,5.017,7,14,7
333,PAN,P003842,P012712,15.933,8,34,26
333,PAN,P003842,P012774,20.9,9,54,45
333,PAN,P005161,P007866,8.967,-7,24,31
333,PAN,P005161,P007947,5.0,8,12,4
333,PAN,P005161,P011204,15.4,5,38,33
333,PAN,P005161,P011209,3.934,0,6,6
333,PAN,P005161,P012712,6.1,7,13,6
333,PAN,P005161,P012774,9.667,-5,26,31
333,PAN,P007866,P007947,0.717,2,2,0
333,PAN,P007866,P011204,15.984,6,47,41
333,PAN,P007866,P011209,0.617,-4,0,4
333,PAN,P007866,P012712,0.717,2,2,0
333,PAN,P007866,P012774,17.267,3,48,45
333,PAN,P007947,P011204,9.567,11,24,13
333,PAN,P007947,P011209,3.933,5,10,5
333,PAN,P007947,P012712,10.617,10,26,16
333,PAN,P007947,P012774,4.833,5,8,3
333,PAN,P011204,P011209,2.967,0,9,9
333,PAN,P011204,P011221,3.167,-2,5,7
333,PAN,P011204,P012712,16.7,12,34,22
333,PAN,P011204,P012774,20.067,12,53,41
333,PAN,P011209,P011221,0.4,-1,1,2
333,PAN,P011209,P012712,2.133,2,9,7
333,PAN,P011209,P012774,1.317,-2,2,4
333,PAN,P011221,P012712,3.167,-2,5,7
333,PAN,P012712,P012774,6.633,4,11,7
