Gamecode,CODETEAM,J1,TIME,DELTA_SCORE,OFF,DEF
1,TSO,P008790,16.1,8,40,32
1,TSO,P009649,40.901,-9,83,92
1,TSO,P012019,34.301,-7,64,71
1,TSO,P013293,32.467,5,72,67
1,TSO,P013295,31.35,-9,67,76
1,TSO,P013296,28.901,-11,53,64
1,TSO,P013297,13.651,6,26,20
1,TSO,P013298,27.334,2,60,58
1,ULM,P006245,14.716,12,33,21
1,ULM,P006997,24.717,11,51,40
1,ULM,P007952,6.816,-14,11,25
1,ULM,P010726,8.266,-5,18,23
1,ULM,P011391,27.065,-1,63,64
1,ULM,P011437,35.299,5,78,73
1,ULM,P012077,23.867,-10,50,60
1,ULM,P012602,12.932,1,24,23
1,ULM,P013289,9.849,1,21,20
1,ULM,P013290,39.917,6,85,79
1,ULM,P013291,21.551,9,46,37
2,HTA,P001927,33.782,-1,65,66
2,HTA,P005181,31.781,7,68,61
2,HTA,P009818,15.6,-10,23,33
2,HTA,P010386,18.399,-15,29,44
2,HTA,P010550,8.699,-2,12,14
2,HTA,P011157,19.949,-13,29,42
2,HTA,P011386,3.167,0,3,3
2,HTA,P012096,25.249,10,54,44
2,HTA,P013283,14.299,12,34,22
2,HTA,P013284,29.065,-3,58,61
2,JOV,P002361,18.899,-3,41,44
2,JOV,P002507,23.0,12,49,37
2,JOV,P004834,16.967,-7,29,36
2,JOV,P005099,19.518,-16,29,45
2,JOV,P010161,20.232,18,48,30
2,JOV,P012349,12.567,-14,16,30
2,JOV,P012740,17.435,-8,25,33
2,JOV,P013285,26.583,8,55,47
2,JOV,P013286,9.884,-2,14,16
2,JOV,P013287,27.149,15,62,47
2,JOV,PJUG,7.766,12,22,10
3,BAH,P003840,34.502,18,76,58
3,BAH,P004172,18.784,7,36,29
3,BAH,P008278,0.117,-3,0,3
3,BAH,P009601,22.701,3,52,49
3,BAH,P011192,22.351,6,41,35
3,BAH,P011201,14.784,-7,20,27
3,BAH,P011821,29.585,12,67,55
3,BAH,P011823,25.951,19,57,38
3,BAH,P012405,12.467,-5,20,25
3,BAH,P012711,18.768,5,31,26
3,WOL,P003212,3.266,1,6,5
3,WOL,P004645,15.934,7,32,25
3,WOL,P005516,17.818,-1,25,26
3,WOL,P006546,26.785,-7,54,61
3,WOL,P006853,9.6,-1,11,12
3,WOL,P008186,17.001,8,33,25
3,WOL,P011248,30.235,-19,54,73
3,WOL,P012003,32.536,-3,60,63
3,WOL,P012577,26.751,-22,43,65
3,WOL,P012789,20.084,-18,27,45
4,BES,P003783,17.217,14,44,30
4,BES,P007914,17.166,13,46,33
4,BES,P008945,23.383,9,60,51
4,BES,P009680,17.984,13,51,38
4,BES,P010652,25.301,21,64,43
4,BES,P011379,13.216,-1,27,28
4,BES,P011924,20.033,5,44,39
4,BES,P011927,23.399,3,46,43
4,BES,P011936,19.417,8,40,32
4,BES,P013255,22.884,5,48,43
4,BUD,P005637,18.267,-17,32,49
4,BUD,P006561,7.584,-10,9,19
4,BUD,P006566,15.7,-6,22,28
4,BUD,P008325,30.466,-10,63,73
4,BUD,P010307,3.316,-2,10,12
4,BUD,P011150,30.033,-6,61,67
4,BUD,P011281,20.466,-20,36,56
4,BUD,P012606,19.534,2,40,38
4,BUD,P012630,22.151,-10,43,53
4,BUD,P013256,21.733,-1,44,45
4,BUD,P013258,8.85,-12,16,28
4,BUD,P013259,1.9,2,4,2
5,CAN,P003425,26.2,5,54,49
5,CAN,P005005,4.783,0,9,9
5,CAN,P006588,22.417,8,48,40
5,CAN,P007560,7.167,-4,16,20
5,CAN,P008121,28.049,7,59,52
5,CAN,P008966,24.433,6,54,48
5,CAN,P010452,17.582,-5,36,41
5,CAN,P010623,13.799,-2,30,32
5,CAN,P011251,18.049,-4,36,40
5,CAN,P012016,15.566,-3,30,33
5,CAN,P012095,21.95,7,48,41
5,TRN,P005438,26.466,0,55,55
5,TRN,P006382,11.099,1,19,18
5,TRN,P006724,21.733,-1,48,49
5,TRN,P012593,27.85,-3,60,63
5,TRN,P012687,10.366,-6,22,28
5,TRN,P013269,20.766,-7,34,41
5,TRN,P013270,27.866,3,65,62
5,TRN,P013271,25.516,0,48,48
5,TRN,P013272,28.333,-2,54,56
6,JER,P006625,27.617,-9,45,54
6,JER,P009879,16.135,-8,17,25
6,JER,P010431,10.651,-2,20,22
6,JER,P010587,30.318,-15,45,60
6,JER,P011970,27.584,-8,54,62
6,JER,P013276,14.702,-19,13,32
6,JER,P013277,19.951,-7,33,40
6,JER,P013278,24.233,1,46,45
6,JER,P013279,19.702,-5,35,40
6,JER,P013281,9.117,-8,12,20
6,PAM,P004863,18.2,18,38,20
6,PAM,P005356,16.616,-10,27,37
6,PAM,P006643,17.8,20,40,20
6,PAM,P007527,21.917,-2,42,44
6,PAM,P009864,8.433,-5,13,18
6,PAM,P010042,23.267,26,53,27
6,PAM,P010393,21.65,13,47,34
6,PAM,P010444,16.883,17,38,21
6,PAM,P011980,16.666,-1,29,30
6,PAM,P011982,23.884,0,44,44
6,PAM,P012738,14.684,4,29,25
7,BOU,P004525,21.45,14,53,39
7,BOU,P004945,13.867,9,35,26
7,BOU,P006904,19.684,-8,42,50
7,BOU,P009552,19.166,8,49,41
7,BOU,P009556,14.85,7,38,31
7,BOU,P010449,20.316,28,58,30
7,BOU,P011837,18.151,12,44,32
7,BOU,P013264,21.233,6,54,48
7,BOU,P013265,26.133,11,65,54
7,BOU,P013266,25.15,13,62,49
7,HAM,P003242,25.067,-9,51,60
7,HAM,P006006,19.7,-7,42,49
7,HAM,P006420,14.934,-9,30,39
7,HAM,P008103,16.55,-11,34,45
7,HAM,P010070,6.016,-5,11,16
7,HAM,P011256,15.482,-19,20,39
7,HAM,P012695,12.466,0,29,29
7,HAM,P013308,25.084,-10,53,63
7,HAM,P013309,14.884,-5,32,37
7,HAM,P013311,18.534,-1,44,45
7,HAM,P013312,16.233,-15,28,43
7,HAM,P013313,15.05,-9,26,35
8,CLU,P002820,24.349,-4,50,54
8,CLU,P004862,11.501,-6,28,34
8,CLU,P005714,15.734,-6,33,39
8,CLU,P006618,11.484,-1,27,28
8,CLU,P010651,32.533,-7,70,77
8,CLU,P011801,12.416,0,28,28
8,CLU,P012620,8.883,-2,18,20
8,CLU,P012698,26.5,-10,52,62
8,CLU,P013302,30.667,2,68,66
8,CLU,P013304,25.933,-1,56,57
8,LJU,P003452,19.899,-7,39,46
8,LJU,P003703,18.068,8,45,37
8,LJU,P009392,5.601,3,11,8
8,LJU,P009753,13.167,8,30,22
8,LJU,P012042,28.683,5,68,63
8,LJU,P012700,28.55,1,66,65
8,LJU,P012996,23.984,2,56,54
8,LJU,P013260,22.15,2,51,49
8,LJU,P013261,25.735,14,67,53
8,LJU,P013262,11.318,2,25,23
8,LJU,P013263,2.85,-3,7,10
9,ARI,P003240,21.183,-10,37,47
9,ARI,P004292,22.415,-10,37,47
9,ARI,P008084,28.865,-19,51,70
9,ARI,P013248,17.068,-6,38,44
9,ARI,P013249,22.033,-18,31,49
9,ARI,P013250,21.267,-5,50,55
9,ARI,P013251,17.165,-9,35,44
9,ARI,P013252,14.516,2,31,29
9,ARI,P013355,5.099,-11,3,14
9,ARI,P013356,20.568,-5,42,47
9,ARI,P013360,9.816,-9,20,29
9,VNC,P003759,14.999,20,42,22
9,VNC,P005404,13.0,-1,31,32
9,VNC,P006571,4.55,0,9,9
9,VNC,P007759,29.049,24,72,48
9,VNC,P008858,28.617,20,67,47
9,VNC,P009400,9.832,-1,22,23
9,VNC,P011909,28.532,17,70,53
9,VNC,P011928,26.0,17,61,44
9,VNC,P012796,25.0,0,53,53
9,VNC,P013305,20.416,4,48,44
10,LKB,P005521,25.317,-2,46,48
10,LKB,P005656,25.365,1,46,45
10,LKB,P006586,31.517,10,58,48
10,LKB,P006860,14.466,-12,17,29
10,LKB,P009299,20.317,-7,33,40
10,LKB,P009898,17.033,-12,20,32
10,LKB,P010461,18.401,0,33,33
10,LKB,P013247,23.917,4,46,42
10,LKB,PLXI,23.667,-12,31,43
10,TTK,P004056,13.618,4,28,24
10,TTK,P004218,17.1,-1,29,30
10,TTK,P004619,3.933,5,9,4
10,TTK,P006598,23.0,4,41,37
10,TTK,P007917,4.7,-1,7,8
10,TTK,P009025,32.018,6,56,50
10,TTK,P011935,25.634,-2,43,45
10,TTK,P011973,27.885,-1,49,50
10,TTK,P012259,25.017,-4,42,46
10,TTK,P012415,10.1,8,23,15
10,TTK,P013300,17.0,12,33,21
11,TRN,P002387,10.9,-6,19,25
11,TRN,P005438,17.034,6,38,32
11,TRN,P006382,11.35,0,21,21
11,TRN,P006724,19.633,14,44,30
11,TRN,P012593,26.366,-3,53,56
11,TRN,P012687,16.082,3,35,32
11,TRN,P013269,20.299,3,42,39
11,TRN,P013270,28.866,9,63,54
11,TRN,P013271,20.366,-8,40,48
11,TRN,P013272,29.099,12,65,53
11,TSO,P008790,18.836,-7,36,43
11,TSO,P009649,31.252,-9,60,69
11,TSO,P012019,33.319,-3,66,69
11,TSO,P013292,6.7,-8,11,19
11,TSO,P013293,23.269,-14,39,53
11,TSO,P013295,24.635,-5,45,50
11,TSO,P013296,10.784,-1,22,23
11,TSO,P013297,25.751,1,53,52
11,TSO,P013298,25.469,16,58,42
12,BUD,P005637,8.983,-23,8,31
12,BUD,P006566,20.3,3,45,42
12,BUD,P008325,34.516,23,77,54
12,BUD,P011150,36.299,6,71,65
12,BUD,P011281,35.649,15,78,63
12,BUD,P012606,9.617,-18,8,26
12,BUD,P012630,17.149,-6,30,36
12,BUD,P013256,35.716,20,78,58
12,BUD,P013258,16.283,-9,26,35
12,BUD,P013259,10.483,-26,9,35
12,CAN,P003425,23.549,1,45,44
12,CAN,P005005,9.117,13,22,9
12,CAN,P006588,22.65,-1,48,49
12,CAN,P007560,0.3,0,0,0
12,CAN,P008121,35.883,-10,67,77
12,CAN,P008966,25.233,6,47,41
12,CAN,P010452,21.85,4,41,37
12,CAN,P010623,22.734,-1,44,45
12,CAN,P011251,26.917,-9,55,64
12,CAN,P012016,19.767,-3,42,45
12,CAN,P012095,17.0,15,34,19
13,BAH,P003840,26.251,17,57,40
13,BAH,P004172,19.718,10,44,34
13,BAH,P009601,25.318,14,58,44
13,BAH,P011192,26.485,19,63,44
13,BAH,P011201,20.934,7,40,33
13,BAH,P011821,26.618,10,57,47
13,BAH,P011823,21.368,20,50,30
13,BAH,P012405,11.733,-4,19,23
13,BAH,P012711,21.585,12,47,35
13,BES,P003783,21.467,-6,36,42
13,BES,P007914,19.4,-4,37,41
13,BES,P008945,22.017,-15,40,55
13,BES,P009680,19.2,-19,30,49
13,BES,P010652,22.484,-10,35,45
13,BES,P011379,13.216,-5,23,28
13,BES,P011924,15.733,-10,25,35
13,BES,P011927,19.233,0,33,33
13,BES,P011936,19.7,-14,30,44
13,BES,P013255,27.55,-22,41,63
14,HTA,P001927,26.617,7,58,51
14,HTA,P004846,22.65,4,52,48
14,HTA,P005181,23.55,5,53,48
14,HTA,P009818,7.25,0,17,17
14,HTA,P010386,9.317,-4,19,23
14,HTA,P010550,28.617,6,63,57
14,HTA,P011157,30.566,8,69,61
14,HTA,P012096,13.133,-7,26,33
14,HTA,P013283,10.083,-5,22,27
14,HTA,P013284,28.217,11,66,55
14,WOL,P003212,5.783,-2,13,15
14,WOL,P004645,23.567,-2,47,49
14,WOL,P005516,14.317,-3,32,35
14,WOL,P006853,20.783,1,45,44
14,WOL,P008186,13.884,2,32,30
14,WOL,P009306,10.584,-12,19,31
14,WOL,P011248,26.435,-3,55,58
14,WOL,P012003,32.368,-4,64,68
14,WOL,P012577,25.484,6,59,53
14,WOL,P012789,26.8,-8,54,62
15,JOV,P002361,17.849,4,40,36
15,JOV,P002507,20.949,1,47,46
15,JOV,P004834,18.816,-5,36,41
15,JOV,P006771,10.4,-15,13,28
15,JOV,P010161,17.282,0,29,29
15,JOV,P012349,14.199,-11,25,36
15,JOV,P012740,25.965,-6,58,64
15,JOV,P013285,26.733,5,55,50
15,JOV,P013286,3.983,-5,7,12
15,JOV,P013287,25.799,7,58,51
15,JOV,PJUG,18.015,5,47,42
15,ULM,P006245,23.583,0,55,55
15,ULM,P006997,21.7,0,46,46
15,ULM,P007952,10.767,3,27,24
15,ULM,P010726,14.233,3,30,27
15,ULM,P011391,18.3,4,41,37
15,ULM,P011437,24.284,0,53,53
15,ULM,P012077,17.9,5,36,31
15,ULM,P012602,11.133,2,23,21
15,ULM,P013289,5.8,4,13,9
15,ULM,P013290,28.867,2,64,62
15,ULM,P013291,23.433,-3,47,50
16,JER,P006625,31.034,24,81,57
16,JER,P008912,18.851,-9,34,43
16,JER,P010431,19.384,29,55,26
16,JER,P010587,28.65,15,73,58
16,JER,P011970,30.034,22,73,51
16,JER,P013276,21.101,23,54,31
16,JER,P013277,20.567,-7,39,46
16,JER,P013278,12.567,-14,21,35
16,JER,P013279,12.367,10,26,16
16,JER,P013281,5.45,7,14,7
16,LKB,P005113,20.95,2,44,42
16,LKB,P005521,21.4,-3,40,43
16,LKB,P005656,20.95,10,47,37
16,LKB,P006586,22.85,-24,36,60
16,LKB,P006860,11.117,-12,17,29
16,LKB,P009299,21.333,-7,44,51
16,LKB,P009898,19.55,-18,33,51
16,LKB,P010461,19.05,-22,30,52
16,LKB,P013247,22.317,-1,45,46
16,LKB,PLXI,20.483,-25,34,59
17,ARI,P003240,19.999,-4,28,32
17,ARI,P004292,24.098,0,38,38
17,ARI,P008084,30.282,-3,52,55
17,ARI,P013049,0.067,2,2,0
17,ARI,P013248,12.066,5,27,22
17,ARI,P013249,26.264,-3,46,49
17,ARI,P013250,27.482,-8,44,52
17,ARI,P013251,19.266,2,31,29
17,ARI,P013252,23.266,-6,32,38
17,ARI,P013355,4.25,-4,2,6
17,ARI,P013356,9.834,-1,13,14
17,ARI,P013360,3.116,-5,0,5
17,TTK,P004056,14.633,0,27,27
17,TTK,P004218,19.533,2,32,30
17,TTK,P004619,2.6,1,6,5
17,TTK,P006598,29.3,16,54,38
17,TTK,P007917,6.883,-2,10,12
17,TTK,P009025,34.666,7,62,55
17,TTK,P011935,11.217,7,17,10
17,TTK,P011973,33.283,2,57,55
17,TTK,P012259,18.617,-8,32,40
17,TTK,P012415,1.617,-1,0,1
17,TTK,P013300,27.651,1,43,42
18,LJU,P003452,25.232,3,58,55
18,LJU,P003703,27.199,5,56,51
18,LJU,P009392,20.899,14,51,37
18,LJU,P009753,20.599,-6,39,45
18,LJU,P012042,29.231,3,64,61
18,LJU,P012700,19.716,-13,34,47
18,LJU,P012996,2.033,-2,5,7
18,LJU,P013260,15.649,3,37,34
18,LJU,P013261,11.899,1,25,24
18,LJU,P013262,10.317,5,24,19
18,LJU,P013263,17.216,12,42,30
18,VNC,P003759,7.417,-9,10,19
18,VNC,P005404,31.6,1,71,70
18,VNC,P006571,1.05,-3,0,3
18,VNC,P008052,20.217,-15,38,53
18,VNC,P008858,31.983,-9,63,72
18,VNC,P009400,18.534,-1,39,40
18,VNC,P011909,23.884,10,53,43
18,VNC,P011928,21.883,10,53,43
18,VNC,P012796,29.416,7,63,56
18,VNC,P013305,14.016,-16,20,36
19,BOU,P004525,20.349,11,46,35
19,BOU,P004945,5.35,-2,9,11
19,BOU,P006904,19.316,-2,36,38
19,BOU,P009552,16.749,4,31,27
19,BOU,P009556,9.816,9,21,12
19,BOU,P010449,20.683,13,48,35
19,BOU,P010450,17.35,4,35,31
19,BOU,P011837,22.067,6,50,44
19,BOU,P013264,20.833,1,41,40
19,BOU,P013265,22.949,8,50,42
19,BOU,P013266,24.533,3,53,50
19,CLU,P002820,23.517,-1,46,47
19,CLU,P004862,13.15,-17,17,34
19,CLU,P005714,16.133,-13,26,39
19,CLU,P006618,22.533,-13,39,52
19,CLU,P010651,15.05,-2,28,30
19,CLU,P011801,15.95,-23,17,40
19,CLU,P012620,14.533,-7,26,33
19,CLU,P012698,24.8,4,52,48
19,CLU,P013302,29.667,7,62,55
19,CLU,P013304,24.667,10,52,42
20,HAM,P003242,23.367,-7,51,58
20,HAM,P006006,12.767,-11,23,34
20,HAM,P006420,10.517,-21,13,34
20,HAM,P010070,17.2,-20,27,47
20,HAM,P011256,17.466,-17,36,53
20,HAM,P012695,6.817,-19,5,24
20,HAM,P013308,18.767,-14,36,50
20,HAM,P013309,24.85,-10,50,60
20,HAM,P013311,18.35,-13,34,47
20,HAM,P013312,29.183,-4,65,69
20,HAM,P013313,20.716,1,50,49
20,PAM,P004548,9.9,6,24,18
20,PAM,P004863,15.866,18,45,27
20,PAM,P005356,13.617,14,38,24
20,PAM,P006643,17.017,19,50,31
20,PAM,P007527,20.249,13,55,42
20,PAM,P009864,12.95,-7,25,32
20,PAM,P010042,23.584,4,55,51
20,PAM,P010393,22.635,9,59,50
20,PAM,P010444,13.783,14,40,26
20,PAM,P011980,17.365,18,46,28
20,PAM,P011982,19.767,7,48,41
20,PAM,P012738,13.267,20,40,20
21,JOV,P002361,18.598,9,42,33
21,JOV,P002507,23.515,-1,37,38
21,JOV,P004834,16.482,6,41,35
21,JOV,P005099,21.698,1,50,49
21,JOV,P006771,3.116,-1,5,6
21,JOV,P010161,15.716,-3,22,25
21,JOV,P012349,8.449,-8,13,21
21,JOV,P012740,27.498,6,62,56
21,JOV,P013285,27.198,13,53,40
21,JOV,P013286,6.2,-7,3,10
21,JOV,P013287,31.515,10,62,52
21,TSO,P003885,19.368,5,44,39
21,TSO,P008790,18.3,-3,35,38
21,TSO,P009649,33.051,5,66,61
21,TSO,P012019,29.0,-9,48,57
21,TSO,P013292,2.4,-6,3,9
21,TSO,P013293,10.301,-5,16,21
21,TSO,P013295,26.101,10,48,38
21,TSO,P013296,18.767,1,33,32
21,TSO,P013297,23.567,-13,34,47
21,TSO,P013298,19.15,-10,38,48
22,ULM,P006245,27.285,16,67,51
22,ULM,P006997,24.885,1,51,50
22,ULM,P007952,10.652,3,26,23
22,ULM,P010726,15.501,11,41,30
22,ULM,P011391,30.735,22,78,56
22,ULM,P011437,18.201,6,36,30
22,ULM,P012077,18.836,10,48,38
22,ULM,P012602,5.334,1,11,10
22,ULM,P013290,36.636,15,87,72
22,ULM,P013291,11.95,5,25,20
22,WOL,P004645,18.834,-14,31,45
22,WOL,P005516,31.833,-9,61,70
22,WOL,P006546,28.3,-11,56,67
22,WOL,P008186,14.199,-12,19,31
22,WOL,P009306,3.466,-2,8,10
22,WOL,P011248,27.766,-17,51,68
22,WOL,P012003,25.332,-7,50,57
22,WOL,P012577,25.748,-6,56,62
22,WOL,P012789,24.517,-12,48,60
23,BES,P003783,11.65,-1,26,27
23,BES,P007914,27.2,2,64,62
23,BES,P008945,25.516,-2,61,63
23,BES,P009680,16.45,-10,29,39
23,BES,P010652,14.501,11,40,29
23,BES,P011379,20.016,-22,38,60
23,BES,P011924,28.5,-13,62,75
23,BES,P011927,28.1,-4,65,69
23,BES,P013255,28.067,-31,50,81
23,HTA,P001927,28.148,37,84,47
23,HTA,P004846,30.482,24,85,61
23,HTA,P005181,6.934,-11,12,23
23,HTA,P010386,26.283,8,68,60
23,HTA,P010465,5.5,-11,7,18
23,HTA,P010550,24.333,2,56,54
23,HTA,P011157,26.033,36,78,42
23,HTA,P011386,10.6,-17,16,33
23,HTA,P012096,13.183,-22,21,43
23,HTA,P013284,28.499,24,78,54
24,BAH,P003840,18.517,-6,31,37
24,BAH,P004172,22.751,1,32,31
24,BAH,P009601,17.817,1,27,26
24,BAH,P011192,34.101,-2,60,62
24,BAH,P011201,23.333,1,38,37
24,BAH,P011821,21.484,-3,28,31
24,BAH,P011823,23.485,-5,39,44
24,BAH,P012405,10.467,8,14,6
24,BAH,P012711,28.05,-10,46,56
24,CAN,P003425,23.966,17,52,35
24,CAN,P005005,5.067,-6,0,6
24,CAN,P006588,24.016,-14,34,48
24,CAN,P007560,3.6,-3,7,10
24,CAN,P008121,29.432,16,60,44
24,CAN,P008966,20.116,21,43,22
24,CAN,P010452,19.4,13,38,25
24,CAN,P010623,16.216,-14,14,28
24,CAN,P011251,24.899,13,50,37
24,CAN,P012016,16.1,-14,17,31
24,CAN,P012095,17.183,-14,15,29
25,BUD,P004222,11.751,10,24,14
25,BUD,P005637,25.349,22,58,36
25,BUD,P006561,14.801,1,26,25
25,BUD,P006566,15.733,7,32,25
25,BUD,P008325,20.733,2,44,42
25,BUD,P010307,7.2,2,19,17
25,BUD,P011150,25.916,24,60,36
25,BUD,P011281,26.134,16,57,41
25,BUD,P012606,18.2,4,34,30
25,BUD,P012630,13.05,4,27,23
25,BUD,P013258,14.0,5,28,23
25,BUD,P013259,7.133,8,16,8
25,TRN,P005438,16.183,-5,27,32
25,TRN,P006382,12.8,-2,16,18
25,TRN,P006724,19.567,-9,32,41
25,TRN,P012593,29.717,-19,49,68
25,TRN,P012687,21.3,-34,22,56
25,TRN,P013269,24.285,-10,40,50
25,TRN,P013270,20.101,-2,38,40
25,TRN,P013271,29.935,-9,54,63
25,TRN,P013272,26.117,-15,42,57
26,HAM,P003242,23.967,-12,43,55
26,HAM,P006006,17.783,-14,25,39
26,HAM,P006420,15.45,-7,20,27
26,HAM,P010070,11.099,4,21,17
26,HAM,P011256,26.15,-10,52,62
26,HAM,P012695,22.917,-6,49,55
26,HAM,P013308,24.635,-21,33,54
26,HAM,P013309,26.599,-2,55,57
26,HAM,P013310,6.85,1,18,17
26,HAM,P013312,24.55,-8,54,62
26,JER,P006625,21.783,15,51,36
26,JER,P009879,13.533,-5,25,30
26,JER,P010431,19.066,5,35,30
26,JER,P010587,26.917,21,67,46
26,JER,P011970,27.815,8,66,58
26,JER,P013276,18.133,-4,38,42
26,JER,P013277,24.284,14,58,44
26,JER,P013278,23.266,14,53,39
26,JER,P013279,13.248,3,26,23
26,JER,P013281,11.95,4,26,22
27,CLU,P002820,24.568,-9,54,63
27,CLU,P004862,23.385,-8,49,57
27,CLU,P005714,18.967,0,43,43
27,CLU,P006618,23.351,2,62,60
27,CLU,P010651,13.883,-6,35,41
27,CLU,P011797,15.016,5,47,42
27,CLU,P011801,18.467,-2,48,50
27,CLU,P012698,22.667,-8,57,65
27,CLU,P013302,23.201,-8,51,59
27,CLU,P013304,16.5,-11,34,45
27,PAM,P004863,20.433,7,62,55
27,PAM,P005356,21.832,28,79,51
27,PAM,P006643,8.017,-4,21,25
27,PAM,P007527,23.251,-5,52,57
27,PAM,P009864,11.65,5,31,26
27,PAM,P010042,22.882,0,49,49
27,PAM,P010393,23.133,-4,53,57
27,PAM,P010444,14.449,5,40,35
27,PAM,P010750,4.333,-1,7,8
27,PAM,P011980,14.349,8,43,35
27,PAM,P011982,25.699,11,66,55
27,PAM,P012738,9.967,-5,22,27
28,BOU,P004525,22.017,8,48,40
28,BOU,P004945,7.183,10,20,10
28,BOU,P006904,15.7,13,36,23
28,BOU,P009552,19.834,12,46,34
28,BOU,P009556,14.267,14,34,20
28,BOU,P010449,24.301,9,52,43
28,BOU,P010450,17.717,20,44,24
28,BOU,P011837,17.684,8,36,28
28,BOU,P013264,18.784,13,43,30
28,BOU,P013265,23.967,5,47,42
28,BOU,P013266,18.551,-2,34,36
28,VNC,P005177,23.049,-19,41,60
28,VNC,P005404,32.866,-9,57,66
28,VNC,P006571,8.167,-18,10,28
28,VNC,P008052,23.099,-33,35,68
28,VNC,P009400,26.583,-12,38,50
28,VNC,P011928,24.066,-5,38,43
28,VNC,P012796,27.549,3,51,48
28,VNC,P013305,34.616,-17,60,77
29,LJU,P003452,23.533,-17,40,57
29,LJU,P003703,30.549,-13,50,63
29,LJU,P009392,11.15,3,21,18
29,LJU,P009431,12.183,0,23,23
29,LJU,P009753,12.867,-9,19,28
29,LJU,P011261,13.517,5,26,21
29,LJU,P012042,26.834,-8,45,53
29,LJU,P012700,22.168,-3,38,41
29,LJU,P012996,15.516,-5,26,31
29,LJU,P013260,20.433,2,39,37
29,LJU,P013263,11.25,5,23,18
29,TTK,P004056,12.449,5,27,22
29,TTK,P004619,3.25,-3,7,10
29,TTK,P006598,29.816,7,59,52
29,TTK,P007917,7.733,-2,11,13
29,TTK,P009025,35.282,10,71,61
29,TTK,P010811,0.667,-1,1,2
29,TTK,P011935,31.516,3,61,58
29,TTK,P011973,34.349,13,69,56
29,TTK,P012259,8.7,0,20,20
29,TTK,P012415,11.7,5,16,11
29,TTK,P013300,24.533,3,48,45
30,ARI,P003240,26.135,12,60,48
30,ARI,P004292,22.049,9,52,43
30,ARI,P008084,20.717,7,38,31
30,ARI,P013248,13.133,-2,18,20
30,ARI,P013249,16.716,3,37,34
30,ARI,P013250,21.117,13,49,36
30,ARI,P013251,22.199,13,53,40
30,ARI,P013252,7.85,10,25,15
30,ARI,P013355,19.017,10,49,39
30,ARI,P013356,19.283,11,54,43
30,ARI,P013360,0.95,0,0,0
30,ARI,P013375,10.834,4,25,21
30,LKB,P005521,23.533,-7,46,53
30,LKB,P005656,24.066,-12,39,51
30,LKB,P006212,14.384,1,31,30
30,LKB,P006586,19.833,-20,32,52
30,LKB,P009299,26.784,-11,47,58
30,LKB,P009898,19.8,-10,38,48
30,LKB,P010461,23.783,-15,43,58
30,LKB,P013247,20.2,-8,36,44
30,LKB,PLXI,27.617,-8,58,66
34,BES,P003783,15.651,13,42,29
34,BES,P007914,17.665,-4,37,41
34,BES,P008945,21.751,37,68,31
34,BES,P009680,18.383,4,42,38
34,BES,P010652,16.883,18,44,26
34,BES,P011379,21.099,13,54,41
34,BES,P011924,21.949,22,59,37
34,BES,P011927,23.633,31,74,43
34,BES,P011936,21.166,17,58,41
34,BES,P012233,2.399,-2,6,8
34,BES,P012624,1.616,0,4,4
34,BES,P013255,17.8,16,47,31
34,ULM,P006245,16.767,-25,30,55
34,ULM,P006997,17.468,-18,36,54
34,ULM,P007952,10.733,-22,10,32
34,ULM,P010582,21.283,-20,39,59
34,ULM,P010726,17.917,1,42,41
34,ULM,P011391,24.716,-8,50,58
34,ULM,P011437,28.784,-23,49,72
34,ULM,P012602,10.133,0,20,20
34,ULM,P013289,19.417,-1,45,46
34,ULM,P013290,25.119,-32,42,74
34,ULM,P013291,7.668,-17,7,24
33,CAN,P003425,29.367,-8,50,58
33,CAN,P005005,14.117,-7,21,28
33,CAN,P006588,26.467,2,50,48
33,CAN,P008121,25.883,-6,45,51
33,CAN,P008966,16.933,-7,28,35
33,CAN,P010452,16.633,-18,19,37
33,CAN,P010623,10.633,-5,16,21
33,CAN,P011251,24.416,-5,45,50
33,CAN,P012016,19.967,-3,35,38
33,CAN,P012095,15.584,-8,21,29
33,HTA,P001927,27.166,14,59,45
33,HTA,P004846,19.617,2,36,34
33,HTA,P005181,16.883,4,32,28
33,HTA,P009877,6.266,4,13,9
33,HTA,P010386,23.116,9,47,38
33,HTA,P010550,30.516,9,60,51
33,HTA,P011157,16.949,12,37,25
33,HTA,P012096,30.816,6,60,54
33,HTA,P013284,28.666,5,51,46
37,LJU,P003452,28.033,10,59,49
37,LJU,P003703,25.151,-8,43,51
37,LJU,P009392,14.467,14,36,22
37,LJU,P009431,15.801,5,31,26
37,LJU,P009753,23.816,11,48,37
37,LJU,P011261,2.75,2,6,4
37,LJU,P012042,25.199,-5,46,51
37,LJU,P012700,28.033,-9,47,56
37,LJU,P013260,22.1,-1,39,40
37,LJU,P013263,14.65,1,25,24
37,LKB,P005113,25.867,17,56,39
37,LKB,P005521,15.834,-16,16,32
37,LKB,P005656,25.348,10,51,41
37,LKB,P006212,6.517,-7,8,15
37,LKB,P006586,17.083,1,33,32
37,LKB,P009299,26.849,6,54,48
37,LKB,P009898,24.233,-6,47,53
37,LKB,P010181,0.15,0,0,0
37,LKB,P010461,14.099,-20,16,36
37,LKB,P013247,28.715,12,58,46
37,LKB,PLXI,15.3,-17,21,38
38,BOU,P004525,24.3,1,38,37
38,BOU,P004945,5.216,0,8,8
38,BOU,P006904,15.716,3,25,22
38,BOU,P009552,15.967,8,33,25
38,BOU,P009556,11.267,7,21,14
38,BOU,P010449,22.717,-1,40,41
38,BOU,P010450,21.5,10,43,33
38,BOU,P011837,21.55,-3,28,31
38,BOU,P013264,18.033,2,33,31
38,BOU,P013265,18.733,-8,26,34
38,BOU,P013266,25.001,1,40,39
38,TTK,P004056,12.699,-2,27,29
38,TTK,P004619,10.6,2,19,17
38,TTK,P006598,18.983,2,30,28
38,TTK,P007917,19.317,-12,24,36
38,TTK,P009025,38.2,0,63,63
38,TTK,P011935,11.816,-8,14,22
38,TTK,P011973,30.817,4,51,47
38,TTK,P012259,14.25,0,23,23
38,TTK,P012415,14.251,-9,20,29
38,TTK,P013300,29.067,3,44,41
40,CLU,P002820,19.467,19,54,35
40,CLU,P004862,19.433,17,50,33
40,CLU,P005714,15.466,22,43,21
40,CLU,P006618,17.7,15,45,30
40,CLU,P010651,16.618,21,45,24
40,CLU,P011797,19.9,11,48,37
40,CLU,P011801,14.784,22,43,21
40,CLU,P012620,5.783,-3,10,13
40,CLU,P012698,16.199,4,34,30
40,CLU,P013301,7.65,2,17,15
40,CLU,P013302,24.7,29,68,39
40,CLU,P013304,22.3,21,58,37
40,HAM,P003242,24.117,-18,41,59
40,HAM,P006420,21.851,-30,32,62
40,HAM,P010070,16.118,-18,24,42
40,HAM,P011256,22.384,-6,43,49
40,HAM,P012690,11.117,0,24,24
40,HAM,P012695,16.483,-23,26,49
40,HAM,P013308,20.984,-19,36,55
40,HAM,P013309,22.917,-25,37,62
40,HAM,P013310,7.216,-5,13,18
40,HAM,P013311,12.2,-24,16,40
40,HAM,P013312,24.618,-12,43,55
31,BUD,P004222,11.999,-4,19,23
31,BUD,P005637,25.649,4,59,55
31,BUD,P006561,3.817,1,8,7
31,BUD,P006566,8.566,-1,18,19
31,BUD,P008325,24.149,12,65,53
31,BUD,P011150,31.449,14,80,66
31,BUD,P011281,21.749,0,46,46
31,BUD,P012606,22.898,5,60,55
31,BUD,P012630,18.632,-1,37,38
31,BUD,P013256,14.016,1,27,26
31,BUD,P013258,17.066,14,41,27
31,TSO,P003885,11.084,-13,22,35
31,TSO,P008790,15.833,-1,37,38
31,TSO,P009649,32.583,-10,68,78
31,TSO,P012019,27.265,4,60,56
31,TSO,P013292,3.683,0,8,8
31,TSO,P013293,17.233,-10,29,39
31,TSO,P013295,31.633,-4,66,70
31,TSO,P013296,19.749,0,36,36
31,TSO,P013297,17.316,-4,36,40
31,TSO,P013298,23.616,-7,53,60
32,BAH,P003840,22.651,12,58,46
32,BAH,P004172,14.983,15,44,29
32,BAH,P008278,3.7,4,10,6
32,BAH,P008282,7.466,14,23,9
32,BAH,P009601,22.383,36,66,30
32,BAH,P011192,24.6,19,65,46
32,BAH,P011201,21.717,30,60,30
32,BAH,P011821,25.683,27,71,44
32,BAH,P011823,19.801,29,60,31
32,BAH,P012405,16.649,5,36,31
32,BAH,P012711,17.084,6,48,42
32,BAH,PLQV,3.283,3,9,6
32,TRN,P005438,22.583,-39,35,74
32,TRN,P006382,12.234,-1,30,31
32,TRN,P006724,22.05,-23,36,59
32,TRN,P012242,6.783,-10,9,19
32,TRN,P012593,18.949,-30,27,57
32,TRN,P012687,23.634,-21,40,61
32,TRN,P013269,24.85,-21,44,65
32,TRN,P013270,24.684,-16,52,68
32,TRN,P013271,16.8,-12,28,40
32,TRN,P013272,27.433,-27,49,76
35,JOV,P002361,16.699,-8,30,38
35,JOV,P002507,24.633,-11,43,54
35,JOV,P004834,10.483,-7,11,18
35,JOV,P005099,18.333,-7,34,41
35,JOV,P006771,3.417,-6,2,8
35,JOV,P010161,25.782,-15,43,58
35,JOV,P012349,23.25,-3,38,41
35,JOV,P012740,24.983,-11,36,47
35,JOV,P013285,23.3,-15,33,48
35,JOV,P013287,21.632,-25,34,59
35,JOV,PJUG,7.483,-7,11,18
35,WOL,P003212,3.333,-2,4,6
35,WOL,P004645,23.051,15,45,30
35,WOL,P005516,24.716,18,58,40
35,WOL,P006546,19.117,7,37,30
35,WOL,P006853,18.2,11,41,30
35,WOL,P008186,13.0,2,19,17
35,WOL,P011248,23.15,11,50,39
35,WOL,P012003,31.484,24,68,44
35,WOL,P012577,24.716,19,64,45
35,WOL,P012789,19.233,10,44,34
36,ARI,P003240,18.366,-2,32,34
36,ARI,P004292,29.682,-13,51,64
36,ARI,P013049,0.283,0,0,0
36,ARI,P013248,10.749,7,27,20
36,ARI,P013249,22.483,-13,36,49
36,ARI,P013250,29.784,-1,53,54
36,ARI,P013251,10.967,-4,18,22
36,ARI,P013252,13.299,-12,16,28
36,ARI,P013253,11.799,2,20,18
36,ARI,P013355,15.951,-5,25,30
36,ARI,P013356,25.799,-15,44,59
36,ARI,P013360,10.833,6,18,12
36,JER,P006625,25.699,11,51,40
36,JER,P009879,6.899,-2,10,12
36,JER,P010431,25.717,16,59,43
36,JER,P010587,19.751,-10,27,37
36,JER,P011970,31.898,9,65,56
36,JER,P013276,21.883,11,47,36
36,JER,P013277,18.533,2,35,33
36,JER,P013278,19.183,-3,31,34
36,JER,P013279,20.099,10,43,33
36,JER,P013281,10.333,6,22,16
39,PAM,P004548,9.866,4,26,22
39,PAM,P005356,12.649,14,32,18
39,PAM,P006643,16.483,5,40,35
39,PAM,P007527,19.917,0,51,51
39,PAM,P009864,11.749,3,32,29
39,PAM,P010042,19.75,10,55,45
39,PAM,P010393,21.999,20,61,41
39,PAM,P010444,16.767,15,41,26
39,PAM,P010750,17.816,16,46,30
39,PAM,P011980,18.0,2,44,42
39,PAM,P011982,23.516,17,65,48
39,PAM,P012738,11.483,4,32,28
39,VNC,P003759,9.8,-16,10,26
39,VNC,P005177,19.233,-13,39,52
39,VNC,P005404,29.983,-25,57,82
39,VNC,P006571,11.517,-12,21,33
39,VNC,P008052,27.616,-4,65,69
39,VNC,P011928,20.499,-15,36,51
39,VNC,P012588,21.099,-12,47,59
39,VNC,P012796,29.499,-7,70,77
39,VNC,P013305,30.749,-6,70,76
49,BOU,P004525,24.602,6,55,49
49,BOU,P004945,17.283,-14,30,44
49,BOU,P006904,15.818,9,36,27
49,BOU,P009552,16.168,1,31,30
49,BOU,P009556,12.802,2,28,26
49,BOU,P010449,15.834,0,29,29
49,BOU,P010450,7.717,7,17,10
49,BOU,P011837,16.417,-9,25,34
49,BOU,P013264,20.15,-12,36,48
49,BOU,P013265,25.468,-12,49,61
49,BOU,P013266,27.751,2,64,62
49,LKB,P005113,25.333,12,53,41
49,LKB,P005521,28.567,20,62,42
49,LKB,P005656,29.0,5,61,56
49,LKB,P006212,10.617,-2,19,21
49,LKB,P006586,14.75,-3,35,38
49,LKB,P009299,20.884,-7,44,51
49,LKB,P009898,23.816,7,46,39
49,LKB,P010181,6.367,-5,9,14
49,LKB,P010461,14.05,-9,28,37
49,LKB,PLXI,26.616,2,63,61
41,TSO,P003885,20.133,0,37,37
41,TSO,P008790,9.817,4,25,21
41,TSO,P009649,37.868,-19,71,90
41,TSO,P012019,37.817,0,74,74
41,TSO,P013292,0.15,-2,0,2
41,TSO,P013293,12.067,-7,27,34
41,TSO,P013295,24.384,-5,57,62
41,TSO,P013296,26.701,-19,47,66
41,TSO,P013297,30.468,1,67,66
41,TSO,P013298,25.6,12,55,43
41,WOL,P003212,7.001,8,22,14
41,WOL,P004645,14.583,-9,20,29
41,WOL,P005516,21.401,-4,40,44
41,WOL,P006546,20.9,-4,37,41
41,WOL,P006853,27.9,8,66,58
41,WOL,P008186,18.633,-6,35,41
41,WOL,P011248,22.435,11,60,49
41,WOL,P012003,38.0,-1,77,78
41,WOL,P012577,28.051,19,74,55
41,WOL,P012789,26.101,13,64,51
42,BES,P003783,15.634,16,37,21
42,BES,P007914,15.217,-2,30,32
42,BES,P008945,28.118,-7,50,57
42,BES,P009680,16.35,18,36,18
42,BES,P010652,24.851,-11,48,59
42,BES,P011379,2.8,-3,3,6
42,BES,P011924,24.367,-10,45,55
42,BES,P011927,22.734,8,50,42
42,BES,P011936,25.867,10,55,45
42,BES,P013255,24.067,11,56,45
42,JOV,P002361,8.834,-11,11,22
42,JOV,P002507,25.984,10,53,43
42,JOV,P004834,20.634,-8,38,46
42,JOV,P005099,24.101,-4,44,48
42,JOV,P006771,12.05,-3,23,26
42,JOV,P010161,11.784,-7,20,27
42,JOV,P012740,20.518,-7,37,44
42,JOV,P013285,28.267,9,60,51
42,JOV,P013286,8.6,-7,12,19
42,JOV,P013287,28.467,-3,57,60
42,JOV,PJUG,10.766,1,25,24
43,CAN,P003425,10.7,7,28,21
43,CAN,P005005,24.102,38,78,40
43,CAN,P006588,15.635,31,56,25
43,CAN,P007560,17.0,27,56,29
43,CAN,P008121,15.9,9,47,38
43,CAN,P008966,14.283,9,40,31
43,CAN,P010452,14.618,-1,36,37
43,CAN,P010623,19.719,16,62,46
43,CAN,P011251,11.435,21,43,22
43,CAN,P012016,14.418,31,54,23
43,CAN,P012095,21.15,23,61,38
43,CAN,P012777,21.05,24,64,40
43,ULM,P006245,25.65,-15,60,75
43,ULM,P006997,15.934,-33,24,57
43,ULM,P007952,12.366,-9,32,41
43,ULM,P010726,16.966,-33,25,58
43,ULM,P011391,30.132,-30,62,92
43,ULM,P012077,29.499,-24,67,91
43,ULM,P012172,5.416,-12,4,16
43,ULM,P012602,17.399,-26,33,59
43,ULM,P013289,21.183,-20,38,58
43,ULM,P013290,25.45,-33,45,78
44,HTA,P001927,35.05,-2,63,65
44,HTA,P004846,8.95,-1,19,20
44,HTA,P005181,20.634,0,39,39
44,HTA,P010386,34.233,-5,60,65
44,HTA,P010550,27.1,-18,45,63
44,HTA,P011157,25.283,-7,42,49
44,HTA,P012096,20.2,9,41,32
44,HTA,P013284,28.55,-6,56,62
44,TRN,P002387,12.567,-2,24,26
44,TRN,P005438,15.483,-5,26,31
44,TRN,P006382,8.7,-4,17,21
44,TRN,P006724,12.249,-2,19,21
44,TRN,P012593,26.199,5,51,46
44,TRN,P012687,18.233,14,43,29
44,TRN,P013269,30.166,9,59,50
44,TRN,P013270,21.283,-1,41,42
44,TRN,P013271,27.683,8,60,52
44,TRN,P013272,27.432,8,55,47
45,BAH,P003840,36.567,23,86,63
45,BAH,P008282,6.416,-14,11,25
45,BAH,P009601,17.683,7,41,34
45,BAH,P011192,19.3,4,43,39
45,BAH,P011201,26.333,15,65,50
45,BAH,P011821,32.867,31,79,48
45,BAH,P011823,33.867,15,82,67
45,BAH,P012405,3.733,1,7,6
45,BAH,P012711,23.234,3,46,43
45,BUD,P004222,11.466,-5,22,27
45,BUD,P005637,19.15,-4,36,40
45,BUD,P006561,15.015,-7,27,34
45,BUD,P006566,24.732,-7,47,54
45,BUD,P008325,28.532,-12,53,65
45,BUD,P011150,31.716,-25,52,77
45,BUD,P011281,29.482,-17,55,72
45,BUD,P012606,22.465,-20,36,56
45,BUD,P012630,11.649,21,37,16
45,BUD,P013258,5.783,-9,10,19
46,CLU,P002820,18.583,-5,30,35
46,CLU,P004862,19.451,1,41,40
46,CLU,P005714,10.416,1,21,20
46,CLU,P006618,15.383,-4,27,31
46,CLU,P010651,28.317,5,58,53
46,CLU,P011797,28.517,15,62,47
46,CLU,P011801,1.75,2,7,5
46,CLU,P012620,2.4,-3,4,7
46,CLU,P012698,25.5,6,51,45
46,CLU,P013302,25.066,10,50,40
46,CLU,P013304,24.617,12,54,42
46,JER,P006625,20.132,-7,39,46
46,JER,P008912,18.849,-7,32,39
46,JER,P010431,16.698,4,36,32
46,JER,P010587,30.599,0,53,53
46,JER,P011970,27.815,-14,51,65
46,JER,P013276,24.198,-10,45,55
46,JER,P013277,23.6,-8,40,48
46,JER,P013278,19.25,0,35,35
46,JER,P013279,13.915,-1,27,28
46,JER,P013281,4.934,3,7,4
47,HAM,P003242,18.15,-16,28,44
47,HAM,P006420,15.668,6,29,23
47,HAM,P010070,11.935,5,21,16
47,HAM,P011256,25.285,2,45,43
47,HAM,P012695,11.068,-3,18,21
47,HAM,P013308,27.101,-22,41,63
47,HAM,P013309,19.218,-4,33,37
47,HAM,P013310,8.15,-1,17,18
47,HAM,P013311,10.167,0,19,19
47,HAM,P013312,24.334,-18,39,57
47,HAM,P013313,28.934,-9,50,59
47,VNC,P003759,22.001,-8,36,44
47,VNC,P005177,10.533,4,19,15
47,VNC,P005404,24.934,0,48,48
47,VNC,P008052,14.067,6,24,18
47,VNC,P009400,21.818,13,45,32
47,VNC,P011928,25.934,6,56,50
47,VNC,P012796,18.0,20,44,24
47,VNC,P012800,31.017,14,67,53
47,VNC,P013305,31.701,5,61,56
48,PAM,P004548,10.4,-3,28,31
48,PAM,P004863,13.018,9,32,23
48,PAM,P005356,19.517,10,51,41
48,PAM,P006643,19.784,1,49,48
48,PAM,P007527,20.484,4,50,46
48,PAM,P009864,13.5,1,33,32
48,PAM,P010393,21.368,1,50,49
48,PAM,P010444,15.568,3,40,37
48,PAM,P010750,16.583,8,41,33
48,PAM,P011980,18.633,13,51,38
48,PAM,P011982,20.217,13,52,39
48,PAM,P012738,10.933,10,28,18
48,TTK,P004056,5.616,-4,11,15
48,TTK,P004619,5.583,-6,10,16
48,TTK,P006598,13.684,-9,22,31
48,TTK,P007917,12.333,-13,20,33
48,TTK,P009025,37.317,-5,84,89
48,TTK,P010465,22.633,2,61,59
48,TTK,P010811,0.383,-3,0,3
48,TTK,P011935,17.9,-3,45,48
48,TTK,P011973,31.117,-11,69,80
48,TTK,P012259,13.966,-18,23,41
48,TTK,P012415,11.717,6,27,21
48,TTK,P013300,27.751,-6,63,69
50,ARI,P003240,20.183,-17,28,45
50,ARI,P004292,30.417,-4,63,67
50,ARI,P013248,5.333,0,11,11
50,ARI,P013249,26.017,4,54,50
50,ARI,P013250,32.467,0,63,63
50,ARI,P013251,18.017,-6,23,29
50,ARI,P013252,16.633,-17,22,39
50,ARI,P013253,24.233,-2,55,57
50,ARI,P013355,16.167,9,37,28
50,ARI,P013356,4.533,1,10,9
50,ARI,P013393,4.3,-2,9,11
50,ARI,P013395,1.7,-1,0,1
50,LJU,P003452,32.117,6,70,64
50,LJU,P003703,29.184,8,56,48
50,LJU,P009392,20.017,15,47,32
50,LJU,P009431,5.583,-4,13,17
50,LJU,P009753,14.434,-4,29,33
50,LJU,P011261,6.584,-2,7,9
50,LJU,P012042,25.468,11,53,42
50,LJU,P012700,32.884,16,67,51
50,LJU,P012996,12.883,4,21,17
50,LJU,P013260,16.334,-6,40,46
50,LJU,P013262,2.367,-7,4,11
50,LJU,P013263,2.15,-2,3,5
51,BAH,P003840,27.95,13,63,50
51,BAH,P004172,24.367,18,59,41
51,BAH,P005348,9.6,-4,11,15
51,BAH,P008278,0.483,0,0,0
51,BAH,P008282,0.483,0,0,0
51,BAH,P009601,26.133,11,52,41
51,BAH,P011192,28.284,3,56,53
51,BAH,P011201,28.833,6,48,42
51,BAH,P011823,29.75,-2,58,60
51,BAH,P012405,3.367,1,3,2
51,BAH,P012711,20.75,14,45,31
51,TSO,P003885,20.034,-2,32,34
51,TSO,P008790,18.885,7,37,30
51,TSO,P009649,33.719,-8,57,65
51,TSO,P012019,18.884,-8,34,42
51,TSO,P013292,6.2,4,11,7
51,TSO,P013293,9.884,-5,16,21
51,TSO,P013295,28.051,-15,42,57
51,TSO,P013297,29.435,-22,46,68
51,TSO,P013298,34.918,-11,60,71
52,BUD,P004222,14.732,-17,24,41
52,BUD,P005637,22.616,-3,42,45
52,BUD,P006561,21.582,-16,38,54
52,BUD,P006566,16.666,1,33,32
52,BUD,P008325,20.683,-2,41,43
52,BUD,P010307,16.115,-7,28,35
52,BUD,P011150,28.866,-17,52,69
52,BUD,P011281,22.832,-20,37,57
52,BUD,P012606,20.016,-5,39,44
52,BUD,P012630,10.466,-14,16,30
52,BUD,P013258,5.416,0,10,10
52,HTA,P001927,17.434,1,38,37
52,HTA,P004846,21.083,23,55,32
52,HTA,P005181,19.3,13,43,30
52,HTA,P009877,7.801,10,19,9
52,HTA,P010386,23.584,0,52,52
52,HTA,P010550,20.584,5,45,40
52,HTA,P011157,25.635,13,60,47
52,HTA,P011386,22.684,15,54,39
52,HTA,P012096,14.666,10,37,27
52,HTA,P013282,1.3,0,2,2
52,HTA,P013284,25.934,10,55,45
53,TRN,P002387,18.367,2,48,46
53,TRN,P005438,18.434,-6,29,35
53,TRN,P006382,12.667,9,34,25
53,TRN,P006724,17.3,-3,41,44
53,TRN,P012593,23.984,2,45,43
53,TRN,P012687,14.9,1,37,36
53,TRN,P013269,23.817,-10,43,53
53,TRN,P013270,26.201,-2,58,60
53,TRN,P013271,22.434,1,41,40
53,TRN,P013272,21.901,-4,34,38
53,ULM,P005422,23.551,14,53,39
53,ULM,P006245,10.583,-8,17,25
53,ULM,P006997,8.3,-8,12,20
53,ULM,P007952,6.6,-8,9,17
53,ULM,P010726,7.266,-6,9,15
53,ULM,P011391,15.5,-18,16,34
53,ULM,P011437,29.418,10,67,57
53,ULM,P012077,27.834,9,66,57
53,ULM,P013289,24.301,20,63,43
53,ULM,P013290,30.517,0,69,69
53,ULM,P013291,16.135,5,39,34
54,CAN,P003425,30.884,17,63,46
54,CAN,P005005,12.0,-15,13,28
54,CAN,P006588,35.767,10,66,56
54,CAN,P008121,35.501,14,67,53
54,CAN,P008966,23.4,12,46,34
54,CAN,P010452,6.834,-5,10,15
54,CAN,P010623,13.9,-15,15,30
54,CAN,P011251,27.418,-2,47,49
54,CAN,P012016,15.434,-9,20,29
54,CAN,P012095,17.917,4,31,27
54,CAN,P012165,5.95,-1,12,13
54,JOV,P002361,23.3,2,42,40
54,JOV,P002507,34.25,-4,58,62
54,JOV,P004834,17.6,9,35,26
54,JOV,P005099,29.249,-14,46,60
54,JOV,P006771,17.117,16,34,18
54,JOV,P010161,14.95,-6,24,30
54,JOV,P012740,14.8,5,24,19
54,JOV,P013285,27.45,-12,44,56
54,JOV,P013287,35.95,-10,56,66
54,JOV,PJUG,10.334,4,17,13
55,BES,P003783,26.166,4,58,54
55,BES,P007914,12.999,10,35,25
55,BES,P008945,32.966,-23,56,79
55,BES,P009680,27.816,1,58,57
55,BES,P010652,23.649,-14,45,59
55,BES,P011379,9.533,-10,10,20
55,BES,P011924,29.215,-20,51,71
55,BES,P011927,19.0,-7,43,50
55,BES,P013255,18.651,-16,34,50
55,WOL,P003212,10.05,-6,21,27
55,WOL,P004645,15.833,15,38,23
55,WOL,P005516,25.333,10,62,52
55,WOL,P006853,25.566,16,58,42
55,WOL,P008186,21.133,27,59,32
55,WOL,P011248,27.316,-2,60,62
55,WOL,P012003,30.616,22,73,51
55,WOL,P012577,25.849,5,60,55
55,WOL,P012789,18.299,-12,34,46
56,JER,P006625,27.151,11,63,52
56,JER,P008912,23.967,13,65,52
56,JER,P009879,10.898,6,26,20
56,JER,P010431,24.95,2,53,51
56,JER,P010587,27.716,9,63,54
56,JER,P011970,28.718,1,68,67
56,JER,P013277,24.349,12,66,54
56,JER,P013279,17.951,0,34,34
56,JER,P013281,14.3,1,32,31
56,LJU,P003452,26.982,-18,57,75
56,LJU,P003703,17.916,1,29,28
56,LJU,P009392,23.182,0,54,54
56,LJU,P009431,11.465,-1,25,26
56,LJU,P009753,16.682,-10,28,38
56,LJU,P011261,14.765,9,36,27
56,LJU,P012042,27.8,-10,55,65
56,LJU,P012700,20.05,-8,35,43
56,LJU,P012996,19.066,-6,42,48
56,LJU,P013260,22.082,-12,54,66
57,ARI,P003240,15.683,-2,34,36
57,ARI,P004292,27.5,-6,64,70
57,ARI,P013248,10.416,8,22,14
57,ARI,P013249,25.834,14,67,53
57,ARI,P013250,25.151,1,58,57
57,ARI,P013251,23.949,4,50,46
57,ARI,P013252,10.534,-6,23,29
57,ARI,P013253,20.001,-1,50,51
57,ARI,P013355,19.05,1,46,45
57,ARI,P013360,9.75,-8,16,24
57,ARI,P013393,12.132,10,25,15
57,BOU,P004525,20.533,-6,37,43
57,BOU,P006904,29.45,-9,62,71
57,BOU,P009552,16.201,5,38,33
57,BOU,P009556,18.849,11,46,35
57,BOU,P010450,17.1,4,48,44
57,BOU,P011837,22.498,-5,45,50
57,BOU,P013264,20.716,2,56,54
57,BOU,P013265,22.949,-9,40,49
57,BOU,P013266,31.699,-8,68,76
59,HAM,P003242,31.802,23,76,53
59,HAM,P006420,14.551,-6,33,39
59,HAM,P010070,12.335,-6,25,31
59,HAM,P011256,22.068,17,51,34
59,HAM,P012695,14.584,2,27,25
59,HAM,P013308,27.268,4,58,54
59,HAM,P013309,23.769,-3,54,57
59,HAM,P013310,2.767,1,3,2
59,HAM,P013312,25.452,18,56,38
59,HAM,P013313,25.419,10,62,52
59,TTK,P004056,15.051,-16,25,41
59,TTK,P004619,6.534,0,16,16
59,TTK,P006598,18.485,-13,28,41
59,TTK,P007917,16.151,3,37,34
59,TTK,P009025,27.237,-4,55,59
59,TTK,P010465,29.202,1,60,59
59,TTK,P011935,18.651,-8,31,39
59,TTK,P011973,30.869,-14,54,68
59,TTK,P012415,14.818,-7,33,40
59,TTK,P013300,23.017,-2,46,48
60,CLU,P002820,22.918,-6,42,48
60,CLU,P004862,19.4,1,39,38
60,CLU,P005714,17.05,-8,33,41
60,CLU,P006618,17.867,-8,35,43
60,CLU,P010651,13.917,0,28,28
60,CLU,P011797,26.501,21,69,48
60,CLU,P012620,5.467,-7,9,16
60,CLU,P012698,29.001,7,64,57
60,CLU,P013302,29.05,27,72,45
60,CLU,P013304,18.834,13,39,26
60,VNC,P003759,16.433,-4,33,37
60,VNC,P005177,10.95,-1,24,25
60,VNC,P005404,22.25,-9,41,50
60,VNC,P008052,15.833,5,37,32
60,VNC,P009400,16.75,5,38,33
60,VNC,P011909,18.0,-12,28,40
60,VNC,P011928,24.167,-13,41,54
60,VNC,P012796,23.567,-4,45,49
60,VNC,P012800,26.534,-2,50,52
60,VNC,P013305,25.516,-5,53,58
61,BES,P003783,16.9,12,44,32
61,BES,P007914,24.766,19,61,42
61,BES,P008945,20.433,20,62,42
61,BES,P009680,19.466,13,53,40
61,BES,P010652,25.366,22,66,44
61,BES,P011379,10.483,-1,21,22
61,BES,P011924,25.149,7,58,51
61,BES,P011927,19.15,7,49,42
61,BES,P011936,24.066,7,54,47
61,BES,P013255,14.216,-1,32,33
61,TSO,P003885,24.051,-3,53,56
61,TSO,P008790,25.584,-12,53,65
61,TSO,P009649,32.134,-9,66,75
61,TSO,P012019,27.668,-15,49,64
61,TSO,P013292,6.783,-4,17,21
61,TSO,P013293,20.534,-20,42,62
61,TSO,P013295,26.833,-15,46,61
61,TSO,P013297,17.701,-23,26,49
61,TSO,P013298,18.717,-4,43,47
62,CAN,P003425,21.716,4,40,36
62,CAN,P005005,12.566,-6,21,27
62,CAN,P006588,25.383,11,47,36
62,CAN,P008121,26.549,4,45,41
62,CAN,P008966,25.249,-3,43,46
62,CAN,P010452,14.615,-13,19,32
62,CAN,P010623,18.282,-6,26,32
62,CAN,P011251,18.982,-7,22,29
62,CAN,P012016,14.749,1,23,22
62,CAN,P012095,21.899,5,44,39
62,WOL,P003212,8.049,3,16,13
62,WOL,P004645,17.467,3,30,27
62,WOL,P005516,23.667,-9,30,39
62,WOL,P006546,14.817,4,28,24
62,WOL,P006853,18.9,-4,37,41
62,WOL,P008186,23.316,1,37,36
62,WOL,P011248,28.499,1,51,50
62,WOL,P012003,26.382,10,44,34
62,WOL,P012577,22.215,0,36,36
62,WOL,P012789,16.683,1,31,30
63,JOV,P002361,4.067,-4,6,10
63,JOV,P002507,26.134,-2,53,55
63,JOV,P004834,17.283,0,36,36
63,JOV,P005099,24.116,0,56,56
63,JOV,P006771,17.283,2,37,35
63,JOV,P010161,27.934,-8,56,64
63,JOV,P012740,25.5,0,51,51
63,JOV,P013285,24.467,-4,50,54
63,JOV,P013286,15.533,-2,37,39
63,JOV,P013287,13.733,14,37,23
63,JOV,PJUG,3.95,-6,6,12
63,TRN,P002387,19.583,5,45,40
63,TRN,P005438,21.517,6,48,42
63,TRN,P006382,10.35,-1,19,20
63,TRN,P006724,6.483,-5,13,18
63,TRN,P012593,19.75,-1,40,41
63,TRN,P012687,18.798,-1,41,42
63,TRN,P013269,25.633,-3,56,59
63,TRN,P013270,23.882,6,57,51
63,TRN,P013271,26.183,7,60,53
63,TRN,P013272,27.816,-3,56,59
64,BUD,P004222,11.434,1,27,26
64,BUD,P005637,30.55,6,74,68
64,BUD,P006561,14.451,-1,31,32
64,BUD,P006566,4.267,3,13,10
64,BUD,P008325,33.567,4,78,74
64,BUD,P010307,9.234,4,22,18
64,BUD,P011150,37.617,6,86,80
64,BUD,P011281,26.734,10,65,55
64,BUD,P012606,25.434,4,62,58
64,BUD,P012630,31.717,-12,67,79
64,ULM,P005422,42.784,-7,92,99
64,ULM,P006245,21.15,1,50,49
64,ULM,P006997,33.717,-1,74,75
64,ULM,P010726,7.583,-7,13,20
64,ULM,P011391,19.149,19,55,36
64,ULM,P012077,27.417,-1,59,60
64,ULM,P013289,8.033,-7,18,25
64,ULM,P013290,40.783,-4,94,98
64,ULM,P013291,24.384,-18,45,63
65,BAH,P003840,26.117,-1,62,63
65,BAH,P004172,21.018,9,45,36
65,BAH,P005348,4.167,4,8,4
65,BAH,P009601,32.501,2,75,73
65,BAH,P011192,36.967,8,82,74
65,BAH,P011201,32.084,4,77,73
65,BAH,P011823,28.001,12,62,50
65,BAH,P012405,0.8,0,0,0
65,BAH,P012711,18.35,2,39,37
65,HTA,P001927,30.168,3,68,65
65,HTA,P004846,24.5,0,55,55
65,HTA,P005181,11.767,-8,17,25
65,HTA,P009877,2.533,-6,2,8
65,HTA,P010386,26.817,-4,61,65
65,HTA,P010550,20.351,-6,36,42
65,HTA,P011386,10.65,-10,17,27
65,HTA,P012096,27.717,-7,56,63
65,HTA,P013284,29.718,3,70,67
65,HTA,P013402,15.784,-5,28,33
66,JER,P006625,28.631,24,67,43
66,JER,P008912,27.448,0,53,53
66,JER,P009879,25.999,32,68,36
66,JER,P010431,31.614,16,75,59
66,JER,P013263,17.498,29,50,21
66,JER,P013277,22.832,20,54,34
66,JER,P013279,22.499,-1,44,45
66,JER,P013281,23.464,20,59,39
66,VNC,P003759,22.083,-14,37,51
66,VNC,P005177,8.116,-10,10,20
66,VNC,P005404,23.2,-14,39,53
66,VNC,P006571,12.133,-14,18,32
66,VNC,P008052,25.75,-10,49,59
66,VNC,P009400,26.232,-23,40,63
66,VNC,P011909,24.366,-16,40,56
66,VNC,P012588,5.783,0,11,11
66,VNC,P012800,25.516,-17,42,59
66,VNC,P013305,26.816,-22,44,66
67,CLU,P002820,25.784,-25,46,71
67,CLU,P004862,20.884,-6,44,50
67,CLU,P005714,19.799,-12,45,57
67,CLU,P006618,10.25,-8,20,28
67,CLU,P010651,11.085,5,23,18
67,CLU,P011797,27.001,-24,52,76
67,CLU,P012698,21.318,8,44,36
67,CLU,P013302,32.7,-19,64,83
67,CLU,P013304,31.184,-14,62,76
67,TTK,P004056,5.717,-12,8,20
67,TTK,P004619,10.384,-5,21,26
67,TTK,P006598,16.118,-5,30,35
67,TTK,P007917,23.05,19,56,37
67,TTK,P009025,38.918,16,96,80
67,TTK,P010465,32.4,24,87,63
67,TTK,P011935,31.567,26,86,60
67,TTK,P012415,15.45,17,47,30
67,TTK,P013300,26.401,15,64,49
68,HAM,P003242,23.484,-17,37,54
68,HAM,P005478,19.884,-10,33,43
68,HAM,P006420,13.668,-5,26,31
68,HAM,P008103,13.334,-3,24,27
68,HAM,P010070,19.101,-16,34,50
68,HAM,P011256,20.3,-12,34,46
68,HAM,P012695,10.0,-6,17,23
68,HAM,P013308,20.417,-5,34,39
68,HAM,P013311,23.367,-16,41,57
68,HAM,P013312,16.0,-8,28,36
68,HAM,P013313,20.45,-17,32,49
68,LKB,P005113,21.984,17,53,36
68,LKB,P005521,23.334,11,52,41
68,LKB,P005656,24.017,16,57,41
68,LKB,P006212,18.017,6,38,32
68,LKB,P009299,27.4,16,63,47
68,LKB,P009898,21.117,7,44,37
68,LKB,P010181,2.466,2,7,5
68,LKB,P010461,15.984,7,34,27
68,LKB,P013247,22.451,17,56,39
68,LKB,PLXI,23.235,16,51,35
69,ARI,P003240,28.333,-2,42,44
69,ARI,P004292,31.65,0,47,47
69,ARI,P012638,5.167,0,6,6
69,ARI,P013248,6.784,2,15,13
69,ARI,P013251,32.683,-5,47,52
69,ARI,P013252,25.116,-4,37,41
69,ARI,P013253,24.633,1,33,32
69,ARI,P013355,8.1,-2,7,9
69,ARI,P013356,10.8,-2,12,14
69,ARI,P013393,18.35,-3,33,36
69,ARI,P013395,8.384,-5,16,21
69,PAM,P004863,10.65,4,17,13
69,PAM,P005356,17.434,1,27,26
69,PAM,P006643,14.549,-6,22,28
69,PAM,P007527,18.915,5,34,29
69,PAM,P010042,24.667,6,36,30
69,PAM,P010393,20.151,-1,26,27
69,PAM,P010444,21.382,4,33,29
69,PAM,P010750,12.365,-5,19,24
69,PAM,P011980,15.465,2,30,28
69,PAM,P011982,25.8,10,41,31
69,PAM,P012738,18.617,0,30,30
70,BOU,P004525,23.285,3,49,46
70,BOU,P004945,12.517,9,30,21
70,BOU,P006904,19.283,-5,41,46
70,BOU,P009552,22.933,9,55,46
70,BOU,P010449,18.717,13,48,35
70,BOU,P010450,14.766,8,40,32
70,BOU,P011837,14.467,-4,31,35
70,BOU,P013264,18.7,2,38,36
70,BOU,P013265,25.069,1,55,54
70,BOU,P013266,30.268,-1,63,64
70,LJU,P003452,32.834,7,73,66
70,LJU,P003703,24.067,-12,44,56
70,LJU,P007641,0.683,2,4,2
70,LJU,P009392,13.1,-22,20,42
70,LJU,P009753,22.65,3,47,44
70,LJU,P012042,32.867,-5,71,76
70,LJU,P012700,29.8,4,64,60
70,LJU,P012996,16.433,-5,33,38
70,LJU,P013260,20.433,-5,47,52
70,LJU,P013262,7.133,-2,12,14
71,HTA,P001927,20.55,6,43,37
71,HTA,P004846,16.666,14,38,24
71,HTA,P005181,19.117,22,49,27
71,HTA,P009877,7.767,11,24,13
71,HTA,P010386,22.4,17,51,34
71,HTA,P010550,27.033,10,57,47
71,HTA,P011386,15.65,4,33,29
71,HTA,P012096,30.716,17,64,47
71,HTA,P013282,1.067,5,7,2
71,HTA,P013283,3.167,8,12,4
71,HTA,P013284,14.083,17,36,19
71,HTA,P013402,21.784,14,51,37
71,TSO,P003885,18.218,-19,27,46
71,TSO,P008790,19.201,-4,34,38
71,TSO,P009649,37.201,-28,61,89
71,TSO,P012019,35.135,-27,57,84
71,TSO,P013292,4.101,-9,2,11
71,TSO,P013293,17.167,-9,31,40
71,TSO,P013295,23.301,-18,37,55
71,TSO,P013297,19.284,-17,30,47
71,TSO,P013298,26.402,-14,41,55
72,BAH,P003840,28.016,1,52,51
72,BAH,P004172,27.032,12,57,45
72,BAH,P005348,7.65,-5,11,16
72,BAH,P009601,25.333,5,54,49
72,BAH,P011192,27.349,6,59,53
72,BAH,P011201,30.966,11,64,53
72,BAH,P011823,29.85,0,54,54
72,BAH,P012711,23.799,10,49,39
72,ULM,P005422,29.649,-7,51,58
72,ULM,P006245,14.499,3,31,28
72,ULM,P006997,19.483,6,41,35
72,ULM,P007952,2.75,-3,5,8
72,ULM,P010726,4.25,-1,9,10
72,ULM,P011391,21.049,-12,35,47
72,ULM,P011437,27.05,-10,43,53
72,ULM,P012077,15.616,1,33,32
72,ULM,P013289,11.95,-2,17,19
72,ULM,P013290,30.483,-9,51,60
72,ULM,P013291,23.216,-6,44,50
73,BUD,P004222,18.501,9,33,24
73,BUD,P005637,17.817,-8,33,41
73,BUD,P006561,9.151,-7,16,23
73,BUD,P006566,20.851,1,37,36
73,BUD,P008325,11.066,-7,22,29
73,BUD,P010307,11.45,-3,18,21
73,BUD,P011150,27.834,-1,52,53
73,BUD,P011281,22.55,-1,43,44
73,BUD,P012606,22.184,-8,39,47
73,BUD,P012630,16.417,-7,28,35
73,BUD,P013256,22.184,2,39,37
73,JOV,P002361,14.483,13,40,27
73,JOV,P002507,22.65,15,47,32
73,JOV,P004834,17.167,-9,31,40
73,JOV,P005099,24.033,3,46,43
73,JOV,P006771,15.083,1,30,29
73,JOV,P009672,22.0,-1,36,37
73,JOV,P010161,18.0,7,42,35
73,JOV,P012740,22.268,1,41,40
73,JOV,P013285,25.433,7,49,42
73,JOV,P013286,3.717,-8,0,8
73,JOV,PJUG,15.166,1,28,27
74,TRN,P002387,22.933,14,60,46
74,TRN,P005438,14.533,-21,20,41
74,TRN,P006382,16.266,1,36,35
74,TRN,P006724,23.783,-3,47,50
74,TRN,P012593,27.149,-12,52,64
74,TRN,P012687,3.1,3,10,7
74,TRN,P013269,31.083,-6,64,70
74,TRN,P013270,28.649,17,67,50
74,TRN,P013271,11.283,1,25,24
74,TRN,P013272,21.216,-19,34,53
74,WOL,P003212,4.717,-1,15,16
74,WOL,P004645,13.267,7,30,23
74,WOL,P005516,25.951,5,53,48
74,WOL,P006546,17.101,13,44,31
74,WOL,P006853,26.266,12,60,48
74,WOL,P008186,21.817,-5,38,43
74,WOL,P011248,27.101,-4,60,64
74,WOL,P012003,27.684,-5,55,60
74,WOL,P012577,18.117,-7,35,42
74,WOL,P012789,17.984,10,50,40
75,BES,P003783,25.817,2,47,45
75,BES,P008945,28.267,0,52,52
75,BES,P009680,25.084,2,53,51
75,BES,P010652,23.9,-7,43,50
75,BES,P011379,12.067,1,18,17
75,BES,P011924,15.135,-12,21,33
75,BES,P011927,11.534,0,20,20
75,BES,P011936,31.568,0,62,62
75,BES,P013255,26.633,4,54,50
75,CAN,P003425,25.316,14,52,38
75,CAN,P005005,8.05,-6,11,17
75,CAN,P006588,31.333,7,58,51
75,CAN,P007560,0.217,1,1,0
75,CAN,P008121,28.733,12,58,46
75,CAN,P008966,16.083,-2,29,31
75,CAN,P010452,9.149,-5,20,25
75,CAN,P010623,14.683,-12,24,36
75,CAN,P011251,29.05,-1,59,60
75,CAN,P012016,23.416,2,43,41
75,CAN,P012095,13.965,0,25,25
76,BOU,P004525,24.466,2,50,48
76,BOU,P004945,28.134,5,59,54
76,BOU,P006904,19.316,-7,33,40
76,BOU,P009552,11.317,-4,19,23
76,BOU,P010449,32.55,-16,62,78
76,BOU,P010450,13.251,-4,24,28
76,BOU,P011837,23.367,-3,46,49
76,BOU,P013264,18.434,-13,34,47
76,BOU,P013265,29.165,-5,58,63
76,JER,P006625,26.534,-5,52,57
76,JER,P008912,28.383,15,68,53
76,JER,P009879,18.666,-5,35,40
76,JER,P010431,18.9,11,48,37
76,JER,P011970,31.434,7,66,59
76,JER,P013263,12.883,8,31,23
76,JER,P013277,18.167,8,38,30
76,JER,P013279,27.117,1,55,54
76,JER,P013281,17.916,5,37,32
77,LJU,P003452,24.35,-9,48,57
77,LJU,P003703,23.683,-16,49,65
77,LJU,P007641,10.382,-10,24,34
77,LJU,P009392,23.367,-17,48,65
77,LJU,P009431,15.733,1,40,39
77,LJU,P009753,6.384,-16,5,21
77,LJU,P011261,1.833,4,6,2
77,LJU,P012042,31.216,-23,65,88
77,LJU,P012700,16.599,-21,23,44
77,LJU,P012996,26.032,-20,48,68
77,LJU,P013260,20.416,-18,44,62
77,PAM,P004863,7.983,12,22,10
77,PAM,P005356,19.184,20,61,41
77,PAM,P006643,18.583,15,57,42
77,PAM,P007527,19.05,14,48,34
77,PAM,P010042,19.466,17,57,40
77,PAM,P010393,19.232,14,47,33
77,PAM,P010444,16.068,13,45,32
77,PAM,P010568,12.084,-11,20,31
77,PAM,P010750,11.95,14,41,27
77,PAM,P011980,19.517,12,51,39
77,PAM,P011982,20.217,12,48,36
77,PAM,P012738,16.666,13,48,35
78,ARI,P004292,30.0,-11,55,66
78,ARI,P012638,15.667,-19,26,45
78,ARI,P013049,12.367,-10,24,34
78,ARI,P013248,11.467,-18,13,31
78,ARI,P013252,24.95,-9,47,56
78,ARI,P013253,25.933,-5,50,55
78,ARI,P013355,24.016,-11,43,54
78,ARI,P013356,21.183,-10,40,50
78,ARI,P013393,12.067,-14,12,26
78,ARI,P013395,22.35,-13,35,48
78,HAM,P003242,20.016,19,47,28
78,HAM,P005478,18.466,-2,40,42
78,HAM,P006006,16.116,-2,41,43
78,HAM,P006420,12.716,16,34,18
78,HAM,P008103,17.482,-3,38,41
78,HAM,P010070,7.067,-8,12,20
78,HAM,P011256,18.649,7,38,31
78,HAM,P013308,21.165,20,51,31
78,HAM,P013309,17.949,21,46,25
78,HAM,P013311,17.666,16,47,31
78,HAM,P013312,11.599,9,25,16
78,HAM,P013313,21.099,27,46,19
79,CLU,P002820,26.733,1,64,63
79,CLU,P004862,23.633,-5,59,64
79,CLU,P005714,25.817,10,71,61
79,CLU,P006618,19.882,10,47,37
79,CLU,P012620,15.798,0,37,37
79,CLU,P012698,25.283,12,65,53
79,CLU,P013301,7.449,1,15,14
79,CLU,P013302,30.517,7,83,76
79,CLU,P013304,24.883,-1,59,60
79,LKB,P005113,24.584,8,66,58
79,LKB,P005521,19.65,4,48,44
79,LKB,P005656,28.451,8,76,68
79,LKB,P006586,19.185,-8,44,52
79,LKB,P006860,11.55,-15,17,32
79,LKB,P009299,26.684,-1,74,75
79,LKB,P009898,17.067,-6,32,38
79,LKB,P010181,2.6,0,2,2
79,LKB,P010461,15.417,-15,27,42
79,LKB,P013247,20.7,0,55,55
79,LKB,PLXI,14.117,-10,24,34
80,TTK,P004056,12.367,3,28,25
80,TTK,P004619,9.868,2,21,19
80,TTK,P006598,6.183,-7,5,12
80,TTK,P007917,7.467,-8,8,16
80,TTK,P009025,36.299,-2,64,66
80,TTK,P010465,33.416,-1,60,61
80,TTK,P010587,21.849,-9,36,45
80,TTK,P011935,23.982,-1,41,42
80,TTK,P011973,21.598,-9,32,41
80,TTK,P012415,4.417,-2,6,8
80,TTK,P013300,22.549,-6,34,40
80,VNC,P003759,12.383,1,21,20
80,VNC,P005177,16.917,13,36,23
80,VNC,P005404,10.849,11,26,15
80,VNC,P008052,18.299,10,42,32
80,VNC,P009400,16.766,-14,21,35
80,VNC,P011909,22.033,9,44,35
80,VNC,P011928,22.25,-3,33,36
80,VNC,P012796,27.616,7,54,47
80,VNC,P012800,34.15,5,65,60
80,VNC,P013305,18.732,1,33,32
