Gamecode,CODETEAM,J1,J2,TIME,DELTA_SCORE,OFF,DEF
1,HAM,P001990,P009663,4.334,1,7,6
1,HAM,P001990,P011187,9.6,3,18,15
1,HAM,P001990,P012578,8.417,0,14,14
1,HAM,P001990,P012579,3.783,-2,7,9
1,HAM,P001990,P012580,13.184,3,22,19
1,HAM,P001990,P012581,10.601,6,20,14
1,HAM,P001990,P012582,1.6,2,4,2
1,HAM,P001990,P012648,4.217,3,8,5
1,HAM,P009663,P011168,12.834,-10,24,34
1,HAM,P009663,P012578,11.451,-5,22,27
1,HAM,P009663,P012579,7.017,-4,9,13
1,HAM,P009663,P012580,12.001,-4,22,26
1,HAM,P009663,P012581,8.284,-6,9,15
1,HAM,P009663,P012582,7.267,-2,21,23
1,HAM,P009663,P012648,5.484,-6,10,16
1,HAM,P011168,P011187,13.234,-14,28,42
1,HAM,P011168,P012578,10.784,-4,22,26
1,HAM,P011168,P012579,13.801,-10,22,32
1,HAM,P011168,P012580,12.817,-14,27,41
1,HAM,P011168,P012581,13.484,-19,21,40
1,HAM,P011168,P012582,20.501,-16,49,65
1,HAM,P011168,P012648,4.35,-10,8,18
1,HAM,P011168,P012694,2.467,1,7,6
1,HAM,P011187,P012578,7.75,1,14,13
1,HAM,P011187,P012579,10.567,-8,20,28
1,HAM,P011187,P012580,14.0,-7,27,34
1,HAM,P011187,P012581,15.801,-7,32,39
1,HAM,P011187,P012582,14.834,-12,32,44
1,HAM,P011187,P012648,3.083,-1,6,7
1,HAM,P011187,P012694,2.467,1,7,6
1,HAM,P012578,P012579,7.883,-5,10,15
1,HAM,P012578,P012580,13.534,-3,24,27
1,HAM,P012578,P012581,8.651,3,13,10
1,HAM,P012578,P012582,5.217,4,19,15
1,HAM,P012578,P012648,3.117,-7,6,13
1,HAM,P012579,P012580,4.3,-5,4,9
1,HAM,P012579,P012581,9.884,-8,15,23
1,HAM,P012579,P012582,10.634,-7,22,29
1,HAM,P012579,P012694,2.467,1,7,6
1,HAM,P012580,P012581,15.501,-4,29,33
1,HAM,P012580,P012582,10.817,-5,28,33
1,HAM,P012580,P012648,7.85,-5,13,18
1,HAM,P012581,P012582,11.517,-18,21,39
1,HAM,P012581,P012648,2.617,1,4,3
1,HAM,P012582,P012648,3.55,-3,9,12
1,HAM,P012582,P012694,2.467,1,7,6
1,PMT,P001686,P002644,3.75,5,9,4
1,PMT,P001686,P011066,12.299,11,37,26
1,PMT,P001686,P011823,11.333,5,33,28
1,PMT,P001686,P011943,0.167,1,1,0
1,PMT,P001686,P011944,8.116,3,23,20
1,PMT,P001686,P011966,2.784,-1,5,6
1,PMT,P001686,P012599,14.916,9,41,32
1,PMT,P001686,P012600,6.967,7,19,12
1,PMT,P002020,P002644,21.033,3,42,39
1,PMT,P002020,P011066,10.616,1,22,21
1,PMT,P002020,P011823,2.517,4,8,4
1,PMT,P002020,P011943,13.117,5,33,28
1,PMT,P002020,P011944,11.282,4,21,17
1,PMT,P002020,P011947,6.617,-4,14,18
1,PMT,P002020,P011966,12.934,6,28,22
1,PMT,P002020,P012599,8.716,4,15,11
1,PMT,P002020,P012600,7.368,5,17,12
1,PMT,P002644,P011066,10.166,2,23,21
1,PMT,P002644,P011943,13.217,4,32,28
1,PMT,P002644,P011944,13.199,7,28,21
1,PMT,P002644,P011947,4.383,-6,8,14
1,PMT,P002644,P011966,15.417,7,31,24
1,PMT,P002644,P012599,9.849,6,17,11
1,PMT,P002644,P012600,10.518,7,23,16
1,PMT,P002644,P012601,0.8,1,3,2
1,PMT,P011066,P011823,13.983,13,41,28
1,PMT,P011066,P011943,4.283,-2,10,12
1,PMT,P011066,P011944,16.366,12,44,32
1,PMT,P011066,P011947,3.333,-3,6,9
1,PMT,P011066,P012599,17.932,13,47,34
1,PMT,P011066,P012600,6.384,10,21,11
1,PMT,P011066,P012601,1.234,3,5,2
1,PMT,P011823,P011943,0.067,2,2,0
1,PMT,P011823,P011944,7.433,3,21,18
1,PMT,P011823,P011947,2.367,2,6,4
1,PMT,P011823,P011966,0.434,-2,2,4
1,PMT,P011823,P012599,13.783,7,39,32
1,PMT,P011823,P012600,5.184,8,18,10
1,PMT,P011823,P012601,0.567,2,2,0
1,PMT,P011943,P011944,7.533,-1,15,16
1,PMT,P011943,P011947,2.45,-1,8,9
1,PMT,P011943,P011966,9.001,8,24,16
1,PMT,P011943,P012600,3.301,8,11,3
1,PMT,P011944,P011966,4.266,-2,5,7
1,PMT,P011944,P012599,11.165,7,27,20
1,PMT,P011944,P012600,1.934,4,7,3
1,PMT,P011944,P012601,1.234,3,5,2
1,PMT,P011947,P011966,3.417,-1,8,9
1,PMT,P011947,P012599,3.15,0,6,6
1,PMT,P011947,P012600,1.15,-3,0,3
1,PMT,P011947,P012601,0.133,0,0,0
1,PMT,P011966,P012599,5.7,0,9,9
1,PMT,P011966,P012600,9.318,5,20,15
1,PMT,P011966,P012601,0.133,0,0,0
1,PMT,P012599,P012600,9.317,6,23,17
1,PMT,P012600,P012601,1.367,3,5,2
2,LLI,P004479,P004773,9.3,-5,13,18
2,LLI,P004479,P005247,12.283,18,28,10
2,LLI,P004479,P006600,14.017,-6,19,25
2,LLI,P004479,P009649,16.617,0,29,29
2,LLI,P004479,P009680,9.817,4,19,15
2,LLI,P004479,P012020,11.083,17,29,12
2,LLI,P004479,P012585,12.0,9,26,17
2,LLI,P004479,P012586,15.283,7,29,22
2,LLI,P004773,P005247,10.483,-1,21,22
2,LLI,P004773,P006600,8.067,-9,9,18
2,LLI,P004773,P009649,6.784,-6,6,12
2,LLI,P004773,P009680,9.267,-6,16,22
2,LLI,P004773,P012020,9.2,2,18,16
2,LLI,P004773,P012585,1.467,0,2,2
2,LLI,P004773,P012586,14.5,-3,23,26
2,LLI,P005247,P006600,7.683,3,16,13
2,LLI,P005247,P009649,6.65,8,16,8
2,LLI,P005247,P009680,14.366,2,31,29
2,LLI,P005247,P012020,15.266,12,36,24
2,LLI,P005247,P012585,8.666,9,22,13
2,LLI,P005247,P012586,16.399,9,38,29
2,LLI,P006600,P009649,16.601,-4,23,27
2,LLI,P006600,P009680,7.433,-8,10,18
2,LLI,P006600,P012585,13.05,0,24,24
2,LLI,P006600,P012586,18.617,-4,31,35
2,LLI,P009649,P009680,6.034,-3,7,10
2,LLI,P009649,P012020,7.1,4,17,13
2,LLI,P009649,P012585,14.584,-1,27,28
2,LLI,P009649,P012586,20.434,2,35,33
2,LLI,P009680,P012020,12.967,7,28,21
2,LLI,P009680,P012585,11.133,5,22,17
2,LLI,P009680,P012586,10.583,-5,19,24
2,LLI,P012020,P012585,7.35,7,18,11
2,LLI,P012020,P012586,11.566,7,26,19
2,LLI,P012585,P012586,13.35,-1,27,28
2,VNC,P003759,P004117,2.217,-2,4,6
2,VNC,P003759,P004381,19.317,4,38,34
2,VNC,P003759,P009400,1.9,-4,0,4
2,VNC,P003759,P011909,21.234,12,48,36
2,VNC,P003759,P011928,20.917,10,44,34
2,VNC,P003759,P012587,3.817,4,10,6
2,VNC,P003759,P012590,4.684,2,10,8
2,VNC,P003759,P012591,18.45,6,38,32
2,VNC,P004117,P004381,7.784,-2,11,13
2,VNC,P004117,P009400,10.767,-18,12,30
2,VNC,P004117,P011909,9.967,1,18,17
2,VNC,P004117,P011928,15.934,-13,21,34
2,VNC,P004117,P012587,7.7,-14,9,23
2,VNC,P004117,P012590,13.351,-14,17,31
2,VNC,P004117,P012591,4.884,2,8,6
2,VNC,P004381,P009400,3.716,-9,2,11
2,VNC,P004381,P011909,25.267,6,49,43
2,VNC,P004381,P011928,26.3,4,49,45
2,VNC,P004381,P012590,2.984,-1,3,4
2,VNC,P004381,P012591,23.3,6,44,38
2,VNC,P009400,P011909,3.516,-4,5,9
2,VNC,P009400,P011928,11.866,-20,12,32
2,VNC,P009400,P012587,6.35,-14,5,19
2,VNC,P009400,P012590,9.884,-15,10,25
2,VNC,P009400,P012591,2.933,-4,2,6
2,VNC,P011909,P011928,29.434,11,58,47
2,VNC,P011909,P012587,3.817,4,10,6
2,VNC,P011909,P012590,7.634,6,16,10
2,VNC,P011909,P012591,22.267,8,44,36
2,VNC,P011928,P012587,8.817,-10,11,21
2,VNC,P011928,P012590,13.601,-8,19,27
2,VNC,P011928,P012591,24.267,6,46,40
2,VNC,P012587,P012590,10.167,-10,15,25
2,VNC,P012590,P012591,0.967,0,2,2
3,PRS,P003481,P005793,7.666,1,22,21
3,PRS,P003481,P012608,2.183,-5,3,8
3,PRS,P003481,P012609,16.366,7,41,34
3,PRS,P003481,P012610,0.733,1,2,1
3,PRS,P003481,P012611,16.366,7,41,34
3,PRS,P003481,P012613,7.967,5,17,12
3,PRS,P003481,P012640,14.183,12,38,26
3,PRS,P004512,P005793,10.8,8,30,22
3,PRS,P004512,P011887,10.5,15,33,18
3,PRS,P004512,P012608,16.983,20,49,29
3,PRS,P004512,P012609,1.233,1,4,3
3,PRS,P004512,P012610,16.983,20,49,29
3,PRS,P004512,P012611,5.25,4,12,8
3,PRS,P004512,P012613,6.183,12,19,7
3,PRS,P005793,P011887,5.217,7,18,11
3,PRS,P005793,P012608,16.55,7,42,35
3,PRS,P005793,P012609,10.299,-2,27,29
3,PRS,P005793,P012610,12.467,12,34,22
3,PRS,P005793,P012611,12.916,5,34,29
3,PRS,P005793,P012613,3.367,4,9,5
3,PRS,P005793,P012640,8.85,10,28,18
3,PRS,P010801,P011551,1.533,-3,0,3
3,PRS,P010801,P011887,2.95,-5,5,10
3,PRS,P010801,P012609,1.55,-1,6,7
3,PRS,P010801,P012610,1.533,-3,0,3
3,PRS,P010801,P012611,0.133,1,1,0
3,PRS,P010801,P012613,1.55,-1,6,7
3,PRS,P010801,P012640,3.083,-4,6,10
3,PRS,P011551,P011887,1.533,-3,0,3
3,PRS,P011551,P012610,1.533,-3,0,3
3,PRS,P011551,P012640,1.533,-3,0,3
3,PRS,P011887,P012608,10.7,15,33,18
3,PRS,P011887,P012609,1.617,-2,5,7
3,PRS,P011887,P012610,12.233,12,33,21
3,PRS,P011887,P012613,6.9,6,20,14
3,PRS,P011887,P012640,2.95,-5,5,10
3,PRS,P012608,P012609,5.516,-4,12,16
3,PRS,P012608,P012610,18.65,24,53,29
3,PRS,P012608,P012611,7.433,-1,15,16
3,PRS,P012608,P012613,9.55,16,28,12
3,PRS,P012608,P012640,3.367,4,9,5
3,PRS,P012609,P012610,2.166,2,6,4
3,PRS,P012609,P012611,16.499,8,42,34
3,PRS,P012609,P012613,12.117,8,32,24
3,PRS,P012609,P012640,17.633,11,49,38
3,PRS,P012610,P012611,5.983,5,14,9
3,PRS,P012610,P012613,7.65,16,23,7
3,PRS,P012610,P012640,3.733,2,6,4
3,PRS,P012611,P012613,8.1,6,18,12
3,PRS,P012611,P012640,14.316,13,39,26
3,PRS,P012613,P012640,12.884,8,32,24
3,WOL,P002333,P002387,9.134,-7,21,28
3,WOL,P002333,P005516,9.45,-1,18,19
3,WOL,P002333,P006154,11.467,4,29,25
3,WOL,P002333,P006907,3.083,4,10,6
3,WOL,P002333,P008104,5.65,-5,15,20
3,WOL,P002333,P011150,11.001,-3,26,29
3,WOL,P002333,P012577,4.083,-4,5,9
3,WOL,P002387,P004229,5.7,-4,7,11
3,WOL,P002387,P004645,0.667,-2,0,2
3,WOL,P002387,P005516,15.484,-17,29,46
3,WOL,P002387,P006154,13.851,-9,32,41
3,WOL,P002387,P008104,17.134,-25,30,55
3,WOL,P002387,P011150,27.018,-24,51,75
3,WOL,P002387,P012576,14.417,-20,27,47
3,WOL,P002387,P012577,16.267,-24,23,47
3,WOL,P004229,P006154,0.4,0,0,0
3,WOL,P004229,P008104,5.7,-4,7,11
3,WOL,P004229,P011150,5.7,-4,7,11
3,WOL,P004229,P012577,5.3,-4,7,11
3,WOL,P004645,P005516,3.033,-3,6,9
3,WOL,P004645,P006154,3.033,-3,6,9
3,WOL,P004645,P008104,1.433,0,5,5
3,WOL,P004645,P011150,1.6,-3,1,4
3,WOL,P004645,P012576,2.366,-1,6,7
3,WOL,P005516,P006154,15.6,6,35,29
3,WOL,P005516,P006907,1.533,3,3,0
3,WOL,P005516,P008104,7.567,-8,14,22
3,WOL,P005516,P011150,16.084,-9,28,37
3,WOL,P005516,P012576,13.9,-9,27,36
3,WOL,P005516,P012577,13.417,-10,20,30
3,WOL,P006154,P006907,3.083,4,10,6
3,WOL,P006154,P008104,12.367,-6,30,36
3,WOL,P006154,P011150,17.534,-5,42,47
3,WOL,P006154,P012576,10.733,-3,26,29
3,WOL,P006154,P012577,5.0,8,10,2
3,WOL,P006907,P008104,2.25,1,7,6
3,WOL,P006907,P011150,1.55,1,7,6
3,WOL,P006907,P012577,0.833,3,3,0
3,WOL,P008104,P011150,16.651,-17,33,50
3,WOL,P008104,P012576,12.201,-14,25,39
3,WOL,P008104,P012577,13.251,-14,22,36
3,WOL,P011150,P012576,14.7,-15,28,43
3,WOL,P011150,P012577,16.434,-17,21,38
3,WOL,P012576,P012577,12.351,-10,21,31
4,HTA,P003533,P004846,8.718,9,18,9
4,HTA,P003533,P006835,10.385,15,26,11
4,HTA,P003533,P007759,18.385,18,48,30
4,HTA,P003533,P010465,16.101,14,40,26
4,HTA,P003533,P010550,15.001,10,37,27
4,HTA,P003533,P011990,12.285,13,30,17
4,HTA,P003533,P011991,20.652,21,53,32
4,HTA,P003533,P012028,0.017,0,0,0
4,HTA,P004846,P006835,15.102,9,43,34
4,HTA,P004846,P007759,7.718,4,21,17
4,HTA,P004846,P010465,10.034,6,26,20
4,HTA,P004846,P010550,11.501,3,30,27
4,HTA,P004846,P011990,7.084,5,20,15
4,HTA,P004846,P011991,10.668,5,27,22
4,HTA,P004846,P012592,0.183,-1,3,4
4,HTA,P006835,P007759,15.418,15,41,26
4,HTA,P006835,P010465,12.517,7,30,23
4,HTA,P006835,P010550,12.634,5,34,29
4,HTA,P006835,P011990,12.351,12,32,20
4,HTA,P006835,P011991,16.118,14,43,29
4,HTA,P006835,P012592,1.133,-1,3,4
4,HTA,P006835,P012706,0.95,0,0,0
4,HTA,P007759,P010465,12.9,10,33,23
4,HTA,P007759,P010550,22.501,13,59,46
4,HTA,P007759,P011990,10.118,12,28,16
4,HTA,P007759,P011991,25.568,20,66,46
4,HTA,P010465,P010550,18.017,12,45,33
4,HTA,P010465,P011990,6.3,0,12,12
4,HTA,P010465,P011991,18.434,14,47,33
4,HTA,P010465,P012028,0.85,-2,0,2
4,HTA,P010465,P012592,1.983,-3,3,6
4,HTA,P010465,P012706,1.8,-2,0,2
4,HTA,P010550,P011990,5.401,4,15,11
4,HTA,P010550,P011991,25.468,13,64,51
4,HTA,P010550,P012028,0.017,0,0,0
4,HTA,P011990,P011991,7.551,9,20,11
4,HTA,P011990,P012028,0.867,-2,0,2
4,HTA,P011990,P012592,1.983,-3,3,6
4,HTA,P011990,P012706,1.8,-2,0,2
4,HTA,P011991,P012028,0.017,0,0,0
4,HTA,P012028,P012592,0.85,-2,0,2
4,HTA,P012028,P012706,0.85,-2,0,2
4,HTA,P012592,P012706,1.8,-2,0,2
4,LJU,P002561,P007066,2.85,-4,0,4
4,LJU,P002561,P008883,1.867,-2,0,2
4,LJU,P002561,P009395,0.983,-2,0,2
4,LJU,P002561,P010594,1.867,-2,0,2
4,LJU,P002561,P011261,2.85,-4,0,4
4,LJU,P002561,P012700,0.983,-2,0,2
4,LJU,P003452,P005969,22.517,-14,46,60
4,LJU,P003452,P007066,3.25,-1,7,8
4,LJU,P003452,P008883,8.834,-3,18,21
4,LJU,P003452,P009395,22.8,-21,44,65
4,LJU,P003452,P010594,6.217,-1,16,17
4,LJU,P003452,P010771,1.183,-4,1,5
4,LJU,P003452,P011261,5.666,-11,10,21
4,LJU,P003452,P012598,18.65,-17,34,51
4,LJU,P003452,P012700,15.083,-16,28,44
4,LJU,P005969,P007066,10.167,-4,21,25
4,LJU,P005969,P008883,17.818,-6,34,40
4,LJU,P005969,P009395,24.718,-11,49,60
4,LJU,P005969,P010594,9.967,0,22,22
4,LJU,P005969,P010771,1.183,-4,1,5
4,LJU,P005969,P011261,9.9,-4,23,27
4,LJU,P005969,P012598,21.201,-11,43,54
4,LJU,P005969,P012700,17.001,-6,33,39
4,LJU,P007066,P008883,8.634,-3,14,17
4,LJU,P007066,P009395,2.25,-2,2,4
4,LJU,P007066,P010594,6.067,0,10,10
4,LJU,P007066,P010771,1.183,-4,1,5
4,LJU,P007066,P011261,11.9,-10,19,29
4,LJU,P007066,P012598,3.517,-2,8,10
4,LJU,P007066,P012700,2.25,-2,2,4
4,LJU,P008883,P009395,11.051,-5,20,25
4,LJU,P008883,P010594,10.884,-3,18,21
4,LJU,P008883,P011261,7.517,-5,12,17
4,LJU,P008883,P012598,8.801,-5,16,21
4,LJU,P008883,P012700,3.334,0,4,4
4,LJU,P009395,P010594,5.767,-2,12,14
4,LJU,P009395,P011261,6.633,-8,11,19
4,LJU,P009395,P012598,21.217,-17,40,57
4,LJU,P009395,P012700,21.517,-16,38,54
4,LJU,P010594,P011261,4.95,-2,8,10
4,LJU,P010594,P012700,1.617,2,2,0
4,LJU,P010771,P011261,1.183,-4,1,5
4,LJU,P011261,P012598,7.9,-8,17,25
4,LJU,P011261,P012700,6.633,-8,11,19
4,LJU,P012598,P012700,17.65,-16,34,50
5,BES,P003783,P007914,27.933,8,46,38
5,BES,P003783,P007917,23.866,5,38,33
5,BES,P003783,P008945,3.933,2,9,7
5,BES,P003783,P009582,21.033,7,38,31
5,BES,P003783,P011357,8.75,-1,15,16
5,BES,P003783,P011379,9.467,2,13,11
5,BES,P003783,P011936,21.683,10,33,23
5,BES,P003783,P012647,17.599,3,24,21
5,BES,P007914,P007917,20.467,4,36,32
5,BES,P007914,P008945,3.933,2,9,7
5,BES,P007914,P009582,16.717,4,32,28
5,BES,P007914,P011357,10.984,-1,21,22
5,BES,P007914,P011379,10.384,4,17,13
5,BES,P007914,P011936,18.284,9,31,22
5,BES,P007914,P012647,11.966,2,16,14
5,BES,P007917,P008945,8.133,-6,12,18
5,BES,P007917,P009582,16.85,-7,27,34
5,BES,P007917,P011357,9.734,0,20,20
5,BES,P007917,P011379,4.234,0,6,6
5,BES,P007917,P011936,18.417,-2,26,28
5,BES,P007917,P012647,19.499,-6,23,29
5,BES,P008945,P009582,4.2,-8,3,11
5,BES,P008945,P011357,0.733,-2,3,5
5,BES,P008945,P011379,0.967,1,2,1
5,BES,P008945,P011936,4.2,-8,3,11
5,BES,P008945,P012647,6.433,-5,7,12
5,BES,P009582,P011357,4.784,-3,9,12
5,BES,P009582,P011379,6.15,4,11,7
5,BES,P009582,P011936,20.95,-3,31,34
5,BES,P009582,P012647,15.516,-6,21,27
5,BES,P011357,P011379,1.8,1,4,3
5,BES,P011357,P011936,7.151,2,12,10
5,BES,P011379,P011936,7.067,6,15,9
5,BES,P011379,P012647,1.467,-2,0,2
5,BES,P011936,P012647,14.716,-6,17,23
5,JOV,P002361,P002507,20.217,0,29,29
5,JOV,P002361,P005094,15.684,4,26,22
5,JOV,P002361,P006771,8.551,-5,10,15
5,JOV,P002361,P010161,6.5,1,12,11
5,JOV,P002361,P010166,8.533,8,18,10
5,JOV,P002361,P010458,2.967,-6,2,8
5,JOV,P002361,P010709,0.217,2,2,0
5,JOV,P002361,P011247,8.1,-3,11,14
5,JOV,P002361,P011248,10.867,3,22,19
5,JOV,P002361,P012076,2.984,0,8,8
5,JOV,P002361,PJUG,8.184,-4,8,12
5,JOV,P002507,P005094,13.717,4,20,16
5,JOV,P002507,P006771,9.234,-2,9,11
5,JOV,P002507,P010161,5.483,1,10,9
5,JOV,P002507,P010166,9.433,10,20,10
5,JOV,P002507,P010458,3.917,-3,5,8
5,JOV,P002507,P011247,10.75,0,16,16
5,JOV,P002507,P011248,10.833,3,18,15
5,JOV,P002507,PJUG,7.884,-1,9,10
5,JOV,P005094,P006771,8.818,3,11,8
5,JOV,P005094,P010161,2.65,-4,3,7
5,JOV,P005094,P010166,5.733,11,14,3
5,JOV,P005094,P010458,2.134,-6,0,6
5,JOV,P005094,P011247,10.384,-4,10,14
5,JOV,P005094,P011248,14.834,10,28,18
5,JOV,P005094,P012076,7.234,4,12,8
5,JOV,P005094,PJUG,7.284,-6,4,10
5,JOV,P006771,P010166,3.0,0,4,4
5,JOV,P006771,P010458,5.0,-5,5,10
5,JOV,P006771,P011247,8.267,3,10,7
5,JOV,P006771,P011248,9.7,-2,11,13
5,JOV,P006771,P012076,7.584,0,11,11
5,JOV,P006771,PJUG,7.118,0,9,9
5,JOV,P010161,P010166,4.15,1,7,6
5,JOV,P010161,P010458,6.684,-7,12,19
5,JOV,P010161,P010709,0.217,2,2,0
5,JOV,P010161,P011247,10.184,-4,19,23
5,JOV,P010161,P011248,1.333,0,3,3
5,JOV,P010161,P012076,5.884,-1,14,15
5,JOV,P010161,PJUG,7.051,-5,14,19
5,JOV,P010166,P011247,8.5,5,14,9
5,JOV,P010166,P011248,6.816,12,16,4
5,JOV,P010166,P012076,3.45,2,5,3
5,JOV,P010166,PJUG,1.917,-1,2,3
5,JOV,P010458,P011247,9.684,-8,15,23
5,JOV,P010458,P011248,2.116,-4,0,4
5,JOV,P010458,P012076,7.567,-7,12,19
5,JOV,P010458,PJUG,10.535,-10,17,27
5,JOV,P010709,P012076,0.217,2,2,0
5,JOV,P010709,PJUG,0.217,2,2,0
5,JOV,P011247,P011248,8.433,2,10,8
5,JOV,P011247,P012076,12.984,0,20,20
5,JOV,P011247,PJUG,12.318,-7,19,26
5,JOV,P011248,P012076,7.2,4,12,8
5,JOV,P012076,PJUG,8.768,-4,16,20
6,BOU,P004525,P010431,4.617,8,14,6
6,BOU,P004525,P010449,7.6,11,23,12
6,BOU,P004525,P010450,14.383,10,29,19
6,BOU,P004525,P010718,15.549,11,32,21
6,BOU,P004525,P011161,12.566,8,23,15
6,BOU,P004525,P011837,2.784,7,9,2
6,BOU,P004525,P012619,17.382,12,37,25
6,BOU,P004525,P012628,5.783,9,17,8
6,BOU,P010431,P010449,18.684,8,48,40
6,BOU,P010431,P010450,4.7,-3,8,11
6,BOU,P010431,P010718,2.067,3,9,6
6,BOU,P010431,P011161,0.5,-3,0,3
6,BOU,P010431,P011836,16.85,-5,38,43
6,BOU,P010431,P011837,15.951,3,39,36
6,BOU,P010431,P012619,5.516,0,13,13
6,BOU,P010431,P012628,16.983,1,39,38
6,BOU,P010449,P010450,4.9,5,13,8
6,BOU,P010449,P010718,8.033,8,24,16
6,BOU,P010449,P011836,17.05,2,40,38
6,BOU,P010449,P011837,17.651,4,42,38
6,BOU,P010449,P012619,6.999,9,21,12
6,BOU,P010449,P012628,17.683,5,41,36
6,BOU,P010450,P010718,12.466,8,25,17
6,BOU,P010450,P011161,9.983,2,16,14
6,BOU,P010450,P011836,2.783,-5,4,9
6,BOU,P010450,P011837,0.667,0,0,0
6,BOU,P010450,P012619,16.499,5,33,28
6,BOU,P010450,P012628,2.283,-2,4,6
6,BOU,P010718,P011161,12.566,8,23,15
6,BOU,P010718,P011836,5.05,5,15,10
6,BOU,P010718,P011837,4.667,8,16,8
6,BOU,P010718,P012619,15.932,8,31,23
6,BOU,P010718,P012628,6.066,5,13,8
6,BOU,P011161,P011836,0.5,-3,0,3
6,BOU,P011161,P011837,0.9,4,4,0
6,BOU,P011161,P012619,12.166,1,19,18
6,BOU,P011161,P012628,3.083,3,7,4
6,BOU,P011836,P011837,15.767,1,37,36
6,BOU,P011836,P012619,4.066,-4,7,11
6,BOU,P011836,P012628,17.266,-3,35,38
6,BOU,P011837,P012628,15.817,5,37,32
6,BOU,P012619,P012628,7.232,1,15,14
6,WRO,P001694,P003034,5.867,-5,8,13
6,WRO,P001694,P005531,20.566,5,46,41
6,WRO,P001694,P009896,23.866,4,50,46
6,WRO,P001694,P011900,13.234,-5,23,28
6,WRO,P001694,P012308,1.7,-1,2,3
6,WRO,P001694,P012699,18.666,2,39,37
6,WRO,P001694,P012735,18.217,1,34,33
6,WRO,P001694,P012736,16.816,-5,30,35
6,WRO,P003034,P005531,8.533,-7,17,24
6,WRO,P003034,P009896,8.2,-12,10,22
6,WRO,P003034,P011900,11.351,-11,15,26
6,WRO,P003034,P012699,5.116,-9,6,15
6,WRO,P003034,P012735,12.834,-17,17,34
6,WRO,P003034,P012736,8.767,-11,11,22
6,WRO,P005531,P009896,25.116,-7,51,58
6,WRO,P005531,P011900,9.084,-3,23,26
6,WRO,P005531,P012699,20.149,-4,41,45
6,WRO,P005531,P012735,17.25,-3,36,39
6,WRO,P005531,P012736,10.966,-1,26,27
6,WRO,P009896,P011900,15.684,-9,30,39
6,WRO,P009896,P012308,1.7,-1,2,3
6,WRO,P009896,P012699,18.666,-3,37,40
6,WRO,P009896,P012735,23.85,-9,43,52
6,WRO,P009896,P012736,15.05,-3,29,32
6,WRO,P011900,P012308,1.7,-1,2,3
6,WRO,P011900,P012699,4.7,-3,9,12
6,WRO,P011900,P012735,16.918,-13,28,41
6,WRO,P011900,P012736,12.001,-11,18,29
6,WRO,P012308,P012735,1.7,-1,2,3
6,WRO,P012699,P012735,9.933,-4,17,21
6,WRO,P012699,P012736,8.566,-3,15,18
6,WRO,P012735,P012736,13.234,-10,23,33
7,CLU,P004862,P005113,14.866,5,35,30
7,CLU,P004862,P005373,6.7,-9,8,17
7,CLU,P004862,P005714,12.633,2,27,25
7,CLU,P004862,P010569,24.099,6,48,42
7,CLU,P004862,P011797,14.983,-6,23,29
7,CLU,P004862,P011801,12.633,2,27,25
7,CLU,P004862,P012621,22.332,12,50,38
7,CLU,P004862,P012698,8.35,-4,18,22
7,CLU,P005113,P005714,2.066,6,8,2
7,CLU,P005113,P010569,14.433,4,32,28
7,CLU,P005113,P011797,12.333,8,27,19
7,CLU,P005113,P011801,2.066,6,8,2
7,CLU,P005113,P012621,16.499,10,40,30
7,CLU,P005113,P012698,3.733,1,10,9
7,CLU,P005373,P005714,9.351,-1,15,16
7,CLU,P005373,P010569,6.567,-6,9,15
7,CLU,P005373,P011797,8.767,6,16,10
7,CLU,P005373,P011801,13.835,-3,24,27
7,CLU,P005373,P012620,1.517,-3,0,3
7,CLU,P005373,P012621,6.567,-6,9,15
7,CLU,P005373,P012698,10.368,-6,15,21
7,CLU,P005714,P010569,7.583,6,16,10
7,CLU,P005714,P011797,7.05,7,13,6
7,CLU,P005714,P011801,19.0,11,39,28
7,CLU,P005714,P012620,1.517,-3,0,3
7,CLU,P005714,P012621,7.449,17,23,6
7,CLU,P005714,P012698,9.351,-1,15,16
7,CLU,P010569,P011797,18.45,-3,32,35
7,CLU,P010569,P011801,12.067,4,25,21
7,CLU,P010569,P012621,26.383,9,56,47
7,CLU,P010569,P012698,4.75,-4,10,14
7,CLU,P011797,P011801,10.517,10,22,12
7,CLU,P011797,P012621,17.883,7,36,29
7,CLU,P011797,P012698,3.217,7,7,0
7,CLU,P011801,P012620,1.517,-3,0,3
7,CLU,P011801,P012621,11.933,15,32,17
7,CLU,P011801,P012698,10.368,-6,15,21
7,CLU,P012620,P012698,1.517,-3,0,3
7,CLU,P012621,P012698,4.75,-4,10,14
7,TTK,P000497,P006693,2.183,-5,0,5
7,TTK,P000497,P011239,2.183,-5,0,5
7,TTK,P000497,P011834,2.183,-5,0,5
7,TTK,P000497,P011925,2.183,-5,0,5
7,TTK,P004801,P005000,7.801,-7,15,22
7,TTK,P004801,P005685,2.984,-5,6,11
7,TTK,P004801,P006693,8.084,-3,14,17
7,TTK,P004801,P009845,1.5,-1,3,4
7,TTK,P004801,P011239,7.834,-1,14,15
7,TTK,P004801,P011834,12.318,-7,23,30
7,TTK,P004801,P011925,-0.05,0,0,0
7,TTK,P004801,P012056,4.567,0,8,8
7,TTK,P004801,P012697,4.234,-4,9,13
7,TTK,P005000,P005685,8.784,-1,14,15
7,TTK,P005000,P006693,9.184,-4,16,20
7,TTK,P005000,P009845,10.267,-4,18,22
7,TTK,P005000,P011239,9.834,-12,13,25
7,TTK,P005000,P011834,21.235,-3,38,41
7,TTK,P005000,P011925,22.701,-7,38,45
7,TTK,P005000,P012056,14.517,-12,24,36
7,TTK,P005000,P012697,17.685,-6,36,42
7,TTK,P005685,P006693,1.134,1,3,2
7,TTK,P005685,P011834,12.151,9,26,17
7,TTK,P005685,P011925,9.167,14,20,6
7,TTK,P005685,P012056,5.467,8,13,5
7,TTK,P005685,P012697,8.917,10,22,12
7,TTK,P006693,P009845,6.25,-2,13,15
7,TTK,P006693,P011239,9.067,-7,9,16
7,TTK,P006693,P011834,11.701,-7,15,22
7,TTK,P006693,P011925,8.317,-5,11,16
7,TTK,P006693,P012056,9.884,0,19,19
7,TTK,P009845,P011834,4.1,-4,6,10
7,TTK,P009845,P011925,10.267,-4,18,22
7,TTK,P009845,P012056,10.7,-4,18,22
7,TTK,P009845,P012697,3.984,-1,8,9
7,TTK,P011239,P011834,12.867,-6,16,22
7,TTK,P011239,P011925,6.583,-15,2,17
7,TTK,P011239,P012056,4.1,-9,3,12
7,TTK,P011239,P012697,5.4,-9,7,16
7,TTK,P011834,P011925,18.367,9,33,24
7,TTK,P011834,P012056,12.617,9,27,18
7,TTK,P011834,P012697,15.401,13,40,27
7,TTK,P011925,P012056,17.317,-2,34,36
7,TTK,P011925,P012697,15.684,7,36,29
7,TTK,P012056,P012697,8.367,2,22,20
8,BUD,P002740,P004945,13.801,7,28,21
8,BUD,P002740,P006561,3.917,-4,5,9
8,BUD,P002740,P006566,6.167,13,16,3
8,BUD,P002740,P010248,18.117,4,32,28
8,BUD,P002740,P010432,4.017,8,12,4
8,BUD,P002740,P011935,13.384,-3,23,26
8,BUD,P002740,P012605,2.334,3,4,1
8,BUD,P002740,P012606,20.467,6,40,34
8,BUD,P002740,P012630,9.0,2,16,14
8,BUD,P004397,P007398,4.55,-1,7,8
8,BUD,P004397,P010432,4.55,-1,7,8
8,BUD,P004397,P012605,4.55,-1,7,8
8,BUD,P004397,P012630,4.55,-1,7,8
8,BUD,P004945,P006561,3.15,-4,5,9
8,BUD,P004945,P006566,4.801,8,13,5
8,BUD,P004945,P007398,10.717,7,22,15
8,BUD,P004945,P010248,9.117,2,16,14
8,BUD,P004945,P010432,14.384,15,34,19
8,BUD,P004945,P011935,17.584,7,32,25
8,BUD,P004945,P012605,9.351,10,21,11
8,BUD,P004945,P012606,15.167,4,29,25
8,BUD,P006561,P007398,0.35,0,0,0
8,BUD,P006561,P010248,3.25,-1,5,6
8,BUD,P006561,P011935,1.017,-3,0,3
8,BUD,P006561,P012606,4.267,-4,5,9
8,BUD,P006561,P012630,1.117,0,0,0
8,BUD,P006566,P007398,2.917,4,9,5
8,BUD,P006566,P010248,4.7,9,12,3
8,BUD,P006566,P010432,4.384,8,13,5
8,BUD,P006566,P012605,5.251,7,13,6
8,BUD,P006566,P012606,3.833,10,12,2
8,BUD,P006566,P012630,4.283,9,12,3
8,BUD,P007398,P010432,16.85,2,32,30
8,BUD,P007398,P011935,9.733,-1,16,17
8,BUD,P007398,P012605,13.1,-2,24,26
8,BUD,P007398,P012606,4.1,4,8,4
8,BUD,P007398,P012630,6.483,-5,10,15
8,BUD,P010248,P011935,10.167,-4,15,19
8,BUD,P010248,P012605,0.867,-1,0,1
8,BUD,P010248,P012606,17.25,5,32,27
8,BUD,P010248,P012630,9.0,2,16,14
8,BUD,P010432,P011935,11.933,3,24,21
8,BUD,P010432,P012605,14.567,2,28,26
8,BUD,P010432,P012606,6.3,8,16,8
8,BUD,P010432,P012630,6.483,-5,10,15
8,BUD,P011935,P012605,5.633,-5,8,13
8,BUD,P011935,P012606,17.484,1,31,30
8,BUD,P011935,P012630,5.533,-11,7,18
8,BUD,P012605,P012630,6.083,-9,7,16
8,BUD,P012606,P012630,9.4,6,19,13
8,LKB,P002012,P004664,25.484,-7,41,48
8,LKB,P002012,P005521,17.418,-24,21,45
8,LKB,P002012,P006230,16.85,-6,31,37
8,LKB,P002012,P007029,26.301,-10,43,53
8,LKB,P002012,P008856,7.418,-5,12,17
8,LKB,P002012,P010461,14.651,-7,21,28
8,LKB,P002012,PLXI,18.95,7,39,32
8,LKB,P004664,P005521,15.384,-12,23,35
8,LKB,P004664,P006230,16.416,-4,29,33
8,LKB,P004664,P007029,25.067,-13,34,47
8,LKB,P004664,P008856,3.467,-3,1,4
8,LKB,P004664,P010461,12.034,-7,14,21
8,LKB,P004664,P012583,3.233,-4,2,6
8,LKB,P004664,PLXI,13.783,6,28,22
8,LKB,P005521,P006230,9.717,-7,19,26
8,LKB,P005521,P007029,16.002,-21,17,38
8,LKB,P005521,P008856,7.652,-6,11,17
8,LKB,P005521,P010461,12.785,-11,15,26
8,LKB,P005521,P012583,5.351,6,13,7
8,LKB,P005521,PLXI,6.767,3,17,14
8,LKB,P006230,P007029,15.067,-5,25,30
8,LKB,P006230,P008856,1.534,0,6,6
8,LKB,P006230,P012583,1.1,2,4,2
8,LKB,P006230,PLXI,11.116,4,26,22
8,LKB,P007029,P008856,9.901,-6,13,19
8,LKB,P007029,P010461,17.034,-10,22,32
8,LKB,P007029,P012583,6.067,-5,4,9
8,LKB,P007029,PLXI,14.033,10,30,20
8,LKB,P008856,P010461,12.951,-3,17,20
8,LKB,P008856,P012583,7.334,2,11,9
8,LKB,P008856,PLXI,8.751,9,21,12
8,LKB,P010461,P012583,7.134,0,9,9
8,LKB,P010461,PLXI,10.551,10,22,12
8,LKB,P012583,PLXI,2.717,7,9,2
9,ARI,P002867,P003240,4.733,-10,3,13
9,ARI,P002867,P004292,5.817,3,17,14
9,ARI,P002867,P012615,0.8,0,0,0
9,ARI,P002867,P012702,6.133,-12,5,17
9,ARI,P002867,P012707,0.183,3,3,0
9,ARI,P002867,P012708,9.382,-5,14,19
9,ARI,P002867,P012716,11.616,-10,19,29
9,ARI,P002867,P012717,4.9,-8,4,12
9,ARI,P002867,P012722,6.1,-1,11,12
9,ARI,P003240,P004292,15.184,-5,23,28
9,ARI,P003240,P012615,21.349,-5,33,38
9,ARI,P003240,P012702,13.066,-8,23,31
9,ARI,P003240,P012707,8.599,-3,18,21
9,ARI,P003240,P012708,23.949,-8,36,44
9,ARI,P003240,P012716,13.699,-12,19,31
9,ARI,P003240,P012717,3.217,1,8,7
9,ARI,P003240,P012722,10.8,-6,13,19
9,ARI,P004292,P012615,15.683,-7,24,31
9,ARI,P004292,P012702,2.434,-4,3,7
9,ARI,P004292,P012707,1.416,0,5,5
9,ARI,P004292,P012708,16.25,7,34,27
9,ARI,P004292,P012716,13.9,-2,28,30
9,ARI,P004292,P012717,2.534,-3,2,5
9,ARI,P004292,P012722,15.65,-5,28,33
9,ARI,P012615,P012702,7.116,-2,12,14
9,ARI,P012615,P012707,8.382,-5,15,20
9,ARI,P012615,P012708,20.216,-3,35,38
9,ARI,P012615,P012716,9.249,-7,12,19
9,ARI,P012615,P012722,11.733,-7,17,24
9,ARI,P012616,P012702,1.1,2,2,0
9,ARI,P012616,P012707,1.1,2,2,0
9,ARI,P012616,P012716,1.1,2,2,0
9,ARI,P012616,P012717,1.1,2,2,0
9,ARI,P012702,P012707,9.149,1,19,18
9,ARI,P012702,P012708,12.949,-8,17,25
9,ARI,P012702,P012716,11.449,-11,15,26
9,ARI,P012702,P012717,8.0,-2,12,14
9,ARI,P012707,P012708,7.132,1,16,15
9,ARI,P012707,P012716,5.565,-1,13,14
9,ARI,P012707,P012717,2.833,1,7,6
9,ARI,P012707,P012722,1.233,-3,2,5
9,ARI,P012708,P012716,16.048,-4,27,31
9,ARI,P012708,P012717,4.983,-3,5,8
9,ARI,P012708,P012722,13.083,-1,24,25
9,ARI,P012716,P012717,8.933,-5,14,19
9,ARI,P012716,P012722,8.633,-6,15,21
9,ARI,P012717,P012722,1.5,-3,2,5
9,CAN,P001607,P003637,8.617,-7,18,25
9,CAN,P001607,P004160,1.317,-2,0,2
9,CAN,P001607,P005005,8.85,-7,18,25
9,CAN,P001607,P006588,6.8,-10,9,19
9,CAN,P001607,P007560,3.783,-5,2,7
9,CAN,P001607,P007644,9.001,-8,12,20
9,CAN,P001607,P008121,4.867,-7,2,9
9,CAN,P001607,P010385,3.433,-3,6,9
9,CAN,P001607,P010452,5.817,-2,11,13
9,CAN,P001607,P010484,2.383,-5,2,7
9,CAN,P003425,P003637,10.667,20,29,9
9,CAN,P003425,P004160,7.751,2,17,15
9,CAN,P003425,P005005,10.734,21,30,9
9,CAN,P003425,P006588,12.218,13,31,18
9,CAN,P003425,P007560,11.784,12,26,14
9,CAN,P003425,P007644,7.284,2,18,16
9,CAN,P003425,P008121,11.634,5,22,17
9,CAN,P003425,P010385,18.834,24,40,16
9,CAN,P003425,P010452,14.234,21,35,14
9,CAN,P003637,P005005,15.9,18,42,24
9,CAN,P003637,P006588,3.267,-5,7,12
9,CAN,P003637,P007560,0.6,0,3,3
9,CAN,P003637,P007644,7.467,0,20,20
9,CAN,P003637,P008121,2.784,-5,2,7
9,CAN,P003637,P010385,11.817,13,27,14
9,CAN,P003637,P010452,16.017,18,40,22
9,CAN,P004160,P006588,9.068,0,17,17
9,CAN,P004160,P007560,3.317,4,7,3
9,CAN,P004160,P007644,5.651,-1,10,11
9,CAN,P004160,P008121,5.751,-4,10,14
9,CAN,P004160,P010385,3.417,1,7,6
9,CAN,P005005,P006588,3.55,-3,11,14
9,CAN,P005005,P007560,3.684,-4,6,10
9,CAN,P005005,P007644,8.117,-2,18,20
9,CAN,P005005,P010385,10.017,15,24,9
9,CAN,P005005,P010452,15.101,23,41,18
9,CAN,P005005,P010484,2.383,-5,2,7
9,CAN,P006588,P007560,10.0,12,23,11
9,CAN,P006588,P007644,9.851,-6,17,23
9,CAN,P006588,P008121,12.151,2,22,20
9,CAN,P006588,P010385,7.717,8,17,9
9,CAN,P006588,P010452,0.167,4,4,0
9,CAN,P006588,P010484,1.283,-3,2,5
9,CAN,P007560,P007644,4.484,-4,3,7
9,CAN,P007560,P008121,7.966,7,12,5
9,CAN,P007560,P010385,9.633,10,19,9
9,CAN,P007560,P010452,4.634,1,9,8
9,CAN,P007560,P010484,2.383,-5,2,7
9,CAN,P007644,P008121,6.851,-5,9,14
9,CAN,P007644,P010452,5.334,2,13,11
9,CAN,P007644,P010484,1.1,-2,0,2
9,CAN,P008121,P010385,9.65,3,15,12
9,CAN,P008121,P010452,4.35,-4,2,6
9,CAN,P010385,P010452,14.55,13,29,16
10,TRN,P001479,P005059,5.101,1,9,8
10,TRN,P001479,P006382,8.85,-6,15,21
10,TRN,P001479,P009903,3.167,2,5,3
10,TRN,P001479,P012593,1.517,0,2,2
10,TRN,P001479,P012594,10.484,-2,17,19
10,TRN,P001479,P012595,9.335,-1,15,16
10,TRN,P001479,P012596,10.201,-5,18,23
10,TRN,P001479,P012597,4.817,-1,11,12
10,TRN,P005059,P005738,25.284,-3,47,50
10,TRN,P005059,P006382,7.167,-8,11,19
10,TRN,P005059,P009903,21.0,2,41,39
10,TRN,P005059,P012593,13.0,2,22,20
10,TRN,P005059,P012594,2.217,2,3,1
10,TRN,P005059,P012595,18.101,6,40,34
10,TRN,P005059,P012596,9.518,-4,15,19
10,TRN,P005059,P012597,20.684,-6,36,42
10,TRN,P005738,P006382,4.934,-6,8,14
10,TRN,P005738,P009903,20.434,-4,38,42
10,TRN,P005738,P012593,14.217,-2,22,24
10,TRN,P005738,P012594,1.217,-4,0,4
10,TRN,P005738,P012595,14.967,3,34,31
10,TRN,P005738,P012596,6.067,-3,9,12
10,TRN,P005738,P012597,18.884,-9,30,39
10,TRN,P006382,P009903,1.383,0,3,3
10,TRN,P006382,P012594,7.333,-5,12,17
10,TRN,P006382,P012595,8.634,-9,15,24
10,TRN,P006382,P012596,12.534,-12,20,32
10,TRN,P006382,P012597,4.833,-2,8,10
10,TRN,P009903,P012593,15.201,-2,24,26
10,TRN,P009903,P012594,4.384,-2,5,7
10,TRN,P009903,P012595,12.867,8,30,22
10,TRN,P009903,P012597,16.5,-12,26,38
10,TRN,P012593,P012594,2.734,-4,2,6
10,TRN,P012593,P012595,5.45,7,11,4
10,TRN,P012593,P012596,0.533,0,0,0
10,TRN,P012593,P012597,10.284,-9,13,22
10,TRN,P012594,P012595,7.968,-1,12,13
10,TRN,P012594,P012596,7.317,-4,12,16
10,TRN,P012594,P012597,3.15,-4,5,9
10,TRN,P012595,P012596,11.568,-6,19,25
10,TRN,P012595,P012597,8.85,1,20,19
10,TRN,P012596,P012597,7.334,2,15,13
10,ULM,P005422,P007952,1.45,0,4,4
10,ULM,P005422,P010106,19.434,-2,32,34
10,ULM,P005422,P010582,13.85,1,24,23
10,ULM,P005422,P010726,0.716,1,1,0
10,ULM,P005422,P011391,4.967,1,12,11
10,ULM,P005422,P011457,2.033,-7,0,7
10,ULM,P005422,P012603,21.434,9,44,35
10,ULM,P005422,P012604,17.05,1,28,27
10,ULM,P005422,P012629,8.901,0,19,19
10,ULM,P005422,P012703,4.033,4,12,8
10,ULM,P007952,P010106,3.617,-5,8,13
10,ULM,P007952,P010582,3.617,-5,8,13
10,ULM,P007952,P010726,2.167,-5,4,9
10,ULM,P007952,P012603,3.617,-5,8,13
10,ULM,P010106,P010582,16.516,-2,30,32
10,ULM,P010106,P010726,2.55,-5,4,9
10,ULM,P010106,P011391,1.067,-3,0,3
10,ULM,P010106,P011457,1.267,-4,0,4
10,ULM,P010106,P012603,21.15,-3,38,41
10,ULM,P010106,P012604,17.733,1,30,29
10,ULM,P010106,P012629,6.334,-5,10,15
10,ULM,P010582,P010726,3.35,-1,8,9
10,ULM,P010582,P011391,3.934,2,8,6
10,ULM,P010582,P011457,9.667,4,21,17
10,ULM,P010582,P012603,19.3,1,35,34
10,ULM,P010582,P012604,21.416,8,40,32
10,ULM,P010582,P012629,11.767,5,24,19
10,ULM,P010582,P012703,12.451,7,26,19
10,ULM,P010726,P011391,0.583,1,1,0
10,ULM,P010726,P011457,0.133,0,0,0
10,ULM,P010726,P012603,3.933,0,9,9
10,ULM,P010726,P012604,1.316,4,4,0
10,ULM,P010726,P012703,1.516,5,5,0
10,ULM,P011391,P011457,5.667,5,12,7
10,ULM,P011391,P012603,5.751,8,16,8
10,ULM,P011391,P012629,9.101,10,23,13
10,ULM,P011391,P012703,8.934,12,24,12
10,ULM,P011457,P012603,1.417,4,4,0
10,ULM,P011457,P012604,7.45,-4,13,17
10,ULM,P011457,P012629,12.984,1,25,24
10,ULM,P011457,P012703,11.85,5,25,20
10,ULM,P012603,P012604,18.933,10,35,25
10,ULM,P012603,P012629,10.518,12,26,14
10,ULM,P012603,P012703,7.151,16,21,5
10,ULM,P012604,P012629,12.984,-1,24,25
10,ULM,P012604,P012703,8.65,5,18,13
10,ULM,P012629,P012703,15.751,14,37,23
11,BES,P003783,P007914,17.249,9,46,37
11,BES,P003783,P007917,12.116,14,35,21
11,BES,P003783,P009582,17.467,-5,33,38
11,BES,P003783,P011357,6.317,3,15,12
11,BES,P003783,P011379,4.683,6,13,7
11,BES,P003783,P011936,19.217,-1,35,36
11,BES,P003783,P012233,1.45,5,6,1
11,BES,P003783,P012622,14.101,5,32,27
11,BES,P003783,P012624,0.683,2,3,1
11,BES,P003783,P012647,20.117,10,46,36
11,BES,P007914,P007917,10.649,14,35,21
11,BES,P007914,P009582,19.933,4,41,37
11,BES,P007914,P011357,14.983,9,32,23
11,BES,P007914,P011379,4.0,4,10,6
11,BES,P007914,P011936,20.249,9,43,34
11,BES,P007914,P012622,12.949,8,31,23
11,BES,P007914,P012647,11.716,11,34,23
11,BES,P007917,P009582,3.617,3,12,9
11,BES,P007917,P011357,6.7,11,24,13
11,BES,P007917,P011379,4.683,6,13,7
11,BES,P007917,P011936,10.9,12,31,19
11,BES,P007917,P012233,1.45,5,6,1
11,BES,P007917,P012622,8.317,12,26,14
11,BES,P007917,P012624,0.683,2,3,1
11,BES,P007917,P012647,8.217,13,23,10
11,BES,P009582,P011357,13.651,8,27,19
11,BES,P009582,P011379,0.8,-2,2,4
11,BES,P009582,P011936,22.784,2,40,38
11,BES,P009582,P012622,16.984,1,30,29
11,BES,P009582,P012647,11.9,-3,23,26
11,BES,P011357,P011936,17.967,13,41,28
11,BES,P011357,P012622,12.25,8,25,17
11,BES,P011379,P012233,0.683,2,3,1
11,BES,P011379,P012624,0.683,2,3,1
11,BES,P011379,P012647,3.2,6,8,2
11,BES,P011936,P012622,19.884,4,34,30
11,BES,P011936,P012647,12.467,-3,20,23
11,BES,P012233,P012622,0.767,3,3,0
11,BES,P012233,P012624,0.683,2,3,1
11,BES,P012233,P012647,0.767,3,3,0
11,BES,P012622,P012647,12.084,3,27,24
11,PMT,P001686,P002644,8.816,-9,18,27
11,PMT,P001686,P009559,4.367,-2,8,10
11,PMT,P001686,P011066,14.634,4,26,22
11,PMT,P001686,P011823,14.867,4,26,22
11,PMT,P001686,P011943,1.933,-7,4,11
11,PMT,P001686,P011944,14.767,10,28,18
11,PMT,P001686,P011947,6.983,-8,12,20
11,PMT,P001686,P011966,9.049,-9,18,27
11,PMT,P001686,P012599,10.267,6,18,12
11,PMT,P001686,P012600,9.049,-9,18,27
11,PMT,P002644,P009559,8.216,-8,15,23
11,PMT,P002644,P011066,0.917,-5,0,5
11,PMT,P002644,P011943,8.432,-13,14,27
11,PMT,P002644,P011944,5.983,5,15,10
11,PMT,P002644,P011947,6.983,-8,14,22
11,PMT,P002644,P011966,16.115,-12,33,45
11,PMT,P002644,P012600,12.666,-18,23,41
11,PMT,P009559,P011066,9.234,-9,14,23
11,PMT,P009559,P011823,12.466,-11,19,30
11,PMT,P009559,P011943,9.315,-8,13,21
11,PMT,P009559,P011944,7.116,-2,14,16
11,PMT,P009559,P011947,13.683,-8,24,32
11,PMT,P009559,P011966,8.299,-6,17,23
11,PMT,P009559,P012599,5.182,-10,5,15
11,PMT,P009559,P012600,4.85,-12,7,19
11,PMT,P011066,P011823,18.584,2,32,30
11,PMT,P011066,P011944,13.184,7,24,17
11,PMT,P011066,P011947,9.234,-9,14,23
11,PMT,P011066,P012599,11.3,3,18,15
11,PMT,P011066,P012600,0.917,-5,0,5
11,PMT,P011823,P011943,2.816,-2,3,5
11,PMT,P011823,P011944,15.9,3,27,24
11,PMT,P011823,P011947,9.316,-6,14,20
11,PMT,P011823,P011966,1.233,-3,2,5
11,PMT,P011823,P012599,15.449,-4,23,27
11,PMT,P011823,P012600,1.233,-3,2,5
11,PMT,P011943,P011944,3.066,-4,3,7
11,PMT,P011943,P011947,3.316,0,5,5
11,PMT,P011943,P011966,8.432,-13,14,27
11,PMT,P011943,P012599,2.816,-2,3,5
11,PMT,P011943,P012600,4.866,-11,9,20
11,PMT,P011944,P011947,4.05,2,11,9
11,PMT,P011944,P011966,5.983,5,15,10
11,PMT,P011944,P012599,12.983,2,21,19
11,PMT,P011944,P012600,4.5,4,10,6
11,PMT,P011947,P011966,6.299,-3,14,17
11,PMT,P011947,P012599,1.799,-5,0,5
11,PMT,P011947,P012600,3.533,-11,4,15
11,PMT,P011966,P012599,1.0,-3,2,5
11,PMT,P011966,P012600,12.982,-16,25,41
11,PMT,P012599,P012600,1.0,-3,2,5
12,JOV,P002361,P002507,13.367,-2,25,27
12,JOV,P002361,P005094,24.183,11,52,41
12,JOV,P002361,P006771,7.467,-4,12,16
12,JOV,P002361,P010161,1.95,-3,4,7
12,JOV,P002361,P010166,2.4,-2,0,2
12,JOV,P002361,P010458,31.284,5,68,63
12,JOV,P002361,P011247,21.584,11,46,35
12,JOV,P002361,P012076,20.334,5,43,38
12,JOV,P002361,PJUG,12.167,-9,22,31
12,JOV,P002507,P005094,19.95,1,36,35
12,JOV,P002507,P006771,0.317,-2,0,2
12,JOV,P002507,P010161,1.5,-1,4,5
12,JOV,P002507,P010166,8.233,-4,12,16
12,JOV,P002507,P010458,13.551,2,28,26
12,JOV,P002507,P010709,2.067,-4,1,5
12,JOV,P002507,P011247,16.867,-2,28,30
12,JOV,P002507,P012076,0.017,0,0,0
12,JOV,P002507,PJUG,11.267,4,26,22
12,JOV,P005094,P010161,0.017,0,0,0
12,JOV,P005094,P010166,8.216,-4,12,16
12,JOV,P005094,P010458,25.901,11,56,45
12,JOV,P005094,P010709,2.067,-4,1,5
12,JOV,P005094,P011247,27.584,7,52,45
12,JOV,P005094,P012076,14.184,6,32,26
12,JOV,P005094,PJUG,14.434,0,31,31
12,JOV,P006771,P010458,8.434,-4,14,18
12,JOV,P006771,P011247,4.834,1,12,11
12,JOV,P006771,P012076,8.117,-2,14,16
12,JOV,P006771,PJUG,4.567,-5,4,9
12,JOV,P010161,P010458,2.35,-1,6,7
12,JOV,P010161,P011247,0.417,2,2,0
12,JOV,P010161,P012076,0.867,0,2,2
12,JOV,P010161,PJUG,2.367,-1,6,7
12,JOV,P010166,P010709,1.85,-5,0,5
12,JOV,P010166,P011247,8.233,-4,12,16
12,JOV,P010166,P012076,0.017,0,0,0
12,JOV,P010166,PJUG,3.983,3,12,9
12,JOV,P010458,P010709,0.217,1,1,0
12,JOV,P010458,P011247,24.652,13,54,41
12,JOV,P010458,P012076,23.201,3,48,45
12,JOV,P010458,PJUG,17.418,-10,29,39
12,JOV,P010709,P011247,2.067,-4,1,5
12,JOV,P011247,P012076,16.052,11,38,27
12,JOV,P011247,PJUG,9.318,1,19,18
12,JOV,P012076,PJUG,10.151,-11,15,26
12,LJU,P001235,P007066,0.017,0,0,0
12,LJU,P001235,P008883,0.017,0,0,0
12,LJU,P001235,P009395,0.017,0,0,0
12,LJU,P001235,P012700,0.017,0,0,0
12,LJU,P002561,P003452,3.017,2,4,2
12,LJU,P002561,P005969,3.533,7,9,2
12,LJU,P002561,P007066,4.85,6,10,4
12,LJU,P002561,P008883,3.8,6,8,2
12,LJU,P002561,P009395,1.55,2,2,0
12,LJU,P002561,P010594,4.433,6,10,4
12,LJU,P002561,P012598,3.367,3,5,2
12,LJU,P002561,P012700,1.05,0,0,0
12,LJU,P003452,P005969,30.416,-3,66,69
12,LJU,P003452,P007066,6.383,-5,10,15
12,LJU,P003452,P008883,19.183,-3,40,43
12,LJU,P003452,P009395,28.183,-3,58,61
12,LJU,P003452,P010594,1.05,0,2,2
12,LJU,P003452,P011261,1.5,-4,0,4
12,LJU,P003452,P012598,31.15,-6,62,68
12,LJU,P003452,P012700,12.65,-6,22,28
12,LJU,P005969,P007066,11.715,1,19,18
12,LJU,P005969,P008883,27.465,6,58,52
12,LJU,P005969,P009395,34.149,0,71,71
12,LJU,P005969,P010594,3.033,5,7,2
12,LJU,P005969,P011261,2.633,-3,0,3
12,LJU,P005969,P012598,32.333,-2,71,73
12,LJU,P005969,P012700,17.183,-3,35,38
12,LJU,P007066,P008883,12.816,-1,18,19
12,LJU,P007066,P009395,5.266,-1,6,7
12,LJU,P007066,P010594,4.433,6,10,4
12,LJU,P007066,P011261,4.133,-7,0,7
12,LJU,P007066,P012598,6.75,-6,9,15
12,LJU,P007066,P012700,3.833,-1,6,7
12,LJU,P008883,P009395,22.066,4,47,43
12,LJU,P008883,P010594,3.383,6,8,2
12,LJU,P008883,P011261,4.133,-7,0,7
12,LJU,P008883,P012598,24.733,-2,52,54
12,LJU,P008883,P012700,5.6,3,13,10
12,LJU,P009395,P011261,1.433,0,0,0
12,LJU,P009395,P012598,29.95,1,65,64
12,LJU,P009395,P012700,18.25,-3,35,38
12,LJU,P010594,P012598,1.4,1,3,2
12,LJU,P011261,P012598,2.7,-7,0,7
12,LJU,P012598,P012700,14.417,-2,29,31
13,HTA,P003533,P004267,12.049,11,31,20
13,HTA,P003533,P004846,11.582,8,27,19
13,HTA,P003533,P007759,12.599,1,28,27
13,HTA,P003533,P010550,8.832,-2,19,21
13,HTA,P003533,P011973,5.8,6,14,8
13,HTA,P003533,P011990,6.282,-4,11,15
13,HTA,P003533,P012706,4.716,-4,10,14
13,HTA,P004267,P004846,31.065,15,73,58
13,HTA,P004267,P007759,31.416,15,73,58
13,HTA,P004267,P010550,27.499,17,69,52
13,HTA,P004267,P011973,28.933,12,64,52
13,HTA,P004267,P011990,7.632,4,20,16
13,HTA,P004267,P012592,1.983,-6,0,6
13,HTA,P004267,P012706,3.883,0,10,10
13,HTA,P004846,P007759,31.249,10,70,60
13,HTA,P004846,P010550,26.716,10,64,54
13,HTA,P004846,P011973,26.183,10,57,47
13,HTA,P004846,P011990,6.849,-3,15,18
13,HTA,P004846,P012592,1.983,-6,0,6
13,HTA,P004846,P012706,0.833,0,2,2
13,HTA,P007759,P010550,27.716,9,63,54
13,HTA,P007759,P011973,26.534,10,57,47
13,HTA,P007759,P011990,6.816,-6,12,18
13,HTA,P007759,P012592,1.983,-6,0,6
13,HTA,P007759,P012706,2.883,-5,5,10
13,HTA,P010550,P011973,21.617,11,50,39
13,HTA,P010550,P011990,10.482,-6,22,28
13,HTA,P010550,P012706,2.666,-3,5,8
13,HTA,P011973,P011990,5.333,2,11,9
13,HTA,P011973,P012592,1.983,-6,0,6
13,HTA,P011973,P012706,1.217,-1,3,4
13,HTA,P011990,P012706,2.666,-3,5,8
13,WOL,P002387,P003212,7.9,-6,12,18
13,WOL,P002387,P004229,5.517,-8,6,14
13,WOL,P002387,P005516,16.534,3,35,32
13,WOL,P002387,P006154,0.767,-2,0,2
13,WOL,P002387,P006546,20.134,2,41,39
13,WOL,P002387,P006907,0.767,-2,0,2
13,WOL,P002387,P011150,20.584,3,47,44
13,WOL,P002387,P012576,16.7,6,36,30
13,WOL,P002387,P012577,4.833,0,11,11
13,WOL,P003212,P004229,10.883,-6,20,26
13,WOL,P003212,P005516,1.0,-2,0,2
13,WOL,P003212,P006154,4.967,-1,10,11
13,WOL,P003212,P006546,9.867,-3,17,20
13,WOL,P003212,P006907,6.884,-6,13,19
13,WOL,P003212,P011150,12.45,-5,27,32
13,WOL,P003212,P012576,8.15,-2,17,19
13,WOL,P003212,P012577,14.716,-5,26,31
13,WOL,P003212,PLCT,1.183,4,6,2
13,WOL,P004229,P005516,2.0,-5,2,7
13,WOL,P004229,P006154,4.967,-1,10,11
13,WOL,P004229,P006546,4.45,-6,6,12
13,WOL,P004229,P006907,5.15,-6,8,14
13,WOL,P004229,P011150,5.8,-9,10,19
13,WOL,P004229,P012577,10.549,-6,18,24
13,WOL,P004229,PLCT,2.216,3,8,5
13,WOL,P005516,P006546,21.501,-3,43,46
13,WOL,P005516,P006907,0.3,-2,0,2
13,WOL,P005516,P011150,18.351,2,39,37
13,WOL,P005516,P012576,18.751,1,36,35
13,WOL,P005516,P012577,5.417,-3,13,16
13,WOL,P005516,PLCT,2.15,-3,4,7
13,WOL,P006154,P006907,3.017,-3,4,7
13,WOL,P006154,P012577,4.967,-1,10,11
13,WOL,P006154,PLCT,1.183,4,6,2
13,WOL,P006546,P006907,2.034,-2,5,7
13,WOL,P006546,P011150,26.135,1,56,55
13,WOL,P006546,P012576,24.701,1,49,48
13,WOL,P006546,P012577,10.5,-3,19,22
13,WOL,P006546,PLCT,2.15,-3,4,7
13,WOL,P006907,P011150,4.167,-5,9,14
13,WOL,P006907,P012576,1.267,0,5,5
13,WOL,P006907,P012577,5.15,-6,8,14
13,WOL,P011150,P012576,23.784,5,51,46
13,WOL,P011150,P012577,11.933,-4,25,29
13,WOL,P012576,P012577,9.134,-5,16,21
13,WOL,P012576,PLCT,1.117,-2,2,4
13,WOL,P012577,PLCT,3.333,1,10,9
14,PRS,P003481,P005793,4.483,0,9,9
14,PRS,P003481,P012608,2.183,2,4,2
14,PRS,P003481,P012609,13.549,6,29,23
14,PRS,P003481,P012610,4.35,5,12,7
14,PRS,P003481,P012611,9.533,1,20,19
14,PRS,P003481,P012613,6.549,4,13,9
14,PRS,P003481,P012640,13.549,6,29,23
14,PRS,P004512,P005793,7.717,-5,17,22
14,PRS,P004512,P011887,4.334,1,5,4
14,PRS,P004512,P012608,12.85,-2,24,26
14,PRS,P004512,P012609,4.333,5,9,4
14,PRS,P004512,P012610,10.766,-5,19,24
14,PRS,P004512,P012611,7.266,-5,15,20
14,PRS,P004512,P012613,5.466,3,7,4
14,PRS,P005793,P011887,2.084,-2,2,4
14,PRS,P005793,P012608,16.117,-5,32,37
14,PRS,P005793,P012609,8.651,2,20,18
14,PRS,P005793,P012610,13.083,-3,28,31
14,PRS,P005793,P012611,14.933,2,34,32
14,PRS,P005793,P012613,9.217,1,17,16
14,PRS,P005793,P012640,9.383,-6,13,19
14,PRS,P011887,P012608,5.401,-1,5,6
14,PRS,P011887,P012609,3.484,1,5,4
14,PRS,P011887,P012610,1.917,-2,0,2
14,PRS,P011887,P012613,4.384,-1,3,4
14,PRS,P012608,P012609,12.567,9,31,22
14,PRS,P012608,P012610,20.866,-2,43,45
14,PRS,P012608,P012611,10.866,1,26,25
14,PRS,P012608,P012613,19.766,6,37,31
14,PRS,P012608,P012640,9.316,-4,14,18
14,PRS,P012609,P012610,10.633,11,32,21
14,PRS,P012609,P012611,12.283,0,25,25
14,PRS,P012609,P012613,17.066,12,40,28
14,PRS,P012609,P012640,17.766,10,41,31
14,PRS,P012610,P012611,13.116,5,33,28
14,PRS,P012610,P012613,16.332,6,33,27
14,PRS,P012610,P012640,11.133,-3,20,23
14,PRS,P012611,P012613,7.849,6,17,11
14,PRS,P012611,P012640,10.35,2,22,20
14,PRS,P012613,P012640,14.499,-1,25,26
14,VNC,P000968,P003759,25.116,1,55,54
14,VNC,P000968,P004117,6.716,-12,7,19
14,VNC,P000968,P009400,12.683,-10,24,34
14,VNC,P000968,P011909,20.983,3,45,42
14,VNC,P000968,P011928,26.7,5,62,57
14,VNC,P000968,P012590,0.383,-2,0,2
14,VNC,P000968,P012591,24.483,3,55,52
14,VNC,P003759,P004117,6.516,-9,2,11
14,VNC,P003759,P009400,13.716,-7,21,28
14,VNC,P003759,P011909,23.85,5,51,46
14,VNC,P003759,P011928,26.65,11,63,52
14,VNC,P003759,P012590,8.433,-1,10,11
14,VNC,P003759,P012591,28.383,8,58,50
14,VNC,P004117,P009400,11.516,-14,10,24
14,VNC,P004117,P011909,3.216,-9,2,11
14,VNC,P004117,P011928,6.833,-8,10,18
14,VNC,P004117,P012587,0.3,2,2,0
14,VNC,P004117,P012590,6.633,-5,5,10
14,VNC,P004117,P012591,11.666,-13,10,23
14,VNC,P009400,P011909,4.4,-4,7,11
14,VNC,P009400,P011928,12.2,-3,27,30
14,VNC,P009400,P012587,0.3,2,2,0
14,VNC,P009400,P012590,6.033,-2,5,7
14,VNC,P009400,P012591,14.016,-10,20,30
14,VNC,P011909,P011928,24.3,8,53,45
14,VNC,P011909,P012590,5.083,-3,8,11
14,VNC,P011909,P012591,20.9,8,46,38
14,VNC,P011928,P012587,0.3,2,2,0
14,VNC,P011928,P012590,7.166,-4,11,15
14,VNC,P011928,P012591,29.783,1,64,63
14,VNC,P012587,P012590,0.3,2,2,0
14,VNC,P012590,P012591,10.433,-5,11,16
15,HAM,P009663,P010070,1.15,0,0,0
15,HAM,P009663,P011168,14.683,-8,38,46
15,HAM,P009663,P011187,10.433,9,25,16
15,HAM,P009663,P012578,6.467,6,18,12
15,HAM,P009663,P012579,13.315,-1,33,34
15,HAM,P009663,P012580,20.649,-6,48,54
15,HAM,P009663,P012581,2.633,2,7,5
15,HAM,P009663,P012582,8.833,2,22,20
15,HAM,P009663,P012648,5.35,-1,14,15
15,HAM,P009663,P012694,9.883,-11,19,30
15,HAM,P010070,P011187,1.15,0,0,0
15,HAM,P010070,P012580,1.15,0,0,0
15,HAM,P010070,P012694,1.15,0,0,0
15,HAM,P011168,P011187,17.283,-5,41,46
15,HAM,P011168,P012578,4.6,-2,6,8
15,HAM,P011168,P012579,13.799,-8,36,44
15,HAM,P011168,P012580,18.632,-8,46,54
15,HAM,P011168,P012581,12.416,-10,28,38
15,HAM,P011168,P012582,18.233,-9,46,55
15,HAM,P011168,P012648,13.917,-7,29,36
15,HAM,P011168,P012694,7.233,-7,18,25
15,HAM,P011187,P012578,7.332,6,16,10
15,HAM,P011187,P012579,11.082,3,29,26
15,HAM,P011187,P012580,11.682,5,25,20
15,HAM,P011187,P012581,15.35,-6,35,41
15,HAM,P011187,P012582,19.534,2,49,47
15,HAM,P011187,P012648,9.533,0,21,21
15,HAM,P011187,P012694,3.816,2,7,5
15,HAM,P011187,P012695,1.133,4,4,0
15,HAM,P012578,P012579,2.633,3,9,6
15,HAM,P012578,P012580,5.25,2,10,8
15,HAM,P012578,P012581,4.033,2,9,7
15,HAM,P012578,P012582,4.033,2,9,7
15,HAM,P012578,P012648,3.583,5,7,2
15,HAM,P012578,P012695,1.133,4,4,0
15,HAM,P012579,P012580,15.298,-4,38,42
15,HAM,P012579,P012581,4.133,-3,10,13
15,HAM,P012579,P012582,7.55,-2,18,20
15,HAM,P012579,P012648,0.483,3,3,0
15,HAM,P012579,P012694,8.099,-3,20,23
15,HAM,P012580,P012581,0.849,-2,2,4
15,HAM,P012580,P012582,8.066,1,22,21
15,HAM,P012580,P012648,6.35,-4,11,15
15,HAM,P012580,P012694,10.466,-8,22,30
15,HAM,P012581,P012582,14.95,-4,35,39
15,HAM,P012581,P012648,7.567,-3,18,21
15,HAM,P012581,P012695,1.133,4,4,0
15,HAM,P012582,P012648,9.6,-4,23,27
15,HAM,P012582,P012695,1.133,4,4,0
15,HAM,P012648,P012694,1.217,-5,2,7
15,LLI,P004479,P004773,2.233,0,0,0
15,LLI,P004479,P005247,0.483,-3,0,3
15,LLI,P004479,P006600,11.533,-2,26,28
15,LLI,P004479,P009649,12.766,-5,26,31
15,LLI,P004479,P009680,1.133,-2,0,2
15,LLI,P004479,P012020,1.233,-3,0,3
15,LLI,P004479,P012585,10.05,-2,26,28
15,LLI,P004479,P012586,11.633,-3,26,29
15,LLI,P004773,P005247,10.383,1,24,23
15,LLI,P004773,P006600,7.933,-4,11,15
15,LLI,P004773,P009649,7.216,-7,9,16
15,LLI,P004773,P009680,9.066,0,20,20
15,LLI,P004773,P012020,6.833,1,17,16
15,LLI,P004773,P012585,8.917,1,21,20
15,LLI,P004773,P012586,6.483,-4,10,14
15,LLI,P005247,P006600,11.633,-3,25,28
15,LLI,P005247,P009649,8.632,-3,19,22
15,LLI,P005247,P009680,15.649,1,39,38
15,LLI,P005247,P012020,8.482,2,23,21
15,LLI,P005247,P012585,16.799,5,43,38
15,LLI,P005247,P012586,8.399,-4,19,23
15,LLI,P006600,P009649,23.383,6,62,56
15,LLI,P006600,P009680,17.399,7,47,40
15,LLI,P006600,P012585,27.65,5,73,68
15,LLI,P006600,P012586,23.533,7,64,57
15,LLI,P009649,P009680,13.532,9,38,29
15,LLI,P009649,P012020,5.132,-2,9,11
15,LLI,P009649,P012585,22.183,11,64,53
15,LLI,P009649,P012586,21.216,7,57,50
15,LLI,P009680,P012020,5.616,4,16,12
15,LLI,P009680,P012585,19.499,15,58,43
15,LLI,P009680,P012586,10.166,10,34,24
15,LLI,P012020,P012585,6.016,8,20,12
15,LLI,P012020,P012586,3.616,-2,7,9
15,LLI,P012585,P012586,23.55,9,67,58
16,BOU,P004525,P010431,1.3,0,2,2
16,BOU,P004525,P010449,11.45,10,20,10
16,BOU,P004525,P010450,19.033,4,30,26
16,BOU,P004525,P010718,14.616,-10,17,27
16,BOU,P004525,P011161,9.549,-10,13,23
16,BOU,P004525,P011836,12.0,10,20,10
16,BOU,P004525,P011837,1.083,-3,2,5
16,BOU,P004525,P012619,6.616,-7,9,16
16,BOU,P004525,P012628,8.349,6,19,13
16,BOU,P010431,P010449,15.167,5,32,27
16,BOU,P010431,P010450,1.583,-3,2,5
16,BOU,P010431,P010718,1.35,-5,0,5
16,BOU,P010431,P011161,3.667,-1,8,9
16,BOU,P010431,P011836,17.251,7,38,31
16,BOU,P010431,P011837,16.467,6,38,32
16,BOU,P010431,P012619,1.067,-2,0,2
16,BOU,P010431,P012628,17.484,9,40,31
16,BOU,P010449,P010450,11.733,7,20,13
16,BOU,P010449,P010718,6.417,-5,4,9
16,BOU,P010449,P011836,23.734,18,48,30
16,BOU,P010449,P011837,12.8,7,30,23
16,BOU,P010449,P012619,1.067,-2,0,2
16,BOU,P010449,P012628,18.9,20,46,26
16,BOU,P010450,P010718,12.933,-9,14,23
16,BOU,P010450,P011161,7.583,-6,10,16
16,BOU,P010450,P011836,12.0,10,20,10
16,BOU,P010450,P011837,0.283,-3,0,3
16,BOU,P010450,P012619,5.733,-6,8,14
16,BOU,P010450,P012628,6.383,10,16,6
16,BOU,P010718,P011161,11.016,-7,21,28
16,BOU,P010718,P011836,9.451,1,14,13
16,BOU,P010718,P011837,2.833,-3,10,13
16,BOU,P010718,P012619,7.683,-9,9,18
16,BOU,P010718,P012628,3.433,-1,11,12
16,BOU,P011161,P011836,6.984,2,18,16
16,BOU,P011161,P011837,6.217,-1,18,19
16,BOU,P011161,P012619,6.616,-7,9,16
16,BOU,P011161,P012628,7.1,-2,19,21
16,BOU,P011836,P011837,17.651,12,46,34
16,BOU,P011836,P012619,1.067,-2,0,2
16,BOU,P011836,P012628,22.734,22,60,38
16,BOU,P011837,P012628,18.734,9,48,39
16,BOU,P012619,P012628,0.883,-1,1,2
16,TRN,P001479,P005059,6.05,1,9,8
16,TRN,P001479,P006382,8.366,-2,9,11
16,TRN,P001479,P009903,4.3,5,9,4
16,TRN,P001479,P012593,3.483,-1,2,3
16,TRN,P001479,P012594,5.366,3,8,5
16,TRN,P001479,P012595,7.933,5,15,10
16,TRN,P001479,P012596,7.116,-1,8,9
16,TRN,P001479,P012597,3.05,6,8,2
16,TRN,P005059,P005738,20.533,-8,40,48
16,TRN,P005059,P006382,4.183,-3,5,8
16,TRN,P005059,P009903,24.25,-3,49,52
16,TRN,P005059,P012593,11.55,-3,25,28
16,TRN,P005059,P012594,4.15,-7,4,11
16,TRN,P005059,P012595,25.516,-2,49,51
16,TRN,P005059,P012596,2.333,-4,0,4
16,TRN,P005059,P012597,7.767,1,15,14
16,TRN,P005738,P006382,6.716,-1,11,12
16,TRN,P005738,P009903,22.85,-8,44,52
16,TRN,P005738,P012593,16.8,-5,36,41
16,TRN,P005738,P012594,12.2,-10,19,29
16,TRN,P005738,P012595,22.266,-4,44,48
16,TRN,P005738,P012596,5.733,-3,11,14
16,TRN,P005738,P012597,7.234,-5,15,20
16,TRN,P006382,P009903,4.75,1,9,8
16,TRN,P006382,P012593,7.266,0,8,8
16,TRN,P006382,P012594,10.899,0,15,15
16,TRN,P006382,P012595,7.816,-3,12,15
16,TRN,P006382,P012596,10.332,-4,11,15
16,TRN,P009903,P012593,14.45,-3,29,32
16,TRN,P009903,P012594,7.05,-7,8,15
16,TRN,P009903,P012595,23.183,2,49,47
16,TRN,P009903,P012597,7.767,1,15,14
16,TRN,P012593,P012594,9.8,-8,13,21
16,TRN,P012593,P012595,10.483,2,25,23
16,TRN,P012593,P012596,5.833,-3,9,12
16,TRN,P012593,P012597,1.467,-3,5,8
16,TRN,P012594,P012595,7.766,1,14,13
16,TRN,P012594,P012596,10.516,0,19,19
16,TRN,P012594,P012597,2.517,0,8,8
16,TRN,P012595,P012596,7.016,-1,10,11
16,TRN,P012595,P012597,8.817,4,18,14
16,TRN,P012596,P012597,2.517,0,8,8
17,CAN,P001607,P003637,4.384,9,13,4
17,CAN,P001607,P005005,13.234,-1,41,42
17,CAN,P001607,P006588,9.434,-4,28,32
17,CAN,P001607,P007560,13.401,-7,32,39
17,CAN,P001607,P007644,9.133,2,27,25
17,CAN,P001607,P008121,7.1,7,22,15
17,CAN,P001607,P009864,7.401,-4,17,21
17,CAN,P001607,P010385,4.0,6,11,5
17,CAN,P001607,P010452,9.217,3,24,21
17,CAN,P001607,P010484,5.3,1,13,12
17,CAN,P003425,P003637,9.183,9,24,15
17,CAN,P003425,P005005,10.833,13,28,15
17,CAN,P003425,P006588,11.217,20,33,13
17,CAN,P003425,P007560,9.883,16,27,11
17,CAN,P003425,P007644,0.65,0,0,0
17,CAN,P003425,P008121,6.467,6,17,11
17,CAN,P003425,P009864,8.883,18,31,13
17,CAN,P003425,P010385,8.65,4,17,13
17,CAN,P003425,P010452,6.083,-1,12,13
17,CAN,P003425,P010484,0.883,3,3,0
17,CAN,P003637,P005005,9.617,11,26,15
17,CAN,P003637,P006588,3.817,9,11,2
17,CAN,P003637,P007560,1.85,3,5,2
17,CAN,P003637,P007644,1.617,0,2,2
17,CAN,P003637,P008121,2.1,4,6,2
17,CAN,P003637,P009864,3.333,12,14,2
17,CAN,P003637,P010385,8.617,6,21,15
17,CAN,P003637,P010452,7.9,6,21,15
17,CAN,P003637,P010484,1.85,3,5,2
17,CAN,P005005,P006588,15.784,14,50,36
17,CAN,P005005,P007560,11.784,4,35,31
17,CAN,P005005,P007644,4.983,4,19,15
17,CAN,P005005,P008121,5.0,5,20,15
17,CAN,P005005,P009864,10.017,5,28,23
17,CAN,P005005,P010385,10.117,8,26,18
17,CAN,P005005,P010452,8.417,-2,22,24
17,CAN,P005005,P010484,1.15,3,5,2
17,CAN,P006588,P007560,14.168,10,42,32
17,CAN,P006588,P007644,3.833,1,14,13
17,CAN,P006588,P008121,11.034,11,37,26
17,CAN,P006588,P009864,14.134,11,40,29
17,CAN,P006588,P010385,3.734,9,11,2
17,CAN,P006588,P010452,0.117,-1,2,3
17,CAN,P007560,P007644,5.95,1,13,12
17,CAN,P007560,P008121,8.801,12,25,13
17,CAN,P007560,P009864,13.184,5,37,32
17,CAN,P007560,P010385,5.2,8,13,5
17,CAN,P007560,P010452,7.4,-4,15,19
17,CAN,P007560,P010484,6.183,4,16,12
17,CAN,P007644,P008121,3.833,1,14,13
17,CAN,P007644,P010452,3.183,-2,6,8
17,CAN,P007644,P010484,5.95,1,13,12
17,CAN,P008121,P009864,6.034,6,17,11
17,CAN,P008121,P010385,4.867,10,14,4
17,CAN,P008121,P010452,3.7,6,8,2
17,CAN,P009864,P010452,1.917,0,5,5
17,CAN,P009864,P010484,0.233,3,3,0
17,CAN,P010385,P010452,10.083,5,23,18
17,CAN,P010452,P010484,3.183,-2,6,8
17,ULM,P004744,P005422,1.2,2,2,0
17,ULM,P004744,P010106,0.233,-3,0,3
17,ULM,P004744,P010582,4.817,0,10,10
17,ULM,P004744,P011457,0.917,1,3,2
17,ULM,P004744,P012603,3.9,-1,7,8
17,ULM,P004744,P012629,3.617,-2,8,10
17,ULM,P004744,P012703,4.584,3,10,7
17,ULM,P005422,P007952,11.633,4,32,28
17,ULM,P005422,P010106,13.2,-4,31,35
17,ULM,P005422,P010582,12.367,1,31,30
17,ULM,P005422,P010726,1.167,-2,2,4
17,ULM,P005422,P011391,13.301,-12,30,42
17,ULM,P005422,P011457,2.667,-5,2,7
17,ULM,P005422,P012603,21.784,0,59,59
17,ULM,P005422,P012629,12.6,-5,31,36
17,ULM,P005422,P012703,14.617,-3,36,39
17,ULM,P007952,P010106,10.4,-13,16,29
17,ULM,P007952,P010582,15.549,-13,31,44
17,ULM,P007952,P010726,2.483,-9,0,9
17,ULM,P007952,P011457,1.883,-5,2,7
17,ULM,P007952,P012603,16.016,-11,32,43
17,ULM,P007952,P012629,4.366,-8,5,13
17,ULM,P007952,P012703,9.266,-9,18,27
17,ULM,P010106,P010582,8.283,-13,13,26
17,ULM,P010106,P010726,3.017,-7,2,9
17,ULM,P010106,P011391,8.467,-5,17,22
17,ULM,P010106,P012603,17.417,-20,30,50
17,ULM,P010106,P012629,11.216,-12,20,32
17,ULM,P010106,P012703,4.167,-7,3,10
17,ULM,P010582,P010726,4.0,-9,3,12
17,ULM,P010582,P011391,2.034,-5,3,8
17,ULM,P010582,P011457,4.717,-7,8,15
17,ULM,P010582,P012603,17.683,-11,36,47
17,ULM,P010582,P012629,6.033,-10,10,20
17,ULM,P010582,P012703,14.117,-5,31,36
17,ULM,P010726,P011391,4.034,0,10,10
17,ULM,P010726,P011457,3.5,-2,8,10
17,ULM,P010726,P012603,3.017,-7,2,9
17,ULM,P010726,P012629,1.35,2,5,3
17,ULM,P010726,P012703,3.5,-2,8,10
17,ULM,P011391,P011457,4.684,-5,8,13
17,ULM,P011391,P012603,10.918,-7,27,34
17,ULM,P011391,P012629,14.484,-9,33,42
17,ULM,P011391,P012703,11.218,-9,24,33
17,ULM,P011457,P012629,4.084,-4,8,12
17,ULM,P011457,P012703,7.484,-9,13,22
17,ULM,P012603,P012629,16.7,-14,35,49
17,ULM,P012603,P012703,15.901,-5,36,41
17,ULM,P012629,P012703,15.418,-14,29,43
18,ARI,P002867,P003240,3.3,-5,4,9
18,ARI,P002867,P004292,8.216,7,14,7
18,ARI,P002867,P012615,10.183,0,16,16
18,ARI,P002867,P012702,5.116,2,10,8
18,ARI,P002867,P012707,7.399,6,14,8
18,ARI,P002867,P012708,5.433,-6,8,14
18,ARI,P002867,P012716,7.833,10,14,4
18,ARI,P002867,P012722,5.184,2,8,6
18,ARI,P003240,P004292,13.867,4,31,27
18,ARI,P003240,P012615,9.1,-6,15,21
18,ARI,P003240,P012702,16.982,-6,36,42
18,ARI,P003240,P012707,6.867,-14,9,23
18,ARI,P003240,P012708,22.883,-12,45,57
18,ARI,P003240,P012716,11.8,-11,18,29
18,ARI,P003240,P012717,8.883,-11,13,24
18,ARI,P003240,P012722,7.118,-7,9,16
18,ARI,P004292,P012615,10.217,1,18,17
18,ARI,P004292,P012702,13.699,14,34,20
18,ARI,P004292,P012707,8.899,2,16,14
18,ARI,P004292,P012708,20.466,3,46,43
18,ARI,P004292,P012716,19.433,2,38,36
18,ARI,P004292,P012717,3.916,4,9,5
18,ARI,P004292,P012722,9.351,-1,18,19
18,ARI,P012615,P012702,4.466,-3,10,13
18,ARI,P012615,P012707,5.583,0,8,8
18,ARI,P012615,P012708,9.783,-5,19,24
18,ARI,P012615,P012716,8.35,-3,9,12
18,ARI,P012615,P012722,8.118,4,13,9
18,ARI,P012702,P012707,11.016,-8,21,29
18,ARI,P012702,P012708,19.415,-5,42,47
18,ARI,P012702,P012716,11.332,7,26,19
18,ARI,P012702,P012717,8.166,-9,13,22
18,ARI,P012707,P012708,9.266,-9,19,28
18,ARI,P012707,P012716,10.933,-1,16,17
18,ARI,P012707,P012717,6.167,-14,9,23
18,ARI,P012707,P012722,3.534,-2,4,6
18,ARI,P012708,P012716,14.049,-6,29,35
18,ARI,P012708,P012717,9.049,-6,18,24
18,ARI,P012708,P012722,7.584,-6,14,20
18,ARI,P012716,P012717,3.983,-6,5,11
18,ARI,P012716,P012722,10.551,-4,17,21
18,ARI,P012717,P012722,2.5,-2,5,7
18,LKB,P002012,P004664,20.468,7,47,40
18,LKB,P002012,P005521,13.084,1,27,26
18,LKB,P002012,P006230,15.018,9,34,25
18,LKB,P002012,P007029,29.335,15,70,55
18,LKB,P002012,P008856,13.018,1,28,27
18,LKB,P002012,P010190,0.05,1,1,0
18,LKB,P002012,P010461,13.417,8,32,24
18,LKB,P002012,P012583,4.167,-7,7,14
18,LKB,P002012,PLXI,21.851,5,46,41
18,LKB,P004664,P005521,9.534,-5,16,21
18,LKB,P004664,P006230,13.934,16,35,19
18,LKB,P004664,P007029,19.684,14,50,36
18,LKB,P004664,P008856,1.534,1,5,4
18,LKB,P004664,P010461,4.067,0,9,9
18,LKB,P004664,P012583,4.984,-10,6,16
18,LKB,P004664,PLXI,14.267,9,32,23
18,LKB,P005521,P006230,5.6,1,7,6
18,LKB,P005521,P006901,1.55,2,4,2
18,LKB,P005521,P007029,12.416,13,32,19
18,LKB,P005521,P008856,9.066,7,19,12
18,LKB,P005521,P010190,0.2,1,1,0
18,LKB,P005521,P010461,7.9,10,20,10
18,LKB,P005521,P012583,8.55,-10,11,21
18,LKB,P005521,PLXI,6.5,-12,3,15
18,LKB,P006230,P006901,0.017,0,0,0
18,LKB,P006230,P007029,14.151,14,35,21
18,LKB,P006230,P008856,4.434,-5,5,10
18,LKB,P006230,P010190,0.017,0,0,0
18,LKB,P006230,P011329,0.017,0,0,0
18,LKB,P006230,P012583,1.517,-2,0,2
18,LKB,P006230,PLXI,14.567,7,32,25
18,LKB,P006901,P007029,0.95,3,3,0
18,LKB,P006901,P008856,1.55,2,4,2
18,LKB,P006901,P010190,0.217,1,1,0
18,LKB,P006901,P010461,0.95,3,3,0
18,LKB,P006901,P011329,0.017,0,0,0
18,LKB,P006901,P012583,0.617,-1,1,2
18,LKB,P006901,PLXI,0.4,-2,0,2
18,LKB,P007029,P008856,15.601,7,35,28
18,LKB,P007029,P010190,1.217,-4,0,4
18,LKB,P007029,P010461,15.45,14,38,24
18,LKB,P007029,P012583,5.233,-5,10,15
18,LKB,P007029,PLXI,20.967,9,47,38
18,LKB,P008856,P010190,1.467,-2,2,4
18,LKB,P008856,P010461,12.717,12,31,19
18,LKB,P008856,P012583,4.833,-3,6,9
18,LKB,P008856,PLXI,13.384,-8,21,29
18,LKB,P010190,P011329,0.017,0,0,0
18,LKB,P010190,P012583,1.484,-2,2,4
18,LKB,P010190,PLXI,1.267,-3,1,4
18,LKB,P010461,P012583,1.95,1,3,2
18,LKB,P010461,PLXI,8.817,0,16,16
18,LKB,P011329,P012583,0.017,0,0,0
18,LKB,P012583,PLXI,5.984,-13,2,15
19,BUD,P002740,P004945,16.867,-5,29,34
19,BUD,P002740,P006561,2.133,-2,2,4
19,BUD,P002740,P009214,5.067,-2,8,10
19,BUD,P002740,P010248,9.067,-3,16,19
19,BUD,P002740,P010432,6.2,0,13,13
19,BUD,P002740,P011935,10.75,-3,19,22
19,BUD,P002740,P012606,16.867,-5,29,34
19,BUD,P002740,P012630,0.517,0,0,0
19,BUD,P004945,P006561,7.951,4,15,11
19,BUD,P004945,P007398,4.634,-5,6,11
19,BUD,P004945,P009214,5.134,-1,11,12
19,BUD,P004945,P010248,10.884,-5,18,23
19,BUD,P004945,P010432,14.934,1,29,28
19,BUD,P004945,P011935,15.55,-9,27,36
19,BUD,P004945,P012605,3.334,-2,4,6
19,BUD,P004945,P012606,24.151,-3,46,49
19,BUD,P004945,P012630,6.501,5,15,10
19,BUD,P006561,P007398,13.417,-2,24,26
19,BUD,P006561,P009214,1.15,-1,3,4
19,BUD,P006561,P010248,6.634,4,13,9
19,BUD,P006561,P010432,9.95,-1,18,19
19,BUD,P006561,P012605,10.217,-6,18,24
19,BUD,P006561,P012606,7.517,8,16,8
19,BUD,P006561,P012630,11.967,4,27,23
19,BUD,P007398,P010248,6.067,2,11,9
19,BUD,P007398,P010432,11.083,-4,22,26
19,BUD,P007398,P011935,3.733,0,9,9
19,BUD,P007398,P012605,12.95,-1,26,27
19,BUD,P007398,P012606,4.2,-1,7,8
19,BUD,P007398,P012630,12.516,3,27,24
19,BUD,P009214,P010248,3.467,0,8,8
19,BUD,P009214,P012606,5.134,-1,11,12
19,BUD,P009214,P012630,0.584,1,3,2
19,BUD,P010248,P011935,5.033,-5,6,11
19,BUD,P010248,P012605,6.067,2,11,9
19,BUD,P010248,P012606,9.067,-3,16,19
19,BUD,P010248,P012630,4.25,4,9,5
19,BUD,P010432,P011935,13.25,1,29,28
19,BUD,P010432,P012605,8.4,-3,17,20
19,BUD,P010432,P012606,14.8,3,30,27
19,BUD,P010432,P012630,14.183,3,30,27
19,BUD,P011935,P012605,4.25,5,10,5
19,BUD,P011935,P012606,14.033,-9,25,34
19,BUD,P011935,P012630,6.533,4,15,11
19,BUD,P012605,P012630,12.65,1,26,25
19,BUD,P012606,P012630,6.367,7,16,9
19,TTK,P004801,P005000,1.417,0,3,3
19,TTK,P004801,P005685,9.95,4,25,21
19,TTK,P004801,P011239,3.883,-6,3,9
19,TTK,P004801,P011834,12.416,-2,25,27
19,TTK,P004801,P011925,4.7,-5,5,10
19,TTK,P004801,P012056,9.133,3,23,20
19,TTK,P004801,P012697,13.833,-2,28,30
19,TTK,P005000,P005685,2.25,2,5,3
19,TTK,P005000,P006693,10.933,5,24,19
19,TTK,P005000,P011239,20.25,1,41,40
19,TTK,P005000,P011834,12.567,7,28,21
19,TTK,P005000,P011925,22.5,3,46,43
19,TTK,P005000,P012056,8.516,-4,15,19
19,TTK,P005000,P012697,11.567,-2,22,24
19,TTK,P005685,P011834,8.533,4,22,18
19,TTK,P005685,P011925,3.15,-1,5,6
19,TTK,P005685,P012056,8.466,9,24,15
19,TTK,P005685,P012697,10.783,6,27,21
19,TTK,P006693,P011239,14.733,6,32,26
19,TTK,P006693,P011834,14.55,6,32,26
19,TTK,P006693,P011925,14.733,6,32,26
19,TTK,P006693,P012056,3.983,1,8,7
19,TTK,P011239,P011834,21.533,2,39,37
19,TTK,P011239,P011925,27.716,0,51,51
19,TTK,P011239,P012056,14.266,-9,22,31
19,TTK,P011239,P012697,14.483,-10,20,30
19,TTK,P011834,P011925,20.933,3,38,35
19,TTK,P011834,P012056,14.216,4,31,27
19,TTK,P011834,P012697,15.516,0,29,29
19,TTK,P011925,P012056,13.599,-3,23,26
19,TTK,P011925,P012697,16.133,-7,24,31
19,TTK,P012056,P012697,18.749,-1,38,39
20,CLU,P004862,P005113,18.534,11,41,30
20,CLU,P004862,P005373,11.3,-3,17,20
20,CLU,P004862,P005714,12.683,4,22,18
20,CLU,P004862,P010569,16.734,4,34,30
20,CLU,P004862,P011797,21.617,5,44,39
20,CLU,P004862,P011801,4.1,2,7,5
20,CLU,P004862,P012620,1.583,0,2,2
20,CLU,P004862,P012621,25.734,6,51,45
20,CLU,P004862,P012698,13.383,3,22,19
20,CLU,P005113,P005714,7.1,4,16,12
20,CLU,P005113,P010569,13.217,4,29,25
20,CLU,P005113,P011797,18.233,10,38,28
20,CLU,P005113,P011801,4.866,1,10,9
20,CLU,P005113,P012621,20.167,12,47,35
20,CLU,P005113,P012698,11.483,6,23,17
20,CLU,P005373,P005714,9.466,1,12,11
20,CLU,P005373,P010569,3.417,-2,5,7
20,CLU,P005373,P011797,7.367,-5,10,15
20,CLU,P005373,P011801,6.183,0,7,7
20,CLU,P005373,P012620,0.8,-2,0,2
20,CLU,P005373,P012621,7.733,-5,10,15
20,CLU,P005373,P012698,7.266,-4,7,11
20,CLU,P005714,P010569,3.216,-4,2,6
20,CLU,P005714,P011797,6.4,6,13,7
20,CLU,P005714,P011801,11.199,-1,15,16
20,CLU,P005714,P012620,4.016,-6,2,8
20,CLU,P005714,P012621,8.816,3,17,14
20,CLU,P005714,P012698,16.232,-3,21,24
20,CLU,P010569,P011797,15.617,-1,29,30
20,CLU,P010569,P011801,3.116,-6,2,8
20,CLU,P010569,P012620,3.216,-4,2,6
20,CLU,P010569,P012621,15.501,4,34,30
20,CLU,P010569,P012698,5.366,-3,7,10
20,CLU,P011797,P011801,3.983,0,4,4
20,CLU,P011797,P012621,21.617,5,44,39
20,CLU,P011797,P012698,7.566,0,10,10
20,CLU,P011801,P012620,2.433,-6,0,6
20,CLU,P011801,P012621,2.166,1,6,5
20,CLU,P011801,P012698,12.682,-3,17,20
20,CLU,P012620,P012698,4.016,-6,2,8
20,CLU,P012621,P012698,9.866,2,19,17
20,WRO,P001694,P003034,9.25,-7,13,20
20,WRO,P001694,P005531,30.168,-7,53,60
20,WRO,P001694,P009896,26.201,-2,46,48
20,WRO,P001694,P011900,17.584,-11,27,38
20,WRO,P001694,P012699,24.017,-3,39,42
20,WRO,P001694,P012735,19.884,10,43,33
20,WRO,P001694,P012736,9.15,-8,10,18
20,WRO,P001694,P012749,5.55,-8,5,13
20,WRO,P003034,P005531,3.967,-5,7,12
20,WRO,P003034,P009896,4.016,4,6,2
20,WRO,P003034,P011900,6.983,-1,11,12
20,WRO,P003034,P012699,10.283,-2,12,14
20,WRO,P003034,P012735,6.166,0,13,13
20,WRO,P003034,P012736,9.616,0,12,12
20,WRO,P003034,P012749,2.783,-1,2,3
20,WRO,P005531,P009896,26.734,0,48,48
20,WRO,P005531,P011900,12.301,-9,21,30
20,WRO,P005531,P012699,20.55,-1,37,38
20,WRO,P005531,P012735,18.601,12,41,29
20,WRO,P005531,P012736,4.4,-4,6,10
20,WRO,P005531,P012749,6.083,-6,7,13
20,WRO,P009896,P011900,12.667,-6,20,26
20,WRO,P009896,P012699,20.233,5,37,32
20,WRO,P009896,P012735,19.084,14,38,24
20,WRO,P009896,P012736,8.099,2,12,10
20,WRO,P009896,P012749,5.966,-1,9,10
20,WRO,P011900,P012699,7.317,-8,7,15
20,WRO,P011900,P012735,4.95,1,11,10
20,WRO,P011900,P012736,9.016,-3,12,15
20,WRO,P011900,P012749,3.65,1,7,6
20,WRO,P012699,P012735,16.45,14,36,22
20,WRO,P012699,P012736,7.516,4,10,6
20,WRO,P012699,P012749,3.766,-5,2,7
20,WRO,P012735,P012736,5.133,-3,6,9
20,WRO,P012736,P012749,1.866,4,4,0
21,LLI,P004479,P004773,5.517,-11,6,17
21,LLI,P004479,P005247,5.517,-11,6,17
21,LLI,P004479,P006600,1.05,-2,0,2
21,LLI,P004479,P009672,1.4,-2,2,4
21,LLI,P004479,P009680,5.517,-11,6,17
21,LLI,P004479,P012020,3.067,-7,4,11
21,LLI,P004773,P005247,9.25,-15,11,26
21,LLI,P004773,P006600,4.783,-6,5,11
21,LLI,P004773,P009649,1.483,4,7,3
21,LLI,P004773,P009672,6.616,-2,14,16
21,LLI,P004773,P009680,6.85,-11,8,19
21,LLI,P004773,P012020,4.55,-3,11,14
21,LLI,P004773,P012586,3.883,0,10,10
21,LLI,P005247,P006600,5.766,-8,5,13
21,LLI,P005247,P009672,5.133,-6,7,13
21,LLI,P005247,P009680,8.166,-10,11,21
21,LLI,P005247,P012020,3.4,-4,7,11
21,LLI,P005247,P012585,1.316,1,3,2
21,LLI,P005247,P012586,3.716,-3,6,9
21,LLI,P006600,P009649,25.634,19,71,52
21,LLI,P006600,P009672,16.85,-5,36,41
21,LLI,P006600,P009680,15.883,16,42,26
21,LLI,P006600,P012585,26.617,17,71,54
21,LLI,P006600,P012586,29.017,13,74,61
21,LLI,P009649,P009672,16.917,6,45,39
21,LLI,P009649,P009680,12.517,20,40,20
21,LLI,P009649,P012020,3.8,7,14,7
21,LLI,P009649,P012585,27.951,22,78,56
21,LLI,P009649,P012586,29.434,26,85,59
21,LLI,P009672,P009680,2.733,-2,4,6
21,LLI,P009672,P012020,3.8,7,14,7
21,LLI,P009672,P012585,15.434,2,38,36
21,LLI,P009672,P012586,19.317,2,48,46
21,LLI,P009680,P012020,3.4,-4,7,11
21,LLI,P009680,P012585,13.833,21,43,22
21,LLI,P009680,P012586,13.833,21,43,22
21,LLI,P012020,P012585,2.65,6,10,4
21,LLI,P012020,P012586,4.133,10,17,7
21,LLI,P012585,P012586,29.267,23,81,58
21,PMT,P001686,P002020,4.95,4,13,9
21,PMT,P001686,P002644,11.399,1,23,22
21,PMT,P001686,P009559,6.267,-6,13,19
21,PMT,P001686,P011066,10.316,-6,21,27
21,PMT,P001686,P011823,5.817,-3,13,16
21,PMT,P001686,P011943,3.85,-9,4,13
21,PMT,P001686,P011944,3.733,2,8,6
21,PMT,P001686,P011946,2.266,-2,2,4
21,PMT,P001686,P011966,6.9,4,15,11
21,PMT,P001686,P012600,13.366,7,32,25
21,PMT,P002020,P002644,5.684,0,14,14
21,PMT,P002020,P011066,1.767,-6,1,7
21,PMT,P002020,P011823,1.117,-4,1,5
21,PMT,P002020,P011943,2.284,-10,2,12
21,PMT,P002020,P011944,1.334,-4,1,5
21,PMT,P002020,P011966,5.034,2,14,12
21,PMT,P002020,P012600,5.034,2,14,12
21,PMT,P002644,P009559,4.2,-16,6,22
21,PMT,P002644,P011066,13.299,-11,29,40
21,PMT,P002644,P011823,9.033,3,20,17
21,PMT,P002644,P011943,11.5,-17,16,33
21,PMT,P002644,P011944,13.433,0,30,30
21,PMT,P002644,P011946,2.266,-2,2,4
21,PMT,P002644,P011966,15.717,-9,31,40
21,PMT,P002644,P012600,13.933,7,37,30
21,PMT,P009559,P011066,17.55,-11,40,51
21,PMT,P009559,P011823,13.767,3,34,31
21,PMT,P009559,P011943,12.017,-3,29,32
21,PMT,P009559,P011944,9.583,-1,23,24
21,PMT,P009559,P011966,2.734,-13,4,17
21,PMT,P009559,P012600,5.75,-5,11,16
21,PMT,P011066,P011823,19.583,0,48,48
21,PMT,P011066,P011943,14.75,-7,32,39
21,PMT,P011066,P011944,18.283,0,45,45
21,PMT,P011066,P011966,3.9,-9,8,17
21,PMT,P011066,P012600,12.816,2,32,30
21,PMT,P011823,P011943,15.284,4,33,29
21,PMT,P011823,P011944,16.717,5,40,35
21,PMT,P011823,P011966,5.717,2,9,7
21,PMT,P011823,P012600,8.633,-2,22,24
21,PMT,P011943,P011944,13.317,4,29,25
21,PMT,P011943,P011946,1.283,-4,0,4
21,PMT,P011943,P011966,9.634,-12,14,26
21,PMT,P011943,P012600,0.817,-6,1,7
21,PMT,P011944,P011966,4.917,-3,9,12
21,PMT,P011944,P012600,8.683,5,23,18
21,PMT,P011946,P011966,2.266,-2,2,4
21,PMT,P011946,P012600,0.983,2,2,0
21,PMT,P011966,P012600,6.517,4,18,14
22,HAM,P001990,P009663,1.683,-5,0,5
22,HAM,P001990,P011187,4.7,-5,6,11
22,HAM,P001990,P012578,1.117,-2,2,4
22,HAM,P001990,P012579,1.117,-2,2,4
22,HAM,P001990,P012580,5.766,-10,6,16
22,HAM,P001990,P012581,5.883,-8,4,12
22,HAM,P001990,P012582,5.266,-8,4,12
22,HAM,P009663,P010070,9.182,-20,11,31
22,HAM,P009663,P011168,8.182,-18,14,32
22,HAM,P009663,P011187,9.816,-13,15,28
22,HAM,P009663,P012578,7.833,-7,16,23
22,HAM,P009663,P012579,9.649,-10,21,31
22,HAM,P009663,P012580,11.365,-25,9,34
22,HAM,P009663,P012581,3.1,-10,1,11
22,HAM,P009663,P012582,6.882,-15,7,22
22,HAM,P009663,P012648,10.632,-5,22,27
22,HAM,P010070,P011168,7.716,-8,17,25
22,HAM,P010070,P011187,6.366,-8,12,20
22,HAM,P010070,P012578,2.3,-4,5,9
22,HAM,P010070,P012579,7.149,-13,14,27
22,HAM,P010070,P012580,5.666,-9,6,15
22,HAM,P010070,P012582,4.566,-8,9,17
22,HAM,P010070,P012648,3.583,-2,6,8
22,HAM,P011168,P011187,15.816,-3,34,37
22,HAM,P011168,P012578,8.249,-17,11,28
22,HAM,P011168,P012579,11.865,-16,23,39
22,HAM,P011168,P012580,16.949,-9,29,38
22,HAM,P011168,P012581,4.183,-1,8,9
22,HAM,P011168,P012582,13.383,5,34,29
22,HAM,P011168,P012648,9.249,-1,22,23
22,HAM,P011187,P012578,7.467,-6,11,17
22,HAM,P011187,P012579,12.233,-2,28,30
22,HAM,P011187,P012580,21.982,-22,32,54
22,HAM,P011187,P012581,9.7,-5,13,18
22,HAM,P011187,P012582,19.999,-2,41,43
22,HAM,P011187,P012648,12.849,-2,28,30
22,HAM,P012578,P012579,10.3,-9,20,29
22,HAM,P012578,P012580,5.816,-14,5,19
22,HAM,P012578,P012581,2.284,-2,1,3
22,HAM,P012578,P012648,3.966,-3,9,12
22,HAM,P012579,P012580,5.416,-10,6,16
22,HAM,P012579,P012581,1.934,-1,1,2
22,HAM,P012579,P012582,5.916,-2,17,19
22,HAM,P012579,P012648,4.149,5,16,11
22,HAM,P012580,P012581,9.449,-9,12,21
22,HAM,P012580,P012582,17.266,-7,27,34
22,HAM,P012580,P012648,12.249,-9,20,29
22,HAM,P012581,P012582,8.999,-4,12,16
22,HAM,P012582,P012648,8.783,1,21,20
22,PRS,P003481,P005793,13.317,0,32,32
22,PRS,P003481,P009556,13.317,0,32,32
22,PRS,P003481,P010801,0.7,2,2,0
22,PRS,P003481,P012608,1.716,6,8,2
22,PRS,P003481,P012609,13.35,0,32,32
22,PRS,P003481,P012610,1.716,6,8,2
22,PRS,P003481,P012611,1.683,6,8,2
22,PRS,P003481,P012613,1.716,6,8,2
22,PRS,P003481,P012640,12.617,-2,30,32
22,PRS,P004512,P012608,16.45,29,46,17
22,PRS,P004512,P012609,1.433,7,10,3
22,PRS,P004512,P012610,16.45,29,46,17
22,PRS,P004512,P012611,15.017,22,36,14
22,PRS,P004512,P012613,16.45,29,46,17
22,PRS,P005793,P009556,15.683,-3,35,38
22,PRS,P005793,P010801,2.133,-1,2,3
22,PRS,P005793,P012608,0.383,2,2,0
22,PRS,P005793,P012609,13.8,0,32,32
22,PRS,P005793,P012610,1.316,2,5,3
22,PRS,P005793,P012612,1.433,-3,0,3
22,PRS,P005793,P012613,1.316,2,5,3
22,PRS,P005793,P012640,14.883,-3,35,38
22,PRS,P009556,P010801,4.766,4,10,6
22,PRS,P009556,P012609,13.8,0,32,32
22,PRS,P009556,P012610,0.933,0,3,3
22,PRS,P009556,P012611,2.633,5,8,3
22,PRS,P009556,P012612,4.066,2,8,6
22,PRS,P009556,P012613,0.933,0,3,3
22,PRS,P009556,P012640,17.133,0,41,41
22,PRS,P010801,P012609,1.183,2,2,0
22,PRS,P010801,P012611,2.633,5,8,3
22,PRS,P010801,P012612,4.066,2,8,6
22,PRS,P010801,P012640,3.583,2,8,6
22,PRS,P012608,P012609,4.599,4,16,12
22,PRS,P012608,P012610,21.682,34,62,28
22,PRS,P012608,P012611,16.7,28,44,16
22,PRS,P012608,P012613,21.682,34,62,28
22,PRS,P012608,P012640,3.516,-1,8,9
22,PRS,P012609,P012610,4.599,4,16,12
22,PRS,P012609,P012612,0.483,0,0,0
22,PRS,P012609,P012613,4.599,4,16,12
22,PRS,P012609,P012640,15.75,-5,36,41
22,PRS,P012610,P012611,16.7,28,44,16
22,PRS,P012610,P012613,22.615,34,65,31
22,PRS,P012610,P012640,4.449,-1,11,12
22,PRS,P012611,P012612,2.633,5,8,3
22,PRS,P012611,P012613,16.7,28,44,16
22,PRS,P012611,P012640,2.633,5,8,3
22,PRS,P012612,P012640,3.583,2,8,6
22,PRS,P012613,P012640,4.449,-1,11,12
23,HTA,P003533,P004267,9.05,5,24,19
23,HTA,P003533,P004846,10.5,-1,27,28
23,HTA,P003533,P006835,8.183,3,23,20
23,HTA,P003533,P007759,6.716,5,20,15
23,HTA,P003533,P010465,5.183,-6,7,13
23,HTA,P003533,P010550,4.033,-4,6,10
23,HTA,P003533,P011991,5.467,-6,9,15
23,HTA,P004267,P004846,7.617,7,24,17
23,HTA,P004267,P006835,10.233,16,36,20
23,HTA,P004267,P007759,5.066,13,24,11
23,HTA,P004267,P010465,5.75,10,16,6
23,HTA,P004267,P010550,7.816,-4,17,21
23,HTA,P004267,P011973,1.5,7,7,0
23,HTA,P004267,P011991,10.3,-6,20,26
23,HTA,P004846,P006835,14.799,15,42,27
23,HTA,P004846,P007759,18.399,14,51,37
23,HTA,P004846,P010465,15.433,5,38,33
23,HTA,P004846,P010550,11.55,3,31,28
23,HTA,P004846,P011973,8.15,3,20,17
23,HTA,P004846,P011991,3.684,-6,7,13
23,HTA,P006835,P007759,17.665,18,51,33
23,HTA,P006835,P010465,16.499,15,41,26
23,HTA,P006835,P010550,7.383,6,22,16
23,HTA,P006835,P011973,7.333,12,18,6
23,HTA,P006835,P011991,9.233,-1,19,20
23,HTA,P007759,P010465,25.766,9,60,51
23,HTA,P007759,P010550,18.15,2,43,41
23,HTA,P007759,P011973,19.0,9,44,35
23,HTA,P007759,P011991,12.166,-2,23,25
23,HTA,P010465,P010550,20.75,8,48,40
23,HTA,P010465,P011973,20.4,11,46,35
23,HTA,P010465,P011991,15.883,4,28,24
23,HTA,P010550,P011973,13.134,-1,28,29
23,HTA,P010550,P011991,15.116,-6,29,35
23,HTA,P011973,P011991,12.083,3,21,18
23,VNC,P000968,P003759,7.484,5,22,17
23,VNC,P000968,P004117,2.2,1,5,4
23,VNC,P000968,P008052,9.001,4,24,20
23,VNC,P000968,P009400,6.867,5,20,15
23,VNC,P000968,P011909,4.334,0,9,9
23,VNC,P000968,P011928,3.717,0,7,7
23,VNC,P000968,P012590,4.534,4,13,9
23,VNC,P000968,P012591,6.667,1,16,15
23,VNC,P003759,P004117,4.916,-1,9,10
23,VNC,P003759,P004381,16.817,-2,37,39
23,VNC,P003759,P008052,7.401,4,24,20
23,VNC,P003759,P009400,6.833,0,15,15
23,VNC,P003759,P011909,15.251,-2,29,31
23,VNC,P003759,P011928,12.1,-4,24,28
23,VNC,P003759,P012590,20.3,-2,45,47
23,VNC,P003759,P012591,17.034,-2,39,41
23,VNC,P004117,P004381,0.933,2,2,0
23,VNC,P004117,P009400,3.616,-3,7,10
23,VNC,P004117,P011909,1.3,2,2,0
23,VNC,P004117,P012590,4.916,-1,9,10
23,VNC,P004117,P012591,1.783,-4,2,6
23,VNC,P004381,P008052,11.367,-15,20,35
23,VNC,P004381,P011909,17.634,-11,29,40
23,VNC,P004381,P011928,21.35,-19,37,56
23,VNC,P004381,P012590,15.633,-9,34,43
23,VNC,P004381,P012591,20.534,-14,41,55
23,VNC,P008052,P009400,5.034,4,15,11
23,VNC,P008052,P011909,10.684,-8,18,26
23,VNC,P008052,P011928,12.967,-15,20,35
23,VNC,P008052,P012590,6.984,-4,19,23
23,VNC,P008052,P012591,18.034,-14,36,50
23,VNC,P009400,P011909,0.95,0,0,0
23,VNC,P009400,P011928,2.767,1,7,6
23,VNC,P009400,P012590,6.9,0,15,15
23,VNC,P009400,P012591,5.433,-3,9,12
23,VNC,P011909,P011928,15.984,-14,23,37
23,VNC,P011909,P012590,8.517,-3,13,16
23,VNC,P011909,P012591,17.018,-8,29,37
23,VNC,P011928,P012590,10.983,-11,21,32
23,VNC,P011928,P012591,20.4,-14,37,51
23,VNC,P012590,P012591,12.833,-10,27,37
24,JOV,P002361,P002507,21.967,-7,40,47
24,JOV,P002361,P005094,17.633,15,42,27
24,JOV,P002361,P006771,12.415,-6,21,27
24,JOV,P002361,P010161,22.101,8,48,40
24,JOV,P002361,P010166,3.483,-3,5,8
24,JOV,P002361,P010458,26.033,17,62,45
24,JOV,P002361,P010709,7.967,-7,12,19
24,JOV,P002361,P012076,11.299,19,32,13
24,JOV,P002361,PJUG,10.166,12,26,14
24,JOV,P002507,P005094,18.133,5,42,37
24,JOV,P002507,P006771,11.533,-12,25,37
24,JOV,P002507,P010161,20.035,-4,42,46
24,JOV,P002507,P010166,3.617,-9,7,16
24,JOV,P002507,P010458,20.517,1,45,44
24,JOV,P002507,P010709,7.967,-7,12,19
24,JOV,P002507,PJUG,8.367,1,23,22
24,JOV,P005094,P006771,9.266,-3,22,25
24,JOV,P005094,P010161,16.667,22,46,24
24,JOV,P005094,P010166,3.617,-9,7,16
24,JOV,P005094,P010458,17.466,27,50,23
24,JOV,P005094,P010709,3.75,-2,5,7
24,JOV,P005094,P012076,6.85,13,22,9
24,JOV,P005094,PJUG,6.55,4,20,16
24,JOV,P006771,P010161,9.383,-9,24,33
24,JOV,P006771,P010166,5.566,-8,14,22
24,JOV,P006771,P010458,18.382,-3,40,43
24,JOV,P006771,P010708,0.383,1,4,3
24,JOV,P006771,P010709,0.383,1,4,3
24,JOV,P006771,P012076,12.232,2,27,25
24,JOV,P006771,PJUG,17.049,1,43,42
24,JOV,P010161,P010166,2.567,-2,8,10
24,JOV,P010161,P010458,22.317,8,55,47
24,JOV,P010161,P010708,0.383,1,4,3
24,JOV,P010161,P010709,8.35,-6,16,22
24,JOV,P010161,P012076,8.416,9,24,15
24,JOV,P010161,PJUG,5.117,-3,13,16
24,JOV,P010166,P010708,0.333,1,4,3
24,JOV,P010166,P010709,0.333,1,4,3
24,JOV,P010166,P012076,2.533,0,5,5
24,JOV,P010166,PJUG,3.883,-3,10,13
24,JOV,P010458,P010709,4.217,-5,7,12
24,JOV,P010458,P012076,14.049,16,39,23
24,JOV,P010458,PJUG,15.283,7,38,31
24,JOV,P010708,P010709,0.383,1,4,3
24,JOV,P010708,PJUG,0.05,0,0,0
24,JOV,P010709,PJUG,0.05,0,0,0
24,JOV,P012076,PJUG,10.949,5,27,22
24,WOL,P002333,P002387,6.133,-8,8,16
24,WOL,P002333,P003212,10.849,-11,19,30
24,WOL,P002333,P004645,9.549,-12,17,29
24,WOL,P002333,P005516,8.499,-13,11,24
24,WOL,P002333,P006154,5.832,2,14,12
24,WOL,P002333,P011150,13.182,-10,25,35
24,WOL,P002333,P012577,5.416,-12,6,18
24,WOL,P002387,P003212,16.917,-2,37,39
24,WOL,P002387,P004645,5.25,1,11,10
24,WOL,P002387,P005516,23.966,13,56,43
24,WOL,P002387,P006154,3.366,-2,4,6
24,WOL,P002387,P011150,20.733,10,51,41
24,WOL,P002387,P012576,23.95,16,60,44
24,WOL,P002387,P012577,20.017,4,45,41
24,WOL,P003212,P004645,13.599,-15,25,40
24,WOL,P003212,P005516,12.333,-2,28,30
24,WOL,P003212,P006154,4.516,2,12,10
24,WOL,P003212,P011150,17.532,-11,41,52
24,WOL,P003212,P012576,15.717,1,36,35
24,WOL,P003212,P012577,16.333,-14,34,48
24,WOL,P004645,P005516,10.016,-10,19,29
24,WOL,P004645,P006154,6.849,2,18,16
24,WOL,P004645,P011150,15.448,-10,37,47
24,WOL,P004645,P012576,10.233,-1,21,22
24,WOL,P004645,P012577,9.716,-19,16,35
24,WOL,P005516,P006154,4.782,-4,6,10
24,WOL,P005516,P011150,21.532,6,55,49
24,WOL,P005516,P012576,21.5,18,54,36
24,WOL,P005516,P012577,18.9,0,43,43
24,WOL,P006154,P011150,5.099,4,14,10
24,WOL,P006154,P012576,2.733,-2,4,6
24,WOL,P006154,P012577,1.083,-2,0,2
24,WOL,P011150,P012576,20.933,8,53,45
24,WOL,P011150,P012577,23.533,-17,48,65
24,WOL,P012576,P012577,23.934,0,52,52
25,BES,P003783,P007914,10.433,-3,23,26
25,BES,P003783,P007917,6.25,-3,8,11
25,BES,P003783,P008945,4.9,2,10,8
25,BES,P003783,P009582,10.75,3,29,26
25,BES,P003783,P011357,4.25,-1,11,12
25,BES,P003783,P011379,8.151,10,21,11
25,BES,P003783,P011936,17.133,1,36,35
25,BES,P003783,P012622,7.834,6,17,11
25,BES,P003783,P012647,6.699,-7,9,16
25,BES,P007914,P007917,4.166,-2,4,6
25,BES,P007914,P008945,9.949,1,12,11
25,BES,P007914,P009582,12.883,-4,27,31
25,BES,P007914,P011357,4.25,-1,11,12
25,BES,P007914,P011379,3.217,3,7,4
25,BES,P007914,P011936,13.532,0,24,24
25,BES,P007914,P012622,10.183,2,15,13
25,BES,P007914,P012647,12.915,-4,17,21
25,BES,P007917,P008945,10.766,11,22,11
25,BES,P007917,P011357,3.183,3,7,4
25,BES,P007917,P011379,3.7,3,10,7
25,BES,P007917,P011936,15.966,6,28,22
25,BES,P007917,P012622,13.9,12,28,16
25,BES,P007917,P012647,10.133,2,13,11
25,BES,P008945,P009582,9.599,-10,12,22
25,BES,P008945,P011357,2.633,3,7,4
25,BES,P008945,P011379,4.867,5,10,5
25,BES,P008945,P011936,20.915,10,36,26
25,BES,P008945,P012622,21.265,7,34,27
25,BES,P008945,P012647,18.298,-1,25,26
25,BES,P009582,P011357,3.7,-1,11,12
25,BES,P009582,P011379,4.417,6,11,5
25,BES,P009582,P011936,11.749,-3,26,29
25,BES,P009582,P012622,7.666,-7,11,18
25,BES,P009582,P012647,9.432,-12,13,25
25,BES,P011357,P011936,4.916,1,13,12
25,BES,P011357,P012622,4.6,4,12,8
25,BES,P011379,P011936,10.434,11,25,14
25,BES,P011379,P012622,6.95,6,16,10
25,BES,P011936,P012622,20.149,13,36,23
25,BES,P011936,P012647,17.798,-3,24,27
25,BES,P012622,P012647,15.449,1,19,18
25,LJU,P003452,P005969,9.549,-7,9,16
25,LJU,P003452,P007066,10.049,-11,7,18
25,LJU,P003452,P008883,5.066,-1,4,5
25,LJU,P003452,P009395,9.183,2,11,9
25,LJU,P003452,P010594,3.933,2,4,2
25,LJU,P003452,P012598,8.049,-9,7,16
25,LJU,P003452,P012700,8.099,4,10,6
25,LJU,P005969,P007066,18.766,-7,23,30
25,LJU,P005969,P008883,14.25,-5,27,32
25,LJU,P005969,P009395,15.45,-7,25,32
25,LJU,P005969,P010594,8.8,1,13,12
25,LJU,P005969,P012598,25.766,-8,41,49
25,LJU,P005969,P012700,21.283,-7,34,41
25,LJU,P007066,P008883,12.566,0,23,23
25,LJU,P007066,P009395,5.75,-4,5,9
25,LJU,P007066,P010594,10.683,3,17,14
25,LJU,P007066,P012598,20.466,-8,30,38
25,LJU,P007066,P012700,16.516,-5,23,28
25,LJU,P008883,P009395,13.217,-2,27,29
25,LJU,P008883,P010594,14.533,5,29,24
25,LJU,P008883,P012598,20.65,0,46,46
25,LJU,P008883,P012700,22.85,-5,44,49
25,LJU,P009395,P010594,9.65,1,19,18
25,LJU,P009395,P012598,17.15,-5,33,38
25,LJU,P009395,P012700,17.8,3,36,33
25,LJU,P010594,P012598,15.2,6,32,26
25,LJU,P010594,P012700,18.533,-2,30,32
25,LJU,P012598,P012700,26.183,-4,51,55
26,BOU,P000498,P004525,7.667,-3,13,16
26,BOU,P000498,P010449,0.283,0,3,3
26,BOU,P000498,P010450,10.733,-9,17,26
26,BOU,P000498,P010718,1.2,-2,3,5
26,BOU,P000498,P011161,11.016,-6,20,26
26,BOU,P000498,P011836,1.483,1,6,5
26,BOU,P000498,P011837,2.566,-5,3,8
26,BOU,P000498,P012628,11.933,-8,20,28
26,BOU,P000498,P012755,1.983,0,7,7
26,BOU,P004525,P010431,5.417,-1,11,12
26,BOU,P004525,P010449,8.001,2,18,16
26,BOU,P004525,P010450,10.084,-10,13,23
26,BOU,P004525,P010718,4.251,-2,8,10
26,BOU,P004525,P011161,9.934,4,22,18
26,BOU,P004525,P011836,3.717,8,12,4
26,BOU,P004525,P012628,13.601,-2,27,29
26,BOU,P010431,P010449,19.983,1,48,47
26,BOU,P010431,P010450,2.95,-4,3,7
26,BOU,P010431,P010718,13.134,2,32,30
26,BOU,P010431,P011161,1.7,5,7,2
26,BOU,P010431,P011836,15.166,4,39,35
26,BOU,P010431,P011837,9.583,4,23,19
26,BOU,P010431,P012628,8.949,-8,22,30
26,BOU,P010431,P012755,3.05,1,7,6
26,BOU,P010449,P010450,5.45,0,11,11
26,BOU,P010449,P010718,14.984,1,38,37
26,BOU,P010449,P011161,9.501,16,28,12
26,BOU,P010449,P011836,19.183,12,52,40
26,BOU,P010449,P011837,15.083,12,40,28
26,BOU,P010449,P012628,16.75,3,43,40
26,BOU,P010449,P012755,3.05,1,7,6
26,BOU,P010450,P010718,1.467,-1,2,3
26,BOU,P010450,P011161,13.233,-5,25,30
26,BOU,P010450,P011837,4.116,1,8,7
26,BOU,P010450,P012628,14.716,-8,26,34
26,BOU,P010450,P012755,1.983,0,7,7
26,BOU,P010718,P011161,1.684,-1,3,4
26,BOU,P010718,P011836,11.0,0,27,27
26,BOU,P010718,P011837,9.75,6,25,19
26,BOU,P010718,P012628,6.134,-7,14,21
26,BOU,P011161,P011836,5.717,16,20,4
26,BOU,P011161,P011837,7.5,3,14,11
26,BOU,P011161,P012628,18.85,7,43,36
26,BOU,P011161,P012755,2.933,1,10,9
26,BOU,P011836,P011837,11.683,7,29,22
26,BOU,P011836,P012628,10.533,3,28,25
26,BOU,P011836,P012755,3.05,1,7,6
26,BOU,P011837,P012628,9.183,0,18,18
26,BOU,P012628,P012755,4.083,0,11,11
26,CLU,P004862,P005113,10.033,-4,19,23
26,CLU,P004862,P005373,14.649,2,29,27
26,CLU,P004862,P010569,15.932,-5,38,43
26,CLU,P004862,P011797,18.449,2,43,41
26,CLU,P004862,P011801,14.615,6,41,35
26,CLU,P004862,P012620,3.833,-2,8,10
26,CLU,P004862,P012621,13.032,-3,23,26
26,CLU,P004862,P012698,11.849,0,27,27
26,CLU,P005113,P005373,3.65,3,7,4
26,CLU,P005113,P010569,14.266,-11,28,39
26,CLU,P005113,P011797,19.849,-8,37,45
26,CLU,P005113,P011801,9.766,-2,22,24
26,CLU,P005113,P012620,0.85,3,3,0
26,CLU,P005113,P012621,13.166,-10,20,30
26,CLU,P005113,P012698,7.816,-3,12,15
26,CLU,P005373,P010569,7.816,-2,17,19
26,CLU,P005373,P011797,10.1,7,22,15
26,CLU,P005373,P011801,13.832,-2,31,33
26,CLU,P005373,P012620,5.583,-1,14,15
26,CLU,P005373,P012621,12.582,6,28,22
26,CLU,P005373,P012698,8.716,-1,20,21
26,CLU,P010569,P011797,23.365,-4,55,59
26,CLU,P010569,P011801,18.231,-2,45,47
26,CLU,P010569,P012620,0.85,3,3,0
26,CLU,P010569,P012621,15.282,-12,29,41
26,CLU,P010569,P012698,10.382,-3,21,24
26,CLU,P011797,P011801,19.582,3,49,46
26,CLU,P011797,P012620,0.9,3,3,0
26,CLU,P011797,P012621,17.699,-4,34,38
26,CLU,P011797,P012698,13.516,1,29,28
26,CLU,P011801,P012620,5.583,-1,14,15
26,CLU,P011801,P012621,13.515,-2,32,34
26,CLU,P011801,P012698,17.532,0,42,42
26,CLU,P012620,P012621,1.7,1,6,5
26,CLU,P012620,P012698,6.433,2,17,15
26,CLU,P012621,P012698,5.016,0,12,12
27,BUD,P002740,P004945,18.033,0,37,37
27,BUD,P002740,P006561,5.883,-3,15,18
27,BUD,P002740,P007398,4.833,7,18,11
27,BUD,P002740,P009214,5.2,-3,12,15
27,BUD,P002740,P010432,16.983,10,40,30
27,BUD,P002740,P011935,17.666,10,43,33
27,BUD,P002740,P012605,4.833,7,18,11
27,BUD,P002740,P012606,18.033,0,37,37
27,BUD,P004945,P006561,2.333,-7,2,9
27,BUD,P004945,P007398,2.15,1,7,6
27,BUD,P004945,P009214,2.333,-7,2,9
27,BUD,P004945,P010432,17.85,8,42,34
27,BUD,P004945,P011935,17.85,8,42,34
27,BUD,P004945,P012606,20.183,1,44,43
27,BUD,P006561,P006566,4.7,-2,8,10
27,BUD,P006561,P007398,11.15,7,38,31
27,BUD,P006561,P009214,13.033,-3,37,40
27,BUD,P006561,P011935,0.683,0,3,3
27,BUD,P006561,P012605,11.383,4,38,34
27,BUD,P006561,P012606,3.55,-6,4,10
27,BUD,P006561,P012630,7.017,2,23,21
27,BUD,P006566,P007398,3.25,0,6,6
27,BUD,P006566,P009214,3.483,-3,6,9
27,BUD,P006566,P012605,3.483,-3,6,9
27,BUD,P006566,P012606,1.217,1,2,1
27,BUD,P006566,P012630,2.667,-1,4,5
27,BUD,P007398,P009214,12.9,12,43,31
27,BUD,P007398,P010432,9.366,9,26,17
27,BUD,P007398,P011935,6.399,3,19,16
27,BUD,P007398,P012605,17.149,14,55,41
27,BUD,P007398,P012606,3.367,2,9,7
27,BUD,P007398,P012630,11.5,9,35,26
27,BUD,P009214,P010432,3.65,6,10,4
27,BUD,P009214,P012605,14.35,10,45,35
27,BUD,P009214,P012606,2.333,-7,2,9
27,BUD,P009214,P012630,9.45,7,31,24
27,BUD,P010432,P011935,21.416,10,51,41
27,BUD,P010432,P012605,7.216,8,19,11
27,BUD,P010432,P012606,17.85,8,42,34
27,BUD,P010432,P012630,5.933,5,14,9
27,BUD,P011935,P012605,4.249,2,12,10
27,BUD,P011935,P012606,17.85,8,42,34
27,BUD,P011935,P012630,2.283,-1,4,5
27,BUD,P012605,P012630,11.733,6,35,29
27,BUD,P012606,P012630,1.217,1,2,1
27,WRO,P001694,P003034,12.484,-1,26,27
27,WRO,P001694,P005531,27.868,-13,59,72
27,WRO,P001694,P009896,15.984,-10,35,45
27,WRO,P001694,P011165,17.601,-4,40,44
27,WRO,P001694,P011900,9.167,-7,12,19
27,WRO,P001694,P012699,15.484,-2,39,41
27,WRO,P001694,P012736,6.684,-1,15,16
27,WRO,P001694,P012749,8.6,-6,18,24
27,WRO,P003034,P005531,12.234,-1,26,27
27,WRO,P003034,P011165,12.467,-1,26,27
27,WRO,P003034,P011900,10.099,-3,20,23
27,WRO,P003034,P011902,6.049,-3,14,17
27,WRO,P003034,P012699,6.833,8,22,14
27,WRO,P003034,P012736,7.9,-12,12,24
27,WRO,P003034,P012749,6.066,-3,14,17
27,WRO,P005531,P009896,15.767,-12,33,45
27,WRO,P005531,P011165,17.218,-4,40,44
27,WRO,P005531,P011900,8.7,-9,10,19
27,WRO,P005531,P011902,0.133,0,0,0
27,WRO,P005531,P012699,14.884,-4,37,41
27,WRO,P005531,P012736,6.467,-3,13,16
27,WRO,P005531,P012749,8.733,-6,18,24
27,WRO,P009896,P011165,11.234,-5,30,35
27,WRO,P009896,P011900,10.6,-7,20,27
27,WRO,P009896,P011902,5.483,0,14,14
27,WRO,P009896,P012699,16.467,-3,40,43
27,WRO,P009896,P012736,3.6,1,10,9
27,WRO,P009896,P012749,6.733,-4,14,18
27,WRO,P011165,P011900,10.85,-6,22,28
27,WRO,P011165,P011902,6.1,-2,16,18
27,WRO,P011165,P012699,17.184,5,50,45
27,WRO,P011165,P012736,2.15,-7,0,7
27,WRO,P011900,P011902,11.532,-3,28,31
27,WRO,P011900,P012699,10.466,6,26,20
27,WRO,P011900,P012736,5.033,-8,9,17
27,WRO,P011900,P012749,6.349,-3,13,16
27,WRO,P011902,P012699,7.816,7,23,16
27,WRO,P011902,P012736,4.816,-10,7,17
27,WRO,P011902,P012749,4.199,-1,10,11
27,WRO,P012699,P012736,1.45,2,4,2
27,WRO,P012699,P012749,2.616,1,7,6
27,WRO,P012736,P012749,7.9,-6,18,24
28,ARI,P002867,P004292,12.466,-6,21,27
28,ARI,P002867,P010387,7.749,-13,6,19
28,ARI,P002867,P012615,11.883,12,25,13
28,ARI,P002867,P012702,8.516,0,12,12
28,ARI,P002867,P012707,11.083,3,16,13
28,ARI,P002867,P012708,11.382,-3,17,20
28,ARI,P002867,P012716,5.033,1,8,7
28,ARI,P002867,P012722,10.416,2,19,17
28,ARI,P004292,P010387,4.816,-8,6,14
28,ARI,P004292,P012615,23.668,3,46,43
28,ARI,P004292,P012702,14.0,-3,29,32
28,ARI,P004292,P012707,10.601,1,16,15
28,ARI,P004292,P012708,16.967,-4,34,38
28,ARI,P004292,P012716,18.351,-4,33,37
28,ARI,P004292,P012722,13.067,1,23,22
28,ARI,P010387,P012702,2.8,-5,3,8
28,ARI,P010387,P012707,4.383,-7,3,10
28,ARI,P010387,P012708,5.466,-9,3,12
28,ARI,P010387,P012716,0.833,-2,0,2
28,ARI,P010387,P012722,4.949,-8,3,11
28,ARI,P012615,P012702,17.116,8,36,28
28,ARI,P012615,P012707,17.734,15,29,14
28,ARI,P012615,P012708,20.317,6,41,35
28,ARI,P012615,P012716,24.568,6,45,39
28,ARI,P012615,P012722,13.718,10,26,16
28,ARI,P012702,P012707,7.583,4,13,9
28,ARI,P012702,P012708,16.999,5,36,31
28,ARI,P012702,P012716,12.65,3,27,24
28,ARI,P012707,P012708,9.533,1,10,9
28,ARI,P012707,P012716,14.434,8,22,14
28,ARI,P012707,P012722,13.117,7,19,12
28,ARI,P012708,P012716,14.401,0,27,27
28,ARI,P012708,P012722,8.067,-8,8,16
28,ARI,P012716,P012722,11.334,4,18,14
28,TTK,P000497,P005000,0.7,3,3,0
28,TTK,P000497,P005685,2.05,5,5,0
28,TTK,P000497,P006693,0.7,3,3,0
28,TTK,P000497,P011239,3.333,0,5,5
28,TTK,P000497,P011834,4.683,2,7,5
28,TTK,P000497,P012056,5.383,5,10,5
28,TTK,P000497,P012697,4.683,2,7,5
28,TTK,P005000,P005685,3.367,-4,2,6
28,TTK,P005000,P006693,22.817,-2,38,40
28,TTK,P005000,P009845,2.6,-4,2,6
28,TTK,P005000,P011239,13.083,6,31,25
28,TTK,P005000,P011834,9.268,-1,11,12
28,TTK,P005000,P011925,23.501,-9,33,42
28,TTK,P005000,P012056,18.983,-1,33,34
28,TTK,P005000,P012697,9.017,-4,7,11
28,TTK,P005685,P006693,0.417,-2,0,2
28,TTK,P005685,P011834,6.434,3,12,9
28,TTK,P005685,P011925,4.934,-2,7,9
28,TTK,P005685,P012056,4.167,7,10,3
28,TTK,P005685,P012697,6.567,5,12,7
28,TTK,P006693,P009845,2.6,-4,2,6
28,TTK,P006693,P011239,15.1,2,33,31
28,TTK,P006693,P011834,8.818,-3,11,14
28,TTK,P006693,P011925,22.501,-11,33,44
28,TTK,P006693,P012056,20.383,-5,35,40
28,TTK,P006693,P012697,6.0,-2,5,7
28,TTK,P009845,P011834,1.067,0,2,2
28,TTK,P009845,P011925,2.6,-4,2,6
28,TTK,P009845,P012056,1.533,-4,0,4
28,TTK,P011239,P011834,11.35,-5,18,23
28,TTK,P011239,P011925,19.5,1,40,39
28,TTK,P011239,P012056,23.633,1,47,46
28,TTK,P011239,P012697,8.533,-1,14,15
28,TTK,P011834,P011925,17.119,-3,26,29
28,TTK,P011834,P012056,16.584,4,30,26
28,TTK,P011834,P012697,18.417,7,31,24
28,TTK,P011925,P012056,26.134,-6,45,51
28,TTK,P011925,P012697,15.651,-2,22,24
28,TTK,P012056,P012697,15.8,3,26,23
29,LKB,P002012,P004664,19.851,-14,35,49
29,LKB,P002012,P005521,13.15,-5,29,34
29,LKB,P002012,P006230,8.717,-2,25,27
29,LKB,P002012,P006901,2.3,0,5,5
29,LKB,P002012,P008856,5.833,1,14,13
29,LKB,P002012,P010190,17.534,-15,24,39
29,LKB,P002012,P010461,13.717,-7,20,27
29,LKB,P002012,P012583,3.25,-4,4,8
29,LKB,P002012,PLXI,18.384,-6,40,46
29,LKB,P004664,P005521,9.284,-11,15,26
29,LKB,P004664,P006230,5.717,-3,16,19
29,LKB,P004664,P006901,0.067,-2,0,2
29,LKB,P004664,P008856,0.317,-1,0,1
29,LKB,P004664,P010190,16.217,-11,24,35
29,LKB,P004664,P010461,11.534,-8,15,23
29,LKB,P004664,P012583,3.583,-4,4,8
29,LKB,P004664,PLXI,15.434,-6,31,37
29,LKB,P005521,P006230,12.716,-8,29,37
29,LKB,P005521,P006901,10.583,-8,17,25
29,LKB,P005521,P008856,18.499,-7,39,46
29,LKB,P005521,P010190,8.017,-9,10,19
29,LKB,P005521,P010461,10.7,-3,20,23
29,LKB,P005521,P011329,1.867,-3,4,7
29,LKB,P005521,P012583,12.399,-9,24,33
29,LKB,P005521,PLXI,12.649,-5,29,34
29,LKB,P006230,P006901,5.183,-7,6,13
29,LKB,P006230,P008856,9.866,-9,18,27
29,LKB,P006230,P010190,2.867,-4,5,9
29,LKB,P006230,P012583,4.316,-3,9,12
29,LKB,P006230,PLXI,12.95,-12,28,40
29,LKB,P006901,P008856,10.516,-6,17,23
29,LKB,P006901,P010190,0.1,0,0,0
29,LKB,P006901,P010461,3.433,2,7,5
29,LKB,P006901,P011329,1.867,-3,4,7
29,LKB,P006901,P012583,4.6,-3,10,13
29,LKB,P006901,PLXI,3.683,-5,2,7
29,LKB,P008856,P010190,4.334,-6,6,12
29,LKB,P008856,P010461,7.983,1,17,16
29,LKB,P008856,P011329,1.867,-3,4,7
29,LKB,P008856,P012583,9.983,-6,23,29
29,LKB,P008856,PLXI,10.066,-8,18,26
29,LKB,P010190,P010461,14.334,-9,21,30
29,LKB,P010190,P012583,6.267,-6,10,16
29,LKB,P010190,PLXI,12.534,-8,20,28
29,LKB,P010461,P012583,4.033,0,10,10
29,LKB,P010461,PLXI,11.066,0,18,18
29,LKB,P011329,P012583,1.867,-3,4,7
29,LKB,P012583,PLXI,3.966,-2,10,12
29,ULM,P005422,P007952,5.667,-3,10,13
29,ULM,P005422,P010582,5.55,-2,9,11
29,ULM,P005422,P010726,7.218,1,14,13
29,ULM,P005422,P011457,5.151,-1,9,10
29,ULM,P005422,P012603,13.15,10,30,20
29,ULM,P005422,P012604,12.634,12,29,17
29,ULM,P005422,P012629,12.851,11,30,19
29,ULM,P005422,P012703,10.983,8,25,17
29,ULM,P007952,P010582,9.867,-4,15,19
29,ULM,P007952,P010726,8.351,-2,14,16
29,ULM,P007952,P011457,11.884,-5,18,23
29,ULM,P007952,P012066,2.283,0,4,4
29,ULM,P007952,P012603,1.083,1,4,3
29,ULM,P007952,P012629,4.35,-3,7,10
29,ULM,P007952,P012703,8.383,0,16,16
29,ULM,P010582,P010726,9.684,-3,18,21
29,ULM,P010582,P011457,12.334,1,25,24
29,ULM,P010582,P012066,4.967,1,16,15
29,ULM,P010582,P012603,5.133,4,17,13
29,ULM,P010582,P012604,7.6,9,27,18
29,ULM,P010582,P012629,3.183,4,9,5
29,ULM,P010582,P012703,11.55,10,32,22
29,ULM,P010726,P011391,1.867,3,7,4
29,ULM,P010726,P011457,10.785,4,24,20
29,ULM,P010726,P012066,1.45,-2,5,7
29,ULM,P010726,P012602,1.867,3,7,4
29,ULM,P010726,P012603,3.617,0,10,10
29,ULM,P010726,P012604,4.184,3,13,10
29,ULM,P010726,P012629,4.718,7,16,9
29,ULM,P010726,P012703,3.867,2,8,6
29,ULM,P011391,P011457,1.867,3,7,4
29,ULM,P011391,P012602,1.867,3,7,4
29,ULM,P011391,P012629,1.867,3,7,4
29,ULM,P011457,P012066,7.2,3,19,16
29,ULM,P011457,P012602,1.867,3,7,4
29,ULM,P011457,P012604,5.817,9,21,12
29,ULM,P011457,P012629,8.817,6,24,18
29,ULM,P011457,P012703,12.55,5,30,25
29,ULM,P012066,P012603,5.683,4,17,13
29,ULM,P012066,P012604,10.6,7,32,25
29,ULM,P012066,P012629,7.916,6,20,14
29,ULM,P012066,P012703,11.433,9,31,22
29,ULM,P012602,P012629,1.867,3,7,4
29,ULM,P012603,P012604,19.35,17,49,32
29,ULM,P012603,P012629,16.9,18,42,24
29,ULM,P012603,P012703,16.816,18,43,25
29,ULM,P012604,P012629,19.5,24,52,28
29,ULM,P012604,P012703,20.983,23,57,34
29,ULM,P012629,P012703,20.899,17,50,33
30,CAN,P001607,P003637,2.833,2,8,6
30,CAN,P001607,P004160,8.816,-7,17,24
30,CAN,P001607,P005005,7.9,-5,17,22
30,CAN,P001607,P006588,8.633,7,17,10
30,CAN,P001607,P007560,6.667,5,14,9
30,CAN,P001607,P007644,4.2,2,9,7
30,CAN,P001607,P008121,10.416,5,22,17
30,CAN,P001607,P009864,5.583,-6,12,18
30,CAN,P001607,P010385,8.533,4,18,14
30,CAN,P001607,P010452,9.683,-7,22,29
30,CAN,P003425,P003637,3.9,-3,5,8
30,CAN,P003425,P004160,12.4,13,27,14
30,CAN,P003425,P005005,8.7,2,14,12
30,CAN,P003425,P006588,16.867,9,38,29
30,CAN,P003425,P007560,5.833,6,18,12
30,CAN,P003425,P007644,6.317,9,16,7
30,CAN,P003425,P008121,12.533,10,32,22
30,CAN,P003425,P009864,9.833,-1,18,19
30,CAN,P003425,P010385,5.533,6,14,8
30,CAN,P003425,P010452,4.816,5,10,5
30,CAN,P003637,P006588,5.183,0,8,8
30,CAN,P003637,P008121,6.733,-1,13,14
30,CAN,P003637,P009864,6.733,-1,13,14
30,CAN,P003637,P010452,1.55,-1,5,6
30,CAN,P004160,P005005,15.983,-1,31,32
30,CAN,P004160,P006588,8.884,5,17,12
30,CAN,P004160,P007560,0.45,2,2,0
30,CAN,P004160,P007644,10.517,11,25,14
30,CAN,P004160,P008121,4.783,5,11,6
30,CAN,P004160,P009864,4.783,-13,4,17
30,CAN,P004160,P010385,5.916,8,15,7
30,CAN,P004160,P010452,12.332,1,27,26
30,CAN,P005005,P006588,4.667,-1,6,7
30,CAN,P005005,P007560,0.617,-2,0,2
30,CAN,P005005,P007644,10.067,9,23,14
30,CAN,P005005,P009864,3.483,-10,4,14
30,CAN,P005005,P010385,3.05,-2,4,6
30,CAN,P005005,P010452,11.933,-2,25,27
30,CAN,P006588,P007560,11.883,13,32,19
30,CAN,P006588,P007644,4.317,1,8,7
30,CAN,P006588,P008121,20.383,15,47,32
30,CAN,P006588,P009864,10.383,4,21,17
30,CAN,P006588,P010385,10.8,11,26,15
30,CAN,P007560,P007644,0.45,2,2,0
30,CAN,P007560,P008121,11.433,11,30,19
30,CAN,P007560,P009864,3.9,7,13,6
30,CAN,P007560,P010385,8.15,2,17,15
30,CAN,P007560,P010452,0.617,-2,0,2
30,CAN,P007644,P010452,6.2,10,17,7
30,CAN,P008121,P009864,11.933,3,26,23
30,CAN,P008121,P010385,11.016,12,28,16
30,CAN,P008121,P010452,2.566,0,7,7
30,CAN,P009864,P010452,5.033,-11,9,20
30,CAN,P010385,P010452,3.266,-1,6,7
30,TRN,P001479,P005059,14.383,6,34,28
30,TRN,P001479,P006382,6.45,5,18,13
30,TRN,P001479,P007828,7.516,1,19,18
30,TRN,P001479,P009903,6.1,7,15,8
30,TRN,P001479,P012593,6.017,8,21,13
30,TRN,P001479,P012594,7.45,0,10,10
30,TRN,P001479,P012595,8.233,-2,12,14
30,TRN,P001479,P012596,10.583,-1,23,24
30,TRN,P005059,P005738,11.067,-16,10,26
30,TRN,P005059,P006382,10.151,-6,17,23
30,TRN,P005059,P007828,7.7,1,17,16
30,TRN,P005059,P009903,14.15,-4,23,27
30,TRN,P005059,P012593,15.084,-4,30,34
30,TRN,P005059,P012594,8.083,-6,9,15
30,TRN,P005059,P012595,12.049,-12,15,27
30,TRN,P005059,P012596,9.133,1,21,20
30,TRN,P005738,P006382,14.835,-10,23,33
30,TRN,P005738,P007828,6.967,-1,12,13
30,TRN,P005738,P009903,16.816,-16,27,43
30,TRN,P005738,P012593,17.717,-15,28,43
30,TRN,P005738,P012594,11.266,-9,19,28
30,TRN,P005738,P012595,10.266,-16,13,29
30,TRN,P005738,P012596,4.334,3,8,5
30,TRN,P006382,P007828,8.917,0,18,18
30,TRN,P006382,P009903,8.334,-6,15,21
30,TRN,P006382,P012593,12.218,-3,26,29
30,TRN,P006382,P012594,9.084,-2,16,18
30,TRN,P006382,P012595,4.367,-6,5,11
30,TRN,P006382,P012596,10.784,8,26,18
30,TRN,P007828,P009903,7.483,3,19,16
30,TRN,P007828,P012593,7.517,3,18,15
30,TRN,P007828,P012594,3.883,-1,6,7
30,TRN,P007828,P012595,2.066,-5,3,8
30,TRN,P007828,P012596,5.883,-1,12,13
30,TRN,P009903,P012593,17.933,-5,37,42
30,TRN,P009903,P012594,10.799,-8,17,25
30,TRN,P009903,P012595,10.049,-7,15,22
30,TRN,P012593,P012594,5.816,-4,12,16
30,TRN,P012593,P012595,9.0,-13,12,25
30,TRN,P012593,P012596,3.634,5,12,7
30,TRN,P012594,P012595,10.566,-5,15,20
30,TRN,P012594,P012596,7.917,-1,12,13
30,TRN,P012595,P012596,7.4,-6,10,16
31,LJU,P002661,P003452,26.35,-13,56,69
31,LJU,P002661,P007066,12.851,2,40,38
31,LJU,P002661,P009395,25.4,-4,53,57
31,LJU,P002661,P010594,10.017,5,26,21
31,LJU,P002661,P010771,2.317,0,8,8
31,LJU,P002661,P011261,7.516,0,14,14
31,LJU,P002661,P012598,13.667,-10,27,37
31,LJU,P002661,P012700,25.818,0,60,60
31,LJU,P003452,P005969,3.267,1,6,5
31,LJU,P003452,P007066,15.434,-6,34,40
31,LJU,P003452,P009395,26.05,-12,46,58
31,LJU,P003452,P010594,9.833,-4,17,21
31,LJU,P003452,P010771,2.334,-2,8,10
31,LJU,P003452,P011261,7.532,-5,11,16
31,LJU,P003452,P012598,20.467,-9,37,46
31,LJU,P003452,P012700,30.201,-10,57,67
31,LJU,P005969,P009395,3.267,1,6,5
31,LJU,P005969,P012598,3.267,1,6,5
31,LJU,P005969,P012700,3.267,1,6,5
31,LJU,P007066,P009395,8.834,2,24,22
31,LJU,P007066,P010594,8.75,5,23,18
31,LJU,P007066,P010771,2.334,-2,8,10
31,LJU,P007066,P011261,5.616,-1,11,12
31,LJU,P007066,P012598,5.367,-4,9,13
31,LJU,P007066,P012700,15.218,0,35,35
31,LJU,P009395,P010594,10.001,3,23,20
31,LJU,P009395,P011261,5.366,-2,7,9
31,LJU,P009395,P012598,15.1,-5,28,33
31,LJU,P009395,P012700,26.918,1,57,56
31,LJU,P010594,P010771,0.017,-2,0,2
31,LJU,P010594,P011261,3.533,6,8,2
31,LJU,P010594,P012598,2.383,0,4,4
31,LJU,P010594,P012700,13.334,3,27,24
31,LJU,P010771,P012700,2.334,-2,8,10
31,LJU,P011261,P012598,3.8,-7,2,9
31,LJU,P011261,P012700,4.433,1,3,2
31,LJU,P012598,P012700,17.817,-2,35,37
31,PMT,P001686,P002644,12.05,2,30,28
31,PMT,P001686,P009559,14.016,0,31,31
31,PMT,P001686,P011066,17.9,2,42,40
31,PMT,P001686,P011823,10.083,1,19,18
31,PMT,P001686,P011943,3.3,3,14,11
31,PMT,P001686,P011944,11.717,-2,21,23
31,PMT,P001686,P011966,3.033,2,7,5
31,PMT,P001686,P012600,9.833,8,32,24
31,PMT,P002020,P002644,3.933,-8,5,13
31,PMT,P002020,P009559,2.233,-2,2,4
31,PMT,P002020,P011943,1.7,-6,3,9
31,PMT,P002020,P011944,2.233,-2,2,4
31,PMT,P002020,P011966,3.933,-8,5,13
31,PMT,P002020,P012600,1.7,-6,3,9
31,PMT,P002644,P009559,19.866,0,41,41
31,PMT,P002644,P011066,24.467,11,59,48
31,PMT,P002644,P011823,5.133,3,9,6
31,PMT,P002644,P011943,13.234,6,40,34
31,PMT,P002644,P011944,13.983,1,24,23
31,PMT,P002644,P011966,6.966,-6,12,18
31,PMT,P002644,P012600,24.3,11,64,53
31,PMT,P009559,P011066,23.483,2,51,49
31,PMT,P009559,P011823,8.483,5,19,14
31,PMT,P009559,P011943,9.883,3,23,20
31,PMT,P009559,P011944,14.566,-4,23,27
31,PMT,P009559,P011966,4.816,0,9,9
31,PMT,P009559,P012600,18.182,4,41,37
31,PMT,P011066,P011823,13.033,8,28,20
31,PMT,P011066,P011943,12.067,9,37,28
31,PMT,P011066,P011944,17.95,3,34,31
31,PMT,P011066,P011966,0.45,0,0,0
31,PMT,P011066,P012600,22.25,17,61,44
31,PMT,P011823,P011943,0.583,0,0,0
31,PMT,P011823,P011944,11.466,3,21,18
31,PMT,P011823,P011966,0.45,0,0,0
31,PMT,P011823,P012600,5.233,12,16,4
31,PMT,P011943,P011944,0.583,0,0,0
31,PMT,P011943,P011966,1.7,-6,3,9
31,PMT,P011943,P012600,14.35,3,40,37
31,PMT,P011944,P011966,2.233,-2,2,4
31,PMT,P011944,P012600,8.333,7,17,10
31,PMT,P011966,P012600,4.283,-4,10,14
32,BES,P003783,P007914,10.634,-7,16,23
32,BES,P003783,P007917,8.117,-7,17,24
32,BES,P003783,P009582,7.417,-4,14,18
32,BES,P003783,P011357,5.2,5,12,7
32,BES,P003783,P011379,1.5,-4,0,4
32,BES,P003783,P011936,9.067,-2,20,22
32,BES,P003783,P012622,9.817,-5,22,27
32,BES,P003783,P012647,7.184,0,15,15
32,BES,P007914,P007917,7.818,-2,18,20
32,BES,P007914,P008945,2.45,3,10,7
32,BES,P007914,P009582,9.484,-8,12,20
32,BES,P007914,P011357,2.917,1,5,4
32,BES,P007914,P011379,2.967,0,8,8
32,BES,P007914,P011936,10.051,-9,13,22
32,BES,P007914,P012622,11.285,-7,21,28
32,BES,P007914,P012647,11.134,-7,17,24
32,BES,P007917,P008945,6.3,-4,17,21
32,BES,P007917,P009582,1.684,-6,4,10
32,BES,P007917,P011357,2.417,3,7,4
32,BES,P007917,P011379,2.967,0,8,8
32,BES,P007917,P011936,11.201,-11,24,35
32,BES,P007917,P012622,13.401,-12,30,42
32,BES,P007917,P012647,9.567,-9,19,28
32,BES,P008945,P009582,14.1,13,36,23
32,BES,P008945,P011357,0.817,3,3,0
32,BES,P008945,P011379,1.467,4,8,4
32,BES,P008945,P011936,18.933,5,45,40
32,BES,P008945,P012622,19.417,10,51,41
32,BES,P008945,P012647,18.116,2,42,40
32,BES,P009582,P011357,5.134,5,12,7
32,BES,P009582,P011936,23.351,3,51,48
32,BES,P009582,P012622,22.385,6,53,47
32,BES,P009582,P012647,19.717,7,42,35
32,BES,P011357,P011936,4.317,7,12,5
32,BES,P011357,P012622,6.334,8,17,9
32,BES,P011379,P012622,2.967,0,8,8
32,BES,P011936,P012622,26.968,0,62,62
32,BES,P011936,P012647,27.584,-1,57,58
32,BES,P012622,P012647,23.834,0,52,52
32,WOL,P002333,P002387,6.916,-11,10,21
32,WOL,P002333,P003212,2.466,0,7,7
32,WOL,P002333,P004645,1.617,-7,0,7
32,WOL,P002333,P005516,5.3,-10,6,16
32,WOL,P002333,P006154,1.866,-2,2,4
32,WOL,P002333,P011150,2.517,-10,2,12
32,WOL,P002333,P012577,4.066,-4,8,12
32,WOL,P002333,PLCT,2.916,0,5,5
32,WOL,P002387,P003212,12.866,-3,24,27
32,WOL,P002387,P004645,18.133,-14,29,43
32,WOL,P002387,P005516,21.149,1,50,49
32,WOL,P002387,P006154,4.632,-2,6,8
32,WOL,P002387,P011150,22.166,-11,45,56
32,WOL,P002387,P012576,11.082,2,21,19
32,WOL,P002387,P012577,24.216,3,59,56
32,WOL,P002387,PLCT,10.232,11,28,17
32,WOL,P003212,P004645,11.1,-1,22,23
32,WOL,P003212,P005516,3.15,5,11,6
32,WOL,P003212,P006154,1.916,0,2,2
32,WOL,P003212,P011150,7.166,-7,10,17
32,WOL,P003212,P012576,3.266,0,5,5
32,WOL,P003212,P012577,12.333,-1,27,28
32,WOL,P003212,PLCT,5.133,-1,8,9
32,WOL,P004645,P005516,16.483,-1,37,38
32,WOL,P004645,P006154,1.266,-1,1,2
32,WOL,P004645,P011150,17.7,-13,31,44
32,WOL,P004645,P012576,10.916,8,28,20
32,WOL,P004645,P012577,19.167,2,44,42
32,WOL,P004645,PLCT,4.75,3,12,9
32,WOL,P005516,P006154,2.716,-2,4,6
32,WOL,P005516,P011150,20.167,3,52,49
32,WOL,P005516,P012576,16.949,11,43,32
32,WOL,P005516,P012577,22.183,17,65,48
32,WOL,P005516,PLCT,5.099,12,20,8
32,WOL,P006154,P011150,0.817,1,3,2
32,WOL,P006154,P012576,1.216,0,0,0
32,WOL,P006154,P012577,1.45,-1,3,4
32,WOL,P006154,PLCT,2.649,-1,3,4
32,WOL,P011150,P012576,15.033,9,38,29
32,WOL,P011150,P012577,21.883,4,56,52
32,WOL,P011150,PLCT,1.883,8,11,3
32,WOL,P012576,P012577,13.183,11,37,26
32,WOL,P012576,PLCT,1.283,-1,0,1
32,WOL,P012577,PLCT,6.983,13,25,12
33,JOV,P002361,P002507,12.217,2,18,16
33,JOV,P002361,P005094,17.517,4,31,27
33,JOV,P002361,P006771,9.184,-2,19,21
33,JOV,P002361,P010161,11.534,0,20,20
33,JOV,P002361,P010166,5.95,-6,5,11
33,JOV,P002361,P010458,7.85,0,12,12
33,JOV,P002361,P010708,1.367,-5,0,5
33,JOV,P002361,P011248,16.333,1,24,23
33,JOV,P002361,P012076,7.434,0,18,18
33,JOV,P002361,PJUG,5.15,-6,9,15
33,JOV,P002507,P005094,13.95,-6,20,26
33,JOV,P002507,P006771,3.683,2,6,4
33,JOV,P002507,P010161,10.399,-9,16,25
33,JOV,P002507,P010166,3.816,0,6,6
33,JOV,P002507,P010458,5.067,1,6,5
33,JOV,P002507,P011248,17.349,-6,26,32
33,JOV,P002507,PJUG,4.583,-8,6,14
33,JOV,P005094,P006771,14.367,4,32,28
33,JOV,P005094,P010161,17.917,-3,30,33
33,JOV,P005094,P010166,0.633,1,1,0
33,JOV,P005094,P010458,6.5,0,8,8
33,JOV,P005094,P010708,0.967,-2,0,2
33,JOV,P005094,P011248,22.884,-10,32,42
33,JOV,P005094,P012076,13.951,2,29,27
33,JOV,P005094,PJUG,15.05,-14,25,39
33,JOV,P006771,P010161,9.984,4,18,14
33,JOV,P006771,P010166,5.417,-6,5,11
33,JOV,P006771,P010458,1.417,0,2,2
33,JOV,P006771,P010708,2.684,-9,0,9
33,JOV,P006771,P011248,8.2,2,16,14
33,JOV,P006771,P012076,13.568,3,31,28
33,JOV,P006771,PJUG,13.768,-10,23,33
33,JOV,P010161,P010166,3.583,-6,2,8
33,JOV,P010161,P010458,4.2,-1,8,9
33,JOV,P010161,P010708,0.75,-2,0,2
33,JOV,P010161,P011248,15.866,-10,25,35
33,JOV,P010161,P012076,10.585,3,20,17
33,JOV,P010161,PJUG,10.05,-12,13,25
33,JOV,P010166,P010458,0.55,0,0,0
33,JOV,P010166,P010708,1.717,-7,0,7
33,JOV,P010166,P011248,3.949,0,6,6
33,JOV,P010166,P012076,0.767,-2,0,2
33,JOV,P010166,PJUG,3.55,-6,3,9
33,JOV,P010458,P011248,7.85,0,12,12
33,JOV,P010458,P012076,2.217,0,6,6
33,JOV,P010458,PJUG,1.417,0,2,2
33,JOV,P010708,P011248,0.967,-2,0,2
33,JOV,P010708,PJUG,2.284,-9,0,9
33,JOV,P011248,P012076,7.334,-1,14,15
33,JOV,P011248,PJUG,9.8,-14,13,27
33,JOV,P012076,PJUG,11.884,-5,22,27
33,VNC,P000968,P003759,18.1,11,41,30
33,VNC,P000968,P004117,8.283,-5,12,17
33,VNC,P000968,P004381,10.633,13,31,18
33,VNC,P000968,P008052,8.0,13,27,14
33,VNC,P000968,P009400,0.9,1,1,0
33,VNC,P000968,P011909,8.483,10,27,17
33,VNC,P000968,P011928,3.667,1,8,7
33,VNC,P000968,P012587,4.033,-3,5,8
33,VNC,P000968,P012588,0.35,2,2,0
33,VNC,P000968,P012590,7.817,0,14,14
33,VNC,P000968,P012591,6.534,1,12,11
33,VNC,P003759,P004117,9.716,-1,14,15
33,VNC,P003759,P004381,23.232,16,52,36
33,VNC,P003759,P008052,8.0,13,27,14
33,VNC,P003759,P009400,0.9,1,1,0
33,VNC,P003759,P011909,17.866,8,41,33
33,VNC,P003759,P011928,13.333,4,23,19
33,VNC,P003759,P012587,6.216,-1,9,10
33,VNC,P003759,P012590,8.45,7,17,10
33,VNC,P003759,P012591,18.383,6,31,25
33,VNC,P004117,P004381,4.066,-4,4,8
33,VNC,P004117,P009400,2.15,-4,1,5
33,VNC,P004117,P011928,2.0,-7,2,9
33,VNC,P004117,P012587,6.216,-1,9,10
33,VNC,P004117,P012590,8.15,-7,12,19
33,VNC,P004117,P012591,6.283,-3,10,13
33,VNC,P004381,P008052,11.084,14,32,18
33,VNC,P004381,P009400,4.134,-2,5,7
33,VNC,P004381,P011909,21.583,9,47,38
33,VNC,P004381,P011928,20.617,3,34,31
33,VNC,P004381,P012587,2.183,2,4,2
33,VNC,P004381,P012588,0.35,2,2,0
33,VNC,P004381,P012590,6.467,3,11,8
33,VNC,P004381,P012591,21.383,12,38,26
33,VNC,P008052,P009400,2.884,3,5,2
33,VNC,P008052,P011909,8.2,11,27,16
33,VNC,P008052,P011928,3.084,1,5,4
33,VNC,P008052,P012590,0.317,0,0,0
33,VNC,P008052,P012591,2.767,1,5,4
33,VNC,P009400,P011928,4.134,-2,5,7
33,VNC,P009400,P012590,2.467,-4,1,5
33,VNC,P009400,P012591,2.567,3,5,2
33,VNC,P011909,P011928,13.583,-4,20,24
33,VNC,P011909,P012590,3.517,3,6,3
33,VNC,P011909,P012591,13.1,-1,20,21
33,VNC,P011928,P012588,0.35,2,2,0
33,VNC,P011928,P012590,8.134,3,15,12
33,VNC,P011928,P012591,20.234,11,38,27
33,VNC,P012587,P012590,3.283,-1,5,6
33,VNC,P012587,P012591,2.933,0,4,4
33,VNC,P012588,P012591,0.35,2,2,0
33,VNC,P012590,P012591,8.534,8,19,11
34,HAM,P001990,P009663,11.716,-1,33,34
34,HAM,P001990,P010070,4.75,-1,11,12
34,HAM,P001990,P011168,1.4,1,2,1
34,HAM,P001990,P011187,1.883,-6,2,8
34,HAM,P001990,P012578,10.283,-4,30,34
34,HAM,P001990,P012579,3.833,3,9,6
34,HAM,P001990,P012580,11.566,-8,26,34
34,HAM,P001990,P012581,13.816,-8,31,39
34,HAM,P001990,P012648,7.133,2,18,16
34,HAM,P001990,P012694,8.416,-2,14,16
34,HAM,P009663,P010070,1.233,-3,4,7
34,HAM,P009663,P011168,16.05,-25,24,49
34,HAM,P009663,P012578,19.799,-26,38,64
34,HAM,P009663,P012579,9.966,-5,18,23
34,HAM,P009663,P012580,23.733,-30,41,71
34,HAM,P009663,P012581,20.083,-21,42,63
34,HAM,P009663,P012648,3.149,-1,9,10
34,HAM,P009663,P012694,9.283,-4,19,23
34,HAM,P009663,P012695,1.316,-4,0,4
34,HAM,P010070,P011168,2.4,-3,4,7
34,HAM,P010070,P012578,6.666,-5,13,18
34,HAM,P010070,P012581,7.633,-4,11,15
34,HAM,P010070,P012648,8.866,-7,15,22
34,HAM,P010070,P012694,2.2,-2,2,4
34,HAM,P010070,P012695,1.716,-3,0,3
34,HAM,P011168,P012578,13.233,-21,17,38
34,HAM,P011168,P012579,8.933,-6,13,19
34,HAM,P011168,P012580,12.917,-26,17,43
34,HAM,P011168,P012581,13.117,-20,24,44
34,HAM,P011168,P012648,4.733,-2,6,8
34,HAM,P011168,P012694,6.617,-6,13,19
34,HAM,P011187,P012580,1.883,-6,2,8
34,HAM,P011187,P012581,1.883,-6,2,8
34,HAM,P011187,P012694,1.883,-6,2,8
34,HAM,P012578,P012579,5.583,-8,4,12
34,HAM,P012578,P012580,16.4,-25,29,54
34,HAM,P012578,P012581,18.666,-17,39,56
34,HAM,P012578,P012648,8.582,-3,18,21
34,HAM,P012578,P012695,1.716,-3,0,3
34,HAM,P012579,P012580,6.833,-6,11,17
34,HAM,P012579,P012581,2.2,1,7,6
34,HAM,P012579,P012648,2.333,1,2,1
34,HAM,P012579,P012694,5.783,4,16,12
34,HAM,P012580,P012581,18.783,-30,32,62
34,HAM,P012580,P012694,9.216,-11,14,25
34,HAM,P012580,P012695,1.133,-2,0,2
34,HAM,P012581,P012648,8.616,-2,16,18
34,HAM,P012581,P012694,10.933,-14,16,30
34,HAM,P012581,P012695,2.666,-3,0,3
34,HAM,P012648,P012694,3.6,-1,4,5
34,HAM,P012648,P012695,1.716,-3,0,3
34,HAM,P012694,P012695,1.133,-2,0,2
34,HTA,P003533,P004267,3.433,-5,4,9
34,HTA,P003533,P004846,10.55,6,30,24
34,HTA,P003533,P006835,8.934,16,33,17
34,HTA,P003533,P007759,9.334,20,37,17
34,HTA,P003533,P010465,6.967,13,22,9
34,HTA,P003533,P010550,5.033,4,13,9
34,HTA,P003533,P011973,1.467,2,4,2
34,HTA,P003533,P011990,7.6,14,29,15
34,HTA,P003533,P011991,2.55,10,12,2
34,HTA,P004267,P004846,8.783,-10,10,20
34,HTA,P004267,P006835,6.05,-7,7,14
34,HTA,P004267,P007759,3.983,1,8,7
34,HTA,P004267,P010465,4.75,-7,4,11
34,HTA,P004267,P010550,8.783,-10,10,20
34,HTA,P004267,P011973,6.733,1,11,10
34,HTA,P004267,P011990,3.433,1,6,5
34,HTA,P004267,P011991,4.05,-6,4,10
34,HTA,P004267,P012592,3.433,1,6,5
34,HTA,P004267,P012706,3.433,1,6,5
34,HTA,P004846,P006835,16.883,14,48,34
34,HTA,P004846,P007759,11.233,14,34,20
34,HTA,P004846,P010465,8.3,4,22,18
34,HTA,P004846,P010550,10.183,-10,12,22
34,HTA,P004846,P011973,8.117,12,26,14
34,HTA,P004846,P011990,6.733,11,24,13
34,HTA,P004846,P011991,6.267,-5,14,19
34,HTA,P004846,P012592,1.483,4,4,0
34,HTA,P006835,P007759,12.25,17,36,19
34,HTA,P006835,P010465,9.5,16,31,15
34,HTA,P006835,P010550,4.983,-6,4,10
34,HTA,P006835,P011973,9.617,10,27,17
34,HTA,P006835,P011990,9.917,16,33,17
34,HTA,P006835,P011991,7.217,-4,17,21
34,HTA,P006835,P012592,2.2,2,4,2
34,HTA,P006835,P012706,0.717,-2,0,2
34,HTA,P007759,P010465,15.167,33,52,19
34,HTA,P007759,P010550,12.55,26,44,18
34,HTA,P007759,P011973,15.067,25,47,22
34,HTA,P007759,P011990,6.367,10,23,13
34,HTA,P007759,P011991,9.117,24,37,13
34,HTA,P007759,P012592,0.4,2,2,0
34,HTA,P010465,P010550,13.45,18,40,22
34,HTA,P010465,P011973,14.117,21,49,28
34,HTA,P010465,P011990,3.4,12,14,2
34,HTA,P010465,P011991,12.417,26,50,24
34,HTA,P010550,P011973,9.467,16,32,16
34,HTA,P010550,P011990,0.183,0,0,0
34,HTA,P010550,P011991,13.3,18,41,23
34,HTA,P011973,P011990,5.833,3,10,7
34,HTA,P011973,P011991,9.867,16,38,22
34,HTA,P011973,P012592,5.633,3,10,7
34,HTA,P011973,P012706,4.15,-1,6,7
34,HTA,P011990,P011991,1.083,1,3,2
34,HTA,P011990,P012592,5.233,1,8,7
34,HTA,P011990,P012706,4.15,-1,6,7
34,HTA,P012592,P012706,4.15,-1,6,7
35,LLI,P004479,P004773,4.167,-3,11,14
35,LLI,P004479,P005247,8.867,-11,13,24
35,LLI,P004479,P006600,1.15,-5,6,11
35,LLI,P004479,P009649,1.15,1,8,7
35,LLI,P004479,P009680,11.367,-10,19,29
35,LLI,P004479,P012585,5.85,-7,10,17
35,LLI,P004479,P012586,7.517,-5,17,22
35,LLI,P004773,P005247,6.616,-1,11,12
35,LLI,P004773,P006600,1.666,-5,9,14
35,LLI,P004773,P009649,0.317,-3,7,10
35,LLI,P004773,P009672,3.399,-5,7,12
35,LLI,P004773,P009680,5.9,-3,9,12
35,LLI,P004773,P012585,0.633,-4,0,4
35,LLI,P004773,P012586,7.566,-8,18,26
35,LLI,P005247,P006600,7.266,-8,13,21
35,LLI,P005247,P009672,4.999,-1,11,12
35,LLI,P005247,P009680,10.1,-8,18,26
35,LLI,P005247,P012585,7.25,-11,13,24
35,LLI,P005247,P012586,10.366,-8,17,25
35,LLI,P006600,P009649,27.499,16,74,58
35,LLI,P006600,P009672,34.248,9,81,72
35,LLI,P006600,P009680,10.016,-2,29,31
35,LLI,P006600,P012585,34.365,5,78,73
35,LLI,P006600,P012586,25.382,6,58,52
35,LLI,P009649,P009672,29.349,11,70,59
35,LLI,P009649,P009680,9.516,-2,26,28
35,LLI,P009649,P012585,30.182,15,71,56
35,LLI,P009649,P012586,23.983,10,56,46
35,LLI,P009672,P009680,8.249,0,25,25
35,LLI,P009672,P012585,32.215,7,74,67
35,LLI,P009672,P012586,27.465,3,56,53
35,LLI,P009680,P012585,13.716,-7,35,42
35,LLI,P009680,P012586,9.6,-8,15,23
35,LLI,P012585,P012586,28.049,2,55,53
35,PRS,P003481,P005793,12.266,-2,23,25
35,PRS,P003481,P009556,9.5,-1,19,20
35,PRS,P003481,P012608,1.833,0,4,4
35,PRS,P003481,P012609,12.266,-2,23,25
35,PRS,P003481,P012613,0.933,-1,0,1
35,PRS,P003481,P012640,12.266,-2,23,25
35,PRS,P004512,P005793,7.566,11,24,13
35,PRS,P004512,P012608,20.516,-3,48,51
35,PRS,P004512,P012609,10.333,4,26,22
35,PRS,P004512,P012610,18.099,2,43,41
35,PRS,P004512,P012611,18.55,-2,31,33
35,PRS,P004512,P012613,18.533,-7,42,49
35,PRS,P004512,P012640,7.067,-1,14,15
35,PRS,P005793,P009556,11.85,-4,22,26
35,PRS,P005793,P012608,2.333,8,21,13
35,PRS,P005793,P012609,18.833,4,43,39
35,PRS,P005793,P012610,2.566,7,15,8
35,PRS,P005793,P012611,1.767,4,9,5
35,PRS,P005793,P012613,4.683,0,14,14
35,PRS,P005793,P012640,17.2,0,37,37
35,PRS,P009556,P012609,11.85,-4,22,26
35,PRS,P009556,P012613,2.35,-3,3,6
35,PRS,P009556,P012640,11.85,-4,22,26
35,PRS,P012608,P012609,12.683,8,44,36
35,PRS,P012608,P012610,25.732,9,64,55
35,PRS,P012608,P012611,11.067,-6,22,28
35,PRS,P012608,P012613,26.633,1,65,64
35,PRS,P012608,P012640,9.467,3,32,29
35,PRS,P012609,P012610,10.849,12,33,21
35,PRS,P012609,P012611,1.767,4,9,5
35,PRS,P012609,P012613,15.033,0,37,37
35,PRS,P012609,P012640,26.85,2,63,61
35,PRS,P012610,P012611,13.95,-6,22,28
35,PRS,P012610,P012613,24.099,5,58,53
35,PRS,P012610,P012640,7.633,7,21,14
35,PRS,P012611,P012613,13.95,-6,22,28
35,PRS,P012611,P012640,1.817,4,9,5
35,PRS,P012613,P012640,13.45,-1,31,32
36,BOU,P000498,P004525,14.734,-15,19,34
36,BOU,P000498,P010431,9.817,10,22,12
36,BOU,P000498,P010450,3.433,-3,2,5
36,BOU,P000498,P010718,7.566,10,20,10
36,BOU,P000498,P011161,9.483,-15,13,28
36,BOU,P000498,P011836,4.999,8,16,8
36,BOU,P000498,P011837,11.633,-1,25,26
36,BOU,P000498,P012619,8.1,-6,10,16
36,BOU,P000498,P012628,9.167,-16,13,29
36,BOU,P004525,P010431,10.467,0,15,15
36,BOU,P004525,P010449,3.2,-4,5,9
36,BOU,P004525,P010450,3.0,-1,2,3
36,BOU,P004525,P010718,8.75,0,12,12
36,BOU,P004525,P011161,14.2,-13,21,34
36,BOU,P004525,P011836,3.2,-4,5,9
36,BOU,P004525,P011837,7.067,-11,9,20
36,BOU,P004525,P012619,12.917,-2,18,20
36,BOU,P004525,P012628,15.201,-18,22,40
36,BOU,P010431,P010449,10.517,0,28,28
36,BOU,P010431,P010450,3.0,-1,2,3
36,BOU,P010431,P010718,14.25,20,47,27
36,BOU,P010431,P011161,1.483,4,4,0
36,BOU,P010431,P011836,14.55,10,44,34
36,BOU,P010431,P011837,13.217,11,39,28
36,BOU,P010431,P012619,5.4,7,10,3
36,BOU,P010431,P012628,4.567,-5,5,10
36,BOU,P010449,P010450,3.5,-1,5,6
36,BOU,P010449,P010718,9.15,0,23,23
36,BOU,P010449,P011836,15.017,-3,33,36
36,BOU,P010449,P011837,9.484,2,25,23
36,BOU,P010449,P012619,2.333,-1,3,4
36,BOU,P010449,P012628,6.867,-5,10,15
36,BOU,P010450,P011836,3.933,-3,5,8
36,BOU,P010450,P011837,1.167,0,2,2
36,BOU,P010450,P012619,5.766,-4,5,9
36,BOU,P010450,P012628,3.933,-3,5,8
36,BOU,P010718,P011161,7.533,-2,8,10
36,BOU,P010718,P011836,13.716,10,39,29
36,BOU,P010718,P011837,12.883,12,39,27
36,BOU,P010718,P012619,7.917,2,12,10
36,BOU,P010718,P012628,4.767,-4,4,8
36,BOU,P011161,P011836,0.533,0,0,0
36,BOU,P011161,P011837,5.733,-8,9,17
36,BOU,P011161,P012619,9.0,-5,12,17
36,BOU,P011161,P012628,10.967,-13,17,30
36,BOU,P011836,P011837,14.05,12,41,29
36,BOU,P011836,P012619,2.766,-3,3,6
36,BOU,P011836,P012628,7.3,-7,10,17
36,BOU,P011837,P012628,9.234,-13,11,24
36,BOU,P012619,P012628,8.533,-8,11,19
36,CAN,P001607,P003425,1.083,-1,4,5
36,CAN,P001607,P003637,4.15,-7,3,10
36,CAN,P001607,P004160,3.566,9,11,2
36,CAN,P001607,P005005,12.583,10,31,21
36,CAN,P001607,P006588,3.766,-7,6,13
36,CAN,P001607,P007560,7.55,2,19,17
36,CAN,P001607,P008121,3.766,-7,6,13
36,CAN,P001607,P009864,9.167,-9,15,24
36,CAN,P001607,P010385,6.549,12,20,8
36,CAN,P001607,P010452,13.216,10,33,23
36,CAN,P003425,P003637,11.45,3,28,25
36,CAN,P003425,P004160,0.533,0,0,0
36,CAN,P003425,P005005,9.3,6,15,9
36,CAN,P003425,P006588,20.866,3,45,42
36,CAN,P003425,P007560,7.083,-1,12,13
36,CAN,P003425,P007644,4.95,2,13,11
36,CAN,P003425,P008121,19.649,5,43,38
36,CAN,P003425,P009864,8.033,5,18,13
36,CAN,P003425,P010385,10.933,-1,18,19
36,CAN,P003425,P010452,4.316,3,8,5
36,CAN,P003637,P005005,7.067,-5,7,12
36,CAN,P003637,P006588,10.1,1,26,25
36,CAN,P003637,P007644,2.817,3,9,6
36,CAN,P003637,P008121,8.533,1,24,23
36,CAN,P003637,P009864,9.983,-5,18,23
36,CAN,P003637,P010385,2.8,-2,4,6
36,CAN,P003637,P010452,5.5,-5,5,10
36,CAN,P004160,P005005,3.416,7,11,4
36,CAN,P004160,P006588,0.866,0,0,0
36,CAN,P004160,P007560,0.183,-2,0,2
36,CAN,P004160,P008121,0.866,0,0,0
36,CAN,P004160,P010385,4.282,7,11,4
36,CAN,P004160,P010452,3.416,7,11,4
36,CAN,P005005,P006588,7.95,4,13,9
36,CAN,P005005,P007560,7.366,5,21,16
36,CAN,P005005,P007644,1.983,-1,4,5
36,CAN,P005005,P008121,4.4,5,7,2
36,CAN,P005005,P009864,11.167,3,20,17
36,CAN,P005005,P010385,8.916,12,22,10
36,CAN,P005005,P010452,14.116,10,33,23
36,CAN,P006588,P007560,7.1,-8,10,18
36,CAN,P006588,P007644,4.95,2,13,11
36,CAN,P006588,P008121,19.999,-2,41,43
36,CAN,P006588,P009864,8.233,-4,16,20
36,CAN,P006588,P010385,9.733,-1,16,17
36,CAN,P006588,P010452,0.633,0,2,2
36,CAN,P007560,P007644,2.133,-1,4,5
36,CAN,P007560,P008121,7.45,-6,10,16
36,CAN,P007560,P009864,5.017,-2,12,14
36,CAN,P007560,P010385,7.666,2,15,13
36,CAN,P007560,P010452,7.716,7,21,14
36,CAN,P007644,P008121,2.967,3,9,6
36,CAN,P008121,P009864,8.233,-4,16,20
36,CAN,P008121,P010385,10.499,0,18,18
36,CAN,P008121,P010452,2.966,1,6,5
36,CAN,P009864,P010452,8.967,0,17,17
36,CAN,P010385,P010452,7.482,11,20,9
37,LKB,P002012,P005521,8.534,-12,12,24
37,LKB,P002012,P006230,9.383,1,19,18
37,LKB,P002012,P007029,25.266,10,67,57
37,LKB,P002012,P008856,27.7,4,69,65
37,LKB,P002012,P010190,2.05,2,2,0
37,LKB,P002012,P010461,11.734,-2,26,28
37,LKB,P002012,P012583,8.633,7,26,19
37,LKB,P002012,PLXI,25.7,14,63,49
37,LKB,P005521,P006230,9.15,4,17,13
37,LKB,P005521,P006901,6.984,0,19,19
37,LKB,P005521,P007029,11.55,-6,28,34
37,LKB,P005521,P008856,7.951,-17,10,27
37,LKB,P005521,P010190,12.25,-3,23,26
37,LKB,P005521,P010461,5.567,-11,6,17
37,LKB,P005521,P012583,7.233,-15,12,27
37,LKB,P005521,PLXI,5.717,-8,5,13
37,LKB,P006230,P006901,4.767,3,13,10
37,LKB,P006230,P007029,9.816,5,30,25
37,LKB,P006230,P008856,8.8,-4,17,21
37,LKB,P006230,P010190,7.6,2,15,13
37,LKB,P006230,P012583,0.783,-3,0,3
37,LKB,P006230,PLXI,9.433,-4,17,21
37,LKB,P006901,P007029,5.117,2,18,16
37,LKB,P006901,P008856,1.517,-5,0,5
37,LKB,P006901,P010190,6.984,0,19,19
37,LKB,P006901,P012583,2.267,-5,6,11
37,LKB,P006901,PLXI,0.5,-3,1,4
37,LKB,P007029,P008856,24.583,6,65,59
37,LKB,P007029,P010190,8.233,4,22,18
37,LKB,P007029,P010461,12.55,2,26,24
37,LKB,P007029,P012583,12.883,1,33,32
37,LKB,P007029,PLXI,21.266,16,59,43
37,LKB,P008856,P010190,1.467,-3,0,3
37,LKB,P008856,P010461,11.734,-2,26,28
37,LKB,P008856,P012583,8.683,5,26,21
37,LKB,P008856,PLXI,24.433,12,63,51
37,LKB,P010190,P010461,2.433,-2,2,4
37,LKB,P010190,P012583,5.433,-8,8,16
37,LKB,P010190,PLXI,2.55,-4,1,5
37,LKB,P010461,P012583,2.433,-2,2,4
37,LKB,P010461,PLXI,10.217,1,24,23
37,LKB,P012583,PLXI,8.116,8,23,15
37,TRN,P001479,P005059,13.383,7,38,31
37,TRN,P001479,P006382,3.667,6,9,3
37,TRN,P001479,P007828,9.749,6,30,24
37,TRN,P001479,P009903,3.349,0,7,7
37,TRN,P001479,P012593,14.783,11,44,33
37,TRN,P001479,P012594,3.499,2,9,7
37,TRN,P001479,P012595,4.716,-5,11,16
37,TRN,P001479,P012596,13.25,9,40,31
37,TRN,P005059,P005738,12.2,-1,25,26
37,TRN,P005059,P006382,3.667,6,9,3
37,TRN,P005059,P007828,9.516,3,26,23
37,TRN,P005059,P009903,9.266,6,19,13
37,TRN,P005059,P012593,19.083,1,50,49
37,TRN,P005059,P012594,5.65,5,13,8
37,TRN,P005059,P012595,13.25,-3,28,31
37,TRN,P005059,P012596,16.317,0,44,44
37,TRN,P005738,P006382,4.75,3,13,10
37,TRN,P005738,P007828,5.7,-5,9,14
37,TRN,P005738,P009903,18.65,-3,36,39
37,TRN,P005738,P012593,9.716,-12,16,28
37,TRN,P005738,P012594,16.567,-2,34,36
37,TRN,P005738,P012595,21.267,-7,41,48
37,TRN,P005738,P012596,4.75,-5,10,15
37,TRN,P006382,P009903,4.75,3,13,10
37,TRN,P006382,P012593,3.667,6,9,3
37,TRN,P006382,P012594,4.75,3,13,10
37,TRN,P006382,P012595,4.75,3,13,10
37,TRN,P006382,P012596,3.667,6,9,3
37,TRN,P007828,P009903,6.766,-4,11,15
37,TRN,P007828,P012593,10.332,7,32,25
37,TRN,P007828,P012594,5.933,-2,13,15
37,TRN,P007828,P012595,5.117,-6,7,13
37,TRN,P007828,P012596,8.683,5,28,23
37,TRN,P009903,P012593,7.366,-5,10,15
37,TRN,P009903,P012594,18.383,-4,37,41
37,TRN,P009903,P012595,19.466,-5,39,44
37,TRN,P012593,P012594,5.433,-2,10,12
37,TRN,P012593,P012595,10.483,-14,19,33
37,TRN,P012593,P012596,17.133,4,50,46
37,TRN,P012594,P012595,18.366,-4,37,41
37,TRN,P012594,P012596,1.683,4,6,2
37,TRN,P012595,P012596,6.517,-7,13,20
38,TTK,P000497,P004801,2.133,1,6,5
38,TTK,P000497,P005685,2.133,1,6,5
38,TTK,P000497,P011834,2.133,1,6,5
38,TTK,P000497,P012697,2.133,1,6,5
38,TTK,P004801,P005000,0.65,0,0,0
38,TTK,P004801,P005685,7.683,3,16,13
38,TTK,P004801,P006693,2.8,-5,3,8
38,TTK,P004801,P011239,3.517,-8,2,10
38,TTK,P004801,P011834,11.034,-5,18,23
38,TTK,P004801,P011925,3.516,3,4,1
38,TTK,P004801,P012056,5.268,-9,8,17
38,TTK,P004801,P012697,8.467,0,15,15
38,TTK,P005000,P005685,1.166,-3,0,3
38,TTK,P005000,P006693,14.633,-4,34,38
38,TTK,P005000,P011239,20.3,13,52,39
38,TTK,P005000,P011834,5.949,-4,15,19
38,TTK,P005000,P011925,22.666,6,54,48
38,TTK,P005000,P012056,17.933,-5,39,44
38,TTK,P005000,P012697,10.699,-7,22,29
38,TTK,P005685,P006693,2.083,-2,3,5
38,TTK,P005685,P011834,12.2,-1,22,23
38,TTK,P005685,P011925,7.616,0,10,10
38,TTK,P005685,P012056,6.501,-3,12,15
38,TTK,P005685,P012697,10.35,1,19,18
38,TTK,P006693,P011239,15.001,-3,32,35
38,TTK,P006693,P011834,6.117,-21,5,26
38,TTK,P006693,P011925,16.6,-3,34,37
38,TTK,P006693,P012056,16.601,-12,35,47
38,TTK,P006693,P012697,1.833,-10,2,12
38,TTK,P011239,P011834,8.217,-4,15,19
38,TTK,P011239,P011925,22.6,6,52,46
38,TTK,P011239,P012056,21.968,-10,41,51
38,TTK,P011239,P012697,10.533,2,22,20
38,TTK,P011834,P011925,14.216,-1,25,26
38,TTK,P011834,P012056,11.768,-24,14,38
38,TTK,P011834,P012697,18.166,-5,36,41
38,TTK,P011925,P012056,23.334,-5,45,50
38,TTK,P011925,P012697,16.516,2,32,30
38,TTK,P012056,P012697,12.967,-16,18,34
38,ULM,P005422,P006997,3.434,2,8,6
38,ULM,P005422,P007952,9.417,-4,19,23
38,ULM,P005422,P010582,12.933,16,36,20
38,ULM,P005422,P010726,4.917,2,13,11
38,ULM,P005422,P011457,2.167,-5,2,7
38,ULM,P005422,P012603,16.832,8,42,34
38,ULM,P005422,P012604,17.182,13,44,31
38,ULM,P005422,P012629,18.432,-3,38,41
38,ULM,P005422,P012703,21.882,7,50,43
38,ULM,P006997,P007952,6.934,0,13,13
38,ULM,P006997,P010582,11.402,-3,17,20
38,ULM,P006997,P010726,8.335,-2,11,13
38,ULM,P006997,P011457,6.651,-4,9,13
38,ULM,P006997,P012603,3.217,-2,4,6
38,ULM,P006997,P012604,1.184,-1,0,1
38,ULM,P006997,P012629,1.384,-1,0,1
38,ULM,P006997,P012703,3.067,-1,6,7
38,ULM,P007952,P010582,9.451,0,18,18
38,ULM,P007952,P010726,5.884,0,11,11
38,ULM,P007952,P011457,7.767,-7,11,18
38,ULM,P007952,P012603,6.367,-2,13,15
38,ULM,P007952,P012629,6.267,-8,10,18
38,ULM,P007952,P012703,9.517,-7,17,24
38,ULM,P010582,P010726,9.818,-2,16,18
38,ULM,P010582,P011457,9.518,-4,14,18
38,ULM,P010582,P012603,10.866,11,31,20
38,ULM,P010582,P012604,11.433,18,35,17
38,ULM,P010582,P012629,7.3,10,20,10
38,ULM,P010582,P012703,14.483,18,41,23
38,ULM,P010726,P011457,3.901,-4,3,7
38,ULM,P010726,P012603,2.9,-2,5,7
38,ULM,P010726,P012604,2.45,0,5,5
38,ULM,P010726,P012629,1.067,0,0,0
38,ULM,P011457,P012603,7.001,0,14,14
38,ULM,P011457,P012604,1.684,2,6,4
38,ULM,P011457,P012629,3.117,-3,7,10
38,ULM,P011457,P012703,8.734,-3,18,21
38,ULM,P012603,P012604,15.566,19,48,29
38,ULM,P012603,P012629,16.0,11,43,32
38,ULM,P012603,P012703,22.383,17,60,43
38,ULM,P012604,P012629,16.5,15,44,29
38,ULM,P012604,P012703,18.733,22,54,32
38,ULM,P012629,P012703,21.933,7,54,47
39,ARI,P002867,P003240,5.801,-6,10,16
39,ARI,P002867,P004292,2.384,4,7,3
39,ARI,P002867,P012615,5.634,0,8,8
39,ARI,P002867,P012616,0.867,0,2,2
39,ARI,P002867,P012702,4.633,-8,6,14
39,ARI,P002867,P012707,7.75,-11,8,19
39,ARI,P002867,P012708,1.1,4,5,1
39,ARI,P002867,P012716,7.817,0,17,17
39,ARI,P002867,P012722,2.551,4,7,3
39,ARI,P002867,P012760,3.267,1,6,5
39,ARI,P003240,P004292,10.468,1,17,16
39,ARI,P003240,P010387,0.767,3,5,2
39,ARI,P003240,P012615,9.202,0,13,13
39,ARI,P003240,P012616,1.084,3,5,2
39,ARI,P003240,P012702,4.35,-5,7,12
39,ARI,P003240,P012707,12.517,-1,19,20
39,ARI,P003240,P012708,16.417,7,25,18
39,ARI,P003240,P012716,15.184,5,28,23
39,ARI,P003240,P012722,7.517,3,13,10
39,ARI,P003240,P012760,9.901,6,18,12
39,ARI,P004292,P010387,0.767,3,5,2
39,ARI,P004292,P012615,17.801,7,36,29
39,ARI,P004292,P012616,1.951,3,7,4
39,ARI,P004292,P012702,5.233,7,16,9
39,ARI,P004292,P012707,4.167,-1,9,10
39,ARI,P004292,P012708,17.95,13,39,26
39,ARI,P004292,P012716,18.001,9,41,32
39,ARI,P004292,P012722,8.284,3,15,12
39,ARI,P004292,P012760,8.934,3,20,17
39,ARI,P010387,P012616,0.767,3,5,2
39,ARI,P010387,P012760,0.767,3,5,2
39,ARI,P012615,P012616,0.317,0,0,0
39,ARI,P012615,P012702,9.15,8,22,14
39,ARI,P012615,P012707,9.984,-3,15,18
39,ARI,P012615,P012708,14.317,12,31,19
39,ARI,P012615,P012716,16.084,11,37,26
39,ARI,P012615,P012722,7.934,3,16,13
39,ARI,P012615,P012760,5.317,-2,6,8
39,ARI,P012616,P012716,1.184,0,2,2
39,ARI,P012616,P012722,0.217,1,1,0
39,ARI,P012616,P012760,1.417,2,6,4
39,ARI,P012702,P012707,7.15,-3,11,14
39,ARI,P012702,P012708,7.75,12,21,9
39,ARI,P012702,P012716,11.266,5,25,20
39,ARI,P012707,P012708,8.45,13,17,4
39,ARI,P012707,P012716,16.733,0,28,28
39,ARI,P012707,P012722,5.233,-2,9,11
39,ARI,P012707,P012760,7.484,4,12,8
39,ARI,P012708,P012716,20.683,23,47,24
39,ARI,P012708,P012722,6.483,1,9,8
39,ARI,P012708,P012760,10.45,11,22,11
39,ARI,P012716,P012722,6.517,3,14,11
39,ARI,P012716,P012760,12.067,8,25,17
39,WRO,P001694,P003034,18.316,0,28,28
39,WRO,P001694,P005531,18.95,-8,32,40
39,WRO,P001694,P009896,12.3,-9,18,27
39,WRO,P001694,P011165,18.733,-5,32,37
39,WRO,P001694,P011900,5.016,-1,5,6
39,WRO,P001694,P011901,9.066,1,12,11
39,WRO,P001694,P012308,2.4,2,4,2
39,WRO,P001694,P012699,18.083,-2,32,34
39,WRO,P001694,P012736,14.199,-6,16,22
39,WRO,P001694,P012749,5.401,-8,5,13
39,WRO,P003034,P005531,12.233,-3,21,24
39,WRO,P003034,P011165,8.45,7,19,12
39,WRO,P003034,P011900,3.283,-3,3,6
39,WRO,P003034,P011901,8.766,-3,11,14
39,WRO,P003034,P011902,0.9,-1,2,3
39,WRO,P003034,P012308,1.183,2,2,0
39,WRO,P003034,P012699,10.733,3,21,18
39,WRO,P003034,P012736,9.516,-3,11,14
39,WRO,P003034,P012749,3.484,-3,2,5
39,WRO,P005531,P009896,11.516,-5,20,25
39,WRO,P005531,P011165,13.95,-5,26,31
39,WRO,P005531,P011900,0.55,-2,0,2
39,WRO,P005531,P011901,8.549,-3,13,16
39,WRO,P005531,P011902,4.799,0,9,9
39,WRO,P005531,P012699,20.166,-1,39,40
39,WRO,P005531,P012736,3.066,-3,4,7
39,WRO,P005531,P012749,1.217,-2,0,2
39,WRO,P009896,P011165,14.216,-16,20,36
39,WRO,P009896,P011900,4.75,-5,8,13
39,WRO,P009896,P011901,5.116,3,11,8
39,WRO,P009896,P011902,8.483,-7,15,22
39,WRO,P009896,P012308,2.301,-3,4,7
39,WRO,P009896,P012699,11.933,-11,18,29
39,WRO,P009896,P012736,8.716,-2,13,15
39,WRO,P009896,P012749,3.801,-9,5,14
39,WRO,P011165,P011900,3.983,-2,6,8
39,WRO,P011165,P011901,0.817,2,4,2
39,WRO,P011165,P011902,3.933,-4,7,11
39,WRO,P011165,P012699,13.916,-7,26,33
39,WRO,P011165,P012736,8.399,0,13,13
39,WRO,P011165,P012749,4.267,-6,3,9
39,WRO,P011900,P011901,2.733,-1,3,4
39,WRO,P011900,P011902,3.017,-7,6,13
39,WRO,P011900,P012308,0.767,-3,2,5
39,WRO,P011900,P012699,0.317,-4,0,4
39,WRO,P011900,P012736,6.949,-1,9,10
39,WRO,P011900,P012749,0.767,-3,2,5
39,WRO,P011901,P011902,4.816,-1,10,11
39,WRO,P011901,P012308,1.583,2,2,0
39,WRO,P011901,P012699,6.933,0,11,11
39,WRO,P011901,P012736,7.149,0,11,11
39,WRO,P011902,P012308,1.084,-3,2,5
39,WRO,P011902,P012699,4.583,-6,7,13
39,WRO,P011902,P012736,4.033,1,8,7
39,WRO,P011902,P012749,1.884,-4,2,6
39,WRO,P012308,P012736,2.717,2,4,2
39,WRO,P012308,P012749,1.901,-3,4,7
39,WRO,P012699,P012736,2.883,-1,2,3
39,WRO,P012699,P012749,1.117,-3,0,3
39,WRO,P012736,P012749,5.301,-7,5,12
40,BUD,P002740,P004945,9.867,-3,19,22
40,BUD,P002740,P006566,3.567,-7,4,11
40,BUD,P002740,P007398,0.35,-2,0,2
40,BUD,P002740,P010432,15.5,-5,28,33
40,BUD,P002740,P011935,12.033,0,24,24
40,BUD,P002740,P012605,2.7,-5,2,7
40,BUD,P002740,P012606,12.85,-1,26,27
40,BUD,P002740,P012630,5.333,-1,9,10
40,BUD,P004945,P006566,5.8,-7,9,16
40,BUD,P004945,P007398,9.716,-4,13,17
40,BUD,P004945,P010432,21.017,-6,37,43
40,BUD,P004945,P011935,20.316,-1,38,39
40,BUD,P004945,P012605,4.667,-4,7,11
40,BUD,P004945,P012606,21.133,-2,40,42
40,BUD,P004945,P012630,2.816,-1,5,6
40,BUD,P006561,P006566,2.383,-3,5,8
40,BUD,P006561,P007398,2.383,-3,5,8
40,BUD,P006561,P012605,2.383,-3,5,8
40,BUD,P006561,P012630,2.383,-3,5,8
40,BUD,P006566,P007398,4.683,-5,7,12
40,BUD,P006566,P010432,5.25,-8,4,12
40,BUD,P006566,P011935,2.9,-2,7,9
40,BUD,P006566,P012605,7.383,-10,9,19
40,BUD,P006566,P012606,3.15,-3,7,10
40,BUD,P006566,P012630,7.016,-7,12,19
40,BUD,P007398,P010432,17.066,-8,29,37
40,BUD,P007398,P011935,16.433,-6,31,37
40,BUD,P007398,P012605,7.183,-4,13,17
40,BUD,P007398,P012606,13.366,-7,23,30
40,BUD,P007398,P012630,11.016,-5,23,28
40,BUD,P010432,P011935,28.933,-2,58,60
40,BUD,P010432,P012605,8.9,-5,13,18
40,BUD,P010432,P012606,27.25,-4,54,58
40,BUD,P010432,P012630,12.816,-2,25,27
40,BUD,P011935,P012605,5.034,2,13,11
40,BUD,P011935,P012606,29.299,-5,57,62
40,BUD,P011935,P012630,14.516,-2,32,34
40,BUD,P012605,P012606,1.967,1,5,4
40,BUD,P012605,P012630,7.183,-4,13,17
40,BUD,P012606,P012630,11.449,-3,24,27
40,CLU,P004862,P005113,13.632,-1,24,25
40,CLU,P004862,P005373,6.233,6,18,12
40,CLU,P004862,P005714,10.816,4,24,20
40,CLU,P004862,P010569,9.049,1,18,17
40,CLU,P004862,P011797,12.482,2,25,23
40,CLU,P004862,P011801,7.766,3,17,14
40,CLU,P004862,P012621,14.766,-1,29,30
40,CLU,P004862,P012698,4.716,6,13,7
40,CLU,P005113,P005714,10.45,5,24,19
40,CLU,P005113,P010569,8.716,2,15,13
40,CLU,P005113,P011797,14.733,7,32,25
40,CLU,P005113,P011801,10.35,8,22,14
40,CLU,P005113,P012621,14.433,8,32,24
40,CLU,P005113,P012698,4.35,-1,7,8
40,CLU,P005373,P005714,4.133,0,8,8
40,CLU,P005373,P010569,10.066,4,25,21
40,CLU,P005373,P011797,5.216,0,10,10
40,CLU,P005373,P011801,10.916,1,25,24
40,CLU,P005373,P012621,10.183,1,23,22
40,CLU,P005373,P012698,10.049,4,23,19
40,CLU,P005714,P010569,6.383,6,17,11
40,CLU,P005714,P011797,14.833,3,32,29
40,CLU,P005714,P011801,10.4,5,25,20
40,CLU,P005714,P012621,18.283,6,41,35
40,CLU,P005714,P012698,9.566,7,25,18
40,CLU,P010569,P011797,5.366,2,10,8
40,CLU,P010569,P011801,23.882,14,56,42
40,CLU,P010569,P012621,19.349,13,48,35
40,CLU,P010569,P012698,17.849,6,39,33
40,CLU,P011797,P011801,8.1,3,17,14
40,CLU,P011797,P012621,14.083,3,30,27
40,CLU,P011797,P012698,5.983,0,12,12
40,CLU,P011801,P012621,21.233,17,55,38
40,CLU,P011801,P012698,18.949,1,39,38
40,CLU,P012621,P012698,12.666,5,30,25
41,PMT,P002020,P002644,3.2,-10,4,14
41,PMT,P002020,P009559,1.5,-4,2,6
41,PMT,P002020,P011066,3.2,-10,4,14
41,PMT,P002020,P011823,0.25,-2,0,2
41,PMT,P002020,P011943,0.25,-2,0,2
41,PMT,P002020,P011944,3.3,-12,4,16
41,PMT,P002020,P012600,2.1,-8,2,10
41,PMT,P002644,P009559,9.433,-2,22,24
41,PMT,P002644,P011066,8.117,-9,19,28
41,PMT,P002644,P011823,3.4,-5,8,13
41,PMT,P002644,P011944,8.333,-14,13,27
41,PMT,P002644,P011947,9.583,1,25,24
41,PMT,P002644,P011966,2.883,-4,7,11
41,PMT,P002644,P012600,13.183,-9,30,39
41,PMT,P009559,P011066,14.233,-1,26,27
41,PMT,P009559,P011823,13.7,-1,23,24
41,PMT,P009559,P011943,10.4,0,18,18
41,PMT,P009559,P011944,17.983,-3,31,34
41,PMT,P009559,P011947,11.6,1,29,28
41,PMT,P009559,P011966,1.2,-3,2,5
41,PMT,P009559,P012600,12.483,1,27,26
41,PMT,P011066,P011823,13.0,-2,21,23
41,PMT,P011066,P011943,8.683,2,14,12
41,PMT,P011066,P011944,16.05,-12,25,37
41,PMT,P011066,P011947,5.7,3,16,13
41,PMT,P011066,P012600,11.017,-7,23,30
41,PMT,P011823,P011943,14.683,-4,25,29
41,PMT,P011823,P011944,25.9,-10,45,55
41,PMT,P011823,P011946,5.383,-2,9,11
41,PMT,P011823,P011947,9.35,-1,22,23
41,PMT,P011823,P011966,8.766,-2,18,20
41,PMT,P011823,P012600,15.1,-7,29,36
41,PMT,P011943,P011944,14.683,-4,25,29
41,PMT,P011943,P011946,1.85,-1,2,3
41,PMT,P011943,P011947,3.933,-4,10,14
41,PMT,P011943,P011966,1.85,-1,2,3
41,PMT,P011943,P012600,2.4,-2,4,6
41,PMT,P011944,P011946,4.95,-2,9,11
41,PMT,P011944,P011947,10.8,0,23,23
41,PMT,P011944,P011966,7.283,-3,13,16
41,PMT,P011944,P012600,18.25,-12,32,44
41,PMT,P011946,P011947,1.916,0,5,5
41,PMT,P011946,P011966,6.866,-2,14,16
41,PMT,P011946,P012600,5.016,-1,12,13
41,PMT,P011946,P012601,1.483,0,5,5
41,PMT,P011947,P011966,5.866,-1,16,17
41,PMT,P011947,P012600,14.833,5,37,32
41,PMT,P011947,P012601,1.483,0,5,5
41,PMT,P011966,P012600,9.599,-4,23,27
41,PMT,P011966,P012601,1.483,0,5,5
41,PMT,P012600,P012601,1.483,0,5,5
41,PRS,P003481,P005793,14.183,0,36,36
41,PRS,P003481,P009556,14.183,0,36,36
41,PRS,P003481,P010801,1.483,0,5,5
41,PRS,P003481,P011887,1.483,0,5,5
41,PRS,P003481,P012609,12.7,0,31,31
41,PRS,P003481,P012640,12.7,0,31,31
41,PRS,P004512,P005793,0.684,2,2,0
41,PRS,P004512,P009556,0.667,2,2,0
41,PRS,P004512,P012608,18.1,14,40,26
41,PRS,P004512,P012609,0.684,2,2,0
41,PRS,P004512,P012610,18.117,14,40,26
41,PRS,P004512,P012611,18.1,14,40,26
41,PRS,P004512,P012613,18.117,14,40,26
41,PRS,P004512,P012640,0.667,2,2,0
41,PRS,P005793,P009556,14.85,2,38,36
41,PRS,P005793,P010801,1.483,0,5,5
41,PRS,P005793,P011887,1.483,0,5,5
41,PRS,P005793,P012609,13.384,2,33,31
41,PRS,P005793,P012610,0.017,0,0,0
41,PRS,P005793,P012613,0.017,0,0,0
41,PRS,P005793,P012640,13.367,2,33,31
41,PRS,P009556,P010801,1.483,0,5,5
41,PRS,P009556,P011887,1.483,0,5,5
41,PRS,P009556,P012609,13.367,2,33,31
41,PRS,P009556,P012640,13.367,2,33,31
41,PRS,P010801,P011887,1.483,0,5,5
41,PRS,P012608,P012609,6.783,-1,16,17
41,PRS,P012608,P012610,25.133,15,58,43
41,PRS,P012608,P012611,18.35,16,42,26
41,PRS,P012608,P012613,25.133,15,58,43
41,PRS,P012608,P012640,7.033,1,18,17
41,PRS,P012609,P012610,6.8,-1,16,17
41,PRS,P012609,P012613,6.8,-1,16,17
41,PRS,P012609,P012640,20.15,1,49,48
41,PRS,P012610,P012611,18.35,16,42,26
41,PRS,P012610,P012613,25.15,15,58,43
41,PRS,P012610,P012640,7.033,1,18,17
41,PRS,P012611,P012613,18.35,16,42,26
41,PRS,P012611,P012640,0.25,2,2,0
41,PRS,P012613,P012640,7.033,1,18,17
42,HTA,P003533,P004267,3.151,-2,6,8
42,HTA,P003533,P004846,5.018,-2,10,12
42,HTA,P003533,P006835,1.367,2,4,2
42,HTA,P003533,P007759,4.634,5,13,8
42,HTA,P003533,P010465,3.817,3,10,7
42,HTA,P003533,P010550,5.601,-1,12,13
42,HTA,P003533,P011991,4.284,-1,9,10
42,HTA,P004267,P004846,3.234,-2,6,8
42,HTA,P004267,P006835,0.117,0,0,0
42,HTA,P004267,P007759,1.517,0,3,3
42,HTA,P004267,P010550,3.117,-2,6,8
42,HTA,P004267,P011973,0.083,0,0,0
42,HTA,P004267,P011991,1.717,-2,3,5
42,HTA,P004846,P006835,13.8,-3,36,39
42,HTA,P004846,P007759,13.967,7,37,30
42,HTA,P004846,P010465,16.183,7,40,33
42,HTA,P004846,P010550,15.334,8,39,31
42,HTA,P004846,P011973,11.665,13,32,19
42,HTA,P004846,P011991,11.867,0,24,24
42,HTA,P006835,P007759,11.867,-5,28,33
42,HTA,P006835,P010465,12.583,-6,31,37
42,HTA,P006835,P010550,6.367,-2,19,21
42,HTA,P006835,P011973,8.599,-2,23,25
42,HTA,P006835,P011991,9.5,0,23,23
42,HTA,P007759,P010465,26.333,6,66,60
42,HTA,P007759,P010550,23.4,14,61,47
42,HTA,P007759,P011973,22.499,2,56,54
42,HTA,P007759,P011991,20.583,3,52,49
42,HTA,P010465,P010550,24.833,10,62,52
42,HTA,P010465,P011973,25.882,11,66,55
42,HTA,P010465,P011991,24.033,1,53,52
42,HTA,P010550,P011973,18.632,15,50,35
42,HTA,P010550,P011991,23.984,-2,55,57
42,HTA,P011973,P011991,20.432,5,45,40
42,LLI,P003850,P004479,6.55,-9,9,18
42,LLI,P003850,P004773,3.65,-4,7,11
42,LLI,P003850,P005247,4.2,-4,7,11
42,LLI,P003850,P008274,2.517,-1,4,5
42,LLI,P003850,P009649,3.85,-5,4,9
42,LLI,P003850,P009680,5.533,-8,7,15
42,LLI,P003850,P012585,2.05,0,2,2
42,LLI,P003850,P012586,3.85,-5,4,9
42,LLI,P004479,P004773,2.683,-6,5,11
42,LLI,P004479,P005247,4.216,-6,7,13
42,LLI,P004479,P006600,9.966,-13,16,29
42,LLI,P004479,P008274,2.517,-1,4,5
42,LLI,P004479,P009649,12.3,-16,18,34
42,LLI,P004479,P009680,5.016,-8,7,15
42,LLI,P004479,P012585,9.983,-11,16,27
42,LLI,P004479,P012586,12.833,-18,18,36
42,LLI,P004773,P005247,7.016,-6,12,18
42,LLI,P004773,P006600,4.449,-3,5,8
42,LLI,P004773,P009649,1.083,-1,0,1
42,LLI,P004773,P009680,6.2,-2,12,14
42,LLI,P004773,P012585,4.316,1,7,6
42,LLI,P004773,P012586,2.999,-7,0,7
42,LLI,P005247,P006600,22.415,13,65,52
42,LLI,P005247,P009649,9.316,12,33,21
42,LLI,P005247,P009680,23.899,9,65,56
42,LLI,P005247,P012585,19.449,12,56,44
42,LLI,P005247,P012586,15.949,6,43,37
42,LLI,P006600,P009649,18.849,0,47,47
42,LLI,P006600,P009680,19.699,13,58,45
42,LLI,P006600,P012585,26.932,0,68,68
42,LLI,P006600,P012586,25.482,-6,57,63
42,LLI,P008274,P009649,2.517,-1,4,5
42,LLI,P008274,P012586,2.517,-1,4,5
42,LLI,P009649,P009680,8.749,4,26,22
42,LLI,P009649,P012585,15.466,-5,36,41
42,LLI,P009649,P012586,18.666,-8,36,44
42,LLI,P009680,P012585,17.266,10,49,39
42,LLI,P009680,P012586,14.566,2,36,34
42,LLI,P012585,P012586,20.466,-7,46,53
43,HAM,P001990,P009663,3.666,-1,9,10
43,HAM,P001990,P012578,1.783,0,5,5
43,HAM,P001990,P012581,3.666,-1,9,10
43,HAM,P001990,P012648,3.666,-1,9,10
43,HAM,P001990,P012694,1.883,-1,4,5
43,HAM,P009663,P010070,1.767,-1,3,4
43,HAM,P009663,P011168,15.884,-13,26,39
43,HAM,P009663,P012578,1.783,0,5,5
43,HAM,P009663,P012579,17.65,-2,33,35
43,HAM,P009663,P012580,16.35,-5,32,37
43,HAM,P009663,P012581,6.316,-4,17,21
43,HAM,P009663,P012582,9.817,-1,20,21
43,HAM,P009663,P012648,6.683,-6,9,15
43,HAM,P009663,P012694,12.783,-8,22,30
43,HAM,P009663,P012695,4.833,5,12,7
43,HAM,P010070,P011168,4.817,-1,10,11
43,HAM,P010070,P012579,1.733,-2,3,5
43,HAM,P010070,P012580,7.767,0,16,16
43,HAM,P010070,P012581,12.617,-11,26,37
43,HAM,P010070,P012582,10.35,-8,23,31
43,HAM,P010070,P012648,2.85,-8,4,12
43,HAM,P010070,P012694,3.017,-3,3,6
43,HAM,P010070,P012695,8.55,-10,16,26
43,HAM,P011168,P012578,1.433,-5,0,5
43,HAM,P011168,P012579,15.167,-13,26,39
43,HAM,P011168,P012580,17.95,-21,32,53
43,HAM,P011168,P012581,9.083,-14,20,34
43,HAM,P011168,P012582,9.367,-5,18,23
43,HAM,P011168,P012648,4.05,-10,0,10
43,HAM,P011168,P012694,11.517,-14,20,34
43,HAM,P012578,P012579,0.4,0,0,0
43,HAM,P012578,P012580,1.433,-5,0,5
43,HAM,P012578,P012581,3.216,-5,5,10
43,HAM,P012578,P012648,2.816,-5,5,10
43,HAM,P012579,P012580,17.283,-8,36,44
43,HAM,P012579,P012581,5.049,-7,12,19
43,HAM,P012579,P012582,10.65,-3,23,26
43,HAM,P012579,P012648,3.017,-5,0,5
43,HAM,P012579,P012694,11.316,-9,19,28
43,HAM,P012579,P012695,7.199,1,16,15
43,HAM,P012580,P012581,12.333,-18,24,42
43,HAM,P012580,P012582,15.367,1,36,35
43,HAM,P012580,P012648,1.033,-5,0,5
43,HAM,P012580,P012694,10.583,-14,18,32
43,HAM,P012580,P012695,9.433,3,22,19
43,HAM,P012581,P012582,10.35,-8,23,31
43,HAM,P012581,P012648,7.549,-14,13,27
43,HAM,P012581,P012694,8.366,-14,18,32
43,HAM,P012581,P012695,9.183,-12,17,29
43,HAM,P012582,P012648,3.967,-8,4,12
43,HAM,P012582,P012695,10.8,-4,25,29
43,HAM,P012648,P012694,3.783,-6,4,10
43,HAM,P012648,P012695,2.85,-8,4,12
43,HAM,P012694,P012695,3.216,-3,4,7
43,JOV,P002361,P005094,6.9,6,15,9
43,JOV,P002361,P006771,12.7,1,27,26
43,JOV,P002361,P010161,13.95,2,37,35
43,JOV,P002361,P010166,9.4,5,30,25
43,JOV,P002361,P010708,9.533,2,17,15
43,JOV,P002361,P010709,4.367,5,15,10
43,JOV,P002361,P011248,16.233,7,44,37
43,JOV,P002361,PJUG,2.717,0,3,3
43,JOV,P005094,P006771,6.9,11,16,5
43,JOV,P005094,P009572,13.099,13,37,24
43,JOV,P005094,P010161,6.7,3,22,19
43,JOV,P005094,P010166,6.683,4,21,17
43,JOV,P005094,P010708,13.382,15,31,16
43,JOV,P005094,P010709,4.35,5,10,5
43,JOV,P005094,P011248,8.299,6,19,13
43,JOV,P005094,PJUG,13.683,13,37,24
43,JOV,P006771,P009572,5.083,11,13,2
43,JOV,P006771,P010161,13.4,7,34,27
43,JOV,P006771,P010166,8.1,8,27,19
43,JOV,P006771,P010708,12.166,10,23,13
43,JOV,P006771,P010709,2.5,6,10,4
43,JOV,P006771,P011248,9.983,1,24,23
43,JOV,P006771,P012349,2.5,6,10,4
43,JOV,P006771,PJUG,7.8,11,16,5
43,JOV,P009572,P010161,8.866,4,26,22
43,JOV,P009572,P010166,8.932,7,30,23
43,JOV,P009572,P010708,10.332,14,24,10
43,JOV,P009572,P010709,4.733,0,7,7
43,JOV,P009572,P011248,6.732,8,19,11
43,JOV,P009572,P012349,2.683,0,4,4
43,JOV,P009572,PJUG,13.732,19,44,25
43,JOV,P010161,P010166,17.35,12,58,46
43,JOV,P010161,P010708,7.949,0,15,15
43,JOV,P010161,P010709,6.5,4,20,16
43,JOV,P010161,P011248,15.166,6,44,38
43,JOV,P010161,P012349,4.433,4,12,8
43,JOV,P010161,PJUG,6.95,6,24,18
43,JOV,P010166,P010708,0.716,2,3,1
43,JOV,P010166,P010709,8.916,6,27,21
43,JOV,P010166,P011248,12.382,12,44,32
43,JOV,P010166,P012349,4.616,6,14,8
43,JOV,P010166,PJUG,6.233,10,26,16
43,JOV,P010708,P010709,2.684,5,5,0
43,JOV,P010708,P011248,11.299,5,22,17
43,JOV,P010708,P012349,0.567,0,0,0
43,JOV,P010708,PJUG,10.832,11,24,13
43,JOV,P010709,P011248,7.167,7,20,13
43,JOV,P010709,P012349,5.183,6,14,8
43,JOV,P011248,P012349,0.75,2,2,0
43,JOV,P011248,PJUG,3.849,6,14,8
44,BES,P003783,P007914,7.8,7,20,13
44,BES,P003783,P007917,1.383,-1,2,3
44,BES,P003783,P008945,7.133,-1,11,12
44,BES,P003783,P009582,11.166,7,27,20
44,BES,P003783,P011357,3.083,3,10,7
44,BES,P003783,P011379,4.2,4,8,4
44,BES,P003783,P011936,14.0,5,27,22
44,BES,P003783,P012622,7.916,-5,12,17
44,BES,P003783,P012647,9.183,-3,15,18
44,BES,P007914,P008945,9.366,-2,16,18
44,BES,P007914,P009582,14.766,12,34,22
44,BES,P007914,P011357,4.933,6,16,10
44,BES,P007914,P011379,4.183,3,7,4
44,BES,P007914,P011936,9.35,1,20,19
44,BES,P007914,P012622,10.216,-3,18,21
44,BES,P007914,P012647,8.05,-4,13,17
44,BES,P007917,P008945,8.45,8,17,9
44,BES,P007917,P011936,8.967,9,19,10
44,BES,P007917,P012622,9.4,8,19,11
44,BES,P007917,P012647,9.4,8,19,11
44,BES,P008945,P009582,15.899,2,29,27
44,BES,P008945,P011357,1.85,3,6,3
44,BES,P008945,P011379,4.283,0,8,8
44,BES,P008945,P011936,22.084,-4,34,38
44,BES,P008945,P012622,29.066,0,49,49
44,BES,P008945,P012647,24.533,-2,38,40
44,BES,P009582,P011357,4.933,6,16,10
44,BES,P009582,P011379,6.883,3,13,10
44,BES,P009582,P011936,15.283,2,29,27
44,BES,P009582,P012622,15.732,-2,28,30
44,BES,P009582,P012647,12.466,-2,20,22
44,BES,P011357,P011936,2.233,4,8,4
44,BES,P011357,P012622,2.7,2,8,6
44,BES,P011379,P011936,5.3,3,11,8
44,BES,P011379,P012622,2.683,-1,5,6
44,BES,P011936,P012622,22.017,-7,33,40
44,BES,P011936,P012647,23.034,-5,35,40
44,BES,P012622,P012647,26.066,-4,40,44
44,VNC,P000968,P003759,4.333,0,13,13
44,VNC,P000968,P004117,1.983,0,6,6
44,VNC,P000968,P004381,8.533,10,22,12
44,VNC,P000968,P008052,15.85,-5,27,32
44,VNC,P000968,P009400,0.85,1,3,2
44,VNC,P000968,P011928,13.5,-5,20,25
44,VNC,P000968,P012587,3.25,-8,2,10
44,VNC,P000968,P012590,9.3,-15,11,26
44,VNC,P000968,P012591,13.733,2,28,26
44,VNC,P003759,P004117,7.25,4,16,12
44,VNC,P003759,P004381,23.0,-4,36,40
44,VNC,P003759,P008052,10.817,-2,18,20
44,VNC,P003759,P009400,14.633,-6,23,29
44,VNC,P003759,P011928,6.916,-6,9,15
44,VNC,P003759,P012587,5.084,-3,6,9
44,VNC,P003759,P012590,9.866,4,22,18
44,VNC,P003759,P012591,18.033,-3,29,32
44,VNC,P004117,P004381,8.717,8,20,12
44,VNC,P004117,P009400,1.067,1,4,3
44,VNC,P004117,P011928,2.117,2,4,2
44,VNC,P004117,P012587,3.384,1,6,5
44,VNC,P004117,P012590,4.65,3,8,5
44,VNC,P004117,P012591,8.3,5,16,11
44,VNC,P004381,P008052,15.067,7,28,21
44,VNC,P004381,P009400,13.783,-7,20,27
44,VNC,P004381,P011928,14.616,7,30,23
44,VNC,P004381,P012587,6.034,-2,9,11
44,VNC,P004381,P012590,9.4,7,20,13
44,VNC,P004381,P012591,23.65,10,43,33
44,VNC,P008052,P009400,6.65,-1,10,11
44,VNC,P008052,P011928,12.9,-4,21,25
44,VNC,P008052,P012587,5.9,-11,5,16
44,VNC,P008052,P012590,10.717,-12,16,28
44,VNC,P008052,P012591,16.967,4,31,27
44,VNC,P009400,P011928,6.916,-6,9,15
44,VNC,P009400,P012587,2.767,-3,4,7
44,VNC,P009400,P012590,4.183,2,10,8
44,VNC,P009400,P012591,7.683,-5,9,14
44,VNC,P011928,P012587,4.2,-7,5,12
44,VNC,P011928,P012590,12.167,-11,16,27
44,VNC,P011928,P012591,14.4,-2,22,24
44,VNC,P012587,P012590,4.2,-7,5,12
44,VNC,P012587,P012591,2.317,0,2,2
44,VNC,P012590,P012591,10.317,-3,16,19
45,LJU,P001235,P002661,9.966,4,25,21
45,LJU,P001235,P003452,10.333,-1,21,22
45,LJU,P001235,P007066,7.9,5,20,15
45,LJU,P001235,P009395,12.216,2,25,23
45,LJU,P001235,P010594,0.6,-4,0,4
45,LJU,P001235,P011261,5.4,2,11,9
45,LJU,P001235,P012598,10.534,10,24,14
45,LJU,P001235,P012700,18.983,6,42,36
45,LJU,P002661,P003452,18.616,-16,33,49
45,LJU,P002661,P007066,13.8,-7,28,35
45,LJU,P002661,P009395,19.966,-6,36,42
45,LJU,P002661,P010594,2.35,-6,2,8
45,LJU,P002661,P011261,11.534,-2,20,22
45,LJU,P002661,P012598,21.051,-2,43,45
45,LJU,P002661,P012700,26.649,-5,57,62
45,LJU,P003452,P007066,10.75,-11,17,28
45,LJU,P003452,P009395,18.533,-7,33,40
45,LJU,P003452,P010594,2.95,-10,2,12
45,LJU,P003452,P011261,2.417,-3,2,5
45,LJU,P003452,P012598,23.634,1,46,45
45,LJU,P003452,P012700,23.299,-9,46,55
45,LJU,P007066,P009395,2.783,-3,3,6
45,LJU,P007066,P010594,2.95,-10,2,12
45,LJU,P007066,P011261,4.167,-4,7,11
45,LJU,P007066,P012598,13.168,4,27,23
45,LJU,P007066,P012700,15.35,-2,32,34
45,LJU,P009395,P010594,0.95,-2,0,2
45,LJU,P009395,P011261,7.367,2,13,11
45,LJU,P009395,P012598,16.3,0,33,33
45,LJU,P009395,P012700,22.149,-2,45,47
45,LJU,P010594,P012598,0.967,0,2,2
45,LJU,P010594,P012700,1.033,-8,0,8
45,LJU,P011261,P012598,6.134,-4,9,13
45,LJU,P011261,P012700,9.117,1,18,17
45,LJU,P012598,P012700,26.084,7,56,49
45,WOL,P003212,P004229,6.817,4,12,8
45,WOL,P003212,P004645,10.917,11,25,14
45,WOL,P003212,P005516,9.417,13,25,12
45,WOL,P003212,P006154,2.667,5,9,4
45,WOL,P003212,P006907,4.417,0,9,9
45,WOL,P003212,P011150,14.367,18,40,22
45,WOL,P003212,P012576,6.45,3,15,12
45,WOL,P003212,P012577,13.684,10,37,27
45,WOL,P004229,P004645,4.55,-3,7,10
45,WOL,P004229,P005516,6.717,-8,9,17
45,WOL,P004229,P006907,5.184,-1,9,10
45,WOL,P004229,P011150,8.084,0,15,15
45,WOL,P004229,P012577,7.584,-8,12,20
45,WOL,P004645,P005516,22.717,16,57,41
45,WOL,P004645,P006154,9.85,6,24,18
45,WOL,P004645,P011150,15.617,21,47,26
45,WOL,P004645,P012576,9.8,4,20,16
45,WOL,P004645,P012577,17.417,4,40,36
45,WOL,P004645,PLCT,6.0,-3,8,11
45,WOL,P005516,P006154,12.816,2,26,24
45,WOL,P005516,P006907,3.584,-3,6,9
45,WOL,P005516,P011150,23.634,12,58,46
45,WOL,P005516,P012576,15.65,0,29,29
45,WOL,P005516,P012577,26.251,-5,51,56
45,WOL,P005516,PLCT,8.15,-7,11,18
45,WOL,P006154,P011150,9.7,12,28,16
45,WOL,P006154,P012576,11.933,5,27,22
45,WOL,P006154,P012577,11.366,3,24,21
45,WOL,P006154,PLCT,3.6,-5,2,7
45,WOL,P006907,P011150,8.001,-3,15,18
45,WOL,P006907,P012576,2.817,-2,6,8
45,WOL,P006907,P012577,8.001,-3,15,18
45,WOL,P011150,P012576,15.7,2,33,31
45,WOL,P011150,P012577,25.951,0,59,59
45,WOL,P011150,PLCT,4.55,-2,9,11
45,WOL,P012576,P012577,15.75,-7,27,34
45,WOL,P012576,PLCT,3.5,-9,3,12
45,WOL,P012577,PLCT,6.8,-2,11,13
46,BOU,P000498,P004525,11.617,-6,24,30
46,BOU,P000498,P010431,1.25,2,5,3
46,BOU,P000498,P010450,10.9,-8,19,27
46,BOU,P000498,P010718,14.183,-4,27,31
46,BOU,P000498,P011836,4.366,1,7,6
46,BOU,P000498,P011837,7.383,4,20,16
46,BOU,P000498,P012619,8.6,-9,11,20
46,BOU,P000498,P012628,5.633,0,11,11
46,BOU,P004525,P010431,9.067,6,19,13
46,BOU,P004525,P010450,15.501,-9,26,35
46,BOU,P004525,P010718,17.401,-4,33,37
46,BOU,P004525,P011161,10.601,2,18,16
46,BOU,P004525,P011837,9.284,9,25,16
46,BOU,P004525,P012619,12.934,-13,17,30
46,BOU,P004525,P012628,2.467,-1,6,7
46,BOU,P010431,P010450,2.35,1,3,2
46,BOU,P010431,P010718,8.967,-1,16,17
46,BOU,P010431,P011161,15.617,1,28,27
46,BOU,P010431,P011836,7.8,-3,14,17
46,BOU,P010431,P011837,12.467,3,27,24
46,BOU,P010431,P012619,4.4,0,6,6
46,BOU,P010431,P012628,5.55,3,14,11
46,BOU,P010450,P010718,11.884,-9,19,28
46,BOU,P010450,P011161,5.134,-1,7,8
46,BOU,P010450,P011836,0.533,0,0,0
46,BOU,P010450,P011837,4.617,3,12,9
46,BOU,P010450,P012619,11.417,-12,14,26
46,BOU,P010450,P012628,1.8,-1,4,5
46,BOU,P010718,P011161,16.117,6,30,24
46,BOU,P010718,P011836,12.899,6,24,18
46,BOU,P010718,P011837,18.55,10,42,32
46,BOU,P010718,P012619,11.75,-8,15,23
46,BOU,P010718,P012628,9.449,12,22,10
46,BOU,P011161,P011836,13.416,8,29,21
46,BOU,P011161,P011837,16.717,9,36,27
46,BOU,P011161,P012619,7.3,1,11,10
46,BOU,P011161,P012628,11.166,14,29,15
46,BOU,P011836,P011837,14.816,4,31,27
46,BOU,P011836,P012619,2.966,5,5,0
46,BOU,P011836,P012628,14.332,15,34,19
46,BOU,P011837,P012628,12.566,10,31,21
46,BOU,P012619,P012628,4.233,4,9,5
46,BUD,P002740,P004945,17.399,-5,30,35
46,BUD,P002740,P009214,2.733,2,6,4
46,BUD,P002740,P010248,1.35,2,4,2
46,BUD,P002740,P010432,16.049,-7,26,33
46,BUD,P002740,P011935,14.083,-7,21,28
46,BUD,P002740,P012605,0.583,0,0,0
46,BUD,P002740,P012606,16.816,-5,30,35
46,BUD,P002740,P012630,0.583,0,3,3
46,BUD,P004945,P007398,11.083,1,19,18
46,BUD,P004945,P009214,4.333,2,10,8
46,BUD,P004945,P010248,13.25,5,27,22
46,BUD,P004945,P010432,16.832,-9,26,35
46,BUD,P004945,P011935,24.816,-8,38,46
46,BUD,P004945,P012605,9.416,-3,13,16
46,BUD,P004945,P012606,20.666,-1,40,41
46,BUD,P004945,P012630,2.533,2,9,7
46,BUD,P007398,P009214,1.866,-2,0,2
46,BUD,P007398,P010248,20.216,2,39,37
46,BUD,P007398,P010432,0.783,-2,0,2
46,BUD,P007398,P011935,18.783,0,37,37
46,BUD,P007398,P012605,14.883,-3,27,30
46,BUD,P007398,P012606,6.116,3,12,9
46,BUD,P007398,P012630,10.266,1,22,21
46,BUD,P009214,P010248,4.816,0,8,8
46,BUD,P009214,P010432,1.383,0,2,2
46,BUD,P009214,P012605,0.683,0,0,0
46,BUD,P009214,P012606,5.516,0,10,10
46,BUD,P009214,P012630,3.466,-2,4,6
46,BUD,P010248,P011935,18.0,2,37,35
46,BUD,P010248,P012605,14.1,-1,27,28
46,BUD,P010248,P012606,9.066,5,20,15
46,BUD,P010248,P012630,11.866,1,26,25
46,BUD,P010432,P011935,14.866,-9,21,30
46,BUD,P010432,P012605,1.366,-2,0,2
46,BUD,P010432,P012606,15.466,-7,26,33
46,BUD,P010432,P012630,0.583,0,3,3
46,BUD,P011935,P012605,14.783,-3,27,30
46,BUD,P011935,P012606,18.083,-4,31,35
46,BUD,P011935,P012630,8.05,1,20,19
46,BUD,P012605,P012630,6.05,0,14,14
46,BUD,P012606,P012630,6.399,1,15,14
47,ARI,P002867,P003240,15.517,10,31,21
47,ARI,P002867,P012615,13.117,14,29,15
47,ARI,P002867,P012616,3.417,-1,2,3
47,ARI,P002867,P012702,11.567,8,25,17
47,ARI,P002867,P012707,12.683,11,23,12
47,ARI,P002867,P012708,17.384,5,30,25
47,ARI,P002867,P012716,20.217,5,32,27
47,ARI,P002867,P012760,7.034,-4,8,12
47,ARI,P003240,P010387,3.017,-6,2,8
47,ARI,P003240,P012615,13.317,5,21,16
47,ARI,P003240,P012702,13.7,9,25,16
47,ARI,P003240,P012707,18.817,-9,23,32
47,ARI,P003240,P012708,20.651,-5,26,31
47,ARI,P003240,P012716,20.084,-8,26,34
47,ARI,P003240,P012760,10.901,-16,10,26
47,ARI,P010387,P012702,1.283,1,4,3
47,ARI,P010387,P012707,4.3,-5,6,11
47,ARI,P010387,P012708,1.283,1,4,3
47,ARI,P010387,P012716,4.3,-5,6,11
47,ARI,P010387,P012760,3.017,-6,2,8
47,ARI,P012615,P012702,4.717,8,15,7
47,ARI,P012615,P012707,12.666,2,16,14
47,ARI,P012615,P012708,18.284,4,29,25
47,ARI,P012615,P012716,10.7,5,18,13
47,ARI,P012615,P012760,5.667,-6,4,10
47,ARI,P012616,P012707,2.517,1,2,1
47,ARI,P012616,P012708,0.9,-2,0,2
47,ARI,P012616,P012716,3.417,-1,2,3
47,ARI,P012616,P012760,3.417,-1,2,3
47,ARI,P012702,P012707,7.45,-1,13,14
47,ARI,P012702,P012708,12.683,7,24,17
47,ARI,P012702,P012716,12.0,-4,18,22
47,ARI,P012707,P012708,16.583,-4,20,24
47,ARI,P012707,P012716,23.55,1,35,34
47,ARI,P012707,P012760,11.234,-8,10,18
47,ARI,P012708,P012716,20.217,-6,27,33
47,ARI,P012708,P012760,8.551,-12,8,20
47,ARI,P012716,P012760,9.851,-7,12,19
47,CLU,P004862,P005113,10.266,-10,9,19
47,CLU,P004862,P005373,9.75,-4,13,17
47,CLU,P004862,P005714,7.766,1,14,13
47,CLU,P004862,P010569,15.217,-4,21,25
47,CLU,P004862,P011797,11.583,-4,18,22
47,CLU,P004862,P011801,11.766,0,18,18
47,CLU,P004862,P012621,17.333,-9,22,31
47,CLU,P004862,P012698,4.783,2,9,7
47,CLU,P005113,P005714,12.7,7,25,18
47,CLU,P005113,P010569,8.883,-9,6,15
47,CLU,P005113,P011797,17.75,1,28,27
47,CLU,P005113,P011801,15.15,5,25,20
47,CLU,P005113,P012621,8.333,-10,7,17
47,CLU,P005113,P012698,13.25,8,24,16
47,CLU,P005373,P005714,6.15,-3,7,10
47,CLU,P005373,P010569,7.267,1,11,10
47,CLU,P005373,P011797,5.65,-1,8,9
47,CLU,P005373,P011801,10.267,3,15,12
47,CLU,P005373,P012620,0.1,-1,0,1
47,CLU,P005373,P012621,9.2,-4,11,15
47,CLU,P005373,P012698,5.284,1,7,6
47,CLU,P005714,P010569,3.767,3,7,4
47,CLU,P005714,P011797,18.35,15,39,24
47,CLU,P005714,P011801,21.65,9,40,31
47,CLU,P005714,P012620,0.1,-1,0,1
47,CLU,P005714,P012621,5.667,-3,7,10
47,CLU,P005714,P012698,19.25,12,37,25
47,CLU,P010569,P011797,13.817,-6,16,22
47,CLU,P010569,P011801,10.8,0,11,11
47,CLU,P010569,P012621,13.6,-3,19,22
47,CLU,P010569,P012698,6.317,-2,5,7
47,CLU,P011797,P011801,18.05,13,35,22
47,CLU,P011797,P012621,10.35,-7,13,20
47,CLU,P011797,P012698,18.05,13,35,22
47,CLU,P011801,P012621,7.95,-2,9,11
47,CLU,P011801,P012698,22.567,12,39,27
47,CLU,P012620,P012621,0.1,-1,0,1
47,CLU,P012620,P012698,0.1,-1,0,1
47,CLU,P012621,P012698,1.067,-1,0,1
48,ULM,P005422,P006997,0.833,-3,1,4
48,ULM,P005422,P010106,16.533,4,37,33
48,ULM,P005422,P010582,13.733,13,32,19
48,ULM,P005422,P011457,4.783,0,9,9
48,ULM,P005422,P012603,12.383,-22,23,45
48,ULM,P005422,P012604,30.567,1,70,69
48,ULM,P005422,P012629,23.601,2,58,56
48,ULM,P005422,P012703,23.167,-3,54,57
48,ULM,P006997,P010106,7.7,6,21,15
48,ULM,P006997,P010582,7.7,6,21,15
48,ULM,P006997,P010726,8.5,5,22,17
48,ULM,P006997,P011457,6.15,7,18,11
48,ULM,P006997,P012603,3.183,-5,5,10
48,ULM,P006997,P012629,1.633,-4,2,6
48,ULM,P006997,P012703,1.633,-4,2,6
48,ULM,P010106,P010582,18.933,8,46,38
48,ULM,P010106,P010726,7.15,7,20,13
48,ULM,P010106,P011457,10.75,6,26,20
48,ULM,P010106,P012066,0.367,-2,0,2
48,ULM,P010106,P012603,2.233,-6,3,9
48,ULM,P010106,P012604,17.2,4,41,37
48,ULM,P010106,P012629,9.584,9,29,20
48,ULM,P010106,P012703,9.15,4,25,21
48,ULM,P010582,P010726,7.15,7,20,13
48,ULM,P010582,P011457,13.1,7,32,25
48,ULM,P010582,P012066,2.717,-1,6,7
48,ULM,P010582,P012603,2.233,-6,3,9
48,ULM,P010582,P012604,16.75,14,42,28
48,ULM,P010582,P012629,6.784,18,24,6
48,ULM,P010582,P012703,8.7,14,26,12
48,ULM,P010726,P011457,5.6,8,17,9
48,ULM,P010726,P012603,2.9,-3,5,8
48,ULM,P010726,P012629,1.35,-2,2,4
48,ULM,P010726,P012703,1.35,-2,2,4
48,ULM,P011457,P012066,2.717,-1,6,7
48,ULM,P011457,P012604,6.95,0,14,14
48,ULM,P011457,P012703,2.35,1,6,5
48,ULM,P012066,P012603,1.533,2,4,2
48,ULM,P012066,P012604,4.25,1,10,9
48,ULM,P012066,P012629,1.533,2,4,2
48,ULM,P012066,P012703,3.883,3,10,7
48,ULM,P012603,P012604,13.633,-18,27,45
48,ULM,P012603,P012629,14.583,-17,29,46
48,ULM,P012603,P012703,14.583,-17,29,46
48,ULM,P012604,P012629,25.701,7,67,60
48,ULM,P012604,P012703,27.617,3,69,66
48,ULM,P012629,P012703,24.567,-3,61,64
48,WRO,P001694,P003034,14.9,-15,29,44
48,WRO,P001694,P009896,12.133,1,26,25
48,WRO,P001694,P011165,27.033,-14,55,69
48,WRO,P001694,P011278,7.7,6,18,12
48,WRO,P001694,P011901,7.0,6,16,10
48,WRO,P001694,P012699,19.333,-20,37,57
48,WRO,P001694,P012736,18.55,-15,37,52
48,WRO,P001694,P012749,1.483,-5,2,7
48,WRO,P003034,P009896,0.017,3,3,0
48,WRO,P003034,P011165,14.917,-12,32,44
48,WRO,P003034,P011278,1.767,0,5,5
48,WRO,P003034,P011901,3.3,-2,7,9
48,WRO,P003034,P011902,1.683,0,4,4
48,WRO,P003034,P012699,14.833,-12,31,43
48,WRO,P003034,P012736,14.983,-10,33,43
48,WRO,P009896,P011165,20.9,-2,48,50
48,WRO,P009896,P011278,18.4,10,47,37
48,WRO,P009896,P011901,17.767,21,54,33
48,WRO,P009896,P011902,15.217,5,36,31
48,WRO,P009896,P012699,12.501,-1,27,28
48,WRO,P009896,P012736,12.55,10,34,24
48,WRO,P009896,P012749,4.183,-7,5,12
48,WRO,P011165,P011278,14.85,1,35,34
48,WRO,P011165,P011901,11.85,4,32,28
48,WRO,P011165,P011902,7.7,-7,14,21
48,WRO,P011165,P012699,22.467,-21,43,64
48,WRO,P011165,P012736,21.2,-12,47,59
48,WRO,P011165,P012749,2.283,-5,2,7
48,WRO,P011278,P011901,17.15,10,46,36
48,WRO,P011278,P011902,11.383,-3,23,26
48,WRO,P011278,P012699,2.484,-1,4,5
48,WRO,P011278,P012736,3.466,7,13,6
48,WRO,P011278,P012749,3.4,-2,5,7
48,WRO,P011901,P011902,12.983,6,34,28
48,WRO,P011901,P012699,4.884,8,15,7
48,WRO,P011901,P012736,7.366,13,25,12
48,WRO,P011901,P012749,1.9,-2,3,5
48,WRO,P011902,P012699,7.984,7,21,14
48,WRO,P011902,P012736,7.95,14,25,11
48,WRO,P011902,P012749,2.7,-2,3,5
48,WRO,P012699,P012736,24.067,-7,54,61
48,WRO,P012699,P012749,0.783,-5,0,5
49,TRN,P001479,P005059,11.867,-8,22,30
49,TRN,P001479,P005738,3.45,3,13,10
49,TRN,P001479,P006382,10.934,-5,22,27
49,TRN,P001479,P009903,5.034,1,13,12
49,TRN,P001479,P012594,3.217,0,8,8
49,TRN,P001479,P012595,4.15,-3,8,11
49,TRN,P001479,P012596,6.6,-12,4,16
49,TRN,P001479,P012597,15.084,-8,30,38
49,TRN,P005059,P005738,8.917,7,26,19
49,TRN,P005059,P006382,15.184,0,31,31
49,TRN,P005059,P009903,3.034,0,9,9
49,TRN,P005059,P012593,1.217,-1,4,5
49,TRN,P005059,P012595,2.15,-4,4,8
49,TRN,P005059,P012596,10.85,-7,13,20
49,TRN,P005059,P012597,16.117,-3,31,34
49,TRN,P005738,P006382,7.783,10,24,14
49,TRN,P005738,P009903,25.666,8,62,54
49,TRN,P005738,P012593,21.45,13,55,42
49,TRN,P005738,P012594,24.449,9,58,49
49,TRN,P005738,P012595,20.783,-1,46,47
49,TRN,P005738,P012596,4.25,5,9,4
49,TRN,P005738,P012597,16.716,10,43,33
49,TRN,P006382,P009903,2.5,0,7,7
49,TRN,P006382,P012594,0.683,-1,2,3
49,TRN,P006382,P012596,10.517,-7,13,20
49,TRN,P006382,P012597,15.867,-1,33,34
49,TRN,P009903,P012593,21.45,13,55,42
49,TRN,P009903,P012594,27.666,9,66,57
49,TRN,P009903,P012595,23.4,2,54,52
49,TRN,P009903,P012597,14.05,3,34,31
49,TRN,P012593,P012594,20.233,14,51,37
49,TRN,P012593,P012595,16.65,6,41,35
49,TRN,P012593,P012597,4.8,7,14,7
49,TRN,P012594,P012595,22.183,3,50,47
49,TRN,P012594,P012597,12.233,2,29,27
49,TRN,P012595,P012596,0.333,0,0,0
49,TRN,P012595,P012597,7.683,-7,13,20
49,TRN,P012596,P012597,10.85,-7,13,20
49,TTK,P000497,P005000,4.251,-5,4,9
49,TTK,P000497,P005685,2.484,-7,2,9
49,TTK,P000497,P011239,1.767,2,2,0
49,TTK,P000497,P011834,1.617,-7,0,7
49,TTK,P000497,P011925,2.634,2,4,2
49,TTK,P000497,P012697,4.251,-5,4,9
49,TTK,P005000,P005685,6.434,0,14,14
49,TTK,P005000,P006693,11.133,0,23,23
49,TTK,P005000,P009845,2.933,1,8,7
49,TTK,P005000,P011239,27.534,-3,59,62
49,TTK,P005000,P011834,21.45,-2,48,50
49,TTK,P005000,P011925,26.334,-2,59,61
49,TTK,P005000,P012056,23.333,5,55,50
49,TTK,P005000,P012697,27.334,-2,62,64
49,TTK,P005685,P011834,1.617,-7,0,7
49,TTK,P005685,P011925,4.817,7,14,7
49,TTK,P005685,P012056,3.95,7,12,5
49,TTK,P005685,P012697,6.434,0,14,14
49,TTK,P006693,P011239,17.05,-1,33,34
49,TTK,P006693,P011834,17.133,-1,35,36
49,TTK,P006693,P011925,14.3,-5,26,31
49,TTK,P006693,P012056,10.933,3,21,18
49,TTK,P006693,P012697,0.783,0,2,2
49,TTK,P009845,P011834,1.683,4,6,2
49,TTK,P009845,P011925,2.933,1,8,7
49,TTK,P009845,P012056,1.25,-3,2,5
49,TTK,P009845,P012697,2.933,1,8,7
49,TTK,P011239,P011834,24.684,-2,53,55
49,TTK,P011239,P011925,25.118,-13,48,61
49,TTK,P011239,P012056,25.45,-2,54,56
49,TTK,P011239,P012697,17.801,-5,39,44
49,TTK,P011834,P011925,17.417,-5,37,42
49,TTK,P011834,P012056,17.05,4,37,33
49,TTK,P011834,P012697,12.417,-4,28,32
49,TTK,P011925,P012056,20.917,-5,44,49
49,TTK,P011925,P012697,20.134,0,48,48
49,TTK,P012056,P012697,19.717,-1,47,48
50,CAN,P001607,P003637,13.966,-2,32,34
50,CAN,P001607,P004160,2.95,-3,3,6
50,CAN,P001607,P005005,13.533,-4,30,34
50,CAN,P001607,P006588,4.083,1,7,6
50,CAN,P001607,P007560,2.983,-4,3,7
50,CAN,P001607,P007644,1.333,-2,2,4
50,CAN,P001607,P008121,1.066,-3,2,5
50,CAN,P001607,P009864,5.0,-8,8,16
50,CAN,P001607,P010385,10.916,2,25,23
50,CAN,P001607,P010452,13.166,-9,28,37
50,CAN,P003425,P003637,2.65,0,6,6
50,CAN,P003425,P004160,6.7,2,9,7
50,CAN,P003425,P005005,5.25,13,19,6
50,CAN,P003425,P006588,19.416,17,46,29
50,CAN,P003425,P007560,10.183,9,27,18
50,CAN,P003425,P007644,4.75,-4,5,9
50,CAN,P003425,P008121,20.717,14,45,31
50,CAN,P003425,P009864,14.617,21,38,17
50,CAN,P003425,P010385,3.383,2,10,8
50,CAN,P003425,P010452,3.334,2,7,5
50,CAN,P003637,P005005,14.916,1,36,35
50,CAN,P003637,P006588,5.483,0,10,10
50,CAN,P003637,P008121,1.7,-3,2,5
50,CAN,P003637,P009864,4.0,-1,10,11
50,CAN,P003637,P010385,12.616,-1,28,29
50,CAN,P003637,P010452,11.133,-2,28,30
50,CAN,P004160,P005005,0.35,2,2,0
50,CAN,P004160,P006588,5.583,0,7,7
50,CAN,P004160,P007560,2.95,-3,3,6
50,CAN,P004160,P007644,5.566,-4,7,11
50,CAN,P004160,P008121,6.35,0,7,7
50,CAN,P004160,P009864,4.084,3,5,2
50,CAN,P004160,P010452,4.067,-1,5,6
50,CAN,P005005,P006588,7.3,9,19,10
50,CAN,P005005,P008121,3.517,6,11,5
50,CAN,P005005,P009864,7.867,7,23,16
50,CAN,P005005,P010385,10.916,2,26,24
50,CAN,P005005,P010452,11.483,0,30,30
50,CAN,P006588,P007560,8.916,12,25,13
50,CAN,P006588,P007644,4.233,-2,5,7
50,CAN,P006588,P008121,19.716,15,45,30
50,CAN,P006588,P009864,13.15,13,31,18
50,CAN,P006588,P010385,6.116,7,17,10
50,CAN,P007560,P007644,1.85,-4,2,6
50,CAN,P007560,P008121,10.216,8,27,19
50,CAN,P007560,P009864,9.633,4,21,17
50,CAN,P007560,P010385,1.683,5,7,2
50,CAN,P007560,P010452,4.25,-7,5,12
50,CAN,P007644,P008121,4.75,-4,5,9
50,CAN,P007644,P010452,1.85,-4,2,6
50,CAN,P008121,P009864,13.65,13,33,20
50,CAN,P008121,P010385,3.383,2,9,7
50,CAN,P008121,P010452,2.067,-4,2,6
50,CAN,P009864,P010452,6.467,0,15,15
50,CAN,P010385,P010452,8.183,-3,18,21
50,LKB,P002012,P004664,17.399,1,40,39
50,LKB,P002012,P005521,7.833,9,18,9
50,LKB,P002012,P006230,10.233,-12,18,30
50,LKB,P002012,P007029,20.716,-13,37,50
50,LKB,P002012,P008856,7.75,-7,6,13
50,LKB,P002012,P010461,11.483,6,23,17
50,LKB,P002012,P012583,3.433,0,5,5
50,LKB,P002012,PLXI,21.749,-8,37,45
50,LKB,P004664,P005521,16.667,7,39,32
50,LKB,P004664,P006230,9.833,2,31,29
50,LKB,P004664,P006901,2.65,3,6,3
50,LKB,P004664,P007029,13.133,-6,31,37
50,LKB,P004664,P010190,7.133,1,19,18
50,LKB,P004664,P010461,13.1,-3,25,28
50,LKB,P004664,P012583,9.75,-5,20,25
50,LKB,P004664,PLXI,15.799,-4,33,37
50,LKB,P005521,P006230,5.733,2,15,13
50,LKB,P005521,P006901,2.65,3,6,3
50,LKB,P005521,P007029,6.117,2,15,13
50,LKB,P005521,P008856,6.016,-3,10,13
50,LKB,P005521,P010190,7.133,1,19,18
50,LKB,P005521,P010461,15.05,-1,31,32
50,LKB,P005521,P012583,14.1,-5,28,33
50,LKB,P005521,PLXI,9.433,1,15,14
50,LKB,P006230,P006901,2.65,3,6,3
50,LKB,P006230,P007029,11.35,-15,18,33
50,LKB,P006230,P008856,6.0,-12,2,14
50,LKB,P006230,P010190,4.483,5,15,10
50,LKB,P006230,P012583,2.95,-1,9,10
50,LKB,P006230,PLXI,10.1,-12,18,30
50,LKB,P006901,P007029,0.167,0,0,0
50,LKB,P006901,P010190,2.483,3,6,3
50,LKB,P007029,P008856,10.3,-7,12,19
50,LKB,P007029,P010461,10.55,5,23,18
50,LKB,P007029,P012583,4.083,-3,8,11
50,LKB,P007029,PLXI,17.316,-15,28,43
50,LKB,P008856,P010461,7.633,2,14,12
50,LKB,P008856,P012583,5.883,-3,10,13
50,LKB,P008856,PLXI,10.95,-10,10,20
50,LKB,P010190,P010461,2.65,-4,4,8
50,LKB,P010190,P012583,4.65,-2,13,15
50,LKB,P010461,P012583,9.25,-7,16,23
50,LKB,P010461,PLXI,13.216,-2,20,22
50,LKB,P012583,PLXI,8.433,-6,11,17
51,PMT,P001686,P002644,7.616,3,16,13
51,PMT,P001686,P011066,3.967,1,8,7
51,PMT,P001686,P011823,4.35,-4,10,14
51,PMT,P001686,P011943,3.533,2,8,6
51,PMT,P001686,P011944,7.0,0,16,16
51,PMT,P001686,P011947,4.95,2,12,10
51,PMT,P001686,P011966,3.533,2,8,6
51,PMT,P001686,P012599,2.833,6,8,2
51,PMT,P001686,P012600,4.35,-4,10,14
51,PMT,P002644,P009559,10.316,-7,18,25
51,PMT,P002644,P011066,15.999,-1,29,30
51,PMT,P002644,P011823,2.266,-3,5,8
51,PMT,P002644,P011943,4.533,2,8,6
51,PMT,P002644,P011944,16.166,-1,28,29
51,PMT,P002644,P011947,8.416,6,15,9
51,PMT,P002644,P011966,4.0,2,8,6
51,PMT,P002644,P012599,14.083,-3,27,30
51,PMT,P002644,P012600,2.333,-6,2,8
51,PMT,P009559,P011066,15.45,-13,29,42
51,PMT,P009559,P011823,6.834,-6,11,17
51,PMT,P009559,P011944,11.633,-6,20,26
51,PMT,P009559,P011946,1.017,0,0,0
51,PMT,P009559,P011947,3.8,-2,2,4
51,PMT,P009559,P012599,15.05,-11,27,38
51,PMT,P009559,P012600,4.5,-7,9,16
51,PMT,P011066,P011823,15.05,-14,27,41
51,PMT,P011066,P011943,0.533,0,0,0
51,PMT,P011066,P011944,23.183,-10,36,46
51,PMT,P011066,P011946,3.533,-1,7,8
51,PMT,P011066,P011947,11.649,-2,16,18
51,PMT,P011066,P012599,26.266,-10,49,59
51,PMT,P011066,P012600,5.234,-10,11,21
51,PMT,P011823,P011944,13.0,-13,20,33
51,PMT,P011823,P011946,5.6,-1,9,10
51,PMT,P011823,P011947,12.233,-6,18,24
51,PMT,P011823,P012599,15.949,-5,29,34
51,PMT,P011823,P012600,8.05,-8,19,27
51,PMT,P011943,P011944,1.0,0,0,0
51,PMT,P011943,P011947,4.533,2,8,6
51,PMT,P011943,P011966,4.0,2,8,6
51,PMT,P011944,P011946,2.3,-3,4,7
51,PMT,P011944,P011947,11.367,-4,14,18
51,PMT,P011944,P011966,0.467,0,0,0
51,PMT,P011944,P012599,20.466,-3,36,39
51,PMT,P011944,P012600,4.35,-4,10,14
51,PMT,P011946,P011947,4.35,2,7,5
51,PMT,P011946,P012599,5.6,-1,9,10
51,PMT,P011947,P011966,4.0,2,8,6
51,PMT,P011947,P012599,11.766,0,16,16
51,PMT,P011947,P012600,2.2,0,4,4
51,PMT,P012599,P012600,4.783,-5,11,16
51,WOL,P002387,P003212,18.182,10,41,31
51,WOL,P002387,P004229,10.017,-8,14,22
51,WOL,P002387,P005516,16.0,-3,20,23
51,WOL,P002387,P006154,10.883,4,24,20
51,WOL,P002387,P006907,0.1,0,0,0
51,WOL,P002387,P011150,16.966,11,43,32
51,WOL,P002387,P012576,15.782,16,38,22
51,WOL,P002387,P012577,12.25,2,21,19
51,WOL,P002387,PLCT,3.416,0,7,7
51,WOL,P003212,P004229,8.367,-3,15,18
51,WOL,P003212,P004645,1.5,-1,3,4
51,WOL,P003212,P005516,10.366,-3,13,16
51,WOL,P003212,P006154,9.666,7,23,16
51,WOL,P003212,P011150,9.249,13,32,19
51,WOL,P003212,P012576,11.898,11,30,19
51,WOL,P003212,P012577,8.416,-2,16,18
51,WOL,P003212,PLCT,3.416,0,7,7
51,WOL,P004229,P004645,3.883,-3,8,11
51,WOL,P004229,P005516,11.483,-11,14,25
51,WOL,P004229,P006154,3.417,-8,2,10
51,WOL,P004229,P006907,0.433,0,0,0
51,WOL,P004229,P011150,8.816,-8,15,23
51,WOL,P004229,P012577,10.916,-3,20,23
51,WOL,P004645,P005516,10.466,7,27,20
51,WOL,P004645,P011150,8.966,8,24,16
51,WOL,P004645,P012576,6.583,10,19,9
51,WOL,P004645,P012577,10.466,7,27,20
51,WOL,P005516,P006154,9.033,-3,13,16
51,WOL,P005516,P006907,1.383,-3,0,3
51,WOL,P005516,P011150,20.166,6,40,34
51,WOL,P005516,P012576,18.516,14,39,25
51,WOL,P005516,P012577,22.983,8,46,38
51,WOL,P006154,P011150,7.767,8,24,16
51,WOL,P006154,P012576,9.816,14,28,14
51,WOL,P006154,P012577,2.35,2,6,4
51,WOL,P006907,P011150,1.383,-3,0,3
51,WOL,P006907,P012576,0.85,-3,0,3
51,WOL,P006907,P012577,1.383,-3,0,3
51,WOL,P011150,P012576,20.066,27,57,30
51,WOL,P011150,P012577,20.216,12,46,34
51,WOL,P011150,PLCT,2.333,2,7,5
51,WOL,P012576,P012577,15.333,11,34,23
51,WOL,P012576,PLCT,3.416,0,7,7
51,WOL,P012577,PLCT,1.083,-2,0,2
52,LJU,P001235,P002661,2.667,9,9,0
52,LJU,P001235,P003452,8.516,-5,13,18
52,LJU,P001235,P007066,3.883,3,11,8
52,LJU,P001235,P009392,3.5,7,9,2
52,LJU,P001235,P009395,8.133,0,13,13
52,LJU,P001235,P010594,0.2,0,0,0
52,LJU,P001235,P011261,2.533,1,8,7
52,LJU,P001235,P012598,8.916,-4,15,19
52,LJU,P001235,P012700,10.516,1,18,17
52,LJU,P002661,P003452,24.233,-5,59,64
52,LJU,P002661,P007066,14.234,-3,34,37
52,LJU,P002661,P009392,9.601,4,26,22
52,LJU,P002661,P009395,16.216,1,38,37
52,LJU,P002661,P010594,2.984,-1,6,7
52,LJU,P002661,P011261,2.049,1,4,3
52,LJU,P002661,P012598,23.183,-5,53,58
52,LJU,P002661,P012700,26.633,-9,59,68
52,LJU,P003452,P007066,13.133,-13,29,42
52,LJU,P003452,P009392,7.917,-2,19,21
52,LJU,P003452,P009395,18.349,-1,39,40
52,LJU,P003452,P011261,0.649,0,4,4
52,LJU,P003452,P012598,25.899,-11,56,67
52,LJU,P003452,P012700,27.232,-19,53,72
52,LJU,P007066,P009392,8.884,3,23,20
52,LJU,P007066,P010594,0.917,-1,2,3
52,LJU,P007066,P011261,0.566,0,4,4
52,LJU,P007066,P012598,8.983,-11,20,31
52,LJU,P007066,P012700,11.2,-14,21,35
52,LJU,P009392,P009395,1.35,-1,3,4
52,LJU,P009392,P010594,1.117,-1,2,3
52,LJU,P009392,P012598,2.75,3,9,6
52,LJU,P009392,P012700,6.617,-5,13,18
52,LJU,P009395,P010594,2.067,0,4,4
52,LJU,P009395,P011261,4.016,2,8,6
52,LJU,P009395,P012598,22.916,2,48,46
52,LJU,P009395,P012700,24.349,1,51,50
52,LJU,P010594,P012598,2.267,0,4,4
52,LJU,P010594,P012700,3.184,-1,6,7
52,LJU,P011261,P012598,4.366,0,10,10
52,LJU,P011261,P012700,4.149,4,10,6
52,LJU,P012598,P012700,29.116,-10,57,67
52,VNC,P000968,P003759,1.983,2,7,5
52,VNC,P000968,P008052,6.483,-4,13,17
52,VNC,P000968,P011928,4.5,-6,6,12
52,VNC,P000968,P012587,2.55,-2,7,9
52,VNC,P000968,P012590,6.483,-4,13,17
52,VNC,P000968,P012591,3.933,-2,6,8
52,VNC,P003759,P004381,17.8,2,37,35
52,VNC,P003759,P008052,8.033,-1,21,22
52,VNC,P003759,P009400,13.533,5,29,24
52,VNC,P003759,P011928,11.75,5,23,18
52,VNC,P003759,P012587,5.816,-4,14,18
52,VNC,P003759,P012590,6.25,-1,15,16
52,VNC,P003759,P012591,13.967,8,30,22
52,VNC,P004381,P008052,16.416,8,46,38
52,VNC,P004381,P009400,21.016,12,52,40
52,VNC,P004381,P011928,20.667,8,49,41
52,VNC,P004381,P012587,5.399,-7,10,17
52,VNC,P004381,P012590,15.017,12,44,32
52,VNC,P004381,P012591,25.017,21,66,45
52,VNC,P008052,P009400,8.916,10,26,16
52,VNC,P008052,P011928,14.433,-6,31,37
52,VNC,P008052,P012587,11.132,-11,23,34
52,VNC,P008052,P012590,20.699,1,52,51
52,VNC,P008052,P012591,18.216,11,48,37
52,VNC,P009400,P011928,13.8,-1,29,30
52,VNC,P009400,P012587,2.549,0,6,6
52,VNC,P009400,P012590,5.7,10,20,10
52,VNC,P009400,P012591,18.55,12,46,34
52,VNC,P011928,P012587,5.233,-7,9,16
52,VNC,P011928,P012590,16.717,2,39,37
52,VNC,P011928,P012591,26.3,5,58,53
52,VNC,P012587,P012590,8.583,-11,17,28
52,VNC,P012587,P012591,3.266,-2,6,8
52,VNC,P012590,P012591,19.283,15,52,37
53,BES,P003783,P005348,6.316,2,17,15
53,BES,P003783,P007914,12.182,0,26,26
53,BES,P003783,P007917,2.183,-3,2,5
53,BES,P003783,P008945,5.434,9,17,8
53,BES,P003783,P009582,14.382,6,37,31
53,BES,P003783,P011357,3.233,0,6,6
53,BES,P003783,P011379,9.249,4,19,15
53,BES,P003783,P011936,11.782,-1,23,24
53,BES,P003783,P012622,7.316,2,16,14
53,BES,P003783,P012647,7.383,1,21,20
53,BES,P005348,P007914,2.333,-1,6,7
53,BES,P005348,P009582,6.316,2,17,15
53,BES,P005348,P011357,3.233,0,6,6
53,BES,P005348,P011379,2.333,-1,6,7
53,BES,P005348,P011936,2.383,0,6,6
53,BES,P005348,P012622,1.6,3,5,2
53,BES,P005348,P012647,0.75,3,5,2
53,BES,P007914,P007917,4.783,-2,9,11
53,BES,P007914,P008945,14.0,10,33,23
53,BES,P007914,P009582,15.316,7,36,29
53,BES,P007914,P011379,8.998,-4,16,20
53,BES,P007914,P011936,11.132,-2,22,24
53,BES,P007914,P012622,7.049,0,9,9
53,BES,P007914,P012647,13.267,8,31,23
53,BES,P007917,P008945,7.417,0,18,18
53,BES,P007917,P011379,0.983,2,2,0
53,BES,P007917,P011936,9.6,-3,20,23
53,BES,P007917,P012622,4.817,-1,11,12
53,BES,P007917,P012647,8.617,-5,18,23
53,BES,P008945,P009582,16.25,13,38,25
53,BES,P008945,P011379,3.683,-2,7,9
53,BES,P008945,P011936,17.0,7,42,35
53,BES,P008945,P012622,16.6,9,35,26
53,BES,P008945,P012647,21.884,18,54,36
53,BES,P009582,P011357,3.233,0,6,6
53,BES,P009582,P011379,6.749,-5,12,17
53,BES,P009582,P011936,13.982,4,33,29
53,BES,P009582,P012622,13.899,7,28,21
53,BES,P009582,P012647,16.733,18,45,27
53,BES,P011357,P011936,2.383,0,6,6
53,BES,P011357,P012622,0.85,0,0,0
53,BES,P011379,P011936,9.082,0,15,15
53,BES,P011379,P012622,4.583,2,7,5
53,BES,P011936,P012622,15.916,4,34,30
53,BES,P011936,P012647,15.8,3,39,36
53,BES,P012622,P012647,16.966,6,39,33
53,HAM,P009663,P011168,21.501,-11,42,53
53,HAM,P009663,P012579,17.383,-15,31,46
53,HAM,P009663,P012580,12.867,-14,20,34
53,HAM,P009663,P012581,22.784,-15,44,59
53,HAM,P009663,P012582,17.3,-13,30,43
53,HAM,P009663,P012648,4.917,2,12,10
53,HAM,P009663,P012694,10.484,-5,22,27
53,HAM,P009663,P012695,3.9,-1,7,8
53,HAM,P011168,P011187,7.083,4,17,13
53,HAM,P011168,P012579,18.4,-1,38,39
53,HAM,P011168,P012580,12.917,2,27,25
53,HAM,P011168,P012581,18.301,-11,36,47
53,HAM,P011168,P012582,19.667,-13,37,50
53,HAM,P011168,P012648,7.55,-4,17,21
53,HAM,P011168,P012694,8.917,6,22,16
53,HAM,P011187,P012579,6.951,7,14,7
53,HAM,P011187,P012580,11.184,11,26,15
53,HAM,P011187,P012581,1.033,-5,0,5
53,HAM,P011187,P012582,6.583,-3,13,16
53,HAM,P011187,P012648,5.266,-1,12,13
53,HAM,P011187,P012694,5.634,9,13,4
53,HAM,P011187,P012695,5.134,2,9,7
53,HAM,P012579,P012580,12.567,-3,22,25
53,HAM,P012579,P012581,14.15,-11,26,37
53,HAM,P012579,P012582,17.167,-7,31,38
53,HAM,P012579,P012694,7.167,-1,14,15
53,HAM,P012579,P012695,3.551,-1,4,5
53,HAM,P012580,P012581,7.867,-11,12,23
53,HAM,P012580,P012582,10.033,-5,18,23
53,HAM,P012580,P012648,6.0,5,15,10
53,HAM,P012580,P012694,14.018,2,28,26
53,HAM,P012580,P012695,8.751,1,16,15
53,HAM,P012581,P012582,15.983,-14,27,41
53,HAM,P012581,P012648,4.183,-4,9,13
53,HAM,P012581,P012694,7.834,-6,17,23
53,HAM,P012581,P012695,3.133,-3,5,8
53,HAM,P012582,P012648,5.316,-6,10,16
53,HAM,P012582,P012695,3.483,-3,6,9
53,HAM,P012648,P012694,4.867,7,14,7
53,HAM,P012648,P012695,2.633,5,7,2
53,HAM,P012694,P012695,5.551,4,10,6
54,JOV,P002361,P005094,17.583,-9,29,38
54,JOV,P002361,P006771,9.632,-9,18,27
54,JOV,P002361,P010161,10.45,-10,15,25
54,JOV,P002361,P010166,2.233,0,8,8
54,JOV,P002361,P010708,9.583,0,17,17
54,JOV,P002361,P011248,12.283,0,26,26
54,JOV,P002361,P012349,6.7,-14,6,20
54,JOV,P002361,PJUG,5.6,-14,5,19
54,JOV,P005094,P006771,16.866,0,29,29
54,JOV,P005094,P009572,9.499,-2,18,20
54,JOV,P005094,P010161,22.717,-1,44,45
54,JOV,P005094,P010166,7.566,-3,15,18
54,JOV,P005094,P010708,19.683,6,41,35
54,JOV,P005094,P011248,26.583,3,55,52
54,JOV,P005094,P012349,5.767,-9,4,13
54,JOV,P005094,PJUG,5.8,-9,5,14
54,JOV,P006771,P009572,7.883,2,14,12
54,JOV,P006771,P010161,12.65,-4,25,29
54,JOV,P006771,P010166,6.7,4,20,16
54,JOV,P006771,P010708,11.499,2,21,19
54,JOV,P006771,P011248,17.433,0,35,35
54,JOV,P006771,P012349,6.883,-10,8,18
54,JOV,P006771,PJUG,5.85,-5,10,15
54,JOV,P009572,P010161,12.016,-2,28,30
54,JOV,P009572,P010166,8.083,4,19,15
54,JOV,P009572,P010708,5.366,2,15,13
54,JOV,P009572,P011248,10.199,-1,22,23
54,JOV,P009572,P012349,2.533,-1,2,3
54,JOV,P009572,PJUG,5.017,2,10,8
54,JOV,P010161,P010166,6.317,-3,15,18
54,JOV,P010161,P010708,17.0,1,37,36
54,JOV,P010161,P011248,18.65,0,41,41
54,JOV,P010161,P012349,5.816,-11,4,15
54,JOV,P010161,PJUG,9.584,-10,15,25
54,JOV,P010166,P010708,1.3,1,4,3
54,JOV,P010166,P011248,8.316,-2,19,21
54,JOV,P010166,PJUG,2.417,3,8,5
54,JOV,P010708,P011248,17.733,8,40,32
54,JOV,P010708,PJUG,2.9,-4,5,9
54,JOV,P011248,P012349,4.0,-4,6,10
54,JOV,P011248,PJUG,0.067,0,0,0
54,JOV,P012349,PJUG,5.233,-11,2,13
54,LLI,P003850,P004479,6.7,-11,6,17
54,LLI,P003850,P004773,6.7,-11,6,17
54,LLI,P003850,P005247,4.05,-4,6,10
54,LLI,P003850,P009649,2.65,-7,0,7
54,LLI,P003850,P012586,6.7,-11,6,17
54,LLI,P004479,P004773,11.95,4,23,19
54,LLI,P004479,P005247,13.051,9,29,20
54,LLI,P004479,P006600,17.584,18,38,20
54,LLI,P004479,P009649,15.784,-4,23,27
54,LLI,P004479,P009680,14.584,9,31,22
54,LLI,P004479,P012585,8.417,1,13,12
54,LLI,P004479,P012586,10.334,-6,13,19
54,LLI,P004773,P005247,8.817,9,21,12
54,LLI,P004773,P006600,5.25,15,17,2
54,LLI,P004773,P009649,3.133,-5,2,7
54,LLI,P004773,P009680,1.933,8,10,2
54,LLI,P004773,P012586,10.017,-4,13,17
54,LLI,P005247,P006600,16.667,23,46,23
54,LLI,P005247,P009649,5.067,6,15,9
54,LLI,P005247,P009680,13.384,12,36,24
54,LLI,P005247,P012585,7.983,8,23,15
54,LLI,P005247,P012586,15.117,5,32,27
54,LLI,P006600,P009649,21.067,9,50,41
54,LLI,P006600,P009680,29.384,15,71,56
54,LLI,P006600,P012585,23.817,7,56,49
54,LLI,P006600,P012586,18.167,9,46,37
54,LLI,P009649,P009680,21.101,5,47,42
54,LLI,P009649,P012585,16.667,5,40,35
54,LLI,P009649,P012586,10.667,-9,23,32
54,LLI,P009680,P012585,23.534,5,53,48
54,LLI,P009680,P012586,14.884,-2,36,38
54,LLI,P012585,P012586,14.85,2,39,37
55,HTA,P003533,P004267,7.834,-8,12,20
55,HTA,P003533,P004846,7.8,-4,17,21
55,HTA,P003533,P006835,12.3,-12,23,35
55,HTA,P003533,P007759,4.95,-2,10,12
55,HTA,P003533,P010465,9.85,-11,19,30
55,HTA,P003533,P010550,4.499,-4,11,15
55,HTA,P003533,P011990,1.967,-7,0,7
55,HTA,P004267,P004846,9.134,-5,16,21
55,HTA,P004267,P006835,12.6,-12,23,35
55,HTA,P004267,P007759,11.833,-5,25,30
55,HTA,P004267,P010465,9.3,-9,14,23
55,HTA,P004267,P010550,6.266,-4,12,16
55,HTA,P004267,P011973,7.433,-4,13,17
55,HTA,P004267,P011990,4.4,-9,7,16
55,HTA,P004267,P012592,0.6,0,2,2
55,HTA,P004846,P006835,12.15,-9,19,28
55,HTA,P004846,P007759,18.351,-12,40,52
55,HTA,P004846,P010465,17.984,-13,41,54
55,HTA,P004846,P010550,18.533,-15,43,58
55,HTA,P004846,P011973,17.584,-14,36,50
55,HTA,P006835,P007759,13.883,-10,28,38
55,HTA,P006835,P010465,17.717,-10,38,48
55,HTA,P006835,P010550,13.182,-8,32,40
55,HTA,P006835,P011973,10.8,-4,22,26
55,HTA,P006835,P011990,7.5,-7,17,24
55,HTA,P006835,P012592,0.6,0,2,2
55,HTA,P007759,P010465,18.1,-9,45,54
55,HTA,P007759,P010550,22.183,-18,51,69
55,HTA,P007759,P011973,21.667,-15,48,63
55,HTA,P007759,P011990,3.233,-5,7,12
55,HTA,P007759,P012592,0.6,0,2,2
55,HTA,P010465,P010550,22.216,-10,60,70
55,HTA,P010465,P011973,18.034,-4,45,49
55,HTA,P010465,P011990,4.267,-2,10,12
55,HTA,P010550,P011973,22.017,-11,53,64
55,HTA,P010550,P011990,3.1,2,10,8
55,HTA,P011973,P011990,4.933,0,15,15
55,HTA,P011990,P012592,0.6,0,2,2
55,PRS,P003481,P005793,9.35,0,18,18
55,PRS,P003481,P009556,12.283,7,32,25
55,PRS,P003481,P010801,0.883,4,5,1
55,PRS,P003481,P012608,1.317,-2,3,5
55,PRS,P003481,P012609,12.717,1,30,29
55,PRS,P003481,P012610,1.317,-2,3,5
55,PRS,P003481,P012611,2.933,7,14,7
55,PRS,P003481,P012613,1.317,-2,3,5
55,PRS,P003481,P012640,12.283,7,32,25
55,PRS,P004512,P005793,2.0,-1,5,6
55,PRS,P004512,P009556,2.0,-1,5,6
55,PRS,P004512,P012608,15.0,18,46,28
55,PRS,P004512,P012609,6.033,5,17,12
55,PRS,P004512,P012610,15.0,18,46,28
55,PRS,P004512,P012611,10.967,12,34,22
55,PRS,P004512,P012613,15.0,18,46,28
55,PRS,P004512,P012640,2.0,-1,5,6
55,PRS,P005793,P009556,11.35,-1,23,24
55,PRS,P005793,P012608,6.933,5,20,15
55,PRS,P005793,P012609,11.35,-1,23,24
55,PRS,P005793,P012610,6.933,5,20,15
55,PRS,P005793,P012613,6.933,5,20,15
55,PRS,P005793,P012640,18.283,4,43,39
55,PRS,P009556,P010801,2.433,2,9,7
55,PRS,P009556,P011551,1.55,-2,4,6
55,PRS,P009556,P012609,13.4,2,32,30
55,PRS,P009556,P012611,4.483,5,18,13
55,PRS,P009556,P012640,15.833,4,41,37
55,PRS,P010801,P011551,1.55,-2,4,6
55,PRS,P010801,P012611,2.433,2,9,7
55,PRS,P010801,P012640,2.433,2,9,7
55,PRS,P011551,P012611,1.55,-2,4,6
55,PRS,P011551,P012640,1.55,-2,4,6
55,PRS,P012608,P012609,6.267,6,19,13
55,PRS,P012608,P012610,24.167,23,73,50
55,PRS,P012608,P012611,11.884,14,38,24
55,PRS,P012608,P012613,24.167,23,73,50
55,PRS,P012608,P012640,6.933,5,20,15
55,PRS,P012609,P012610,6.267,6,19,13
55,PRS,P012609,P012611,2.967,5,13,8
55,PRS,P012609,P012613,6.267,6,19,13
55,PRS,P012609,P012640,13.4,2,32,30
55,PRS,P012610,P012611,11.884,14,38,24
55,PRS,P012610,P012613,24.167,23,73,50
55,PRS,P012610,P012640,6.933,5,20,15
55,PRS,P012611,P012613,11.884,14,38,24
55,PRS,P012611,P012640,4.483,5,18,13
55,PRS,P012613,P012640,6.933,5,20,15
56,BOU,P000498,P004525,5.216,7,16,9
56,BOU,P000498,P010431,8.816,10,27,17
56,BOU,P000498,P010450,1.416,-2,1,3
56,BOU,P000498,P010718,14.6,8,45,37
56,BOU,P000498,P011836,13.883,9,38,29
56,BOU,P000498,P011837,14.316,22,44,22
56,BOU,P000498,P012619,5.616,-4,14,18
56,BOU,P000498,P012628,17.533,14,55,41
56,BOU,P004525,P010431,10.583,-5,24,29
56,BOU,P004525,P010450,5.15,-15,6,21
56,BOU,P004525,P010718,0.867,-2,2,4
56,BOU,P004525,P011161,5.367,-12,8,20
56,BOU,P004525,P011836,0.617,-2,0,2
56,BOU,P004525,P011837,4.333,10,14,4
56,BOU,P004525,P012619,5.383,-13,8,21
56,BOU,P004525,P012628,4.816,12,18,6
56,BOU,P010431,P010450,10.833,-15,20,35
56,BOU,P010431,P010718,13.567,-6,32,38
56,BOU,P010431,P011161,17.633,-17,34,51
56,BOU,P010431,P011836,11.366,-7,20,27
56,BOU,P010431,P011837,10.816,14,27,13
56,BOU,P010431,P012619,13.566,-13,30,43
56,BOU,P010431,P012628,8.616,11,30,19
56,BOU,P010450,P010718,6.217,-2,15,17
56,BOU,P010450,P011161,10.734,-14,21,35
56,BOU,P010450,P011836,3.133,-4,5,9
56,BOU,P010450,P011837,0.75,2,2,0
56,BOU,P010450,P012619,10.367,-14,18,32
56,BOU,P010718,P011161,12.517,-11,22,33
56,BOU,P010718,P011836,21.75,-6,48,54
56,BOU,P010718,P011837,15.666,10,39,29
56,BOU,P010718,P012619,9.384,-5,24,29
56,BOU,P010718,P012628,13.9,2,41,39
56,BOU,P011161,P011836,11.033,-13,17,30
56,BOU,P011161,P011837,6.583,0,11,11
56,BOU,P011161,P012619,11.417,-14,23,37
56,BOU,P011161,P012628,3.316,1,8,7
56,BOU,P011836,P011837,16.566,12,41,29
56,BOU,P011836,P012619,6.533,-8,12,20
56,BOU,P011836,P012628,14.783,3,39,36
56,BOU,P011837,P012628,14.566,18,42,24
56,BOU,P012619,P012628,5.866,-1,19,20
56,LKB,P002012,P004664,16.65,-5,37,42
56,LKB,P002012,P005521,6.7,0,18,18
56,LKB,P002012,P006230,19.917,3,51,48
56,LKB,P002012,P007029,21.817,1,50,49
56,LKB,P002012,P008856,9.751,-1,19,20
56,LKB,P002012,P010190,2.317,-3,5,8
56,LKB,P002012,P010461,7.517,-6,10,16
56,LKB,P002012,PLXI,25.067,-1,54,55
56,LKB,P004664,P005521,7.333,4,26,22
56,LKB,P004664,P006230,16.833,6,45,39
56,LKB,P004664,P006901,4.516,0,18,18
56,LKB,P004664,P007029,22.716,0,62,62
56,LKB,P004664,P010190,1.5,-4,0,4
56,LKB,P004664,P010461,7.383,-10,17,27
56,LKB,P004664,PLXI,19.933,-7,43,50
56,LKB,P005521,P006230,10.034,0,26,26
56,LKB,P005521,P006901,7.35,4,25,21
56,LKB,P005521,P007029,9.366,18,40,22
56,LKB,P005521,P008856,10.617,2,25,23
56,LKB,P005521,P010190,4.334,-9,5,14
56,LKB,P005521,P010461,8.332,6,27,21
56,LKB,P005521,PLXI,11.866,11,32,21
56,LKB,P006230,P006901,4.0,1,11,10
56,LKB,P006230,P007029,17.05,14,51,37
56,LKB,P006230,P008856,7.751,0,19,19
56,LKB,P006230,P010190,4.334,-9,5,14
56,LKB,P006230,PLXI,18.417,9,48,39
56,LKB,P006901,P007029,3.633,7,21,14
56,LKB,P006901,P008856,3.117,2,8,6
56,LKB,P006901,P010190,2.017,-6,0,6
56,LKB,P006901,P010461,3.016,-2,12,14
56,LKB,P006901,PLXI,2.883,2,9,7
56,LKB,P007029,P008856,6.634,10,17,7
56,LKB,P007029,P010461,12.716,-4,30,34
56,LKB,P007029,PLXI,27.6,6,65,59
56,LKB,P008856,P010190,2.834,-5,5,10
56,LKB,P008856,P010461,6.383,2,11,9
56,LKB,P008856,PLXI,11.917,10,28,18
56,LKB,P010461,PLXI,13.849,-6,25,31
57,CAN,P001607,P003637,3.783,-6,2,8
57,CAN,P001607,P004160,13.049,12,32,20
57,CAN,P001607,P005005,18.298,0,32,32
57,CAN,P001607,P007560,7.782,-1,14,15
57,CAN,P001607,P007644,13.949,-4,20,24
57,CAN,P001607,P008121,5.5,7,16,9
57,CAN,P001607,P009864,9.367,10,23,13
57,CAN,P001607,P010385,11.182,-2,20,22
57,CAN,P001607,P010452,11.149,13,32,19
57,CAN,P001607,P010484,1.133,-1,1,2
57,CAN,P003425,P003637,1.617,-1,4,5
57,CAN,P003425,P004160,6.283,3,13,10
57,CAN,P003425,P005005,3.217,1,4,3
57,CAN,P003425,P007560,8.3,4,17,13
57,CAN,P003425,P007644,2.433,1,7,6
57,CAN,P003425,P008121,12.983,5,30,25
57,CAN,P003425,P009864,8.3,4,17,13
57,CAN,P003425,P010385,5.467,1,10,9
57,CAN,P003425,P010452,16.2,6,34,28
57,CAN,P003637,P005005,2.683,-7,0,7
57,CAN,P003637,P007644,3.1,-8,0,8
57,CAN,P003637,P008121,2.717,0,6,6
57,CAN,P003637,P009864,0.25,-2,0,2
57,CAN,P003637,P010385,5.15,-5,6,11
57,CAN,P003637,P010452,2.3,1,6,5
57,CAN,P004160,P005005,11.866,7,22,15
57,CAN,P004160,P007560,0.816,-2,0,2
57,CAN,P004160,P007644,8.766,4,21,17
57,CAN,P004160,P008121,7.466,8,23,15
57,CAN,P004160,P009864,7.117,9,20,11
57,CAN,P004160,P010385,7.666,5,14,9
57,CAN,P004160,P010452,14.299,14,35,21
57,CAN,P005005,P007560,7.782,-1,14,15
57,CAN,P005005,P007644,12.232,-5,16,21
57,CAN,P005005,P009864,6.267,6,13,7
57,CAN,P005005,P010385,13.299,-2,22,24
57,CAN,P005005,P010452,9.283,6,20,14
57,CAN,P005005,P010484,1.133,-1,1,2
57,CAN,P007560,P007644,4.749,-1,6,7
57,CAN,P007560,P008121,8.3,4,17,13
57,CAN,P007560,P009864,10.3,7,20,13
57,CAN,P007560,P010385,3.833,-1,10,11
57,CAN,P007560,P010452,11.333,4,25,21
57,CAN,P007560,P010484,1.133,-1,1,2
57,CAN,P007644,P008121,4.15,2,11,9
57,CAN,P007644,P009864,6.267,6,13,7
57,CAN,P007644,P010385,5.016,-9,2,11
57,CAN,P007644,P010452,3.733,3,11,8
57,CAN,P007644,P010484,1.133,-1,1,2
57,CAN,P008121,P009864,11.4,8,27,19
57,CAN,P008121,P010385,3.35,1,8,7
57,CAN,P008121,P010452,18.066,13,46,33
57,CAN,P009864,P010452,11.4,8,27,19
57,CAN,P010385,P010452,11.633,8,28,20
57,TTK,P005000,P005685,5.75,-2,10,12
57,TTK,P005000,P006693,16.017,-1,29,30
57,TTK,P005000,P009845,3.133,-2,2,4
57,TTK,P005000,P011239,21.633,-4,37,41
57,TTK,P005000,P011925,31.116,-7,53,60
57,TTK,P005000,P011975,2.467,-1,4,5
57,TTK,P005000,P012056,23.099,-7,39,46
57,TTK,P005000,P012697,21.249,-4,38,42
57,TTK,P005685,P006693,4.6,-4,9,13
57,TTK,P005685,P009845,0.283,-2,0,2
57,TTK,P005685,P011925,6.033,-4,10,14
57,TTK,P005685,P012056,6.033,-4,10,14
57,TTK,P005685,P012697,1.433,0,1,1
57,TTK,P006693,P009845,5.35,-6,10,16
57,TTK,P006693,P011239,16.567,-2,30,32
57,TTK,P006693,P011925,24.05,-7,45,52
57,TTK,P006693,P011975,7.8,-1,12,13
57,TTK,P006693,P012056,19.066,-9,31,40
57,TTK,P006693,P012697,6.15,2,14,12
57,TTK,P009845,P011239,8.2,-6,12,18
57,TTK,P009845,P011925,7.633,-8,12,20
57,TTK,P009845,P011975,1.8,0,2,2
57,TTK,P009845,P012056,4.4,-6,8,14
57,TTK,P009845,P012697,3.133,-2,2,4
57,TTK,P011239,P011925,29.383,-8,53,61
57,TTK,P011239,P011975,7.8,-1,12,13
57,TTK,P011239,P012056,21.266,-8,37,45
57,TTK,P011239,P012697,16.083,-3,31,34
57,TTK,P011925,P011975,6.95,-1,12,13
57,TTK,P011925,P012056,30.182,-13,53,66
57,TTK,P011925,P012697,21.249,-4,38,42
57,TTK,P011975,P012056,4.383,0,6,6
57,TTK,P012056,P012697,15.699,-5,28,33
58,TRN,P001479,P005059,13.018,5,33,28
58,TRN,P001479,P006382,5.567,4,16,12
58,TRN,P001479,P009903,0.417,0,0,0
58,TRN,P001479,P012593,5.634,4,15,11
58,TRN,P001479,P012595,3.134,-3,2,5
58,TRN,P001479,P012596,12.318,5,33,28
58,TRN,P001479,P012597,11.984,5,33,28
58,TRN,P005059,P005738,13.333,10,32,22
58,TRN,P005059,P006382,7.417,3,19,16
58,TRN,P005059,P007828,0.5,-3,0,3
58,TRN,P005059,P009903,10.883,9,23,14
58,TRN,P005059,P012593,8.034,7,20,13
58,TRN,P005059,P012594,0.417,1,3,2
58,TRN,P005059,P012595,14.2,7,28,21
58,TRN,P005059,P012596,15.185,6,42,36
58,TRN,P005059,P012597,22.417,15,60,45
58,TRN,P005738,P006382,1.85,-1,3,4
58,TRN,P005738,P007828,2.834,-7,2,9
58,TRN,P005738,P009903,23.417,5,42,37
58,TRN,P005738,P012593,8.267,-1,14,15
58,TRN,P005738,P012594,14.068,-5,22,27
58,TRN,P005738,P012595,22.85,8,45,37
58,TRN,P005738,P012596,3.567,-1,9,10
58,TRN,P005738,P012597,17.75,8,35,27
58,TRN,P006382,P009903,0.883,2,2,0
58,TRN,P006382,P012595,0.5,0,0,0
58,TRN,P006382,P012596,6.251,1,17,16
58,TRN,P006382,P012597,7.2,3,19,16
58,TRN,P007828,P009903,2.834,-7,2,9
58,TRN,P007828,P012594,2.334,-4,2,6
58,TRN,P007828,P012595,1.667,-5,2,7
58,TRN,P007828,P012597,1.167,-2,0,2
58,TRN,P009903,P012593,7.567,1,14,13
58,TRN,P009903,P012594,12.951,-4,19,23
58,TRN,P009903,P012595,21.784,5,40,35
58,TRN,P009903,P012597,14.6,9,26,17
58,TRN,P012593,P012594,5.867,-4,9,13
58,TRN,P012593,P012595,8.384,1,14,13
58,TRN,P012593,P012596,6.334,2,15,13
58,TRN,P012593,P012597,5.517,2,15,13
58,TRN,P012594,P012595,11.784,-2,19,21
58,TRN,P012594,P012596,1.117,-1,3,4
58,TRN,P012594,P012597,7.734,-1,11,12
58,TRN,P012595,P012596,3.917,0,7,7
58,TRN,P012595,P012597,15.716,9,31,22
58,TRN,P012596,P012597,14.851,4,42,38
58,WRO,P003034,P005531,3.901,-7,4,11
58,WRO,P003034,P011165,12.768,-10,22,32
58,WRO,P003034,P011900,6.217,-7,8,15
58,WRO,P003034,P011901,3.584,-7,4,11
58,WRO,P003034,P011902,4.567,0,10,10
58,WRO,P003034,P012010,9.184,-3,18,21
58,WRO,P003034,P012699,10.851,-6,22,28
58,WRO,P005531,P009896,25.733,4,51,47
58,WRO,P005531,P011165,13.768,-1,28,29
58,WRO,P005531,P011900,14.001,-7,23,30
58,WRO,P005531,P011901,7.251,-7,10,17
58,WRO,P005531,P011902,3.383,-2,2,4
58,WRO,P005531,P012010,21.367,2,44,42
58,WRO,P005531,P012699,13.184,-3,30,33
58,WRO,P005531,P012736,17.616,5,36,31
58,WRO,P009896,P011165,9.45,7,22,15
58,WRO,P009896,P011900,12.484,-2,21,23
58,WRO,P009896,P011901,3.667,0,6,6
58,WRO,P009896,P011902,3.383,-2,2,4
58,WRO,P009896,P012010,21.45,3,42,39
58,WRO,P009896,P012699,12.017,0,26,26
58,WRO,P009896,P012736,18.016,6,34,28
58,WRO,P011165,P011900,8.451,-9,12,21
58,WRO,P011165,P011901,7.251,-7,10,17
58,WRO,P011165,P011902,5.45,-2,10,12
58,WRO,P011165,P012010,13.951,2,33,31
58,WRO,P011165,P012699,14.568,-2,34,36
58,WRO,P011165,P012736,4.883,6,13,7
58,WRO,P011900,P011901,3.734,-5,2,7
58,WRO,P011900,P011902,0.267,-2,0,2
58,WRO,P011900,P012010,15.651,-7,29,36
58,WRO,P011900,P012699,8.934,-7,14,21
58,WRO,P011900,P012736,7.801,-2,15,17
58,WRO,P011901,P011902,0.883,-2,0,2
58,WRO,P011901,P012699,2.634,0,8,8
58,WRO,P011902,P012010,7.334,-2,12,14
58,WRO,P011902,P012699,4.834,-2,10,12
58,WRO,P011902,P012736,2.767,-2,2,4
58,WRO,P012010,P012699,19.068,-9,37,46
58,WRO,P012010,P012736,17.267,2,33,31
58,WRO,P012699,P012736,6.45,-3,11,14
59,CLU,P004862,P005113,20.833,12,47,35
59,CLU,P004862,P005373,10.884,-9,17,26
59,CLU,P004862,P005714,9.767,-9,17,26
59,CLU,P004862,P010569,22.384,12,51,39
59,CLU,P004862,P011797,21.95,11,51,40
59,CLU,P004862,P011801,10.716,-3,18,21
59,CLU,P004862,P012620,0.934,1,4,3
59,CLU,P004862,P012621,12.034,-3,22,25
59,CLU,P004862,P012698,18.234,0,37,37
59,CLU,P005113,P005714,3.083,-8,2,10
59,CLU,P005113,P010569,18.15,20,45,25
59,CLU,P005113,P011797,18.383,16,43,27
59,CLU,P005113,P011801,5.166,-1,9,10
59,CLU,P005113,P012620,0.717,1,2,1
59,CLU,P005113,P012621,8.65,5,18,13
59,CLU,P005113,P012698,9.95,3,22,19
59,CLU,P005373,P005714,14.533,7,33,26
59,CLU,P005373,P010569,4.017,-8,4,12
59,CLU,P005373,P011797,9.65,-4,19,23
59,CLU,P005373,P011801,13.616,6,29,23
59,CLU,P005373,P012620,1.983,7,9,2
59,CLU,P005373,P012621,5.25,-8,4,12
59,CLU,P005373,P012698,14.267,5,33,28
59,CLU,P005714,P010569,0.217,0,2,2
59,CLU,P005714,P011797,7.55,-1,15,16
59,CLU,P005714,P011801,16.149,1,31,30
59,CLU,P005714,P012620,2.2,7,11,4
59,CLU,P005714,P012621,2.3,0,4,4
59,CLU,P005714,P012698,15.533,-1,33,34
59,CLU,P010569,P011797,20.483,13,47,34
59,CLU,P010569,P011801,2.633,4,7,3
59,CLU,P010569,P012620,0.934,1,4,3
59,CLU,P010569,P012621,12.034,-3,22,25
59,CLU,P010569,P012698,8.684,9,22,13
59,CLU,P011797,P011801,8.716,5,18,13
59,CLU,P011797,P012621,12.216,-2,20,22
59,CLU,P011797,P012698,13.184,10,35,25
59,CLU,P011801,P012620,1.983,7,9,2
59,CLU,P011801,P012621,2.083,0,2,2
59,CLU,P011801,P012698,14.066,1,29,28
59,CLU,P012620,P012621,0.934,1,4,3
59,CLU,P012620,P012698,1.983,7,9,2
59,CLU,P012621,P012698,0.967,-2,0,2
59,ULM,P005422,P006997,4.067,-13,0,13
59,ULM,P005422,P007952,5.484,-8,9,17
59,ULM,P005422,P010106,9.916,1,17,16
59,ULM,P005422,P010582,9.367,-6,14,20
59,ULM,P005422,P010726,0.484,-1,2,3
59,ULM,P005422,P011457,4.933,-2,11,13
59,ULM,P005422,P012603,12.051,-5,20,25
59,ULM,P005422,P012604,15.15,-8,22,30
59,ULM,P005422,P012629,10.983,-11,15,26
59,ULM,P005422,P012703,10.901,-19,14,33
59,ULM,P006997,P007952,3.617,-11,4,15
59,ULM,P006997,P010726,0.867,-6,0,6
59,ULM,P006997,P011457,3.034,-1,6,7
59,ULM,P006997,P012604,3.5,-3,2,5
59,ULM,P006997,P012629,6.917,-14,6,20
59,ULM,P006997,P012703,7.334,-16,6,22
59,ULM,P007952,P010106,0.367,2,2,0
59,ULM,P007952,P010582,1.534,-2,2,4
59,ULM,P007952,P010726,1.867,-7,2,9
59,ULM,P007952,P011457,2.5,2,7,5
59,ULM,P007952,P012603,4.201,-5,6,11
59,ULM,P007952,P012604,0.017,0,0,0
59,ULM,P007952,P012629,6.9,-14,9,23
59,ULM,P007952,P012703,8.317,-17,11,28
59,ULM,P010106,P010582,22.933,10,50,40
59,ULM,P010106,P010726,3.017,-2,2,4
59,ULM,P010106,P011457,12.666,19,37,18
59,ULM,P010106,P012603,23.033,14,52,38
59,ULM,P010106,P012604,24.299,13,53,40
59,ULM,P010106,P012629,2.433,3,7,4
59,ULM,P010582,P010726,4.167,-6,2,8
59,ULM,P010582,P011457,12.216,17,35,18
59,ULM,P010582,P012603,23.184,1,47,46
59,ULM,P010582,P012604,23.3,4,48,44
59,ULM,P010582,P012629,0.7,-2,2,4
59,ULM,P010582,P012703,1.867,-8,0,8
59,ULM,P010726,P011457,0.217,-2,0,2
59,ULM,P010726,P012603,4.234,-5,4,9
59,ULM,P010726,P012604,3.017,-2,2,4
59,ULM,P010726,P012629,0.45,-4,0,4
59,ULM,P010726,P012703,2.084,-9,2,11
59,ULM,P011457,P012603,11.033,18,34,16
59,ULM,P011457,P012604,16.066,17,44,27
59,ULM,P011457,P012629,6.35,2,16,14
59,ULM,P011457,P012703,6.117,-2,14,16
59,ULM,P012603,P012604,23.767,10,52,42
59,ULM,P012603,P012629,5.4,1,11,10
59,ULM,P012603,P012703,4.901,-9,6,15
59,ULM,P012604,P012629,8.5,0,16,16
59,ULM,P012604,P012703,6.784,-7,9,16
59,ULM,P012629,P012703,12.967,-17,18,35
60,ARI,P002867,P003240,15.95,-5,22,27
60,ARI,P002867,P004292,6.3,-6,4,10
60,ARI,P002867,P010387,2.417,3,6,3
60,ARI,P002867,P012615,12.884,6,19,13
60,ARI,P002867,P012616,3.9,0,4,4
60,ARI,P002867,P012702,19.167,4,24,20
60,ARI,P002867,P012707,7.633,-9,6,15
60,ARI,P002867,P012708,14.934,2,20,18
60,ARI,P002867,P012716,15.083,-9,12,21
60,ARI,P002867,P012760,7.2,-10,7,17
60,ARI,P003240,P004292,0.583,0,0,0
60,ARI,P003240,P010387,2.417,3,6,3
60,ARI,P003240,P012615,18.266,10,39,29
60,ARI,P003240,P012616,8.283,9,25,16
60,ARI,P003240,P012702,15.383,0,20,20
60,ARI,P003240,P012707,10.299,-6,15,21
60,ARI,P003240,P012708,22.999,7,49,42
60,ARI,P003240,P012716,9.949,-9,12,21
60,ARI,P003240,P012760,14.199,3,36,33
60,ARI,P004292,P012615,0.583,0,0,0
60,ARI,P004292,P012616,3.9,0,4,4
60,ARI,P004292,P012702,2.75,4,4,0
60,ARI,P004292,P012707,2.4,-6,0,6
60,ARI,P004292,P012708,0.583,0,0,0
60,ARI,P004292,P012716,6.3,-6,4,10
60,ARI,P004292,P012760,4.133,-10,0,10
60,ARI,P010387,P012702,2.417,3,6,3
60,ARI,P010387,P012707,2.417,3,6,3
60,ARI,P012615,P012616,8.283,9,25,16
60,ARI,P012615,P012702,11.817,3,14,11
60,ARI,P012615,P012707,0.933,-2,0,2
60,ARI,P012615,P012708,19.767,16,43,27
60,ARI,P012615,P012716,4.534,6,6,0
60,ARI,P012615,P012760,9.933,12,30,18
60,ARI,P012616,P012702,2.75,4,4,0
60,ARI,P012616,P012707,0.933,-2,0,2
60,ARI,P012616,P012708,6.833,11,25,14
60,ARI,P012616,P012716,4.417,0,4,4
60,ARI,P012616,P012760,9.433,5,25,20
60,ARI,P012702,P012707,6.133,0,9,9
60,ARI,P012702,P012708,12.817,5,16,11
60,ARI,P012702,P012716,9.566,5,11,6
60,ARI,P012707,P012708,5.399,-1,9,10
60,ARI,P012707,P012716,9.982,-13,9,22
60,ARI,P012707,P012760,7.199,-12,6,18
60,ARI,P012708,P012716,10.833,1,16,15
60,ARI,P012708,P012760,14.299,7,38,31
60,ARI,P012716,P012760,10.8,-15,10,25
60,BUD,P004945,P007398,20.683,8,38,30
60,BUD,P004945,P009214,1.133,0,3,3
60,BUD,P004945,P010248,8.1,10,17,7
60,BUD,P004945,P010432,22.733,5,40,35
60,BUD,P004945,P011935,30.217,15,54,39
60,BUD,P004945,P012605,9.483,4,15,11
60,BUD,P004945,P012606,21.867,11,42,31
60,BUD,P004945,P012630,11.184,7,19,12
60,BUD,P006566,P009214,2.6,-4,4,8
60,BUD,P006566,P010248,2.6,-4,4,8
60,BUD,P006566,P010432,1.067,-3,2,5
60,BUD,P006566,P011935,1.067,-3,2,5
60,BUD,P006566,P012605,1.983,-1,4,5
60,BUD,P006566,P012606,1.684,-6,2,8
60,BUD,P006566,P012630,3.667,-7,6,13
60,BUD,P007398,P010432,22.383,1,38,37
60,BUD,P007398,P011935,22.9,1,38,37
60,BUD,P007398,P012605,1.483,-4,0,4
60,BUD,P007398,P012606,21.417,5,38,33
60,BUD,P007398,P012630,2.734,-7,0,7
60,BUD,P009214,P010248,3.733,-4,7,11
60,BUD,P009214,P012605,3.116,-1,7,8
60,BUD,P009214,P012606,0.617,-3,0,3
60,BUD,P009214,P012630,3.733,-4,7,11
60,BUD,P010248,P011935,9.734,7,14,7
60,BUD,P010248,P012605,12.75,4,19,15
60,BUD,P010248,P012606,3.484,-4,2,6
60,BUD,P010248,P012630,13.467,3,21,18
60,BUD,P010432,P011935,26.017,-5,42,47
60,BUD,P010432,P012605,1.483,-4,0,4
60,BUD,P010432,P012606,24.534,-1,42,43
60,BUD,P010432,P012630,5.851,-13,4,17
60,BUD,P011935,P012605,11.117,1,12,11
60,BUD,P011935,P012606,27.918,-2,44,46
60,BUD,P011935,P012630,16.102,-6,18,24
60,BUD,P012605,P012606,2.767,-3,0,3
60,BUD,P012605,P012630,12.75,4,19,15
60,BUD,P012606,P012630,9.852,-17,6,23
61,HTA,P003533,P004267,9.517,-2,17,19
61,HTA,P003533,P004846,13.251,-1,24,25
61,HTA,P003533,P006835,11.017,-8,19,27
61,HTA,P003533,P007759,8.717,-1,16,17
61,HTA,P003533,P010465,7.284,0,18,18
61,HTA,P003533,P011990,1.95,-3,1,4
61,HTA,P003533,P011991,13.8,-5,25,30
61,HTA,P004267,P004846,10.835,-1,26,27
61,HTA,P004267,P006835,6.034,-5,12,17
61,HTA,P004267,P007759,7.317,-10,13,23
61,HTA,P004267,P010465,3.784,1,9,8
61,HTA,P004267,P011973,3.084,-2,9,11
61,HTA,P004267,P011990,0.95,4,4,0
61,HTA,P004267,P011991,11.351,-9,22,31
61,HTA,P004846,P006835,20.568,-7,46,53
61,HTA,P004846,P007759,17.651,-4,43,47
61,HTA,P004846,P010465,14.584,-7,34,41
61,HTA,P004846,P011973,13.234,-3,36,39
61,HTA,P004846,P011990,2.9,1,5,4
61,HTA,P004846,P011991,17.985,-10,34,44
61,HTA,P006835,P007759,22.817,-1,56,57
61,HTA,P006835,P010465,20.667,-4,50,54
61,HTA,P006835,P011973,20.534,4,52,48
61,HTA,P006835,P011990,5.667,0,10,10
61,HTA,P006835,P011991,23.968,-11,47,58
61,HTA,P007759,P010465,16.567,1,44,43
61,HTA,P007759,P011973,17.15,1,47,46
61,HTA,P007759,P011991,18.317,-2,41,43
61,HTA,P010465,P011973,16.517,-1,41,42
61,HTA,P010465,P011990,2.767,-1,5,6
61,HTA,P010465,P011991,15.634,-1,35,36
61,HTA,P011973,P011990,3.717,3,9,6
61,HTA,P011973,P011991,15.168,-2,34,36
61,HTA,P011990,P011991,4.717,-4,6,10
61,PMT,P001686,P002644,7.65,10,21,11
61,PMT,P001686,P011823,13.701,6,37,31
61,PMT,P001686,P011944,9.468,15,30,15
61,PMT,P001686,P011947,7.967,2,19,17
61,PMT,P001686,P011966,13.317,14,39,25
61,PMT,P001686,P012599,17.051,11,44,33
61,PMT,P001686,P012600,16.25,6,42,36
61,PMT,P002020,P002644,7.2,1,17,16
61,PMT,P002020,P011823,0.867,4,4,0
61,PMT,P002020,P011943,3.234,0,9,9
61,PMT,P002020,P011944,4.833,5,12,7
61,PMT,P002020,P011947,2.55,2,7,5
61,PMT,P002020,P011966,5.517,3,14,11
61,PMT,P002020,P012599,2.883,-4,3,7
61,PMT,P002020,P012600,5.184,9,18,9
61,PMT,P002644,P011943,4.151,-1,10,11
61,PMT,P002644,P011944,10.483,10,25,15
61,PMT,P002644,P011947,7.7,-8,9,17
61,PMT,P002644,P011966,12.667,10,30,20
61,PMT,P002644,P012599,14.133,1,25,24
61,PMT,P002644,P012600,9.816,1,19,18
61,PMT,P011823,P011943,1.8,-4,5,9
61,PMT,P011823,P011944,12.485,2,36,34
61,PMT,P011823,P011947,10.451,5,31,26
61,PMT,P011823,P011966,11.034,-2,28,30
61,PMT,P011823,P012599,14.585,-2,36,38
61,PMT,P011823,P012600,21.285,3,59,56
61,PMT,P011943,P011944,2.717,-5,6,11
61,PMT,P011943,P011947,0.917,-1,1,2
61,PMT,P011943,P011966,5.034,-4,14,18
61,PMT,P011943,P012599,1.584,-4,1,5
61,PMT,P011943,P012600,4.367,-1,14,15
61,PMT,P011944,P011947,13.084,2,35,33
61,PMT,P011944,P011966,9.817,10,26,16
61,PMT,P011944,P012599,14.251,5,33,28
61,PMT,P011944,P012600,14.734,4,41,37
61,PMT,P011947,P011966,1.917,-4,0,4
61,PMT,P011947,P012599,11.684,-13,19,32
61,PMT,P011947,P012600,16.334,3,39,36
61,PMT,P011966,P012599,18.884,8,42,34
61,PMT,P011966,P012600,16.617,-3,39,42
61,PMT,P012599,P012600,19.817,-6,41,47
62,JOV,P002361,P005094,21.984,-15,38,53
62,JOV,P002361,P006771,17.551,0,36,36
62,JOV,P002361,P009572,15.985,10,36,26
62,JOV,P002361,P010161,17.984,2,39,37
62,JOV,P002361,P010708,16.418,3,36,33
62,JOV,P002361,P010709,15.068,13,35,22
62,JOV,P002361,P011248,19.434,-9,37,46
62,JOV,P002361,P012349,18.184,0,35,35
62,JOV,P005094,P006771,16.75,-12,27,39
62,JOV,P005094,P009572,10.65,-5,25,30
62,JOV,P005094,P010161,9.782,-10,20,30
62,JOV,P005094,P010708,17.067,-1,36,37
62,JOV,P005094,P010709,8.367,1,19,18
62,JOV,P005094,P011248,19.866,-21,35,56
62,JOV,P005094,P012349,10.666,-17,16,33
62,JOV,P006771,P009572,10.584,-9,22,31
62,JOV,P006771,P010161,7.083,-8,14,22
62,JOV,P006771,P010708,14.984,7,35,28
62,JOV,P006771,P010709,6.917,-1,14,15
62,JOV,P006771,P011248,16.15,-4,34,38
62,JOV,P006771,P012349,9.317,-13,14,27
62,JOV,P009572,P010161,16.334,13,42,29
62,JOV,P009572,P010708,6.55,-2,15,17
62,JOV,P009572,P010709,7.4,20,24,4
62,JOV,P009572,P011248,12.767,-15,24,39
62,JOV,P009572,P012349,17.334,4,40,36
62,JOV,P010161,P010708,1.05,0,2,2
62,JOV,P010161,P010709,9.117,22,29,7
62,JOV,P010161,P011248,11.349,-24,14,38
62,JOV,P010161,P012349,21.433,1,48,47
62,JOV,P010708,P010709,6.401,-1,14,15
62,JOV,P010708,P011248,16.334,6,38,32
62,JOV,P010709,P011248,3.084,2,8,6
62,JOV,P010709,P012349,10.25,20,29,9
62,JOV,P011248,P012349,9.816,-27,10,37
62,PRS,P003481,P005793,10.283,-10,23,33
62,PRS,P003481,P009556,10.4,-10,23,33
62,PRS,P003481,P012608,1.633,-1,4,5
62,PRS,P003481,P012609,12.033,-11,27,38
62,PRS,P003481,P012610,1.75,-1,4,5
62,PRS,P003481,P012611,0.75,0,2,2
62,PRS,P003481,P012640,11.283,-11,25,36
62,PRS,P004512,P005793,2.383,-6,0,6
62,PRS,P004512,P012608,23.033,4,44,40
62,PRS,P004512,P012609,13.05,12,31,19
62,PRS,P004512,P012610,23.033,4,44,40
62,PRS,P004512,P012611,18.066,-5,30,35
62,PRS,P004512,P012613,7.6,-2,13,15
62,PRS,P004512,P012640,4.967,9,14,5
62,PRS,P005793,P009556,14.1,-1,37,38
62,PRS,P005793,P012608,6.316,0,12,12
62,PRS,P005793,P012609,14.1,-1,37,38
62,PRS,P005793,P012610,6.316,0,12,12
62,PRS,P005793,P012611,2.383,-6,0,6
62,PRS,P005793,P012612,7.75,15,26,11
62,PRS,P005793,P012640,18.033,5,49,44
62,PRS,P009556,P012609,14.217,-1,37,38
62,PRS,P009556,P012610,0.117,0,0,0
62,PRS,P009556,P012612,3.817,9,14,5
62,PRS,P009556,P012640,14.217,-1,37,38
62,PRS,P012608,P012609,16.866,10,39,29
62,PRS,P012608,P012610,30.782,8,64,56
62,PRS,P012608,P012611,19.866,-4,36,40
62,PRS,P012608,P012612,5.066,4,12,8
62,PRS,P012608,P012613,7.6,-2,13,15
62,PRS,P012608,P012640,11.966,13,32,19
62,PRS,P012609,P012610,16.983,10,39,29
62,PRS,P012609,P012611,9.883,4,23,19
62,PRS,P012609,P012612,4.95,7,14,7
62,PRS,P012609,P012640,22.25,6,57,51
62,PRS,P012610,P012611,19.866,-4,36,40
62,PRS,P012610,P012612,5.066,4,12,8
62,PRS,P012610,P012613,7.6,-2,13,15
62,PRS,P012610,P012640,12.083,13,32,19
62,PRS,P012611,P012613,7.6,-2,13,15
62,PRS,P012611,P012640,1.05,1,4,3
62,PRS,P012612,P012640,8.883,13,26,13
63,BES,P003783,P005348,4.633,-13,0,13
63,BES,P003783,P007914,6.084,-4,7,11
63,BES,P003783,P007917,1.9,-8,0,8
63,BES,P003783,P008945,0.6,0,2,2
63,BES,P003783,P009582,3.167,2,5,3
63,BES,P003783,P011357,2.417,-2,2,4
63,BES,P003783,P011379,6.283,-9,5,14
63,BES,P003783,P011936,8.217,-7,9,16
63,BES,P003783,P012622,9.35,-21,4,25
63,BES,P003783,P012647,2.617,-6,2,8
63,BES,P005348,P007914,0.1,0,0,0
63,BES,P005348,P007917,1.9,-8,0,8
63,BES,P005348,P008945,13.634,14,34,20
63,BES,P005348,P009582,12.201,13,30,17
63,BES,P005348,P011379,2.616,-7,0,7
63,BES,P005348,P011936,11.35,5,23,18
63,BES,P005348,P012622,13.1,-1,23,24
63,BES,P005348,P012647,13.534,1,26,25
63,BES,P007914,P008945,13.666,-6,30,36
63,BES,P007914,P009582,15.633,-2,35,37
63,BES,P007914,P011357,2.417,-2,2,4
63,BES,P007914,P011379,4.3,-7,5,12
63,BES,P007914,P011936,15.1,-7,26,33
63,BES,P007914,P012622,8.767,-11,13,24
63,BES,P007914,P012647,12.933,-1,30,31
63,BES,P007917,P011379,0.933,-5,0,5
63,BES,P007917,P012622,1.9,-8,0,8
63,BES,P007917,P012647,0.967,-3,0,3
63,BES,P008945,P009582,26.05,15,67,52
63,BES,P008945,P011379,2.116,1,7,6
63,BES,P008945,P011936,20.816,11,51,40
63,BES,P008945,P012622,15.2,15,43,28
63,BES,P008945,P012647,25.05,6,58,52
63,BES,P009582,P011357,1.267,1,2,1
63,BES,P009582,P011379,4.016,2,10,8
63,BES,P009582,P011936,19.55,16,50,34
63,BES,P009582,P012622,13.167,14,37,23
63,BES,P009582,P012647,21.817,7,52,45
63,BES,P011357,P011936,2.417,-2,2,4
63,BES,P011357,P012622,1.15,-3,0,3
63,BES,P011379,P011936,6.266,-1,12,13
63,BES,P011379,P012622,7.066,-6,9,15
63,BES,P011936,P012622,12.383,1,23,22
63,BES,P011936,P012647,17.633,0,36,36
63,BES,P012622,P012647,13.717,-4,28,32
63,LLI,P004479,P004773,9.1,5,19,14
63,LLI,P004479,P005247,15.684,7,34,27
63,LLI,P004479,P006600,9.583,-1,19,20
63,LLI,P004479,P009680,12.483,5,28,23
63,LLI,P004479,P012020,11.817,10,28,18
63,LLI,P004479,P012585,16.783,9,39,30
63,LLI,P004479,P012586,10.15,1,21,20
63,LLI,P004773,P005247,8.734,7,16,9
63,LLI,P004773,P006600,12.749,6,28,22
63,LLI,P004773,P009680,11.1,2,21,19
63,LLI,P004773,P012020,3.384,3,6,3
63,LLI,P004773,P012585,6.2,5,16,11
63,LLI,P004773,P012586,13.333,8,30,22
63,LLI,P005247,P006600,20.383,-5,37,42
63,LLI,P005247,P009680,28.15,2,57,55
63,LLI,P005247,P012020,12.184,6,28,22
63,LLI,P005247,P012585,23.867,-6,49,55
63,LLI,P005247,P012586,21.334,-7,39,46
63,LLI,P006600,P009680,19.449,-5,38,43
63,LLI,P006600,P012585,21.233,-4,43,47
63,LLI,P006600,P012586,27.799,-3,55,58
63,LLI,P009680,P012020,11.617,4,26,22
63,LLI,P009680,P012585,21.7,-3,48,51
63,LLI,P009680,P012586,19.833,-9,38,47
63,LLI,P012020,P012585,8.8,3,22,19
63,LLI,P012020,P012586,0.934,-2,2,4
63,LLI,P012585,P012586,21.617,-8,43,51
64,HAM,P001990,P009663,1.817,1,7,6
64,HAM,P001990,P010070,2.583,-1,7,8
64,HAM,P001990,P011187,4.0,-6,7,13
64,HAM,P001990,P012579,5.5,-6,11,17
64,HAM,P001990,P012580,3.134,-2,7,9
64,HAM,P001990,P012581,1.683,0,4,4
64,HAM,P001990,P012582,4.084,-4,10,14
64,HAM,P001990,P012648,0.267,2,3,1
64,HAM,P009663,P010070,2.384,-2,2,4
64,HAM,P009663,P011168,16.75,4,39,35
64,HAM,P009663,P011187,3.634,-4,7,11
64,HAM,P009663,P012579,6.818,-1,15,16
64,HAM,P009663,P012580,11.784,7,31,24
64,HAM,P009663,P012581,16.216,8,35,27
64,HAM,P009663,P012582,19.867,8,48,40
64,HAM,P009663,P012648,10.7,1,26,25
64,HAM,P009663,P012695,5.034,2,6,4
64,HAM,P010070,P011168,2.95,1,8,7
64,HAM,P010070,P011187,10.833,-5,21,26
64,HAM,P010070,P012579,10.417,-5,21,26
64,HAM,P010070,P012580,4.8,0,6,6
64,HAM,P010070,P012581,4.866,4,12,8
64,HAM,P010070,P012582,2.4,-1,7,8
64,HAM,P010070,P012695,6.367,-3,8,11
64,HAM,P011168,P011187,7.367,5,17,12
64,HAM,P011168,P012579,7.917,1,17,16
64,HAM,P011168,P012580,8.367,2,20,18
64,HAM,P011168,P012581,14.649,8,37,29
64,HAM,P011168,P012582,19.5,3,43,40
64,HAM,P011168,P012648,12.3,-8,23,31
64,HAM,P011187,P012579,15.984,-7,32,39
64,HAM,P011187,P012580,9.467,0,17,17
64,HAM,P011187,P012581,5.416,9,17,8
64,HAM,P011187,P012582,10.301,2,25,23
64,HAM,P011187,P012648,0.717,-2,0,2
64,HAM,P011187,P012695,7.217,0,13,13
64,HAM,P012579,P012580,9.901,-2,18,20
64,HAM,P012579,P012581,6.033,-3,14,17
64,HAM,P012579,P012582,10.801,-5,22,27
64,HAM,P012579,P012648,1.15,-5,0,5
64,HAM,P012579,P012695,6.751,-3,10,13
64,HAM,P012580,P012581,9.766,13,24,11
64,HAM,P012580,P012582,14.801,8,36,28
64,HAM,P012580,P012648,2.934,-3,8,11
64,HAM,P012580,P012695,9.45,9,17,8
64,HAM,P012581,P012582,16.416,8,36,28
64,HAM,P012581,P012648,9.633,-3,18,21
64,HAM,P012581,P012695,6.45,4,11,7
64,HAM,P012582,P012648,12.567,-6,26,32
64,HAM,P012582,P012695,5.267,7,11,4
64,LJU,P001235,P002661,6.083,-1,9,10
64,LJU,P001235,P003452,17.033,11,31,20
64,LJU,P001235,P007066,3.0,-4,0,4
64,LJU,P001235,P009395,4.783,-2,6,8
64,LJU,P001235,P010771,9.733,19,27,8
64,LJU,P001235,P011261,10.733,19,27,8
64,LJU,P001235,P012598,4.783,-2,6,8
64,LJU,P001235,P012700,13.916,12,26,14
64,LJU,P002661,P003452,22.966,-15,48,63
64,LJU,P002661,P007066,9.8,-18,14,32
64,LJU,P002661,P009392,12.35,-12,24,36
64,LJU,P002661,P009395,8.399,0,16,16
64,LJU,P002661,P010594,1.0,-2,0,2
64,LJU,P002661,P010771,8.767,7,28,21
64,LJU,P002661,P011261,13.483,15,35,20
64,LJU,P002661,P012598,5.683,-2,15,17
64,LJU,P002661,P012700,19.533,-12,47,59
64,LJU,P003452,P007066,8.2,-20,9,29
64,LJU,P003452,P009392,9.333,-20,15,35
64,LJU,P003452,P009395,14.732,-9,22,31
64,LJU,P003452,P010594,2.55,-9,0,9
64,LJU,P003452,P010771,12.967,20,40,20
64,LJU,P003452,P011261,16.083,26,42,16
64,LJU,P003452,P012598,11.466,-6,21,27
64,LJU,P003452,P012700,28.466,-10,60,70
64,LJU,P007066,P009392,6.35,-13,12,25
64,LJU,P007066,P011261,2.6,2,5,3
64,LJU,P007066,P012598,0.45,-1,2,3
64,LJU,P007066,P012700,8.8,-18,14,32
64,LJU,P009392,P009395,3.583,-3,4,7
64,LJU,P009392,P010594,1.55,-7,0,7
64,LJU,P009392,P010771,2.967,-1,8,9
64,LJU,P009392,P011261,6.45,6,14,8
64,LJU,P009392,P012700,9.017,-18,19,37
64,LJU,P009395,P010594,2.55,-9,0,9
64,LJU,P009395,P011261,2.216,4,4,0
64,LJU,P009395,P012598,10.966,-6,18,24
64,LJU,P009395,P012700,11.699,-11,18,29
64,LJU,P010594,P012598,1.0,-2,0,2
64,LJU,P010594,P012700,1.55,-7,0,7
64,LJU,P010771,P011261,15.267,24,43,19
64,LJU,P010771,P012700,11.967,23,38,15
64,LJU,P011261,P012598,0.05,1,1,0
64,LJU,P011261,P012700,13.65,27,41,14
64,LJU,P012598,P012700,11.466,-6,21,27
65,VNC,P003759,P004381,14.367,3,35,32
65,VNC,P003759,P008052,4.0,2,12,10
65,VNC,P003759,P009400,6.067,-1,13,14
65,VNC,P003759,P011928,11.0,2,26,24
65,VNC,P003759,P012587,4.0,2,12,10
65,VNC,P003759,P012590,8.933,5,25,20
65,VNC,P003759,P012591,11.633,3,29,26
65,VNC,P004117,P004381,9.983,9,22,13
65,VNC,P004117,P008052,4.617,6,7,1
65,VNC,P004117,P009400,10.367,10,23,13
65,VNC,P004117,P011928,6.033,3,16,13
65,VNC,P004117,P012587,0.283,-1,0,1
65,VNC,P004117,P012590,4.667,6,7,1
65,VNC,P004117,P012591,6.65,3,17,14
65,VNC,P004381,P008052,14.35,6,31,25
65,VNC,P004381,P009400,20.95,10,47,37
65,VNC,P004381,P011928,23.966,4,58,54
65,VNC,P004381,P012587,3.6,0,9,9
65,VNC,P004381,P012590,14.833,6,32,26
65,VNC,P004381,P012591,23.283,6,58,52
65,VNC,P008052,P009400,15.517,13,33,20
65,VNC,P008052,P011928,14.35,3,32,29
65,VNC,P008052,P012587,5.6,0,14,14
65,VNC,P008052,P012590,18.517,8,39,31
65,VNC,P008052,P012591,14.917,6,36,30
65,VNC,P009400,P011928,22.717,10,55,45
65,VNC,P009400,P012590,11.067,10,21,11
65,VNC,P009400,P012591,22.651,12,56,44
65,VNC,P011928,P012587,1.883,-3,2,5
65,VNC,P011928,P012590,14.883,3,33,30
65,VNC,P011928,P012591,30.7,10,74,64
65,VNC,P012587,P012590,5.65,0,14,14
65,VNC,P012587,P012591,2.516,-2,5,7
65,VNC,P012590,P012591,15.45,6,37,31
65,WOL,P002387,P004229,11.667,-3,19,22
65,WOL,P002387,P004645,10.2,-2,23,25
65,WOL,P002387,P005516,24.851,-11,44,55
65,WOL,P002387,P006154,16.05,-10,29,39
65,WOL,P002387,P006907,3.6,-4,3,7
65,WOL,P002387,P012576,16.617,-13,29,42
65,WOL,P002387,P012577,22.583,-9,43,52
65,WOL,P002387,PLCT,19.5,-4,34,38
65,WOL,P004229,P004645,3.367,-1,8,9
65,WOL,P004229,P005516,11.967,-5,19,24
65,WOL,P004229,P006154,3.367,-1,8,9
65,WOL,P004229,P006907,2.4,-4,0,4
65,WOL,P004229,P012577,6.5,-2,11,13
65,WOL,P004229,PLCT,8.6,-4,11,15
65,WOL,P004645,P005516,8.651,-4,19,23
65,WOL,P004645,P006154,10.817,-6,23,29
65,WOL,P004645,P006907,2.767,-3,7,10
65,WOL,P004645,P012576,6.217,-4,11,15
65,WOL,P004645,P012577,8.75,-3,21,24
65,WOL,P004645,PLCT,10.567,-1,24,25
65,WOL,P005516,P006154,10.401,-10,17,27
65,WOL,P005516,P006907,2.75,-3,1,4
65,WOL,P005516,P012576,12.651,-13,19,32
65,WOL,P005516,P012577,17.234,-11,31,42
65,WOL,P005516,PLCT,15.167,-7,26,33
65,WOL,P006154,P006907,7.217,-2,19,21
65,WOL,P006154,P012576,16.667,-6,33,39
65,WOL,P006154,P012577,21.117,-9,42,51
65,WOL,P006154,PLCT,12.3,4,29,25
65,WOL,P006907,P012576,4.8,2,13,11
65,WOL,P006907,P012577,7.867,-3,20,23
65,WOL,P006907,PLCT,8.467,-3,17,20
65,WOL,P012576,P012577,19.067,-8,38,46
65,WOL,P012576,PLCT,13.117,2,29,27
65,WOL,P012577,PLCT,22.15,1,50,49
66,ARI,P002867,P003240,2.633,-2,0,2
66,ARI,P002867,P004292,4.584,8,13,5
66,ARI,P002867,P012615,10.433,-4,13,17
66,ARI,P002867,P012616,3.7,1,8,7
66,ARI,P002867,P012702,7.117,-8,5,13
66,ARI,P002867,P012707,9.45,-1,12,13
66,ARI,P002867,P012708,6.483,-4,5,9
66,ARI,P002867,P012716,7.15,-6,6,12
66,ARI,P002867,P012760,6.45,8,14,6
66,ARI,P003240,P004292,6.633,-5,9,14
66,ARI,P003240,P012615,8.866,-3,9,12
66,ARI,P003240,P012702,7.333,-2,7,9
66,ARI,P003240,P012707,1.933,-5,2,7
66,ARI,P003240,P012708,7.333,-2,7,9
66,ARI,P003240,P012716,0.4,-4,0,4
66,ARI,P003240,P012760,1.933,-5,2,7
66,ARI,P004292,P012615,12.633,-10,20,30
66,ARI,P004292,P012616,8.55,9,19,10
66,ARI,P004292,P012702,8.217,5,17,12
66,ARI,P004292,P012707,20.999,-4,37,41
66,ARI,P004292,P012708,10.517,3,20,17
66,ARI,P004292,P012716,18.816,-3,35,38
66,ARI,P004292,P012760,18.783,-3,34,37
66,ARI,P012615,P012616,3.7,1,8,7
66,ARI,P012615,P012702,12.15,-7,14,21
66,ARI,P012615,P012707,14.232,-14,20,34
66,ARI,P012615,P012708,13.699,-1,20,21
66,ARI,P012615,P012716,9.749,-18,12,30
66,ARI,P012615,P012760,10.466,-4,20,24
66,ARI,P012616,P012702,1.117,-1,2,3
66,ARI,P012616,P012707,10.016,12,23,11
66,ARI,P012616,P012716,7.433,10,17,7
66,ARI,P012616,P012760,10.016,12,23,11
66,ARI,P012702,P012707,5.884,-3,7,10
66,ARI,P012702,P012708,12.533,-2,17,19
66,ARI,P012702,P012716,5.917,-6,7,13
66,ARI,P012707,P012708,10.4,-3,16,19
66,ARI,P012707,P012716,25.083,-7,43,50
66,ARI,P012707,P012760,22.999,1,44,43
66,ARI,P012708,P012716,10.033,-6,16,22
66,ARI,P012708,P012760,5.134,3,11,8
66,ARI,P012716,P012760,18.483,0,36,36
66,BOU,P000498,P004525,1.85,-2,2,4
66,BOU,P000498,P010450,3.334,-5,2,7
66,BOU,P000498,P010718,0.767,-1,0,1
66,BOU,P000498,P011161,4.417,-6,4,10
66,BOU,P000498,P011836,1.85,-2,2,4
66,BOU,P000498,P011837,3.334,-5,2,7
66,BOU,P000498,P012628,5.184,-7,4,11
66,BOU,P004525,P010431,13.001,-5,23,28
66,BOU,P004525,P010450,3.667,-1,7,8
66,BOU,P004525,P010718,11.866,2,23,21
66,BOU,P004525,P011161,14.967,-5,27,32
66,BOU,P004525,P011836,18.367,1,38,37
66,BOU,P004525,P012617,11.434,15,33,18
66,BOU,P004525,P012628,12.784,7,27,20
66,BOU,P010431,P010450,6.534,-5,8,13
66,BOU,P010431,P010718,20.283,7,36,29
66,BOU,P010431,P011161,9.4,-5,15,20
66,BOU,P010431,P011836,21.2,6,40,34
66,BOU,P010431,P011837,14.683,9,25,16
66,BOU,P010431,P012617,20.401,6,36,30
66,BOU,P010431,P012628,5.234,3,9,6
66,BOU,P010450,P010718,6.334,0,8,8
66,BOU,P010450,P011161,2.617,-7,2,9
66,BOU,P010450,P011836,0.05,-3,0,3
66,BOU,P010450,P011837,6.551,-9,3,12
66,BOU,P010450,P012617,6.834,-2,8,10
66,BOU,P010450,P012628,4.951,-8,2,10
66,BOU,P010718,P011161,7.933,-7,10,17
66,BOU,P010718,P011836,19.499,6,36,30
66,BOU,P010718,P011837,13.967,4,21,17
66,BOU,P010718,P012617,17.133,14,34,20
66,BOU,P010718,P012628,5.55,-1,8,9
66,BOU,P011161,P011836,16.45,-1,31,32
66,BOU,P011161,P011837,4.05,0,6,6
66,BOU,P011161,P012617,4.467,7,15,8
66,BOU,P011161,P012628,11.767,4,22,18
66,BOU,P011836,P011837,11.466,13,24,11
66,BOU,P011836,P012617,17.85,22,46,24
66,BOU,P011836,P012628,12.6,14,31,17
66,BOU,P011837,P012617,13.25,5,21,16
66,BOU,P011837,P012628,4.767,-1,6,7
66,BOU,P012617,P012628,7.367,13,23,10
67,BUD,P002740,P004945,14.0,-6,19,25
67,BUD,P002740,P007398,4.65,0,5,5
67,BUD,P002740,P009214,5.833,-4,7,11
67,BUD,P002740,P010248,5.65,-4,8,12
67,BUD,P002740,P010432,16.5,-4,25,29
67,BUD,P002740,P011935,16.317,-4,26,30
67,BUD,P002740,P012605,9.9,-8,14,22
67,BUD,P002740,P012606,12.6,-1,21,22
67,BUD,P002740,P012630,3.15,-1,7,8
67,BUD,P004945,P007398,11.534,0,21,21
67,BUD,P004945,P009214,3.449,-5,10,15
67,BUD,P004945,P010248,21.567,-9,39,48
67,BUD,P004945,P010432,10.284,-6,14,20
67,BUD,P004945,P011935,28.402,-10,43,53
67,BUD,P004945,P012605,3.534,-11,2,13
67,BUD,P004945,P012606,28.317,-4,51,55
67,BUD,P004945,P012630,6.317,-9,13,22
67,BUD,P007398,P009214,4.117,0,5,5
67,BUD,P007398,P010248,10.167,-1,18,19
67,BUD,P007398,P010432,6.017,1,8,7
67,BUD,P007398,P011935,12.067,0,21,21
67,BUD,P007398,P012605,4.65,0,5,5
67,BUD,P007398,P012606,11.534,0,21,21
67,BUD,P009214,P010248,2.816,-2,10,12
67,BUD,P009214,P010432,4.75,-3,5,8
67,BUD,P009214,P012605,4.75,-3,5,8
67,BUD,P009214,P012606,2.816,-2,10,12
67,BUD,P009214,P012630,1.733,-1,8,9
67,BUD,P010248,P011935,18.751,-7,29,36
67,BUD,P010248,P012605,1.217,0,2,2
67,BUD,P010248,P012606,20.35,-9,37,46
67,BUD,P010248,P012630,5.75,-4,13,17
67,BUD,P010432,P011935,13.684,-5,23,28
67,BUD,P010432,P012605,10.467,-13,14,27
67,BUD,P010432,P012606,8.317,4,16,12
67,BUD,P010432,P012630,3.717,-6,7,13
67,BUD,P011935,P012605,6.934,-10,11,21
67,BUD,P011935,P012606,25.851,-3,43,46
67,BUD,P011935,P012630,7.734,-9,12,21
67,BUD,P012605,P012606,0.35,-1,2,3
67,BUD,P012605,P012630,4.934,-6,9,15
67,BUD,P012606,P012630,4.533,-4,11,15
67,ULM,P005422,P006997,10.434,14,35,21
67,ULM,P005422,P010106,21.834,13,47,34
67,ULM,P005422,P010582,12.983,10,29,19
67,ULM,P005422,P011457,4.151,6,11,5
67,ULM,P005422,P012603,21.583,12,50,38
67,ULM,P005422,P012604,15.3,4,26,22
67,ULM,P005422,P012629,12.751,8,32,24
67,ULM,P005422,P012703,3.9,5,14,9
67,ULM,P006997,P010106,12.883,10,33,23
67,ULM,P006997,P010582,15.299,8,34,26
67,ULM,P006997,P010726,4.25,0,5,5
67,ULM,P006997,P011457,14.0,3,28,25
67,ULM,P006997,P012603,9.283,8,27,19
67,ULM,P006997,P012604,2.783,3,5,2
67,ULM,P006997,P012629,13.767,9,37,28
67,ULM,P006997,P012703,13.633,5,28,23
67,ULM,P010106,P010582,17.349,11,35,24
67,ULM,P010106,P010726,1.933,1,3,2
67,ULM,P010106,P011457,4.667,1,6,5
67,ULM,P010106,P012603,19.6,12,44,32
67,ULM,P010106,P012604,15.25,5,23,18
67,ULM,P010106,P012629,8.851,3,18,15
67,ULM,P010106,P012703,2.433,0,3,3
67,ULM,P010582,P010726,4.25,0,5,5
67,ULM,P010582,P011457,9.5,-3,16,19
67,ULM,P010582,P012603,12.983,10,29,19
67,ULM,P010582,P012604,12.75,5,21,16
67,ULM,P010582,P012629,5.6,0,13,13
67,ULM,P010582,P012703,10.35,-1,18,19
67,ULM,P010726,P011457,1.467,-3,0,3
67,ULM,P010726,P012604,2.783,3,5,2
67,ULM,P010726,P012703,2.317,-1,2,3
67,ULM,P011457,P012603,1.983,-1,2,3
67,ULM,P011457,P012604,1.634,-1,1,2
67,ULM,P011457,P012629,11.734,5,26,21
67,ULM,P011457,P012703,13.4,1,26,25
67,ULM,P012603,P012604,14.283,3,25,22
67,ULM,P012603,P012629,10.583,1,23,22
67,ULM,P012603,P012703,3.966,-1,8,9
67,ULM,P012604,P012629,6.567,-2,10,12
67,ULM,P012604,P012703,3.45,0,8,8
67,ULM,P012629,P012703,11.483,4,29,25
68,CLU,P004862,P005113,16.533,14,35,21
68,CLU,P004862,P005373,9.983,15,30,15
68,CLU,P004862,P005714,7.633,3,17,14
68,CLU,P004862,P010569,14.15,4,30,26
68,CLU,P004862,P011797,20.9,26,52,26
68,CLU,P004862,P011801,8.85,13,26,13
68,CLU,P004862,P012620,5.15,0,11,11
68,CLU,P004862,P012621,18.883,12,41,29
68,CLU,P004862,P012698,8.85,13,26,13
68,CLU,P005113,P005714,5.016,6,11,5
68,CLU,P005113,P010569,11.517,8,24,16
68,CLU,P005113,P011797,14.333,10,26,16
68,CLU,P005113,P011801,1.733,0,0,0
68,CLU,P005113,P012620,3.933,4,9,5
68,CLU,P005113,P012621,18.266,14,35,21
68,CLU,P005113,P012698,1.733,0,0,0
68,CLU,P005373,P005714,7.066,4,17,13
68,CLU,P005373,P010569,1.416,0,4,4
68,CLU,P005373,P010997,1.933,4,7,3
68,CLU,P005373,P011797,12.566,23,41,18
68,CLU,P005373,P011801,14.516,16,39,23
68,CLU,P005373,P011907,1.933,4,7,3
68,CLU,P005373,P012620,5.266,4,12,8
68,CLU,P005373,P012621,2.316,2,7,5
68,CLU,P005373,P012698,13.333,16,36,20
68,CLU,P005714,P010569,4.15,2,13,11
68,CLU,P005714,P011797,3.416,5,10,5
68,CLU,P005714,P011801,9.999,10,28,18
68,CLU,P005714,P012620,11.416,6,27,21
68,CLU,P005714,P012621,10.349,8,27,19
68,CLU,P005714,P012698,5.883,4,14,10
68,CLU,P010569,P011797,12.65,10,28,18
68,CLU,P010569,P011801,3.216,4,11,7
68,CLU,P010569,P012620,4.15,2,13,11
68,CLU,P010569,P012621,16.8,12,41,29
68,CLU,P010569,P012698,0.283,-2,0,2
68,CLU,P010997,P011797,1.933,4,7,3
68,CLU,P010997,P011907,1.933,4,7,3
68,CLU,P010997,P012620,1.933,4,7,3
68,CLU,P011797,P011801,11.233,17,30,13
68,CLU,P011797,P011907,1.933,4,7,3
68,CLU,P011797,P012620,1.933,4,7,3
68,CLU,P011797,P012621,16.649,12,33,21
68,CLU,P011797,P012698,10.05,17,27,10
68,CLU,P011801,P012620,6.266,6,16,10
68,CLU,P011801,P012621,5.849,6,14,8
68,CLU,P011801,P012698,15.066,16,36,20
68,CLU,P011907,P012620,1.933,4,7,3
68,CLU,P012620,P012621,8.083,6,22,16
68,CLU,P012620,P012698,3.333,0,5,5
68,CLU,P012621,P012698,1.733,0,0,0
68,TRN,P001479,P005059,8.9,-7,8,15
68,TRN,P001479,P005738,4.15,-2,11,13
68,TRN,P001479,P006382,16.834,1,27,26
68,TRN,P001479,P007828,11.367,-1,24,25
68,TRN,P001479,P009903,7.3,4,13,9
68,TRN,P001479,P012593,9.967,0,21,21
68,TRN,P001479,P012595,4.5,-9,0,9
68,TRN,P001479,P012596,8.817,-10,8,18
68,TRN,P001479,P012597,9.233,-8,16,24
68,TRN,P005059,P005738,5.516,-11,7,18
68,TRN,P005059,P006382,9.05,-8,8,16
68,TRN,P005059,P009903,6.016,-5,7,12
68,TRN,P005059,P012593,2.533,-4,2,6
68,TRN,P005059,P012595,6.833,-12,5,17
68,TRN,P005059,P012596,8.4,-13,8,21
68,TRN,P005059,P012597,10.416,-12,15,27
68,TRN,P005738,P006382,2.267,0,6,6
68,TRN,P005738,P007828,8.783,-2,20,22
68,TRN,P005738,P009903,14.699,-31,17,48
68,TRN,P005738,P012593,20.499,-25,34,59
68,TRN,P005738,P012594,9.583,-19,12,31
68,TRN,P005738,P012595,9.466,-9,15,24
68,TRN,P005738,P012596,5.033,1,11,10
68,TRN,P005738,P012597,15.532,-30,23,53
68,TRN,P006382,P007828,8.834,5,19,14
68,TRN,P006382,P009903,7.95,0,13,13
68,TRN,P006382,P012593,7.034,6,16,10
68,TRN,P006382,P012595,4.4,-6,0,6
68,TRN,P006382,P012596,8.717,-7,8,15
68,TRN,P006382,P012597,6.45,-3,11,14
68,TRN,P007828,P009903,6.4,-3,11,14
68,TRN,P007828,P012593,14.2,0,30,30
68,TRN,P007828,P012595,2.7,4,6,2
68,TRN,P007828,P012596,5.45,4,11,7
68,TRN,P007828,P012597,6.266,-11,11,22
68,TRN,P009903,P012593,17.116,-25,22,47
68,TRN,P009903,P012594,9.583,-19,12,31
68,TRN,P009903,P012595,4.433,-10,4,14
68,TRN,P009903,P012597,14.499,-19,21,40
68,TRN,P012593,P012594,9.583,-19,12,31
68,TRN,P012593,P012595,6.733,-6,10,16
68,TRN,P012593,P012596,5.05,4,11,7
68,TRN,P012593,P012597,12.549,-23,18,41
68,TRN,P012594,P012595,4.433,-10,4,14
68,TRN,P012594,P012597,5.15,-9,8,17
68,TRN,P012595,P012596,9.533,-8,11,19
68,TRN,P012595,P012597,2.833,-6,5,11
68,TRN,P012596,P012597,4.4,-7,8,15
69,CAN,P001607,P003637,15.916,12,42,30
69,CAN,P001607,P004160,3.067,6,8,2
69,CAN,P001607,P005005,20.849,8,51,43
69,CAN,P001607,P007560,6.0,0,11,11
69,CAN,P001607,P007644,15.783,14,43,29
69,CAN,P001607,P009864,2.433,-3,2,5
69,CAN,P001607,P010385,6.767,7,16,9
69,CAN,P001607,P010452,6.216,4,17,13
69,CAN,P001607,P010484,14.633,4,34,30
69,CAN,P003425,P003637,1.267,-5,2,7
69,CAN,P003425,P004160,4.683,-3,4,7
69,CAN,P003425,P005005,2.233,-12,0,12
69,CAN,P003425,P007560,9.767,7,19,12
69,CAN,P003425,P007644,2.233,0,4,4
69,CAN,P003425,P008121,12.684,11,25,14
69,CAN,P003425,P009864,8.283,-5,9,14
69,CAN,P003425,P010385,6.901,6,16,10
69,CAN,P003425,P010452,11.283,0,17,17
69,CAN,P003425,P010484,1.934,-3,4,7
69,CAN,P003637,P005005,18.583,-3,42,45
69,CAN,P003637,P007560,1.767,-8,0,8
69,CAN,P003637,P007644,8.916,11,29,18
69,CAN,P003637,P008121,0.367,2,2,0
69,CAN,P003637,P009864,5.334,-14,4,18
69,CAN,P003637,P010385,4.7,2,11,9
69,CAN,P003637,P010452,5.383,1,14,13
69,CAN,P003637,P010484,13.567,-2,30,32
69,CAN,P004160,P005005,2.333,-4,3,7
69,CAN,P004160,P007560,2.467,5,5,0
69,CAN,P004160,P007644,5.167,8,12,4
69,CAN,P004160,P008121,2.95,2,4,2
69,CAN,P004160,P009864,3.066,-4,1,5
69,CAN,P004160,P010385,3.684,6,8,2
69,CAN,P004160,P010452,3.583,-4,3,7
69,CAN,P005005,P007560,5.7,-13,6,19
69,CAN,P005005,P007644,13.849,7,38,31
69,CAN,P005005,P009864,6.3,-21,2,23
69,CAN,P005005,P010385,4.7,2,11,9
69,CAN,P005005,P010452,7.716,-3,17,20
69,CAN,P005005,P010484,17.133,-9,34,43
69,CAN,P007560,P007644,6.4,0,11,11
69,CAN,P007560,P008121,9.367,7,19,12
69,CAN,P007560,P009864,5.85,-6,6,12
69,CAN,P007560,P010385,7.751,10,18,8
69,CAN,P007560,P010452,8.867,3,17,14
69,CAN,P007560,P010484,6.2,-9,8,17
69,CAN,P007644,P008121,1.7,2,4,2
69,CAN,P007644,P009864,0.483,1,1,0
69,CAN,P007644,P010385,3.684,6,8,2
69,CAN,P007644,P010452,3.783,7,15,8
69,CAN,P007644,P010484,10.066,0,23,23
69,CAN,P008121,P009864,6.183,5,9,4
69,CAN,P008121,P010385,6.501,6,16,10
69,CAN,P008121,P010452,9.95,5,17,12
69,CAN,P008121,P010484,1.034,4,4,0
69,CAN,P009864,P010452,9.266,-8,8,16
69,CAN,P009864,P010484,2.734,-9,2,11
69,CAN,P010385,P010452,4.617,3,11,8
69,CAN,P010385,P010484,5.367,4,13,9
69,WRO,P003034,P005531,12.084,-13,14,27
69,WRO,P003034,P009896,9.35,2,19,17
69,WRO,P003034,P011165,12.751,-10,25,35
69,WRO,P003034,P011900,7.217,-14,8,22
69,WRO,P003034,P011902,0.9,-4,0,4
69,WRO,P003034,P012010,14.65,-8,24,32
69,WRO,P003034,P012699,7.317,-1,17,18
69,WRO,P003034,P012736,9.467,-12,9,21
69,WRO,P005531,P009896,12.018,-9,13,22
69,WRO,P005531,P011165,16.485,-11,26,37
69,WRO,P005531,P011900,5.617,-15,1,16
69,WRO,P005531,P011902,8.283,-6,15,21
69,WRO,P005531,P012010,18.4,-12,25,37
69,WRO,P005531,P012699,7.783,2,17,15
69,WRO,P005531,P012736,9.934,-12,9,21
69,WRO,P009896,P011165,20.801,13,46,33
69,WRO,P009896,P011900,12.934,13,33,20
69,WRO,P009896,P011901,8.383,16,26,10
69,WRO,P009896,P011902,11.817,14,30,16
69,WRO,P009896,P012010,14.134,-1,21,22
69,WRO,P009896,P012699,5.5,6,11,5
69,WRO,P009896,P012736,6.467,-6,9,15
69,WRO,P011165,P011900,16.751,2,37,35
69,WRO,P011165,P011901,8.383,16,26,10
69,WRO,P011165,P011902,16.183,13,41,28
69,WRO,P011165,P012010,19.584,-6,38,44
69,WRO,P011165,P012699,13.683,2,32,30
69,WRO,P011165,P012736,4.251,-7,5,12
69,WRO,P011900,P011901,8.383,16,26,10
69,WRO,P011900,P011902,10.483,14,30,16
69,WRO,P011900,P012010,10.367,-16,15,31
69,WRO,P011900,P012699,6.417,-7,12,19
69,WRO,P011900,P012736,4.367,-9,2,11
69,WRO,P011901,P011902,8.383,16,26,10
69,WRO,P011902,P012010,9.9,-5,19,24
69,WRO,P011902,P012699,6.483,3,17,14
69,WRO,P011902,P012736,0.7,-1,2,3
69,WRO,P012010,P012699,16.05,2,36,34
69,WRO,P012010,P012736,6.383,-6,6,12
69,WRO,P012699,P012736,0.967,1,2,1
70,LKB,P002012,P004868,0.6,-5,0,5
70,LKB,P002012,P005521,23.75,31,69,38
70,LKB,P002012,P006230,27.633,14,63,49
70,LKB,P002012,P008856,30.583,18,71,53
70,LKB,P002012,P010190,11.133,-11,18,29
70,LKB,P002012,P010461,4.5,10,16,6
70,LKB,P002012,PLXI,32.733,19,79,60
70,LKB,P004868,P005521,12.866,-17,14,31
70,LKB,P004868,P006230,2.7,-5,0,5
70,LKB,P004868,P006901,4.35,2,12,10
70,LKB,P004868,P008856,10.433,-6,14,20
70,LKB,P004868,P010190,2.433,-11,0,11
70,LKB,P004868,P010461,9.566,-7,14,21
70,LKB,P004868,PLXI,8.516,-19,2,21
70,LKB,P005521,P006230,21.35,21,53,32
70,LKB,P005521,P006901,4.35,2,12,10
70,LKB,P005521,P008856,31.433,29,75,46
70,LKB,P005521,P010190,4.583,-10,8,18
70,LKB,P005521,P010461,14.066,3,30,27
70,LKB,P005521,PLXI,31.666,17,71,54
70,LKB,P006230,P008856,26.633,13,55,42
70,LKB,P006230,P010190,12.683,-16,18,34
70,LKB,P006230,PLXI,30.333,9,63,54
70,LKB,P006901,P008856,4.35,2,12,10
70,LKB,P006901,P010461,4.35,2,12,10
70,LKB,P008856,P010190,8.983,-12,10,22
70,LKB,P008856,P010461,13.183,9,30,21
70,LKB,P008856,PLXI,36.066,15,73,58
70,LKB,P010190,P010461,0.883,-6,0,6
70,LKB,P010190,PLXI,13.566,-22,18,40
70,LKB,P010461,PLXI,9.716,1,18,17
70,TTK,P005000,P005685,7.117,-4,16,20
70,TTK,P005000,P006693,18.617,-1,41,42
70,TTK,P005000,P009845,4.183,4,13,9
70,TTK,P005000,P011239,31.083,-7,57,64
70,TTK,P005000,P011834,11.95,-11,12,23
70,TTK,P005000,P011925,34.55,-10,67,77
70,TTK,P005000,P011975,1.9,-2,4,6
70,TTK,P005000,P012056,33.0,-6,63,69
70,TTK,P005000,P012697,10.4,-7,19,26
70,TTK,P005685,P009845,1.4,0,3,3
70,TTK,P005685,P011834,2.767,-2,6,8
70,TTK,P005685,P011925,7.117,-4,16,20
70,TTK,P005685,P012056,4.367,-4,10,14
70,TTK,P005685,P012697,5.7,-2,13,15
70,TTK,P006693,P011239,20.984,1,43,42
70,TTK,P006693,P011834,6.017,1,8,7
70,TTK,P006693,P011925,17.334,2,37,35
70,TTK,P006693,P012056,18.617,-1,41,42
70,TTK,P006693,P012697,2.367,2,2,0
70,TTK,P009845,P011239,5.583,6,17,11
70,TTK,P009845,P011834,2.8,2,7,5
70,TTK,P009845,P011925,6.983,6,20,14
70,TTK,P009845,P011975,3.15,-5,6,11
70,TTK,P009845,P012056,3.833,11,14,3
70,TTK,P011239,P011834,15.983,-5,19,24
70,TTK,P011239,P011925,34.233,-2,64,66
70,TTK,P011239,P011975,3.85,-6,8,14
70,TTK,P011239,P012056,31.116,4,60,56
70,TTK,P011239,P012697,8.7,-3,12,15
70,TTK,P011834,P011925,15.1,-6,19,25
70,TTK,P011834,P011975,1.95,-4,4,8
70,TTK,P011834,P012056,11.133,-2,13,15
70,TTK,P011834,P012697,7.3,-1,12,13
70,TTK,P011925,P011975,3.85,-6,8,14
70,TTK,P011925,P012056,31.833,1,64,63
70,TTK,P011925,P012697,14.4,-5,25,30
70,TTK,P011975,P012697,0.7,-1,2,3
70,TTK,P012056,P012697,8.033,-3,15,18
71,PMT,P001686,P002020,0.683,1,1,0
71,PMT,P001686,P002644,23.202,4,50,46
71,PMT,P001686,P010549,10.768,0,25,25
71,PMT,P001686,P011823,1.734,-3,1,4
71,PMT,P001686,P011943,7.918,1,13,12
71,PMT,P001686,P011944,15.218,0,28,28
71,PMT,P001686,P011947,21.818,4,47,43
71,PMT,P001686,P011966,19.185,-1,39,40
71,PMT,P001686,P012600,1.95,2,4,2
71,PMT,P002020,P010549,1.583,-1,4,5
71,PMT,P002020,P011823,6.933,-2,16,18
71,PMT,P002020,P011943,5.35,-1,12,13
71,PMT,P002020,P011944,5.35,-1,12,13
71,PMT,P002020,P011947,2.266,0,5,5
71,PMT,P002020,P011966,2.266,0,5,5
71,PMT,P002020,P012600,6.033,0,13,13
71,PMT,P002644,P010549,10.701,0,24,24
71,PMT,P002644,P011823,7.451,7,21,14
71,PMT,P002644,P011943,13.702,11,34,23
71,PMT,P002644,P011944,18.252,7,39,32
71,PMT,P002644,P011947,22.485,7,53,46
71,PMT,P002644,P011966,20.835,3,47,44
71,PMT,P002644,P012600,5.984,5,16,11
71,PMT,P010549,P011823,2.75,-3,5,8
71,PMT,P010549,P011943,1.717,-2,3,5
71,PMT,P010549,P011944,3.434,-2,5,7
71,PMT,P010549,P011947,9.467,0,24,24
71,PMT,P010549,P011966,11.184,0,26,26
71,PMT,P011823,P011943,13.368,5,33,28
71,PMT,P011823,P011944,9.084,2,23,21
71,PMT,P011823,P011947,5.701,1,13,12
71,PMT,P011823,P011966,7.384,-2,15,17
71,PMT,P011823,P012600,10.067,3,25,22
71,PMT,P011943,P011944,15.418,7,36,29
71,PMT,P011943,P011947,8.018,7,18,11
71,PMT,P011943,P011966,5.001,1,10,9
71,PMT,P011943,P012600,10.184,3,25,22
71,PMT,P011944,P011947,13.051,6,29,23
71,PMT,P011944,P011966,8.784,-3,15,18
71,PMT,P011944,P012600,7.217,0,17,17
71,PMT,P011947,P011966,19.901,-3,43,46
71,PMT,P011947,P012600,1.833,2,4,2
71,PMT,P011966,P012600,4.8,5,12,7
71,VNC,P000968,P003759,17.617,-5,34,39
71,VNC,P000968,P004117,6.433,-2,14,16
71,VNC,P000968,P008052,17.05,-8,33,41
71,VNC,P000968,P009400,10.467,-2,20,22
71,VNC,P000968,P011928,13.433,-1,29,30
71,VNC,P000968,P012587,11.266,-4,23,27
71,VNC,P000968,P012591,19.934,-6,39,45
71,VNC,P003759,P008052,17.167,-6,33,39
71,VNC,P003759,P009400,18.367,-3,37,40
71,VNC,P003759,P011928,8.35,0,18,18
71,VNC,P003759,P012587,15.583,-6,31,37
71,VNC,P003759,P012591,24.984,-4,51,55
71,VNC,P004117,P008052,8.05,5,21,16
71,VNC,P004117,P009400,6.55,3,15,12
71,VNC,P004117,P011928,12.983,1,29,28
71,VNC,P004117,P012587,10.133,4,24,20
71,VNC,P004117,P012591,7.783,-7,13,20
71,VNC,P008052,P009400,13.134,2,28,26
71,VNC,P008052,P011928,9.55,3,23,20
71,VNC,P008052,P012587,20.4,3,46,43
71,VNC,P008052,P012591,21.517,-11,40,51
71,VNC,P009400,P011928,16.4,1,35,34
71,VNC,P009400,P012587,16.483,-2,34,36
71,VNC,P009400,P012591,24.267,-7,47,54
71,VNC,P011928,P012587,13.516,-1,29,30
71,VNC,P011928,P012591,17.1,-7,33,40
71,VNC,P012587,P012591,21.483,-10,41,51
72,HAM,P001990,P009663,11.017,-9,18,27
72,HAM,P001990,P010070,5.767,2,11,9
72,HAM,P001990,P011187,4.9,-2,8,10
72,HAM,P001990,P012579,6.917,-4,16,20
72,HAM,P001990,P012580,5.983,-5,8,13
72,HAM,P001990,P012581,11.967,-8,18,26
72,HAM,P001990,P012582,10.15,-13,15,28
72,HAM,P001990,P012648,6.967,-5,10,15
72,HAM,P009663,P010070,18.417,-6,30,36
72,HAM,P009663,P011187,12.083,4,23,19
72,HAM,P009663,P012579,15.084,-6,23,29
72,HAM,P009663,P012580,13.95,-6,20,26
72,HAM,P009663,P012581,15.5,-6,32,38
72,HAM,P009663,P012582,6.45,-8,10,18
72,HAM,P009663,P012648,10.0,-2,19,21
72,HAM,P009663,P012694,3.45,1,7,6
72,HAM,P009663,P012695,4.517,-6,6,12
72,HAM,P010070,P011187,12.483,2,25,23
72,HAM,P010070,P012579,15.267,-2,28,30
72,HAM,P010070,P012580,14.283,-4,23,27
72,HAM,P010070,P012581,10.734,1,24,23
72,HAM,P010070,P012648,4.55,3,9,6
72,HAM,P010070,P012694,0.7,-2,0,2
72,HAM,P010070,P012695,8.867,-2,18,20
72,HAM,P011187,P012579,17.851,6,37,31
72,HAM,P011187,P012580,19.15,0,38,38
72,HAM,P011187,P012581,6.766,0,12,12
72,HAM,P011187,P012582,9.117,-1,15,16
72,HAM,P011187,P012648,4.467,0,7,7
72,HAM,P011187,P012694,3.567,-1,7,8
72,HAM,P011187,P012695,7.484,0,16,16
72,HAM,P012579,P012580,19.35,0,35,35
72,HAM,P012579,P012581,3.234,1,10,9
72,HAM,P012579,P012582,5.684,-2,10,12
72,HAM,P012579,P012648,0.417,0,0,0
72,HAM,P012579,P012694,3.45,1,7,6
72,HAM,P012579,P012695,7.55,2,14,12
72,HAM,P012580,P012581,4.283,-5,5,10
72,HAM,P012580,P012582,6.6,-4,10,14
72,HAM,P012580,P012648,0.117,-2,0,2
72,HAM,P012580,P012694,2.867,1,7,6
72,HAM,P012580,P012695,8.417,-3,14,17
72,HAM,P012581,P012582,8.683,-10,12,22
72,HAM,P012581,P012648,11.9,-5,21,26
72,HAM,P012581,P012695,4.601,-4,10,14
72,HAM,P012582,P012648,7.767,-8,12,20
72,HAM,P012582,P012695,3.017,-2,4,6
72,HAM,P012648,P012694,0.117,-2,0,2
72,HAM,P012648,P012695,3.434,-7,6,13
72,HAM,P012694,P012695,0.117,-2,0,2
72,WOL,P002387,P003212,16.169,8,31,23
72,WOL,P002387,P004229,8.201,-2,19,21
72,WOL,P002387,P004645,10.584,5,21,16
72,WOL,P002387,P005516,10.034,-8,14,22
72,WOL,P002387,P006154,7.284,3,20,17
72,WOL,P002387,P006907,6.868,-3,11,14
72,WOL,P002387,P012576,6.684,1,12,11
72,WOL,P002387,P012577,12.968,1,23,22
72,WOL,P002387,PLCT,10.484,-1,21,22
72,WOL,P003212,P004229,6.784,4,18,14
72,WOL,P003212,P004645,8.934,9,19,10
72,WOL,P003212,P005516,4.501,-3,2,5
72,WOL,P003212,P006154,3.301,2,9,7
72,WOL,P003212,P006907,4.735,-2,7,9
72,WOL,P003212,P012576,8.318,0,15,15
72,WOL,P003212,P012577,12.235,5,21,16
72,WOL,P003212,PLCT,10.367,9,26,17
72,WOL,P004229,P004645,3.95,0,9,9
72,WOL,P004229,P005516,3.9,-6,7,13
72,WOL,P004229,P006154,1.95,2,8,6
72,WOL,P004229,P006907,1.334,-3,4,7
72,WOL,P004229,P012577,7.883,1,18,17
72,WOL,P004229,PLCT,8.734,-4,17,21
72,WOL,P004645,P005516,20.351,11,42,31
72,WOL,P004645,P006154,17.634,13,42,29
72,WOL,P004645,P006907,6.867,-1,11,12
72,WOL,P004645,P012576,11.967,14,31,17
72,WOL,P004645,P012577,19.651,16,44,28
72,WOL,P004645,PLCT,6.334,5,17,12
72,WOL,P005516,P006154,17.983,15,46,31
72,WOL,P005516,P006907,7.55,-4,12,16
72,WOL,P005516,P012576,12.134,6,25,19
72,WOL,P005516,P012577,22.918,5,45,40
72,WOL,P005516,PLCT,3.301,-8,3,11
72,WOL,P006154,P006907,8.167,0,16,16
72,WOL,P006154,P012576,11.4,13,30,17
72,WOL,P006154,P012577,17.3,18,47,29
72,WOL,P006154,PLCT,0.117,2,2,0
72,WOL,P006907,P012576,3.467,0,4,4
72,WOL,P006907,P012577,5.467,-1,8,9
72,WOL,P006907,PLCT,2.217,-2,3,5
72,WOL,P012576,P012577,15.885,7,33,26
72,WOL,P012576,PLCT,4.817,3,10,7
72,WOL,P012577,PLCT,8.301,0,17,17
73,LJU,P001235,P002661,2.05,1,3,2
73,LJU,P001235,P003452,1.117,1,3,2
73,LJU,P001235,P007066,2.05,1,3,2
73,LJU,P001235,P012598,2.05,1,3,2
73,LJU,P001235,P012700,0.933,0,0,0
73,LJU,P002661,P003452,25.734,5,70,65
73,LJU,P002661,P005969,21.967,-1,62,63
73,LJU,P002661,P007066,16.533,2,49,47
73,LJU,P002661,P009392,7.8,-1,19,20
73,LJU,P002661,P010594,7.0,1,17,16
73,LJU,P002661,P011261,5.017,-3,13,16
73,LJU,P002661,P012598,18.534,-10,41,51
73,LJU,P002661,P012700,19.433,-6,54,60
73,LJU,P003452,P005969,28.15,0,68,68
73,LJU,P003452,P007066,22.583,5,57,52
73,LJU,P003452,P009392,8.033,-1,12,13
73,LJU,P003452,P010594,11.9,1,28,27
73,LJU,P003452,P011261,3.467,1,8,7
73,LJU,P003452,P012598,14.751,-3,31,34
73,LJU,P003452,P012700,23.133,-1,55,56
73,LJU,P005969,P007066,23.466,-2,59,61
73,LJU,P005969,P009392,3.383,0,2,2
73,LJU,P005969,P010594,11.9,1,28,27
73,LJU,P005969,P012598,10.984,-9,23,32
73,LJU,P005969,P012700,23.95,-5,58,63
73,LJU,P007066,P009392,2.583,-2,0,2
73,LJU,P007066,P010594,9.083,2,23,21
73,LJU,P007066,P012598,5.55,-6,10,16
73,LJU,P007066,P012700,20.216,-4,47,51
73,LJU,P009392,P011261,5.017,-3,13,16
73,LJU,P009392,P012598,7.8,-1,19,20
73,LJU,P009392,P012700,6.916,-4,11,15
73,LJU,P010594,P012598,2.817,-1,5,6
73,LJU,P010594,P012700,4.9,0,11,11
73,LJU,P011261,P012598,5.017,-3,13,16
73,LJU,P011261,P012700,1.55,-4,5,9
73,LJU,P012598,P012700,12.633,-12,27,39
73,LLI,P003850,P004773,5.166,-7,9,16
73,LLI,P003850,P005247,4.133,-6,5,11
73,LLI,P003850,P008274,3.083,-2,6,8
73,LLI,P003850,P009680,2.083,-5,3,8
73,LLI,P003850,P012020,3.083,-2,6,8
73,LLI,P003850,P012585,1.033,-1,4,5
73,LLI,P003850,P012586,2.083,-5,3,8
73,LLI,P004773,P005247,14.916,-11,22,33
73,LLI,P004773,P006600,14.35,9,42,33
73,LLI,P004773,P008274,10.033,-2,22,24
73,LLI,P004773,P009680,20.233,4,52,48
73,LLI,P004773,P012020,9.533,-2,19,21
73,LLI,P004773,P012585,12.133,9,42,33
73,LLI,P004773,P012586,17.5,8,48,40
73,LLI,P005247,P006600,17.75,-1,41,42
73,LLI,P005247,P008274,5.65,-3,8,11
73,LLI,P005247,P009680,24.949,-2,55,57
73,LLI,P005247,P012020,9.066,-1,15,16
73,LLI,P005247,P012585,15.066,0,37,37
73,LLI,P005247,P012586,24.066,-4,53,57
73,LLI,P006600,P008274,3.4,2,10,8
73,LLI,P006600,P009680,25.867,11,73,62
73,LLI,P006600,P012584,0.05,0,0,0
73,LLI,P006600,P012585,24.333,10,71,61
73,LLI,P006600,P012586,25.05,13,71,58
73,LLI,P008274,P009680,5.433,-4,10,14
73,LLI,P008274,P012020,6.683,-4,12,16
73,LLI,P008274,P012584,0.05,0,0,0
73,LLI,P008274,P012585,4.433,1,14,13
73,LLI,P008274,P012586,1.567,4,6,2
73,LLI,P009680,P012020,6.316,2,13,11
73,LLI,P009680,P012584,0.05,0,0,0
73,LLI,P009680,P012585,23.3,14,71,57
73,LLI,P009680,P012586,28.833,12,79,67
73,LLI,P012020,P012585,1.833,3,8,5
73,LLI,P012020,P012586,4.35,4,11,7
73,LLI,P012584,P012585,0.05,0,0,0
73,LLI,P012585,P012586,22.483,16,69,53
74,BES,P003783,P005348,4.416,4,10,6
74,BES,P003783,P007914,16.25,-3,30,33
74,BES,P003783,P007917,1.65,-3,2,5
74,BES,P003783,P009582,10.083,5,20,15
74,BES,P003783,P011357,5.8,-3,13,16
74,BES,P003783,P011379,2.3,-2,3,5
74,BES,P003783,P011936,16.116,-5,29,34
74,BES,P003783,P012622,11.483,-1,20,21
74,BES,P003783,P012647,11.166,4,21,17
74,BES,P005348,P007914,5.4,12,14,2
74,BES,P005348,P008945,10.8,2,13,11
74,BES,P005348,P009582,10.3,-6,9,15
74,BES,P005348,P011357,4.916,12,14,2
74,BES,P005348,P011379,6.333,-6,5,11
74,BES,P005348,P011936,4.766,-2,6,8
74,BES,P005348,P012622,10.533,8,17,9
74,BES,P005348,P012647,3.4,0,4,4
74,BES,P007914,P007917,1.65,-3,2,5
74,BES,P007914,P008945,10.316,11,25,14
74,BES,P007914,P009582,10.483,9,21,12
74,BES,P007914,P011357,9.216,5,21,16
74,BES,P007914,P011379,3.05,1,8,7
74,BES,P007914,P011936,18.967,-8,35,43
74,BES,P007914,P012622,18.166,8,40,32
74,BES,P007914,P012647,12.766,0,24,24
74,BES,P007917,P011357,1.65,-3,2,5
74,BES,P007917,P011936,1.65,-3,2,5
74,BES,P008945,P009582,13.832,1,14,13
74,BES,P008945,P011357,3.416,8,8,0
74,BES,P008945,P011379,8.216,-3,10,13
74,BES,P008945,P011936,11.216,-2,16,18
74,BES,P008945,P012622,15.449,8,27,19
74,BES,P008945,P012647,7.483,-1,11,12
74,BES,P009582,P011357,1.8,-3,2,5
74,BES,P009582,P011379,9.099,-2,11,13
74,BES,P009582,P011936,16.165,6,25,19
74,BES,P009582,P012622,12.499,5,15,10
74,BES,P009582,P012647,11.399,9,19,10
74,BES,P011357,P011936,3.717,-7,7,14
74,BES,P011357,P012622,6.349,11,17,6
74,BES,P011379,P011936,3.816,-5,4,9
74,BES,P011379,P012622,9.25,-3,11,14
74,BES,P011936,P012622,14.266,-5,24,29
74,BES,P011936,P012647,18.649,3,32,29
74,BES,P012622,P012647,9.733,-3,17,20
74,PRS,P003481,P005793,11.967,6,28,22
74,PRS,P003481,P012608,0.867,-2,0,2
74,PRS,P003481,P012609,10.55,5,25,20
74,PRS,P003481,P012610,2.284,-1,3,4
74,PRS,P003481,P012611,12.834,4,28,24
74,PRS,P003481,P012613,0.867,-2,0,2
74,PRS,P003481,P012640,11.967,6,28,22
74,PRS,P004512,P005793,0.034,0,0,0
74,PRS,P004512,P012608,16.817,-5,25,30
74,PRS,P004512,P012609,13.484,-9,15,24
74,PRS,P004512,P012610,16.834,-5,25,30
74,PRS,P004512,P012611,5.267,-1,10,11
74,PRS,P004512,P012613,14.367,2,25,23
74,PRS,P004512,P012640,0.533,-2,0,2
74,PRS,P005793,P012608,7.117,-7,6,13
74,PRS,P005793,P012609,15.518,4,30,26
74,PRS,P005793,P012610,5.434,-7,4,11
74,PRS,P005793,P012611,12.684,6,28,22
74,PRS,P005793,P012612,3.834,1,5,4
74,PRS,P005793,P012613,2.9,-6,1,7
74,PRS,P005793,P012640,19.784,-1,34,35
74,PRS,P012608,P012609,17.767,-10,20,30
74,PRS,P012608,P012610,24.183,-12,30,42
74,PRS,P012608,P012611,6.217,-3,10,13
74,PRS,P012608,P012612,5.55,4,9,5
74,PRS,P012608,P012613,20.616,-3,30,33
74,PRS,P012608,P012640,10.066,-6,10,16
74,PRS,P012609,P012610,14.667,-11,15,26
74,PRS,P012609,P012611,13.267,0,25,25
74,PRS,P012609,P012612,3.834,1,5,4
74,PRS,P012609,P012613,11.1,-2,15,17
74,PRS,P012609,P012640,16.017,2,30,28
74,PRS,P012610,P012611,7.634,-2,13,15
74,PRS,P012610,P012612,2.433,3,4,1
74,PRS,P012610,P012613,20.633,-3,30,33
74,PRS,P012610,P012640,8.366,-6,8,14
74,PRS,P012611,P012612,0.717,0,0,0
74,PRS,P012611,P012613,4.3,2,10,8
74,PRS,P012611,P012640,12.684,6,28,22
74,PRS,P012612,P012613,2.433,3,4,1
74,PRS,P012612,P012640,6.267,4,9,5
74,PRS,P012613,P012640,5.316,-3,5,8
75,HTA,P003533,P004267,3.966,0,8,8
75,HTA,P003533,P004846,7.416,1,18,17
75,HTA,P003533,P006835,5.95,-4,14,18
75,HTA,P003533,P007759,3.966,-2,9,11
75,HTA,P003533,P010465,6.884,-11,13,24
75,HTA,P003533,P011990,0.033,0,0,0
75,HTA,P003533,P011991,8.317,-8,18,26
75,HTA,P004267,P004846,7.55,0,16,16
75,HTA,P004267,P006835,1.5,5,5,0
75,HTA,P004267,P007759,3.683,-1,7,8
75,HTA,P004267,P010465,3.867,1,9,8
75,HTA,P004267,P011973,3.584,0,8,8
75,HTA,P004267,P011990,0.033,0,0,0
75,HTA,P004267,P011991,6.017,-5,11,16
75,HTA,P004846,P006835,13.233,10,39,29
75,HTA,P004846,P007759,17.999,8,50,42
75,HTA,P004846,P010465,12.134,-1,30,31
75,HTA,P004846,P011973,16.467,6,46,40
75,HTA,P004846,P011990,2.233,0,7,7
75,HTA,P004846,P011991,18.5,4,50,46
75,HTA,P006835,P007759,26.616,6,70,64
75,HTA,P006835,P010465,19.218,-4,47,51
75,HTA,P006835,P011973,23.4,11,64,53
75,HTA,P006835,P011990,3.483,0,9,9
75,HTA,P006835,P011991,24.0,4,64,60
75,HTA,P007759,P010465,21.084,-3,53,56
75,HTA,P007759,P011973,30.15,7,80,73
75,HTA,P007759,P011990,3.516,0,9,9
75,HTA,P007759,P011991,29.45,5,78,73
75,HTA,P010465,P011973,20.084,7,54,47
75,HTA,P010465,P011991,24.601,-5,62,67
75,HTA,P011973,P011990,3.483,0,9,9
75,HTA,P011973,P011991,26.3,9,71,62
75,HTA,P011990,P011991,1.283,0,2,2
75,JOV,P005094,P006771,15.332,9,40,31
75,JOV,P005094,P009572,7.582,-5,20,25
75,JOV,P005094,P010161,12.433,-13,23,36
75,JOV,P005094,P010708,4.8,-2,11,13
75,JOV,P005094,P011247,28.466,-3,63,66
75,JOV,P005094,P011248,26.016,-8,57,65
75,JOV,P005094,P012349,5.549,-14,8,22
75,JOV,P005094,P012780,24.232,8,62,54
75,JOV,P005094,PJUG,14.782,-4,40,44
75,JOV,P006771,P009572,1.883,1,6,5
75,JOV,P006771,P011247,17.699,11,48,37
75,JOV,P006771,P011248,15.216,7,40,33
75,JOV,P006771,P012349,6.583,-2,19,21
75,JOV,P006771,P012780,17.249,17,49,32
75,JOV,P006771,PJUG,4.366,5,14,9
75,JOV,P009572,P010161,2.933,-4,8,12
75,JOV,P009572,P010708,0.433,-4,0,4
75,JOV,P009572,P011247,1.25,0,2,2
75,JOV,P009572,P011248,4.666,0,14,14
75,JOV,P009572,P012349,0.983,1,4,3
75,JOV,P009572,P012780,7.849,0,24,24
75,JOV,P009572,PJUG,6.549,-5,18,23
75,JOV,P010161,P010708,4.367,2,11,9
75,JOV,P010161,P011247,11.45,-8,21,29
75,JOV,P010161,P011248,8.967,-7,17,24
75,JOV,P010161,P012349,4.133,-8,7,15
75,JOV,P010161,P012780,5.833,-5,13,18
75,JOV,P010161,PJUG,3.416,-5,8,13
75,JOV,P010708,P011247,4.367,2,11,9
75,JOV,P010708,P011248,3.7,-5,8,13
75,JOV,P010708,PJUG,1.533,-1,3,4
75,JOV,P011247,P011248,26.8,-4,61,65
75,JOV,P011247,P012349,9.799,-11,22,33
75,JOV,P011247,P012780,22.583,12,58,46
75,JOV,P011247,PJUG,8.45,1,22,21
75,JOV,P011248,P012349,9.416,-7,23,30
75,JOV,P011248,P012780,23.083,12,62,50
75,JOV,P011248,PJUG,7.0,-4,18,22
75,JOV,P012349,P012780,5.2,4,18,14
75,JOV,P012349,PJUG,1.333,-3,3,6
75,JOV,P012780,PJUG,11.699,0,34,34
76,BOU,P000498,P004525,15.532,0,34,34
76,BOU,P000498,P010431,10.033,3,22,19
76,BOU,P000498,P010450,1.883,6,6,0
76,BOU,P000498,P010718,8.301,12,23,11
76,BOU,P000498,P011161,10.799,-4,25,29
76,BOU,P000498,P011836,2.884,7,10,3
76,BOU,P000498,P011837,10.233,10,23,13
76,BOU,P000498,P012619,8.183,-3,21,24
76,BOU,P000498,P012628,5.816,-3,12,15
76,BOU,P004525,P010431,10.333,3,22,19
76,BOU,P004525,P010450,1.883,6,6,0
76,BOU,P004525,P010718,5.734,2,13,11
76,BOU,P004525,P011161,8.866,-14,15,29
76,BOU,P004525,P011837,9.6,5,21,16
76,BOU,P004525,P012617,0.784,-3,0,3
76,BOU,P004525,P012619,6.716,-8,13,21
76,BOU,P004525,P012628,5.816,-3,12,15
76,BOU,P010431,P010450,1.883,6,6,0
76,BOU,P010431,P010718,18.334,18,36,18
76,BOU,P010431,P011161,2.883,-8,3,11
76,BOU,P010431,P011836,12.767,13,23,10
76,BOU,P010431,P011837,21.367,19,42,23
76,BOU,P010431,P012617,13.067,13,23,10
76,BOU,P010431,P012619,1.733,-3,3,6
76,BOU,P010450,P011837,1.883,6,6,0
76,BOU,P010718,P011161,10.517,6,28,22
76,BOU,P010718,P011836,23.117,22,51,29
76,BOU,P010718,P011837,26.284,21,56,35
76,BOU,P010718,P012617,20.55,12,41,29
76,BOU,P010718,P012619,2.567,3,8,5
76,BOU,P011161,P011836,10.917,9,29,20
76,BOU,P011161,P011837,9.933,0,22,22
76,BOU,P011161,P012617,8.984,-1,19,20
76,BOU,P011161,P012619,9.85,-5,22,27
76,BOU,P011161,P012628,6.383,-3,13,16
76,BOU,P011836,P011837,20.55,19,43,24
76,BOU,P011836,P012617,20.8,15,42,27
76,BOU,P011836,P012619,3.134,3,9,6
76,BOU,P011836,P012628,0.567,0,1,1
76,BOU,P011837,P012617,19.917,14,41,27
76,BOU,P011837,P012628,0.833,2,2,0
76,BOU,P012617,P012619,1.667,-2,1,3
76,BOU,P012617,P012628,0.567,0,1,1
76,BOU,P012619,P012628,5.55,-5,11,16
76,TTK,P000497,P005000,4.334,-11,7,18
76,TTK,P000497,P006693,3.267,-10,5,15
76,TTK,P000497,P009845,2.534,-6,5,11
76,TTK,P000497,P011239,2.867,-6,4,10
76,TTK,P000497,P011834,2.867,-6,4,10
76,TTK,P000497,P011975,1.467,-5,3,8
76,TTK,P004801,P005000,20.168,-5,35,40
76,TTK,P004801,P006693,13.684,2,29,27
76,TTK,P004801,P009845,4.767,-9,7,16
76,TTK,P004801,P011239,19.201,-3,32,35
76,TTK,P004801,P011834,8.233,-8,17,25
76,TTK,P004801,P011925,16.584,-16,16,32
76,TTK,P004801,P011975,0.817,0,2,2
76,TTK,P004801,P012697,7.75,-17,2,19
76,TTK,P005000,P006693,29.818,-2,59,61
76,TTK,P005000,P009845,4.668,-6,12,18
76,TTK,P005000,P011239,34.935,-3,61,64
76,TTK,P005000,P011834,21.334,1,46,45
76,TTK,P005000,P011925,26.818,-1,41,42
76,TTK,P005000,P011975,2.284,-5,5,10
76,TTK,P005000,P012697,5.117,-8,2,10
76,TTK,P006693,P009845,2.434,-7,6,13
76,TTK,P006693,P011239,27.384,5,53,48
76,TTK,P006693,P011834,20.067,3,44,41
76,TTK,P006693,P011925,20.334,6,35,29
76,TTK,P006693,P011975,2.284,-5,5,10
76,TTK,P009845,P011239,2.234,1,6,5
76,TTK,P009845,P011834,3.85,-12,3,15
76,TTK,P009845,P011925,3.8,-7,4,11
76,TTK,P009845,P011975,2.284,-5,5,10
76,TTK,P009845,P012697,2.633,-9,0,9
76,TTK,P011239,P011834,21.184,3,45,42
76,TTK,P011239,P011925,26.818,-1,41,42
76,TTK,P011239,P012697,5.117,-8,2,10
76,TTK,P011834,P011925,15.7,-4,25,29
76,TTK,P011834,P012697,2.633,-9,0,9
76,TTK,P011925,P012697,7.75,-17,2,19
77,LKB,P002012,P004868,9.866,16,28,12
77,LKB,P002012,P005521,20.966,19,52,33
77,LKB,P002012,P007029,8.515,-1,16,17
77,LKB,P002012,P008856,22.482,17,53,36
77,LKB,P002012,P010190,1.533,1,3,2
77,LKB,P002012,P010461,15.166,2,31,29
77,LKB,P002012,PLXI,21.932,18,53,35
77,LKB,P004868,P005521,8.817,12,26,14
77,LKB,P004868,P006901,9.651,-6,10,16
77,LKB,P004868,P007029,15.8,1,24,23
77,LKB,P004868,P008856,10.35,13,25,12
77,LKB,P004868,P010190,10.617,-5,13,18
77,LKB,P004868,PLXI,12.967,9,26,17
77,LKB,P005521,P006901,1.967,-1,3,4
77,LKB,P005521,P007029,6.233,-1,12,13
77,LKB,P005521,P008856,19.966,19,49,30
77,LKB,P005521,P010190,1.867,-1,3,4
77,LKB,P005521,P010461,14.033,6,29,23
77,LKB,P005521,PLXI,17.883,19,46,27
77,LKB,P006901,P007029,14.784,-14,16,30
77,LKB,P006901,P008856,5.767,-8,6,14
77,LKB,P006901,P010190,12.934,-7,16,23
77,LKB,P006901,P010461,5.233,-8,6,14
77,LKB,P006901,PLXI,9.2,-12,7,19
77,LKB,P007029,P008856,11.549,-10,16,26
77,LKB,P007029,P010190,14.467,-6,19,25
77,LKB,P007029,P010461,7.416,-16,8,24
77,LKB,P007029,PLXI,14.432,-13,17,30
77,LKB,P008856,P010190,3.817,-1,6,7
77,LKB,P008856,P010461,17.816,-4,34,38
77,LKB,P008856,PLXI,21.249,10,47,37
77,LKB,P010190,P010461,3.85,-1,6,7
77,LKB,P010190,PLXI,8.783,-4,10,14
77,LKB,P010461,PLXI,18.082,-3,34,37
77,WRO,P003034,P005531,11.232,-3,20,23
77,WRO,P003034,P011900,9.467,2,16,14
77,WRO,P003034,P011901,7.567,2,10,8
77,WRO,P003034,P011902,7.766,-3,8,11
77,WRO,P003034,P012010,9.382,-6,14,20
77,WRO,P003034,P012699,10.416,-8,13,21
77,WRO,P003034,P012736,11.966,0,15,15
77,WRO,P005531,P009896,22.917,0,47,47
77,WRO,P005531,P011900,22.933,6,52,46
77,WRO,P005531,P011901,2.2,3,6,3
77,WRO,P005531,P011902,6.149,-7,7,14
77,WRO,P005531,P012010,32.082,-6,61,67
77,WRO,P005531,P012699,26.916,-2,53,55
77,WRO,P005531,P012736,12.699,-3,22,25
77,WRO,P009896,P011900,19.05,3,40,37
77,WRO,P009896,P011902,2.017,-4,1,5
77,WRO,P009896,P012010,22.917,0,47,47
77,WRO,P009896,P012699,18.317,5,42,37
77,WRO,P009896,P012736,6.45,-4,11,15
77,WRO,P011900,P011901,5.784,1,6,5
77,WRO,P011900,P011902,3.9,0,2,2
77,WRO,P011900,P012010,22.866,4,50,46
77,WRO,P011900,P012699,19.383,7,44,37
77,WRO,P011900,P012736,11.217,-3,14,17
77,WRO,P011901,P011902,5.55,1,6,5
77,WRO,P011901,P012699,1.6,-1,2,3
77,WRO,P011901,P012736,7.567,2,10,8
77,WRO,P011902,P012010,4.366,-8,3,11
77,WRO,P011902,P012699,4.283,-8,3,11
77,WRO,P011902,P012736,5.633,1,6,5
77,WRO,P012010,P012699,27.266,-2,53,55
77,WRO,P012010,P012736,10.849,-6,16,22
77,WRO,P012699,P012736,7.283,-3,10,13
78,CAN,P001607,P003637,6.267,0,14,14
78,CAN,P001607,P004160,8.067,0,15,15
78,CAN,P001607,P005005,5.917,5,19,14
78,CAN,P001607,P007560,7.717,5,20,15
78,CAN,P001607,P007644,11.984,7,30,23
78,CAN,P001607,P009864,8.3,6,26,20
78,CAN,P001607,P010385,3.451,3,6,3
78,CAN,P001607,P010452,2.483,-4,2,6
78,CAN,P001607,P010484,1.75,-2,4,6
78,CAN,P003425,P003637,15.267,-1,26,27
78,CAN,P003425,P004160,17.133,19,39,20
78,CAN,P003425,P005005,10.967,-3,21,24
78,CAN,P003425,P007560,11.367,18,34,16
78,CAN,P003425,P007644,13.75,15,36,21
78,CAN,P003425,P009864,8.317,0,17,17
78,CAN,P003425,P010385,11.15,17,28,11
78,CAN,P003425,P010452,16.117,3,31,28
78,CAN,P003637,P004160,13.2,-1,20,21
78,CAN,P003637,P005005,10.417,-1,22,23
78,CAN,P003637,P007560,0.617,0,2,2
78,CAN,P003637,P007644,9.017,-3,18,21
78,CAN,P003637,P009864,10.917,1,24,23
78,CAN,P003637,P010385,5.384,5,10,5
78,CAN,P003637,P010452,15.05,-4,24,28
78,CAN,P004160,P005005,2.083,-1,2,3
78,CAN,P004160,P007560,12.0,20,34,14
78,CAN,P004160,P007644,17.683,15,42,27
78,CAN,P004160,P009864,7.117,6,19,13
78,CAN,P004160,P010385,13.184,17,29,12
78,CAN,P004160,P010452,10.333,1,16,15
78,CAN,P005005,P007560,7.084,3,20,17
78,CAN,P005005,P007644,10.134,6,26,20
78,CAN,P005005,P009864,9.5,0,24,24
78,CAN,P005005,P010385,1.417,3,5,2
78,CAN,P005005,P010452,8.267,-2,17,19
78,CAN,P005005,P010484,1.75,-2,4,6
78,CAN,P007560,P007644,17.334,25,50,25
78,CAN,P007560,P009864,5.7,5,19,14
78,CAN,P007560,P010385,9.217,15,24,9
78,CAN,P007560,P010452,3.55,3,9,6
78,CAN,P007560,P010484,1.75,-2,4,6
78,CAN,P007644,P009864,6.3,8,22,14
78,CAN,P007644,P010385,10.651,18,29,11
78,CAN,P007644,P010452,6.083,-3,11,14
78,CAN,P009864,P010452,8.567,0,17,17
78,CAN,P009864,P010484,1.75,-2,4,6
78,CAN,P010385,P010452,3.95,2,5,3
78,CLU,P004862,P005113,13.05,-7,23,30
78,CLU,P004862,P005373,7.683,-14,8,22
78,CLU,P004862,P005714,12.633,-21,14,35
78,CLU,P004862,P010569,18.549,-15,32,47
78,CLU,P004862,P011797,13.533,-9,23,32
78,CLU,P004862,P011801,11.499,-20,15,35
78,CLU,P004862,P012621,12.582,-8,21,29
78,CLU,P004862,P012698,14.867,-14,24,38
78,CLU,P005113,P005714,8.417,6,21,15
78,CLU,P005113,P010569,16.317,-8,27,35
78,CLU,P005113,P011797,14.434,-5,25,30
78,CLU,P005113,P011801,11.684,5,25,20
78,CLU,P005113,P012620,0.067,-2,0,2
78,CLU,P005113,P012621,15.733,3,34,31
78,CLU,P005113,P012698,19.234,0,37,37
78,CLU,P005373,P005714,9.767,-12,13,25
78,CLU,P005373,P010569,0.133,-2,0,2
78,CLU,P005373,P011797,0.017,0,0,0
78,CLU,P005373,P011801,9.9,-14,13,27
78,CLU,P005373,P012621,6.35,-5,8,13
78,CLU,P005373,P012698,5.75,-9,10,19
78,CLU,P005714,P010569,5.083,-9,6,15
78,CLU,P005714,P011797,1.217,0,2,2
78,CLU,P005714,P011801,21.717,-15,38,53
78,CLU,P005714,P012620,0.067,-2,0,2
78,CLU,P005714,P012621,18.083,1,35,34
78,CLU,P005714,P012698,16.084,-8,31,39
78,CLU,P010569,P011797,14.2,-9,23,32
78,CLU,P010569,P011801,7.216,-9,11,20
78,CLU,P010569,P012621,11.049,-4,22,26
78,CLU,P010569,P012698,14.717,-8,23,31
78,CLU,P011797,P011801,1.884,0,2,2
78,CLU,P011797,P012621,5.517,-2,11,13
78,CLU,P011797,P012698,8.934,-3,14,17
78,CLU,P011801,P012620,0.067,-2,0,2
78,CLU,P011801,P012621,19.416,3,40,37
78,CLU,P011801,P012698,18.217,-8,36,44
78,CLU,P012620,P012698,0.067,-2,0,2
78,CLU,P012621,P012698,14.266,8,33,25
79,BUD,P002740,P004397,4.183,-5,6,11
79,BUD,P002740,P004945,2.683,-3,7,10
79,BUD,P002740,P006566,4.983,-11,6,17
79,BUD,P002740,P007398,1.017,-3,2,5
79,BUD,P002740,P009214,5.483,3,13,10
79,BUD,P002740,P010248,21.9,1,48,47
79,BUD,P002740,P011935,12.234,3,29,26
79,BUD,P002740,P012605,5.284,2,10,8
79,BUD,P002740,P012606,16.616,-1,38,39
79,BUD,P002740,P012630,13.217,18,33,15
79,BUD,P004397,P006566,4.183,-5,6,11
79,BUD,P004397,P010248,4.183,-5,6,11
79,BUD,P004397,P012606,4.183,-5,6,11
79,BUD,P004945,P007398,13.65,2,35,33
79,BUD,P004945,P009214,4.833,-2,16,18
79,BUD,P004945,P010248,9.516,3,29,26
79,BUD,P004945,P010432,6.817,-4,13,17
79,BUD,P004945,P011935,11.5,1,26,25
79,BUD,P004945,P012605,5.267,2,11,9
79,BUD,P004945,P012606,11.066,-3,31,34
79,BUD,P006566,P010248,4.983,-11,6,17
79,BUD,P006566,P011935,0.8,-6,0,6
79,BUD,P006566,P012606,4.983,-11,6,17
79,BUD,P007398,P009214,5.183,-6,11,17
79,BUD,P007398,P010248,12.25,-6,27,33
79,BUD,P007398,P010432,11.867,4,25,21
79,BUD,P007398,P011935,18.934,4,41,37
79,BUD,P007398,P012605,11.134,8,24,16
79,BUD,P007398,P012606,12.983,-10,28,38
79,BUD,P007398,P012630,9.45,-1,15,16
79,BUD,P009214,P010248,10.349,0,24,24
79,BUD,P009214,P010432,0.317,-3,0,3
79,BUD,P009214,P012605,1.467,2,2,0
79,BUD,P009214,P012606,9.199,-5,22,27
79,BUD,P009214,P012630,5.833,-1,8,9
79,BUD,P010248,P011935,18.601,3,43,40
79,BUD,P010248,P012605,6.101,0,11,11
79,BUD,P010248,P012606,27.032,-2,62,64
79,BUD,P010248,P012630,17.617,9,36,27
79,BUD,P010432,P011935,11.55,7,25,18
79,BUD,P010432,P012605,10.317,10,23,13
79,BUD,P010432,P012606,1.55,-6,2,8
79,BUD,P010432,P012630,5.05,8,12,4
79,BUD,P011935,P012605,14.951,8,32,24
79,BUD,P011935,P012606,15.2,2,36,34
79,BUD,P011935,P012630,16.834,18,40,22
79,BUD,P012605,P012630,11.151,8,23,15
79,BUD,P012606,P012630,11.516,9,25,16
79,TRN,P001479,P006382,7.134,-11,7,18
79,TRN,P001479,P007828,4.683,-11,2,13
79,TRN,P001479,P009903,8.083,4,14,10
79,TRN,P001479,P012593,7.183,1,13,12
79,TRN,P001479,P012594,9.683,4,16,12
79,TRN,P001479,P012595,11.05,-16,9,25
79,TRN,P001479,P012596,9.0,-18,6,24
79,TRN,P001479,P012597,11.516,-9,13,22
79,TRN,P005738,P006382,9.168,-3,20,23
79,TRN,P005738,P007828,3.383,2,13,11
79,TRN,P005738,P009903,21.75,5,60,55
79,TRN,P005738,P012593,8.783,12,27,15
79,TRN,P005738,P012594,16.5,11,46,35
79,TRN,P005738,P012595,20.384,1,52,51
79,TRN,P005738,P012596,6.167,7,16,9
79,TRN,P005738,P012597,25.533,13,70,57
79,TRN,P006382,P007828,3.05,-7,2,9
79,TRN,P006382,P009903,5.601,-4,12,16
79,TRN,P006382,P012593,1.15,-1,2,3
79,TRN,P006382,P012594,2.501,1,6,5
79,TRN,P006382,P012595,16.302,-14,27,41
79,TRN,P006382,P012596,10.701,-10,15,25
79,TRN,P006382,P012597,9.601,-7,17,24
79,TRN,P007828,P009903,2.15,-1,8,9
79,TRN,P007828,P012595,8.066,-9,15,24
79,TRN,P007828,P012596,5.916,-8,7,15
79,TRN,P007828,P012597,5.016,-2,13,15
79,TRN,P009903,P012593,14.816,14,38,24
79,TRN,P009903,P012594,24.216,15,60,45
79,TRN,P009903,P012595,16.267,-4,39,43
79,TRN,P009903,P012597,26.449,7,65,58
79,TRN,P012593,P012594,14.816,14,38,24
79,TRN,P012593,P012595,2.4,0,5,5
79,TRN,P012593,P012596,1.15,-1,2,3
79,TRN,P012593,P012597,13.566,13,35,22
79,TRN,P012594,P012595,12.617,2,27,25
79,TRN,P012594,P012596,1.967,0,2,2
79,TRN,P012594,P012597,22.432,13,53,40
79,TRN,P012595,P012596,15.167,-11,22,33
79,TRN,P012595,P012597,23.483,-9,48,57
79,TRN,P012596,P012597,10.6,-3,18,21
80,ARI,P002867,P003240,8.317,-6,16,22
80,ARI,P002867,P004292,16.283,-4,27,31
80,ARI,P002867,P010387,10.866,2,23,21
80,ARI,P002867,P012702,14.166,-9,25,34
80,ARI,P002867,P012707,16.184,2,36,34
80,ARI,P002867,P012708,8.666,-9,10,19
80,ARI,P002867,P012716,6.734,-3,11,14
80,ARI,P002867,P012722,7.417,3,16,13
80,ARI,P002867,P012760,0.767,0,0,0
80,ARI,P003240,P004292,12.85,-7,27,34
80,ARI,P003240,P010387,1.5,-3,3,6
80,ARI,P003240,P012702,18.283,-11,31,42
80,ARI,P003240,P012707,24.884,-3,53,56
80,ARI,P003240,P012708,23.683,-15,44,59
80,ARI,P003240,P012716,22.234,1,48,47
80,ARI,P003240,P012722,4.434,2,12,10
80,ARI,P003240,P012760,7.683,-2,18,20
80,ARI,P004292,P010387,9.116,6,20,14
80,ARI,P004292,P012702,12.849,-11,21,32
80,ARI,P004292,P012707,16.017,7,37,30
80,ARI,P004292,P012708,12.816,-16,19,35
80,ARI,P004292,P012716,10.834,-1,19,20
80,ARI,P004292,P012722,7.717,2,14,12
80,ARI,P004292,P012760,4.65,4,12,8
80,ARI,P010387,P012702,7.266,-1,15,16
80,ARI,P010387,P012707,8.533,2,21,19
80,ARI,P010387,P012708,2.583,-1,2,3
80,ARI,P010387,P012722,3.6,3,8,5
80,ARI,P012702,P012707,19.5,-8,39,47
80,ARI,P012702,P012708,18.649,-8,31,39
80,ARI,P012702,P012716,11.683,0,22,22
80,ARI,P012707,P012708,18.7,-9,37,46
80,ARI,P012707,P012716,21.651,4,46,42
80,ARI,P012707,P012722,8.134,7,20,13
80,ARI,P012707,P012760,6.933,2,15,13
80,ARI,P012708,P012716,19.817,-13,37,50
80,ARI,P012708,P012722,3.45,-5,4,9
80,ARI,P012708,P012760,5.9,-8,12,20
80,ARI,P012716,P012722,6.784,0,14,14
80,ARI,P012716,P012760,7.867,-4,15,19
80,ULM,P005422,P006997,1.45,-3,1,4
80,ULM,P005422,P007952,8.033,7,18,11
80,ULM,P005422,P010106,22.917,10,53,43
80,ULM,P005422,P010582,23.716,14,60,46
80,ULM,P005422,P010726,4.75,-4,5,9
80,ULM,P005422,P011457,7.801,-9,3,12
80,ULM,P005422,P012603,23.351,15,60,45
80,ULM,P005422,P012604,19.651,7,45,38
80,ULM,P005422,P012703,6.667,-1,11,12
80,ULM,P006997,P007952,8.15,-3,17,20
80,ULM,P006997,P010106,11.333,-4,25,29
80,ULM,P006997,P010582,7.066,-7,12,19
80,ULM,P006997,P010726,7.283,7,22,15
80,ULM,P006997,P011457,11.116,-7,23,30
80,ULM,P006997,P012603,1.267,-3,1,4
80,ULM,P006997,P012604,3.766,1,11,10
80,ULM,P006997,P012703,2.033,-1,4,5
80,ULM,P007952,P010106,10.967,6,25,19
80,ULM,P007952,P010582,13.416,13,34,21
80,ULM,P007952,P010726,6.417,-1,13,14
80,ULM,P007952,P011457,13.55,-9,17,26
80,ULM,P007952,P012603,3.483,17,18,1
80,ULM,P007952,P012703,6.716,2,14,12
80,ULM,P010106,P010582,26.916,11,65,54
80,ULM,P010106,P010726,10.733,3,24,21
80,ULM,P010106,P011457,14.017,-4,26,30
80,ULM,P010106,P012603,22.784,12,54,42
80,ULM,P010106,P012604,22.733,10,56,46
80,ULM,P010582,P010726,3.733,2,8,6
80,ULM,P010582,P011457,11.366,-9,15,24
80,ULM,P010582,P012603,22.65,22,63,41
80,ULM,P010582,P012604,19.45,4,45,41
80,ULM,P010582,P012703,6.883,2,14,12
80,ULM,P010726,P011457,7.0,1,16,15
80,ULM,P010726,P012603,3.917,-4,3,7
80,ULM,P010726,P012604,6.65,2,14,12
80,ULM,P010726,P012703,2.517,-2,3,5
80,ULM,P011457,P012603,4.234,3,8,5
80,ULM,P011457,P012604,5.083,3,14,11
80,ULM,P011457,P012703,6.033,-5,6,11
80,ULM,P012603,P012604,21.651,7,48,41
80,ULM,P012603,P012703,4.067,7,13,6
80,ULM,P012604,P012703,2.684,-2,3,5
81,JOV,P002361,P002507,6.767,-3,11,14
81,JOV,P002361,P005094,10.767,-1,22,23
81,JOV,P002361,P006771,9.232,12,28,16
81,JOV,P002361,P009572,5.75,0,15,15
81,JOV,P002361,P010161,8.951,-1,13,14
81,JOV,P002361,P010708,12.783,18,37,19
81,JOV,P002361,P011247,6.25,-1,8,9
81,JOV,P002361,P011248,15.668,6,29,23
81,JOV,P002361,P012349,15.4,16,37,21
81,JOV,P002361,P012780,6.617,0,11,11
81,JOV,P002361,PJUG,6.483,14,25,11
81,JOV,P002507,P005094,4.467,-1,11,12
81,JOV,P002507,P006771,3.1,0,8,8
81,JOV,P002507,P009572,4.467,-1,11,12
81,JOV,P002507,P010161,3.667,-3,3,6
81,JOV,P002507,P011248,2.3,-2,0,2
81,JOV,P002507,P012349,2.3,-2,0,2
81,JOV,P005094,P006771,6.933,-4,12,16
81,JOV,P005094,P009572,5.75,0,15,15
81,JOV,P005094,P010161,2.234,-1,5,6
81,JOV,P005094,P011247,10.317,-8,12,20
81,JOV,P005094,P011248,10.651,-8,14,22
81,JOV,P005094,P012780,12.467,-7,18,25
81,JOV,P005094,PJUG,4.15,-2,7,9
81,JOV,P006771,P009572,4.383,1,12,11
81,JOV,P006771,P010708,7.116,16,22,6
81,JOV,P006771,P011247,5.35,0,6,6
81,JOV,P006771,P011248,6.15,0,8,8
81,JOV,P006771,P012349,7.116,16,22,6
81,JOV,P006771,P012780,3.833,-4,4,8
81,JOV,P006771,PJUG,2.983,11,14,3
81,JOV,P009572,P010161,1.367,-1,3,4
81,JOV,P009572,P012780,1.283,1,4,3
81,JOV,P010161,P010708,4.1,2,8,6
81,JOV,P010161,P011247,4.867,-10,7,17
81,JOV,P010161,P011248,11.218,-8,16,24
81,JOV,P010161,P012349,11.584,-10,15,25
81,JOV,P010161,P012780,6.051,-10,9,19
81,JOV,P010161,PJUG,1.233,-2,1,3
81,JOV,P010708,P011247,4.9,5,9,4
81,JOV,P010708,P011248,11.367,14,28,14
81,JOV,P010708,P012349,15.583,23,43,20
81,JOV,P010708,PJUG,6.483,14,25,11
81,JOV,P011247,P011248,19.551,-13,28,41
81,JOV,P011247,P012349,9.767,-5,16,21
81,JOV,P011247,P012780,15.184,-18,19,37
81,JOV,P011247,PJUG,4.15,-2,7,9
81,JOV,P011248,P012349,18.851,2,35,33
81,JOV,P011248,P012780,15.835,-18,21,39
81,JOV,P011248,PJUG,6.417,3,17,14
81,JOV,P012349,P012780,5.184,-10,7,17
81,JOV,P012349,PJUG,6.483,14,25,11
81,JOV,P012780,PJUG,4.15,-2,7,9
81,PMT,P001686,P002644,16.717,-4,27,31
81,PMT,P001686,P010549,6.883,-3,9,12
81,PMT,P001686,P011823,3.566,-3,7,10
81,PMT,P001686,P011943,5.6,-2,12,14
81,PMT,P001686,P011944,7.449,1,13,12
81,PMT,P001686,P011947,17.616,-5,32,37
81,PMT,P001686,P011966,14.417,-6,25,31
81,PMT,P001686,P012600,8.884,-6,11,17
81,PMT,P002020,P002644,5.533,10,14,4
81,PMT,P002020,P010549,5.683,2,12,10
81,PMT,P002020,P011823,6.433,-2,13,15
81,PMT,P002020,P011943,1.134,0,2,2
81,PMT,P002020,P011944,10.616,6,23,17
81,PMT,P002020,P011947,6.283,6,15,9
81,PMT,P002020,P011966,1.35,2,4,2
81,PMT,P002020,P012600,10.832,8,25,17
81,PMT,P002644,P010549,17.099,5,30,25
81,PMT,P002644,P011823,7.749,-4,15,19
81,PMT,P002644,P011943,4.35,0,11,11
81,PMT,P002644,P011944,17.882,8,36,28
81,PMT,P002644,P011947,16.033,-1,30,31
81,PMT,P002644,P011966,13.7,-4,24,28
81,PMT,P002644,P012600,20.933,-2,37,39
81,PMT,P010549,P011823,6.299,-6,9,15
81,PMT,P010549,P011943,1.233,2,3,1
81,PMT,P010549,P011944,10.849,-2,18,20
81,PMT,P010549,P011947,5.233,-1,9,10
81,PMT,P010549,P011966,2.783,0,3,3
81,PMT,P010549,P012600,15.866,-1,27,28
81,PMT,P011823,P011943,7.016,-4,15,19
81,PMT,P011823,P011944,11.049,-7,18,25
81,PMT,P011823,P011947,10.366,0,23,23
81,PMT,P011823,P011966,6.699,-2,17,19
81,PMT,P011823,P012600,11.815,-8,23,31
81,PMT,P011943,P011944,1.25,0,0,0
81,PMT,P011943,P011947,5.717,-2,12,14
81,PMT,P011943,P011966,7.8,-3,20,23
81,PMT,P011943,P012600,2.1,-3,5,8
81,PMT,P011944,P011947,12.649,6,27,21
81,PMT,P011944,P011966,5.933,3,13,10
81,PMT,P011944,P012600,16.315,1,32,31
81,PMT,P011947,P011966,14.083,-4,27,31
81,PMT,P011947,P012600,12.616,1,25,24
81,PMT,P011966,P012600,5.567,-6,7,13
82,BES,P003783,P005348,0.45,2,2,0
82,BES,P003783,P007914,11.717,-2,24,26
82,BES,P003783,P008945,7.417,0,14,14
82,BES,P003783,P009582,13.2,-4,23,27
82,BES,P003783,P011379,2.783,-2,6,8
82,BES,P003783,P011936,9.833,-1,20,21
82,BES,P003783,P012622,14.434,2,25,23
82,BES,P003783,P012647,16.234,1,30,29
82,BES,P005348,P007914,3.283,0,7,7
82,BES,P005348,P007917,0.467,-1,2,3
82,BES,P005348,P008945,5.467,-1,11,12
82,BES,P005348,P009582,5.45,2,11,9
82,BES,P005348,P011357,0.25,0,0,0
82,BES,P005348,P011936,0.8,1,1,0
82,BES,P005348,P012622,1.834,0,5,5
82,BES,P005348,P012647,5.667,1,13,12
82,BES,P007914,P007917,2.6,-3,4,7
82,BES,P007914,P008945,10.167,0,25,25
82,BES,P007914,P009582,13.85,-9,27,36
82,BES,P007914,P011379,5.383,-5,10,15
82,BES,P007914,P011936,5.0,-6,11,17
82,BES,P007914,P012622,11.301,-4,22,26
82,BES,P007914,P012647,13.367,1,30,29
82,BES,P007917,P008945,11.1,1,23,22
82,BES,P007917,P011357,0.8,-2,0,2
82,BES,P007917,P011379,6.25,1,15,14
82,BES,P007917,P011936,8.033,5,17,12
82,BES,P007917,P012622,11.1,1,23,22
82,BES,P007917,P012647,4.05,2,8,6
82,BES,P008945,P009582,11.484,-9,17,26
82,BES,P008945,P011357,1.517,-2,0,2
82,BES,P008945,P011379,6.25,1,15,14
82,BES,P008945,P011936,15.667,-3,24,27
82,BES,P008945,P012622,24.318,-6,45,51
82,BES,P008945,P012647,20.217,-1,38,39
82,BES,P009582,P011357,0.717,0,0,0
82,BES,P009582,P011379,2.783,-2,6,8
82,BES,P009582,P011936,11.267,-5,19,24
82,BES,P009582,P012622,14.418,-8,20,28
82,BES,P009582,P012647,19.167,-5,33,38
82,BES,P011357,P011936,1.517,-2,0,2
82,BES,P011357,P012622,1.267,-2,0,2
82,BES,P011379,P011936,6.433,2,17,15
82,BES,P011379,P012622,6.25,1,15,14
82,BES,P011936,P012622,17.017,0,28,28
82,BES,P011936,P012647,14.033,1,23,22
82,BES,P012622,P012647,23.401,0,41,41
82,HTA,P003533,P004267,6.417,4,13,9
82,HTA,P003533,P004846,11.867,7,29,22
82,HTA,P003533,P006835,3.917,0,10,10
82,HTA,P003533,P007759,4.55,5,16,11
82,HTA,P003533,P010465,3.017,2,7,5
82,HTA,P003533,P010550,9.117,3,19,16
82,HTA,P003533,P011991,8.583,7,22,15
82,HTA,P004267,P004846,7.084,5,15,10
82,HTA,P004267,P006835,2.117,0,2,2
82,HTA,P004267,P007759,4.133,4,4,0
82,HTA,P004267,P010465,7.784,7,13,6
82,HTA,P004267,P010550,9.367,7,17,10
82,HTA,P004267,P011973,4.8,5,6,1
82,HTA,P004267,P011991,3.166,4,6,2
82,HTA,P004846,P006835,11.801,-7,21,28
82,HTA,P004846,P007759,11.15,0,29,29
82,HTA,P004846,P010465,9.018,-4,16,20
82,HTA,P004846,P010550,11.617,4,26,22
82,HTA,P004846,P011973,10.384,-6,18,24
82,HTA,P004846,P011991,16.083,5,34,29
82,HTA,P006835,P007759,16.4,0,40,40
82,HTA,P006835,P010465,13.951,-8,27,35
82,HTA,P006835,P010550,1.4,-2,2,4
82,HTA,P006835,P011973,16.767,-6,33,39
82,HTA,P006835,P011991,16.383,-1,37,38
82,HTA,P007759,P010465,19.7,-2,36,38
82,HTA,P007759,P010550,12.732,7,25,18
82,HTA,P007759,P011973,24.349,0,47,47
82,HTA,P007759,P011991,22.582,6,55,49
82,HTA,P010465,P010550,12.55,7,21,14
82,HTA,P010465,P011973,23.484,-3,41,44
82,HTA,P010465,P011991,16.5,-3,31,34
82,HTA,P010550,P011973,11.599,7,21,14
82,HTA,P010550,P011991,14.482,7,29,22
82,HTA,P011973,P011991,21.149,-1,42,43
83,LJU,P002661,P003042,5.883,-9,7,16
83,LJU,P002661,P003452,24.082,-7,49,56
83,LJU,P002661,P005969,18.199,-5,42,47
83,LJU,P002661,P007066,13.899,1,29,28
83,LJU,P002661,P009392,0.583,-1,1,2
83,LJU,P002661,P010594,3.1,-4,8,12
83,LJU,P002661,P011261,11.983,-8,17,25
83,LJU,P002661,P012598,17.683,-4,35,39
83,LJU,P002661,P012700,19.316,-11,44,55
83,LJU,P003042,P003452,4.9,-8,7,15
83,LJU,P003042,P005969,5.9,-7,8,15
83,LJU,P003042,P011261,2.517,-3,2,5
83,LJU,P003042,P012700,6.4,-9,8,17
83,LJU,P003452,P005969,24.916,-4,52,56
83,LJU,P003452,P007066,24.699,-3,47,50
83,LJU,P003452,P009392,11.383,-5,19,24
83,LJU,P003452,P011261,11.0,-7,17,24
83,LJU,P003452,P012598,14.583,0,27,27
83,LJU,P003452,P012700,26.033,-10,54,64
83,LJU,P005969,P007066,16.666,-4,34,38
83,LJU,P005969,P009392,11.383,-5,19,24
83,LJU,P005969,P010594,3.1,-4,8,12
83,LJU,P005969,P011261,2.017,-1,2,3
83,LJU,P005969,P012598,7.7,1,19,18
83,LJU,P005969,P012700,28.183,-7,60,67
83,LJU,P007066,P009392,11.383,-5,19,24
83,LJU,P007066,P011261,8.033,1,13,12
83,LJU,P007066,P012598,8.783,0,13,13
83,LJU,P007066,P012700,15.333,-2,33,35
83,LJU,P009392,P012700,10.8,-4,18,22
83,LJU,P010594,P012598,3.1,-4,8,12
83,LJU,P010594,P012700,3.1,-4,8,12
83,LJU,P011261,P012598,9.983,-5,16,21
83,LJU,P011261,P012700,4.467,-9,5,14
83,LJU,P012598,P012700,8.9,-4,22,26
83,PRS,P004512,P005793,2.5,-6,2,8
83,PRS,P004512,P011887,0.8,0,2,2
83,PRS,P004512,P012608,13.633,5,24,19
83,PRS,P004512,P012609,12.833,5,22,17
83,PRS,P004512,P012610,13.633,5,24,19
83,PRS,P004512,P012613,10.3,9,20,11
83,PRS,P004512,P012640,0.833,2,2,0
83,PRS,P005793,P009556,13.566,0,31,31
83,PRS,P005793,P011887,11.65,4,31,27
83,PRS,P005793,P012608,9.951,4,23,19
83,PRS,P005793,P012609,16.283,-5,33,38
83,PRS,P005793,P012610,9.951,4,23,19
83,PRS,P005793,P012612,4.167,10,15,5
83,PRS,P005793,P012613,8.583,-10,13,23
83,PRS,P005793,P012640,17.417,15,45,30
83,PRS,P009556,P010801,0.867,0,3,3
83,PRS,P009556,P011887,11.25,3,30,27
83,PRS,P009556,P012609,13.566,0,31,31
83,PRS,P009556,P012612,0.15,0,0,0
83,PRS,P009556,P012613,7.033,-9,12,21
83,PRS,P009556,P012640,11.3,6,29,23
83,PRS,P010801,P011887,0.867,0,3,3
83,PRS,P010801,P012613,0.867,0,3,3
83,PRS,P010801,P012640,0.867,0,3,3
83,PRS,P011887,P012608,5.701,2,18,16
83,PRS,P011887,P012609,12.7,4,34,30
83,PRS,P011887,P012610,5.701,2,18,16
83,PRS,P011887,P012612,4.451,3,16,13
83,PRS,P011887,P012613,6.567,-7,15,22
83,PRS,P011887,P012640,8.117,9,25,16
83,PRS,P012608,P012609,16.217,7,31,24
83,PRS,P012608,P012610,25.568,16,59,43
83,PRS,P012608,P012612,8.051,12,29,17
83,PRS,P012608,P012613,15.334,7,31,24
83,PRS,P012608,P012640,7.817,11,21,10
83,PRS,P012609,P012610,16.217,7,31,24
83,PRS,P012609,P012612,2.067,2,7,5
83,PRS,P012609,P012613,16.966,-1,29,30
83,PRS,P012609,P012640,12.283,9,30,21
83,PRS,P012610,P012612,8.051,12,29,17
83,PRS,P012610,P012613,15.334,7,31,24
83,PRS,P012610,P012640,7.817,11,21,10
83,PRS,P012612,P012613,2.167,0,7,7
83,PRS,P012612,P012640,3.7,9,13,4
83,PRS,P012613,P012640,6.317,-4,11,15
84,LLI,P004479,P005247,5.267,7,16,9
84,LLI,P004479,P006600,5.267,7,16,9
84,LLI,P004479,P009680,5.267,7,16,9
84,LLI,P004479,P012585,5.267,7,16,9
84,LLI,P004773,P005247,5.733,10,16,6
84,LLI,P004773,P006600,4.833,2,11,9
84,LLI,P004773,P008274,4.433,6,12,6
84,LLI,P004773,P009649,10.25,-5,19,24
84,LLI,P004773,P009672,7.533,-4,16,20
84,LLI,P004773,P009680,9.183,5,20,15
84,LLI,P004773,P012020,11.1,3,24,21
84,LLI,P004773,P012584,0.05,0,0,0
84,LLI,P004773,P012586,10.817,3,22,19
84,LLI,P005247,P006600,20.051,23,58,35
84,LLI,P005247,P009649,2.767,6,11,5
84,LLI,P005247,P009672,4.667,-6,10,16
84,LLI,P005247,P009680,20.734,24,59,35
84,LLI,P005247,P012020,4.85,-5,9,14
84,LLI,P005247,P012585,16.401,2,40,38
84,LLI,P005247,P012586,19.134,11,49,38
84,LLI,P006600,P008274,0.75,-1,3,4
84,LLI,P006600,P009649,8.55,2,28,26
84,LLI,P006600,P009672,6.967,-3,23,26
84,LLI,P006600,P009680,20.1,18,55,37
84,LLI,P006600,P012585,18.234,11,53,42
84,LLI,P006600,P012586,18.584,17,53,36
84,LLI,P008274,P009649,4.433,6,12,6
84,LLI,P008274,P009672,2.483,5,9,4
84,LLI,P008274,P009680,1.95,1,3,2
84,LLI,P008274,P012020,3.633,7,9,2
84,LLI,P008274,P012584,0.05,0,0,0
84,LLI,P009649,P009672,10.85,-4,27,31
84,LLI,P009649,P009680,7.75,2,19,17
84,LLI,P009649,P012020,9.267,0,17,17
84,LLI,P009649,P012584,0.05,0,0,0
84,LLI,P009649,P012585,4.85,1,15,14
84,LLI,P009649,P012586,12.701,0,32,32
84,LLI,P009672,P009680,1.233,-4,3,7
84,LLI,P009672,P012020,8.5,-7,14,21
84,LLI,P009672,P012584,0.05,0,0,0
84,LLI,P009672,P012585,7.984,-6,21,27
84,LLI,P009672,P012586,11.801,-11,25,36
84,LLI,P009680,P012020,5.617,2,12,10
84,LLI,P009680,P012585,13.767,9,36,27
84,LLI,P009680,P012586,17.267,16,45,29
84,LLI,P012020,P012585,3.017,-8,2,10
84,LLI,P012020,P012586,10.484,-12,17,29
84,LLI,P012585,P012586,15.484,-4,37,41
84,WOL,P003212,P004229,0.933,3,6,3
84,WOL,P003212,P004645,9.366,4,26,22
84,WOL,P003212,P005516,4.517,-4,10,14
84,WOL,P003212,P006154,8.783,-16,21,37
84,WOL,P003212,P006907,5.1,-14,9,23
84,WOL,P003212,P012576,16.983,-17,37,54
84,WOL,P003212,P012577,15.433,-9,39,48
84,WOL,P003212,PLCT,10.549,-3,24,27
84,WOL,P004229,P004645,1.616,3,6,3
84,WOL,P004229,P005516,7.75,-14,9,23
84,WOL,P004229,P006154,5.5,-8,7,15
84,WOL,P004229,P006907,7.75,-14,9,23
84,WOL,P004229,P012577,8.0,-11,15,26
84,WOL,P004229,PLCT,3.183,-3,8,11
84,WOL,P004645,P005516,7.183,6,14,8
84,WOL,P004645,P006154,2.233,-1,6,7
84,WOL,P004645,P006907,4.533,6,10,4
84,WOL,P004645,P012576,13.866,7,32,25
84,WOL,P004645,P012577,9.216,5,24,19
84,WOL,P004645,PLCT,13.915,10,34,24
84,WOL,P005516,P006154,13.816,-3,30,33
84,WOL,P005516,P006907,16.199,-7,29,36
84,WOL,P005516,P012576,18.849,10,45,35
84,WOL,P005516,P012577,22.033,-9,44,53
84,WOL,P005516,PLCT,16.049,5,35,30
84,WOL,P006154,P006907,13.166,-23,20,43
84,WOL,P006154,P012576,15.649,-10,38,48
84,WOL,P006154,P012577,18.633,-12,41,53
84,WOL,P006154,PLCT,6.816,1,17,16
84,WOL,P006907,P012576,13.549,-7,29,36
84,WOL,P006907,P012577,15.983,-22,28,50
84,WOL,P006907,PLCT,8.916,-3,18,21
84,WOL,P012576,P012577,24.949,-3,58,61
84,WOL,P012576,PLCT,21.415,8,49,41
84,WOL,P012577,PLCT,17.549,5,43,38
85,HAM,P001990,P009663,10.25,-1,21,22
85,HAM,P001990,P010070,6.033,5,17,12
85,HAM,P001990,P011168,0.283,0,0,0
85,HAM,P001990,P011187,1.9,2,4,2
85,HAM,P001990,P012579,4.883,5,16,11
85,HAM,P001990,P012580,6.4,-4,8,12
85,HAM,P001990,P012581,3.767,-4,4,8
85,HAM,P001990,P012582,11.1,4,25,21
85,HAM,P001990,P012648,3.783,0,5,5
85,HAM,P001990,P012694,1.333,-3,0,3
85,HAM,P009663,P010070,16.701,2,41,39
85,HAM,P009663,P011168,12.434,-16,19,35
85,HAM,P009663,P011187,0.5,2,2,0
85,HAM,P009663,P012579,13.75,-4,29,33
85,HAM,P009663,P012580,11.167,-17,14,31
85,HAM,P009663,P012581,5.067,-13,4,17
85,HAM,P009663,P012582,21.434,-8,43,51
85,HAM,P009663,P012648,5.15,1,10,9
85,HAM,P009663,P012694,1.233,-3,0,3
85,HAM,P009663,P012695,1.65,1,5,4
85,HAM,P010070,P011168,10.084,-6,20,26
85,HAM,P010070,P011187,1.5,2,5,3
85,HAM,P010070,P012579,9.917,-2,23,25
85,HAM,P010070,P012580,3.767,0,11,11
85,HAM,P010070,P012581,2.167,-3,4,7
85,HAM,P010070,P012582,15.817,5,40,35
85,HAM,P010070,P012648,4.3,4,10,6
85,HAM,P010070,P012695,1.65,1,5,4
85,HAM,P011168,P011187,10.283,-8,19,27
85,HAM,P011168,P012579,10.251,-8,17,25
85,HAM,P011168,P012580,14.7,-20,26,46
85,HAM,P011168,P012581,12.8,-17,20,37
85,HAM,P011168,P012582,19.317,-13,37,50
85,HAM,P011168,P012648,2.283,-2,1,3
85,HAM,P011168,P012694,2.833,-6,1,7
85,HAM,P011187,P012579,0.567,1,2,1
85,HAM,P011187,P012580,10.116,-3,22,25
85,HAM,P011187,P012581,13.566,-1,27,28
85,HAM,P011187,P012582,9.25,0,22,22
85,HAM,P011187,P012648,3.883,1,6,5
85,HAM,P011187,P012694,4.816,-3,6,9
85,HAM,P011187,P012695,1.883,3,5,2
85,HAM,P012579,P012580,4.917,-3,8,11
85,HAM,P012579,P012581,1.117,2,4,2
85,HAM,P012579,P012582,14.534,-2,33,35
85,HAM,P012579,P012694,0.6,-1,0,1
85,HAM,P012580,P012581,14.767,-19,23,42
85,HAM,P012580,P012582,17.267,-12,32,44
85,HAM,P012580,P012648,1.133,-3,0,3
85,HAM,P012580,P012694,2.166,-7,0,7
85,HAM,P012581,P012582,11.334,-8,21,29
85,HAM,P012581,P012648,3.883,1,6,5
85,HAM,P012581,P012694,5.449,-5,6,11
85,HAM,P012581,P012695,1.883,3,5,2
85,HAM,P012582,P012648,5.433,1,10,9
85,HAM,P012582,P012695,1.65,1,5,4
85,HAM,P012648,P012694,3.883,1,6,5
85,HAM,P012648,P012695,3.533,4,10,6
85,HAM,P012694,P012695,1.883,3,5,2
85,VNC,P000968,P003759,5.066,3,14,11
85,VNC,P000968,P008052,10.2,5,25,20
85,VNC,P000968,P009400,5.566,0,14,14
85,VNC,P000968,P011909,13.05,-5,21,26
85,VNC,P000968,P011928,9.767,-3,17,20
85,VNC,P000968,P012587,12.933,2,29,27
85,VNC,P000968,P012591,2.75,-2,4,6
85,VNC,P003759,P004381,10.784,1,26,25
85,VNC,P003759,P008052,9.2,6,27,21
85,VNC,P003759,P009400,7.583,3,21,18
85,VNC,P003759,P011909,3.283,-2,4,6
85,VNC,P003759,P011928,5.417,-2,11,13
85,VNC,P003759,P012587,10.05,6,29,23
85,VNC,P003759,P012591,12.017,1,28,27
85,VNC,P004381,P008052,14.567,14,38,24
85,VNC,P004381,P009400,13.333,11,34,23
85,VNC,P004381,P011909,11.7,19,33,14
85,VNC,P004381,P011928,17.0,9,39,30
85,VNC,P004381,P012493,0.983,-1,4,5
85,VNC,P004381,P012587,5.867,-1,15,16
85,VNC,P004381,P012588,2.25,-2,4,6
85,VNC,P004381,P012591,24.184,18,59,41
85,VNC,P008052,P009400,4.516,13,19,6
85,VNC,P008052,P011909,17.184,12,38,26
85,VNC,P008052,P011928,12.767,8,27,19
85,VNC,P008052,P012587,16.067,4,40,36
85,VNC,P008052,P012591,14.567,14,38,24
85,VNC,P009400,P011909,9.016,11,23,12
85,VNC,P009400,P011928,14.433,-3,29,32
85,VNC,P009400,P012493,0.983,-1,4,5
85,VNC,P009400,P012587,3.666,2,12,10
85,VNC,P009400,P012588,2.25,-2,4,6
85,VNC,P009400,P012591,14.25,10,32,22
85,VNC,P011909,P011928,18.667,11,41,30
85,VNC,P011909,P012587,11.65,-7,19,26
85,VNC,P011909,P012591,14.45,17,37,20
85,VNC,P011928,P012493,0.983,-1,4,5
85,VNC,P011928,P012587,8.25,-1,15,16
85,VNC,P011928,P012588,2.25,-2,4,6
85,VNC,P011928,P012591,17.534,8,37,29
85,VNC,P012493,P012588,0.983,-1,4,5
85,VNC,P012587,P012591,6.717,-1,17,18
85,VNC,P012588,P012591,1.267,-1,0,1
86,BOU,P000498,P004525,10.699,6,28,22
86,BOU,P000498,P010431,3.333,3,10,7
86,BOU,P000498,P010718,5.099,-9,8,17
86,BOU,P000498,P011161,12.382,4,31,27
86,BOU,P000498,P011836,6.616,-11,11,22
86,BOU,P000498,P011837,4.149,6,13,7
86,BOU,P000498,P012619,6.4,-5,10,15
86,BOU,P000498,P012628,7.05,-2,13,15
86,BOU,P004525,P010431,12.567,13,39,26
86,BOU,P004525,P010718,10.633,-1,28,29
86,BOU,P004525,P011161,11.316,1,28,27
86,BOU,P004525,P011836,7.5,-1,21,22
86,BOU,P004525,P011837,10.333,9,29,20
86,BOU,P004525,P012617,10.934,3,29,26
86,BOU,P004525,P012619,3.8,1,7,6
86,BOU,P004525,P012628,8.75,5,19,14
86,BOU,P010431,P010718,16.6,11,43,32
86,BOU,P010431,P011161,4.116,3,10,7
86,BOU,P010431,P011836,17.7,7,39,32
86,BOU,P010431,P011837,15.833,14,46,32
86,BOU,P010431,P012617,20.784,17,55,38
86,BOU,P010431,P012619,3.7,6,6,0
86,BOU,P010431,P012628,4.967,6,12,6
86,BOU,P010718,P011161,7.749,-11,11,22
86,BOU,P010718,P011836,21.816,-6,47,53
86,BOU,P010718,P011837,16.449,-6,30,36
86,BOU,P010718,P012617,20.317,1,46,45
86,BOU,P010718,P012619,3.5,-3,3,6
86,BOU,P010718,P012628,2.633,-8,0,8
86,BOU,P011161,P011836,8.649,-8,14,22
86,BOU,P011161,P011837,7.566,-2,16,18
86,BOU,P011161,P012617,3.417,-8,3,11
86,BOU,P011161,P012619,5.633,1,10,9
86,BOU,P011161,P012628,5.5,4,13,9
86,BOU,P011836,P011837,12.066,-4,23,27
86,BOU,P011836,P012617,18.467,6,42,36
86,BOU,P011836,P012619,6.3,0,9,9
86,BOU,P011836,P012628,4.35,-3,6,9
86,BOU,P011837,P012617,18.25,-1,39,40
86,BOU,P011837,P012628,4.95,4,12,8
86,BOU,P012617,P012619,2.917,6,6,0
86,BOU,P012617,P012628,6.05,4,12,8
86,BOU,P012619,P012628,8.15,-2,13,15
86,ULM,P005422,P010106,19.883,1,43,42
86,ULM,P005422,P010582,23.05,-1,45,46
86,ULM,P005422,P010726,0.483,-2,0,2
86,ULM,P005422,P011391,3.6,1,7,6
86,ULM,P005422,P011457,11.799,1,19,18
86,ULM,P005422,P012603,14.884,0,35,35
86,ULM,P005422,P012604,23.967,-4,45,49
86,ULM,P005422,P012629,4.567,0,9,9
86,ULM,P005422,P012703,10.167,-8,13,21
86,ULM,P010106,P010582,24.5,-4,51,55
86,ULM,P010106,P010726,1.933,-7,2,9
86,ULM,P010106,P011391,2.25,-7,4,11
86,ULM,P010106,P011457,9.549,8,23,15
86,ULM,P010106,P012603,17.967,-13,39,52
86,ULM,P010106,P012604,23.967,-4,49,53
86,ULM,P010106,P012629,3.684,-12,7,19
86,ULM,P010106,P012703,3.267,-6,2,8
86,ULM,P010582,P011391,0.65,3,3,0
86,ULM,P010582,P011457,11.449,5,23,18
86,ULM,P010582,P012603,18.584,-9,41,50
86,ULM,P010582,P012604,27.284,-11,50,61
86,ULM,P010582,P012629,1.917,-7,3,10
86,ULM,P010582,P012703,6.434,-8,4,12
86,ULM,P010726,P011391,2.4,-5,4,9
86,ULM,P010726,P012603,1.917,-3,4,7
86,ULM,P010726,P012629,1.917,-3,4,7
86,ULM,P010726,P012703,0.95,0,2,2
86,ULM,P011391,P011457,1.533,-2,0,2
86,ULM,P011391,P012603,3.184,2,9,7
86,ULM,P011391,P012629,4.384,-3,8,11
86,ULM,P011391,P012703,4.067,3,9,6
86,ULM,P011457,P012603,7.283,10,25,15
86,ULM,P011457,P012604,16.483,13,40,27
86,ULM,P011457,P012629,7.1,6,19,13
86,ULM,P011457,P012703,9.0,3,19,16
86,ULM,P012603,P012604,23.068,-4,54,58
86,ULM,P012603,P012629,10.118,0,27,27
86,ULM,P012603,P012703,10.135,9,26,17
86,ULM,P012604,P012629,8.584,1,24,23
86,ULM,P012604,P012703,12.451,-3,22,25
86,ULM,P012629,P012703,9.601,10,27,17
87,ARI,P002867,P003240,17.968,-4,36,40
87,ARI,P002867,P010387,7.316,2,14,12
87,ARI,P002867,P012702,9.334,0,21,21
87,ARI,P002867,P012707,13.833,0,25,25
87,ARI,P002867,P012716,17.934,1,39,38
87,ARI,P002867,P012717,15.6,-5,21,26
87,ARI,P002867,P012722,12.833,0,21,21
87,ARI,P002867,P012760,2.05,-2,3,5
87,ARI,P003240,P010177,3.667,8,10,2
87,ARI,P003240,P010387,4.1,5,12,7
87,ARI,P003240,P012616,12.117,-8,12,20
87,ARI,P003240,P012702,16.868,8,37,29
87,ARI,P003240,P012707,23.368,-2,38,40
87,ARI,P003240,P012716,30.685,-4,54,58
87,ARI,P003240,P012717,9.351,-7,12,19
87,ARI,P003240,P012722,7.217,-4,12,16
87,ARI,P003240,P012760,9.667,-8,9,17
87,ARI,P010177,P012702,3.667,8,10,2
87,ARI,P010177,P012707,3.667,8,10,2
87,ARI,P010177,P012716,3.667,8,10,2
87,ARI,P010387,P012702,4.733,3,12,9
87,ARI,P010387,P012707,3.216,-3,2,5
87,ARI,P010387,P012716,4.1,5,12,7
87,ARI,P010387,P012717,3.216,-3,2,5
87,ARI,P010387,P012722,2.583,-1,2,3
87,ARI,P012616,P012702,4.5,-2,6,8
87,ARI,P012616,P012707,12.117,-8,12,20
87,ARI,P012616,P012716,12.117,-8,12,20
87,ARI,P012616,P012760,7.617,-6,6,12
87,ARI,P012702,P012707,11.684,6,25,19
87,ARI,P012702,P012716,16.201,6,35,29
87,ARI,P012702,P012717,3.017,-5,2,7
87,ARI,P012707,P012716,23.334,3,41,38
87,ARI,P012707,P012717,9.316,2,13,11
87,ARI,P012707,P012722,8.266,2,13,11
87,ARI,P012707,P012760,9.667,-8,9,17
87,ARI,P012716,P012717,9.317,-2,15,17
87,ARI,P012716,P012722,7.85,3,17,14
87,ARI,P012716,P012760,9.667,-8,9,17
87,ARI,P012717,P012722,12.583,0,19,19
87,TRN,P001479,P006382,2.066,0,5,5
87,TRN,P001479,P007828,14.383,1,23,22
87,TRN,P001479,P009903,7.049,-3,7,10
87,TRN,P001479,P012593,15.116,4,27,23
87,TRN,P001479,P012595,8.566,1,11,10
87,TRN,P001479,P012596,9.4,4,21,17
87,TRN,P001479,P012597,9.216,-3,18,21
87,TRN,P005738,P006382,15.367,-3,26,29
87,TRN,P005738,P007828,5.033,6,13,7
87,TRN,P005738,P009903,16.233,4,30,26
87,TRN,P005738,P012593,7.634,-6,11,17
87,TRN,P005738,P012595,17.533,2,32,30
87,TRN,P005738,P012596,7.317,-3,11,14
87,TRN,P005738,P012597,22.0,8,41,33
87,TRN,P005738,P012687,3.083,-4,0,4
87,TRN,P006382,P009903,10.233,-4,17,21
87,TRN,P006382,P012593,9.633,-8,14,22
87,TRN,P006382,P012595,9.35,-2,17,19
87,TRN,P006382,P012596,7.2,1,14,13
87,TRN,P006382,P012597,15.883,4,31,27
87,TRN,P007828,P009903,9.899,7,18,11
87,TRN,P007828,P012593,13.05,4,22,18
87,TRN,P007828,P012595,13.599,7,24,17
87,TRN,P007828,P012596,9.517,0,18,18
87,TRN,P007828,P012597,12.183,3,26,23
87,TRN,P009903,P012593,7.333,-5,8,13
87,TRN,P009903,P012595,22.399,3,37,34
87,TRN,P009903,P012597,16.899,6,31,25
87,TRN,P009903,P012687,3.083,-4,0,4
87,TRN,P012593,P012595,8.85,-1,12,13
87,TRN,P012593,P012596,15.417,3,30,27
87,TRN,P012593,P012597,13.967,1,28,27
87,TRN,P012595,P012596,3.7,0,6,6
87,TRN,P012595,P012597,17.316,6,33,27
87,TRN,P012595,P012687,3.083,-4,0,4
87,TRN,P012596,P012597,14.317,-1,28,29
87,TRN,P012597,P012687,3.083,-4,0,4
88,BUD,P002740,P004397,12.0,6,28,22
88,BUD,P002740,P004945,1.133,0,5,5
88,BUD,P002740,P006566,13.267,-14,22,36
88,BUD,P002740,P007398,5.983,-3,13,16
88,BUD,P002740,P009214,2.3,-3,5,8
88,BUD,P002740,P010248,15.634,1,37,36
88,BUD,P002740,P010432,6.066,-14,6,20
88,BUD,P002740,P011935,7.267,-13,10,23
88,BUD,P002740,P012605,8.717,-9,15,24
88,BUD,P002740,P012606,14.433,-3,31,34
88,BUD,P004397,P004945,10.633,-2,20,22
88,BUD,P004397,P006566,8.784,3,16,13
88,BUD,P004397,P007398,10.133,0,19,19
88,BUD,P004397,P010248,21.5,4,43,39
88,BUD,P004397,P012605,6.167,2,10,8
88,BUD,P004397,P012606,16.783,3,36,33
88,BUD,P004945,P006566,4.067,-5,4,9
88,BUD,P004945,P007398,14.233,-9,23,32
88,BUD,P004945,P009214,2.333,-3,2,5
88,BUD,P004945,P010248,14.116,-11,22,33
88,BUD,P004945,P010432,5.317,-3,10,13
88,BUD,P004945,P011935,6.467,-9,10,19
88,BUD,P004945,P012605,11.45,-7,17,24
88,BUD,P004945,P012606,7.983,-7,15,22
88,BUD,P006566,P007398,0.133,-3,0,3
88,BUD,P006566,P010248,12.451,-7,22,29
88,BUD,P006566,P010432,4.883,-12,4,16
88,BUD,P006566,P011935,8.417,-19,10,29
88,BUD,P006566,P012605,6.084,-8,10,18
88,BUD,P006566,P012606,11.25,-11,16,27
88,BUD,P007398,P009214,4.633,-6,7,13
88,BUD,P007398,P010248,13.583,-4,24,28
88,BUD,P007398,P010432,6.633,-8,12,20
88,BUD,P007398,P011935,5.317,-3,10,13
88,BUD,P007398,P012605,12.633,-9,19,28
88,BUD,P007398,P012606,7.583,-3,17,20
88,BUD,P009214,P010248,3.45,-4,5,9
88,BUD,P009214,P010432,1.183,-2,2,4
88,BUD,P009214,P012605,3.516,-5,4,9
88,BUD,P009214,P012606,1.117,-1,3,4
88,BUD,P010248,P011935,3.667,-10,6,16
88,BUD,P010248,P012605,11.017,-5,18,23
88,BUD,P010248,P012606,19.05,-4,39,43
88,BUD,P010432,P011935,10.067,-12,14,26
88,BUD,P010432,P012605,9.15,-11,14,25
88,BUD,P010432,P012606,2.233,-6,2,8
88,BUD,P011935,P012605,10.484,-13,18,31
88,BUD,P011935,P012606,3.25,-9,2,11
88,BUD,P012605,P012606,1.45,1,3,2
88,CAN,P001607,P003637,0.5,0,0,0
88,CAN,P001607,P004160,22.166,23,58,35
88,CAN,P001607,P005005,12.333,16,31,15
88,CAN,P001607,P007560,7.316,3,17,14
88,CAN,P001607,P007644,17.15,20,49,29
88,CAN,P001607,P008121,3.017,4,10,6
88,CAN,P001607,P009864,8.999,6,17,11
88,CAN,P001607,P010385,11.434,20,37,17
88,CAN,P001607,P010452,3.083,2,4,2
88,CAN,P001607,P010484,4.666,-2,9,11
88,CAN,P003425,P003637,15.384,5,37,32
88,CAN,P003425,P004160,1.667,2,2,0
88,CAN,P003425,P005005,1.467,3,5,2
88,CAN,P003425,P007644,3.951,-1,5,6
88,CAN,P003425,P008121,15.584,4,34,30
88,CAN,P003425,P009864,11.967,4,29,25
88,CAN,P003425,P010385,5.084,3,10,7
88,CAN,P003425,P010452,13.1,8,34,26
88,CAN,P003637,P005005,0.717,1,3,2
88,CAN,P003637,P007644,2.284,-3,3,6
88,CAN,P003637,P008121,15.167,4,34,30
88,CAN,P003637,P009864,12.467,4,29,25
88,CAN,P003637,P010385,3.417,1,8,7
88,CAN,P003637,P010452,13.6,8,34,26
88,CAN,P004160,P005005,13.366,15,33,18
88,CAN,P004160,P007560,7.599,0,17,17
88,CAN,P004160,P007644,19.1,19,51,32
88,CAN,P004160,P008121,3.434,4,10,6
88,CAN,P004160,P009864,8.499,6,17,11
88,CAN,P004160,P010385,13.384,19,39,20
88,CAN,P004160,P010452,2.583,2,4,2
88,CAN,P004160,P010484,4.666,-2,9,11
88,CAN,P005005,P007560,0.283,-3,0,3
88,CAN,P005005,P007644,11.5,14,32,18
88,CAN,P005005,P009864,4.483,-1,6,7
88,CAN,P005005,P010385,9.6,17,30,13
88,CAN,P005005,P010452,2.583,2,4,2
88,CAN,P007560,P007644,5.166,-1,12,13
88,CAN,P007560,P009864,4.016,7,11,4
88,CAN,P007560,P010385,1.35,-4,2,6
88,CAN,P007560,P010484,4.666,-2,9,11
88,CAN,P007644,P008121,5.001,0,10,10
88,CAN,P007644,P009864,3.933,1,8,7
88,CAN,P007644,P010385,15.218,18,42,24
88,CAN,P007644,P010484,2.233,-3,4,7
88,CAN,P008121,P009864,12.467,4,29,25
88,CAN,P008121,P010385,6.134,4,15,11
88,CAN,P008121,P010452,13.6,8,34,26
88,CAN,P009864,P010452,14.6,8,33,25
88,CAN,P009864,P010484,2.433,1,5,4
88,CAN,P010385,P010452,1.583,2,5,3
89,CLU,P004862,P005113,8.95,-1,29,30
89,CLU,P004862,P005373,18.566,10,52,42
89,CLU,P004862,P005714,5.783,-7,16,23
89,CLU,P004862,P010569,25.965,14,79,65
89,CLU,P004862,P011797,19.915,9,59,50
89,CLU,P004862,P011801,14.916,-3,47,50
89,CLU,P004862,P012621,11.733,5,26,21
89,CLU,P004862,P012698,14.232,-3,44,47
89,CLU,P005113,P005373,0.4,3,3,0
89,CLU,P005113,P005714,11.734,-13,20,33
89,CLU,P005113,P010569,10.216,15,37,22
89,CLU,P005113,P011797,6.933,8,26,18
89,CLU,P005113,P011801,19.717,-2,47,49
89,CLU,P005113,P012620,9.2,-2,16,18
89,CLU,P005113,P012621,3.133,0,7,7
89,CLU,P005113,P012698,17.517,0,43,43
89,CLU,P005373,P010569,20.549,10,56,46
89,CLU,P005373,P011797,18.299,9,50,41
89,CLU,P005373,P011801,7.683,5,25,20
89,CLU,P005373,P012621,9.983,5,21,16
89,CLU,P005373,P012698,6.716,-2,17,19
89,CLU,P005714,P010569,1.733,1,7,6
89,CLU,P005714,P011797,1.333,0,7,7
89,CLU,P005714,P011801,13.9,-11,30,41
89,CLU,P005714,P012620,8.117,-4,14,18
89,CLU,P005714,P012621,0.617,-2,0,2
89,CLU,P005714,P012698,12.383,-8,26,34
89,CLU,P010569,P011797,25.065,16,72,56
89,CLU,P010569,P011801,17.732,12,56,44
89,CLU,P010569,P012620,1.083,2,2,0
89,CLU,P010569,P012621,12.499,7,28,21
89,CLU,P010569,P012698,16.482,7,51,44
89,CLU,P011797,P011801,11.299,7,38,31
89,CLU,P011797,P012620,0.7,2,4,2
89,CLU,P011797,P012621,10.683,7,26,19
89,CLU,P011797,P012698,11.365,6,34,28
89,CLU,P011801,P012620,9.2,-2,16,18
89,CLU,P011801,P012621,2.433,-2,2,4
89,CLU,P011801,P012698,22.716,-4,55,59
89,CLU,P012620,P012621,1.383,0,2,2
89,CLU,P012620,P012698,7.117,-4,10,14
89,LKB,P002012,P004868,9.684,-12,14,26
89,LKB,P002012,P005521,19.383,-1,54,55
89,LKB,P002012,P007029,28.283,9,83,74
89,LKB,P002012,P008856,18.4,-9,36,45
89,LKB,P002012,P010190,5.583,3,17,14
89,LKB,P002012,P010461,22.749,10,67,57
89,LKB,P002012,PLXI,31.25,-4,77,81
89,LKB,P004868,P005521,13.917,-11,25,36
89,LKB,P004868,P006901,6.3,4,18,14
89,LKB,P004868,P007029,8.034,4,22,18
89,LKB,P004868,P008856,6.117,-7,9,16
89,LKB,P004868,P010190,8.6,-2,20,22
89,LKB,P004868,P010461,0.4,-3,0,3
89,LKB,P004868,PLXI,12.484,-17,20,37
89,LKB,P005521,P006901,10.767,-5,24,29
89,LKB,P005521,P007029,22.2,6,68,62
89,LKB,P005521,P008856,5.833,-13,9,22
89,LKB,P005521,P010190,14.867,-1,35,36
89,LKB,P005521,P010461,14.533,2,43,41
89,LKB,P005521,PLXI,20.7,-13,54,67
89,LKB,P006901,P007029,8.367,-3,18,21
89,LKB,P006901,P008856,1.1,-4,4,8
89,LKB,P006901,P010190,9.667,-1,20,21
89,LKB,P006901,P010461,3.367,-5,2,7
89,LKB,P006901,PLXI,3.5,-6,10,16
89,LKB,P007029,P008856,15.85,-6,38,44
89,LKB,P007029,P010190,10.95,7,29,22
89,LKB,P007029,P010461,26.116,5,69,64
89,LKB,P007029,PLXI,26.8,2,77,75
89,LKB,P008856,P010461,11.2,0,24,24
89,LKB,P008856,PLXI,19.5,-13,40,53
89,LKB,P010190,P010461,7.133,-5,14,19
89,LKB,P010190,PLXI,5.8,-5,13,18
89,LKB,P010461,PLXI,20.566,4,57,53
90,TTK,P000497,P004801,7.399,2,15,13
90,TTK,P000497,P006693,5.416,9,13,4
90,TTK,P000497,P009845,1.783,3,5,2
90,TTK,P000497,P011239,5.616,-1,10,11
90,TTK,P000497,P011834,5.616,-1,10,11
90,TTK,P000497,P011925,1.783,3,5,2
90,TTK,P000497,P012697,1.983,-7,2,9
90,TTK,P004801,P005000,11.866,-12,11,23
90,TTK,P004801,P005685,0.6,-1,0,1
90,TTK,P004801,P006693,17.882,-4,24,28
90,TTK,P004801,P009845,4.816,0,9,9
90,TTK,P004801,P011239,20.249,-11,27,38
90,TTK,P004801,P011834,12.016,-3,20,23
90,TTK,P004801,P011925,18.849,-9,26,35
90,TTK,P004801,P012697,8.983,-10,12,22
90,TTK,P005000,P005685,4.717,-6,7,13
90,TTK,P005000,P006693,15.566,-2,23,25
90,TTK,P005000,P009845,3.033,-3,4,7
90,TTK,P005000,P011239,14.55,-5,21,26
90,TTK,P005000,P011834,6.134,-11,9,20
90,TTK,P005000,P011925,22.3,-14,32,46
90,TTK,P005000,P012697,11.034,-3,21,24
90,TTK,P005685,P011834,4.117,-5,7,12
90,TTK,P005685,P011925,4.717,-6,7,13
90,TTK,P005685,P012697,4.717,-6,7,13
90,TTK,P006693,P009845,4.816,0,9,9
90,TTK,P006693,P011239,21.266,10,41,31
90,TTK,P006693,P011834,4.833,4,8,4
90,TTK,P006693,P011925,21.249,6,42,36
90,TTK,P006693,P011975,3.9,5,14,9
90,TTK,P006693,P012697,9.4,12,26,14
90,TTK,P009845,P011925,4.816,0,9,9
90,TTK,P011239,P011834,14.033,-9,22,31
90,TTK,P011239,P011925,23.65,0,45,45
90,TTK,P011239,P011975,3.9,5,14,9
90,TTK,P011239,P012697,18.6,-1,40,41
90,TTK,P011834,P011925,11.334,-11,19,30
90,TTK,P011834,P012697,14.517,-20,21,41
90,TTK,P011925,P011975,3.9,5,14,9
90,TTK,P011925,P012697,20.134,2,45,43
90,TTK,P011975,P012697,3.9,5,14,9
90,WRO,P003034,P005531,19.567,21,50,29
90,WRO,P003034,P007472,9.251,-3,14,17
90,WRO,P003034,P011900,20.584,14,51,37
90,WRO,P003034,P011901,14.818,20,40,20
90,WRO,P003034,P011902,4.5,5,14,9
90,WRO,P003034,P012699,15.934,7,35,28
90,WRO,P003034,P012736,1.967,4,6,2
90,WRO,P003034,P012749,3.983,8,14,6
90,WRO,P005531,P007472,10.668,-2,17,19
90,WRO,P005531,P009896,15.802,-7,21,28
90,WRO,P005531,P011900,28.851,10,60,50
90,WRO,P005531,P011901,16.935,19,41,22
90,WRO,P005531,P011902,2.983,4,10,6
90,WRO,P005531,P012699,30.319,5,54,49
90,WRO,P005531,P012736,10.868,-1,15,16
90,WRO,P005531,P012749,6.151,7,16,9
90,WRO,P007472,P009896,4.501,-1,9,10
90,WRO,P007472,P011900,9.051,-7,14,21
90,WRO,P007472,P011901,8.685,4,18,14
90,WRO,P007472,P011902,1.517,1,4,3
90,WRO,P007472,P012699,11.018,-8,16,24
90,WRO,P007472,P012736,0.317,0,0,0
90,WRO,P009896,P011900,12.567,-9,18,27
90,WRO,P009896,P011901,6.584,-6,10,16
90,WRO,P009896,P012699,17.168,-8,24,32
90,WRO,P009896,P012736,8.734,-5,9,14
90,WRO,P009896,P012749,3.384,-4,5,9
90,WRO,P011900,P011901,15.651,9,39,30
90,WRO,P011900,P011902,4.5,5,14,9
90,WRO,P011900,P012699,26.584,-5,48,53
90,WRO,P011900,P012736,9.934,0,15,15
90,WRO,P011900,P012749,5.55,3,17,14
90,WRO,P011901,P011902,1.517,1,4,3
90,WRO,P011901,P012699,18.668,10,43,33
90,WRO,P011901,P012749,2.75,-1,5,6
90,WRO,P011902,P012749,2.983,4,10,6
90,WRO,P012699,P012736,9.851,-3,11,14
90,WRO,P012699,P012749,3.534,-2,5,7
90,WRO,P012736,P012749,1.801,1,4,3
91,HAM,P001990,P009663,5.867,4,15,11
91,HAM,P001990,P010070,13.051,-5,30,35
91,HAM,P001990,P011187,11.6,-6,28,34
91,HAM,P001990,P012579,9.817,-6,25,31
91,HAM,P001990,P012580,8.25,2,18,16
91,HAM,P001990,P012581,13.9,5,36,31
91,HAM,P001990,P012582,4.416,3,13,10
91,HAM,P001990,P012648,2.967,-5,7,12
91,HAM,P009663,P010070,12.101,4,29,25
91,HAM,P009663,P011168,15.267,-11,23,34
91,HAM,P009663,P012579,4.7,-3,8,11
91,HAM,P009663,P012580,19.134,-4,34,38
91,HAM,P009663,P012581,10.95,3,22,19
91,HAM,P009663,P012582,11.367,-11,15,26
91,HAM,P009663,P012648,4.367,-9,6,15
91,HAM,P009663,P012694,0.783,-1,0,1
91,HAM,P010070,P011168,7.317,5,19,14
91,HAM,P010070,P011187,8.267,-4,20,24
91,HAM,P010070,P012579,11.384,-3,28,31
91,HAM,P010070,P012580,10.701,5,25,20
91,HAM,P010070,P012581,9.484,2,23,21
91,HAM,P010070,P012582,3.117,-1,6,7
91,HAM,P010070,P012648,4.967,-8,11,19
91,HAM,P010070,P012694,1.083,5,5,0
91,HAM,P011168,P011187,7.267,-1,17,18
91,HAM,P011168,P012579,10.0,2,23,21
91,HAM,P011168,P012580,16.784,-15,24,39
91,HAM,P011168,P012581,9.717,-6,16,22
91,HAM,P011168,P012582,14.751,-12,22,34
91,HAM,P011168,P012648,4.367,-9,6,15
91,HAM,P011168,P012694,4.666,-1,10,11
91,HAM,P011187,P012579,15.117,-1,40,41
91,HAM,P011187,P012580,5.9,-9,8,17
91,HAM,P011187,P012581,12.667,-4,30,34
91,HAM,P011187,P012582,7.8,2,20,18
91,HAM,P011187,P012648,2.967,-5,7,12
91,HAM,P011187,P012694,3.883,0,10,10
91,HAM,P012579,P012580,4.85,-3,7,10
91,HAM,P012579,P012581,8.917,2,25,23
91,HAM,P012579,P012582,6.1,1,17,16
91,HAM,P012579,P012648,4.967,-8,11,19
91,HAM,P012579,P012694,3.416,3,8,5
91,HAM,P012580,P012581,14.7,-3,27,30
91,HAM,P012580,P012582,13.867,-13,18,31
91,HAM,P012580,P012648,2.367,-6,2,8
91,HAM,P012580,P012694,3.583,-6,5,11
91,HAM,P012581,P012582,12.883,1,27,26
91,HAM,P012581,P012694,1.25,-4,2,6
91,HAM,P012582,P012648,2.367,-6,2,8
91,PMT,P001686,P002644,15.799,5,46,41
91,PMT,P001686,P010549,9.733,9,26,17
91,PMT,P001686,P011823,10.3,-2,18,20
91,PMT,P001686,P011942,13.849,-8,33,41
91,PMT,P001686,P011944,17.083,4,42,38
91,PMT,P001686,P011947,8.466,0,19,19
91,PMT,P001686,P011966,14.016,-8,29,37
91,PMT,P001686,P012600,15.15,12,43,31
91,PMT,P002020,P002644,6.383,2,15,13
91,PMT,P002020,P010549,12.333,9,29,20
91,PMT,P002020,P011823,7.517,9,18,9
91,PMT,P002020,P011942,1.0,0,2,2
91,PMT,P002020,P011944,4.95,4,12,8
91,PMT,P002020,P011966,10.517,9,25,16
91,PMT,P002020,P012600,12.9,11,31,20
91,PMT,P002644,P010549,12.749,9,35,26
91,PMT,P002644,P011942,8.483,-1,26,27
91,PMT,P002644,P011944,14.583,5,40,35
91,PMT,P002644,P011947,5.216,0,12,12
91,PMT,P002644,P011966,8.916,-1,23,24
91,PMT,P002644,P012600,16.599,9,47,38
91,PMT,P010549,P011823,9.317,9,20,11
91,PMT,P010549,P011942,4.833,0,13,13
91,PMT,P010549,P011944,7.883,14,22,8
91,PMT,P010549,P011947,1.533,-2,2,4
91,PMT,P010549,P011966,10.35,4,22,18
91,PMT,P010549,P012600,19.533,20,51,31
91,PMT,P011823,P011942,6.366,-7,9,16
91,PMT,P011823,P011944,7.45,3,14,11
91,PMT,P011823,P011947,3.25,0,7,7
91,PMT,P011823,P011966,15.617,2,31,29
91,PMT,P011823,P012600,11.451,14,27,13
91,PMT,P011942,P011944,6.65,-7,15,22
91,PMT,P011942,P011947,6.499,-4,12,16
91,PMT,P011942,P011966,8.816,-6,18,24
91,PMT,P011942,P012600,2.9,1,12,11
91,PMT,P011944,P011947,3.683,2,10,8
91,PMT,P011944,P011966,10.4,-5,22,27
91,PMT,P011944,P012600,15.45,12,39,27
91,PMT,P011947,P011966,3.25,0,7,7
91,PMT,P011947,P012600,1.967,4,7,3
91,PMT,P011966,P012600,16.25,9,39,30
92,LLI,P005247,P006600,15.567,6,43,37
92,LLI,P005247,P008274,9.334,15,22,7
92,LLI,P005247,P009649,10.866,5,29,24
92,LLI,P005247,P009672,3.583,3,10,7
92,LLI,P005247,P009680,21.667,6,53,47
92,LLI,P005247,P012020,10.35,5,22,17
92,LLI,P005247,P012585,17.284,3,45,42
92,LLI,P005247,P012586,15.017,1,36,35
92,LLI,P006600,P008274,8.251,1,13,12
92,LLI,P006600,P009649,15.55,-1,43,44
92,LLI,P006600,P009672,7.366,4,22,18
92,LLI,P006600,P009680,21.767,4,60,56
92,LLI,P006600,P012585,25.55,0,65,65
92,LLI,P006600,P012586,14.817,2,38,36
92,LLI,P008274,P009649,10.267,-3,14,17
92,LLI,P008274,P009672,1.0,2,4,2
92,LLI,P008274,P009680,8.934,8,16,8
92,LLI,P008274,P012020,6.3,6,13,7
92,LLI,P008274,P012585,8.501,0,12,12
92,LLI,P008274,P012586,5.617,-1,10,11
92,LLI,P009649,P009672,8.949,3,24,21
92,LLI,P009649,P009680,16.816,1,46,45
92,LLI,P009649,P012020,9.399,-1,16,17
92,LLI,P009649,P012585,17.316,-8,43,51
92,LLI,P009649,P012586,10.633,-4,21,25
92,LLI,P009672,P009680,5.433,3,17,14
92,LLI,P009672,P012020,2.583,1,6,5
92,LLI,P009672,P012585,6.366,2,18,16
92,LLI,P009672,P012586,4.516,2,11,9
92,LLI,P009680,P012020,9.1,1,18,17
92,LLI,P009680,P012585,26.484,2,70,68
92,LLI,P009680,P012586,13.267,-5,32,37
92,LLI,P012020,P012585,5.817,-4,10,14
92,LLI,P012020,P012586,7.583,-8,11,19
92,LLI,P012585,P012586,18.15,-11,37,48
92,VNC,P000968,P003759,0.467,-1,0,1
92,VNC,P000968,P004117,10.65,3,21,18
92,VNC,P000968,P008052,6.301,3,15,12
92,VNC,P000968,P009400,13.401,1,26,25
92,VNC,P000968,P011928,9.384,-3,16,19
92,VNC,P000968,P012590,11.734,-4,21,25
92,VNC,P000968,P012591,1.667,5,5,0
92,VNC,P003759,P004117,0.3,0,0,0
92,VNC,P003759,P004381,10.617,-2,17,19
92,VNC,P003759,P008052,4.984,-11,0,11
92,VNC,P003759,P009400,1.267,-5,0,5
92,VNC,P003759,P011909,9.817,2,17,15
92,VNC,P003759,P011928,5.8,8,17,9
92,VNC,P003759,P012590,1.25,-3,0,3
92,VNC,P003759,P012591,9.834,0,17,17
92,VNC,P004117,P004381,3.05,-10,4,14
92,VNC,P004117,P008052,3.55,5,10,5
92,VNC,P004117,P009400,12.017,-4,21,25
92,VNC,P004117,P011909,1.683,-3,4,7
92,VNC,P004117,P011928,9.85,-12,15,27
92,VNC,P004117,P012590,11.917,-10,19,29
92,VNC,P004117,P012591,1.783,3,6,3
92,VNC,P004381,P008052,17.75,-3,44,47
92,VNC,P004381,P009400,5.85,-6,14,20
92,VNC,P004381,P011909,16.25,-3,34,37
92,VNC,P004381,P011928,21.783,5,65,60
92,VNC,P004381,P012590,7.65,-9,17,26
92,VNC,P004381,P012591,23.45,8,65,57
92,VNC,P008052,P009400,10.784,4,29,25
92,VNC,P008052,P011909,8.767,-8,13,21
92,VNC,P008052,P011928,15.517,6,49,43
92,VNC,P008052,P012590,11.017,2,29,27
92,VNC,P008052,P012591,17.534,2,47,45
92,VNC,P009400,P011928,14.434,-5,30,35
92,VNC,P009400,P012590,13.334,-13,21,34
92,VNC,P009400,P012591,5.917,8,19,11
92,VNC,P011909,P011928,12.233,3,34,31
92,VNC,P011909,P012590,1.55,-4,0,4
92,VNC,P011909,P012591,14.7,1,34,33
92,VNC,P011928,P012590,14.584,-15,28,43
92,VNC,P011928,P012591,21.083,21,70,49
92,VNC,P012590,P012591,4.5,4,17,13
93,PRS,P004512,P005793,13.9,14,38,24
93,PRS,P004512,P011232,0.317,-3,0,3
93,PRS,P004512,P011887,8.366,15,26,11
93,PRS,P004512,P012608,17.183,21,51,30
93,PRS,P004512,P012609,7.333,8,20,12
93,PRS,P004512,P012610,17.183,21,51,30
93,PRS,P004512,P012613,1.9,3,7,4
93,PRS,P004512,P012640,2.55,5,11,6
93,PRS,P005793,P009556,1.45,-4,1,5
93,PRS,P005793,P011232,0.317,-3,0,3
93,PRS,P005793,P011887,7.7,5,19,14
93,PRS,P005793,P012608,22.883,20,65,45
93,PRS,P005793,P012609,7.333,8,20,12
93,PRS,P005793,P012610,22.883,20,65,45
93,PRS,P005793,P012613,10.433,2,28,26
93,PRS,P005793,P012640,10.433,2,28,26
93,PRS,P009556,P010801,2.116,3,9,6
93,PRS,P009556,P011232,11.849,7,28,21
93,PRS,P009556,P011551,2.116,3,9,6
93,PRS,P009556,P011887,9.899,2,23,21
93,PRS,P009556,P012609,3.933,2,9,7
93,PRS,P009556,P012613,11.716,1,23,22
93,PRS,P009556,P012640,12.249,2,26,24
93,PRS,P010801,P011232,1.583,2,6,4
93,PRS,P010801,P011551,2.116,3,9,6
93,PRS,P010801,P011887,2.116,3,9,6
93,PRS,P010801,P012640,0.533,1,3,2
93,PRS,P011232,P011551,1.583,2,6,4
93,PRS,P011232,P011887,7.916,5,19,14
93,PRS,P011232,P012608,0.317,-3,0,3
93,PRS,P011232,P012609,3.933,2,9,7
93,PRS,P011232,P012610,0.317,-3,0,3
93,PRS,P011232,P012613,10.266,5,22,17
93,PRS,P011232,P012640,10.266,5,22,17
93,PRS,P011551,P011887,2.116,3,9,6
93,PRS,P011551,P012640,0.533,1,3,2
93,PRS,P011887,P012608,8.366,15,26,11
93,PRS,P011887,P012610,8.366,15,26,11
93,PRS,P011887,P012613,8.516,1,16,15
93,PRS,P011887,P012640,9.699,4,23,19
93,PRS,P012608,P012609,7.333,8,20,12
93,PRS,P012608,P012610,26.166,27,78,51
93,PRS,P012608,P012613,10.883,9,34,25
93,PRS,P012608,P012640,11.533,11,38,27
93,PRS,P012609,P012610,7.333,8,20,12
93,PRS,P012609,P012613,3.933,2,9,7
93,PRS,P012609,P012640,3.933,2,9,7
93,PRS,P012610,P012613,10.883,9,34,25
93,PRS,P012610,P012640,11.533,11,38,27
93,PRS,P012613,P012640,21.866,8,55,47
93,WOL,P002387,P003212,10.299,-11,22,33
93,WOL,P002387,P004229,9.849,-15,16,31
93,WOL,P002387,P004645,5.717,-1,12,13
93,WOL,P002387,P005516,16.049,-7,34,41
93,WOL,P002387,P006154,10.132,-8,19,27
93,WOL,P002387,P006907,2.166,-5,2,7
93,WOL,P002387,P012576,8.566,-4,18,22
93,WOL,P002387,P012577,7.966,-13,12,25
93,WOL,P002387,P012789,1.45,4,5,1
93,WOL,P002387,PLCT,7.266,0,16,16
93,WOL,P003212,P004229,11.566,-18,19,37
93,WOL,P003212,P004645,10.784,-8,19,27
93,WOL,P003212,P005516,9.15,-6,19,25
93,WOL,P003212,P006154,12.649,-11,24,35
93,WOL,P003212,P006907,2.883,-5,2,7
93,WOL,P003212,P012576,5.55,-2,13,15
93,WOL,P003212,P012577,13.3,-15,22,37
93,WOL,P003212,P012789,4.95,1,9,8
93,WOL,P003212,PLCT,7.133,-1,15,16
93,WOL,P004229,P004645,13.367,-6,27,33
93,WOL,P004229,P005516,7.483,-3,16,19
93,WOL,P004229,P006154,16.332,-17,29,46
93,WOL,P004229,P006907,0.733,-2,0,2
93,WOL,P004229,P012577,10.666,-19,17,36
93,WOL,P004645,P005516,12.484,-6,27,33
93,WOL,P004645,P006154,16.233,-1,33,34
93,WOL,P004645,P012576,6.867,-5,15,20
93,WOL,P004645,P012577,15.167,-10,30,40
93,WOL,P004645,P012789,1.35,0,2,2
93,WOL,P004645,PLCT,4.367,-7,11,18
93,WOL,P005516,P006154,11.666,-1,26,27
93,WOL,P005516,P006907,5.7,-9,10,19
93,WOL,P005516,P012576,15.333,-9,33,42
93,WOL,P005516,P012577,13.1,-8,27,35
93,WOL,P005516,P012789,4.267,-6,8,14
93,WOL,P005516,PLCT,13.1,-17,28,45
93,WOL,P006154,P006907,2.85,-5,6,11
93,WOL,P006154,P012576,3.333,2,6,4
93,WOL,P006154,P012577,13.999,-17,23,40
93,WOL,P006154,P012789,4.267,1,13,12
93,WOL,P006154,PLCT,4.267,1,13,12
93,WOL,P006907,P012576,1.433,-3,2,5
93,WOL,P006907,P012789,4.267,-6,8,14
93,WOL,P006907,PLCT,5.7,-9,10,19
93,WOL,P012576,P012577,11.817,-4,25,29
93,WOL,P012576,PLCT,8.833,-11,20,31
93,WOL,P012577,P012789,0.65,0,0,0
93,WOL,P012577,PLCT,5.867,-6,12,18
93,WOL,P012789,PLCT,7.067,-2,15,17
94,HTA,P003533,P004267,9.017,9,27,18
94,HTA,P003533,P004846,7.7,7,21,14
94,HTA,P003533,P006835,13.75,14,40,26
94,HTA,P003533,P007759,2.617,3,8,5
94,HTA,P003533,P010465,10.783,12,32,20
94,HTA,P003533,P011991,11.133,11,32,21
94,HTA,P004267,P004846,5.2,-2,10,12
94,HTA,P004267,P006835,11.317,5,29,24
94,HTA,P004267,P007759,10.0,3,27,24
94,HTA,P004267,P010465,6.484,7,19,12
94,HTA,P004267,P010550,5.517,4,17,13
94,HTA,P004267,P011973,7.817,0,19,19
94,HTA,P004267,P011991,11.984,10,36,26
94,HTA,P004846,P006835,14.7,13,38,25
94,HTA,P004846,P007759,12.584,-2,25,27
94,HTA,P004846,P010465,13.8,7,36,29
94,HTA,P004846,P010550,8.95,-4,20,24
94,HTA,P004846,P011973,13.584,-2,27,29
94,HTA,P004846,P011991,13.35,11,35,24
94,HTA,P006835,P007759,7.2,3,17,14
94,HTA,P006835,P010465,13.267,18,40,22
94,HTA,P006835,P010550,1.183,2,5,3
94,HTA,P006835,P011973,5.884,4,12,8
94,HTA,P006835,P011991,15.967,21,47,26
94,HTA,P007759,P010465,10.167,-6,14,20
94,HTA,P007759,P010550,17.617,-2,36,38
94,HTA,P007759,P011973,19.834,-6,35,41
94,HTA,P007759,P011991,14.517,3,30,27
94,HTA,P010465,P010550,12.917,-7,21,28
94,HTA,P010465,P011973,15.401,-1,29,30
94,HTA,P010465,P011991,21.917,14,53,39
94,HTA,P010550,P011973,19.184,-5,38,43
94,HTA,P010550,P011991,16.1,0,35,35
94,HTA,P011973,P011991,18.568,6,40,34
94,LJU,P003042,P003452,2.417,-8,2,10
94,LJU,P003042,P005969,2.417,-8,2,10
94,LJU,P003042,P010594,0.8,-5,0,5
94,LJU,P003042,P011261,1.717,-7,0,7
94,LJU,P003042,P012598,1.617,-3,2,5
94,LJU,P003042,P012700,0.7,-1,2,3
94,LJU,P003452,P005969,23.918,-12,45,57
94,LJU,P003452,P009392,6.767,-5,13,18
94,LJU,P003452,P009395,32.118,-7,64,71
94,LJU,P003452,P010594,10.668,-5,25,30
94,LJU,P003452,P011261,20.419,-11,45,56
94,LJU,P003452,P012598,18.251,-2,35,37
94,LJU,P003452,P012700,33.318,-14,67,81
94,LJU,P005969,P009392,3.0,-9,2,11
94,LJU,P005969,P009395,23.117,-3,46,49
94,LJU,P005969,P010594,4.067,4,13,9
94,LJU,P005969,P011261,10.051,-6,22,28
94,LJU,P005969,P012598,16.884,-1,30,31
94,LJU,P005969,P012700,22.95,-9,44,53
94,LJU,P009392,P009395,8.117,-5,13,18
94,LJU,P009392,P010594,0.35,0,0,0
94,LJU,P009392,P011261,6.817,-2,11,13
94,LJU,P009392,P012598,0.35,-3,0,3
94,LJU,P009392,P012700,8.467,-8,13,21
94,LJU,P009395,P010594,9.117,5,23,18
94,LJU,P009395,P011261,18.951,1,43,42
94,LJU,P009395,P012598,14.2,2,25,23
94,LJU,P009395,P012700,33.584,-5,66,71
94,LJU,P010594,P011261,12.351,-1,31,32
94,LJU,P010594,P012598,2.434,-1,8,9
94,LJU,P010594,P012700,9.617,-1,24,25
94,LJU,P011261,P012598,3.701,-6,8,14
94,LJU,P011261,P012700,19.801,-8,44,52
94,LJU,P012598,P012700,16.967,-6,32,38
95,BES,P003783,P005348,0.05,-3,0,3
95,BES,P003783,P007914,8.55,-6,12,18
95,BES,P003783,P008945,2.134,-7,0,7
95,BES,P003783,P009582,6.233,-8,6,14
95,BES,P003783,P011357,2.35,2,6,4
95,BES,P003783,P011379,4.767,0,6,6
95,BES,P003783,P011936,11.017,-11,12,23
95,BES,P003783,P012622,4.566,-6,2,8
95,BES,P003783,P012647,7.801,-13,4,17
95,BES,P005348,P007914,1.4,-2,2,4
95,BES,P005348,P008945,15.834,-8,32,40
95,BES,P005348,P009582,6.783,-4,15,19
95,BES,P005348,P011357,2.15,-3,4,7
95,BES,P005348,P011379,9.434,-1,17,18
95,BES,P005348,P011936,8.918,-4,23,27
95,BES,P005348,P012622,12.117,-2,20,22
95,BES,P005348,P012647,9.25,-5,15,20
95,BES,P007914,P008945,5.233,1,12,11
95,BES,P007914,P009582,7.3,-3,16,19
95,BES,P007914,P011357,4.367,3,12,9
95,BES,P007914,P011379,4.783,2,8,6
95,BES,P007914,P011936,10.8,-1,22,23
95,BES,P007914,P012622,2.533,-4,2,6
95,BES,P007914,P012647,6.766,-2,10,12
95,BES,P008945,P009582,18.516,6,50,44
95,BES,P008945,P011357,5.3,3,16,13
95,BES,P008945,P011379,9.334,1,19,18
95,BES,P008945,P011936,21.201,8,60,52
95,BES,P008945,P012622,21.033,5,47,42
95,BES,P008945,P012647,19.883,-1,40,41
95,BES,P009582,P011357,7.65,5,22,17
95,BES,P009582,P011379,1.167,1,3,2
95,BES,P009582,P011936,21.333,1,51,50
95,BES,P009582,P012622,13.182,6,30,24
95,BES,P009582,P012647,15.432,-4,31,35
95,BES,P011357,P011936,7.65,5,22,17
95,BES,P011357,P012622,1.133,5,6,1
95,BES,P011379,P011936,9.984,4,21,17
95,BES,P011379,P012622,10.6,-4,16,20
95,BES,P011379,P012647,7.867,1,10,9
95,BES,P011936,P012622,18.266,7,42,35
95,BES,P011936,P012647,17.167,-1,35,36
95,BES,P012622,P012647,18.166,-3,31,34
95,JOV,P002507,P005094,18.165,7,43,36
95,JOV,P002507,P006771,7.433,-6,6,12
95,JOV,P002507,P009572,10.932,2,17,15
95,JOV,P002507,P010709,3.2,-1,9,10
95,JOV,P002507,P011247,10.366,1,26,25
95,JOV,P002507,P011248,7.583,4,19,15
95,JOV,P002507,P012349,2.017,-2,0,2
95,JOV,P002507,P012780,8.499,5,19,14
95,JOV,P002507,PJUG,12.533,10,33,23
95,JOV,P005094,P006771,9.617,-7,15,22
95,JOV,P005094,P009572,8.915,4,17,13
95,JOV,P005094,P010161,0.017,0,0,0
95,JOV,P005094,P010708,1.134,-2,2,4
95,JOV,P005094,P010709,5.166,-3,11,14
95,JOV,P005094,P011247,17.649,-7,37,44
95,JOV,P005094,P011248,14.183,-2,30,32
95,JOV,P005094,P012780,14.665,-1,28,29
95,JOV,P005094,PJUG,12.349,7,33,26
95,JOV,P006771,P009572,6.05,-2,4,6
95,JOV,P006771,P010161,0.017,0,0,0
95,JOV,P006771,P010708,9.884,-3,18,21
95,JOV,P006771,P011247,18.084,0,42,42
95,JOV,P006771,P011248,20.917,2,46,44
95,JOV,P006771,P012349,14.534,5,31,26
95,JOV,P006771,P012780,6.834,7,22,15
95,JOV,P006771,PJUG,3.234,-4,0,4
95,JOV,P009572,P010709,1.183,0,4,4
95,JOV,P009572,P011247,1.116,-2,0,2
95,JOV,P009572,P011248,2.833,2,4,2
95,JOV,P009572,P012349,2.817,-2,2,4
95,JOV,P009572,P012780,5.016,6,13,7
95,JOV,P009572,PJUG,8.066,0,15,15
95,JOV,P010161,P010708,0.017,0,0,0
95,JOV,P010161,PJUG,0.017,0,0,0
95,JOV,P010708,P011247,9.867,-3,18,21
95,JOV,P010708,P011248,9.867,-3,18,21
95,JOV,P010708,P012349,8.75,-1,16,17
95,JOV,P010708,PJUG,0.017,0,0,0
95,JOV,P010709,P011247,3.983,-3,7,10
95,JOV,P010709,P011248,1.283,0,2,2
95,JOV,P010709,P012780,1.966,-2,2,4
95,JOV,P010709,PJUG,3.883,-3,9,12
95,JOV,P011247,P011248,23.867,3,57,54
95,JOV,P011247,P012349,11.717,7,29,22
95,JOV,P011247,P012780,14.249,1,30,29
95,JOV,P011247,PJUG,6.566,3,18,15
95,JOV,P011248,P012349,12.517,7,31,24
95,JOV,P011248,P012780,11.85,1,28,27
95,JOV,P011248,PJUG,1.9,6,9,3
95,JOV,P012349,P012780,3.767,8,15,7
95,JOV,P012349,PJUG,2.017,-2,0,2
95,JOV,P012780,PJUG,6.882,3,15,12
96,BOU,P000498,P004525,14.768,1,17,16
96,BOU,P000498,P010431,6.017,5,11,6
96,BOU,P000498,P010450,16.784,-5,17,22
96,BOU,P000498,P010718,4.467,0,11,11
96,BOU,P000498,P011837,6.267,-2,13,15
96,BOU,P000498,P012617,6.483,-6,11,17
96,BOU,P000498,P012618,6.367,-3,7,10
96,BOU,P000498,P012619,8.617,0,8,8
96,BOU,P000498,P012628,15.234,-10,17,27
96,BOU,P004525,P010431,9.201,11,20,9
96,BOU,P004525,P010450,14.868,7,20,13
96,BOU,P004525,P010718,4.617,1,11,10
96,BOU,P004525,P011837,3.9,1,11,10
96,BOU,P004525,P012617,4.717,7,14,7
96,BOU,P004525,P012618,6.968,7,12,5
96,BOU,P004525,P012619,8.617,0,8,8
96,BOU,P004525,P012628,10.284,-3,11,14
96,BOU,P010431,P010450,7.901,8,18,10
96,BOU,P010431,P010718,11.168,7,25,18
96,BOU,P010431,P011836,7.517,9,19,10
96,BOU,P010431,P011837,5.034,3,11,8
96,BOU,P010431,P012617,12.335,12,30,18
96,BOU,P010431,P012618,11.268,11,26,15
96,BOU,P010431,P012619,2.05,3,4,1
96,BOU,P010431,P012628,0.917,-1,0,1
96,BOU,P010450,P010718,0.717,-2,2,4
96,BOU,P010450,P011836,1.3,1,2,1
96,BOU,P010450,P011837,1.95,-4,2,6
96,BOU,P010450,P012617,6.267,-3,11,14
96,BOU,P010450,P012618,8.101,2,14,12
96,BOU,P010450,P012619,9.917,1,10,9
96,BOU,P010450,P012628,12.067,-9,8,17
96,BOU,P010718,P011836,11.1,9,26,17
96,BOU,P010718,P011837,11.034,4,27,23
96,BOU,P010718,P012617,19.684,9,46,37
96,BOU,P010718,P012618,9.717,4,21,17
96,BOU,P010718,P012628,10.5,0,23,23
96,BOU,P011836,P011837,2.667,5,7,2
96,BOU,P011836,P012617,12.4,10,28,18
96,BOU,P011836,P012618,8.433,4,19,15
96,BOU,P011836,P012619,1.3,1,2,1
96,BOU,P011836,P012628,4.883,1,9,8
96,BOU,P011837,P012617,11.767,3,27,24
96,BOU,P011837,P012628,8.717,-2,18,20
96,BOU,P012617,P012618,12.167,4,26,22
96,BOU,P012617,P012619,1.3,1,2,1
96,BOU,P012617,P012628,13.816,-5,25,30
96,BOU,P012618,P012628,5.983,-5,7,12
96,BOU,P012619,P012628,7.867,-2,6,8
96,WRO,P003034,P007472,4.05,-4,4,8
96,WRO,P003034,P011278,5.683,-3,4,7
96,WRO,P003034,P011900,9.984,-7,11,18
96,WRO,P003034,P011901,7.316,-7,8,15
96,WRO,P003034,P012601,11.399,-8,10,18
96,WRO,P003034,P012699,9.884,-7,9,16
96,WRO,P003034,P012736,15.45,-10,17,27
96,WRO,P003034,P012749,3.634,-2,5,7
96,WRO,P007472,P009896,3.15,1,8,7
96,WRO,P007472,P011278,0.133,1,1,0
96,WRO,P007472,P011900,3.75,0,9,9
96,WRO,P007472,P011901,5.883,-3,12,15
96,WRO,P007472,P012601,3.583,-2,4,6
96,WRO,P007472,P012699,3.533,0,9,9
96,WRO,P007472,P012736,3.933,-1,5,6
96,WRO,P007472,P012749,1.317,0,0,0
96,WRO,P009896,P011900,23.017,2,45,43
96,WRO,P009896,P011901,20.0,9,43,34
96,WRO,P009896,P012601,19.867,1,37,36
96,WRO,P009896,P012699,21.067,0,43,43
96,WRO,P009896,P012736,4.967,-5,4,9
96,WRO,P011278,P011900,2.533,1,3,2
96,WRO,P011278,P011901,0.633,0,0,0
96,WRO,P011278,P012601,3.283,-3,2,5
96,WRO,P011278,P012699,5.183,-2,5,7
96,WRO,P011278,P012736,5.816,-2,5,7
96,WRO,P011900,P011901,24.2,4,47,43
96,WRO,P011900,P012601,24.4,-2,41,43
96,WRO,P011900,P012699,28.434,-3,51,54
96,WRO,P011900,P012736,13.684,-9,16,25
96,WRO,P011900,P012749,2.534,-2,5,7
96,WRO,P011901,P012601,23.649,3,43,40
96,WRO,P011901,P012699,19.717,5,41,36
96,WRO,P011901,P012736,7.866,-3,10,13
96,WRO,P012601,P012699,22.567,-4,37,41
96,WRO,P012601,P012736,15.216,-13,14,27
96,WRO,P012601,P012749,1.1,0,0,0
96,WRO,P012699,P012736,11.634,-11,12,23
96,WRO,P012699,P012749,2.317,-2,5,7
96,WRO,P012736,P012749,3.634,-2,5,7
97,CLU,P004862,P005113,9.034,-8,19,27
97,CLU,P004862,P005373,14.15,-6,29,35
97,CLU,P004862,P005714,5.567,1,13,12
97,CLU,P004862,P010569,16.217,-11,34,45
97,CLU,P004862,P011797,16.067,-15,30,45
97,CLU,P004862,P011801,11.134,-7,25,32
97,CLU,P004862,P012621,7.484,-8,14,22
97,CLU,P004862,P012698,13.083,-2,28,30
97,CLU,P005113,P005714,11.717,-4,23,27
97,CLU,P005113,P010569,4.25,-3,12,15
97,CLU,P005113,P011797,4.467,-16,1,17
97,CLU,P005113,P011801,16.85,-6,36,42
97,CLU,P005113,P012621,15.567,-11,31,42
97,CLU,P005113,P012698,7.583,4,22,18
97,CLU,P005373,P010569,21.716,0,44,44
97,CLU,P005373,P011797,20.566,0,42,42
97,CLU,P005373,P011801,10.183,2,21,19
97,CLU,P005373,P012621,3.033,3,9,6
97,CLU,P005373,P012698,17.216,1,31,30
97,CLU,P005714,P010569,0.017,0,0,0
97,CLU,P005714,P011797,2.317,-7,0,7
97,CLU,P005714,P011801,11.734,-4,23,27
97,CLU,P005714,P012621,11.717,-4,23,27
97,CLU,P005714,P012698,3.867,2,10,8
97,CLU,P010569,P011797,22.25,-5,46,51
97,CLU,P010569,P011801,14.833,4,37,33
97,CLU,P010569,P012621,6.383,0,20,20
97,CLU,P010569,P012698,21.866,3,47,44
97,CLU,P011797,P011801,13.9,-9,24,33
97,CLU,P011797,P012621,7.0,-13,12,25
97,CLU,P011797,P012698,17.233,1,33,32
97,CLU,P011801,P012621,18.983,-3,44,47
97,CLU,P011801,P012698,14.183,7,34,27
97,CLU,P012621,P012698,7.833,4,23,19
97,TTK,P004801,P005000,11.6,14,32,18
97,TTK,P004801,P005685,10.317,9,23,14
97,TTK,P004801,P006693,22.783,14,46,32
97,TTK,P004801,P009845,2.933,4,10,6
97,TTK,P004801,P011239,19.332,9,44,35
97,TTK,P004801,P011834,27.616,17,66,49
97,TTK,P004801,P011925,23.9,7,45,38
97,TTK,P004801,P011975,0.183,-2,2,4
97,TTK,P005000,P005685,10.567,0,21,21
97,TTK,P005000,P006693,13.233,8,38,30
97,TTK,P005000,P009845,4.25,2,13,11
97,TTK,P005000,P011239,10.666,12,39,27
97,TTK,P005000,P011834,19.2,11,59,48
97,TTK,P005000,P011925,15.484,1,38,37
97,TTK,P005685,P006693,11.133,1,24,23
97,TTK,P005685,P011834,12.0,0,29,29
97,TTK,P005685,P011925,11.5,-1,23,24
97,TTK,P005685,P011975,0.683,-5,0,5
97,TTK,P006693,P011239,20.649,8,47,39
97,TTK,P006693,P011834,29.749,8,70,62
97,TTK,P006693,P011925,28.966,2,59,57
97,TTK,P006693,P011975,0.683,-5,0,5
97,TTK,P009845,P011239,4.25,2,13,11
97,TTK,P009845,P011834,4.25,2,13,11
97,TTK,P009845,P011925,1.317,-2,3,5
97,TTK,P011239,P011834,25.932,10,65,55
97,TTK,P011239,P011925,22.716,1,50,49
97,TTK,P011239,P011975,0.183,-2,2,4
97,TTK,P011834,P011925,32.183,-1,72,73
97,TTK,P011834,P011975,0.866,-7,2,9
97,TTK,P011925,P011975,0.866,-7,2,9
98,BUD,P002740,P004397,8.967,-3,13,16
98,BUD,P002740,P004945,20.282,6,48,42
98,BUD,P002740,P006566,12.615,5,36,31
98,BUD,P002740,P007398,6.166,-4,10,14
98,BUD,P002740,P010248,17.282,7,46,39
98,BUD,P002740,P010432,8.833,-2,11,13
98,BUD,P002740,P011281,17.832,6,38,32
98,BUD,P002740,P011935,4.3,1,6,5
98,BUD,P002740,P012606,8.183,4,20,16
98,BUD,P004397,P004945,9.4,-5,12,17
98,BUD,P004397,P006566,4.733,-2,6,8
98,BUD,P004397,P007398,4.3,0,7,7
98,BUD,P004397,P010248,9.4,-5,12,17
98,BUD,P004397,P010432,4.3,0,7,7
98,BUD,P004397,P011281,4.3,0,7,7
98,BUD,P004397,P012606,9.4,-5,12,17
98,BUD,P004945,P006566,19.316,1,46,45
98,BUD,P004945,P007398,2.617,-2,5,7
98,BUD,P004945,P010248,24.316,3,56,53
98,BUD,P004945,P010432,3.017,-4,2,6
98,BUD,P004945,P011281,12.016,4,29,25
98,BUD,P004945,P011935,3.1,2,4,2
98,BUD,P004945,P012605,0.767,2,2,0
98,BUD,P004945,P012606,14.433,1,28,27
98,BUD,P006566,P007398,9.8,-1,21,22
98,BUD,P006566,P010248,18.733,4,48,44
98,BUD,P006566,P010432,7.783,-5,14,19
98,BUD,P006566,P011281,13.199,0,31,31
98,BUD,P006566,P011935,6.467,3,16,13
98,BUD,P006566,P012605,3.817,1,10,9
98,BUD,P006566,P012606,9.533,2,20,18
98,BUD,P007398,P010248,3.467,-2,7,9
98,BUD,P007398,P010432,11.833,0,23,23
98,BUD,P007398,P011281,10.016,-1,17,18
98,BUD,P007398,P011935,7.667,2,18,16
98,BUD,P007398,P012605,3.817,1,10,9
98,BUD,P007398,P012606,1.517,-1,2,3
98,BUD,P010248,P010432,0.017,-3,0,3
98,BUD,P010248,P011281,9.016,5,27,22
98,BUD,P010248,P011935,2.383,0,4,4
98,BUD,P010248,P012605,1.617,2,4,2
98,BUD,P010248,P012606,14.433,1,28,27
98,BUD,P010432,P011281,13.033,-5,19,24
98,BUD,P010432,P011935,8.384,4,18,14
98,BUD,P010432,P012605,2.2,-1,6,7
98,BUD,P011281,P011935,8.1,3,14,11
98,BUD,P011281,P012605,0.383,-2,0,2
98,BUD,P011281,P012606,0.233,2,2,0
98,BUD,P011935,P012605,2.667,1,8,7
98,LKB,P002012,P005521,17.066,3,41,38
98,LKB,P002012,P006230,14.467,13,31,18
98,LKB,P002012,P007029,22.001,6,47,41
98,LKB,P002012,P008856,21.883,5,39,34
98,LKB,P002012,P010190,1.933,-1,5,6
98,LKB,P002012,P010461,13.933,-4,30,34
98,LKB,P002012,PLXI,24.317,2,51,49
98,LKB,P004868,P005521,9.816,-2,20,22
98,LKB,P004868,P006230,5.616,-1,11,12
98,LKB,P004868,P006901,1.533,0,2,2
98,LKB,P004868,P007029,6.766,-3,11,14
98,LKB,P004868,P008856,3.2,1,7,6
98,LKB,P004868,P010190,4.85,-1,11,12
98,LKB,P004868,P010461,2.667,-1,7,8
98,LKB,P004868,PLXI,4.816,-1,11,12
98,LKB,P005521,P006230,11.916,-1,22,23
98,LKB,P005521,P006901,1.533,0,2,2
98,LKB,P005521,P007029,18.216,-6,38,44
98,LKB,P005521,P008856,14.549,0,29,29
98,LKB,P005521,P010190,6.783,-2,16,18
98,LKB,P005521,P010461,14.199,-4,34,38
98,LKB,P005521,PLXI,18.582,-8,42,50
98,LKB,P006230,P007029,16.167,8,33,25
98,LKB,P006230,P008856,15.983,12,32,20
98,LKB,P006230,P010190,2.183,0,4,4
98,LKB,P006230,P010461,0.017,3,3,0
98,LKB,P006230,PLXI,13.983,14,32,18
98,LKB,P006901,P007029,1.533,0,2,2
98,LKB,P006901,PLXI,1.533,0,2,2
98,LKB,P007029,P008856,21.4,-1,37,38
98,LKB,P007029,P010190,1.8,-2,2,4
98,LKB,P007029,P010461,11.85,-8,23,31
98,LKB,P007029,PLXI,20.467,-6,39,45
98,LKB,P008856,P010461,9.866,-12,11,23
98,LKB,P008856,PLXI,18.583,-5,29,34
98,LKB,P010190,P010461,4.6,-2,12,14
98,LKB,P010190,PLXI,4.983,0,14,14
98,LKB,P010461,PLXI,14.4,-16,28,44
99,ARI,P002867,P004292,4.083,-10,2,12
99,ARI,P002867,P010387,13.718,-9,17,26
99,ARI,P002867,P012616,6.401,-8,9,17
99,ARI,P002867,P012702,8.484,-2,12,14
99,ARI,P002867,P012707,8.384,-4,13,17
99,ARI,P002867,P012708,7.05,-11,5,16
99,ARI,P002867,P012716,8.018,-1,11,12
99,ARI,P002867,P012717,3.25,-8,3,11
99,ARI,P002867,P012722,7.118,-10,8,18
99,ARI,P002867,P012760,1.366,-5,0,5
99,ARI,P004292,P010387,5.466,-7,8,15
99,ARI,P004292,P012616,11.017,-11,17,28
99,ARI,P004292,P012702,10.567,-4,24,28
99,ARI,P004292,P012707,6.383,-3,13,16
99,ARI,P004292,P012708,12.382,-6,28,34
99,ARI,P004292,P012716,7.867,-6,18,24
99,ARI,P004292,P012717,15.4,-11,31,42
99,ARI,P004292,P012722,8.433,-9,15,24
99,ARI,P004292,P012760,1.866,-5,0,5
99,ARI,P010177,P012616,1.85,0,4,4
99,ARI,P010177,P012708,1.85,0,4,4
99,ARI,P010177,P012717,1.85,0,4,4
99,ARI,P010177,P012722,1.85,0,4,4
99,ARI,P010387,P012616,9.717,-12,15,27
99,ARI,P010387,P012702,9.384,-6,12,18
99,ARI,P010387,P012707,10.017,-8,13,21
99,ARI,P010387,P012708,5.383,-1,8,9
99,ARI,P010387,P012716,6.801,-2,8,10
99,ARI,P010387,P012722,7.417,-7,11,18
99,ARI,P010387,P012760,0.233,0,0,0
99,ARI,P012616,P012702,6.401,-5,10,15
99,ARI,P012616,P012707,9.567,-10,13,23
99,ARI,P012616,P012708,8.75,-7,15,22
99,ARI,P012616,P012716,1.217,-2,2,4
99,ARI,P012616,P012717,9.684,-7,15,22
99,ARI,P012616,P012722,11.1,-11,18,29
99,ARI,P012616,P012760,1.9,-3,2,5
99,ARI,P012702,P012707,13.317,-9,19,28
99,ARI,P012702,P012708,8.333,0,17,17
99,ARI,P012702,P012716,13.501,-4,26,30
99,ARI,P012702,P012717,10.817,-2,24,26
99,ARI,P012707,P012708,5.516,0,10,10
99,ARI,P012707,P012716,8.484,-3,11,14
99,ARI,P012707,P012717,9.15,-2,17,19
99,ARI,P012707,P012722,2.75,0,7,7
99,ARI,P012707,P012760,3.1,-1,4,5
99,ARI,P012708,P012716,11.184,-2,20,22
99,ARI,P012708,P012717,17.983,-12,33,45
99,ARI,P012708,P012722,10.067,-7,20,27
99,ARI,P012708,P012760,4.966,-6,4,10
99,ARI,P012716,P012717,11.584,-5,23,28
99,ARI,P012716,P012722,3.184,-5,3,8
99,ARI,P012716,P012760,1.7,2,2,0
99,ARI,P012717,P012722,7.417,-7,14,21
99,ARI,P012717,P012760,4.733,-6,4,10
99,CAN,P001607,P003637,0.55,0,2,2
99,CAN,P001607,P004160,17.8,12,37,25
99,CAN,P001607,P005005,11.833,2,25,23
99,CAN,P001607,P007560,4.617,7,9,2
99,CAN,P001607,P007644,15.9,12,35,23
99,CAN,P001607,P008121,1.9,3,5,2
99,CAN,P001607,P009864,0.783,1,3,2
99,CAN,P001607,P010385,7.8,6,19,13
99,CAN,P001607,P010452,8.85,2,16,14
99,CAN,P001607,P010484,3.367,3,5,2
99,CAN,P003425,P003637,16.4,9,39,30
99,CAN,P003425,P004160,1.417,3,3,0
99,CAN,P003425,P005005,0.8,1,2,1
99,CAN,P003425,P007560,0.833,1,2,1
99,CAN,P003425,P007644,9.784,6,20,14
99,CAN,P003425,P008121,17.784,12,42,30
99,CAN,P003425,P009864,11.85,3,28,25
99,CAN,P003425,P010385,6.767,10,16,6
99,CAN,P003425,P010452,8.0,6,22,16
99,CAN,P003425,P010484,0.833,1,2,1
99,CAN,P003637,P005005,0.55,0,2,2
99,CAN,P003637,P007560,0.033,0,0,0
99,CAN,P003637,P007644,8.917,3,19,16
99,CAN,P003637,P008121,16.367,9,39,30
99,CAN,P003637,P009864,12.4,3,30,27
99,CAN,P003637,P010385,4.55,6,11,5
99,CAN,P003637,P010452,8.0,6,22,16
99,CAN,P003637,P010484,0.033,0,0,0
99,CAN,P004160,P005005,14.317,5,33,28
99,CAN,P004160,P007560,7.651,10,19,9
99,CAN,P004160,P007644,19.801,18,46,28
99,CAN,P004160,P008121,3.317,6,8,2
99,CAN,P004160,P009864,0.233,1,1,0
99,CAN,P004160,P010385,10.034,11,24,13
99,CAN,P004160,P010452,8.85,2,16,14
99,CAN,P004160,P010484,5.584,4,13,9
99,CAN,P005005,P007560,3.834,4,12,8
99,CAN,P005005,P007644,12.417,5,31,26
99,CAN,P005005,P009864,0.55,0,2,2
99,CAN,P005005,P010385,7.75,7,19,12
99,CAN,P005005,P010452,7.6,-2,12,14
99,CAN,P005005,P010484,3.017,2,10,8
99,CAN,P007560,P007644,7.651,10,19,9
99,CAN,P007560,P010385,1.65,3,4,1
99,CAN,P007560,P010452,1.25,4,4,0
99,CAN,P007560,P010484,6.417,5,15,10
99,CAN,P007644,P008121,11.684,9,25,16
99,CAN,P007644,P009864,5.05,-2,9,11
99,CAN,P007644,P010385,11.684,17,31,14
99,CAN,P007644,P010452,6.4,2,12,10
99,CAN,P007644,P010484,5.584,4,13,9
99,CAN,P008121,P009864,12.083,4,29,25
99,CAN,P008121,P010385,7.601,11,18,7
99,CAN,P008121,P010452,8.0,6,22,16
99,CAN,P009864,P010452,7.583,6,22,16
99,CAN,P010385,P010452,2.867,0,4,4
99,CAN,P010385,P010484,0.833,1,2,1
100,TRN,P001479,P005738,11.883,9,26,17
100,TRN,P001479,P006382,9.884,8,25,17
100,TRN,P001479,P007828,6.999,-7,5,12
100,TRN,P001479,P009903,10.416,-3,26,29
100,TRN,P001479,P012593,19.449,-2,36,38
100,TRN,P001479,P012595,14.266,9,40,31
100,TRN,P001479,P012597,13.883,7,43,36
100,TRN,P001479,P012687,2.416,3,7,4
100,TRN,P005738,P006382,7.901,8,21,13
100,TRN,P005738,P007828,4.3,-3,2,5
100,TRN,P005738,P009903,17.7,-8,31,39
100,TRN,P005738,P012593,12.033,-7,14,21
100,TRN,P005738,P012595,25.566,6,55,49
100,TRN,P005738,P012597,23.433,-1,48,49
100,TRN,P005738,P012687,15.516,0,31,31
100,TRN,P006382,P007828,2.35,0,2,2
100,TRN,P006382,P009903,6.717,-6,8,14
100,TRN,P006382,P012593,8.317,-3,11,14
100,TRN,P006382,P012595,7.034,9,22,13
100,TRN,P006382,P012597,6.601,3,18,15
100,TRN,P006382,P012687,0.2,1,1,0
100,TRN,P007828,P009903,2.699,-4,3,7
100,TRN,P007828,P012593,6.999,-7,5,12
100,TRN,P007828,P012595,2.733,-3,0,3
100,TRN,P007828,P012597,1.883,-4,3,7
100,TRN,P007828,P012687,0.033,0,0,0
100,TRN,P009903,P012593,12.116,-11,22,33
100,TRN,P009903,P012595,22.2,-7,47,54
100,TRN,P009903,P012597,25.85,-8,57,65
100,TRN,P009903,P012687,14.766,3,34,31
100,TRN,P012593,P012595,13.016,-3,25,28
100,TRN,P012593,P012597,13.383,-9,27,36
100,TRN,P012593,P012687,1.883,2,4,2
100,TRN,P012595,P012597,24.983,5,64,59
100,TRN,P012595,P012687,14.266,0,31,31
100,TRN,P012597,P012687,16.316,3,36,33
100,ULM,P005422,P006997,9.916,4,29,25
100,ULM,P005422,P010106,15.416,-18,31,49
100,ULM,P005422,P010582,10.9,4,23,19
100,ULM,P005422,P010726,6.083,-4,17,21
100,ULM,P005422,P011457,0.033,0,0,0
100,ULM,P005422,P012603,22.183,-3,55,58
100,ULM,P005422,P012604,12.3,-7,26,33
100,ULM,P005422,P012629,5.233,-3,15,18
100,ULM,P005422,P012703,6.8,15,24,9
100,ULM,P006997,P010106,4.783,-3,13,16
100,ULM,P006997,P010582,3.4,1,5,4
100,ULM,P006997,P010726,7.35,-10,15,25
100,ULM,P006997,P011457,3.0,-3,2,5
100,ULM,P006997,P012603,11.817,1,31,30
100,ULM,P006997,P012604,1.85,-5,2,7
100,ULM,P006997,P012629,9.017,-6,15,21
100,ULM,P006997,P012703,10.667,-3,20,23
100,ULM,P010106,P010582,9.983,-6,16,22
100,ULM,P010106,P010726,11.017,-2,23,25
100,ULM,P010106,P011457,7.234,3,12,9
100,ULM,P010106,P012603,15.416,-18,31,49
100,ULM,P010106,P012604,17.917,-12,30,42
100,ULM,P010106,P012629,6.517,-5,11,16
100,ULM,P010106,P012703,2.517,1,5,4
100,ULM,P010582,P010726,0.05,0,0,0
100,ULM,P010582,P011457,4.1,-1,6,7
100,ULM,P010582,P012603,14.667,12,33,21
100,ULM,P010582,P012604,15.417,10,34,24
100,ULM,P010582,P012629,7.917,7,16,9
100,ULM,P010582,P012703,8.834,17,23,6
100,ULM,P010726,P011457,4.884,2,6,4
100,ULM,P010726,P012603,8.0,-2,21,23
100,ULM,P010726,P012604,9.284,0,16,16
100,ULM,P010726,P012629,6.184,-2,7,9
100,ULM,P010726,P012703,6.284,-2,11,13
100,ULM,P011457,P012603,1.217,-1,2,3
100,ULM,P011457,P012604,7.234,3,12,9
100,ULM,P011457,P012629,7.717,-1,9,10
100,ULM,P011457,P012703,5.517,-2,7,9
100,ULM,P012603,P012604,17.267,5,40,35
100,ULM,P012603,P012629,12.101,6,31,25
100,ULM,P012603,P012703,13.668,24,40,16
100,ULM,P012604,P012629,13.334,2,27,25
100,ULM,P012604,P012703,11.001,16,29,13
100,ULM,P012629,P012703,13.984,6,29,23
101,BES,P003783,P005348,4.849,-11,8,19
101,BES,P003783,P007914,18.833,-12,30,42
101,BES,P003783,P008945,5.833,0,10,10
101,BES,P003783,P009582,11.366,-10,17,27
101,BES,P003783,P011357,3.833,-13,5,18
101,BES,P003783,P011379,9.55,-5,17,22
101,BES,P003783,P011924,11.933,-11,21,32
101,BES,P003783,P011936,9.55,-8,11,19
101,BES,P003783,P012622,14.133,-11,23,34
101,BES,P003783,P012647,12.116,-3,18,21
101,BES,P005348,P007914,0.267,3,3,0
101,BES,P005348,P008945,0.167,3,3,0
101,BES,P005348,P009582,3.533,-2,11,13
101,BES,P005348,P011357,2.666,-9,3,12
101,BES,P005348,P011924,4.949,-11,8,19
101,BES,P005348,P012622,1.85,-3,3,6
101,BES,P005348,P012647,2.183,-2,5,7
101,BES,P007914,P008945,14.4,14,34,20
101,BES,P007914,P009582,8.067,-8,10,18
101,BES,P007914,P011357,1.167,-4,2,6
101,BES,P007914,P011379,13.2,-7,23,30
101,BES,P007914,P011924,5.934,-6,11,17
101,BES,P007914,P011936,15.183,1,30,29
101,BES,P007914,P012622,21.784,5,47,42
101,BES,P007914,P012647,13.433,6,26,20
101,BES,P008945,P009582,3.283,3,5,2
101,BES,P008945,P011379,9.583,-9,14,23
101,BES,P008945,P011924,5.266,-8,6,14
101,BES,P008945,P011936,12.716,3,27,24
101,BES,P008945,P012622,17.5,6,38,32
101,BES,P008945,P012647,9.916,12,23,11
101,BES,P009582,P011357,2.25,-7,5,12
101,BES,P009582,P011379,1.933,-1,3,4
101,BES,P009582,P011924,8.267,-10,15,25
101,BES,P009582,P011936,3.417,-2,2,4
101,BES,P009582,P012622,1.784,-1,3,4
101,BES,P009582,P012647,8.7,-6,9,15
101,BES,P011357,P011924,3.833,-13,5,18
101,BES,P011357,P012622,1.583,-6,0,6
101,BES,P011379,P011924,5.433,-3,9,12
101,BES,P011379,P011936,7.333,-12,6,18
101,BES,P011379,P012622,13.1,-11,20,31
101,BES,P011924,P011936,7.083,-6,8,14
101,BES,P011924,P012622,10.266,-17,12,29
101,BES,P011924,P012647,8.5,-7,13,20
101,BES,P011936,P012622,18.849,-3,36,39
101,BES,P011936,P012647,14.933,7,32,25
101,BES,P012622,P012647,13.683,5,30,25
101,PMT,P001686,P002644,5.849,2,16,14
101,PMT,P001686,P010549,5.849,2,16,14
101,PMT,P001686,P011823,4.917,2,12,10
101,PMT,P001686,P011943,4.35,3,10,7
101,PMT,P001686,P011944,5.966,-4,10,14
101,PMT,P001686,P011947,6.233,4,18,14
101,PMT,P001686,P011966,4.8,8,18,10
101,PMT,P001686,P012600,5.1,-1,12,13
101,PMT,P002020,P002644,1.167,-3,0,3
101,PMT,P002020,P011823,1.917,-5,2,7
101,PMT,P002020,P011942,3.084,-8,2,10
101,PMT,P002020,P011944,3.084,-8,2,10
101,PMT,P002020,P012600,3.084,-8,2,10
101,PMT,P002644,P010549,16.667,12,40,28
101,PMT,P002644,P011823,0.383,2,2,0
101,PMT,P002644,P011942,1.167,-3,0,3
101,PMT,P002644,P011943,15.351,10,31,21
101,PMT,P002644,P011944,6.183,-5,8,13
101,PMT,P002644,P011947,15.4,16,37,21
101,PMT,P002644,P011966,17.333,19,45,26
101,PMT,P002644,P012600,11.5,-6,17,23
101,PMT,P010549,P011823,5.683,11,13,2
101,PMT,P010549,P011943,16.501,21,37,16
101,PMT,P010549,P011944,3.849,-3,4,7
101,PMT,P010549,P011947,13.95,15,32,17
101,PMT,P010549,P011966,16.584,28,49,21
101,PMT,P010549,P012600,10.317,6,21,15
101,PMT,P011823,P011942,1.917,-5,2,7
101,PMT,P011823,P011943,14.767,14,36,22
101,PMT,P011823,P011944,10.0,-4,16,20
101,PMT,P011823,P011947,4.25,3,13,10
101,PMT,P011823,P011966,9.851,12,30,18
101,PMT,P011823,P012600,16.851,10,42,32
101,PMT,P011942,P011944,3.084,-8,2,10
101,PMT,P011942,P012600,3.084,-8,2,10
101,PMT,P011943,P011944,11.483,6,22,16
101,PMT,P011943,P011947,12.651,11,28,17
101,PMT,P011943,P011966,21.618,19,53,34
101,PMT,P011943,P012600,23.751,12,51,39
101,PMT,P011944,P011947,3.033,0,4,4
101,PMT,P011944,P011966,4.9,-1,8,9
101,PMT,P011944,P012600,13.15,-9,20,29
101,PMT,P011947,P011966,14.317,19,44,25
101,PMT,P011947,P012600,7.234,0,16,16
101,PMT,P011966,P012600,17.801,12,45,33
102,JOV,P002361,P002507,5.085,4,12,8
102,JOV,P002361,P005094,6.301,0,13,13
102,JOV,P002361,P006771,10.618,10,28,18
102,JOV,P002361,P010458,9.751,9,26,17
102,JOV,P002361,P010708,12.417,6,29,23
102,JOV,P002361,P011247,4.667,3,11,8
102,JOV,P002361,P011248,13.785,16,39,23
102,JOV,P002361,P012349,7.068,2,15,13
102,JOV,P002361,PJUG,0.984,2,3,1
102,JOV,P002507,P005094,10.618,-3,17,20
102,JOV,P002507,P006771,9.651,5,18,13
102,JOV,P002507,P010458,2.484,2,6,4
102,JOV,P002507,P011247,18.684,0,32,32
102,JOV,P002507,P011248,16.134,6,30,24
102,JOV,P002507,P012349,14.351,0,26,26
102,JOV,P002507,PJUG,11.401,2,23,21
102,JOV,P005094,P010458,7.117,-5,14,19
102,JOV,P005094,P010708,4.1,-2,7,9
102,JOV,P005094,P011247,14.534,-6,26,32
102,JOV,P005094,P011248,7.451,6,17,11
102,JOV,P005094,P012349,4.534,-3,8,11
102,JOV,P005094,P012780,2.033,-4,4,8
102,JOV,P005094,PJUG,10.984,-7,18,25
102,JOV,P006771,P010458,7.2,0,19,19
102,JOV,P006771,P010708,8.2,0,19,19
102,JOV,P006771,P011247,9.883,-7,15,22
102,JOV,P006771,P011248,18.467,2,37,35
102,JOV,P006771,P012349,13.301,3,24,21
102,JOV,P006771,P012780,2.65,-2,6,8
102,JOV,P006771,PJUG,2.034,1,6,5
102,JOV,P010458,P010708,7.733,-1,17,18
102,JOV,P010458,P011247,9.133,-10,18,28
102,JOV,P010458,P011248,8.717,9,27,18
102,JOV,P010458,P012780,4.683,-6,10,16
102,JOV,P010458,PJUG,3.45,-6,7,13
102,JOV,P010708,P011247,3.466,-5,5,10
102,JOV,P010708,P011248,10.967,4,27,23
102,JOV,P010708,P012349,5.317,2,12,10
102,JOV,P011247,P011248,16.483,5,33,28
102,JOV,P011247,P012349,12.6,0,23,23
102,JOV,P011247,P012780,4.683,-6,10,16
102,JOV,P011247,PJUG,13.867,-6,27,33
102,JOV,P011248,P012349,14.517,2,27,25
102,JOV,P011248,P012780,1.233,0,3,3
102,JOV,P011248,PJUG,6.25,2,12,10
102,JOV,P012349,PJUG,6.984,2,17,15
102,JOV,P012780,PJUG,3.45,-6,7,13
102,LJU,P002561,P003452,4.799,-1,9,10
102,LJU,P002561,P005969,0.483,0,0,0
102,LJU,P002561,P009395,4.799,-1,9,10
102,LJU,P002561,P010594,0.35,0,0,0
102,LJU,P002561,P011261,1.933,0,3,3
102,LJU,P002561,P012598,4.449,-1,9,10
102,LJU,P002561,P012700,2.383,-1,6,7
102,LJU,P003452,P005969,26.151,-1,53,54
102,LJU,P003452,P009392,5.484,-5,10,15
102,LJU,P003452,P009395,28.984,3,62,59
102,LJU,P003452,P010594,18.134,-3,36,39
102,LJU,P003452,P011261,3.6,-4,5,9
102,LJU,P003452,P012598,8.499,-2,16,18
102,LJU,P003452,P012700,26.217,5,57,52
102,LJU,P005969,P009392,5.484,-5,10,15
102,LJU,P005969,P009395,32.168,1,64,63
102,LJU,P005969,P010594,27.667,-3,55,58
102,LJU,P005969,P011261,11.2,-4,21,25
102,LJU,P005969,P012598,9.583,2,23,21
102,LJU,P005969,P012700,30.0,6,62,56
102,LJU,P009392,P009395,5.484,-5,10,15
102,LJU,P009392,P010594,0.167,-3,0,3
102,LJU,P009392,P012700,5.317,-2,10,12
102,LJU,P009395,P010594,24.151,-1,47,48
102,LJU,P009395,P011261,11.1,-7,16,23
102,LJU,P009395,P012598,10.383,3,24,21
102,LJU,P009395,P012700,28.867,7,60,53
102,LJU,P010594,P011261,11.2,-4,21,25
102,LJU,P010594,P012598,6.883,-2,16,18
102,LJU,P010594,P012700,22.116,4,45,41
102,LJU,P011261,P012598,7.333,3,19,16
102,LJU,P011261,P012700,6.166,0,11,11
102,LJU,P012598,P012700,8.466,1,21,20
103,HTA,P003533,P004267,4.267,-6,3,9
103,HTA,P003533,P004846,8.451,-8,12,20
103,HTA,P003533,P006835,5.684,-6,8,14
103,HTA,P003533,P007759,5.584,-4,10,14
103,HTA,P003533,P010465,4.184,-2,9,11
103,HTA,P003533,P010550,2.467,-4,2,6
103,HTA,P003533,P011991,3.167,-2,4,6
103,HTA,P004267,P004846,4.517,-5,5,10
103,HTA,P004267,P006835,10.15,-2,21,23
103,HTA,P004267,P007759,12.633,-3,26,29
103,HTA,P004267,P010465,6.0,7,16,9
103,HTA,P004267,P010550,3.5,1,7,6
103,HTA,P004267,P011973,3.383,-2,9,11
103,HTA,P004267,P011991,10.15,6,25,19
103,HTA,P004846,P006835,14.783,7,40,33
103,HTA,P004846,P007759,7.75,0,17,17
103,HTA,P004846,P010465,13.384,11,41,30
103,HTA,P004846,P010550,8.6,-4,17,21
103,HTA,P004846,P011973,3.133,-2,8,10
103,HTA,P004846,P011991,13.05,9,36,27
103,HTA,P006835,P007759,14.5,3,34,31
103,HTA,P006835,P010465,19.467,19,56,37
103,HTA,P006835,P010550,6.683,5,18,13
103,HTA,P006835,P011973,4.533,-5,12,17
103,HTA,P006835,P011991,21.4,11,55,44
103,HTA,P007759,P010465,21.85,16,50,34
103,HTA,P007759,P010550,16.633,1,29,28
103,HTA,P007759,P011973,14.416,-2,28,30
103,HTA,P007759,P011991,23.966,13,54,41
103,HTA,P010465,P010550,17.9,4,37,33
103,HTA,P010465,P011973,14.083,-1,27,28
103,HTA,P010465,P011991,29.8,18,72,54
103,HTA,P010550,P011973,12.933,2,24,22
103,HTA,P010550,P011991,19.616,7,42,35
103,HTA,P011973,P011991,17.383,-2,36,38
103,WOL,P002387,P003212,16.368,-10,32,42
103,WOL,P002387,P005516,17.7,5,45,40
103,WOL,P002387,P006154,4.75,-2,8,10
103,WOL,P002387,P006546,21.934,1,53,52
103,WOL,P002387,P012576,15.617,0,41,41
103,WOL,P002387,P012577,10.884,-10,22,32
103,WOL,P002387,P012789,9.484,-6,15,21
103,WOL,P002387,PLCT,3.667,-2,8,10
103,WOL,P003212,P004645,1.633,-4,1,5
103,WOL,P003212,P005516,11.283,2,27,25
103,WOL,P003212,P006154,4.383,6,11,5
103,WOL,P003212,P006546,16.867,-15,32,47
103,WOL,P003212,P012576,12.7,-8,25,33
103,WOL,P003212,P012577,8.717,-11,14,25
103,WOL,P003212,P012789,7.617,-5,14,19
103,WOL,P003212,PLCT,1.7,-7,0,7
103,WOL,P004645,P005516,10.95,1,18,17
103,WOL,P004645,P006154,9.167,-2,13,15
103,WOL,P004645,P006546,3.416,-1,6,7
103,WOL,P004645,P012576,12.583,-3,19,22
103,WOL,P004645,P012577,12.583,-3,19,22
103,WOL,P005516,P006154,13.6,-2,22,24
103,WOL,P005516,P006546,16.599,12,47,35
103,WOL,P005516,P012576,26.016,7,60,53
103,WOL,P005516,P012577,20.233,4,40,36
103,WOL,P005516,P012789,4.95,0,9,9
103,WOL,P005516,PLCT,2.533,-1,8,9
103,WOL,P006154,P006546,3.0,3,6,3
103,WOL,P006154,P012576,13.5,-3,23,26
103,WOL,P006154,P012577,12.95,-3,21,24
103,WOL,P006154,P012789,2.45,3,4,1
103,WOL,P006546,P012576,16.149,3,44,41
103,WOL,P006546,P012577,11.133,-4,25,29
103,WOL,P006546,P012789,9.484,-6,15,21
103,WOL,P006546,PLCT,3.95,-5,8,13
103,WOL,P012576,P012577,24.183,-5,44,49
103,WOL,P012576,PLCT,1.316,1,8,7
103,WOL,P012577,P012789,1.317,-4,3,7
103,WOL,P012789,PLCT,2.634,-6,0,6
104,PRS,P004512,P005793,10.084,-7,18,25
104,PRS,P004512,P009556,0.667,2,2,0
104,PRS,P004512,P011232,2.8,4,8,4
104,PRS,P004512,P011887,3.884,-8,7,15
104,PRS,P004512,P012608,14.834,-3,28,31
104,PRS,P004512,P012609,7.617,-5,11,16
104,PRS,P004512,P012610,14.901,-5,28,33
104,PRS,P004512,P012613,4.817,2,10,8
104,PRS,P005793,P010801,2.267,0,2,2
104,PRS,P005793,P011232,0.067,-2,0,2
104,PRS,P005793,P011887,2.467,-2,7,9
104,PRS,P005793,P012608,17.551,5,41,36
104,PRS,P005793,P012609,9.884,-5,13,18
104,PRS,P005793,P012610,17.618,3,41,38
104,PRS,P005793,P012613,5.267,10,21,11
104,PRS,P005793,P012640,5.267,10,21,11
104,PRS,P009556,P010801,6.734,4,10,6
104,PRS,P009556,P011232,16.567,25,48,23
104,PRS,P009556,P011551,3.95,3,5,2
104,PRS,P009556,P011887,3.95,3,5,2
104,PRS,P009556,P012608,0.667,2,2,0
104,PRS,P009556,P012609,11.25,24,43,19
104,PRS,P009556,P012610,0.667,2,2,0
104,PRS,P009556,P012613,11.867,21,40,19
104,PRS,P009556,P012640,12.617,22,43,21
104,PRS,P010801,P011232,6.734,4,10,6
104,PRS,P010801,P011551,3.95,3,5,2
104,PRS,P010801,P011887,3.95,3,5,2
104,PRS,P010801,P012608,3.267,0,3,3
104,PRS,P010801,P012609,3.684,3,7,4
104,PRS,P010801,P012610,3.267,0,3,3
104,PRS,P010801,P012613,2.367,-2,1,3
104,PRS,P010801,P012640,3.784,1,6,5
104,PRS,P011232,P011551,3.95,3,5,2
104,PRS,P011232,P011887,3.95,3,5,2
104,PRS,P011232,P012608,2.733,6,8,2
104,PRS,P011232,P012609,11.317,22,43,21
104,PRS,P011232,P012610,2.8,4,8,4
104,PRS,P011232,P012613,13.933,25,46,21
104,PRS,P011232,P012640,12.617,22,43,21
104,PRS,P011551,P011887,3.95,3,5,2
104,PRS,P011887,P012608,3.884,-8,7,15
104,PRS,P011887,P012610,3.884,-8,7,15
104,PRS,P011887,P012613,1.417,-6,0,6
104,PRS,P012608,P012609,9.817,-3,13,16
104,PRS,P012608,P012610,23.368,7,52,45
104,PRS,P012608,P012613,11.084,12,32,20
104,PRS,P012608,P012640,6.267,10,22,12
104,PRS,P012609,P012610,9.884,-5,13,18
104,PRS,P012609,P012613,9.833,21,38,17
104,PRS,P012609,P012640,11.25,24,43,19
104,PRS,P012610,P012613,11.084,12,32,20
104,PRS,P012610,P012640,6.267,10,22,12
104,PRS,P012613,P012640,17.467,29,60,31
104,VNC,P003759,P004381,9.967,-5,19,24
104,VNC,P003759,P008052,4.25,-6,5,11
104,VNC,P003759,P009400,2.433,2,4,2
104,VNC,P003759,P011909,12.267,-8,20,28
104,VNC,P003759,P011928,11.717,-2,22,24
104,VNC,P003759,P012587,3.567,-5,4,9
104,VNC,P003759,P012590,7.95,-6,12,18
104,VNC,P003759,P012591,11.717,-2,22,24
104,VNC,P004381,P008052,5.783,-11,9,20
104,VNC,P004381,P011909,14.85,-17,24,41
104,VNC,P004381,P011928,15.434,-18,26,44
104,VNC,P004381,P012590,5.9,-14,7,21
104,VNC,P004381,P012591,12.534,-11,23,34
104,VNC,P008052,P009400,4.2,2,12,10
104,VNC,P008052,P011909,13.917,-6,28,34
104,VNC,P008052,P011928,7.567,-6,17,23
104,VNC,P008052,P012587,8.184,3,21,18
104,VNC,P008052,P012590,12.767,-5,26,31
104,VNC,P008052,P012591,3.2,-3,6,9
104,VNC,P009400,P011909,5.383,1,11,10
104,VNC,P009400,P011928,10.283,-12,18,30
104,VNC,P009400,P012587,7.767,-7,20,27
104,VNC,P009400,P012590,13.433,-8,27,35
104,VNC,P009400,P012591,10.233,-10,16,26
104,VNC,P011909,P011928,23.284,-17,37,54
104,VNC,P011909,P012587,12.601,1,24,23
104,VNC,P011909,P012590,20.467,-14,31,45
104,VNC,P011909,P012591,19.967,-16,29,45
104,VNC,P011928,P012587,12.501,-9,24,33
104,VNC,P011928,P012590,22.384,-23,36,59
104,VNC,P011928,P012591,27.234,-25,44,69
104,VNC,P012587,P012590,18.218,-10,36,46
104,VNC,P012587,P012591,10.034,-13,15,28
104,VNC,P012590,P012591,18.017,-20,25,45
105,HAM,P001990,P009663,8.75,1,26,25
105,HAM,P001990,P010070,3.701,-6,4,10
105,HAM,P001990,P011187,4.651,0,11,11
105,HAM,P001990,P012579,7.218,1,19,18
105,HAM,P001990,P012580,8.35,-6,19,25
105,HAM,P001990,P012581,7.184,4,23,19
105,HAM,P001990,P012582,9.7,7,33,26
105,HAM,P001990,P012648,4.05,3,13,10
105,HAM,P009663,P010070,1.217,-3,2,5
105,HAM,P009663,P011168,14.416,14,31,17
105,HAM,P009663,P012579,5.85,3,15,12
105,HAM,P009663,P012580,17.566,2,36,34
105,HAM,P009663,P012581,20.167,14,50,36
105,HAM,P009663,P012582,22.816,12,55,43
105,HAM,P009663,P012648,4.483,-1,13,14
105,HAM,P009663,P012695,0.867,-6,0,6
105,HAM,P010070,P011168,6.316,-1,13,14
105,HAM,P010070,P011187,9.35,-6,15,21
105,HAM,P010070,P012579,10.567,-9,17,26
105,HAM,P010070,P012580,2.85,-3,4,7
105,HAM,P010070,P012581,2.85,-6,4,10
105,HAM,P010070,P012648,4.317,2,9,7
105,HAM,P010070,P012694,0.55,-2,0,2
105,HAM,P010070,P012695,0.55,-2,0,2
105,HAM,P011168,P011187,10.766,-5,15,20
105,HAM,P011168,P012579,12.182,1,22,21
105,HAM,P011168,P012580,14.533,10,28,18
105,HAM,P011168,P012581,17.099,7,29,22
105,HAM,P011168,P012582,18.133,12,33,21
105,HAM,P011168,P012648,6.55,0,13,13
105,HAM,P011168,P012694,0.733,-2,0,2
105,HAM,P011187,P012579,14.467,-5,26,31
105,HAM,P011187,P012580,5.817,-2,11,13
105,HAM,P011187,P012581,4.616,-7,2,9
105,HAM,P011187,P012582,5.884,1,11,10
105,HAM,P011187,P012648,6.484,2,13,11
105,HAM,P011187,P012694,1.283,-4,0,4
105,HAM,P011187,P012695,0.55,-2,0,2
105,HAM,P012579,P012580,5.05,-2,11,13
105,HAM,P012579,P012581,7.633,2,17,15
105,HAM,P012579,P012582,9.017,9,24,15
105,HAM,P012579,P012648,7.084,0,13,13
105,HAM,P012579,P012694,1.283,-4,0,4
105,HAM,P012579,P012695,0.917,-4,0,4
105,HAM,P012580,P012581,15.8,3,29,26
105,HAM,P012580,P012582,20.533,3,43,40
105,HAM,P012580,P012648,2.533,-1,7,8
105,HAM,P012580,P012695,0.5,-4,0,4
105,HAM,P012581,P012582,21.2,15,48,33
105,HAM,P012581,P012648,1.35,2,6,4
105,HAM,P012581,P012694,0.733,-2,0,2
105,HAM,P012581,P012695,0.5,-4,0,4
105,HAM,P012582,P012648,6.65,-1,17,18
105,HAM,P012582,P012695,0.867,-6,0,6
105,HAM,P012648,P012695,0.367,-2,0,2
105,HAM,P012694,P012695,0.55,-2,0,2
105,LLI,P004773,P005247,18.751,5,39,34
105,LLI,P004773,P006600,8.184,-7,16,23
105,LLI,P004773,P008274,11.017,2,23,21
105,LLI,P004773,P009649,8.367,-5,11,16
105,LLI,P004773,P009672,8.634,0,21,21
105,LLI,P004773,P009680,11.218,-3,23,26
105,LLI,P004773,P012020,11.434,4,23,19
105,LLI,P004773,P012585,0.867,-8,0,8
105,LLI,P005247,P006600,9.384,1,19,18
105,LLI,P005247,P008274,11.017,2,23,21
105,LLI,P005247,P009649,7.517,3,11,8
105,LLI,P005247,P009672,10.701,0,24,24
105,LLI,P005247,P009680,12.418,5,26,21
105,LLI,P005247,P012020,11.434,4,23,19
105,LLI,P005247,P012585,2.05,0,3,3
105,LLI,P006600,P008274,4.917,-8,4,12
105,LLI,P006600,P009649,22.868,-9,41,50
105,LLI,P006600,P009672,18.467,8,48,40
105,LLI,P006600,P009680,27.118,-2,56,58
105,LLI,P006600,P012585,20.534,-7,40,47
105,LLI,P008274,P009649,8.05,-3,11,14
105,LLI,P008274,P009672,4.517,-1,9,10
105,LLI,P008274,P009680,6.784,-2,11,13
105,LLI,P008274,P012020,10.267,6,23,17
105,LLI,P008274,P012585,4.167,-4,4,8
105,LLI,P009649,P009672,14.167,5,35,30
105,LLI,P009649,P009680,22.818,-5,43,48
105,LLI,P009649,P012020,3.833,5,9,4
105,LLI,P009649,P012585,19.184,-7,39,46
105,LLI,P009672,P009680,20.334,6,50,44
105,LLI,P009672,P012020,6.384,-3,11,14
105,LLI,P009672,P012585,16.2,5,38,33
105,LLI,P009680,P012020,4.484,0,9,9
105,LLI,P009680,P012585,21.234,-7,42,49
105,LLI,P012020,P012585,0.7,0,2,2
106,BOU,P000498,P004525,10.083,10,21,11
106,BOU,P000498,P010450,11.45,11,25,14
106,BOU,P000498,P010718,3.033,-5,7,12
106,BOU,P000498,P011161,14.483,6,32,26
106,BOU,P000498,P011836,4.4,-4,11,15
106,BOU,P000498,P011837,3.233,2,5,3
106,BOU,P000498,P012618,8.85,2,23,21
106,BOU,P000498,P012619,2.4,2,4,2
106,BOU,P004525,P010431,8.0,3,19,16
106,BOU,P004525,P010450,14.15,11,31,20
106,BOU,P004525,P010718,4.35,-1,9,10
106,BOU,P004525,P011161,11.9,8,25,17
106,BOU,P004525,P011837,6.566,3,14,11
106,BOU,P004525,P012617,7.017,-1,15,16
106,BOU,P004525,P012618,6.65,7,16,9
106,BOU,P004525,P012619,5.284,0,10,10
106,BOU,P010431,P010450,4.433,-2,10,12
106,BOU,P010431,P010718,15.367,13,31,18
106,BOU,P010431,P011161,2.983,-1,8,9
106,BOU,P010431,P011836,11.8,8,22,14
106,BOU,P010431,P011837,12.633,10,23,13
106,BOU,P010431,P012617,16.817,12,33,21
106,BOU,P010431,P012618,4.283,3,12,9
106,BOU,P010431,P012619,2.884,-2,6,8
106,BOU,P010450,P011161,13.983,0,27,27
106,BOU,P010450,P011836,3.483,-7,6,13
106,BOU,P010450,P011837,5.133,1,9,8
106,BOU,P010450,P012617,5.4,-1,12,13
106,BOU,P010450,P012618,7.933,-1,18,19
106,BOU,P010450,P012619,4.567,4,10,6
106,BOU,P010718,P011161,9.199,0,19,19
106,BOU,P010718,P011836,18.016,9,33,24
106,BOU,P010718,P011837,12.383,6,19,13
106,BOU,P010718,P012617,17.133,8,27,19
106,BOU,P010718,P012618,9.266,6,23,17
106,BOU,P010718,P012619,0.717,-4,0,4
106,BOU,P011161,P011836,11.282,-8,21,29
106,BOU,P011161,P011837,4.883,-3,5,8
106,BOU,P011161,P012617,5.716,-5,6,11
106,BOU,P011161,P012618,15.899,1,37,36
106,BOU,P011161,P012619,2.4,2,4,2
106,BOU,P011836,P011837,10.95,4,14,10
106,BOU,P011836,P012617,15.516,8,24,16
106,BOU,P011836,P012618,10.549,-2,25,27
106,BOU,P011837,P012617,14.283,5,23,18
106,BOU,P012617,P012618,5.366,4,10,6
106,BOU,P012617,P012619,2.884,-2,6,8
106,TRN,P001479,P005059,11.133,-9,13,22
106,TRN,P001479,P007828,2.35,4,9,5
106,TRN,P001479,P009903,8.65,-10,7,17
106,TRN,P001479,P012593,6.566,-3,15,18
106,TRN,P001479,P012594,0.367,0,0,0
106,TRN,P001479,P012595,14.533,-9,22,31
106,TRN,P001479,P012596,5.883,1,15,14
106,TRN,P001479,P012597,8.65,-10,7,17
106,TRN,P005059,P005738,8.184,7,17,10
106,TRN,P005059,P006382,2.15,-4,3,7
106,TRN,P005059,P009903,11.751,-7,11,18
106,TRN,P005059,P012593,6.199,-6,9,15
106,TRN,P005059,P012595,16.4,-1,27,28
106,TRN,P005059,P012596,7.649,3,19,16
106,TRN,P005059,P012597,14.134,1,21,20
106,TRN,P005738,P006382,10.733,-12,12,24
106,TRN,P005738,P009903,16.318,-5,24,29
106,TRN,P005738,P012593,11.533,-6,18,24
106,TRN,P005738,P012594,16.183,-11,25,36
106,TRN,P005738,P012595,12.668,8,27,19
106,TRN,P005738,P012596,9.066,4,21,17
106,TRN,P005738,P012597,16.851,11,36,25
106,TRN,P006382,P009903,5.767,-5,7,12
106,TRN,P006382,P012593,6.516,-8,7,15
106,TRN,P006382,P012594,8.666,-10,9,19
106,TRN,P006382,P012595,0.083,-2,0,2
106,TRN,P006382,P012596,5.049,-9,5,14
106,TRN,P006382,P012597,4.3,-6,5,11
106,TRN,P007828,P012593,2.35,4,9,5
106,TRN,P007828,P012595,2.35,4,9,5
106,TRN,P007828,P012596,2.35,4,9,5
106,TRN,P009903,P012593,5.267,-6,7,13
106,TRN,P009903,P012594,11.517,-7,17,24
106,TRN,P009903,P012595,19.201,-10,24,34
106,TRN,P009903,P012597,21.401,-10,27,37
106,TRN,P012593,P012594,7.933,-8,12,20
106,TRN,P012593,P012595,9.766,-8,20,28
106,TRN,P012593,P012596,12.915,-5,26,31
106,TRN,P012593,P012597,3.683,2,9,7
106,TRN,P012594,P012595,6.834,-5,10,15
106,TRN,P012594,P012596,5.033,-4,8,12
106,TRN,P012594,P012597,9.667,1,19,18
106,TRN,P012595,P012596,8.083,7,25,18
106,TRN,P012595,P012597,19.218,4,32,28
106,TRN,P012596,P012597,4.1,11,16,5
107,CAN,P001607,P003425,2.383,-7,0,7
107,CAN,P001607,P003637,14.384,1,36,35
107,CAN,P001607,P004160,6.833,13,20,7
107,CAN,P001607,P005005,7.734,-4,17,21
107,CAN,P001607,P006588,9.483,13,30,17
107,CAN,P001607,P007560,1.4,0,4,4
107,CAN,P001607,P007644,2.917,-2,7,9
107,CAN,P001607,P008121,17.266,11,43,32
107,CAN,P001607,P009864,14.182,3,34,31
107,CAN,P001607,P010385,10.818,4,26,22
107,CAN,P001607,P010452,12.6,-4,23,27
107,CAN,P003425,P003637,5.4,-6,6,12
107,CAN,P003425,P004160,7.384,-6,15,21
107,CAN,P003425,P005005,9.117,-3,20,23
107,CAN,P003425,P006588,5.767,-1,15,16
107,CAN,P003425,P007560,3.8,1,10,9
107,CAN,P003425,P008121,9.983,-15,11,26
107,CAN,P003425,P009864,8.533,-11,11,22
107,CAN,P003425,P010385,10.434,-7,20,27
107,CAN,P003425,P010452,13.067,-17,16,33
107,CAN,P003637,P005005,6.867,-7,12,19
107,CAN,P003637,P006588,3.433,1,13,12
107,CAN,P003637,P007560,2.95,2,8,6
107,CAN,P003637,P007644,5.084,-1,12,13
107,CAN,P003637,P008121,16.0,4,38,34
107,CAN,P003637,P009864,8.716,-3,21,24
107,CAN,P003637,P010385,14.018,0,29,29
107,CAN,P003637,P010452,14.084,-3,25,28
107,CAN,P004160,P005005,10.034,0,25,25
107,CAN,P004160,P006588,13.067,10,35,25
107,CAN,P004160,P007560,0.467,-2,0,2
107,CAN,P004160,P008121,4.65,5,10,5
107,CAN,P004160,P009864,5.633,5,13,8
107,CAN,P004160,P010385,9.051,0,22,22
107,CAN,P004160,P010452,1.617,-5,0,5
107,CAN,P005005,P006588,9.467,2,25,23
107,CAN,P005005,P007560,0.05,0,0,0
107,CAN,P005005,P007644,2.917,-2,7,9
107,CAN,P005005,P008121,0.133,0,0,0
107,CAN,P005005,P009864,0.983,0,3,3
107,CAN,P005005,P010385,15.918,-7,34,41
107,CAN,P005005,P010452,4.384,-7,5,12
107,CAN,P006588,P007560,1.25,-1,3,4
107,CAN,P006588,P008121,7.033,9,23,14
107,CAN,P006588,P009864,7.849,9,26,17
107,CAN,P006588,P010385,8.651,2,22,20
107,CAN,P007560,P007644,2.167,1,5,4
107,CAN,P007560,P008121,8.567,1,22,21
107,CAN,P007560,P009864,6.8,-2,17,19
107,CAN,P007560,P010385,1.817,3,5,2
107,CAN,P007560,P010452,5.2,1,14,13
107,CAN,P007644,P008121,2.167,1,5,4
107,CAN,P007644,P009864,0.4,-2,0,2
107,CAN,P007644,P010385,4.684,1,12,11
107,CAN,P008121,P009864,20.949,-4,45,49
107,CAN,P008121,P010385,7.284,7,17,10
107,CAN,P008121,P010452,18.9,-7,34,41
107,CAN,P009864,P010452,13.683,-11,22,33
107,CAN,P010385,P010452,9.601,-3,17,20
107,ULM,P005422,P006997,11.95,-1,21,22
107,ULM,P005422,P007952,5.6,-2,14,16
107,ULM,P005422,P010106,25.717,-1,60,61
107,ULM,P005422,P010582,21.284,9,55,46
107,ULM,P005422,P010726,7.3,-12,10,22
107,ULM,P005422,P011457,0.633,-5,1,6
107,ULM,P005422,P012603,20.517,-6,50,56
107,ULM,P005422,P012604,26.867,-5,57,62
107,ULM,P005422,P012703,10.0,-5,16,21
107,ULM,P006997,P007952,4.05,-1,9,10
107,ULM,P006997,P010106,11.016,-1,19,20
107,ULM,P006997,P010582,8.866,2,17,15
107,ULM,P006997,P010726,4.5,-6,6,12
107,ULM,P006997,P011457,3.499,-3,5,8
107,ULM,P006997,P012604,11.399,-3,17,20
107,ULM,P006997,P012703,6.516,-3,10,13
107,ULM,P007952,P010106,4.966,2,15,13
107,ULM,P007952,P010582,2.667,6,8,2
107,ULM,P007952,P010726,4.317,0,10,10
107,ULM,P007952,P011457,4.95,5,14,9
107,ULM,P007952,P012603,6.25,6,18,12
107,ULM,P007952,P012703,8.4,4,20,16
107,ULM,P010106,P010582,21.617,12,59,47
107,ULM,P010106,P010726,4.783,-9,6,15
107,ULM,P010106,P011457,6.649,-1,17,18
107,ULM,P010106,P012603,21.35,1,57,56
107,ULM,P010106,P012604,27.4,-2,61,63
107,ULM,P010106,P012703,5.966,-1,10,11
107,ULM,P010582,P011457,9.666,13,27,14
107,ULM,P010582,P012603,22.334,20,65,45
107,ULM,P010582,P012604,28.533,16,74,58
107,ULM,P010582,P012703,9.833,10,23,13
107,ULM,P010726,P011457,0.916,-6,0,6
107,ULM,P010726,P012603,3.333,-9,4,13
107,ULM,P010726,P012604,3.516,-15,0,15
107,ULM,P010726,P012703,2.667,-3,4,7
107,ULM,P011457,P012603,9.416,9,28,19
107,ULM,P011457,P012604,7.965,1,19,18
107,ULM,P011457,P012703,7.966,11,21,10
107,ULM,P012603,P012604,23.3,2,59,57
107,ULM,P012603,P012703,11.7,9,27,18
107,ULM,P012604,P012703,9.816,2,17,15
108,ARI,P003240,P004292,18.049,12,36,24
108,ARI,P003240,P010387,2.017,-1,2,3
108,ARI,P003240,P012616,7.0,2,9,7
108,ARI,P003240,P012702,14.65,17,34,17
108,ARI,P003240,P012707,12.684,-1,18,19
108,ARI,P003240,P012708,16.5,9,35,26
108,ARI,P003240,P012716,13.166,10,25,15
108,ARI,P003240,P012717,15.283,-4,22,26
108,ARI,P003240,P012722,4.684,-4,5,9
108,ARI,P003240,P012760,8.899,-4,10,14
108,ARI,P004292,P010387,2.45,1,5,4
108,ARI,P004292,P012616,5.0,2,7,5
108,ARI,P004292,P012702,13.233,9,33,24
108,ARI,P004292,P012707,7.65,2,14,12
108,ARI,P004292,P012708,14.033,11,35,24
108,ARI,P004292,P012716,12.249,7,30,23
108,ARI,P004292,P012717,15.116,-5,23,28
108,ARI,P004292,P012722,4.867,4,8,4
108,ARI,P004292,P012760,6.749,-3,9,12
108,ARI,P010387,P012707,2.45,1,5,4
108,ARI,P010387,P012716,0.433,2,3,1
108,ARI,P010387,P012722,2.45,1,5,4
108,ARI,P012616,P012702,8.1,1,13,12
108,ARI,P012616,P012707,12.467,0,16,16
108,ARI,P012616,P012708,4.967,2,6,4
108,ARI,P012616,P012716,13.1,3,19,16
108,ARI,P012616,P012717,1.617,0,0,0
108,ARI,P012616,P012722,1.267,0,0,0
108,ARI,P012616,P012760,5.35,2,6,4
108,ARI,P012702,P012707,9.901,0,14,14
108,ARI,P012702,P012708,11.45,13,30,17
108,ARI,P012702,P012716,13.317,7,31,24
108,ARI,P012702,P012717,8.217,1,17,16
108,ARI,P012707,P012708,11.718,2,15,13
108,ARI,P012707,P012716,15.5,3,24,21
108,ARI,P012707,P012717,5.934,-4,7,11
108,ARI,P012707,P012722,4.517,-2,8,10
108,ARI,P012707,P012760,8.383,3,11,8
108,ARI,P012708,P012716,12.317,14,29,15
108,ARI,P012708,P012717,13.767,-5,24,29
108,ARI,P012708,P012722,1.584,-6,0,6
108,ARI,P012708,P012760,11.4,4,18,14
108,ARI,P012716,P012717,4.533,-9,5,14
108,ARI,P012716,P012722,0.433,2,3,1
108,ARI,P012716,P012760,10.016,1,11,10
108,ARI,P012717,P012722,3.334,-3,3,6
108,ARI,P012717,P012760,7.199,-7,7,14
108,LKB,P002012,P004868,3.466,-4,7,11
108,LKB,P002012,P005521,26.415,4,48,44
108,LKB,P002012,P006230,14.433,2,23,21
108,LKB,P002012,P006901,8.083,-5,11,16
108,LKB,P002012,P007029,20.516,2,37,35
108,LKB,P002012,P010190,18.099,3,30,27
108,LKB,P002012,P010461,13.149,-2,25,27
108,LKB,P002012,P011329,6.167,0,11,11
108,LKB,P004868,P005521,10.9,-4,17,21
108,LKB,P004868,P006230,5.651,2,10,8
108,LKB,P004868,P006901,12.833,-4,17,21
108,LKB,P004868,P007029,9.184,-8,10,18
108,LKB,P004868,P010190,8.117,-10,4,14
108,LKB,P004868,P010461,9.699,-13,9,22
108,LKB,P004868,P011329,1.55,-3,2,5
108,LKB,P005521,P006230,19.0,6,33,27
108,LKB,P005521,P006901,14.066,-4,19,23
108,LKB,P005521,P007029,24.083,7,45,38
108,LKB,P005521,P010190,21.132,2,32,30
108,LKB,P005521,P010461,15.382,-4,25,29
108,LKB,P005521,P011329,6.55,1,13,12
108,LKB,P006230,P006901,9.717,-4,10,14
108,LKB,P006230,P007029,15.484,3,29,26
108,LKB,P006230,P010190,17.766,-1,25,26
108,LKB,P006230,P011329,0.417,0,2,2
108,LKB,P006901,P007029,8.217,-6,8,14
108,LKB,P006901,P010190,10.549,-12,7,19
108,LKB,P006901,P010461,8.799,-7,11,18
108,LKB,P006901,P011329,1.8,-2,1,3
108,LKB,P007029,P010190,21.183,-6,29,35
108,LKB,P007029,P010461,14.216,-7,18,25
108,LKB,P007029,P011329,5.917,-1,12,13
108,LKB,P010190,P010461,8.983,-8,9,17
108,LKB,P010190,P011329,1.167,-4,0,4
108,LKB,P010461,P011329,7.3,-3,11,14
109,BUD,P002740,P004945,3.467,-7,6,13
109,BUD,P002740,P006566,14.433,-2,31,33
109,BUD,P002740,P007398,4.516,-8,11,19
109,BUD,P002740,P009214,7.016,-6,19,25
109,BUD,P002740,P010248,12.233,-15,25,40
109,BUD,P002740,P010432,8.3,3,17,14
109,BUD,P002740,P011281,3.467,-7,6,13
109,BUD,P002740,P011935,13.517,-6,23,29
109,BUD,P002740,P012606,15.183,0,30,30
109,BUD,P004945,P006566,8.917,-11,13,24
109,BUD,P004945,P007398,16.05,-5,27,32
109,BUD,P004945,P009214,7.617,-7,13,20
109,BUD,P004945,P010248,15.384,-19,22,41
109,BUD,P004945,P010432,7.55,1,15,14
109,BUD,P004945,P011281,9.417,-17,13,30
109,BUD,P004945,P011935,9.817,-6,15,21
109,BUD,P004945,P012606,13.517,-1,24,25
109,BUD,P006566,P007398,7.383,-10,15,25
109,BUD,P006566,P009214,6.183,-15,10,25
109,BUD,P006566,P010248,11.133,-17,18,35
109,BUD,P006566,P010432,12.217,4,26,22
109,BUD,P006566,P011281,3.15,-10,2,12
109,BUD,P006566,P011935,11.667,7,25,18
109,BUD,P006566,P012606,18.317,2,36,34
109,BUD,P007398,P009214,6.033,-3,16,19
109,BUD,P007398,P010248,13.016,-14,23,37
109,BUD,P007398,P010432,7.55,1,15,14
109,BUD,P007398,P011281,4.383,-6,5,11
109,BUD,P007398,P011935,9.033,-5,13,18
109,BUD,P007398,P012606,14.3,-2,27,29
109,BUD,P009214,P010248,10.85,-10,24,34
109,BUD,P009214,P010432,1.633,-3,2,5
109,BUD,P009214,P011281,6.517,-4,13,17
109,BUD,P009214,P012606,4.083,-4,7,11
109,BUD,P010248,P011281,9.417,-17,13,30
109,BUD,P010248,P011935,11.717,-11,17,28
109,BUD,P010248,P012606,12.85,-5,22,27
109,BUD,P010432,P011935,10.3,6,21,15
109,BUD,P010432,P012606,15.85,4,32,28
109,BUD,P011281,P011935,1.317,-7,0,7
109,BUD,P011935,P012606,20.7,2,38,36
109,TTK,P000497,P005000,1.467,-4,2,6
109,TTK,P000497,P005685,0.883,0,0,0
109,TTK,P000497,P006693,11.35,11,30,19
109,TTK,P000497,P011239,10.467,11,30,19
109,TTK,P000497,P011834,11.35,11,30,19
109,TTK,P000497,P011925,9.883,15,28,13
109,TTK,P004801,P005000,10.567,4,21,17
109,TTK,P004801,P005685,3.717,0,7,7
109,TTK,P004801,P006693,17.7,5,38,33
109,TTK,P004801,P009845,4.117,0,7,7
109,TTK,P004801,P011239,18.1,5,38,33
109,TTK,P004801,P011834,14.9,5,33,28
109,TTK,P004801,P011925,17.617,-1,34,35
109,TTK,P004801,P011975,0.55,2,2,0
109,TTK,P005000,P005685,3.15,0,7,7
109,TTK,P005000,P006693,14.267,8,34,26
109,TTK,P005000,P009845,4.117,0,7,7
109,TTK,P005000,P011239,15.234,8,34,26
109,TTK,P005000,P011834,11.467,8,29,21
109,TTK,P005000,P011925,13.267,8,30,22
109,TTK,P005685,P006693,1.45,0,0,0
109,TTK,P005685,P009845,3.15,0,7,7
109,TTK,P005685,P011834,1.45,0,0,0
109,TTK,P005685,P011925,4.6,0,7,7
109,TTK,P006693,P011239,34.433,23,89,66
109,TTK,P006693,P011834,33.083,23,84,61
109,TTK,P006693,P011925,29.733,22,73,51
109,TTK,P006693,P011975,1.033,1,5,4
109,TTK,P006693,P012771,0.483,-1,3,4
109,TTK,P009845,P011239,0.967,0,0,0
109,TTK,P009845,P011925,4.117,0,7,7
109,TTK,P011239,P011834,31.633,23,84,61
109,TTK,P011239,P011925,29.25,22,73,51
109,TTK,P011239,P011975,1.033,1,5,4
109,TTK,P011239,P012771,0.483,-1,3,4
109,TTK,P011834,P011925,26.933,22,68,46
109,TTK,P011834,P011975,1.033,1,5,4
109,TTK,P011834,P012771,0.483,-1,3,4
109,TTK,P011975,P012771,0.483,-1,3,4
110,CLU,P004862,P005113,19.183,9,44,35
110,CLU,P004862,P005373,4.05,-2,8,10
110,CLU,P004862,P005714,4.167,-4,8,12
110,CLU,P004862,P010569,19.183,9,44,35
110,CLU,P004862,P011797,8.383,7,20,13
110,CLU,P004862,P011801,8.551,2,23,21
110,CLU,P004862,P012620,3.683,-6,3,9
110,CLU,P004862,P012621,16.55,3,37,34
110,CLU,P004862,P012698,9.65,2,21,19
110,CLU,P005113,P005714,1.533,-3,4,7
110,CLU,P005113,P010569,19.333,11,44,33
110,CLU,P005113,P011797,10.183,4,24,20
110,CLU,P005113,P011801,6.184,3,19,16
110,CLU,P005113,P012620,3.683,-6,3,9
110,CLU,P005113,P012621,18.1,5,41,36
110,CLU,P005113,P012698,5.733,1,13,12
110,CLU,P005373,P005714,17.166,-1,29,30
110,CLU,P005373,P010569,1.733,1,3,2
110,CLU,P005373,P011801,18.899,0,32,32
110,CLU,P005373,P012620,9.816,7,19,12
110,CLU,P005373,P012621,6.766,-4,8,12
110,CLU,P005373,P012698,17.166,-1,29,30
110,CLU,P005714,P010569,0.117,-2,0,2
110,CLU,P005714,P011797,1.533,-3,4,7
110,CLU,P005714,P011801,18.816,-6,33,39
110,CLU,P005714,P012620,8.083,6,16,10
110,CLU,P005714,P012621,6.55,-7,9,16
110,CLU,P005714,P012698,17.299,-4,29,33
110,CLU,P010569,P011797,8.65,7,20,13
110,CLU,P010569,P011801,6.384,7,18,11
110,CLU,P010569,P012620,5.416,-5,6,11
110,CLU,P010569,P012621,18.433,6,40,34
110,CLU,P010569,P012698,5.483,6,13,7
110,CLU,P011797,P011801,1.8,-3,4,7
110,CLU,P011797,P012621,10.05,7,24,17
110,CLU,P011797,P012698,0.133,-3,0,3
110,CLU,P011801,P012620,9.816,7,19,12
110,CLU,P011801,P012621,10.184,-4,20,24
110,CLU,P011801,P012698,20.166,-2,36,38
110,CLU,P012620,P012621,5.416,-5,6,11
110,CLU,P012620,P012698,8.083,6,16,10
110,CLU,P012621,P012698,7.883,-5,11,16
110,WRO,P003034,P007472,2.967,-8,0,8
110,WRO,P003034,P009896,5.0,1,9,8
110,WRO,P003034,P011278,3.084,-7,1,8
110,WRO,P003034,P011900,13.933,14,35,21
110,WRO,P003034,P011901,14.617,14,36,22
110,WRO,P003034,P012601,10.933,12,28,16
110,WRO,P003034,P012699,17.434,0,32,32
110,WRO,P003034,P012736,8.1,-2,11,13
110,WRO,P007472,P011278,2.967,-8,0,8
110,WRO,P007472,P012699,2.967,-8,0,8
110,WRO,P007472,P012736,2.967,-8,0,8
110,WRO,P009896,P011278,5.65,3,10,7
110,WRO,P009896,P011900,15.433,-8,32,40
110,WRO,P009896,P011901,13.7,-2,32,34
110,WRO,P009896,P012308,9.083,7,20,13
110,WRO,P009896,P012601,13.516,-10,25,35
110,WRO,P009896,P012699,18.916,-4,30,34
110,WRO,P009896,P012736,15.366,-11,18,29
110,WRO,P011278,P011900,0.967,-4,2,6
110,WRO,P011278,P011901,1.267,-3,1,4
110,WRO,P011278,P012308,5.65,3,10,7
110,WRO,P011278,P012601,0.467,0,2,2
110,WRO,P011278,P012699,8.051,0,13,13
110,WRO,P011278,P012736,8.701,0,13,13
110,WRO,P011900,P011901,20.6,13,57,44
110,WRO,P011900,P012308,2.2,0,8,8
110,WRO,P011900,P012601,20.683,5,52,47
110,WRO,P011900,P012699,20.0,-2,41,43
110,WRO,P011900,P012736,10.916,-10,17,27
110,WRO,P011901,P012308,2.85,0,8,8
110,WRO,P011901,P012601,19.5,10,50,40
110,WRO,P011901,P012699,18.384,4,40,36
110,WRO,P011901,P012736,9.95,-4,16,20
110,WRO,P012308,P012601,3.433,4,10,6
110,WRO,P012308,P012699,6.233,7,12,5
110,WRO,P012308,P012736,6.883,7,12,5
110,WRO,P012601,P012699,20.583,-9,36,45
110,WRO,P012601,P012736,15.949,-16,21,37
110,WRO,P012699,P012736,20.1,-20,20,40
111,LLI,P004773,P005247,11.567,-5,17,22
111,LLI,P004773,P006600,8.666,-5,15,20
111,LLI,P004773,P008274,3.8,1,7,6
111,LLI,P004773,P009649,13.584,-7,25,32
111,LLI,P004773,P009672,5.567,-7,6,13
111,LLI,P004773,P009680,9.883,-2,20,22
111,LLI,P004773,P012020,8.751,-6,12,18
111,LLI,P004773,P012585,8.65,-1,18,19
111,LLI,P005247,P006600,19.816,-4,42,46
111,LLI,P005247,P008274,3.8,1,7,6
111,LLI,P005247,P009649,10.85,-5,20,25
111,LLI,P005247,P009672,19.5,-12,38,50
111,LLI,P005247,P009680,20.133,-1,45,46
111,LLI,P005247,P012020,6.934,-9,7,16
111,LLI,P005247,P012585,15.2,-5,32,37
111,LLI,P006600,P009649,14.016,9,40,31
111,LLI,P006600,P009672,22.35,9,57,48
111,LLI,P006600,P009680,30.116,4,72,68
111,LLI,P006600,P012585,25.5,3,62,59
111,LLI,P008274,P009649,3.8,1,7,6
111,LLI,P008274,P012020,3.8,1,7,6
111,LLI,P009649,P009672,13.917,12,38,26
111,LLI,P009649,P009680,16.166,12,47,35
111,LLI,P009649,P012020,9.684,-6,14,20
111,LLI,P009649,P012585,13.583,8,37,29
111,LLI,P009672,P009680,23.483,12,62,50
111,LLI,P009672,P012020,4.867,-7,5,12
111,LLI,P009672,P012585,19.984,13,54,41
111,LLI,P009680,P012020,1.95,0,4,4
111,LLI,P009680,P012585,27.333,3,66,63
111,LLI,P012020,P012585,2.75,3,7,4
111,PMT,P001686,P002020,8.15,-3,21,24
111,PMT,P001686,P002644,19.033,7,49,42
111,PMT,P001686,P010549,21.617,-2,54,56
111,PMT,P001686,P011823,8.484,-3,23,26
111,PMT,P001686,P011942,13.666,3,38,35
111,PMT,P001686,P011944,16.65,-6,40,46
111,PMT,P001686,P011966,7.617,-6,17,23
111,PMT,P001686,P012600,17.983,6,46,40
111,PMT,P002020,P002644,6.983,0,9,9
111,PMT,P002020,P010549,11.583,-3,26,29
111,PMT,P002020,P011823,7.567,-1,21,22
111,PMT,P002020,P011942,0.966,-2,0,2
111,PMT,P002020,P011944,12.683,0,26,26
111,PMT,P002020,P011966,5.034,-1,8,9
111,PMT,P002020,P012600,7.566,-2,9,11
111,PMT,P002644,P010549,17.617,6,40,34
111,PMT,P002644,P011823,0.8,2,2,0
111,PMT,P002644,P011942,17.066,10,43,33
111,PMT,P002644,P011944,20.733,-3,35,38
111,PMT,P002644,P011966,11.8,-5,20,25
111,PMT,P002644,P012600,28.9,11,62,51
111,PMT,P010549,P011823,8.367,1,23,22
111,PMT,P010549,P011942,7.9,4,22,18
111,PMT,P010549,P011944,15.45,-3,35,38
111,PMT,P010549,P011966,2.934,-4,4,8
111,PMT,P010549,P012600,18.4,1,40,39
111,PMT,P011823,P011942,1.717,0,4,4
111,PMT,P011823,P011944,6.617,-2,19,21
111,PMT,P011823,P011966,2.784,-3,6,9
111,PMT,P011823,P012600,0.8,2,2,0
111,PMT,P011942,P011944,9.25,-8,15,23
111,PMT,P011942,P011966,8.483,-4,18,22
111,PMT,P011942,P012600,16.016,9,40,31
111,PMT,P011944,P011966,9.717,-8,14,22
111,PMT,P011944,P012600,19.1,-2,32,34
111,PMT,P011966,P012600,9.967,-1,17,18
112,HAM,P001990,P009663,5.7,-6,9,15
112,HAM,P001990,P010070,2.384,-5,4,9
112,HAM,P001990,P011168,1.833,-1,3,4
112,HAM,P001990,P011187,9.05,-9,17,26
112,HAM,P001990,P012579,13.367,-9,26,35
112,HAM,P001990,P012580,9.15,-8,14,22
112,HAM,P001990,P012581,7.849,-8,14,22
112,HAM,P001990,P012582,14.199,-11,25,36
112,HAM,P001990,P012648,2.8,-7,4,11
112,HAM,P009663,P010070,4.934,-9,10,19
112,HAM,P009663,P011168,18.052,-6,52,58
112,HAM,P009663,P012579,11.735,-1,28,29
112,HAM,P009663,P012580,14.085,1,39,38
112,HAM,P009663,P012581,16.167,-18,40,58
112,HAM,P009663,P012582,15.184,-6,40,46
112,HAM,P009663,P012648,5.517,-6,15,21
112,HAM,P009663,P012694,3.634,3,11,8
112,HAM,P010070,P011168,10.234,-16,20,36
112,HAM,P010070,P011187,7.684,-12,14,26
112,HAM,P010070,P012579,6.168,-10,12,22
112,HAM,P010070,P012580,4.734,-10,6,16
112,HAM,P010070,P012581,8.867,-11,20,31
112,HAM,P010070,P012648,5.467,-11,10,21
112,HAM,P011168,P011187,5.367,-7,10,17
112,HAM,P011168,P012579,10.018,4,29,25
112,HAM,P011168,P012580,14.768,-2,42,44
112,HAM,P011168,P012581,18.634,-20,44,64
112,HAM,P011168,P012582,11.384,-1,34,35
112,HAM,P011168,P012648,7.084,-10,15,25
112,HAM,P011168,P012694,3.634,3,11,8
112,HAM,P011187,P012579,10.184,-8,23,31
112,HAM,P011187,P012580,7.633,-5,15,20
112,HAM,P011187,P012581,6.65,-8,12,20
112,HAM,P011187,P012582,6.733,-4,13,17
112,HAM,P011187,P012648,4.367,-11,4,15
112,HAM,P012579,P012580,12.618,0,29,29
112,HAM,P012579,P012581,8.917,-4,22,26
112,HAM,P012579,P012582,12.85,0,30,30
112,HAM,P012579,P012648,1.117,-3,2,5
112,HAM,P012579,P012694,3.634,3,11,8
112,HAM,P012580,P012581,8.583,-8,21,29
112,HAM,P012580,P012582,16.317,-3,41,44
112,HAM,P012580,P012648,1.617,1,5,4
112,HAM,P012580,P012694,1.767,6,8,2
112,HAM,P012581,P012582,13.916,-13,32,45
112,HAM,P012581,P012648,7.15,-15,12,27
112,HAM,P012581,P012694,1.867,-3,3,6
112,HAM,P012582,P012648,4.417,-6,9,15
112,PRS,P004512,P005793,12.767,8,38,30
112,PRS,P004512,P011232,2.4,5,13,8
112,PRS,P004512,P011887,4.867,3,17,14
112,PRS,P004512,P012608,15.167,13,51,38
112,PRS,P004512,P012609,10.3,10,34,24
112,PRS,P004512,P012610,15.167,13,51,38
112,PRS,P005793,P011551,3.25,-7,5,12
112,PRS,P005793,P011887,3.95,-8,6,14
112,PRS,P005793,P012608,20.034,4,56,52
112,PRS,P005793,P012609,10.3,10,34,24
112,PRS,P005793,P012610,20.034,4,56,52
112,PRS,P005793,P012613,4.017,3,13,10
112,PRS,P005793,P012640,5.784,2,16,14
112,PRS,P009556,P011232,17.567,20,51,31
112,PRS,P009556,P011551,6.067,9,23,14
112,PRS,P009556,P011887,3.5,5,15,10
112,PRS,P009556,P012609,14.067,15,36,21
112,PRS,P009556,P012613,11.5,11,28,17
112,PRS,P009556,P012640,17.567,20,51,31
112,PRS,P011232,P011551,6.067,9,23,14
112,PRS,P011232,P011887,5.9,10,28,18
112,PRS,P011232,P012608,2.4,5,13,8
112,PRS,P011232,P012609,14.067,15,36,21
112,PRS,P011232,P012610,2.4,5,13,8
112,PRS,P011232,P012613,11.5,11,28,17
112,PRS,P011232,P012640,17.567,20,51,31
112,PRS,P011551,P011887,4.983,-1,17,18
112,PRS,P011551,P012608,3.25,-7,5,12
112,PRS,P011551,P012609,2.567,4,8,4
112,PRS,P011551,P012610,3.25,-7,5,12
112,PRS,P011551,P012640,7.834,8,26,18
112,PRS,P011887,P012608,6.35,-3,19,22
112,PRS,P011887,P012610,6.35,-3,19,22
112,PRS,P011887,P012640,3.5,5,15,10
112,PRS,P012608,P012609,10.3,10,34,24
112,PRS,P012608,P012610,22.434,9,69,60
112,PRS,P012608,P012613,4.017,3,13,10
112,PRS,P012608,P012640,5.784,2,16,14
112,PRS,P012609,P012610,10.3,10,34,24
112,PRS,P012609,P012613,11.5,11,28,17
112,PRS,P012609,P012640,14.067,15,36,21
112,PRS,P012610,P012613,4.017,3,13,10
112,PRS,P012610,P012640,5.784,2,16,14
112,PRS,P012613,P012640,15.517,14,41,27
113,HTA,P003533,P004267,4.216,3,10,7
113,HTA,P003533,P004846,6.616,-2,15,17
113,HTA,P003533,P006835,13.899,-11,23,34
113,HTA,P003533,P007759,13.899,-11,23,34
113,HTA,P003533,P010465,10.416,-11,16,27
113,HTA,P003533,P011990,6.55,-12,5,17
113,HTA,P004267,P004846,13.999,32,52,20
113,HTA,P004267,P006835,10.549,18,36,18
113,HTA,P004267,P007759,11.349,19,40,21
113,HTA,P004267,P010465,7.116,11,25,14
113,HTA,P004267,P011973,13.566,26,51,25
113,HTA,P004267,P011990,8.4,1,24,23
113,HTA,P004267,P012028,1.083,3,3,0
113,HTA,P004267,P012706,0.85,3,3,0
113,HTA,P004846,P006835,24.549,19,64,45
113,HTA,P004846,P007759,25.582,20,68,48
113,HTA,P004846,P010465,23.316,3,56,53
113,HTA,P004846,P011973,24.316,29,71,42
113,HTA,P004846,P011990,5.35,7,18,11
113,HTA,P006835,P007759,32.299,8,75,67
113,HTA,P006835,P010465,22.716,-7,42,49
113,HTA,P006835,P011973,18.633,19,52,33
113,HTA,P006835,P011990,7.25,-14,8,22
113,HTA,P006835,P012028,0.233,0,0,0
113,HTA,P007759,P010465,23.749,-6,46,52
113,HTA,P007759,P011973,19.433,20,56,36
113,HTA,P007759,P011990,7.017,-14,8,22
113,HTA,P010465,P011973,18.683,12,48,36
113,HTA,P010465,P011990,10.4,2,23,21
113,HTA,P011973,P011990,7.133,8,24,16
113,HTA,P011973,P012028,1.316,3,3,0
113,HTA,P011973,P012706,1.083,3,3,0
113,HTA,P011973,P012793,0.233,0,0,0
113,HTA,P011990,P012028,1.316,3,3,0
113,HTA,P011990,P012706,1.083,3,3,0
113,HTA,P011990,P012793,0.233,0,0,0
113,HTA,P012028,P012706,1.083,3,3,0
113,HTA,P012028,P012793,0.233,0,0,0
113,HTA,P012706,P012793,0.233,0,0,0
113,VNC,P003759,P004117,11.233,-8,18,26
113,VNC,P003759,P008052,3.983,0,11,11
113,VNC,P003759,P009400,8.816,-9,12,21
113,VNC,P003759,P011909,16.65,-7,33,40
113,VNC,P003759,P012587,15.866,-3,33,36
113,VNC,P003759,P012590,22.0,-6,49,55
113,VNC,P003759,P012591,24.916,-7,52,59
113,VNC,P004117,P008052,8.801,-5,21,26
113,VNC,P004117,P009400,18.967,-11,38,49
113,VNC,P004117,P011909,13.25,-11,23,34
113,VNC,P004117,P012587,12.467,-9,23,32
113,VNC,P004117,P012590,19.817,-17,34,51
113,VNC,P004117,P012591,16.933,-7,31,38
113,VNC,P008052,P009400,10.834,-7,24,31
113,VNC,P008052,P011909,2.617,-4,7,11
113,VNC,P008052,P012587,12.434,-4,31,35
113,VNC,P008052,P012590,8.317,-8,18,26
113,VNC,P008052,P012591,4.15,8,16,8
113,VNC,P009400,P011909,9.25,-8,14,22
113,VNC,P009400,P012587,15.55,-12,26,38
113,VNC,P009400,P012590,14.367,-14,25,39
113,VNC,P009400,P012591,13.416,-3,25,28
113,VNC,P011909,P012587,15.0,-7,31,38
113,VNC,P011909,P012590,19.0,-8,39,47
113,VNC,P011909,P012591,21.233,-11,41,52
113,VNC,P012587,P012590,18.317,-8,40,48
113,VNC,P012587,P012591,17.366,3,40,37
113,VNC,P012590,P012591,24.45,-7,55,62
114,JOV,P002361,P002507,17.435,2,42,40
114,JOV,P002361,P006771,15.784,-2,32,34
114,JOV,P002361,P010161,7.768,1,18,17
114,JOV,P002361,P010458,13.634,4,32,28
114,JOV,P002361,P010709,2.433,-2,3,5
114,JOV,P002361,P011247,13.001,5,35,30
114,JOV,P002361,P011248,9.984,-6,14,20
114,JOV,P002361,P012349,7.867,-6,11,17
114,JOV,P002361,P012780,9.234,-4,17,21
114,JOV,P002507,P006771,12.05,-1,28,29
114,JOV,P002507,P010161,10.084,6,26,20
114,JOV,P002507,P010458,11.433,5,30,25
114,JOV,P002507,P011247,17.55,6,45,39
114,JOV,P002507,P011248,9.233,-4,15,19
114,JOV,P002507,P012349,7.767,-2,14,16
114,JOV,P002507,P012780,2.384,0,8,8
114,JOV,P006771,P010161,0.15,2,2,0
114,JOV,P006771,P010458,14.25,2,31,29
114,JOV,P006771,P011247,16.483,15,46,31
114,JOV,P006771,P011248,16.917,13,38,25
114,JOV,P006771,P012349,10.267,10,26,16
114,JOV,P006771,P012780,12.767,17,33,16
114,JOV,P010161,P010458,6.217,4,17,13
114,JOV,P010161,P010709,1.55,-3,0,3
114,JOV,P010161,P011247,12.234,7,32,25
114,JOV,P010161,P011248,7.9,-3,16,19
114,JOV,P010161,P012349,5.6,-2,9,11
114,JOV,P010161,P012780,6.901,-4,16,20
114,JOV,P010458,P011247,16.05,8,42,34
114,JOV,P010458,P011248,11.25,0,22,22
114,JOV,P010458,P012780,9.034,1,18,17
114,JOV,P010709,P011248,0.883,1,3,2
114,JOV,P010709,P012349,2.433,-2,3,5
114,JOV,P010709,P012780,2.433,-2,3,5
114,JOV,P011247,P011248,16.116,17,43,26
114,JOV,P011247,P012349,10.7,12,30,18
114,JOV,P011247,P012780,12.734,18,39,21
114,JOV,P011248,P012349,13.383,15,35,20
114,JOV,P011248,P012780,17.134,11,42,31
114,JOV,P012349,P012780,8.983,11,24,13
114,WOL,P003212,P004229,14.584,10,39,29
114,WOL,P003212,P004645,14.15,-16,27,43
114,WOL,P003212,P005516,6.883,-5,11,16
114,WOL,P003212,P006154,15.567,-1,40,41
114,WOL,P003212,P006907,11.867,9,30,21
114,WOL,P003212,P012576,7.383,-14,12,26
114,WOL,P003212,P012577,20.5,-12,46,58
114,WOL,P003212,P012789,3.366,-1,5,6
114,WOL,P003212,PLCT,1.5,-2,2,4
114,WOL,P004229,P004645,10.918,-4,23,27
114,WOL,P004229,P005516,10.334,-5,19,24
114,WOL,P004229,P006154,12.051,8,34,26
114,WOL,P004229,P006907,11.967,13,32,19
114,WOL,P004229,P012577,15.768,0,40,40
114,WOL,P004229,P012789,1.383,3,3,0
114,WOL,P004229,PLCT,3.067,-1,6,7
114,WOL,P004645,P005516,20.9,-15,34,49
114,WOL,P004645,P006154,14.851,0,31,31
114,WOL,P004645,P006907,4.8,-1,8,9
114,WOL,P004645,P012576,16.816,-15,28,43
114,WOL,P004645,P012577,25.317,-22,45,67
114,WOL,P004645,P012789,1.983,-4,2,6
114,WOL,P004645,PLCT,9.133,-15,14,29
114,WOL,P005516,P006154,8.017,6,14,8
114,WOL,P005516,P006907,4.766,1,7,6
114,WOL,P005516,P012576,10.616,-3,16,19
114,WOL,P005516,P012577,19.217,-13,30,43
114,WOL,P005516,P012789,3.366,-1,5,6
114,WOL,P005516,PLCT,7.633,-13,12,25
114,WOL,P006154,P006907,10.8,6,27,21
114,WOL,P006154,P012576,11.533,-3,20,23
114,WOL,P006154,P012577,21.517,4,50,46
114,WOL,P006907,P012576,3.116,-6,2,8
114,WOL,P006907,P012577,9.3,5,23,18
114,WOL,P006907,P012789,1.383,3,3,0
114,WOL,P006907,PLCT,2.333,-2,4,6
114,WOL,P012576,P012577,16.466,-13,26,39
114,WOL,P012576,PLCT,6.066,-14,8,22
114,WOL,P012577,P012789,1.983,-4,2,6
114,WOL,P012577,PLCT,6.8,-13,10,23
115,BES,P005348,P007914,5.25,3,15,12
115,BES,P005348,P008945,2.383,4,9,5
115,BES,P005348,P009582,8.999,0,21,21
115,BES,P005348,P011379,6.183,6,17,11
115,BES,P005348,P011924,9.183,2,22,20
115,BES,P005348,P011936,6.316,3,16,13
115,BES,P005348,P012622,2.567,6,10,4
115,BES,P005348,P012647,5.383,0,14,14
115,BES,P007914,P008945,6.15,-4,9,13
115,BES,P007914,P009582,6.483,-5,9,14
115,BES,P007914,P011379,9.45,5,21,16
115,BES,P007914,P011924,11.667,1,23,22
115,BES,P007914,P011936,10.45,-4,15,19
115,BES,P007914,P012622,13.451,0,25,25
115,BES,P007914,P012647,8.367,-8,11,19
115,BES,P007917,P008945,8.317,14,26,12
115,BES,P007917,P011924,1.717,-3,2,5
115,BES,P007917,P011936,10.034,11,28,17
115,BES,P007917,P012622,10.034,11,28,17
115,BES,P007917,P012647,10.034,11,28,17
115,BES,P008945,P009582,4.166,2,11,9
115,BES,P008945,P011924,2.317,2,7,5
115,BES,P008945,P011936,20.95,14,53,39
115,BES,P008945,P012622,18.567,10,44,34
115,BES,P008945,P012647,20.95,14,53,39
115,BES,P009582,P011379,7.866,-4,11,15
115,BES,P009582,P011924,12.149,-12,19,31
115,BES,P009582,P011936,11.515,-5,23,28
115,BES,P009582,P012622,5.633,-10,7,17
115,BES,P009582,P012647,8.449,-6,19,25
115,BES,P011379,P011924,10.833,6,23,17
115,BES,P011379,P011936,3.916,3,6,3
115,BES,P011379,P012622,5.084,8,14,6
115,BES,P011924,P011936,14.0,-8,25,33
115,BES,P011924,P012622,13.068,-3,28,31
115,BES,P011924,P012647,10.534,-13,19,32
115,BES,P011936,P012622,24.634,1,53,52
115,BES,P011936,P012647,28.717,1,65,64
115,BES,P012622,P012647,24.234,-3,51,54
115,LJU,P002561,P003452,6.85,-5,12,17
115,LJU,P002561,P005969,3.717,-2,5,7
115,LJU,P002561,P007066,5.833,-1,11,12
115,LJU,P002561,P009395,5.251,2,11,9
115,LJU,P002561,P010594,6.85,-5,12,17
115,LJU,P002561,P012700,7.367,3,17,14
115,LJU,P003452,P005969,25.751,-3,55,58
115,LJU,P003452,P007066,3.716,-4,6,10
115,LJU,P003452,P009392,7.967,9,22,13
115,LJU,P003452,P009395,27.285,1,61,60
115,LJU,P003452,P010594,21.567,-9,48,57
115,LJU,P003452,P011261,5.867,5,13,8
115,LJU,P003452,P012700,25.001,-6,51,57
115,LJU,P005969,P007066,3.15,-2,5,7
115,LJU,P005969,P009392,14.85,4,33,29
115,LJU,P005969,P009395,33.718,0,71,71
115,LJU,P005969,P010594,16.317,-9,36,45
115,LJU,P005969,P011261,12.75,0,24,24
115,LJU,P005969,P012700,28.751,-8,55,63
115,LJU,P007066,P009395,2.117,3,5,2
115,LJU,P007066,P010594,3.716,-4,6,10
115,LJU,P007066,P012700,4.8,4,11,7
115,LJU,P009392,P009395,14.85,4,33,29
115,LJU,P009392,P010594,0.05,1,3,2
115,LJU,P009392,P011261,11.233,2,24,22
115,LJU,P009392,P012700,10.45,-4,17,21
115,LJU,P009395,P010594,17.851,-5,42,47
115,LJU,P009395,P011261,12.75,0,24,24
115,LJU,P009395,P012700,31.318,-9,61,70
115,LJU,P010594,P012700,19.917,-5,45,50
115,LJU,P011261,P012700,8.4,-7,11,18
116,BOU,P000498,P004525,10.616,4,27,23
116,BOU,P000498,P010431,4.783,0,11,11
116,BOU,P000498,P010450,8.433,-6,19,25
116,BOU,P000498,P011161,10.882,2,27,25
116,BOU,P000498,P011836,5.866,-5,11,16
116,BOU,P000498,P011837,8.433,-6,19,25
116,BOU,P000498,P012618,3.466,3,9,6
116,BOU,P000498,P012619,4.583,2,10,8
116,BOU,P000498,P012628,8.866,2,19,17
116,BOU,P004525,P010431,1.566,-1,3,4
116,BOU,P004525,P010450,5.116,-10,10,20
116,BOU,P004525,P011161,11.382,2,29,27
116,BOU,P004525,P011837,3.1,-3,8,11
116,BOU,P004525,P012617,1.566,-1,3,4
116,BOU,P004525,P012618,6.082,-1,14,15
116,BOU,P004525,P012619,4.583,2,10,8
116,BOU,P004525,P012628,11.049,0,24,24
116,BOU,P010431,P010450,14.933,9,37,28
116,BOU,P010431,P011161,2.25,-1,5,6
116,BOU,P010431,P011836,23.783,9,57,48
116,BOU,P010431,P011837,11.266,6,29,23
116,BOU,P010431,P012617,18.799,9,44,35
116,BOU,P010431,P012618,14.083,2,31,29
116,BOU,P010431,P012628,9.933,-1,23,24
116,BOU,P010450,P011161,5.549,-4,16,20
116,BOU,P010450,P011836,16.183,12,43,31
116,BOU,P010450,P011837,14.283,1,37,36
116,BOU,P010450,P012617,11.283,13,32,19
116,BOU,P010450,P012618,7.016,1,16,15
116,BOU,P010450,P012628,2.4,-8,2,10
116,BOU,P011161,P011836,4.7,1,14,13
116,BOU,P011161,P011837,3.849,-5,8,13
116,BOU,P011161,P012617,1.85,7,9,2
116,BOU,P011161,P012618,7.65,6,25,19
116,BOU,P011161,P012619,4.583,2,10,8
116,BOU,P011161,P012628,11.633,2,29,27
116,BOU,P011836,P011837,12.349,1,29,28
116,BOU,P011836,P012617,18.6,17,50,33
116,BOU,P011836,P012618,13.884,10,37,27
116,BOU,P011836,P012628,9.567,-1,23,24
116,BOU,P011837,P012617,7.016,4,18,14
116,BOU,P011837,P012628,1.5,-6,0,6
116,BOU,P012617,P012618,13.15,12,35,23
116,BOU,P012617,P012628,8.4,3,21,18
116,BOU,P012618,P012628,14.533,3,37,34
116,BOU,P012619,P012628,4.583,2,10,8
116,CLU,P004862,P005113,9.833,-21,16,37
116,CLU,P004862,P005373,17.217,5,46,41
116,CLU,P004862,P005714,13.733,-4,34,38
116,CLU,P004862,P010569,11.183,-16,24,40
116,CLU,P004862,P011797,16.8,-10,41,51
116,CLU,P004862,P011801,17.15,7,48,41
116,CLU,P004862,P012621,10.733,-23,18,41
116,CLU,P004862,P012698,12.683,-6,29,35
116,CLU,P005113,P005714,0.933,-7,0,7
116,CLU,P005113,P010569,8.9,-14,16,30
116,CLU,P005113,P011797,9.833,-21,16,37
116,CLU,P005113,P012621,9.833,-21,16,37
116,CLU,P005373,P005714,15.717,2,38,36
116,CLU,P005373,P010569,3.95,4,12,8
116,CLU,P005373,P011797,12.117,14,37,23
116,CLU,P005373,P011801,22.017,11,58,47
116,CLU,P005373,P012621,3.617,3,10,7
116,CLU,P005373,P012698,14.833,-7,31,38
116,CLU,P005714,P010569,6.683,3,14,11
116,CLU,P005714,P011797,8.45,2,22,20
116,CLU,P005714,P011801,23.167,9,53,44
116,CLU,P005714,P012620,4.283,3,8,5
116,CLU,P005714,P012621,9.217,-2,15,17
116,CLU,P005714,P012698,15.617,-10,28,38
116,CLU,P010569,P011797,12.167,-10,26,36
116,CLU,P010569,P011801,10.633,7,26,19
116,CLU,P010569,P012620,4.283,3,8,5
116,CLU,P010569,P012621,17.25,-5,34,39
116,CLU,P010569,P012698,3.083,0,8,8
116,CLU,P011797,P011801,12.884,18,38,20
116,CLU,P011797,P012621,14.317,-17,25,42
116,CLU,P011797,P012698,5.7,0,11,11
116,CLU,P011801,P012620,4.283,3,8,5
116,CLU,P011801,P012621,11.134,8,23,15
116,CLU,P011801,P012698,18.0,-3,38,41
116,CLU,P012620,P012621,4.283,3,8,5
116,CLU,P012621,P012698,3.484,2,7,5
117,BUD,P002740,P004397,4.751,7,13,6
117,BUD,P002740,P004945,4.701,8,11,3
117,BUD,P002740,P006566,7.084,-9,10,19
117,BUD,P002740,P007398,2.933,2,6,4
117,BUD,P002740,P010248,17.867,10,38,28
117,BUD,P002740,P010432,2.184,4,7,3
117,BUD,P002740,P011281,15.217,3,31,28
117,BUD,P002740,P011935,15.3,7,32,25
117,BUD,P002740,P012606,10.167,24,32,8
117,BUD,P004397,P004945,14.568,0,25,25
117,BUD,P004397,P006566,9.851,-5,21,26
117,BUD,P004397,P007398,9.433,3,16,13
117,BUD,P004397,P010248,11.284,0,18,18
117,BUD,P004397,P010432,11.434,3,27,24
117,BUD,P004397,P011281,15.467,-1,29,30
117,BUD,P004397,P011935,0.067,-3,0,3
117,BUD,P004397,P012606,14.017,8,31,23
117,BUD,P004945,P006566,4.901,-4,10,14
117,BUD,P004945,P007398,8.183,-10,10,20
117,BUD,P004945,P010248,11.901,-6,20,26
117,BUD,P004945,P010432,5.917,0,11,11
117,BUD,P004945,P011281,8.884,-2,14,16
117,BUD,P004945,P011935,3.317,-9,6,15
117,BUD,P004945,P012606,8.9,-1,17,18
117,BUD,P006566,P010248,11.984,-12,17,29
117,BUD,P006566,P010432,3.634,-4,9,13
117,BUD,P006566,P011281,14.234,-15,21,36
117,BUD,P006566,P011935,5.834,-14,5,19
117,BUD,P006566,P012606,4.95,-1,11,12
117,BUD,P007398,P010248,7.383,-9,9,18
117,BUD,P007398,P010432,6.933,5,16,11
117,BUD,P007398,P011281,8.3,2,13,11
117,BUD,P007398,P011935,4.883,-7,9,16
117,BUD,P007398,P012606,9.216,-2,21,23
117,BUD,P010248,P011281,23.9,3,43,40
117,BUD,P010248,P011935,17.35,-5,35,40
117,BUD,P010248,P012606,12.599,11,32,21
117,BUD,P010432,P011281,5.517,-2,13,15
117,BUD,P010432,P012606,10.117,6,25,19
117,BUD,P011281,P011935,13.95,2,27,25
117,BUD,P011281,P012606,12.199,14,33,19
117,BUD,P011935,P012606,8.699,9,26,17
117,WRO,P003034,P011278,2.617,-3,3,6
117,WRO,P003034,P011900,4.951,-9,3,12
117,WRO,P003034,P011901,2.017,-7,0,7
117,WRO,P003034,P012601,4.034,-7,3,10
117,WRO,P003034,P012699,3.017,-6,3,9
117,WRO,P003034,P012736,5.334,-5,6,11
117,WRO,P003034,P012749,4.634,-3,6,9
117,WRO,P007472,P009896,0.817,-4,0,4
117,WRO,P007472,P011278,2.384,-2,4,6
117,WRO,P007472,P011900,1.567,2,4,2
117,WRO,P007472,P012601,2.384,-2,4,6
117,WRO,P007472,P012749,2.384,-2,4,6
117,WRO,P009896,P011278,17.866,7,43,36
117,WRO,P009896,P011900,20.033,5,41,36
117,WRO,P009896,P011901,17.783,-5,33,38
117,WRO,P009896,P012308,3.867,2,4,2
117,WRO,P009896,P012601,22.1,9,51,42
117,WRO,P009896,P012699,26.582,11,65,54
117,WRO,P009896,P012736,2.533,-3,3,6
117,WRO,P009896,P012749,13.483,14,36,22
117,WRO,P011278,P011900,9.634,1,19,18
117,WRO,P011278,P011901,4.383,-7,7,14
117,WRO,P011278,P012308,3.867,2,4,2
117,WRO,P011278,P012601,10.784,7,29,22
117,WRO,P011278,P012699,15.399,6,42,36
117,WRO,P011278,P012736,5.15,-6,6,12
117,WRO,P011278,P012749,18.184,11,43,32
117,WRO,P011900,P011901,18.5,-11,30,41
117,WRO,P011900,P012308,1.717,2,2,0
117,WRO,P011900,P012601,19.518,-5,33,38
117,WRO,P011900,P012699,20.15,-4,39,43
117,WRO,P011900,P012736,3.634,-4,3,7
117,WRO,P011900,P012749,8.568,7,18,11
117,WRO,P011901,P012601,15.417,-5,26,31
117,WRO,P011901,P012699,19.1,-10,33,43
117,WRO,P011901,P012736,2.0,-3,3,6
117,WRO,P012308,P012601,2.15,0,2,2
117,WRO,P012308,P012749,3.867,2,4,2
117,WRO,P012601,P012699,20.967,6,49,43
117,WRO,P012601,P012736,2.717,-2,3,5
117,WRO,P012601,P012749,12.801,7,32,25
117,WRO,P012699,P012736,4.233,-4,6,10
117,WRO,P012699,P012749,11.016,13,35,22
117,WRO,P012736,P012749,5.867,-5,6,11
118,ARI,P003240,P004292,11.017,8,31,23
118,ARI,P003240,P010387,10.866,4,23,19
118,ARI,P003240,P012616,1.933,-1,7,8
118,ARI,P003240,P012702,3.0,-3,7,10
118,ARI,P003240,P012708,8.249,-6,12,18
118,ARI,P003240,P012716,9.918,3,27,24
118,ARI,P003240,P012717,9.251,4,22,18
118,ARI,P003240,P012722,8.317,-3,13,16
118,ARI,P003240,P012760,10.2,11,30,19
118,ARI,P003240,P012792,13.317,3,28,25
118,ARI,P004292,P010387,6.5,3,16,13
118,ARI,P004292,P012616,1.016,0,5,5
118,ARI,P004292,P012702,14.2,7,36,29
118,ARI,P004292,P012708,18.382,6,48,42
118,ARI,P004292,P012716,21.6,11,58,47
118,ARI,P004292,P012717,17.084,15,43,28
118,ARI,P004292,P012722,2.35,3,5,2
118,ARI,P004292,P012760,11.183,5,33,28
118,ARI,P004292,P012792,7.6,2,21,19
118,ARI,P010387,P012702,2.033,-2,5,7
118,ARI,P010387,P012708,7.499,-4,12,16
118,ARI,P010387,P012716,1.1,-3,0,3
118,ARI,P010387,P012722,4.083,-3,4,7
118,ARI,P010387,P012760,5.85,6,14,8
118,ARI,P010387,P012792,9.933,3,18,15
118,ARI,P012616,P012708,0.45,0,0,0
118,ARI,P012616,P012716,1.5,-1,7,8
118,ARI,P012616,P012717,0.9,-1,2,3
118,ARI,P012616,P012722,0.917,-1,2,3
118,ARI,P012616,P012760,1.016,0,5,5
118,ARI,P012702,P012708,13.233,8,34,26
118,ARI,P012702,P012716,12.167,9,31,22
118,ARI,P012702,P012717,12.167,9,31,22
118,ARI,P012708,P012716,17.4,8,45,37
118,ARI,P012708,P012717,14.617,8,35,27
118,ARI,P012708,P012722,4.233,-3,4,7
118,ARI,P012708,P012760,8.166,-3,19,22
118,ARI,P012708,P012792,10.299,-6,19,25
118,ARI,P012716,P012717,23.868,12,57,45
118,ARI,P012716,P012722,4.367,0,9,9
118,ARI,P012716,P012760,11.867,-1,32,33
118,ARI,P012716,P012792,9.817,-6,22,28
118,ARI,P012717,P012722,4.217,0,9,9
118,ARI,P012717,P012760,7.484,3,17,14
118,ARI,P012717,P012792,5.884,-2,12,14
118,ARI,P012722,P012792,5.316,-5,6,11
118,ARI,P012760,P012792,13.634,3,34,31
118,TTK,P000497,P004801,2.45,-7,2,9
118,TTK,P000497,P005000,7.266,6,18,12
118,TTK,P000497,P006693,4.517,1,11,10
118,TTK,P000497,P009845,0.617,-3,0,3
118,TTK,P000497,P011239,7.566,4,18,14
118,TTK,P000497,P011834,8.183,1,18,17
118,TTK,P000497,P011925,2.133,2,5,3
118,TTK,P004801,P005000,13.532,-2,36,38
118,TTK,P004801,P005685,2.033,-1,5,6
118,TTK,P004801,P006693,14.833,-14,33,47
118,TTK,P004801,P009845,2.917,-5,3,8
118,TTK,P004801,P011239,14.765,-15,26,41
118,TTK,P004801,P011834,16.416,-11,39,50
118,TTK,P004801,P011925,19.832,-8,48,56
118,TTK,P004801,P011975,4.433,-3,8,11
118,TTK,P004801,P011978,0.117,-2,0,2
118,TTK,P005000,P005685,2.033,-1,5,6
118,TTK,P005000,P006693,19.65,7,46,39
118,TTK,P005000,P011239,25.549,2,50,48
118,TTK,P005000,P011834,24.283,11,60,49
118,TTK,P005000,P011925,25.016,3,58,55
118,TTK,P005000,P011975,5.35,-4,11,15
118,TTK,P005000,P011978,0.117,-2,0,2
118,TTK,P005685,P011925,2.033,-1,5,6
118,TTK,P005685,P011975,2.033,-1,5,6
118,TTK,P006693,P009845,2.917,-5,3,8
118,TTK,P006693,P011239,22.916,-7,41,48
118,TTK,P006693,P011834,26.967,-5,57,62
118,TTK,P006693,P011925,23.883,-7,49,56
118,TTK,P006693,P011978,0.117,-2,0,2
118,TTK,P009845,P011834,2.917,-5,3,8
118,TTK,P009845,P011925,2.3,-2,3,5
118,TTK,P011239,P011834,27.549,-3,55,58
118,TTK,P011239,P011925,26.066,-10,48,58
118,TTK,P011239,P011975,3.317,-3,6,9
118,TTK,P011834,P011925,26.983,-1,61,62
118,TTK,P011834,P011975,0.917,-1,3,4
118,TTK,P011834,P011978,0.117,-2,0,2
118,TTK,P011925,P011975,5.35,-4,11,15
119,LKB,P002012,P004664,24.367,3,59,56
119,LKB,P002012,P004868,2.901,-5,6,11
119,LKB,P002012,P005521,6.133,6,16,10
119,LKB,P002012,P006230,17.733,5,45,40
119,LKB,P002012,P006901,10.9,-2,27,29
119,LKB,P002012,P007029,23.533,-7,53,60
119,LKB,P002012,P010190,13.533,-8,30,38
119,LKB,P002012,P010461,9.3,-12,16,28
119,LKB,P004664,P004868,11.117,6,27,21
119,LKB,P004664,P005521,6.133,6,16,10
119,LKB,P004664,P006230,19.95,15,52,37
119,LKB,P004664,P006901,17.067,14,46,32
119,LKB,P004664,P007029,25.467,9,63,54
119,LKB,P004664,P010190,15.717,-3,37,40
119,LKB,P004664,P010461,13.25,-6,28,34
119,LKB,P004868,P006230,8.951,3,21,18
119,LKB,P004868,P006901,13.45,10,33,23
119,LKB,P004868,P007029,11.501,6,28,22
119,LKB,P004868,P010190,8.3,3,19,16
119,LKB,P004868,P010461,6.716,1,14,13
119,LKB,P005521,P006230,6.133,6,16,10
119,LKB,P005521,P007029,6.133,6,16,10
119,LKB,P006230,P006901,15.317,16,44,28
119,LKB,P006230,P007029,20.75,10,52,42
119,LKB,P006230,P010190,6.566,5,18,13
119,LKB,P006901,P007029,16.0,5,39,34
119,LKB,P006901,P010190,13.983,-6,29,35
119,LKB,P006901,P010461,8.483,-9,14,23
119,LKB,P007029,P010190,14.033,-11,28,39
119,LKB,P007029,P010461,11.383,-10,21,31
119,LKB,P010190,P010461,15.2,-16,27,43
119,ULM,P005422,P006997,4.883,0,11,11
119,ULM,P005422,P007952,7.85,0,19,19
119,ULM,P005422,P010106,16.884,4,42,38
119,ULM,P005422,P010582,19.899,10,48,38
119,ULM,P005422,P010726,11.349,-1,29,30
119,ULM,P005422,P011457,1.483,-4,3,7
119,ULM,P005422,P012603,24.417,10,65,55
119,ULM,P005422,P012604,21.616,8,57,49
119,ULM,P005422,P012703,9.483,5,30,25
119,ULM,P006997,P007952,7.9,-8,12,20
119,ULM,P006997,P010582,6.2,0,13,13
119,ULM,P006997,P010726,10.484,-13,14,27
119,ULM,P006997,P011457,10.534,-12,14,26
119,ULM,P006997,P012603,4.234,-9,4,13
119,ULM,P006997,P012604,3.283,5,9,4
119,ULM,P006997,P012703,14.15,-11,23,34
119,ULM,P007952,P010106,3.584,5,11,6
119,ULM,P007952,P010582,1.967,1,3,2
119,ULM,P007952,P010726,8.516,-8,14,22
119,ULM,P007952,P011457,4.383,-3,6,9
119,ULM,P007952,P012603,4.067,5,13,8
119,ULM,P007952,P012703,10.133,-4,22,26
119,ULM,P010106,P010582,12.9,-1,25,26
119,ULM,P010106,P012603,16.884,4,42,38
119,ULM,P010106,P012604,13.3,-1,31,32
119,ULM,P010106,P012703,3.984,5,17,12
119,ULM,P010582,P010726,7.033,5,20,15
119,ULM,P010582,P011457,5.0,-7,8,15
119,ULM,P010582,P012603,21.55,2,47,45
119,ULM,P010582,P012604,19.982,9,49,40
119,ULM,P010582,P012703,4.933,1,11,10
119,ULM,P010726,P011457,8.317,-12,11,23
119,ULM,P010726,P012603,10.117,1,25,24
119,ULM,P010726,P012604,7.083,4,21,17
119,ULM,P010726,P012703,9.833,-12,14,26
119,ULM,P011457,P012603,5.551,-11,7,18
119,ULM,P011457,P012604,3.4,-4,7,11
119,ULM,P011457,P012703,9.4,-11,12,23
119,ULM,P012603,P012604,20.35,5,52,47
119,ULM,P012603,P012703,7.434,-3,21,24
119,ULM,P012604,P012703,5.65,6,18,12
120,CAN,P001607,P004160,9.533,-7,18,25
120,CAN,P001607,P005005,9.85,2,21,19
120,CAN,P001607,P006588,11.917,6,31,25
120,CAN,P001607,P007560,5.934,6,15,9
120,CAN,P001607,P007644,7.567,-4,13,17
120,CAN,P001607,P008121,4.183,1,12,11
120,CAN,P001607,P009864,4.399,-12,2,14
120,CAN,P001607,P010385,5.617,12,20,8
120,CAN,P003425,P003637,8.367,-10,9,19
120,CAN,P003425,P004160,6.549,-7,7,14
120,CAN,P003425,P005005,6.783,-1,10,11
120,CAN,P003425,P006588,8.7,-7,13,20
120,CAN,P003425,P007560,13.315,-8,29,37
120,CAN,P003425,P007644,9.399,-14,9,23
120,CAN,P003425,P008121,14.816,-14,31,45
120,CAN,P003425,P009864,9.1,-3,21,24
120,CAN,P003425,P010385,11.232,-9,20,29
120,CAN,P003425,P010452,11.399,-7,23,30
120,CAN,P003637,P005005,3.55,1,5,4
120,CAN,P003637,P006588,4.617,-2,5,7
120,CAN,P003637,P007644,4.783,-8,4,12
120,CAN,P003637,P008121,4.817,-11,4,15
120,CAN,P003637,P009864,5.167,-6,7,13
120,CAN,P003637,P010452,2.167,-4,2,6
120,CAN,P004160,P005005,11.599,-5,23,28
120,CAN,P004160,P006588,7.033,-5,16,21
120,CAN,P004160,P007560,4.366,-10,2,12
120,CAN,P004160,P007644,9.449,-17,8,25
120,CAN,P004160,P008121,0.783,-5,0,5
120,CAN,P004160,P009864,3.616,-10,2,12
120,CAN,P004160,P010385,9.416,3,22,19
120,CAN,P004160,P010452,3.316,-5,2,7
120,CAN,P005005,P006588,10.9,5,24,19
120,CAN,P005005,P007560,2.15,-1,3,4
120,CAN,P005005,P007644,10.199,-9,11,20
120,CAN,P005005,P009864,5.35,-4,7,11
120,CAN,P005005,P010385,7.483,4,20,16
120,CAN,P006588,P007560,10.35,-2,23,25
120,CAN,P006588,P007644,5.767,1,11,10
120,CAN,P006588,P008121,9.333,-7,20,27
120,CAN,P006588,P009864,5.15,-9,5,14
120,CAN,P006588,P010385,10.033,4,28,24
120,CAN,P007560,P007644,4.834,1,10,9
120,CAN,P007560,P008121,13.399,3,39,36
120,CAN,P007560,P009864,4.716,1,14,13
120,CAN,P007560,P010385,10.032,-7,20,27
120,CAN,P007560,P010452,9.232,-3,21,24
120,CAN,P007644,P008121,4.667,-3,11,14
120,CAN,P007644,P009864,4.416,-9,4,13
120,CAN,P007644,P010385,3.233,-2,5,7
120,CAN,P007644,P010452,3.55,-8,2,10
120,CAN,P008121,P009864,8.149,-11,16,27
120,CAN,P008121,P010385,7.766,-3,18,21
120,CAN,P008121,P010452,8.083,-2,21,23
120,CAN,P009864,P010452,3.933,3,14,11
120,CAN,P010385,P010452,3.916,-2,7,9
120,TRN,P001479,P005059,6.717,4,15,11
120,TRN,P001479,P006382,5.166,12,14,2
120,TRN,P001479,P007828,5.317,-3,5,8
120,TRN,P001479,P009903,4.734,7,12,5
120,TRN,P001479,P012593,16.233,5,35,30
120,TRN,P001479,P012594,5.066,4,15,11
120,TRN,P001479,P012595,3.917,-2,5,7
120,TRN,P001479,P012596,12.366,-2,23,25
120,TRN,P001479,P012597,6.151,2,13,11
120,TRN,P001479,P012687,2.733,-7,3,10
120,TRN,P005059,P005738,2.0,2,7,5
120,TRN,P005059,P006382,0.683,4,4,0
120,TRN,P005059,P009903,2.917,4,9,5
120,TRN,P005059,P012593,8.717,6,22,16
120,TRN,P005059,P012595,4.55,0,10,10
120,TRN,P005059,P012596,5.8,2,13,11
120,TRN,P005059,P012597,3.484,2,8,6
120,TRN,P005738,P006382,6.733,4,14,10
120,TRN,P005738,P007828,9.783,21,29,8
120,TRN,P005738,P009903,13.9,6,40,34
120,TRN,P005738,P012593,8.45,2,20,18
120,TRN,P005738,P012594,10.317,0,27,27
120,TRN,P005738,P012595,19.634,20,58,38
120,TRN,P005738,P012596,9.0,11,23,12
120,TRN,P005738,P012597,11.783,2,34,32
120,TRN,P006382,P007828,6.8,10,14,4
120,TRN,P006382,P009903,0.783,3,3,0
120,TRN,P006382,P012593,6.382,8,16,8
120,TRN,P006382,P012594,3.616,8,10,2
120,TRN,P006382,P012595,3.967,7,9,2
120,TRN,P006382,P012596,11.116,13,25,12
120,TRN,P006382,P012597,1.483,-5,3,8
120,TRN,P006382,P012687,0.867,0,0,0
120,TRN,P007828,P009903,4.25,4,11,7
120,TRN,P007828,P012593,7.983,6,14,8
120,TRN,P007828,P012595,8.317,16,24,8
120,TRN,P007828,P012596,10.85,14,23,9
120,TRN,P007828,P012597,5.45,5,16,11
120,TRN,P007828,P012687,1.65,-1,0,1
120,TRN,P009903,P012593,9.351,6,23,17
120,TRN,P009903,P012594,11.467,5,32,27
120,TRN,P009903,P012595,13.767,8,42,34
120,TRN,P009903,P012597,13.367,9,36,27
120,TRN,P012593,P012594,7.183,1,19,18
120,TRN,P012593,P012595,9.784,4,23,19
120,TRN,P012593,P012596,15.332,1,32,31
120,TRN,P012593,P012597,7.451,-4,13,17
120,TRN,P012593,P012687,1.866,-7,3,10
120,TRN,P012594,P012595,10.684,2,29,27
120,TRN,P012594,P012596,3.916,-1,10,11
120,TRN,P012594,P012597,8.2,3,23,20
120,TRN,P012594,P012687,1.083,-6,3,9
120,TRN,P012595,P012596,9.784,10,21,11
120,TRN,P012595,P012597,9.8,7,31,24
120,TRN,P012596,P012597,4.567,-5,11,16
120,TRN,P012596,P012687,2.733,-7,3,10
121,LJU,P002561,P003452,12.067,-7,26,33
121,LJU,P002561,P005969,12.666,-5,27,32
121,LJU,P002561,P007066,12.95,-2,35,37
121,LJU,P002561,P009392,3.733,-4,1,5
121,LJU,P002561,P009395,16.583,-6,36,42
121,LJU,P002561,P011261,8.533,0,19,19
121,LJU,P003452,P005969,31.467,-5,81,86
121,LJU,P003452,P007066,21.501,5,61,56
121,LJU,P003452,P009392,15.65,-16,31,47
121,LJU,P003452,P009395,33.717,-1,88,89
121,LJU,P003452,P011261,27.334,0,73,73
121,LJU,P005969,P007066,21.017,7,62,55
121,LJU,P005969,P009392,16.783,-16,31,47
121,LJU,P005969,P009395,34.266,1,89,88
121,LJU,P005969,P011261,27.933,2,74,72
121,LJU,P007066,P009392,1.767,-5,2,7
121,LJU,P007066,P009395,23.217,11,69,58
121,LJU,P007066,P011261,19.484,8,55,47
121,LJU,P009392,P009395,15.016,-11,29,40
121,LJU,P009392,P011261,14.183,-12,30,42
121,LJU,P009395,P011261,30.133,6,81,75
121,PMT,P001686,P002644,12.599,-4,36,40
121,PMT,P001686,P010549,4.5,3,6,3
121,PMT,P001686,P011823,9.551,3,23,20
121,PMT,P001686,P011942,17.45,4,44,40
121,PMT,P001686,P011943,3.467,-2,11,13
121,PMT,P001686,P011944,13.067,0,40,40
121,PMT,P001686,P011947,6.433,-9,16,25
121,PMT,P001686,P011966,7.95,-5,20,25
121,PMT,P001686,P012600,13.583,6,40,34
121,PMT,P002020,P010549,6.267,6,18,12
121,PMT,P002020,P011823,6.267,6,18,12
121,PMT,P002020,P011942,3.15,8,14,6
121,PMT,P002020,P011943,3.117,-2,4,6
121,PMT,P002020,P011944,3.117,-2,4,6
121,PMT,P002020,P012600,3.15,8,14,6
121,PMT,P002644,P010549,6.234,-4,10,14
121,PMT,P002644,P011823,11.584,0,28,28
121,PMT,P002644,P011942,15.083,1,44,43
121,PMT,P002644,P011943,7.2,3,16,13
121,PMT,P002644,P011944,13.133,1,40,39
121,PMT,P002644,P011947,14.6,-2,38,40
121,PMT,P002644,P011966,4.816,-1,14,15
121,PMT,P002644,P012600,11.483,-10,30,40
121,PMT,P010549,P011823,14.835,5,34,29
121,PMT,P010549,P011942,9.367,7,24,17
121,PMT,P010549,P011943,5.884,3,10,7
121,PMT,P010549,P011944,3.567,-1,5,6
121,PMT,P010549,P011947,5.051,-1,8,9
121,PMT,P010549,P012600,7.967,2,21,19
121,PMT,P011823,P011942,16.151,13,48,35
121,PMT,P011823,P011943,10.584,1,21,20
121,PMT,P011823,P011944,15.917,5,40,35
121,PMT,P011823,P011947,11.401,5,26,21
121,PMT,P011823,P011966,3.134,-4,6,10
121,PMT,P011823,P012600,10.184,2,32,30
121,PMT,P011942,P011944,13.2,7,42,35
121,PMT,P011942,P011947,7.117,2,20,18
121,PMT,P011942,P011966,6.717,-2,16,18
121,PMT,P011942,P012600,15.433,12,48,36
121,PMT,P011943,P011944,9.417,-5,20,25
121,PMT,P011943,P011947,7.2,3,16,13
121,PMT,P011943,P012600,1.867,-1,6,7
121,PMT,P011944,P011947,9.933,1,28,27
121,PMT,P011944,P011966,2.917,-2,6,8
121,PMT,P011944,P012600,6.2,4,23,19
121,PMT,P011947,P011966,1.233,-3,4,7
121,PMT,P011947,P012600,1.9,-8,4,12
121,PMT,P011966,P012600,5.033,-3,14,17
122,BES,P005348,P007914,4.117,-5,5,10
122,BES,P005348,P008945,8.282,15,19,4
122,BES,P005348,P009582,18.348,11,34,23
122,BES,P005348,P011357,6.149,-7,6,13
122,BES,P005348,P011924,12.266,-2,20,22
122,BES,P005348,P011936,8.583,2,17,15
122,BES,P005348,P012233,0.017,-2,0,2
122,BES,P005348,P012622,6.533,5,10,5
122,BES,P005348,P012647,13.233,15,29,14
122,BES,P007914,P008945,9.583,2,15,13
122,BES,P007914,P009582,5.783,-1,10,11
122,BES,P007914,P011357,8.7,-3,14,17
122,BES,P007914,P011379,1.967,-4,2,6
122,BES,P007914,P011924,11.484,-3,19,22
122,BES,P007914,P011936,14.067,-2,25,27
122,BES,P007914,P012233,0.017,-2,0,2
122,BES,P007914,P012622,11.884,0,20,20
122,BES,P007914,P012647,10.934,-2,18,20
122,BES,P008945,P009582,13.648,13,27,14
122,BES,P008945,P011357,4.983,-5,6,11
122,BES,P008945,P011379,2.066,1,3,2
122,BES,P008945,P011924,5.499,6,11,5
122,BES,P008945,P011936,12.016,6,22,16
122,BES,P008945,P012622,17.032,15,29,14
122,BES,P008945,P012647,16.615,27,36,9
122,BES,P009582,P011357,10.282,-5,15,20
122,BES,P009582,P011379,0.833,-2,0,2
122,BES,P009582,P011924,14.082,2,26,24
122,BES,P009582,P011936,13.516,7,28,21
122,BES,P009582,P012622,9.365,10,16,6
122,BES,P009582,P012647,13.799,21,32,11
122,BES,P011357,P011379,1.05,0,2,2
122,BES,P011357,P011924,8.499,-4,13,17
122,BES,P011357,P011936,9.067,-3,15,18
122,BES,P011357,P012622,4.066,-1,5,6
122,BES,P011379,P011924,4.033,-3,5,8
122,BES,P011379,P011936,1.967,-4,2,6
122,BES,P011379,P012622,2.066,1,3,2
122,BES,P011379,P012647,2.15,-1,3,4
122,BES,P011924,P011936,12.867,-2,25,27
122,BES,P011924,P012622,9.749,3,17,14
122,BES,P011924,P012647,13.717,7,28,21
122,BES,P011936,P012622,11.633,5,22,17
122,BES,P011936,P012647,15.816,7,32,25
122,BES,P012233,P012622,0.017,-2,0,2
122,BES,P012233,P012647,0.017,-2,0,2
122,BES,P012622,P012647,17.583,16,34,18
122,WOL,P002387,P003212,3.833,-6,5,11
122,WOL,P002387,P005516,9.166,-15,5,20
122,WOL,P002387,P006546,8.066,-16,2,18
122,WOL,P002387,P012576,7.033,-13,2,15
122,WOL,P002387,P012577,8.866,-14,6,20
122,WOL,P002387,P012789,3.833,-6,5,11
122,WOL,P002387,PLCT,2.667,-6,3,9
122,WOL,P003212,P004229,3.883,-3,6,9
122,WOL,P003212,P004645,11.284,-5,18,23
122,WOL,P003212,P005516,2.133,-2,3,5
122,WOL,P003212,P006154,4.1,-3,6,9
122,WOL,P003212,P006546,14.217,-8,22,30
122,WOL,P003212,P006907,2.533,0,5,5
122,WOL,P003212,P012576,1.417,-4,0,4
122,WOL,P003212,P012577,13.65,-8,22,30
122,WOL,P003212,P012789,16.217,-2,30,32
122,WOL,P003212,PLCT,12.801,5,27,22
122,WOL,P004229,P005516,3.667,1,6,5
122,WOL,P004229,P006154,7.55,-2,12,14
122,WOL,P004229,P006546,1.35,-3,1,4
122,WOL,P004229,P006907,6.2,1,11,10
122,WOL,P004229,P012577,7.55,-2,12,14
122,WOL,P004645,P005516,1.467,0,2,2
122,WOL,P004645,P006546,10.784,-7,16,23
122,WOL,P004645,P012576,1.417,-4,0,4
122,WOL,P004645,P012577,3.417,-4,4,8
122,WOL,P004645,P012789,11.334,-1,20,21
122,WOL,P004645,PLCT,11.301,1,20,19
122,WOL,P005516,P006154,5.767,4,11,7
122,WOL,P005516,P006546,12.717,-8,12,20
122,WOL,P005516,P006907,6.384,4,11,7
122,WOL,P005516,P012576,9.75,-10,7,17
122,WOL,P005516,P012577,17.15,-1,23,24
122,WOL,P005516,P012789,7.2,3,13,10
122,WOL,P005516,PLCT,7.067,0,11,11
122,WOL,P006154,P006546,1.567,-3,1,4
122,WOL,P006154,P006907,8.3,4,16,12
122,WOL,P006154,P012576,2.1,3,5,2
122,WOL,P006154,P012577,9.867,1,17,16
122,WOL,P006154,P012789,0.217,0,0,0
122,WOL,P006546,P006907,0.617,0,0,0
122,WOL,P006546,P012576,9.067,-17,2,19
122,WOL,P006546,P012577,15.6,-10,17,27
122,WOL,P006546,P012789,16.517,4,31,27
122,WOL,P006546,PLCT,17.234,4,32,28
122,WOL,P006907,P012576,2.717,3,5,2
122,WOL,P006907,P012577,8.917,4,16,12
122,WOL,P012576,P012577,7.75,-5,6,11
122,WOL,P012576,PLCT,3.417,-9,1,10
122,WOL,P012577,P012789,13.367,0,24,24
122,WOL,P012577,PLCT,8.534,11,21,10
122,WOL,P012789,PLCT,16.451,14,37,23
123,JOV,P002507,P006771,12.183,-3,20,23
123,JOV,P002507,P010161,6.116,3,17,14
123,JOV,P002507,P010458,5.716,1,15,14
123,JOV,P002507,P010708,0.033,0,0,0
123,JOV,P002507,P010709,2.933,2,4,2
123,JOV,P002507,P011247,13.85,1,31,30
123,JOV,P002507,P011248,13.283,-7,21,28
123,JOV,P002507,P012349,10.017,-2,17,19
123,JOV,P002507,P012780,3.1,-1,5,6
123,JOV,P002507,PJUG,8.233,-2,18,20
123,JOV,P006771,P010709,2.933,2,4,2
123,JOV,P006771,P011247,8.2,0,16,16
123,JOV,P006771,P011248,12.25,-4,21,25
123,JOV,P006771,P012349,10.45,0,19,19
123,JOV,P006771,P012780,3.733,-3,5,8
123,JOV,P006771,PJUG,2.983,-4,3,7
123,JOV,P010161,P010458,12.799,2,31,29
123,JOV,P010161,P010708,0.933,3,3,0
123,JOV,P010161,P010709,2.833,-6,5,11
123,JOV,P010161,P011247,15.099,13,42,29
123,JOV,P010161,P011248,16.498,1,34,33
123,JOV,P010161,P012349,11.032,8,27,19
123,JOV,P010161,P012780,17.582,8,42,34
123,JOV,P010161,PJUG,14.032,16,39,23
123,JOV,P010458,P010708,0.9,3,3,0
123,JOV,P010458,P011247,8.816,-1,22,23
123,JOV,P010458,P011248,6.116,-2,12,14
123,JOV,P010458,P012780,6.183,-2,13,15
123,JOV,P010458,PJUG,10.666,7,28,21
123,JOV,P010708,P011248,0.933,3,3,0
123,JOV,P010708,PJUG,0.933,3,3,0
123,JOV,P010709,P011248,5.766,-4,9,13
123,JOV,P010709,P012349,5.766,-4,9,13
123,JOV,P010709,P012780,2.833,-6,5,11
123,JOV,P011247,P011248,17.217,0,38,38
123,JOV,P011247,P012349,15.767,10,40,30
123,JOV,P011247,P012780,13.333,14,37,23
123,JOV,P011247,PJUG,11.25,11,34,23
123,JOV,P011248,P012349,23.383,2,48,46
123,JOV,P011248,P012780,18.949,-4,40,44
123,JOV,P011248,PJUG,10.933,-1,22,23
123,JOV,P012349,P012780,14.049,9,36,27
123,JOV,P012349,PJUG,5.8,5,16,11
123,JOV,P012780,PJUG,13.566,9,33,24
123,VNC,P000968,P003759,24.516,12,60,48
123,VNC,P000968,P004117,13.05,-3,23,26
123,VNC,P000968,P008052,16.0,11,41,30
123,VNC,P000968,P009400,6.233,3,13,10
123,VNC,P000968,P011909,20.55,7,49,42
123,VNC,P000968,P012591,26.783,10,62,52
123,VNC,P003759,P004117,12.783,-1,23,24
123,VNC,P003759,P008052,14.433,12,39,27
123,VNC,P003759,P009400,6.233,3,13,10
123,VNC,P003759,P011909,20.983,8,49,41
123,VNC,P003759,P012590,2.7,-1,2,3
123,VNC,P003759,P012591,27.216,11,62,51
123,VNC,P004117,P008052,7.184,-14,8,22
123,VNC,P004117,P009400,6.883,-3,11,14
123,VNC,P004117,P011909,13.85,-12,20,32
123,VNC,P004117,P011928,0.383,0,0,0
123,VNC,P004117,P012587,1.517,-7,0,7
123,VNC,P004117,P012590,6.917,-12,8,20
123,VNC,P004117,P012591,18.833,-8,31,39
123,VNC,P008052,P009400,6.117,-6,10,16
123,VNC,P008052,P011909,20.716,-1,48,49
123,VNC,P008052,P011928,5.216,-5,11,16
123,VNC,P008052,P012587,5.8,-9,11,20
123,VNC,P008052,P012590,10.833,-18,17,35
123,VNC,P008052,P012591,21.033,2,47,45
123,VNC,P009400,P011909,0.383,0,0,0
123,VNC,P009400,P011928,0.633,0,0,0
123,VNC,P009400,P012587,1.517,-7,0,7
123,VNC,P009400,P012590,3.317,-6,4,10
123,VNC,P009400,P012591,8.416,4,17,13
123,VNC,P011909,P011928,5.349,-5,11,16
123,VNC,P011909,P012587,4.283,-2,11,13
123,VNC,P011909,P012590,9.516,-12,15,27
123,VNC,P011909,P012591,26.166,-3,53,56
123,VNC,P011928,P012587,4.283,-2,11,13
123,VNC,P011928,P012590,5.216,-5,11,16
123,VNC,P011928,P012591,1.316,-3,0,3
123,VNC,P012587,P012590,5.8,-9,11,20
123,VNC,P012590,P012591,7.033,-9,8,17
124,HAM,P009663,P010070,1.266,-8,0,8
124,HAM,P009663,P011168,17.615,-1,43,44
124,HAM,P009663,P011187,1.733,-3,2,5
124,HAM,P009663,P012579,5.766,-10,10,20
124,HAM,P009663,P012580,17.965,-7,40,47
124,HAM,P009663,P012581,20.948,-11,49,60
124,HAM,P009663,P012582,16.383,-10,40,50
124,HAM,P009663,P012648,6.966,-10,19,29
124,HAM,P009663,P012694,5.499,5,19,14
124,HAM,P009663,P012695,5.583,-13,14,27
124,HAM,P010070,P011168,3.217,-7,5,12
124,HAM,P010070,P011187,3.401,-7,7,14
124,HAM,P010070,P012579,3.401,-7,7,14
124,HAM,P010070,P012580,2.4,-13,2,15
124,HAM,P010070,P012581,1.266,-8,0,8
124,HAM,P010070,P012648,2.267,-2,5,7
124,HAM,P010070,P012695,1.45,-8,2,10
124,HAM,P011168,P011187,11.668,3,34,31
124,HAM,P011168,P012579,16.918,-9,39,48
124,HAM,P011168,P012580,21.433,6,55,49
124,HAM,P011168,P012581,21.233,9,55,46
124,HAM,P011168,P012582,16.684,1,42,41
124,HAM,P011168,P012648,8.967,-6,23,29
124,HAM,P011168,P012694,10.333,12,36,24
124,HAM,P011187,P012579,9.085,-2,25,27
124,HAM,P011187,P012580,7.667,-5,20,25
124,HAM,P011187,P012581,6.6,1,18,17
124,HAM,P011187,P012582,4.734,3,16,13
124,HAM,P011187,P012648,4.784,0,13,13
124,HAM,P011187,P012694,5.933,1,15,14
124,HAM,P011187,P012695,0.667,-3,2,5
124,HAM,P012579,P012580,9.134,-6,20,26
124,HAM,P012579,P012581,6.134,-2,11,13
124,HAM,P012579,P012582,7.684,-1,20,21
124,HAM,P012579,P012648,6.834,-8,16,24
124,HAM,P012579,P012694,4.717,0,14,14
124,HAM,P012579,P012695,0.667,-3,2,5
124,HAM,P012580,P012581,22.016,-7,50,57
124,HAM,P012580,P012582,13.317,0,34,34
124,HAM,P012580,P012694,9.133,8,28,20
124,HAM,P012580,P012695,3.467,-12,7,19
124,HAM,P012581,P012582,15.784,-4,41,45
124,HAM,P012581,P012648,4.916,-2,16,18
124,HAM,P012581,P012694,9.716,9,30,21
124,HAM,P012581,P012695,5.583,-13,14,27
124,HAM,P012582,P012648,6.55,-9,17,26
124,HAM,P012582,P012695,4.8,-8,14,22
124,HAM,P012648,P012694,2.933,1,10,9
124,HAM,P012648,P012695,2.783,-4,9,13
124,HTA,P003533,P004267,15.417,23,52,29
124,HTA,P003533,P004846,15.067,15,46,31
124,HTA,P003533,P007759,7.949,4,23,19
124,HTA,P003533,P011973,8.533,-5,23,28
124,HTA,P003533,P011990,21.466,11,67,56
124,HTA,P003533,P012028,2.617,-6,4,10
124,HTA,P003533,P012592,1.183,-4,2,6
124,HTA,P003533,P012794,18.1,14,59,45
124,HTA,P004267,P004846,26.4,22,81,59
124,HTA,P004267,P007759,18.066,11,54,43
124,HTA,P004267,P011973,18.85,7,55,48
124,HTA,P004267,P011990,24.917,27,80,53
124,HTA,P004267,P012028,3.734,-1,7,8
124,HTA,P004267,P012706,1.25,2,4,2
124,HTA,P004267,P012794,18.234,25,63,38
124,HTA,P004846,P007759,14.616,4,40,36
124,HTA,P004846,P011973,20.583,2,59,57
124,HTA,P004846,P011990,23.9,17,72,55
124,HTA,P004846,P012028,3.217,-1,5,6
124,HTA,P004846,P012794,15.217,17,53,36
124,HTA,P007759,P011973,19.0,3,51,48
124,HTA,P007759,P011990,15.666,6,42,36
124,HTA,P007759,P012028,2.4,-1,5,6
124,HTA,P007759,P012592,1.117,-2,2,4
124,HTA,P007759,P012706,2.367,0,6,6
124,HTA,P007759,P012793,0.85,0,2,2
124,HTA,P007759,P012794,10.233,7,35,28
124,HTA,P011973,P011990,18.55,-3,49,52
124,HTA,P011973,P012028,2.5,-3,5,8
124,HTA,P011973,P012592,1.117,-2,2,4
124,HTA,P011973,P012706,2.367,0,6,6
124,HTA,P011973,P012793,0.85,0,2,2
124,HTA,P011973,P012794,11.45,-3,36,39
124,HTA,P011990,P012028,1.8,-6,4,10
124,HTA,P011990,P012592,1.183,-4,2,6
124,HTA,P011990,P012794,19.65,12,64,52
124,HTA,P012028,P012592,1.183,-4,2,6
124,HTA,P012028,P012794,2.617,-6,4,10
124,HTA,P012592,P012706,1.117,-2,2,4
124,HTA,P012592,P012793,0.85,0,2,2
124,HTA,P012592,P012794,1.45,-6,2,8
124,HTA,P012706,P012793,0.85,0,2,2
124,HTA,P012706,P012794,1.517,0,4,4
125,LLI,P004773,P005247,17.833,-6,33,39
125,LLI,P004773,P006600,13.367,-10,21,31
125,LLI,P004773,P008274,4.217,5,12,7
125,LLI,P004773,P009649,11.583,-9,20,29
125,LLI,P004773,P009672,2.883,3,9,6
125,LLI,P004773,P009680,16.868,-7,33,40
125,LLI,P004773,P012020,9.767,3,25,22
125,LLI,P004773,P012584,1.267,4,6,2
125,LLI,P004773,P012585,14.751,-11,25,36
125,LLI,P005247,P006600,19.316,-18,32,50
125,LLI,P005247,P008274,4.033,1,8,7
125,LLI,P005247,P009649,14.532,-4,28,32
125,LLI,P005247,P009672,7.316,-4,17,21
125,LLI,P005247,P009680,13.4,-15,21,36
125,LLI,P005247,P012020,5.683,4,14,10
125,LLI,P005247,P012585,17.883,-14,31,45
125,LLI,P006600,P008274,6.417,7,14,7
125,LLI,P006600,P009649,17.383,-6,30,36
125,LLI,P006600,P009672,8.8,-10,17,27
125,LLI,P006600,P009680,18.251,-15,31,46
125,LLI,P006600,P012585,24.334,-16,43,59
125,LLI,P008274,P009649,6.1,5,12,7
125,LLI,P008274,P009680,3.651,10,12,2
125,LLI,P008274,P012020,1.267,4,6,2
125,LLI,P008274,P012584,1.267,4,6,2
125,LLI,P008274,P012585,3.784,8,10,2
125,LLI,P009649,P009672,14.45,-4,31,35
125,LLI,P009649,P009680,16.351,-14,26,40
125,LLI,P009649,P012020,10.567,-7,21,28
125,LLI,P009649,P012585,20.834,-13,36,49
125,LLI,P009672,P009680,8.134,-12,14,26
125,LLI,P009672,P012020,6.15,0,14,14
125,LLI,P009672,P012585,12.067,-13,22,35
125,LLI,P009680,P012020,10.151,-3,21,24
125,LLI,P009680,P012584,1.267,4,6,2
125,LLI,P009680,P012585,25.535,-20,44,64
125,LLI,P012020,P012584,1.267,4,6,2
125,LLI,P012020,P012585,7.284,-5,13,18
125,PRS,P003481,P005793,0.217,0,0,0
125,PRS,P003481,P009556,3.15,7,13,6
125,PRS,P003481,P011232,11.417,11,27,16
125,PRS,P003481,P012608,4.45,3,9,6
125,PRS,P003481,P012609,7.45,6,18,12
125,PRS,P003481,P012610,3.967,5,9,4
125,PRS,P003481,P012613,3.6,1,5,4
125,PRS,P003481,P012640,11.417,11,27,16
125,PRS,P004512,P005793,14.183,8,33,25
125,PRS,P004512,P011232,0.017,0,0,0
125,PRS,P004512,P011887,4.649,-9,8,17
125,PRS,P004512,P012608,18.466,5,42,37
125,PRS,P004512,P012609,13.05,14,34,20
125,PRS,P004512,P012610,16.399,2,35,33
125,PRS,P004512,P012613,4.283,-3,9,12
125,PRS,P004512,P012640,2.817,3,7,4
125,PRS,P005793,P011232,3.234,-1,8,9
125,PRS,P005793,P011551,1.583,-6,2,8
125,PRS,P005793,P011887,4.783,-2,12,14
125,PRS,P005793,P012608,18.516,3,40,37
125,PRS,P005793,P012609,12.634,16,33,17
125,PRS,P005793,P012610,18.499,3,40,37
125,PRS,P005793,P012613,4.333,-5,7,12
125,PRS,P005793,P012640,8.95,-8,17,25
125,PRS,P009556,P011232,5.933,14,23,9
125,PRS,P009556,P012609,5.933,14,23,9
125,PRS,P009556,P012613,2.783,7,10,3
125,PRS,P009556,P012640,5.933,14,23,9
125,PRS,P011232,P011551,1.583,-6,2,8
125,PRS,P011232,P011887,3.0,-1,8,9
125,PRS,P011232,P012608,4.467,3,9,6
125,PRS,P011232,P012609,11.667,18,34,16
125,PRS,P011232,P012610,3.967,5,9,4
125,PRS,P011232,P012613,6.383,8,15,7
125,PRS,P011232,P012640,17.2,17,45,28
125,PRS,P011551,P011887,1.583,-6,2,8
125,PRS,P011551,P012640,1.583,-6,2,8
125,PRS,P011887,P012608,4.649,-9,8,17
125,PRS,P011887,P012609,2.05,3,8,5
125,PRS,P011887,P012610,4.016,-7,6,13
125,PRS,P011887,P012613,2.866,-8,4,12
125,PRS,P011887,P012640,3.0,-1,8,9
125,PRS,P012608,P012609,13.533,12,34,22
125,PRS,P012608,P012610,24.699,2,51,49
125,PRS,P012608,P012613,8.616,-8,16,24
125,PRS,P012608,P012640,11.6,1,23,22
125,PRS,P012609,P012610,10.983,11,27,16
125,PRS,P012609,P012613,8.433,11,22,11
125,PRS,P012609,P012640,13.067,23,39,16
125,PRS,P012610,P012613,6.566,-11,9,20
125,PRS,P012610,P012640,9.7,-2,18,20
125,PRS,P012613,P012640,12.133,8,27,19
126,BOU,P000498,P004525,9.034,0,20,20
126,BOU,P000498,P010431,3.567,7,7,0
126,BOU,P000498,P010718,3.884,7,7,0
126,BOU,P000498,P011161,12.418,2,26,24
126,BOU,P000498,P011836,6.951,9,13,4
126,BOU,P000498,P011837,5.334,6,10,4
126,BOU,P000498,P012618,10.651,3,23,20
126,BOU,P000498,P012628,12.101,2,26,24
126,BOU,P004525,P010431,1.716,-1,4,5
126,BOU,P004525,P010718,4.066,3,10,7
126,BOU,P004525,P011161,12.25,1,26,25
126,BOU,P004525,P011837,4.233,-2,7,9
126,BOU,P004525,P012617,4.932,0,10,10
126,BOU,P004525,P012618,9.733,2,23,21
126,BOU,P004525,P012628,9.9,-3,20,23
126,BOU,P010431,P010718,22.117,0,41,41
126,BOU,P010431,P011836,20.784,-2,37,39
126,BOU,P010431,P011837,17.083,1,32,31
126,BOU,P010431,P012617,18.583,-12,32,44
126,BOU,P010431,P012618,5.417,-4,9,13
126,BOU,P010431,P012628,0.733,-1,2,3
126,BOU,P010718,P011161,5.017,3,11,8
126,BOU,P010718,P011836,27.968,6,56,50
126,BOU,P010718,P011837,19.05,6,37,31
126,BOU,P010718,P012617,27.8,0,57,57
126,BOU,P010718,P012618,12.984,3,29,26
126,BOU,P010718,P012628,5.25,8,16,8
126,BOU,P011161,P011836,5.351,4,11,7
126,BOU,P011161,P011837,4.117,1,8,7
126,BOU,P011161,P012617,5.183,3,11,8
126,BOU,P011161,P012618,13.484,4,29,25
126,BOU,P011161,P012628,12.584,2,26,24
126,BOU,P011836,P011837,16.967,4,33,29
126,BOU,P011836,P012617,23.734,-3,47,50
126,BOU,P011836,P012618,14.068,4,29,25
126,BOU,P011836,P012628,8.317,10,22,12
126,BOU,P011837,P012617,15.866,-4,30,34
126,BOU,P011837,P012628,2.15,-4,3,7
126,BOU,P012617,P012618,12.8,1,27,26
126,BOU,P012617,P012628,5.766,3,14,11
126,BOU,P012618,P012628,16.067,11,39,28
126,CAN,P001607,P003637,4.0,3,6,3
126,CAN,P001607,P004160,14.268,-8,24,32
126,CAN,P001607,P005005,9.434,-12,13,25
126,CAN,P001607,P006588,4.584,7,10,3
126,CAN,P001607,P007560,1.767,1,4,3
126,CAN,P001607,P008121,7.067,6,13,7
126,CAN,P001607,P009864,10.501,-3,18,21
126,CAN,P001607,P010385,7.767,-2,12,14
126,CAN,P001607,P010452,13.684,-12,20,32
126,CAN,P003425,P003637,25.016,-4,49,53
126,CAN,P003425,P004160,1.716,1,5,4
126,CAN,P003425,P006588,25.899,-8,49,57
126,CAN,P003425,P008121,26.732,-3,54,57
126,CAN,P003425,P009864,18.649,1,36,35
126,CAN,P003425,P010385,8.083,-4,18,22
126,CAN,P003425,P010452,0.833,5,5,0
126,CAN,P003637,P005005,0.45,0,0,0
126,CAN,P003637,P006588,27.883,-1,55,56
126,CAN,P003637,P008121,28.566,-1,55,56
126,CAN,P003637,P009864,20.25,3,37,34
126,CAN,P003637,P010385,8.766,-4,18,22
126,CAN,P003637,P010452,1.133,0,0,0
126,CAN,P004160,P005005,8.984,-12,13,25
126,CAN,P004160,P006588,2.6,0,4,4
126,CAN,P004160,P007560,1.767,1,4,3
126,CAN,P004160,P008121,5.233,4,12,8
126,CAN,P004160,P009864,8.9,-5,17,22
126,CAN,P004160,P010385,7.084,-2,12,14
126,CAN,P004160,P010452,13.384,-7,25,32
126,CAN,P005005,P009864,5.867,-7,8,15
126,CAN,P005005,P010385,3.567,-5,5,10
126,CAN,P005005,P010452,9.434,-12,13,25
126,CAN,P006588,P008121,30.483,-1,59,60
126,CAN,P006588,P009864,20.683,-1,37,38
126,CAN,P006588,P010385,9.8,0,22,22
126,CAN,P007560,P009864,1.767,1,4,3
126,CAN,P007560,P010452,1.767,1,4,3
126,CAN,P008121,P009864,21.516,4,42,38
126,CAN,P008121,P010385,12.283,-1,25,26
126,CAN,P008121,P010452,3.316,4,8,4
126,CAN,P009864,P010452,8.467,-1,17,18
126,CAN,P010385,P010452,6.05,-6,8,14
127,LKB,P002012,P004664,19.382,4,43,39
127,LKB,P002012,P006230,20.366,-4,34,38
127,LKB,P002012,P006901,2.233,0,2,2
127,LKB,P002012,P007029,24.549,-3,45,48
127,LKB,P002012,P009898,12.066,-2,25,27
127,LKB,P002012,P010190,22.266,-2,41,43
127,LKB,P002012,P010461,6.466,3,18,15
127,LKB,P004664,P004868,8.233,-5,13,18
127,LKB,P004664,P006230,14.016,-2,27,29
127,LKB,P004664,P006901,6.616,1,8,7
127,LKB,P004664,P007029,23.482,2,47,45
127,LKB,P004664,P009898,8.466,-3,23,26
127,LKB,P004664,P010190,16.666,-2,34,36
127,LKB,P004664,P010461,13.599,1,29,28
127,LKB,P004868,P006230,1.4,-3,2,5
127,LKB,P004868,P006901,9.016,1,11,10
127,LKB,P004868,P007029,8.116,2,13,11
127,LKB,P004868,P009898,8.783,-6,12,18
127,LKB,P004868,P010190,5.35,-7,5,12
127,LKB,P004868,P010461,11.766,-2,16,18
127,LKB,P006230,P006901,2.233,0,2,2
127,LKB,P006230,P007029,20.116,-7,31,38
127,LKB,P006230,P009898,9.4,-5,14,19
127,LKB,P006230,P010190,19.533,-7,34,41
127,LKB,P006901,P007029,8.049,3,10,7
127,LKB,P006901,P009898,4.633,0,5,5
127,LKB,P006901,P010190,3.2,-2,3,5
127,LKB,P006901,P010461,9.016,1,11,10
127,LKB,P007029,P009898,13.516,-3,25,28
127,LKB,P007029,P010190,20.283,-4,34,38
127,LKB,P007029,P010461,12.549,6,27,21
127,LKB,P009898,P010190,15.083,-10,21,31
127,LKB,P009898,P010461,11.449,-3,23,26
127,LKB,P010190,P010461,8.083,-2,12,14
127,TRN,P001479,P005059,10.683,8,23,15
127,TRN,P001479,P006382,8.2,-2,11,13
127,TRN,P001479,P007828,11.3,4,17,13
127,TRN,P001479,P009903,3.183,3,10,7
127,TRN,P001479,P012593,10.016,5,17,12
127,TRN,P001479,P012594,1.433,0,5,5
127,TRN,P001479,P012596,12.45,2,18,16
127,TRN,P001479,P012597,5.267,0,11,11
127,TRN,P005059,P005738,14.866,-2,27,29
127,TRN,P005059,P006382,7.317,4,15,11
127,TRN,P005059,P007828,6.35,7,12,5
127,TRN,P005059,P009903,13.399,-2,28,30
127,TRN,P005059,P012593,16.866,6,34,28
127,TRN,P005059,P012594,10.632,-6,17,23
127,TRN,P005059,P012596,12.15,8,22,14
127,TRN,P005059,P012597,9.933,1,22,21
127,TRN,P005738,P006382,7.416,5,16,11
127,TRN,P005738,P007828,1.933,3,5,2
127,TRN,P005738,P009903,19.482,1,39,38
127,TRN,P005738,P012593,14.683,0,31,31
127,TRN,P005738,P012594,16.765,-6,28,34
127,TRN,P005738,P012595,2.183,2,5,3
127,TRN,P005738,P012596,4.883,0,9,9
127,TRN,P005738,P012597,15.249,1,32,31
127,TRN,P006382,P007828,7.233,0,10,10
127,TRN,P006382,P009903,3.466,5,7,2
127,TRN,P006382,P012593,2.583,-2,0,2
127,TRN,P006382,P012594,1.416,-1,2,3
127,TRN,P006382,P012596,12.15,-2,20,22
127,TRN,P006382,P012597,12.683,5,27,22
127,TRN,P007828,P009903,3.683,6,10,4
127,TRN,P007828,P012593,7.683,5,12,7
127,TRN,P007828,P012596,9.55,1,12,11
127,TRN,P007828,P012597,5.2,2,10,8
127,TRN,P009903,P012593,17.516,3,41,38
127,TRN,P009903,P012594,17.382,-3,33,36
127,TRN,P009903,P012595,2.183,2,5,3
127,TRN,P009903,P012597,10.366,1,23,22
127,TRN,P012593,P012594,14.516,-1,30,31
127,TRN,P012593,P012595,2.183,2,5,3
127,TRN,P012593,P012596,7.183,2,7,5
127,TRN,P012593,P012597,5.567,0,15,15
127,TRN,P012594,P012595,2.183,2,5,3
127,TRN,P012594,P012596,0.816,-3,0,3
127,TRN,P012594,P012597,7.649,-6,12,18
127,TRN,P012596,P012597,10.15,0,20,20
128,TTK,P000497,P005000,1.6,-1,2,3
128,TTK,P000497,P006693,2.45,9,11,2
128,TTK,P000497,P011239,4.05,8,13,5
128,TTK,P000497,P011834,4.05,8,13,5
128,TTK,P000497,P011925,4.05,8,13,5
128,TTK,P004801,P005000,12.367,10,36,26
128,TTK,P004801,P005685,1.3,-1,5,6
128,TTK,P004801,P006693,13.816,-4,25,29
128,TTK,P004801,P009845,5.25,4,12,8
128,TTK,P004801,P011239,13.35,1,32,31
128,TTK,P004801,P011834,12.567,-2,27,29
128,TTK,P004801,P011925,13.35,0,31,31
128,TTK,P005000,P005685,3.883,-6,5,11
128,TTK,P005000,P006693,17.199,3,33,30
128,TTK,P005000,P009845,6.983,2,12,10
128,TTK,P005000,P010477,9.833,2,19,17
128,TTK,P005000,P011239,15.667,17,47,30
128,TTK,P005000,P011834,11.917,6,28,22
128,TTK,P005000,P011925,19.083,11,46,35
128,TTK,P005685,P006693,3.883,-6,5,11
128,TTK,P005685,P010477,2.583,-5,0,5
128,TTK,P005685,P011925,3.883,-6,5,11
128,TTK,P006693,P009845,3.883,-2,4,6
128,TTK,P006693,P010477,15.467,-7,25,32
128,TTK,P006693,P011239,24.8,6,52,46
128,TTK,P006693,P011834,21.75,-5,39,44
128,TTK,P006693,P011925,27.016,-2,50,52
128,TTK,P009845,P010477,1.167,-4,0,4
128,TTK,P009845,P011239,1.9,2,7,5
128,TTK,P009845,P011834,5.35,-2,5,7
128,TTK,P009845,P011925,4.467,0,8,8
128,TTK,P010477,P011239,13.367,5,30,25
128,TTK,P010477,P011834,9.834,-5,16,21
128,TTK,P010477,P011925,16.217,-2,30,32
128,TTK,P011239,P011834,21.934,3,51,48
128,TTK,P011239,P011925,28.0,14,68,54
128,TTK,P011834,P011925,21.734,1,45,44
128,ULM,P005422,P006997,15.384,7,32,25
128,ULM,P005422,P010106,22.867,13,56,43
128,ULM,P005422,P010582,16.401,12,38,26
128,ULM,P005422,P010726,6.933,5,13,8
128,ULM,P005422,P011457,0.317,0,0,0
128,ULM,P005422,P012066,0.15,-2,0,2
128,ULM,P005422,P012603,10.15,9,28,19
128,ULM,P005422,P012604,26.001,14,60,46
128,ULM,P005422,P012703,5.801,-2,13,15
128,ULM,P006997,P007952,3.85,-3,7,10
128,ULM,P006997,P010106,13.217,9,31,22
128,ULM,P006997,P010582,10.717,3,20,17
128,ULM,P006997,P010726,8.55,0,15,15
128,ULM,P006997,P011457,6.55,-7,12,19
128,ULM,P006997,P012604,18.084,3,37,34
128,ULM,P006997,P012703,11.384,-12,22,34
128,ULM,P007952,P010106,1.117,-5,0,5
128,ULM,P007952,P010582,5.5,-4,7,11
128,ULM,P007952,P010726,1.967,-5,2,7
128,ULM,P007952,P011457,7.467,-9,9,18
128,ULM,P007952,P012603,3.617,-6,2,8
128,ULM,P007952,P012703,6.35,-4,9,13
128,ULM,P010106,P010582,17.685,5,40,35
128,ULM,P010106,P010726,6.616,5,13,8
128,ULM,P010106,P011457,2.684,-4,3,7
128,ULM,P010106,P012066,1.567,-4,3,7
128,ULM,P010106,P012603,13.601,0,31,31
128,ULM,P010106,P012604,25.851,12,62,50
128,ULM,P010106,P012703,2.667,-3,9,12
128,ULM,P010582,P011457,9.117,-10,12,22
128,ULM,P010582,P012066,3.067,-7,5,12
128,ULM,P010582,P012603,17.568,-4,35,39
128,ULM,P010582,P012604,22.935,1,48,47
128,ULM,P010582,P012703,10.75,-8,15,23
128,ULM,P010726,P011457,2.284,-5,2,7
128,ULM,P010726,P012603,0.033,0,0,0
128,ULM,P010726,P012604,6.933,5,13,8
128,ULM,P010726,P012703,2.284,-5,2,7
128,ULM,P011457,P012603,4.534,-8,2,10
128,ULM,P011457,P012604,3.934,-6,5,11
128,ULM,P011457,P012703,8.717,-11,11,22
128,ULM,P012066,P012603,2.917,-5,5,10
128,ULM,P012066,P012604,3.067,-7,5,12
128,ULM,P012066,P012703,1.5,-3,2,5
128,ULM,P012603,P012604,13.984,2,33,31
128,ULM,P012603,P012703,4.0,-4,4,8
128,ULM,P012604,P012703,9.351,-12,17,29
129,ARI,P003240,P004292,7.95,11,21,10
129,ARI,P003240,P010387,4.6,-11,5,16
129,ARI,P003240,P012615,12.25,4,30,26
129,ARI,P003240,P012702,10.783,3,22,19
129,ARI,P003240,P012708,6.883,4,14,10
129,ARI,P003240,P012716,5.099,8,15,7
129,ARI,P003240,P012717,5.316,1,8,7
129,ARI,P003240,P012722,3.233,-7,3,10
129,ARI,P003240,P012760,3.467,6,10,4
129,ARI,P003240,P012792,10.683,1,24,23
129,ARI,P004292,P010387,1.033,-5,0,5
129,ARI,P004292,P012615,6.15,11,19,8
129,ARI,P004292,P012702,8.9,-2,13,15
129,ARI,P004292,P012708,22.65,16,53,37
129,ARI,P004292,P012716,17.666,13,45,32
129,ARI,P004292,P012717,19.383,10,44,34
129,ARI,P004292,P012722,4.383,4,11,7
129,ARI,P004292,P012760,12.167,16,36,20
129,ARI,P004292,P012792,1.85,10,10,0
129,ARI,P010387,P012615,6.217,-7,11,18
129,ARI,P010387,P012638,1.55,4,6,2
129,ARI,P010387,P012702,1.667,-4,2,6
129,ARI,P010387,P012716,1.65,-5,2,7
129,ARI,P010387,P012717,3.2,-1,8,9
129,ARI,P010387,P012722,1.3,-6,0,6
129,ARI,P010387,P012760,3.283,-6,5,11
129,ARI,P010387,P012792,6.7,-7,13,20
129,ARI,P012615,P012638,1.55,4,6,2
129,ARI,P012615,P012702,7.467,1,17,16
129,ARI,P012615,P012708,5.083,4,12,8
129,ARI,P012615,P012716,1.65,7,9,2
129,ARI,P012615,P012717,1.617,4,6,2
129,ARI,P012615,P012722,1.3,-6,0,6
129,ARI,P012615,P012760,3.467,6,10,4
129,ARI,P012615,P012792,8.717,4,24,20
129,ARI,P012638,P012717,1.55,4,6,2
129,ARI,P012638,P012792,1.55,4,6,2
129,ARI,P012702,P012708,10.1,1,16,15
129,ARI,P012702,P012716,6.367,3,11,8
129,ARI,P012702,P012717,6.667,-1,7,8
129,ARI,P012702,P012792,4.317,-1,8,9
129,ARI,P012708,P012716,20.016,21,50,29
129,ARI,P012708,P012717,21.033,18,49,31
129,ARI,P012708,P012722,4.966,6,13,7
129,ARI,P012708,P012760,11.05,15,32,17
129,ARI,P012708,P012792,2.683,3,5,2
129,ARI,P012716,P012717,24.399,14,55,41
129,ARI,P012716,P012722,6.899,5,16,11
129,ARI,P012716,P012760,12.633,10,34,24
129,ARI,P012716,P012792,7.549,8,19,11
129,ARI,P012717,P012722,6.899,5,16,11
129,ARI,P012717,P012760,12.633,10,34,24
129,ARI,P012717,P012792,8.299,8,19,11
129,ARI,P012722,P012792,3.816,-5,5,10
129,ARI,P012760,P012792,5.7,7,15,8
129,WRO,P003034,P009896,11.699,-3,23,26
129,WRO,P003034,P011278,7.083,-5,12,17
129,WRO,P003034,P011900,10.582,6,19,13
129,WRO,P003034,P011901,11.266,7,26,19
129,WRO,P003034,P012601,8.016,-4,11,15
129,WRO,P003034,P012699,10.733,-8,16,24
129,WRO,P003034,P012749,13.149,-1,25,26
129,WRO,P009896,P011278,7.816,-15,11,26
129,WRO,P009896,P011900,21.565,-10,37,47
129,WRO,P009896,P011901,18.849,-11,31,42
129,WRO,P009896,P012601,20.149,-19,31,50
129,WRO,P009896,P012699,22.799,-33,35,68
129,WRO,P009896,P012749,21.115,-17,40,57
129,WRO,P011278,P011900,11.549,-5,22,27
129,WRO,P011278,P011901,3.833,-1,8,9
129,WRO,P011278,P012601,2.567,4,9,5
129,WRO,P011278,P012699,14.583,-10,28,38
129,WRO,P011278,P012749,15.033,-8,30,38
129,WRO,P011900,P011901,10.233,0,16,16
129,WRO,P011900,P012601,15.3,-4,25,29
129,WRO,P011900,P012699,19.116,-12,31,43
129,WRO,P011900,P012749,20.915,1,42,41
129,WRO,P011901,P012601,15.233,-16,21,37
129,WRO,P011901,P012699,16.766,-19,27,46
129,WRO,P011901,P012749,12.216,0,27,27
129,WRO,P012601,P012699,19.783,-14,35,49
129,WRO,P012601,P012749,14.616,-7,28,35
129,WRO,P012699,P012749,23.416,-16,44,60
130,BUD,P002740,P004945,5.6,8,16,8
130,BUD,P002740,P005637,6.517,-13,5,18
130,BUD,P002740,P006566,11.9,-9,15,24
130,BUD,P002740,P007398,2.55,-3,2,5
130,BUD,P002740,P008325,3.8,2,7,5
130,BUD,P002740,P010248,11.167,-13,13,26
130,BUD,P002740,P011281,10.267,-5,15,20
130,BUD,P002740,P012606,8.067,-11,7,18
130,BUD,P004945,P005637,6.167,2,9,7
130,BUD,P004945,P006566,10.383,2,28,26
130,BUD,P004945,P007398,9.316,3,23,20
130,BUD,P004945,P008325,8.683,3,24,21
130,BUD,P004945,P010248,8.55,3,19,16
130,BUD,P004945,P011281,11.133,0,29,29
130,BUD,P004945,P012606,9.1,3,24,21
130,BUD,P005637,P006566,10.984,-2,17,19
130,BUD,P005637,P007398,8.7,-2,9,11
130,BUD,P005637,P008325,9.384,3,16,13
130,BUD,P005637,P010248,10.067,-13,10,23
130,BUD,P005637,P011281,7.667,-5,12,17
130,BUD,P005637,P012606,18.318,-10,26,36
130,BUD,P006566,P007398,17.884,4,37,33
130,BUD,P006566,P008325,14.867,0,29,29
130,BUD,P006566,P010248,15.984,4,33,29
130,BUD,P006566,P011281,20.101,13,48,35
130,BUD,P006566,P012606,21.301,4,41,37
130,BUD,P007398,P008325,16.6,4,35,31
130,BUD,P007398,P010248,5.9,-1,10,11
130,BUD,P007398,P011281,12.883,1,29,28
130,BUD,P007398,P012606,16.167,6,35,29
130,BUD,P008325,P011281,9.717,-3,23,26
130,BUD,P008325,P012606,17.617,7,42,35
130,BUD,P010248,P011281,15.967,5,33,28
130,BUD,P010248,P012606,11.701,-9,14,23
130,BUD,P011281,P012606,15.001,2,35,33
130,CLU,P004862,P005113,14.1,12,39,27
130,CLU,P004862,P005373,10.232,-5,14,19
130,CLU,P004862,P005714,10.333,2,24,22
130,CLU,P004862,P010569,7.216,-4,9,13
130,CLU,P004862,P011797,18.815,8,44,36
130,CLU,P004862,P011801,13.032,5,29,24
130,CLU,P004862,P012621,17.099,11,44,33
130,CLU,P004862,P012698,6.833,-1,9,10
130,CLU,P005113,P005714,13.316,0,26,26
130,CLU,P005113,P010569,5.867,-2,9,11
130,CLU,P005113,P010997,2.2,1,3,2
130,CLU,P005113,P011797,21.849,14,52,38
130,CLU,P005113,P011801,15.249,6,36,30
130,CLU,P005113,P012620,2.133,-1,5,6
130,CLU,P005113,P012621,21.816,12,54,42
130,CLU,P005113,P012698,0.666,2,4,2
130,CLU,P005373,P005714,1.2,-3,3,6
130,CLU,P005373,P010569,12.082,-1,17,18
130,CLU,P005373,P011797,5.366,-6,5,11
130,CLU,P005373,P011801,13.082,-1,19,20
130,CLU,P005373,P012620,3.283,1,6,5
130,CLU,P005373,P012621,4.816,-1,7,8
130,CLU,P005373,P012698,11.599,0,17,17
130,CLU,P005714,P011797,12.666,-7,24,31
130,CLU,P005714,P011801,4.549,-10,5,15
130,CLU,P005714,P012620,2.216,-3,5,8
130,CLU,P005714,P012621,14.433,-4,29,33
130,CLU,P005714,P012698,0.483,-7,0,7
130,CLU,P010569,P010997,2.2,1,3,2
130,CLU,P010569,P011797,7.583,-3,9,12
130,CLU,P010569,P011801,16.816,-3,26,29
130,CLU,P010569,P012620,3.283,1,6,5
130,CLU,P010569,P012621,6.7,-3,8,11
130,CLU,P010569,P012698,10.049,2,17,15
130,CLU,P010997,P011797,2.2,1,3,2
130,CLU,P010997,P011801,2.2,1,3,2
130,CLU,P011797,P011801,16.115,1,33,32
130,CLU,P011797,P012620,0.083,-2,0,2
130,CLU,P011797,P012621,22.899,11,54,43
130,CLU,P011797,P012698,2.416,-5,4,9
130,CLU,P011801,P012620,5.499,-2,11,13
130,CLU,P011801,P012621,15.449,6,37,31
130,CLU,P011801,P012698,12.465,-3,21,24
130,CLU,P012620,P012621,2.133,-1,5,6
130,CLU,P012620,P012698,3.366,-1,6,7
130,CLU,P012621,P012698,1.983,1,6,5
131,PMT,P001686,P002020,7.5,-3,12,15
131,PMT,P001686,P002691,1.017,0,2,2
131,PMT,P001686,P005301,2.383,-1,4,5
131,PMT,P001686,P011823,20.299,-14,36,50
131,PMT,P001686,P011942,10.299,4,22,18
131,PMT,P001686,P011943,19.933,-19,31,50
131,PMT,P001686,P011944,14.65,-15,24,39
131,PMT,P001686,P011947,13.549,-3,24,27
131,PMT,P001686,P011966,10.166,0,20,20
131,PMT,P001686,P012600,11.4,-17,17,34
131,PMT,P002020,P002691,1.834,0,2,2
131,PMT,P002020,P005301,6.567,1,10,9
131,PMT,P002020,P011942,6.033,-1,8,9
131,PMT,P002020,P011943,11.867,0,18,18
131,PMT,P002020,P011944,5.533,-3,10,13
131,PMT,P002020,P011947,2.967,0,2,2
131,PMT,P002020,P011966,8.067,1,15,14
131,PMT,P002020,P012600,1.5,1,3,2
131,PMT,P002691,P005301,2.967,-3,3,6
131,PMT,P002691,P011823,2.15,-3,3,6
131,PMT,P002691,P011942,0.633,-2,0,2
131,PMT,P002691,P011943,2.467,-2,2,4
131,PMT,P002691,P011947,3.351,-1,5,6
131,PMT,P002691,P011966,1.517,-1,3,4
131,PMT,P005301,P011823,8.016,-6,18,24
131,PMT,P005301,P011942,6.933,2,12,10
131,PMT,P005301,P011943,6.75,0,10,10
131,PMT,P005301,P011944,5.466,-4,15,19
131,PMT,P005301,P011947,4.617,-3,9,12
131,PMT,P005301,P011966,10.417,-1,20,21
131,PMT,P005301,P012600,4.216,-5,11,16
131,PMT,P011823,P011942,9.916,7,24,17
131,PMT,P011823,P011943,14.816,-19,23,42
131,PMT,P011823,P011944,13.883,-15,27,42
131,PMT,P011823,P011947,14.799,-6,31,37
131,PMT,P011823,P011966,10.133,-1,21,22
131,PMT,P011823,P012600,14.116,-23,25,48
131,PMT,P011942,P011943,9.183,3,17,14
131,PMT,P011942,P011944,2.6,-2,4,6
131,PMT,P011942,P011947,8.366,7,20,13
131,PMT,P011942,P011966,9.833,6,21,15
131,PMT,P011943,P011944,13.383,-13,22,35
131,PMT,P011943,P011947,8.483,-6,11,17
131,PMT,P011943,P011966,8.167,-1,13,14
131,PMT,P011943,P012600,11.683,-19,17,36
131,PMT,P011944,P011947,3.566,-3,8,11
131,PMT,P011944,P011966,6.45,-5,12,17
131,PMT,P011944,P012600,12.133,-12,26,38
131,PMT,P011947,P011966,6.0,3,14,11
131,PMT,P011947,P012600,5.366,-12,8,20
131,PMT,P011966,P012600,2.05,-1,5,6
131,PRS,P003481,P009556,9.217,3,16,13
131,PRS,P003481,P011232,9.217,3,16,13
131,PRS,P003481,P012609,9.217,3,16,13
131,PRS,P003481,P012640,9.217,3,16,13
131,PRS,P004512,P005793,8.116,5,26,21
131,PRS,P004512,P011232,1.4,3,6,3
131,PRS,P004512,P011887,5.033,-4,8,12
131,PRS,P004512,P012608,16.266,11,48,37
131,PRS,P004512,P012609,8.283,9,28,19
131,PRS,P004512,P012610,16.216,9,46,37
131,PRS,P004512,P012613,8.15,6,22,16
131,PRS,P004512,P012640,1.6,5,8,3
131,PRS,P005793,P009556,1.55,0,0,0
131,PRS,P005793,P011232,1.8,4,4,0
131,PRS,P005793,P011887,2.533,-3,4,7
131,PRS,P005793,P012608,11.183,0,31,31
131,PRS,P005793,P012609,6.467,6,20,14
131,PRS,P005793,P012610,11.133,-2,29,31
131,PRS,P005793,P012612,2.834,-5,5,10
131,PRS,P005793,P012640,4.384,-5,5,10
131,PRS,P009556,P011232,15.734,10,30,20
131,PRS,P009556,P011887,2.95,3,8,5
131,PRS,P009556,P012609,12.784,7,22,15
131,PRS,P009556,P012612,2.95,3,8,5
131,PRS,P009556,P012613,2.017,4,6,2
131,PRS,P009556,P012640,15.734,10,30,20
131,PRS,P011232,P011887,2.95,3,8,5
131,PRS,P011232,P012608,1.4,3,6,3
131,PRS,P011232,P012609,13.618,9,26,17
131,PRS,P011232,P012610,1.35,1,4,3
131,PRS,P011232,P012612,3.734,3,10,7
131,PRS,P011232,P012613,3.951,3,10,7
131,PRS,P011232,P012640,16.518,10,32,22
131,PRS,P011887,P012608,5.033,-4,8,12
131,PRS,P011887,P012610,5.033,-4,8,12
131,PRS,P011887,P012612,2.95,3,8,5
131,PRS,P011887,P012613,2.5,-1,4,5
131,PRS,P011887,P012640,2.95,3,8,5
131,PRS,P012608,P012609,8.283,9,28,19
131,PRS,P012608,P012610,23.433,9,59,50
131,PRS,P012608,P012612,7.217,0,13,13
131,PRS,P012608,P012613,12.3,11,30,19
131,PRS,P012608,P012640,8.817,5,21,16
131,PRS,P012609,P012610,8.233,7,26,19
131,PRS,P012609,P012612,0.784,0,2,2
131,PRS,P012609,P012613,6.167,7,16,9
131,PRS,P012609,P012640,13.568,7,24,17
131,PRS,P012610,P012612,7.217,0,13,13
131,PRS,P012610,P012613,12.3,11,30,19
131,PRS,P012610,P012640,8.817,5,21,16
131,PRS,P012612,P012613,5.167,5,10,5
131,PRS,P012612,P012640,10.951,3,23,20
131,PRS,P012613,P012640,8.784,14,24,10
132,HTA,P003533,P004846,3.783,-4,7,11
132,HTA,P003533,P007759,4.783,-3,10,13
132,HTA,P003533,P007867,10.75,-7,18,25
132,HTA,P003533,P010550,4.783,-3,10,13
132,HTA,P003533,P011973,5.967,-4,8,12
132,HTA,P003533,P011990,6.967,-3,11,14
132,HTA,P003533,P012794,5.967,-4,8,12
132,HTA,P004267,P004846,8.533,-6,29,35
132,HTA,P004267,P007759,8.533,-6,29,35
132,HTA,P004267,P007867,0.65,0,2,2
132,HTA,P004267,P010550,3.183,-6,10,16
132,HTA,P004267,P011973,8.533,-6,29,35
132,HTA,P004267,P012794,4.7,0,17,17
132,HTA,P004846,P007759,24.449,-5,64,69
132,HTA,P004846,P007867,4.666,-4,9,13
132,HTA,P004846,P010550,23.149,5,61,56
132,HTA,P004846,P011973,26.616,7,77,70
132,HTA,P004846,P011990,4.4,10,16,6
132,HTA,P004846,P012794,22.2,13,65,52
132,HTA,P007759,P007867,7.849,-4,15,19
132,HTA,P007759,P010550,23.232,-6,53,59
132,HTA,P007759,P011973,23.799,-3,62,65
132,HTA,P007759,P011990,2.3,0,5,5
132,HTA,P007759,P012794,19.383,3,50,47
132,HTA,P007867,P010550,8.599,-8,13,21
132,HTA,P007867,P011973,10.433,-9,13,22
132,HTA,P007867,P011990,8.367,-7,11,18
132,HTA,P007867,P012794,9.55,-9,11,20
132,HTA,P010550,P011973,23.899,3,59,56
132,HTA,P010550,P011990,7.75,6,21,15
132,HTA,P010550,P012794,20.133,9,49,40
132,HTA,P011973,P011990,10.817,3,22,19
132,HTA,P011973,P012794,30.8,5,74,69
132,HTA,P011990,P012794,10.467,3,22,19
132,LLI,P004773,P006600,11.334,-4,27,31
132,LLI,P004773,P009649,12.234,8,32,24
132,LLI,P004773,P009680,10.634,-5,24,29
132,LLI,P004773,P012020,13.367,7,32,25
132,LLI,P004773,P012584,3.367,2,10,8
132,LLI,P004773,P012585,12.467,-5,27,32
132,LLI,P004773,P012586,17.617,6,41,35
132,LLI,P004773,P012797,17.784,3,43,40
132,LLI,P006600,P009649,17.118,0,45,45
132,LLI,P006600,P009680,21.601,5,58,53
132,LLI,P006600,P012584,0.65,-3,2,5
132,LLI,P006600,P012585,24.818,-2,64,66
132,LLI,P006600,P012586,19.251,-1,45,46
132,LLI,P006600,P012797,11.768,-7,31,38
132,LLI,P009649,P009680,12.651,9,36,27
132,LLI,P009649,P012020,10.417,9,28,19
132,LLI,P009649,P012584,2.717,5,8,3
132,LLI,P009649,P012585,15.301,1,41,40
132,LLI,P009649,P012586,25.551,9,66,57
132,LLI,P009649,P012797,14.151,-5,36,41
132,LLI,P009680,P012020,1.117,-2,1,3
132,LLI,P009680,P012584,0.65,-3,2,5
132,LLI,P009680,P012585,22.151,2,58,56
132,LLI,P009680,P012586,14.217,7,35,28
132,LLI,P009680,P012797,7.851,-1,22,23
132,LLI,P012020,P012584,2.717,5,8,3
132,LLI,P012020,P012585,2.95,-2,4,6
132,LLI,P012020,P012586,12.25,9,31,22
132,LLI,P012020,P012797,10.65,2,24,22
132,LLI,P012584,P012585,0.65,-3,2,5
132,LLI,P012584,P012586,2.717,5,8,3
132,LLI,P012585,P012586,19.834,1,45,44
132,LLI,P012585,P012797,12.901,-8,31,39
132,LLI,P012586,P012797,14.567,-4,33,37
133,HAM,P001990,P009663,8.734,2,23,21
133,HAM,P001990,P010070,6.45,2,14,12
133,HAM,P001990,P012579,2.05,-2,4,6
133,HAM,P001990,P012580,4.45,3,12,9
133,HAM,P001990,P012581,7.5,-1,19,20
133,HAM,P001990,P012582,4.067,1,13,12
133,HAM,P001990,P012648,8.817,7,23,16
133,HAM,P009663,P010070,5.534,-1,10,11
133,HAM,P009663,P011168,17.568,-10,34,44
133,HAM,P009663,P012579,7.801,-13,12,25
133,HAM,P009663,P012580,14.8,-8,28,36
133,HAM,P009663,P012581,20.201,-8,50,58
133,HAM,P009663,P012582,22.001,-11,52,63
133,HAM,P009663,P012648,15.151,6,38,32
133,HAM,P009663,P012695,2.25,1,7,6
133,HAM,P009663,P012696,1.3,2,2,0
133,HAM,P010070,P011168,3.217,-2,7,9
133,HAM,P010070,P012579,4.217,-2,7,9
133,HAM,P010070,P012580,4.45,3,12,9
133,HAM,P010070,P012581,5.783,-2,13,15
133,HAM,P010070,P012648,9.017,2,21,19
133,HAM,P011168,P012579,15.435,-5,30,35
133,HAM,P011168,P012580,18.001,-2,33,35
133,HAM,P011168,P012581,22.085,-3,52,55
133,HAM,P011168,P012582,18.668,-5,39,44
133,HAM,P011168,P012648,7.767,-1,19,20
133,HAM,P011168,P012696,5.067,0,10,10
133,HAM,P012579,P012580,10.867,-2,19,21
133,HAM,P012579,P012581,13.117,-6,30,36
133,HAM,P012579,P012582,8.484,-8,17,25
133,HAM,P012579,P012648,4.034,-2,7,9
133,HAM,P012579,P012696,5.067,0,10,10
133,HAM,P012580,P012581,16.667,-4,33,37
133,HAM,P012580,P012582,14.1,-7,25,32
133,HAM,P012580,P012648,5.183,3,14,11
133,HAM,P012580,P012695,0.883,-2,2,4
133,HAM,P012580,P012696,5.067,0,10,10
133,HAM,P012581,P012582,21.818,0,55,55
133,HAM,P012581,P012648,13.034,7,39,32
133,HAM,P012581,P012695,1.5,3,5,2
133,HAM,P012581,P012696,3.767,-2,8,10
133,HAM,P012582,P012648,9.684,5,28,23
133,HAM,P012582,P012695,2.25,1,7,6
133,HAM,P012648,P012695,2.117,1,7,6
133,JOV,P002507,P006771,11.883,10,34,24
133,JOV,P002507,P010161,10.05,-1,26,27
133,JOV,P002507,P010458,10.35,6,30,24
133,JOV,P002507,P010709,1.133,1,4,3
133,JOV,P002507,P011247,13.416,8,40,32
133,JOV,P002507,P011248,19.5,10,56,46
133,JOV,P002507,P012349,10.15,-4,23,27
133,JOV,P002507,P012780,1.433,7,7,0
133,JOV,P002507,PJUG,9.817,-1,20,21
133,JOV,P006771,P010161,0.133,0,0,0
133,JOV,P006771,P010458,21.883,2,52,50
133,JOV,P006771,P010709,5.2,1,13,12
133,JOV,P006771,P011247,14.85,13,43,30
133,JOV,P006771,P011248,19.616,10,50,40
133,JOV,P006771,P012349,1.367,2,4,2
133,JOV,P006771,P012780,14.366,8,36,28
133,JOV,P006771,PJUG,9.966,-2,20,22
133,JOV,P010161,P010458,4.367,5,14,9
133,JOV,P010161,P010709,1.133,1,4,3
133,JOV,P010161,P011247,10.866,-7,19,26
133,JOV,P010161,P011248,12.3,-4,29,33
133,JOV,P010161,P012349,10.233,-10,19,29
133,JOV,P010161,P012780,4.683,-4,7,11
133,JOV,P010161,PJUG,5.167,0,14,14
133,JOV,P010458,P010709,5.2,1,13,12
133,JOV,P010458,P011247,14.317,3,34,31
133,JOV,P010458,P011248,21.633,6,53,47
133,JOV,P010458,P012780,16.483,1,36,35
133,JOV,P010458,PJUG,13.099,4,32,28
133,JOV,P010709,P011247,6.333,2,17,15
133,JOV,P010709,P012349,1.133,1,4,3
133,JOV,P010709,P012780,5.2,1,13,12
133,JOV,P011247,P011248,18.533,6,45,39
133,JOV,P011247,P012349,10.283,-4,21,25
133,JOV,P011247,P012780,14.183,5,29,24
133,JOV,P011247,PJUG,1.883,-2,0,2
133,JOV,P011248,P012349,9.167,-7,19,26
133,JOV,P011248,P012780,14.299,3,30,27
133,JOV,P011248,PJUG,14.416,0,34,34
133,JOV,P012349,P012780,1.45,-4,0,4
133,JOV,P012349,PJUG,2.617,-6,2,8
133,JOV,P012780,PJUG,5.899,-1,14,15
134,BES,P005348,P007914,0.75,-2,0,2
134,BES,P005348,P008945,0.917,-2,0,2
134,BES,P005348,P011379,0.917,-2,0,2
134,BES,P005348,P011924,1.867,-8,0,8
134,BES,P005348,P012622,1.284,-6,0,6
134,BES,P005348,P012647,1.284,-6,0,6
134,BES,P005348,P012711,1.117,-6,0,6
134,BES,P007914,P008945,21.267,0,56,56
134,BES,P007914,P011357,7.167,3,20,17
134,BES,P007914,P011379,1.767,-6,1,7
134,BES,P007914,P011924,18.518,1,45,44
134,BES,P007914,P011936,13.017,4,34,30
134,BES,P007914,P012622,15.2,12,43,31
134,BES,P007914,P012647,18.084,0,46,46
134,BES,P007914,P012711,11.634,-12,27,39
134,BES,P008945,P011357,4.15,6,14,8
134,BES,P008945,P011379,14.45,-9,18,27
134,BES,P008945,P011924,14.367,0,35,35
134,BES,P008945,P011936,23.149,1,47,46
134,BES,P008945,P012622,30.65,8,66,58
134,BES,P008945,P012647,31.9,-7,65,72
134,BES,P008945,P012711,9.75,-13,23,36
134,BES,P011357,P011924,7.167,3,20,17
134,BES,P011357,P011936,3.017,-3,6,9
134,BES,P011357,P012622,4.15,6,14,8
134,BES,P011357,P012711,3.017,-3,6,9
134,BES,P011379,P011924,2.45,-6,3,9
134,BES,P011379,P011936,12.9,-3,17,20
134,BES,P011379,P012622,11.817,-3,15,18
134,BES,P011379,P012647,13.767,-7,18,25
134,BES,P011924,P011936,7.7,-1,19,20
134,BES,P011924,P012622,10.601,4,27,23
134,BES,P011924,P012647,12.951,-6,28,34
134,BES,P011924,P012711,11.251,-11,23,34
134,BES,P011936,P012622,20.866,4,42,38
134,BES,P011936,P012647,25.833,5,54,49
134,BES,P011936,P012711,11.05,-3,29,32
134,BES,P012622,P012647,27.95,-4,55,59
134,BES,P012622,P012711,7.15,-13,14,27
134,BES,P012647,P012711,13.167,-15,30,45
134,VNC,P000968,P003759,0.617,3,3,0
134,VNC,P000968,P008052,10.034,9,30,21
134,VNC,P000968,P009400,10.034,9,30,21
134,VNC,P000968,P011928,0.3,-3,0,3
134,VNC,P000968,P012587,7.617,12,23,11
134,VNC,P000968,P012591,2.417,-3,7,10
134,VNC,P000968,P012796,9.117,9,27,18
134,VNC,P003759,P004381,17.65,-9,23,32
134,VNC,P003759,P008052,7.417,-2,13,15
134,VNC,P003759,P009400,3.301,-3,6,9
134,VNC,P003759,P011909,14.966,-3,20,23
134,VNC,P003759,P011928,10.85,-4,13,17
134,VNC,P003759,P012587,2.034,0,6,6
134,VNC,P003759,P012591,16.233,-6,20,26
134,VNC,P004381,P008052,20.816,6,55,49
134,VNC,P004381,P009400,6.567,-5,11,16
134,VNC,P004381,P011909,29.765,8,69,61
134,VNC,P004381,P011928,17.166,-8,28,36
134,VNC,P004381,P012587,3.15,-7,6,13
134,VNC,P004381,P012591,30.749,6,68,62
134,VNC,P004381,P012796,12.733,13,44,31
134,VNC,P008052,P009400,14.718,7,39,32
134,VNC,P008052,P011909,17.516,10,48,38
134,VNC,P008052,P011928,3.633,-6,7,13
134,VNC,P008052,P012587,10.767,5,29,24
134,VNC,P008052,P012591,19.65,8,54,46
134,VNC,P008052,P012796,20.117,23,65,42
134,VNC,P009400,P011909,2.0,2,4,2
134,VNC,P009400,P011928,4.15,-8,5,13
134,VNC,P009400,P012587,9.034,9,26,17
134,VNC,P009400,P012591,7.134,-7,13,20
134,VNC,P009400,P012796,10.734,12,30,18
134,VNC,P011909,P011928,14.249,-3,25,28
134,VNC,P011909,P012587,1.733,-4,3,7
134,VNC,P011909,P012591,27.599,10,64,54
134,VNC,P011909,P012796,12.5,12,43,31
134,VNC,P011928,P012591,17.466,-11,28,39
134,VNC,P011928,P012796,2.05,-1,6,7
134,VNC,P012587,P012796,8.733,5,23,18
134,VNC,P012591,P012796,12.684,15,46,31
135,LJU,P001235,P003514,4.367,3,8,5
135,LJU,P001235,P005969,11.65,3,30,27
135,LJU,P001235,P007066,0.533,-2,0,2
135,LJU,P001235,P009392,9.717,-1,25,26
135,LJU,P001235,P009395,14.667,8,38,30
135,LJU,P001235,P010594,5.483,7,13,6
135,LJU,P001235,P011261,7.4,3,18,15
135,LJU,P001235,P012700,6.983,3,20,17
135,LJU,P002561,P003452,2.716,-6,3,9
135,LJU,P002561,P003514,7.466,-3,15,18
135,LJU,P002561,P007066,7.466,-3,15,18
135,LJU,P002561,P009392,8.199,-7,15,22
135,LJU,P002561,P009395,0.733,-4,0,4
135,LJU,P002561,P011261,5.483,-1,12,13
135,LJU,P002561,P012700,0.733,-4,0,4
135,LJU,P003452,P003514,1.983,-2,3,5
135,LJU,P003452,P005969,10.317,2,23,21
135,LJU,P003452,P007066,4.75,1,13,12
135,LJU,P003452,P009392,3.516,-2,7,9
135,LJU,P003452,P009395,8.283,-5,13,18
135,LJU,P003452,P010594,9.517,-2,19,21
135,LJU,P003452,P012700,11.05,-2,23,25
135,LJU,P003514,P005969,5.2,-1,9,10
135,LJU,P003514,P007066,11.199,-6,20,26
135,LJU,P003514,P009392,13.766,-5,28,33
135,LJU,P003514,P009395,5.017,5,12,7
135,LJU,P003514,P010594,2.45,4,4,0
135,LJU,P003514,P011261,13.416,1,29,28
135,LJU,P005969,P007066,8.933,-4,19,23
135,LJU,P005969,P009392,12.983,3,34,31
135,LJU,P005969,P009395,19.317,6,47,41
135,LJU,P005969,P010594,15.267,-1,32,33
135,LJU,P005969,P011261,10.133,-3,23,26
135,LJU,P005969,P012700,19.2,3,47,44
135,LJU,P007066,P009392,11.732,-8,20,28
135,LJU,P007066,P010594,4.667,1,14,13
135,LJU,P007066,P011261,11.649,-8,21,29
135,LJU,P007066,P012700,4.667,1,14,13
135,LJU,P009392,P009395,11.367,3,33,30
135,LJU,P009392,P011261,15.633,-3,35,38
135,LJU,P009392,P012700,5.483,0,15,15
135,LJU,P009395,P010594,12.233,2,22,20
135,LJU,P009395,P011261,7.517,7,22,15
135,LJU,P009395,P012700,15.266,-2,33,35
135,LJU,P010594,P011261,3.533,2,8,6
135,LJU,P010594,P012700,14.45,-1,32,33
135,LJU,P011261,P012700,1.9,-2,4,6
135,WOL,P002387,P003212,5.568,0,13,13
135,WOL,P002387,P004645,0.017,0,0,0
135,WOL,P002387,P005516,16.566,1,37,36
135,WOL,P002387,P006154,0.517,2,2,0
135,WOL,P002387,P006546,23.234,-5,51,56
135,WOL,P002387,P011150,22.267,-5,49,54
135,WOL,P002387,P012576,21.234,-3,45,48
135,WOL,P002387,P012577,3.184,-4,7,11
135,WOL,P002387,P012789,2.417,2,8,6
135,WOL,P003212,P004645,0.017,0,0,0
135,WOL,P003212,P006154,9.951,-2,19,21
135,WOL,P003212,P006546,10.335,-1,22,23
135,WOL,P003212,P006907,4.817,-1,10,11
135,WOL,P003212,P011150,9.717,4,27,23
135,WOL,P003212,P012576,7.801,1,16,15
135,WOL,P003212,P012577,14.068,3,32,29
135,WOL,P003212,P012789,10.334,0,25,25
135,WOL,P004645,P005516,3.666,4,10,6
135,WOL,P004645,P006546,2.0,2,5,3
135,WOL,P004645,P006907,1.683,2,5,3
135,WOL,P004645,P011150,3.683,4,10,6
135,WOL,P004645,P012577,3.666,4,10,6
135,WOL,P005516,P006546,18.549,3,42,39
135,WOL,P005516,P006907,1.683,2,5,3
135,WOL,P005516,P011150,20.232,5,47,42
135,WOL,P005516,P012576,16.483,3,37,34
135,WOL,P005516,P012577,3.749,2,10,8
135,WOL,P006154,P006546,2.134,-4,0,4
135,WOL,P006154,P006907,4.817,-1,10,11
135,WOL,P006154,P011150,2.483,1,7,6
135,WOL,P006154,P012576,1.517,-2,0,2
135,WOL,P006154,P012577,9.951,-2,19,21
135,WOL,P006154,P012789,8.434,0,19,19
135,WOL,P006546,P011150,27.4,2,65,63
135,WOL,P006546,P012576,25.901,0,56,56
135,WOL,P006546,P012577,9.934,-3,21,24
135,WOL,P006546,P012789,2.517,-2,6,8
135,WOL,P006907,P011150,1.683,2,5,3
135,WOL,P006907,P012577,6.5,1,15,14
135,WOL,P006907,P012789,4.817,-1,10,11
135,WOL,P011150,P012576,23.417,2,54,52
135,WOL,P011150,P012577,10.999,4,31,27
135,WOL,P011150,P012789,4.383,1,13,12
135,WOL,P012576,P012577,7.251,-1,16,17
135,WOL,P012577,P012789,8.434,0,19,19
136,BOU,P000498,P004525,14.199,7,27,20
136,BOU,P000498,P010431,11.466,6,24,18
136,BOU,P000498,P010450,9.965,1,16,15
136,BOU,P000498,P010718,10.733,2,20,18
136,BOU,P000498,P011161,8.266,-3,12,15
136,BOU,P000498,P011836,4.567,-4,9,13
136,BOU,P000498,P011837,4.699,5,8,3
136,BOU,P000498,P012618,15.033,-2,28,30
136,BOU,P004525,P010431,11.3,-1,26,27
136,BOU,P004525,P010450,10.632,9,23,14
136,BOU,P004525,P010718,11.967,-2,27,29
136,BOU,P004525,P011161,11.716,9,26,17
136,BOU,P004525,P011836,1.584,4,9,5
136,BOU,P004525,P011837,7.449,1,14,13
136,BOU,P004525,P012617,7.117,1,17,16
136,BOU,P004525,P012618,12.7,4,23,19
136,BOU,P010431,P010450,3.132,2,7,5
136,BOU,P010431,P010718,22.201,-8,43,51
136,BOU,P010431,P011161,0.85,0,4,4
136,BOU,P010431,P011836,14.018,0,31,31
136,BOU,P010431,P011837,13.883,-8,19,27
136,BOU,P010431,P012617,12.001,-11,20,31
136,BOU,P010431,P012618,8.417,0,18,18
136,BOU,P010450,P010718,1.399,-1,2,3
136,BOU,P010450,P011161,14.166,-1,25,26
136,BOU,P010450,P011836,5.267,-7,7,14
136,BOU,P010450,P011837,4.333,0,8,8
136,BOU,P010450,P012617,6.467,2,12,10
136,BOU,P010450,P012618,12.099,3,20,17
136,BOU,P010718,P011161,3.183,1,7,6
136,BOU,P010718,P011836,13.185,-1,28,29
136,BOU,P010718,P011837,14.5,-6,21,27
136,BOU,P010718,P012617,12.951,-9,22,31
136,BOU,P010718,P012618,8.017,-4,14,18
136,BOU,P011161,P011836,4.851,-7,6,13
136,BOU,P011161,P011837,4.95,2,10,8
136,BOU,P011161,P012617,7.417,4,14,10
136,BOU,P011161,P012618,10.733,-1,16,17
136,BOU,P011836,P011837,11.384,-7,15,22
136,BOU,P011836,P012617,13.468,-5,24,29
136,BOU,P011836,P012618,5.484,-5,11,16
136,BOU,P011837,P012617,14.134,-11,21,32
136,BOU,P012617,P012618,4.117,1,6,5
136,BUD,P002740,P004945,16.367,6,33,27
136,BUD,P002740,P005637,14.2,11,33,22
136,BUD,P002740,P006566,0.533,2,2,0
136,BUD,P002740,P008325,4.033,-4,5,9
136,BUD,P002740,P010248,16.9,8,35,27
136,BUD,P002740,P011281,14.783,11,33,22
136,BUD,P002740,P011935,6.15,-7,7,14
136,BUD,P002740,P012606,6.15,-7,7,14
136,BUD,P002740,P012630,4.616,-4,5,9
136,BUD,P004945,P005637,17.251,4,39,35
136,BUD,P004945,P007398,3.617,-2,5,7
136,BUD,P004945,P008325,2.85,0,8,8
136,BUD,P004945,P010248,19.984,4,38,34
136,BUD,P004945,P011281,20.067,2,45,43
136,BUD,P004945,P011935,8.2,-4,19,23
136,BUD,P004945,P012606,8.917,-2,21,23
136,BUD,P004945,P012630,0.683,0,0,0
136,BUD,P005637,P006566,0.533,2,2,0
136,BUD,P005637,P007398,4.317,-4,6,10
136,BUD,P005637,P008325,0.9,-2,2,4
136,BUD,P005637,P010248,17.617,9,37,28
136,BUD,P005637,P011281,17.067,4,39,35
136,BUD,P005637,P011935,1.55,-2,6,8
136,BUD,P005637,P012606,4.55,-1,12,13
136,BUD,P005637,P012630,2.283,-1,4,5
136,BUD,P006566,P010248,0.533,2,2,0
136,BUD,P006566,P011281,0.533,2,2,0
136,BUD,P007398,P008325,1.95,-3,2,5
136,BUD,P007398,P010248,9.7,5,20,15
136,BUD,P007398,P011281,1.7,-5,0,5
136,BUD,P007398,P011935,6.95,6,16,10
136,BUD,P007398,P012606,10.333,7,22,15
136,BUD,P007398,P012630,8.033,4,17,13
136,BUD,P008325,P011281,4.867,-1,9,10
136,BUD,P008325,P011935,9.95,-6,14,20
136,BUD,P008325,P012606,10.85,-8,16,24
136,BUD,P008325,P012630,8.0,-8,8,16
136,BUD,P010248,P011281,17.383,7,34,27
136,BUD,P010248,P011935,8.917,5,19,14
136,BUD,P010248,P012606,11.4,8,23,15
136,BUD,P010248,P012630,7.566,8,16,8
136,BUD,P011281,P011935,7.417,-2,16,18
136,BUD,P011281,P012606,7.8,-2,16,18
136,BUD,P011281,P012630,3.983,0,2,2
136,BUD,P011935,P012606,20.517,-3,39,42
136,BUD,P011935,P012630,12.417,1,20,19
136,BUD,P012606,P012630,15.083,0,24,24
137,ARI,P003240,P004292,10.816,-5,18,23
137,ARI,P003240,P012615,6.9,-10,2,12
137,ARI,P003240,P012702,13.7,0,24,24
137,ARI,P003240,P012708,15.133,-7,25,32
137,ARI,P003240,P012716,10.534,-12,14,26
137,ARI,P003240,P012717,19.551,-7,39,46
137,ARI,P003240,P012722,1.9,-3,0,3
137,ARI,P003240,P012760,6.083,-10,13,23
137,ARI,P003240,P012792,11.651,-6,21,27
137,ARI,P004292,P012615,7.283,-12,6,18
137,ARI,P004292,P012702,8.633,-7,13,20
137,ARI,P004292,P012708,15.383,-16,24,40
137,ARI,P004292,P012716,3.85,-2,6,8
137,ARI,P004292,P012717,10.233,-2,22,24
137,ARI,P004292,P012722,3.1,-3,4,7
137,ARI,P004292,P012760,5.683,-4,11,15
137,ARI,P004292,P012792,4.883,-5,8,13
137,ARI,P012615,P012702,5.4,0,9,9
137,ARI,P012615,P012708,10.967,-12,13,25
137,ARI,P012615,P012716,9.4,-1,13,14
137,ARI,P012615,P012717,2.384,-2,2,4
137,ARI,P012615,P012722,3.883,-5,4,9
137,ARI,P012615,P012760,3.383,-6,2,8
137,ARI,P012615,P012792,10.6,-4,17,21
137,ARI,P012702,P012708,17.934,4,40,36
137,ARI,P012702,P012716,12.568,6,28,22
137,ARI,P012702,P012717,16.701,5,37,32
137,ARI,P012702,P012792,13.468,12,33,21
137,ARI,P012708,P012716,12.751,0,27,27
137,ARI,P012708,P012717,18.934,0,43,43
137,ARI,P012708,P012722,3.883,-5,4,9
137,ARI,P012708,P012760,6.35,-7,12,19
137,ARI,P012708,P012792,14.801,3,36,33
137,ARI,P012716,P012717,16.602,-7,34,41
137,ARI,P012716,P012722,0.783,-2,0,2
137,ARI,P012716,P012760,7.983,-8,15,23
137,ARI,P012716,P012792,20.201,2,43,41
137,ARI,P012717,P012760,8.25,-8,20,28
137,ARI,P012717,P012792,16.685,1,39,38
137,ARI,P012722,P012792,1.983,-2,4,6
137,ARI,P012760,P012792,8.8,-13,15,28
137,CLU,P004862,P005113,20.167,7,48,41
137,CLU,P004862,P005373,7.167,7,19,12
137,CLU,P004862,P005714,6.284,4,16,12
137,CLU,P004862,P010569,21.05,10,51,41
137,CLU,P004862,P011797,6.65,-1,15,16
137,CLU,P004862,P011801,13.151,2,25,23
137,CLU,P004862,P012621,21.05,10,51,41
137,CLU,P004862,P012698,13.817,17,43,26
137,CLU,P005113,P005714,2.134,-1,4,5
137,CLU,P005113,P010569,18.5,10,46,36
137,CLU,P005113,P011797,6.267,-1,15,16
137,CLU,P005113,P011801,6.834,-3,8,11
137,CLU,P005113,P012621,18.967,12,48,36
137,CLU,P005113,P012698,9.667,12,31,19
137,CLU,P005373,P005714,15.05,8,32,24
137,CLU,P005373,P010569,3.867,1,8,7
137,CLU,P005373,P011797,1.7,1,3,2
137,CLU,P005373,P011801,18.534,9,40,31
137,CLU,P005373,P012620,4.533,0,9,9
137,CLU,P005373,P012621,11.2,5,20,15
137,CLU,P005373,P012698,13.617,5,29,24
137,CLU,P005714,P010569,0.45,-2,0,2
137,CLU,P005714,P011801,17.634,5,36,31
137,CLU,P005714,P012620,4.533,0,9,9
137,CLU,P005714,P012621,8.25,4,14,10
137,CLU,P005714,P012698,16.201,2,33,31
137,CLU,P010569,P011797,7.967,0,18,18
137,CLU,P010569,P011801,8.634,-3,12,15
137,CLU,P010569,P012621,22.817,9,54,45
137,CLU,P010569,P012698,7.983,11,27,16
137,CLU,P011797,P011801,1.317,1,3,2
137,CLU,P011797,P012621,7.967,0,18,18
137,CLU,P011801,P012620,4.533,0,9,9
137,CLU,P011801,P012621,16.434,3,26,23
137,CLU,P011801,P012698,16.201,2,33,31
137,CLU,P012620,P012621,1.433,3,3,0
137,CLU,P012620,P012698,3.1,-3,6,9
137,CLU,P012621,P012698,14.35,14,38,24
138,ULM,P005422,P007952,5.133,-9,5,14
138,ULM,P005422,P010106,20.084,0,43,43
138,ULM,P005422,P010582,23.966,1,54,53
138,ULM,P005422,P010726,2.65,2,6,4
138,ULM,P005422,P011391,2.85,-1,9,10
138,ULM,P005422,P011457,13.083,-4,26,30
138,ULM,P005422,P012603,20.55,-1,47,48
138,ULM,P005422,P012604,25.65,5,59,54
138,ULM,P005422,P012703,20.566,-13,43,56
138,ULM,P007952,P010106,0.517,-3,0,3
138,ULM,P007952,P010582,4.616,-6,5,11
138,ULM,P007952,P011457,4.1,-5,5,10
138,ULM,P007952,P012603,1.033,-4,0,4
138,ULM,P007952,P012703,5.133,-9,5,14
138,ULM,P010106,P010582,14.734,0,33,33
138,ULM,P010106,P010726,4.35,0,11,11
138,ULM,P010106,P011391,2.15,2,7,5
138,ULM,P010106,P011457,3.867,-6,6,12
138,ULM,P010106,P012603,20.534,0,46,46
138,ULM,P010106,P012604,21.734,-5,45,50
138,ULM,P010106,P012703,9.634,-12,17,29
138,ULM,P010582,P010726,3.75,-3,11,14
138,ULM,P010582,P011391,1.05,-1,4,5
138,ULM,P010582,P011457,9.666,2,20,18
138,ULM,P010582,P012603,20.667,-8,49,57
138,ULM,P010582,P012604,24.667,1,60,59
138,ULM,P010582,P012703,18.216,-10,40,50
138,ULM,P010726,P011457,0.45,0,0,0
138,ULM,P010726,P012603,5.95,-1,17,18
138,ULM,P010726,P012604,6.4,-1,17,18
138,ULM,P010726,P012703,2.05,-1,6,7
138,ULM,P011391,P012603,2.85,-1,9,10
138,ULM,P011391,P012703,2.5,-3,7,10
138,ULM,P011457,P012604,9.433,1,21,20
138,ULM,P011457,P012703,13.533,-4,26,30
138,ULM,P012603,P012604,22.584,-3,53,56
138,ULM,P012603,P012703,11.7,-14,27,41
138,ULM,P012604,P012703,17.6,-6,41,47
138,WRO,P003034,P011278,9.367,6,23,17
138,WRO,P003034,P011901,7.45,8,19,11
138,WRO,P003034,P012010,9.234,-1,21,22
138,WRO,P003034,P012094,14.9,9,38,29
138,WRO,P003034,P012601,7.317,1,17,16
138,WRO,P003034,P012699,11.684,7,27,20
138,WRO,P003034,P012736,6.784,-2,15,17
138,WRO,P009896,P011278,5.167,2,12,10
138,WRO,P009896,P011901,9.034,-3,21,24
138,WRO,P009896,P012010,16.051,8,40,32
138,WRO,P009896,P012094,13.267,4,39,35
138,WRO,P009896,P012601,18.084,3,48,45
138,WRO,P009896,P012699,16.084,8,44,36
138,WRO,P009896,P012736,15.317,-2,36,38
138,WRO,P011278,P011901,10.234,7,26,19
138,WRO,P011278,P012010,4.367,1,9,8
138,WRO,P011278,P012094,12.35,8,31,23
138,WRO,P011278,P012601,0.067,0,0,0
138,WRO,P011278,P012699,6.218,8,17,9
138,WRO,P011278,P012736,10.634,0,22,22
138,WRO,P011901,P012010,3.434,1,8,7
138,WRO,P011901,P012094,13.05,4,32,28
138,WRO,P011901,P012601,6.384,-2,14,16
138,WRO,P011901,P012699,7.834,9,21,12
138,WRO,P011901,P012736,8.784,-4,19,23
138,WRO,P012010,P012094,13.517,8,38,30
138,WRO,P012010,P012601,20.918,6,52,46
138,WRO,P012010,P012699,21.168,6,51,45
138,WRO,P012010,P012736,12.451,-1,25,26
138,WRO,P012094,P012601,15.817,5,46,41
138,WRO,P012094,P012699,16.667,16,48,32
138,WRO,P012094,P012736,13.1,-2,36,38
138,WRO,P012601,P012699,21.684,7,54,47
138,WRO,P012601,P012736,11.601,-4,29,33
138,WRO,P012699,P012736,10.001,-1,22,23
139,TRN,P001479,P005059,19.25,5,38,33
139,TRN,P001479,P005738,3.217,-6,3,9
139,TRN,P001479,P006382,10.833,7,21,14
139,TRN,P001479,P009903,0.733,3,5,2
139,TRN,P001479,P012593,9.533,-2,17,19
139,TRN,P001479,P012596,15.3,8,30,22
139,TRN,P001479,P012597,16.034,4,33,29
139,TRN,P001479,P012687,2.1,1,5,4
139,TRN,P005059,P005738,10.15,-5,15,20
139,TRN,P005059,P006382,12.266,9,23,14
139,TRN,P005059,P009903,7.666,4,17,13
139,TRN,P005059,P012593,16.466,-1,29,30
139,TRN,P005059,P012594,0.95,1,1,0
139,TRN,P005059,P012596,15.3,8,30,22
139,TRN,P005059,P012597,17.884,3,38,35
139,TRN,P005059,P012687,4.8,0,9,9
139,TRN,P005738,P006382,1.433,2,2,0
139,TRN,P005738,P009903,19.95,-9,32,41
139,TRN,P005738,P012593,23.967,-19,35,54
139,TRN,P005738,P012594,13.967,-9,21,30
139,TRN,P005738,P012596,0.8,-4,0,4
139,TRN,P005738,P012597,18.884,-21,28,49
139,TRN,P005738,P012687,3.5,-5,4,9
139,TRN,P006382,P009903,2.166,5,7,2
139,TRN,P006382,P012593,4.649,3,7,4
139,TRN,P006382,P012596,10.1,4,16,12
139,TRN,P006382,P012597,7.617,6,16,10
139,TRN,P009903,P012593,20.683,-6,37,43
139,TRN,P009903,P012594,13.967,-9,21,30
139,TRN,P009903,P012597,14.867,-11,25,36
139,TRN,P009903,P012687,2.7,-1,4,5
139,TRN,P012593,P012594,13.967,-9,21,30
139,TRN,P012593,P012596,6.383,-3,9,12
139,TRN,P012593,P012597,21.984,-18,37,55
139,TRN,P012593,P012687,3.5,-5,4,9
139,TRN,P012594,P012597,13.017,-10,20,30
139,TRN,P012596,P012597,13.617,6,30,24
139,TRN,P012596,P012687,2.9,-3,5,8
139,TRN,P012597,P012687,2.9,-3,5,8
139,TTK,P004801,P005000,10.55,4,25,21
139,TTK,P004801,P006693,21.233,15,50,35
139,TTK,P004801,P006883,2.233,-1,4,5
139,TTK,P004801,P009845,4.516,0,9,9
139,TTK,P004801,P010477,2.5,2,6,4
139,TTK,P004801,P011239,17.484,10,41,31
139,TTK,P004801,P011834,10.2,5,22,17
139,TTK,P004801,P011925,18.133,11,42,31
139,TTK,P004801,P011975,4.083,2,9,7
139,TTK,P005000,P006693,16.75,11,34,23
139,TTK,P005000,P006883,8.083,-12,7,19
139,TTK,P005000,P009845,1.533,-5,2,7
139,TTK,P005000,P010477,14.267,-7,19,26
139,TTK,P005000,P011239,16.767,6,35,29
139,TTK,P005000,P011834,6.517,-7,5,12
139,TTK,P005000,P011925,17.733,-2,33,35
139,TTK,P006693,P006883,5.233,-2,5,7
139,TTK,P006693,P009845,3.016,3,7,4
139,TTK,P006693,P010477,14.383,11,28,17
139,TTK,P006693,P011239,24.867,23,60,37
139,TTK,P006693,P011834,17.933,9,36,27
139,TTK,P006693,P011925,24.966,24,59,35
139,TTK,P006693,P011975,4.083,2,9,7
139,TTK,P006883,P009845,1.533,-5,2,7
139,TTK,P006883,P010477,7.899,-9,7,16
139,TTK,P006883,P011239,2.383,-5,2,7
139,TTK,P006883,P011834,5.116,-1,5,6
139,TTK,P006883,P011925,5.116,-13,4,17
139,TTK,P009845,P010477,0.033,-2,0,2
139,TTK,P009845,P011834,1.033,0,2,2
139,TTK,P009845,P011925,3.516,-2,7,9
139,TTK,P009845,P011975,3.016,3,7,4
139,TTK,P010477,P011239,14.25,2,27,25
139,TTK,P010477,P011834,12.016,-2,18,20
139,TTK,P010477,P011925,13.716,-3,23,26
139,TTK,P011239,P011834,15.917,0,31,31
139,TTK,P011239,P011925,27.133,13,58,45
139,TTK,P011239,P011975,1.067,-1,2,3
139,TTK,P011834,P011925,15.1,1,29,28
139,TTK,P011834,P011975,2.1,-1,4,5
139,TTK,P011925,P011975,1.983,3,5,2
140,CAN,P001607,P003425,0.267,0,2,2
140,CAN,P001607,P004160,10.8,-5,16,21
140,CAN,P001607,P004466,4.466,-13,5,18
140,CAN,P001607,P005005,5.951,1,8,7
140,CAN,P001607,P006588,1.267,-2,2,4
140,CAN,P001607,P007644,4.05,-9,7,16
140,CAN,P001607,P008121,5.383,-5,13,18
140,CAN,P001607,P009864,4.233,-7,7,14
140,CAN,P001607,P010385,8.633,-2,12,14
140,CAN,P001607,P010452,8.15,-2,12,14
140,CAN,P003425,P003637,10.983,6,25,19
140,CAN,P003425,P004160,5.918,0,14,14
140,CAN,P003425,P004466,5.3,6,15,9
140,CAN,P003425,P005005,12.167,11,37,26
140,CAN,P003425,P006588,19.334,12,52,40
140,CAN,P003425,P007644,3.017,9,13,4
140,CAN,P003425,P008121,19.117,12,52,40
140,CAN,P003425,P009864,17.5,16,52,36
140,CAN,P003425,P010385,6.233,-3,9,12
140,CAN,P003425,P010452,7.5,7,21,14
140,CAN,P003637,P006588,10.983,6,25,19
140,CAN,P003637,P008121,10.983,6,25,19
140,CAN,P003637,P009864,9.9,6,25,19
140,CAN,P003637,P010385,1.083,0,0,0
140,CAN,P004160,P004466,3.217,-5,6,11
140,CAN,P004160,P005005,7.751,2,12,10
140,CAN,P004160,P006588,3.384,-5,4,9
140,CAN,P004160,P007644,3.668,-1,8,9
140,CAN,P004160,P008121,5.75,-2,12,14
140,CAN,P004160,P009864,4.6,0,10,10
140,CAN,P004160,P010385,10.8,-5,16,21
140,CAN,P004160,P010452,10.984,1,22,21
140,CAN,P004466,P005005,4.799,4,11,7
140,CAN,P004466,P006588,0.567,0,0,0
140,CAN,P004466,P007644,4.333,0,13,13
140,CAN,P004466,P008121,2.016,-6,3,9
140,CAN,P004466,P009864,1.883,-6,3,9
140,CAN,P004466,P010385,5.349,-7,7,14
140,CAN,P004466,P010452,7.666,-1,17,18
140,CAN,P005005,P006588,5.434,6,20,14
140,CAN,P005005,P007644,4.0,1,8,7
140,CAN,P005005,P008121,5.567,6,20,14
140,CAN,P005005,P009864,9.267,6,26,20
140,CAN,P005005,P010385,6.433,4,9,5
140,CAN,P005005,P010452,10.567,7,21,14
140,CAN,P006588,P007644,0.4,3,3,0
140,CAN,P006588,P008121,20.117,10,52,42
140,CAN,P006588,P009864,15.6,15,46,31
140,CAN,P006588,P010385,4.25,-5,4,9
140,CAN,P007644,P008121,2.349,-3,8,11
140,CAN,P007644,P009864,4.066,-4,10,14
140,CAN,P007644,P010385,0.133,0,0,0
140,CAN,P007644,P010452,2.784,4,10,6
140,CAN,P008121,P009864,17.633,9,51,42
140,CAN,P008121,P010385,6.466,-2,10,12
140,CAN,P008121,P010452,2.083,3,6,3
140,CAN,P009864,P010452,2.25,1,6,5
140,CAN,P010385,P010452,10.616,0,17,17
140,LKB,P002012,P004868,1.834,-7,6,13
140,LKB,P002012,P006230,7.317,-7,11,18
140,LKB,P002012,P006901,11.484,-8,27,35
140,LKB,P002012,P007029,19.817,2,51,49
140,LKB,P002012,P009898,19.717,1,49,48
140,LKB,P002012,P010190,6.117,-6,14,20
140,LKB,P002012,P010461,14.8,10,41,31
140,LKB,P002012,PLXI,15.25,-1,33,34
140,LKB,P004868,P006230,7.05,-1,14,15
140,LKB,P004868,P006901,8.267,4,23,19
140,LKB,P004868,P007029,13.783,-10,25,35
140,LKB,P004868,P009898,13.45,-3,28,31
140,LKB,P004868,P010190,10.717,-10,18,28
140,LKB,P004868,P010461,8.516,-3,12,15
140,LKB,P004868,PLXI,5.983,-14,2,16
140,LKB,P006230,P006901,6.901,-3,13,16
140,LKB,P006230,P007029,12.0,-12,18,30
140,LKB,P006230,P009898,12.7,-6,25,31
140,LKB,P006230,P010190,6.667,2,12,10
140,LKB,P006230,PLXI,4.833,-5,7,12
140,LKB,P006901,P007029,13.417,3,35,32
140,LKB,P006901,P009898,15.967,4,37,33
140,LKB,P006901,P010190,6.601,-3,16,19
140,LKB,P006901,P010461,11.8,5,29,24
140,LKB,P006901,PLXI,3.167,-6,4,10
140,LKB,P007029,P009898,25.249,5,61,56
140,LKB,P007029,P010190,10.5,-7,16,23
140,LKB,P007029,P010461,18.149,18,46,28
140,LKB,P007029,PLXI,15.549,-3,28,31
140,LKB,P009898,P010190,8.35,-2,17,19
140,LKB,P009898,P010461,18.416,12,48,36
140,LKB,P009898,PLXI,15.683,-3,35,38
140,LKB,P010190,P010461,7.95,-10,8,18
140,LKB,P010190,PLXI,6.966,-12,3,15
140,LKB,P010461,PLXI,15.033,-4,28,32
141,PMT,P001686,P002644,20.916,17,48,31
141,PMT,P001686,P005301,15.099,6,35,29
141,PMT,P001686,P011823,6.35,2,15,13
141,PMT,P001686,P011942,17.533,7,41,34
141,PMT,P001686,P011944,11.9,-5,23,28
141,PMT,P001686,P011947,11.683,9,22,13
141,PMT,P001686,P011966,14.933,24,40,16
141,PMT,P001686,P012600,10.65,16,28,12
141,PMT,P002020,P002691,3.083,0,5,5
141,PMT,P002020,P011823,3.666,-2,5,7
141,PMT,P002020,P011942,3.666,-2,5,7
141,PMT,P002020,P011943,3.666,-2,5,7
141,PMT,P002020,P011944,0.583,-2,0,2
141,PMT,P002644,P005301,12.533,10,31,21
141,PMT,P002644,P011942,17.2,12,38,26
141,PMT,P002644,P011943,1.95,-2,1,3
141,PMT,P002644,P011944,10.0,-4,16,20
141,PMT,P002644,P011947,11.95,8,23,15
141,PMT,P002644,P011966,14.6,23,39,16
141,PMT,P002644,P012600,10.983,12,24,12
141,PMT,P002691,P011823,3.083,0,5,5
141,PMT,P002691,P011942,3.083,0,5,5
141,PMT,P002691,P011943,3.083,0,5,5
141,PMT,P005301,P011823,5.283,-3,10,13
141,PMT,P005301,P011942,16.983,7,41,34
141,PMT,P005301,P011943,0.55,-3,0,3
141,PMT,P005301,P011944,9.75,-7,19,26
141,PMT,P005301,P011947,3.433,4,6,2
141,PMT,P005301,P011966,7.633,14,22,8
141,PMT,P011823,P011942,8.566,-2,18,20
141,PMT,P011823,P011943,8.616,6,21,15
141,PMT,P011823,P011944,6.5,-2,13,15
141,PMT,P011823,P011947,6.4,10,18,8
141,PMT,P011823,P011966,5.383,10,18,8
141,PMT,P011823,P012600,6.017,13,21,8
141,PMT,P011942,P011943,6.066,-1,9,10
141,PMT,P011942,P011944,14.883,-6,27,33
141,PMT,P011942,P011947,4.117,1,6,5
141,PMT,P011942,P011966,7.367,16,24,8
141,PMT,P011942,P012600,3.6,8,10,2
141,PMT,P011943,P011944,4.6,-1,6,7
141,PMT,P011943,P011947,4.5,5,13,8
141,PMT,P011943,P011966,2.883,5,11,6
141,PMT,P011943,P012600,6.35,9,17,8
141,PMT,P011944,P011947,3.134,-3,2,5
141,PMT,P011944,P012600,4.65,6,10,4
141,PMT,P011947,P011966,14.783,21,39,18
141,PMT,P011947,P012600,13.4,17,35,18
141,PMT,P011966,P012600,12.35,19,35,16
141,WOL,P002387,P003212,1.3,0,2,2
141,WOL,P002387,P004645,4.134,-4,3,7
141,WOL,P002387,P005516,8.316,-4,14,18
141,WOL,P002387,P006154,14.883,-2,24,26
141,WOL,P002387,P006546,16.066,0,30,30
141,WOL,P002387,P006907,8.483,0,15,15
141,WOL,P002387,P011150,4.433,-4,7,11
141,WOL,P002387,P012576,4.651,-6,3,9
141,WOL,P002387,P012577,13.833,-4,25,29
141,WOL,P002387,P012789,19.165,0,37,37
141,WOL,P003212,P006546,2.284,0,4,4
141,WOL,P003212,P006907,1.817,-8,0,8
141,WOL,P003212,P011150,2.167,-8,2,10
141,WOL,P003212,P012576,3.001,-10,2,12
141,WOL,P003212,P012577,3.784,-8,4,12
141,WOL,P003212,P012789,0.783,2,2,0
141,WOL,P004645,P006154,4.134,-4,3,7
141,WOL,P004645,P006546,1.817,3,3,0
141,WOL,P004645,P012576,4.134,-4,3,7
141,WOL,P004645,P012577,2.317,-7,0,7
141,WOL,P005516,P006154,5.183,-5,4,9
141,WOL,P005516,P006546,18.299,-10,32,42
141,WOL,P005516,P011150,9.916,-5,21,26
141,WOL,P005516,P012576,3.95,-6,6,12
141,WOL,P005516,P012577,13.183,-6,25,31
141,WOL,P005516,P012789,14.349,-4,26,30
141,WOL,P006154,P006546,15.35,-8,22,30
141,WOL,P006154,P006907,11.083,-5,19,24
141,WOL,P006154,P011150,1.117,-2,0,2
141,WOL,P006154,P012576,6.301,-8,5,13
141,WOL,P006154,P012577,17.55,-16,24,40
141,WOL,P006154,P012789,16.799,-6,27,33
141,WOL,P006546,P006907,5.967,-6,9,15
141,WOL,P006546,P011150,11.7,-7,23,30
141,WOL,P006546,P012576,7.268,-5,11,16
141,WOL,P006546,P012577,20.767,-11,39,50
141,WOL,P006546,P012789,23.482,-8,43,51
141,WOL,P006907,P011150,1.5,-8,0,8
141,WOL,P006907,P012576,1.817,-8,0,8
141,WOL,P006907,P012577,9.85,-12,14,26
141,WOL,P006907,P012789,11.083,-5,19,24
141,WOL,P011150,P012576,3.95,-10,6,16
141,WOL,P011150,P012577,8.767,-11,16,27
141,WOL,P011150,P012789,9.25,-5,17,22
141,WOL,P012576,P012577,9.268,-23,8,31
141,WOL,P012577,P012789,20.749,-2,41,43
142,LJU,P001235,P003452,3.283,0,8,8
142,LJU,P001235,P003514,3.183,-6,5,11
142,LJU,P001235,P005969,3.283,0,8,8
142,LJU,P001235,P007066,3.0,-3,5,8
142,LJU,P001235,P009392,0.183,-3,0,3
142,LJU,P001235,P009395,4.683,-4,12,16
142,LJU,P001235,P010594,3.283,0,8,8
142,LJU,P001235,P010771,1.783,-2,1,3
142,LJU,P001235,P011261,3.183,-6,5,11
142,LJU,P002561,P003452,20.499,8,60,52
142,LJU,P002561,P003514,2.533,-3,3,6
142,LJU,P002561,P005969,18.682,2,51,49
142,LJU,P002561,P007066,11.932,-6,28,34
142,LJU,P002561,P009392,5.633,6,18,12
142,LJU,P002561,P009395,15.133,4,41,37
142,LJU,P002561,P010594,9.849,2,26,24
142,LJU,P002561,P010771,3.517,4,13,9
142,LJU,P002561,P011261,4.35,3,12,9
142,LJU,P003452,P003514,10.5,-10,17,27
142,LJU,P003452,P005969,30.832,-7,73,80
142,LJU,P003452,P007066,10.549,-4,28,32
142,LJU,P003452,P009392,12.0,7,32,25
142,LJU,P003452,P009395,28.916,-6,66,72
142,LJU,P003452,P010594,14.732,-6,34,40
142,LJU,P003452,P010771,2.367,5,10,5
142,LJU,P003452,P011261,3.45,5,12,7
142,LJU,P003514,P005969,12.133,-11,20,31
142,LJU,P003514,P007066,4.383,-5,5,10
142,LJU,P003514,P009392,6.55,-2,14,16
142,LJU,P003514,P009395,11.9,-14,21,35
142,LJU,P003514,P010594,6.666,-14,6,20
142,LJU,P003514,P010771,2.933,-3,4,7
142,LJU,P003514,P011261,4.083,-8,5,13
142,LJU,P005969,P007066,9.949,-4,26,30
142,LJU,P005969,P009392,12.0,7,32,25
142,LJU,P005969,P009395,27.549,-9,60,69
142,LJU,P005969,P010594,14.282,-9,31,40
142,LJU,P005969,P010771,1.15,-1,3,4
142,LJU,P007066,P009392,1.383,2,8,6
142,LJU,P007066,P009395,7.4,-7,17,24
142,LJU,P007066,P010594,4.366,-2,7,9
142,LJU,P007066,P010771,1.783,-2,1,3
142,LJU,P007066,P011261,4.983,-5,7,12
142,LJU,P009392,P009395,10.8,2,24,22
142,LJU,P009392,P011261,0.183,-3,0,3
142,LJU,P009395,P010594,10.749,-8,23,31
142,LJU,P009395,P010771,1.367,3,6,3
142,LJU,P009395,P011261,2.767,-1,10,11
142,LJU,P010594,P010771,2.15,1,7,6
142,LJU,P010594,P011261,2.983,0,6,6
142,LJU,P010771,P011261,4.15,3,11,8
142,VNC,P000968,P003759,4.9,0,14,14
142,VNC,P000968,P004381,4.1,3,13,10
142,VNC,P000968,P008052,7.184,2,19,17
142,VNC,P000968,P009400,2.55,6,11,5
142,VNC,P000968,P011909,0.667,0,0,0
142,VNC,P000968,P011928,6.467,-4,18,22
142,VNC,P000968,P012259,6.517,2,19,17
142,VNC,P000968,P012587,2.367,-7,5,12
142,VNC,P000968,P012591,11.101,-8,26,34
142,VNC,P000968,P012796,8.751,-2,23,25
142,VNC,P003759,P004381,12.5,10,31,21
142,VNC,P003759,P008052,8.35,3,22,19
142,VNC,P003759,P009400,4.05,0,8,8
142,VNC,P003759,P011909,6.817,10,20,10
142,VNC,P003759,P011928,9.367,7,23,16
142,VNC,P003759,P012259,9.183,4,25,21
142,VNC,P003759,P012591,15.701,6,37,31
142,VNC,P004381,P008052,8.633,5,24,19
142,VNC,P004381,P009400,12.766,-3,27,30
142,VNC,P004381,P011909,7.284,13,23,10
142,VNC,P004381,P011928,21.5,11,56,45
142,VNC,P004381,P012259,6.466,5,18,13
142,VNC,P004381,P012587,2.5,-2,6,8
142,VNC,P004381,P012591,27.15,16,73,57
142,VNC,P004381,P012796,17.633,6,49,43
142,VNC,P008052,P009400,8.383,4,24,20
142,VNC,P008052,P011909,1.134,3,3,0
142,VNC,P008052,P012259,12.467,6,34,28
142,VNC,P008052,P012591,10.601,1,25,24
142,VNC,P008052,P012796,7.784,4,21,17
142,VNC,P009400,P011928,7.25,-1,14,15
142,VNC,P009400,P012259,5.85,6,18,12
142,VNC,P009400,P012591,10.1,-3,20,23
142,VNC,P009400,P012796,11.583,3,30,27
142,VNC,P011909,P011928,6.817,10,20,10
142,VNC,P011909,P012591,7.951,13,23,10
142,VNC,P011909,P012796,1.134,3,3,0
142,VNC,P011928,P012259,0.833,1,3,2
142,VNC,P011928,P012587,4.867,-9,11,20
142,VNC,P011928,P012591,23.867,4,61,57
142,VNC,P011928,P012796,14.5,-3,38,41
142,VNC,P012259,P012591,7.767,1,19,18
142,VNC,P012259,P012796,4.117,3,12,9
142,VNC,P012587,P012591,4.867,-9,11,20
142,VNC,P012587,P012796,4.867,-9,11,20
142,VNC,P012591,P012796,18.767,-1,49,50
143,BES,P003783,P007917,2.133,-7,1,8
143,BES,P003783,P008945,1.034,-2,3,5
143,BES,P003783,P011379,10.749,11,24,13
143,BES,P003783,P011924,10.35,-11,20,31
143,BES,P003783,P011936,9.667,8,26,18
143,BES,P003783,P012622,14.017,11,35,24
143,BES,P003783,P012647,13.15,9,35,26
143,BES,P003783,P012711,9.7,-7,20,27
143,BES,P007917,P008945,4.584,-4,7,11
143,BES,P007917,P011357,3.017,-4,4,8
143,BES,P007917,P011379,1.433,-3,1,4
143,BES,P007917,P011924,4.817,-5,8,13
143,BES,P007917,P011936,1.467,-6,0,6
143,BES,P007917,P012622,0.433,0,0,0
143,BES,P007917,P012647,2.467,-4,3,7
143,BES,P007917,P012711,6.517,-11,8,19
143,BES,P008945,P011357,3.017,-4,4,8
143,BES,P008945,P011379,14.95,0,25,25
143,BES,P008945,P011924,16.268,6,37,31
143,BES,P008945,P011936,20.418,6,39,33
143,BES,P008945,P012622,20.634,7,42,35
143,BES,P008945,P012647,21.434,16,49,33
143,BES,P008945,P012711,11.001,-1,18,19
143,BES,P011357,P011924,3.017,-4,4,8
143,BES,P011357,P012711,3.017,-4,4,8
143,BES,P011379,P011924,10.433,-1,19,20
143,BES,P011379,P011936,16.233,13,31,18
143,BES,P011379,P012622,23.766,13,47,34
143,BES,P011379,P012647,18.799,13,40,27
143,BES,P011379,P012711,6.433,-2,9,11
143,BES,P011924,P011936,10.334,5,25,20
143,BES,P011924,P012622,15.934,3,37,34
143,BES,P011924,P012647,15.867,11,46,35
143,BES,P011924,P012711,16.384,-4,32,36
143,BES,P011936,P012622,22.484,20,50,30
143,BES,P011936,P012647,26.417,20,59,39
143,BES,P011936,P012711,9.184,-2,18,20
143,BES,P012622,P012647,27.883,25,67,42
143,BES,P012622,P012711,9.317,1,18,17
143,BES,P012647,P012711,11.251,-2,25,27
143,HAM,P001990,P009663,8.6,-3,11,14
143,HAM,P001990,P010070,10.183,6,23,17
143,HAM,P001990,P011187,7.417,6,20,14
143,HAM,P001990,P012579,10.95,14,27,13
143,HAM,P001990,P012580,12.15,1,22,21
143,HAM,P001990,P012581,6.651,-7,11,18
143,HAM,P001990,P012582,5.117,-7,4,11
143,HAM,P001990,P012648,2.283,-2,2,4
143,HAM,P001990,P012694,0.717,4,4,0
143,HAM,P009663,P010070,6.133,5,13,8
143,HAM,P009663,P011168,7.983,-3,13,16
143,HAM,P009663,P011187,1.5,-4,0,4
143,HAM,P009663,P012579,13.55,-6,19,25
143,HAM,P009663,P012580,19.0,-8,30,38
143,HAM,P009663,P012581,15.317,-16,21,37
143,HAM,P009663,P012582,12.85,-9,17,26
143,HAM,P009663,P012648,4.667,-8,4,12
143,HAM,P010070,P011168,5.25,-4,9,13
143,HAM,P010070,P011187,11.383,-2,22,24
143,HAM,P010070,P012579,12.566,9,32,23
143,HAM,P010070,P012580,14.866,5,32,27
143,HAM,P010070,P012581,10.484,-2,21,23
143,HAM,P010070,P012648,0.467,-1,0,1
143,HAM,P011168,P011187,14.867,-5,28,33
143,HAM,P011168,P012579,11.084,-3,25,28
143,HAM,P011168,P012580,13.733,-7,23,30
143,HAM,P011168,P012581,19.317,-6,35,41
143,HAM,P011168,P012582,15.25,-1,32,33
143,HAM,P011168,P012648,2.517,3,8,5
143,HAM,P011168,P012694,2.667,-2,3,5
143,HAM,P011187,P012579,15.484,5,38,33
143,HAM,P011187,P012580,13.416,-9,20,29
143,HAM,P011187,P012581,17.651,-9,30,39
143,HAM,P011187,P012582,7.517,1,19,18
143,HAM,P011187,P012648,2.517,3,8,5
143,HAM,P011187,P012694,3.384,2,7,5
143,HAM,P012579,P012580,14.083,3,30,27
143,HAM,P012579,P012581,14.635,-5,31,36
143,HAM,P012579,P012582,9.634,1,19,18
143,HAM,P012579,P012648,7.184,-5,12,17
143,HAM,P012579,P012694,2.234,3,7,4
143,HAM,P012580,P012581,22.817,-20,34,54
143,HAM,P012580,P012582,11.8,-7,19,26
143,HAM,P012580,P012648,1.917,-5,2,7
143,HAM,P012580,P012694,1.15,-1,0,1
143,HAM,P012581,P012582,14.5,-11,24,35
143,HAM,P012581,P012648,2.384,-6,2,8
143,HAM,P012581,P012694,3.384,2,7,5
143,HAM,P012582,P012648,4.8,1,10,9
144,JOV,P002507,P006771,23.333,8,49,41
144,JOV,P002507,P010161,0.567,-1,0,1
144,JOV,P002507,P010458,23.633,15,50,35
144,JOV,P002507,P010677,20.733,10,42,32
144,JOV,P002507,P010709,0.9,-1,0,1
144,JOV,P002507,P011247,19.25,15,49,34
144,JOV,P002507,P011248,10.583,2,21,19
144,JOV,P002507,P012349,3.15,-5,6,11
144,JOV,P002507,PJUG,4.983,-3,7,10
144,JOV,P006771,P010458,22.2,13,46,33
144,JOV,P006771,P010677,23.933,8,47,39
144,JOV,P006771,P010709,0.333,0,0,0
144,JOV,P006771,P011247,17.234,10,42,32
144,JOV,P006771,P011248,13.234,-6,21,27
144,JOV,P006771,P012349,6.667,-10,10,20
144,JOV,P006771,P012780,5.534,-5,7,12
144,JOV,P006771,PJUG,3.0,-6,2,8
144,JOV,P010161,P010677,1.3,1,2,1
144,JOV,P010161,P010709,0.717,-1,0,1
144,JOV,P010161,P011248,0.583,2,2,0
144,JOV,P010161,P012349,1.3,1,2,1
144,JOV,P010161,P012780,0.733,2,2,0
144,JOV,P010458,P010677,21.3,7,46,39
144,JOV,P010458,P011247,21.0,16,51,35
144,JOV,P010458,P011248,12.65,2,24,22
144,JOV,P010458,P012780,4.317,-4,9,13
144,JOV,P010458,PJUG,6.7,-5,10,15
144,JOV,P010677,P010709,1.05,-1,0,1
144,JOV,P010677,P011247,14.35,12,38,26
144,JOV,P010677,P011248,13.083,-3,26,29
144,JOV,P010677,P012349,8.133,-2,15,17
144,JOV,P010677,P012780,8.7,-5,19,24
144,JOV,P010677,PJUG,5.15,-7,9,16
144,JOV,P010709,P012349,1.05,-1,0,1
144,JOV,P010709,P012780,0.15,0,0,0
144,JOV,P011247,P011248,12.617,-6,26,32
144,JOV,P011247,P012349,3.917,-7,8,15
144,JOV,P011247,P012780,5.667,-6,10,16
144,JOV,P011247,PJUG,5.633,2,12,10
144,JOV,P011248,P012349,11.0,-8,23,31
144,JOV,P011248,P012780,13.067,-8,26,34
144,JOV,P011248,PJUG,7.783,1,19,18
144,JOV,P012349,P012780,8.9,-4,17,21
144,JOV,P012349,PJUG,4.083,0,11,11
144,JOV,P012780,PJUG,5.8,-2,14,16
144,LLI,P004773,P006600,6.466,-3,12,15
144,LLI,P004773,P009649,8.333,-16,12,28
144,LLI,P004773,P009680,7.999,-8,13,21
144,LLI,P004773,P012020,9.4,-2,19,21
144,LLI,P004773,P012585,11.666,1,23,22
144,LLI,P004773,P012586,8.35,1,18,17
144,LLI,P004773,P012797,11.25,7,27,20
144,LLI,P006600,P009649,24.333,-16,35,51
144,LLI,P006600,P009680,28.066,-13,44,57
144,LLI,P006600,P012585,18.633,-7,35,42
144,LLI,P006600,P012586,16.866,-18,20,38
144,LLI,P006600,P012797,19.5,9,34,25
144,LLI,P009649,P009680,26.266,-20,37,57
144,LLI,P009649,P012020,7.166,3,24,21
144,LLI,P009649,P012585,18.816,-3,43,46
144,LLI,P009649,P012586,19.899,-10,39,49
144,LLI,P009649,P012797,21.183,10,46,36
144,LLI,P009680,P012020,1.933,-4,2,6
144,LLI,P009680,P012585,20.166,-12,36,48
144,LLI,P009680,P012586,16.466,-19,19,38
144,LLI,P009680,P012797,19.1,8,33,25
144,LLI,P012020,P012585,8.683,15,29,14
144,LLI,P012020,P012586,9.35,14,33,19
144,LLI,P012020,P012797,9.6,14,33,19
144,LLI,P012585,P012586,14.733,5,39,34
144,LLI,P012585,P012797,16.567,33,51,18
144,LLI,P012586,P012797,19.2,11,44,33
145,HTA,P003533,P004846,14.583,2,30,28
145,HTA,P003533,P007759,11.684,7,28,21
145,HTA,P003533,P007867,9.566,3,24,21
145,HTA,P003533,P010465,7.633,-3,18,21
145,HTA,P003533,P010550,10.583,7,25,18
145,HTA,P003533,P012028,0.867,-2,4,6
145,HTA,P003533,P012706,0.867,-2,4,6
145,HTA,P003533,P012794,14.817,4,35,31
145,HTA,P004846,P007759,16.517,-9,29,38
145,HTA,P004846,P007867,16.316,-17,32,49
145,HTA,P004846,P010465,12.366,-4,31,35
145,HTA,P004846,P010550,16.133,-10,28,38
145,HTA,P004846,P011973,11.6,-17,22,39
145,HTA,P004846,P012794,17.217,-5,36,41
145,HTA,P007759,P007867,19.6,-12,39,51
145,HTA,P007759,P010465,6.733,0,15,15
145,HTA,P007759,P010550,24.917,-13,44,57
145,HTA,P007759,P011973,15.567,-13,32,45
145,HTA,P007759,P012028,0.867,-2,4,6
145,HTA,P007759,P012706,0.867,-2,4,6
145,HTA,P007759,P012794,24.584,-4,57,61
145,HTA,P007867,P010465,11.799,-16,22,38
145,HTA,P007867,P010550,22.866,-7,50,57
145,HTA,P007867,P011973,16.617,-15,35,50
145,HTA,P007867,P012794,20.3,-8,46,54
145,HTA,P010465,P010550,6.299,-8,13,21
145,HTA,P010465,P011973,4.733,-1,13,14
145,HTA,P010465,P012794,12.233,-8,24,32
145,HTA,P010550,P011973,15.417,-12,30,42
145,HTA,P010550,P012794,20.117,-1,42,43
145,HTA,P011973,P012794,13.134,-6,32,38
145,HTA,P012028,P012706,0.867,-2,4,6
145,HTA,P012028,P012794,0.867,-2,4,6
145,HTA,P012706,P012794,0.867,-2,4,6
145,PRS,P004512,P005793,6.267,13,21,8
145,PRS,P004512,P011232,2.783,0,10,10
145,PRS,P004512,P012608,16.566,26,52,26
145,PRS,P004512,P012609,8.066,10,24,14
145,PRS,P004512,P012610,16.566,26,52,26
145,PRS,P004512,P012611,6.8,14,21,7
145,PRS,P004512,P012613,9.216,15,28,13
145,PRS,P005793,P012608,10.184,13,27,14
145,PRS,P005793,P012609,3.9,6,12,6
145,PRS,P005793,P012610,10.184,13,27,14
145,PRS,P005793,P012611,2.367,7,9,2
145,PRS,P005793,P012612,3.917,0,6,6
145,PRS,P005793,P012640,3.917,0,6,6
145,PRS,P009556,P011232,11.95,-11,30,41
145,PRS,P009556,P012609,11.95,-11,30,41
145,PRS,P009556,P012611,3.317,-2,9,11
145,PRS,P009556,P012612,4.983,0,17,17
145,PRS,P009556,P012613,6.967,-11,13,24
145,PRS,P009556,P012640,8.633,-9,21,30
145,PRS,P011232,P012608,4.85,-2,10,12
145,PRS,P011232,P012609,13.033,-13,33,46
145,PRS,P011232,P012610,4.85,-2,10,12
145,PRS,P011232,P012611,3.317,-2,9,11
145,PRS,P011232,P012612,7.05,-2,17,19
145,PRS,P011232,P012613,8.667,-9,20,29
145,PRS,P011232,P012640,10.7,-11,21,32
145,PRS,P012608,P012609,11.849,9,29,20
145,PRS,P012608,P012610,28.05,29,74,45
145,PRS,P012608,P012611,12.3,19,37,18
145,PRS,P012608,P012612,7.701,4,17,13
145,PRS,P012608,P012613,14.716,20,44,24
145,PRS,P012608,P012640,5.984,-2,6,8
145,PRS,P012609,P012610,11.849,9,29,20
145,PRS,P012609,P012611,7.1,-3,14,17
145,PRS,P012609,P012612,4.983,0,17,17
145,PRS,P012609,P012613,13.833,-6,27,33
145,PRS,P012609,P012640,8.633,-9,21,30
145,PRS,P012610,P012611,12.3,19,37,18
145,PRS,P012610,P012612,7.701,4,17,13
145,PRS,P012610,P012613,14.716,20,44,24
145,PRS,P012610,P012640,5.984,-2,6,8
145,PRS,P012611,P012612,1.717,6,11,5
145,PRS,P012611,P012613,13.25,10,37,27
145,PRS,P012612,P012613,1.717,6,11,5
145,PRS,P012612,P012640,10.967,-2,23,25
145,PRS,P012613,P012640,3.65,-9,4,13
146,BOU,P000498,P004525,16.433,5,34,29
146,BOU,P000498,P010431,4.434,4,10,6
146,BOU,P000498,P010450,3.8,5,12,7
146,BOU,P000498,P010718,3.167,3,8,5
146,BOU,P000498,P011161,14.465,0,26,26
146,BOU,P000498,P011836,4.383,2,10,8
146,BOU,P000498,P011837,3.983,7,11,4
146,BOU,P000498,P012618,11.75,-6,18,24
146,BOU,P000498,P012619,5.083,6,15,9
146,BOU,P000498,P012628,15.766,2,32,30
146,BOU,P004525,P010431,3.467,-4,6,10
146,BOU,P004525,P010450,6.85,15,24,9
146,BOU,P004525,P010718,4.7,7,16,9
146,BOU,P004525,P011161,14.132,11,32,21
146,BOU,P004525,P011837,3.983,7,11,4
146,BOU,P004525,P012617,6.133,15,24,9
146,BOU,P004525,P012618,16.3,12,40,28
146,BOU,P004525,P012619,2.283,1,7,6
146,BOU,P004525,P012628,15.983,11,38,27
146,BOU,P010431,P010718,15.101,11,42,31
146,BOU,P010431,P011836,13.451,14,38,24
146,BOU,P010431,P011837,9.867,9,29,20
146,BOU,P010431,P012617,12.484,6,34,28
146,BOU,P010431,P012618,4.434,-4,7,11
146,BOU,P010431,P012619,2.617,5,8,3
146,BOU,P010431,P012628,1.817,-1,2,3
146,BOU,P010450,P010718,3.05,10,12,2
146,BOU,P010450,P011161,1.883,2,4,2
146,BOU,P010450,P011837,1.883,2,4,2
146,BOU,P010450,P012617,3.05,10,12,2
146,BOU,P010450,P012618,4.967,13,20,7
146,BOU,P010450,P012628,1.917,3,8,5
146,BOU,P010718,P011161,2.767,0,6,6
146,BOU,P010718,P011836,16.218,14,44,30
146,BOU,P010718,P011837,9.867,9,29,20
146,BOU,P010718,P012617,15.534,16,46,30
146,BOU,P010718,P012618,6.217,5,17,12
146,BOU,P010718,P012619,4.834,7,14,7
146,BOU,P010718,P012628,2.217,2,6,4
146,BOU,P011161,P011836,3.983,-1,8,9
146,BOU,P011161,P011837,3.983,7,11,4
146,BOU,P011161,P012617,1.433,8,8,0
146,BOU,P011161,P012618,9.449,0,16,16
146,BOU,P011161,P012619,4.683,3,13,10
146,BOU,P011161,P012628,15.682,10,36,26
146,BOU,P011836,P011837,9.867,9,29,20
146,BOU,P011836,P012617,10.834,9,30,21
146,BOU,P011836,P012618,2.55,-3,3,6
146,BOU,P011836,P012619,5.017,7,14,7
146,BOU,P011836,P012628,3.433,1,8,7
146,BOU,P011837,P012617,9.867,9,29,20
146,BOU,P011837,P012628,2.1,5,7,2
146,BOU,P012617,P012618,7.1,15,25,10
146,BOU,P012617,P012628,1.433,8,8,0
146,BOU,P012618,P012628,12.633,4,26,22
146,BOU,P012619,P012628,4.683,3,13,10
146,LKB,P002012,P004868,3.1,-4,4,8
146,LKB,P002012,P006230,17.117,-10,33,43
146,LKB,P002012,P006901,16.066,-28,27,55
146,LKB,P002012,P007029,23.333,-16,45,61
146,LKB,P002012,P009898,19.55,-15,38,53
146,LKB,P002012,P010190,11.966,-22,21,43
146,LKB,P002012,P010461,11.299,-22,19,41
146,LKB,P002012,P011329,6.433,-11,11,22
146,LKB,P002012,PLXI,4.8,0,10,10
146,LKB,P004868,P006230,5.666,-10,8,18
146,LKB,P004868,P006901,4.933,-3,6,9
146,LKB,P004868,P007029,10.4,-8,16,24
146,LKB,P004868,P009898,11.25,-3,16,19
146,LKB,P004868,P010190,6.15,1,9,8
146,LKB,P004868,P010461,9.017,5,15,10
146,LKB,P004868,P011329,1.233,-1,4,5
146,LKB,P004868,PLXI,6.983,3,14,11
146,LKB,P006230,P006901,9.8,-18,13,31
146,LKB,P006230,P007029,19.833,-18,37,55
146,LKB,P006230,P009898,15.667,-15,29,44
146,LKB,P006230,P010190,5.183,-2,11,13
146,LKB,P006230,P011329,3.433,-1,8,9
146,LKB,P006230,PLXI,2.633,2,9,7
146,LKB,P006901,P007029,15.583,-16,25,41
146,LKB,P006901,P009898,13.983,-15,22,37
146,LKB,P006901,P010190,5.666,-21,7,28
146,LKB,P006901,P010461,11.199,-13,20,33
146,LKB,P006901,P011329,6.433,-11,11,22
146,LKB,P006901,PLXI,0.333,1,1,0
146,LKB,P007029,P009898,23.3,-14,43,57
146,LKB,P007029,P010190,8.35,-5,17,22
146,LKB,P007029,P010461,10.8,-2,20,22
146,LKB,P007029,P011329,3.433,-1,8,9
146,LKB,P007029,PLXI,7.5,0,17,17
146,LKB,P009898,P010190,9.25,-3,17,20
146,LKB,P009898,P010461,12.766,-1,21,22
146,LKB,P009898,PLXI,7.966,2,14,12
146,LKB,P010190,P010461,12.2,-17,19,36
146,LKB,P010190,P011329,4.233,-11,7,18
146,LKB,P010190,PLXI,6.534,4,12,8
146,LKB,P010461,P011329,4.233,-11,7,18
146,LKB,P010461,PLXI,9.15,1,15,14
146,LKB,P011329,PLXI,1.233,-1,4,5
147,CAN,P001607,P004160,5.066,-4,3,7
147,CAN,P001607,P004466,4.883,-16,4,20
147,CAN,P001607,P005005,7.683,-13,4,17
147,CAN,P001607,P007644,1.266,-2,1,3
147,CAN,P001607,P008121,2.266,-7,3,10
147,CAN,P001607,P009864,1.5,-5,2,7
147,CAN,P001607,P010385,8.449,-15,5,20
147,CAN,P001607,P010452,8.683,-18,6,24
147,CAN,P003425,P003637,21.301,5,44,39
147,CAN,P003425,P004160,5.716,-1,11,12
147,CAN,P003425,P004466,3.034,6,11,5
147,CAN,P003425,P005005,5.968,-6,7,13
147,CAN,P003425,P006588,21.051,7,48,41
147,CAN,P003425,P007644,7.85,2,18,16
147,CAN,P003425,P008121,24.083,16,59,43
147,CAN,P003425,P009864,19.833,9,45,36
147,CAN,P003425,P010385,8.501,-2,13,15
147,CAN,P003425,P010452,2.867,4,8,4
147,CAN,P003637,P005005,4.651,-9,4,13
147,CAN,P003637,P006588,19.334,4,40,36
147,CAN,P003637,P007644,1.85,1,4,3
147,CAN,P003637,P008121,16.65,14,40,26
147,CAN,P003637,P009864,16.05,11,39,28
147,CAN,P003637,P010385,5.251,-6,5,11
147,CAN,P003637,P010452,0.117,0,0,0
147,CAN,P004160,P005005,4.3,-2,2,4
147,CAN,P004160,P007644,5.549,-4,7,11
147,CAN,P004160,P008121,6.482,-3,12,15
147,CAN,P004160,P009864,3.783,-2,6,8
147,CAN,P004160,P010385,6.999,-3,8,11
147,CAN,P004160,P010452,5.233,-1,7,8
147,CAN,P004466,P005005,4.7,-8,5,13
147,CAN,P004466,P006588,1.717,3,8,5
147,CAN,P004466,P007644,1.717,3,8,5
147,CAN,P004466,P008121,3.217,-2,10,12
147,CAN,P004466,P009864,1.5,-5,2,7
147,CAN,P004466,P010385,4.7,-8,5,13
147,CAN,P004466,P010452,6.2,-13,7,20
147,CAN,P005005,P006588,2.684,-10,0,10
147,CAN,P005005,P007644,2.383,1,4,3
147,CAN,P005005,P009864,1.1,-1,2,3
147,CAN,P005005,P010385,12.551,-18,9,27
147,CAN,P005005,P010452,8.584,-10,7,17
147,CAN,P006588,P007644,1.717,3,8,5
147,CAN,P006588,P008121,18.367,17,48,31
147,CAN,P006588,P009864,15.567,9,37,28
147,CAN,P006588,P010385,3.767,-5,3,8
147,CAN,P007644,P008121,6.733,-1,15,16
147,CAN,P007644,P009864,4.266,0,8,8
147,CAN,P007644,P010385,3.133,-3,3,6
147,CAN,P008121,P009864,20.233,5,45,40
147,CAN,P008121,P010385,4.399,1,9,8
147,CAN,P008121,P010452,2.966,-4,7,11
147,CAN,P009864,P010452,1.5,-5,2,7
147,CAN,P010385,P010452,10.05,-9,12,21
147,TTK,P004801,P005000,15.867,6,33,27
147,TTK,P004801,P006693,11.817,11,25,14
147,TTK,P004801,P006883,15.684,17,39,22
147,TTK,P004801,P009845,6.784,1,11,10
147,TTK,P004801,P011239,4.883,-5,9,14
147,TTK,P004801,P011834,12.634,9,29,20
147,TTK,P004801,P011925,11.667,9,22,13
147,TTK,P005000,P006693,17.016,3,34,31
147,TTK,P005000,P006883,17.65,9,44,35
147,TTK,P005000,P009845,9.267,1,15,14
147,TTK,P005000,P010477,1.917,2,2,0
147,TTK,P005000,P011239,5.683,-5,9,14
147,TTK,P005000,P011834,16.016,-1,36,37
147,TTK,P005000,P011925,16.916,1,31,30
147,TTK,P006693,P006883,17.817,19,47,28
147,TTK,P006693,P009845,6.633,-5,7,12
147,TTK,P006693,P010477,12.817,2,25,23
147,TTK,P006693,P011239,7.483,-5,12,17
147,TTK,P006693,P011834,23.483,4,51,47
147,TTK,P006693,P011925,30.666,7,63,56
147,TTK,P006883,P009845,2.634,6,8,2
147,TTK,P006883,P010477,4.317,5,11,6
147,TTK,P006883,P011239,4.883,-5,9,14
147,TTK,P006883,P011834,22.834,12,54,42
147,TTK,P006883,P011925,17.717,17,44,27
147,TTK,P009845,P010477,1.55,2,2,0
147,TTK,P009845,P011834,2.95,4,10,6
147,TTK,P009845,P011925,7.25,-5,7,12
147,TTK,P010477,P011239,7.0,-5,12,17
147,TTK,P010477,P011834,11.0,0,23,23
147,TTK,P010477,P011925,12.867,2,25,23
147,TTK,P011239,P011834,12.049,-10,21,31
147,TTK,P011239,P011925,7.483,-5,12,17
147,TTK,P011834,P011925,22.766,2,48,46
148,TRN,P001479,P005059,8.967,4,15,11
148,TRN,P001479,P006382,9.201,8,22,14
148,TRN,P001479,P009903,5.184,7,9,2
148,TRN,P001479,P012593,6.584,6,15,9
148,TRN,P001479,P012594,11.167,5,26,21
148,TRN,P001479,P012596,9.717,2,23,21
148,TRN,P001479,P012597,8.784,4,18,14
148,TRN,P005059,P005738,16.034,3,35,32
148,TRN,P005059,P006382,5.301,1,5,4
148,TRN,P005059,P009903,17.551,5,37,32
148,TRN,P005059,P012593,19.067,3,37,34
148,TRN,P005059,P012594,5.233,0,9,9
148,TRN,P005059,P012596,7.45,2,13,11
148,TRN,P005059,P012597,18.267,7,41,34
148,TRN,P005059,P012687,2.134,3,8,5
148,TRN,P005738,P006382,10.151,-4,17,21
148,TRN,P005738,P009903,21.934,-1,48,49
148,TRN,P005738,P012593,13.9,0,27,27
148,TRN,P005738,P012594,0.95,-4,1,5
148,TRN,P005738,P012596,3.167,-2,5,7
148,TRN,P005738,P012597,23.067,-1,53,54
148,TRN,P005738,P012687,11.201,-3,26,29
148,TRN,P006382,P009903,13.851,2,25,23
148,TRN,P006382,P012593,3.451,1,5,4
148,TRN,P006382,P012594,5.934,5,17,12
148,TRN,P006382,P012596,5.501,2,14,12
148,TRN,P006382,P012597,15.901,3,34,31
148,TRN,P006382,P012687,8.117,-2,17,19
148,TRN,P009903,P012593,14.417,6,31,25
148,TRN,P009903,P012594,1.45,3,3,0
148,TRN,P009903,P012597,24.651,5,54,49
148,TRN,P009903,P012687,9.434,-3,21,24
148,TRN,P012593,P012594,6.117,5,14,9
148,TRN,P012593,P012596,6.067,0,11,11
148,TRN,P012593,P012597,12.333,3,28,25
148,TRN,P012594,P012596,10.667,-2,24,26
148,TRN,P012594,P012597,6.0,-4,13,17
148,TRN,P012594,P012687,0.95,-4,1,5
148,TRN,P012596,P012597,7.2,-2,17,19
148,TRN,P012596,P012687,1.767,0,5,5
148,TRN,P012597,P012687,11.201,-3,26,29
148,WRO,P003034,P005531,11.983,-11,18,29
148,WRO,P003034,P011278,2.933,-5,2,7
148,WRO,P003034,P011901,0.167,0,0,0
148,WRO,P003034,P012010,9.633,-10,16,26
148,WRO,P003034,P012094,2.033,-3,2,5
148,WRO,P003034,P012601,8.733,-8,16,24
148,WRO,P003034,P012699,11.499,-13,18,31
148,WRO,P003034,P012736,-0.317,-2,0,2
148,WRO,P005531,P009896,15.399,10,32,22
148,WRO,P005531,P011278,2.933,-5,2,7
148,WRO,P005531,P011901,4.217,0,6,6
148,WRO,P005531,P012010,15.749,-1,30,31
148,WRO,P005531,P012094,12.45,-4,20,24
148,WRO,P005531,P012601,21.166,4,45,41
148,WRO,P005531,P012699,23.798,-5,43,48
148,WRO,P005531,P012736,6.633,0,12,12
148,WRO,P009896,P011278,2.45,-3,5,8
148,WRO,P009896,P011901,9.666,5,24,19
148,WRO,P009896,P012010,9.0,3,16,13
148,WRO,P009896,P012094,21.016,0,45,45
148,WRO,P009896,P012601,22.766,9,52,43
148,WRO,P009896,P012699,14.649,3,28,25
148,WRO,P009896,P012736,13.582,9,34,25
148,WRO,P011278,P011901,0.583,0,3,3
148,WRO,P011278,P012010,4.8,-8,4,12
148,WRO,P011278,P012094,2.45,-3,5,8
148,WRO,P011278,P012601,2.567,-5,3,8
148,WRO,P011278,P012699,2.933,-5,2,7
148,WRO,P011278,P012736,-0.117,2,2,0
148,WRO,P011901,P012010,1.2,2,2,0
148,WRO,P011901,P012094,9.45,-1,22,23
148,WRO,P011901,P012601,11.15,1,24,23
148,WRO,P011901,P012699,0.383,2,2,0
148,WRO,P011901,P012736,7.316,3,21,18
148,WRO,P012010,P012094,2.884,-6,2,8
148,WRO,P012010,P012601,15.7,-2,30,32
148,WRO,P012010,P012699,15.566,-6,28,34
148,WRO,P012094,P012601,19.5,-7,40,47
148,WRO,P012094,P012699,11.599,-7,18,25
148,WRO,P012094,P012736,14.082,3,34,31
148,WRO,P012601,P012699,19.115,-1,41,42
148,WRO,P012601,P012736,10.099,5,29,24
148,WRO,P012699,P012736,6.582,0,12,12
149,CLU,P004862,P005113,8.967,-2,19,21
149,CLU,P004862,P005714,1.95,-4,3,7
149,CLU,P004862,P010569,10.151,-2,22,24
149,CLU,P004862,P011797,8.017,0,19,19
149,CLU,P004862,P011801,2.517,-4,3,7
149,CLU,P004862,P012621,10.534,-4,22,26
149,CLU,P005113,P005714,1.75,-3,2,5
149,CLU,P005113,P010569,15.651,-8,29,37
149,CLU,P005113,P011797,15.584,-8,29,37
149,CLU,P005113,P011801,3.1,-8,2,10
149,CLU,P005113,P012620,2.584,0,7,7
149,CLU,P005113,P012621,16.834,-8,29,37
149,CLU,P005113,P012698,5.134,-7,7,14
149,CLU,P005373,P005714,18.584,14,45,31
149,CLU,P005373,P010569,1.667,2,4,2
149,CLU,P005373,P010997,1.017,-1,2,3
149,CLU,P005373,P011797,8.867,4,19,15
149,CLU,P005373,P011801,20.684,17,51,34
149,CLU,P005373,P012620,12.717,13,32,19
149,CLU,P005373,P012621,14.133,20,45,25
149,CLU,P005373,P012698,5.067,-1,6,7
149,CLU,P005714,P010569,1.917,-2,3,5
149,CLU,P005714,P010997,1.017,-1,2,3
149,CLU,P005714,P011797,7.617,1,13,12
149,CLU,P005714,P011801,21.901,9,50,41
149,CLU,P005714,P012620,13.934,12,34,22
149,CLU,P005714,P012621,15.35,12,44,32
149,CLU,P005714,P012698,4.984,-2,4,6
149,CLU,P010569,P011797,17.101,-6,33,39
149,CLU,P010569,P011801,4.584,-5,7,12
149,CLU,P010569,P012620,2.067,1,5,4
149,CLU,P010569,P012621,18.318,-5,34,39
149,CLU,P010569,P012698,5.484,-7,7,14
149,CLU,P010997,P011801,1.017,-1,2,3
149,CLU,P010997,P012620,1.017,-1,2,3
149,CLU,P011797,P011801,10.15,-1,19,20
149,CLU,P011797,P012620,2.967,1,5,4
149,CLU,P011797,P012621,21.067,3,44,41
149,CLU,P011797,P012698,7.834,-10,11,21
149,CLU,P011801,P012620,13.584,12,34,22
149,CLU,P011801,P012621,18.4,13,50,37
149,CLU,P011801,P012698,5.467,-4,6,10
149,CLU,P012620,P012621,10.5,12,33,21
149,CLU,P012620,P012698,3.234,2,4,2
149,CLU,P012621,P012698,5.0,-3,7,10
149,ULM,P005422,P007952,6.766,-2,10,12
149,ULM,P005422,P010106,19.216,-9,37,46
149,ULM,P005422,P010582,18.416,-7,35,42
149,ULM,P005422,P010726,3.25,-2,2,4
149,ULM,P005422,P011391,0.267,0,0,0
149,ULM,P005422,P011457,5.833,0,8,8
149,ULM,P005422,P012603,17.416,-11,31,42
149,ULM,P005422,P012604,16.216,-9,29,38
149,ULM,P005422,P012703,5.616,-4,4,8
149,ULM,P007952,P010106,5.766,12,22,10
149,ULM,P007952,P010582,7.016,-3,16,19
149,ULM,P007952,P010726,6.417,-8,7,15
149,ULM,P007952,P011457,10.683,6,25,19
149,ULM,P007952,P012603,3.533,7,13,6
149,ULM,P007952,P012703,9.883,4,23,19
149,ULM,P010106,P010582,24.732,-1,57,58
149,ULM,P010106,P011457,7.849,10,24,14
149,ULM,P010106,P012603,26.632,5,61,56
149,ULM,P010106,P012604,24.632,-6,50,56
149,ULM,P010106,P012703,12.765,13,37,24
149,ULM,P010582,P010726,5.567,-8,7,15
149,ULM,P010582,P011391,0.267,0,0,0
149,ULM,P010582,P011457,9.383,-7,16,23
149,ULM,P010582,P012603,21.699,-2,48,50
149,ULM,P010582,P012604,23.799,-6,48,54
149,ULM,P010582,P012703,13.449,-2,29,31
149,ULM,P010726,P011457,8.817,-10,9,19
149,ULM,P010726,P012604,2.4,-2,2,4
149,ULM,P010726,P012703,8.817,-10,9,19
149,ULM,P011391,P011457,0.267,0,0,0
149,ULM,P011391,P012703,0.267,0,0,0
149,ULM,P011457,P012603,4.083,9,13,4
149,ULM,P011457,P012604,6.316,-6,8,14
149,ULM,P011457,P012703,15.833,-2,29,31
149,ULM,P012603,P012604,23.282,-2,48,50
149,ULM,P012603,P012703,10.615,14,30,16
149,ULM,P012604,P012703,12.215,-1,23,24
150,ARI,P002867,P004292,1.45,-2,2,4
150,ARI,P002867,P012702,3.416,3,9,6
150,ARI,P002867,P012708,4.8,3,10,7
150,ARI,P002867,P012717,4.8,3,10,7
150,ARI,P002867,P012760,1.384,0,1,1
150,ARI,P002867,P012792,3.35,5,8,3
150,ARI,P003240,P004292,17.116,1,34,33
150,ARI,P003240,P012615,8.616,3,14,11
150,ARI,P003240,P012702,4.167,-9,2,11
150,ARI,P003240,P012708,17.417,-6,30,36
150,ARI,P003240,P012716,8.816,5,13,8
150,ARI,P003240,P012717,15.6,-5,26,31
150,ARI,P003240,P012722,0.483,0,0,0
150,ARI,P003240,P012760,19.566,7,38,31
150,ARI,P003240,P012792,5.083,-4,3,7
150,ARI,P004292,P012615,12.716,5,26,21
150,ARI,P004292,P012702,6.1,-9,9,18
150,ARI,P004292,P012708,21.617,-6,42,48
150,ARI,P004292,P012716,11.183,7,24,17
150,ARI,P004292,P012717,12.967,-5,25,30
150,ARI,P004292,P012722,0.483,0,0,0
150,ARI,P004292,P012760,19.1,9,42,33
150,ARI,P012615,P012702,7.184,-5,14,19
150,ARI,P012615,P012708,14.534,-1,31,32
150,ARI,P012615,P012716,18.067,5,38,33
150,ARI,P012615,P012717,0.0,0,0,0
150,ARI,P012615,P012722,0.883,0,2,2
150,ARI,P012615,P012760,11.533,8,24,16
150,ARI,P012615,P012792,4.867,-3,11,14
150,ARI,P012702,P012708,12.767,-7,25,32
150,ARI,P012702,P012716,7.184,-5,14,19
150,ARI,P012702,P012717,6.583,-4,11,15
150,ARI,P012702,P012792,7.667,0,16,16
150,ARI,P012708,P012716,13.001,1,29,28
150,ARI,P012708,P012717,18.667,-2,35,37
150,ARI,P012708,P012722,0.4,0,2,2
150,ARI,P012708,P012760,20.034,4,39,35
150,ARI,P012708,P012792,9.567,2,21,19
150,ARI,P012716,P012717,1.733,0,1,1
150,ARI,P012716,P012722,0.883,0,2,2
150,ARI,P012716,P012760,11.733,10,23,13
150,ARI,P012716,P012792,6.6,-3,12,15
150,ARI,P012717,P012760,13.817,2,25,23
150,ARI,P012717,P012792,7.433,3,11,8
150,ARI,P012722,P012792,0.4,0,2,2
150,ARI,P012760,P012792,4.233,0,4,4
150,BUD,P002740,P004945,17.25,8,35,27
150,BUD,P002740,P005637,13.284,-6,21,27
150,BUD,P002740,P008325,8.233,14,24,10
150,BUD,P002740,P010248,13.234,-10,21,31
150,BUD,P002740,P011281,8.183,2,19,17
150,BUD,P002740,P011935,8.666,10,24,14
150,BUD,P002740,P012606,12.9,2,26,24
150,BUD,P002740,P012630,4.25,-4,10,14
150,BUD,P004945,P005637,13.25,-6,18,24
150,BUD,P004945,P008325,10.016,14,23,9
150,BUD,P004945,P010248,12.567,-8,20,28
150,BUD,P004945,P011281,11.466,0,21,21
150,BUD,P004945,P011935,9.816,12,25,13
150,BUD,P004945,P012606,14.966,6,28,22
150,BUD,P004945,P012630,1.133,-2,2,4
150,BUD,P005637,P008325,4.667,-1,7,8
150,BUD,P005637,P009214,0.017,0,0,0
150,BUD,P005637,P010248,20.034,-4,35,39
150,BUD,P005637,P011281,13.6,-3,21,24
150,BUD,P005637,P011935,0.45,0,0,0
150,BUD,P005637,P012606,21.017,1,40,39
150,BUD,P005637,P012630,12.617,-1,26,27
150,BUD,P008325,P009214,1.683,-3,0,3
150,BUD,P008325,P011281,10.533,9,28,19
150,BUD,P008325,P011935,11.316,13,28,15
150,BUD,P008325,P012606,10.266,4,18,14
150,BUD,P008325,P012630,5.55,-2,12,14
150,BUD,P009214,P010248,0.9,-1,0,1
150,BUD,P009214,P011935,2.566,-4,0,4
150,BUD,P009214,P012606,2.583,-4,0,4
150,BUD,P009214,P012630,2.583,-4,0,4
150,BUD,P010248,P011281,12.4,-6,19,25
150,BUD,P010248,P011935,4.366,-9,5,14
150,BUD,P010248,P012606,21.133,-7,38,45
150,BUD,P010248,P012630,12.966,-7,22,29
150,BUD,P011281,P011935,9.399,6,26,20
150,BUD,P011281,P012606,14.783,1,28,27
150,BUD,P011281,P012630,11.5,3,26,23
150,BUD,P011935,P012606,10.382,-4,16,20
150,BUD,P011935,P012630,5.899,-8,8,16
150,BUD,P012606,P012630,17.566,-11,30,41
151,HTA,P003533,P004846,10.434,-10,24,34
151,HTA,P003533,P007759,4.4,-8,7,15
151,HTA,P003533,P007867,4.283,-3,12,15
151,HTA,P003533,P010465,8.434,-3,22,25
151,HTA,P003533,P010550,10.334,-2,27,29
151,HTA,P003533,P011973,2.1,-3,6,9
151,HTA,P003533,P011990,3.1,2,9,7
151,HTA,P003533,P012794,13.251,-9,33,42
151,HTA,P004846,P007759,12.6,-8,27,35
151,HTA,P004846,P007867,7.516,-10,15,25
151,HTA,P004846,P010465,13.834,-8,30,38
151,HTA,P004846,P010550,15.734,-7,35,42
151,HTA,P004846,P011973,15.4,-7,36,43
151,HTA,P004846,P011990,3.1,2,9,7
151,HTA,P004846,P012794,16.318,-8,40,48
151,HTA,P007759,P007867,16.349,3,48,45
151,HTA,P007759,P010465,18.666,-12,42,54
151,HTA,P007759,P010550,17.3,-4,43,47
151,HTA,P007759,P011973,21.899,-1,60,61
151,HTA,P007759,P012794,12.65,-6,33,39
151,HTA,P007867,P010465,13.299,5,38,33
151,HTA,P007867,P010550,15.166,1,43,42
151,HTA,P007867,P011973,18.232,3,53,50
151,HTA,P007867,P012794,13.883,1,43,42
151,HTA,P010465,P010550,21.85,3,58,55
151,HTA,P010465,P011973,21.033,-5,53,58
151,HTA,P010465,P012794,13.684,0,41,41
151,HTA,P010550,P011973,19.233,2,52,50
151,HTA,P010550,P011990,3.1,2,9,7
151,HTA,P010550,P012794,15.551,5,49,44
151,HTA,P011973,P012794,14.167,3,44,41
151,HTA,P011990,P012794,3.1,2,9,7
151,PMT,P001686,P002644,16.733,10,53,43
151,PMT,P001686,P005301,11.432,-3,24,27
151,PMT,P001686,P011823,17.265,-5,39,44
151,PMT,P001686,P011942,23.099,17,70,53
151,PMT,P001686,P011944,23.866,14,65,51
151,PMT,P001686,P011947,7.283,-7,19,26
151,PMT,P001686,P011966,10.132,-9,27,36
151,PMT,P001686,P012600,26.182,3,71,68
151,PMT,P002644,P005301,3.016,2,11,9
151,PMT,P002644,P010549,1.683,0,5,5
151,PMT,P002644,P011942,14.666,11,49,38
151,PMT,P002644,P011943,3.566,2,13,11
151,PMT,P002644,P011944,15.499,9,50,41
151,PMT,P002644,P011947,6.383,2,20,18
151,PMT,P002644,P011966,7.233,4,24,20
151,PMT,P002644,P012600,22.149,12,71,59
151,PMT,P005301,P010549,1.683,0,5,5
151,PMT,P005301,P011823,10.849,-4,21,25
151,PMT,P005301,P011942,7.316,3,22,19
151,PMT,P005301,P011944,10.249,0,24,24
151,PMT,P005301,P011947,1.25,0,2,2
151,PMT,P005301,P011966,3.616,-2,8,10
151,PMT,P005301,P012600,6.049,-4,11,15
151,PMT,P010549,P011944,1.683,0,5,5
151,PMT,P010549,P012600,1.683,0,5,5
151,PMT,P011823,P011942,10.216,5,27,22
151,PMT,P011823,P011944,11.566,3,25,22
151,PMT,P011823,P011947,3.433,-5,9,14
151,PMT,P011823,P011966,5.699,-8,14,22
151,PMT,P011823,P012600,10.032,-6,21,27
151,PMT,P011942,P011943,1.033,-2,3,5
151,PMT,P011942,P011944,22.099,16,67,51
151,PMT,P011942,P011966,2.783,0,9,9
151,PMT,P011942,P012600,18.316,14,57,43
151,PMT,P011943,P011944,1.033,-2,3,5
151,PMT,P011943,P011947,2.533,4,10,6
151,PMT,P011943,P011966,2.533,4,10,6
151,PMT,P011943,P012600,3.566,2,13,11
151,PMT,P011944,P012600,22.265,8,61,53
151,PMT,P011947,P011966,9.816,-3,29,32
151,PMT,P011947,P012600,8.566,-3,27,30
151,PMT,P011966,P012600,9.916,-2,31,33
152,JOV,P002507,P006771,13.167,-14,25,39
152,JOV,P002507,P010161,6.316,-5,12,17
152,JOV,P002507,P010458,11.032,-10,22,32
152,JOV,P002507,P010677,18.5,-5,40,45
152,JOV,P002507,P011247,21.05,-5,47,52
152,JOV,P002507,P011248,0.667,-2,0,2
152,JOV,P002507,P012349,9.284,3,22,19
152,JOV,P002507,P012780,2.367,-5,3,8
152,JOV,P002507,PJUG,8.617,-5,17,22
152,JOV,P006771,P010161,4.083,-2,6,8
152,JOV,P006771,P010458,11.716,-7,21,28
152,JOV,P006771,P010677,13.968,-9,28,37
152,JOV,P006771,P010708,0.033,0,0,0
152,JOV,P006771,P011247,22.468,-17,38,55
152,JOV,P006771,P011248,2.584,-1,3,4
152,JOV,P006771,P012349,10.968,-7,21,28
152,JOV,P006771,P012780,13.002,-6,23,29
152,JOV,P006771,PJUG,6.751,-5,15,20
152,JOV,P010161,P010458,6.999,-3,14,17
152,JOV,P010161,P010677,5.0,-4,8,12
152,JOV,P010161,P010708,0.033,0,0,0
152,JOV,P010161,P011247,8.499,6,19,13
152,JOV,P010161,P012349,2.783,2,5,3
152,JOV,P010161,P012780,3.85,4,7,3
152,JOV,P010161,PJUG,3.233,-2,5,7
152,JOV,P010458,P010677,9.133,-6,20,26
152,JOV,P010458,P011247,15.299,-2,31,33
152,JOV,P010458,P011248,0.533,0,0,0
152,JOV,P010458,P012349,0.167,2,2,0
152,JOV,P010458,P012780,4.583,2,7,5
152,JOV,P010458,PJUG,3.666,0,7,7
152,JOV,P010677,P011247,19.751,2,45,43
152,JOV,P010677,P011248,3.5,1,8,7
152,JOV,P010677,P012349,16.868,6,42,36
152,JOV,P010677,P012780,9.351,-3,18,21
152,JOV,P010677,PJUG,12.601,2,31,29
152,JOV,P010708,P011247,0.033,0,0,0
152,JOV,P010708,P012349,0.033,0,0,0
152,JOV,P011247,P011248,3.167,-1,3,4
152,JOV,P011247,P012349,14.601,8,35,27
152,JOV,P011247,P012780,13.701,-3,21,24
152,JOV,P011247,PJUG,11.767,8,29,21
152,JOV,P011248,P012349,6.134,0,11,11
152,JOV,P011248,P012780,6.0,2,11,9
152,JOV,P011248,PJUG,4.083,1,8,7
152,JOV,P012349,P012780,12.051,1,26,25
152,JOV,P012349,PJUG,13.251,9,36,27
152,JOV,P012780,PJUG,12.767,0,28,28
152,PRS,P004512,P005793,7.716,4,16,12
152,PRS,P004512,P011232,0.967,0,0,0
152,PRS,P004512,P012608,12.8,7,27,20
152,PRS,P004512,P012609,9.683,9,24,15
152,PRS,P004512,P012610,12.8,7,27,20
152,PRS,P004512,P012611,2.767,-2,3,5
152,PRS,P004512,P012613,1.617,-2,3,5
152,PRS,P004512,P012640,2.85,5,8,3
152,PRS,P005793,P012608,18.183,5,37,32
152,PRS,P005793,P012609,8.767,3,19,16
152,PRS,P005793,P012610,18.35,3,37,34
152,PRS,P005793,P012611,5.217,-9,5,14
152,PRS,P005793,P012613,10.634,-1,21,22
152,PRS,P005793,P012640,4.533,7,13,6
152,PRS,P011232,P012608,3.884,1,7,6
152,PRS,P011232,P012609,13.6,0,34,34
152,PRS,P011232,P012610,3.884,1,7,6
152,PRS,P011232,P012611,9.6,-1,21,22
152,PRS,P011232,P012612,14.067,4,38,34
152,PRS,P011232,P012613,9.517,-5,19,24
152,PRS,P011232,P012640,14.417,4,38,34
152,PRS,P012608,P012609,11.15,10,27,17
152,PRS,P012608,P012610,26.234,9,55,46
152,PRS,P012608,P012611,9.784,-12,11,23
152,PRS,P012608,P012612,0.467,4,4,0
152,PRS,P012608,P012613,14.584,-4,27,31
152,PRS,P012608,P012640,7.85,16,25,9
152,PRS,P012609,P012610,11.317,8,27,19
152,PRS,P012609,P012611,6.75,0,18,18
152,PRS,P012609,P012612,13.6,0,34,34
152,PRS,P012609,P012613,8.701,-3,19,22
152,PRS,P012609,P012640,16.1,5,42,37
152,PRS,P012610,P012611,9.951,-14,11,25
152,PRS,P012610,P012612,0.467,4,4,0
152,PRS,P012610,P012613,14.751,-6,27,33
152,PRS,P012610,P012640,7.85,16,25,9
152,PRS,P012611,P012612,6.533,2,18,16
152,PRS,P012611,P012613,8.801,-14,11,25
152,PRS,P012611,P012640,6.533,2,18,16
152,PRS,P012612,P012613,7.067,-2,16,18
152,PRS,P012612,P012640,14.067,4,38,34
152,PRS,P012613,P012640,11.6,5,29,24
153,BES,P003783,P007914,12.367,-6,20,26
153,BES,P003783,P007917,4.35,-6,6,12
153,BES,P003783,P008945,1.35,-1,3,4
153,BES,P003783,P011357,6.933,-1,14,15
153,BES,P003783,P011379,3.767,-6,7,13
153,BES,P003783,P011924,12.867,0,24,24
153,BES,P003783,P011936,4.45,-9,8,17
153,BES,P003783,P012622,7.034,6,19,13
153,BES,P003783,P012647,5.733,-13,6,19
153,BES,P003783,P012711,10.417,0,21,21
153,BES,P007914,P007917,4.317,-4,6,10
153,BES,P007914,P008945,7.717,-9,15,24
153,BES,P007914,P011357,4.533,-2,7,9
153,BES,P007914,P011379,0.65,-3,0,3
153,BES,P007914,P011924,8.967,4,16,12
153,BES,P007914,P011936,9.8,-20,16,36
153,BES,P007914,P012622,6.534,7,16,9
153,BES,P007914,P012647,10.617,-17,16,33
153,BES,P007914,P012711,14.834,-10,28,38
153,BES,P007917,P008945,7.017,-9,12,21
153,BES,P007917,P011379,5.0,-12,6,18
153,BES,P007917,P011924,7.75,-8,12,20
153,BES,P007917,P011936,0.95,-7,0,7
153,BES,P007917,P012622,5.667,-8,9,17
153,BES,P007917,P012647,5.017,-2,9,11
153,BES,P008945,P011379,10.683,-5,16,21
153,BES,P008945,P011924,4.75,-3,9,12
153,BES,P008945,P011936,17.966,-11,31,42
153,BES,P008945,P012622,18.066,-4,31,35
153,BES,P008945,P012647,15.583,-1,31,32
153,BES,P008945,P012711,13.0,-9,24,33
153,BES,P011357,P011379,1.917,0,5,5
153,BES,P011357,P011924,4.467,1,8,7
153,BES,P011357,P011936,2.466,-2,6,8
153,BES,P011357,P012622,2.4,1,7,6
153,BES,P011357,P012711,5.016,-1,9,10
153,BES,P011379,P011924,6.6,-8,11,19
153,BES,P011379,P011936,7.85,-3,12,15
153,BES,P011379,P012622,13.8,-8,23,31
153,BES,P011379,P012647,3.716,3,6,3
153,BES,P011379,P012711,3.817,-2,6,8
153,BES,P011924,P012622,9.367,3,21,18
153,BES,P011924,P012647,4.333,-6,6,12
153,BES,P011924,P012711,5.967,9,13,4
153,BES,P011936,P012622,14.416,-2,26,28
153,BES,P011936,P012647,14.316,-8,25,33
153,BES,P011936,P012711,17.45,-18,32,50
153,BES,P012622,P012647,10.249,5,19,14
153,BES,P012622,P012711,12.867,8,29,21
153,BES,P012647,P012711,10.3,-13,18,31
153,LLI,P004479,P004773,9.134,-2,14,16
153,LLI,P004479,P005247,7.801,3,16,13
153,LLI,P004479,P006600,1.984,1,5,4
153,LLI,P004479,P009649,4.867,1,8,7
153,LLI,P004479,P009680,1.433,-5,0,5
153,LLI,P004479,P012020,8.917,0,14,14
153,LLI,P004479,P012586,9.468,6,19,13
153,LLI,P004773,P005247,6.367,3,14,11
153,LLI,P004773,P006600,1.684,-4,3,7
153,LLI,P004773,P009649,7.267,-7,10,17
153,LLI,P004773,P009680,3.683,-9,3,12
153,LLI,P004773,P012020,13.25,-1,23,24
153,LLI,P004773,P012584,1.117,-3,2,5
153,LLI,P004773,P012585,1.3,-1,2,3
153,LLI,P004773,P012586,11.251,4,23,19
153,LLI,P004773,P012797,4.683,0,10,10
153,LLI,P005247,P006600,6.834,7,19,12
153,LLI,P005247,P009649,1.767,3,5,2
153,LLI,P005247,P009680,1.733,1,3,2
153,LLI,P005247,P012020,9.2,20,31,11
153,LLI,P005247,P012585,7.9,21,31,10
153,LLI,P005247,P012586,14.301,26,47,21
153,LLI,P005247,P012797,8.233,24,34,10
153,LLI,P006600,P009649,16.867,-1,32,33
153,LLI,P006600,P009680,16.433,-4,28,32
153,LLI,P006600,P012585,18.483,4,38,34
153,LLI,P006600,P012586,5.501,7,18,11
153,LLI,P006600,P012797,19.95,2,41,39
153,LLI,P009649,P009680,16.916,-12,25,37
153,LLI,P009649,P012020,7.567,-1,14,15
153,LLI,P009649,P012584,1.117,-3,2,5
153,LLI,P009649,P012585,15.4,2,31,29
153,LLI,P009649,P012586,7.518,10,21,11
153,LLI,P009649,P012797,18.45,0,36,36
153,LLI,P009680,P012020,2.216,-7,0,7
153,LLI,P009680,P012585,14.966,-2,25,27
153,LLI,P009680,P012797,17.216,-6,28,34
153,LLI,P012020,P012584,1.117,-3,2,5
153,LLI,P012020,P012585,6.117,18,26,8
153,LLI,P012020,P012586,15.851,25,47,22
153,LLI,P012020,P012797,8.033,21,31,10
153,LLI,P012584,P012586,1.117,-3,2,5
153,LLI,P012585,P012586,9.634,24,39,15
153,LLI,P012585,P012797,24.6,22,64,42
153,LLI,P012586,P012797,10.767,29,44,15
154,HAM,P001990,P009663,3.267,-4,8,12
154,HAM,P001990,P010070,6.434,-7,15,22
154,HAM,P001990,P011187,8.984,-15,17,32
154,HAM,P001990,P012579,4.517,-13,5,18
154,HAM,P001990,P012580,10.134,-13,23,36
154,HAM,P001990,P012581,6.617,-11,12,23
154,HAM,P001990,P012648,9.051,-13,20,33
154,HAM,P009663,P010070,7.783,4,24,20
154,HAM,P009663,P011168,14.017,-11,30,41
154,HAM,P009663,P012579,5.017,0,15,15
154,HAM,P009663,P012580,16.651,-25,31,56
154,HAM,P009663,P012581,17.933,-16,37,53
154,HAM,P009663,P012582,6.117,-11,9,20
154,HAM,P009663,P012648,11.8,-9,25,34
154,HAM,P009663,P012695,4.483,-4,9,13
154,HAM,P010070,P011168,3.199,-1,10,11
154,HAM,P010070,P011187,4.7,-12,7,19
154,HAM,P010070,P012579,5.183,-9,11,20
154,HAM,P010070,P012580,4.317,-1,13,14
154,HAM,P010070,P012581,6.849,0,18,18
154,HAM,P010070,P012648,8.617,-6,20,26
154,HAM,P010070,P012695,2.85,0,6,6
154,HAM,P011168,P011187,9.248,3,19,16
154,HAM,P011168,P012579,10.949,4,31,27
154,HAM,P011168,P012580,16.617,-12,32,44
154,HAM,P011168,P012581,19.665,-11,38,49
154,HAM,P011168,P012582,10.616,-5,17,22
154,HAM,P011168,P012648,8.749,1,19,18
154,HAM,P011187,P012579,10.449,-9,21,30
154,HAM,P011187,P012580,11.733,-4,27,31
154,HAM,P011187,P012581,12.832,-10,22,32
154,HAM,P011187,P012582,4.499,6,8,2
154,HAM,P011187,P012648,10.483,-7,23,30
154,HAM,P012579,P012580,8.567,-7,21,28
154,HAM,P012579,P012581,8.899,-6,20,26
154,HAM,P012579,P012582,2.533,6,6,0
154,HAM,P012579,P012648,5.75,-2,14,16
154,HAM,P012580,P012581,21.267,-30,36,66
154,HAM,P012580,P012582,7.2,-9,11,20
154,HAM,P012580,P012648,15.417,-11,35,46
154,HAM,P012580,P012695,1.633,-4,3,7
154,HAM,P012581,P012582,10.616,-5,17,22
154,HAM,P012581,P012648,13.899,-11,27,38
154,HAM,P012581,P012695,4.483,-4,9,13
154,HAM,P012582,P012648,0.883,-2,0,2
154,HAM,P012648,P012695,4.483,-4,9,13
154,LJU,P002561,P003452,8.134,11,28,17
154,LJU,P002561,P003514,8.767,8,24,16
154,LJU,P002561,P007066,8.767,8,24,16
154,LJU,P002561,P009392,6.3,5,16,11
154,LJU,P002561,P009395,1.9,-3,4,7
154,LJU,P002561,P010594,7.95,-2,20,22
154,LJU,P002561,P010771,3.583,-2,8,10
154,LJU,P002561,P010912,3.583,-2,8,10
154,LJU,P002561,P011261,6.116,-8,8,16
154,LJU,P002561,P012700,1.9,-3,4,7
154,LJU,P003452,P003514,8.584,10,28,18
154,LJU,P003452,P005969,15.651,22,50,28
154,LJU,P003452,P007066,6.234,14,24,10
154,LJU,P003452,P009392,6.167,17,24,7
154,LJU,P003452,P009395,18.434,21,56,35
154,LJU,P003452,P010594,18.501,18,56,38
154,LJU,P003452,P011261,0.883,2,2,0
154,LJU,P003452,P012700,16.084,25,52,27
154,LJU,P003514,P005969,7.516,-10,17,27
154,LJU,P003514,P007066,14.333,7,39,32
154,LJU,P003514,P009392,10.682,2,26,24
154,LJU,P003514,P009395,2.833,-7,4,11
154,LJU,P003514,P010594,6.484,-2,17,19
154,LJU,P003514,P011261,4.599,-7,4,11
154,LJU,P003514,P012700,4.866,-1,13,14
154,LJU,P005969,P007066,6.849,3,19,16
154,LJU,P005969,P009392,7.582,3,21,18
154,LJU,P005969,P009395,16.134,19,50,31
154,LJU,P005969,P010594,17.284,23,55,32
154,LJU,P005969,P010771,1.883,4,7,3
154,LJU,P005969,P010912,0.6,4,4,0
154,LJU,P005969,P011261,4.349,5,13,8
154,LJU,P005969,P012700,21.616,31,68,37
154,LJU,P007066,P009392,10.599,7,28,21
154,LJU,P007066,P010594,5.017,4,15,11
154,LJU,P007066,P011261,4.999,-5,6,11
154,LJU,P007066,P012700,5.666,6,17,11
154,LJU,P009392,P009395,2.883,3,8,5
154,LJU,P009392,P010771,1.283,0,3,3
154,LJU,P009392,P011261,7.165,-3,11,14
154,LJU,P009392,P012700,6.399,6,19,13
154,LJU,P009395,P010594,16.034,15,48,33
154,LJU,P009395,P011261,0.883,2,2,0
154,LJU,P009395,P012700,16.567,22,52,30
154,LJU,P010594,P010771,4.183,2,12,10
154,LJU,P010594,P010912,4.183,2,12,10
154,LJU,P010594,P011261,4.183,2,12,10
154,LJU,P010594,P012700,17.117,22,53,31
154,LJU,P010771,P010912,4.183,2,12,10
154,LJU,P010771,P011261,5.466,2,15,13
154,LJU,P010771,P012700,1.283,0,3,3
154,LJU,P010912,P011261,4.183,2,12,10
154,LJU,P011261,P012700,2.566,4,7,3
155,VNC,P003759,P004117,9.917,-11,10,21
155,VNC,P003759,P004381,21.734,5,41,36
155,VNC,P003759,P008052,12.933,1,19,18
155,VNC,P003759,P009400,19.117,14,42,28
155,VNC,P003759,P011928,10.501,0,21,21
155,VNC,P003759,P012259,23.617,-4,38,42
155,VNC,P003759,P012587,7.117,3,13,10
155,VNC,P004117,P004381,19.584,-26,18,44
155,VNC,P004117,P008052,12.767,-16,11,27
155,VNC,P004117,P009400,10.434,-11,11,22
155,VNC,P004117,P011928,12.067,-22,10,32
155,VNC,P004117,P012259,16.201,-25,16,41
155,VNC,P004117,P012587,9.917,-11,8,19
155,VNC,P004117,P012588,0.517,-2,0,2
155,VNC,P004381,P008052,16.866,-4,22,26
155,VNC,P004381,P009400,26.017,4,45,41
155,VNC,P004381,P011928,21.284,-16,30,46
155,VNC,P004381,P012259,26.067,-13,39,52
155,VNC,P004381,P012587,9.267,0,13,13
155,VNC,P004381,P012588,0.517,-2,0,2
155,VNC,P008052,P009400,11.233,5,18,13
155,VNC,P008052,P011928,6.133,-8,6,14
155,VNC,P008052,P012259,19.233,-9,25,34
155,VNC,P008052,P012587,6.967,-5,7,12
155,VNC,P009400,P011928,13.867,-2,23,25
155,VNC,P009400,P012259,18.317,2,34,32
155,VNC,P009400,P012587,10.834,-2,15,17
155,VNC,P009400,P012588,0.517,-2,0,2
155,VNC,P011928,P012259,14.317,-16,19,35
155,VNC,P011928,P012587,6.967,0,11,11
155,VNC,P012259,P012587,4.667,-5,5,10
155,VNC,P012259,P012588,0.517,-2,0,2
155,WOL,P002387,P005516,25.266,19,54,35
155,WOL,P002387,P006154,14.766,1,25,24
155,WOL,P002387,P006546,14.716,3,28,25
155,WOL,P002387,P006907,12.016,16,33,17
155,WOL,P002387,P012576,21.066,11,42,31
155,WOL,P002387,P012577,11.683,15,28,13
155,WOL,P002387,P012789,5.083,7,14,7
155,WOL,P004645,P005516,8.917,-4,12,16
155,WOL,P004645,P006154,10.684,3,14,11
155,WOL,P004645,P006546,7.051,-2,11,13
155,WOL,P004645,P006907,2.617,2,4,2
155,WOL,P004645,P012576,1.334,-4,0,4
155,WOL,P004645,P012577,12.284,1,16,15
155,WOL,P004645,P012789,12.517,4,19,15
155,WOL,P005516,P006154,19.883,1,30,29
155,WOL,P005516,P006546,17.617,-1,31,32
155,WOL,P005516,P006907,11.916,18,34,16
155,WOL,P005516,P012576,22.15,7,42,35
155,WOL,P005516,P012577,18.95,12,37,25
155,WOL,P005516,P012789,12.033,8,24,16
155,WOL,P006154,P006546,12.367,-1,19,20
155,WOL,P006154,P006907,3.25,1,6,5
155,WOL,P006154,P012576,12.934,-5,19,24
155,WOL,P006154,P012577,15.4,7,23,16
155,WOL,P006154,P012789,12.516,9,20,11
155,WOL,P006546,P006907,7.033,4,17,13
155,WOL,P006546,P012576,14.7,2,26,24
155,WOL,P006546,P012577,6.517,0,11,11
155,WOL,P006546,P012789,7.067,-1,13,14
155,WOL,P006907,P012576,9.466,12,23,11
155,WOL,P006907,P012577,7.067,13,17,4
155,WOL,P006907,P012789,5.167,6,14,8
155,WOL,P012576,P012577,7.95,5,16,11
155,WOL,P012577,P012789,16.017,11,28,17
156,ARI,P002867,P004292,4.95,5,9,4
156,ARI,P002867,P012615,6.283,-6,10,16
156,ARI,P002867,P012708,7.633,0,13,13
156,ARI,P002867,P012716,2.55,0,4,4
156,ARI,P002867,P012717,4.95,5,9,4
156,ARI,P002867,P012760,9.133,1,15,14
156,ARI,P002867,P012792,5.233,-5,8,13
156,ARI,P004292,P012615,15.001,0,31,31
156,ARI,P004292,P012702,17.301,-11,28,39
156,ARI,P004292,P012708,20.051,-2,34,36
156,ARI,P004292,P012716,23.567,-6,36,42
156,ARI,P004292,P012717,19.667,-5,27,32
156,ARI,P004292,P012760,12.75,10,23,13
156,ARI,P004292,P012792,11.117,1,24,23
156,ARI,P012615,P012702,8.851,0,18,18
156,ARI,P012615,P012708,7.751,-5,16,21
156,ARI,P012615,P012716,14.384,2,25,23
156,ARI,P012615,P012717,5.567,-4,7,11
156,ARI,P012615,P012760,10.983,-4,19,23
156,ARI,P012615,P012792,16.584,-3,30,33
156,ARI,P012702,P012708,14.184,-12,24,36
156,ARI,P012702,P012716,18.284,-10,30,40
156,ARI,P012702,P012717,12.984,-13,20,33
156,ARI,P012702,P012792,10.4,-2,20,22
156,ARI,P012708,P012716,15.534,-7,24,31
156,ARI,P012708,P012717,21.501,-5,34,39
156,ARI,P012708,P012760,10.7,5,19,14
156,ARI,P012708,P012792,8.25,-6,16,22
156,ARI,P012716,P012717,16.167,-9,20,29
156,ARI,P012716,P012760,10.383,3,17,14
156,ARI,P012716,P012792,15.667,-1,32,33
156,ARI,P012717,P012760,8.833,8,12,4
156,ARI,P012717,P012792,3.667,-1,7,8
156,ARI,P012760,P012792,9.15,-3,19,22
156,BOU,P000498,P004525,13.45,2,29,27
156,BOU,P000498,P010431,1.866,1,3,2
156,BOU,P000498,P010718,1.116,2,2,0
156,BOU,P000498,P011161,14.2,2,29,27
156,BOU,P000498,P011836,2.616,1,3,2
156,BOU,P000498,P011837,2.066,-2,3,5
156,BOU,P000498,P012618,14.0,5,29,24
156,BOU,P000498,P012628,14.95,1,30,29
156,BOU,P004525,P010431,3.634,5,8,3
156,BOU,P004525,P010718,3.8,0,6,6
156,BOU,P004525,P011161,13.616,-3,27,30
156,BOU,P004525,P011837,5.3,-1,8,9
156,BOU,P004525,P012617,3.8,0,6,6
156,BOU,P004525,P012618,11.95,3,27,24
156,BOU,P004525,P012628,13.45,2,29,27
156,BOU,P010431,P010718,22.349,8,44,36
156,BOU,P010431,P011836,20.165,4,39,35
156,BOU,P010431,P011837,19.283,6,37,31
156,BOU,P010431,P012617,21.933,8,44,36
156,BOU,P010431,P012618,4.516,3,10,7
156,BOU,P010431,P012628,1.45,1,3,2
156,BOU,P010718,P011161,2.7,-1,2,3
156,BOU,P010718,P011836,21.249,7,40,33
156,BOU,P010718,P011837,19.016,2,34,32
156,BOU,P010718,P012617,23.933,5,44,39
156,BOU,P010718,P012618,6.033,5,12,7
156,BOU,P011161,P011836,2.584,2,2,0
156,BOU,P011161,P011837,1.666,-6,0,6
156,BOU,P011161,P012617,2.0,-3,0,3
156,BOU,P011161,P012618,14.534,5,29,24
156,BOU,P011161,P012628,13.5,0,27,27
156,BOU,P011836,P011837,15.649,1,29,28
156,BOU,P011836,P012617,20.133,5,38,33
156,BOU,P011836,P012618,7.1,5,12,7
156,BOU,P011836,P012628,1.5,-1,1,2
156,BOU,P011837,P012617,18.883,2,34,32
156,BOU,P011837,P012628,1.933,-2,3,5
156,BOU,P012617,P012618,5.05,3,10,7
156,BOU,P012618,P012628,13.017,3,27,24
157,BUD,P002740,P004945,18.349,-1,32,33
157,BUD,P002740,P005637,12.383,8,22,14
157,BUD,P002740,P008325,12.517,0,21,21
157,BUD,P002740,P010248,16.866,-3,29,32
157,BUD,P002740,P011281,21.05,-6,36,42
157,BUD,P002740,P011935,16.767,-11,28,39
157,BUD,P002740,P012606,11.5,2,19,17
157,BUD,P002740,P012630,8.1,-1,13,14
157,BUD,P004945,P005637,13.682,-2,23,25
157,BUD,P004945,P008325,7.216,-1,12,13
157,BUD,P004945,P010248,14.199,-8,24,32
157,BUD,P004945,P011281,15.882,-11,26,37
157,BUD,P004945,P011935,7.733,-7,13,20
157,BUD,P004945,P012606,8.599,-6,14,20
157,BUD,P005637,P008325,12.167,10,28,18
157,BUD,P005637,P009214,0.867,-5,0,5
157,BUD,P005637,P010248,10.466,-3,17,20
157,BUD,P005637,P011281,20.233,8,41,33
157,BUD,P005637,P012606,13.55,5,30,25
157,BUD,P005637,P012630,7.184,7,19,12
157,BUD,P008325,P009214,2.35,-8,0,8
157,BUD,P008325,P011281,16.067,9,35,26
157,BUD,P008325,P011935,14.35,-6,21,27
157,BUD,P008325,P012606,25.733,6,47,41
157,BUD,P008325,P012630,16.6,6,32,26
157,BUD,P009214,P011935,1.483,-3,0,3
157,BUD,P009214,P012606,2.35,-8,0,8
157,BUD,P009214,P012630,2.35,-8,0,8
157,BUD,P010248,P011281,18.249,-8,31,39
157,BUD,P010248,P011935,7.783,-5,14,19
157,BUD,P010248,P012606,1.383,-5,2,7
157,BUD,P010248,P012630,4.05,0,7,7
157,BUD,P011281,P011935,13.85,-7,25,32
157,BUD,P011281,P012606,16.433,6,35,29
157,BUD,P011281,P012630,15.5,13,35,22
157,BUD,P011935,P012606,13.333,-4,19,23
157,BUD,P011935,P012630,13.233,-1,20,21
157,BUD,P012606,P012630,15.583,8,30,22
157,ULM,P005422,P007952,5.566,6,12,6
157,ULM,P005422,P010106,15.466,-3,24,27
157,ULM,P005422,P010582,18.816,-8,26,34
157,ULM,P005422,P010726,7.383,12,18,6
157,ULM,P005422,P011457,7.133,4,12,8
157,ULM,P005422,P012603,20.199,2,34,32
157,ULM,P005422,P012604,21.766,0,34,34
157,ULM,P005422,P012703,12.999,11,24,13
157,ULM,P007952,P010106,5.266,2,11,9
157,ULM,P007952,P010582,4.299,6,12,6
157,ULM,P007952,P010726,10.349,10,23,13
157,ULM,P007952,P011457,10.382,6,21,15
157,ULM,P007952,P012603,3.816,8,12,4
157,ULM,P007952,P012703,10.382,6,21,15
157,ULM,P010106,P010582,21.449,4,41,37
157,ULM,P010106,P010726,5.266,2,11,9
157,ULM,P010106,P011457,7.083,-9,14,23
157,ULM,P010106,P012603,26.532,0,53,53
157,ULM,P010106,P012604,24.399,-5,46,51
157,ULM,P010106,P012703,13.199,-3,28,31
157,ULM,P010582,P010726,2.133,5,7,2
157,ULM,P010582,P011457,4.999,-6,5,11
157,ULM,P010582,P012603,27.865,3,50,47
157,ULM,P010582,P012604,25.099,-7,38,45
157,ULM,P010582,P012703,12.932,-1,21,22
157,ULM,P010726,P011457,8.733,5,16,11
157,ULM,P010726,P012603,3.916,9,13,4
157,ULM,P010726,P012604,2.3,4,6,2
157,ULM,P010726,P012703,10.516,9,22,13
157,ULM,P011457,P012603,7.416,-8,15,23
157,ULM,P011457,P012604,7.3,-13,10,23
157,ULM,P011457,P012703,17.682,-7,31,38
157,ULM,P012603,P012604,30.915,-5,56,61
157,ULM,P012603,P012703,18.265,3,39,36
157,ULM,P012604,P012703,18.149,-2,34,36
158,CLU,P005113,P005714,6.133,-4,11,15
158,CLU,P005113,P010569,16.65,4,34,30
158,CLU,P005113,P011797,22.783,0,45,45
158,CLU,P005113,P011801,19.883,13,43,30
158,CLU,P005113,P012621,15.2,-9,24,33
158,CLU,P005113,P012698,10.483,-4,23,27
158,CLU,P005373,P005714,13.068,-2,28,30
158,CLU,P005373,P010569,3.467,6,11,5
158,CLU,P005373,P011797,9.501,9,26,17
158,CLU,P005373,P011801,12.101,2,32,30
158,CLU,P005373,P012620,3.034,-8,0,8
158,CLU,P005373,P012621,9.801,9,26,17
158,CLU,P005373,P012698,15.168,0,33,33
158,CLU,P005714,P011797,13.3,0,30,30
158,CLU,P005714,P011801,16.417,3,41,38
158,CLU,P005714,P012620,2.584,-8,0,8
158,CLU,P005714,P012621,9.667,-1,22,23
158,CLU,P005714,P012698,18.367,-8,40,48
158,CLU,P010569,P011797,19.667,10,45,35
158,CLU,P010569,P011801,16.25,13,38,25
158,CLU,P010569,P012620,0.45,0,0,0
158,CLU,P010569,P012621,16.017,2,32,30
158,CLU,P010569,P012698,7.967,5,20,15
158,CLU,P011797,P011801,26.2,21,66,45
158,CLU,P011797,P012621,21.117,-2,41,43
158,CLU,P011797,P012698,19.3,2,47,45
158,CLU,P011801,P012620,2.467,-8,0,8
158,CLU,P011801,P012621,18.35,12,45,33
158,CLU,P011801,P012698,19.0,8,51,43
158,CLU,P012620,P012621,0.567,0,0,0
158,CLU,P012620,P012698,3.034,-8,0,8
158,CLU,P012621,P012698,12.017,-7,26,33
158,TRN,P001479,P006382,9.267,4,20,16
158,TRN,P001479,P007828,0.033,0,0,0
158,TRN,P001479,P009903,8.25,-1,18,19
158,TRN,P001479,P012593,5.467,-4,12,16
158,TRN,P001479,P012594,11.7,-1,23,24
158,TRN,P001479,P012595,6.5,-4,9,13
158,TRN,P001479,P012596,4.317,-2,5,7
158,TRN,P001479,P012597,4.734,-4,5,9
158,TRN,P005059,P005738,22.968,-1,51,52
158,TRN,P005059,P006382,0.567,-3,0,3
158,TRN,P005059,P009903,11.667,-4,27,31
158,TRN,P005059,P012593,11.717,5,28,23
158,TRN,P005059,P012595,11.451,-4,26,30
158,TRN,P005059,P012596,10.534,4,21,17
158,TRN,P005059,P012597,22.968,-1,51,52
158,TRN,P005738,P006382,2.351,-3,2,5
158,TRN,P005738,P009903,13.301,1,34,33
158,TRN,P005738,P012593,13.034,8,33,25
158,TRN,P005738,P012594,2.684,-1,7,8
158,TRN,P005738,P012595,15.919,-5,35,40
158,TRN,P005738,P012596,13.368,-2,23,25
158,TRN,P005738,P012597,26.119,-5,55,60
158,TRN,P006382,P007828,0.033,0,0,0
158,TRN,P006382,P009903,6.917,6,20,14
158,TRN,P006382,P012593,3.817,1,12,11
158,TRN,P006382,P012594,9.267,4,20,16
158,TRN,P006382,P012595,5.034,3,8,5
158,TRN,P006382,P012596,4.651,-5,2,7
158,TRN,P006382,P012597,4.568,-3,4,7
158,TRN,P007828,P009903,0.033,0,0,0
158,TRN,P007828,P012594,0.033,0,0,0
158,TRN,P009903,P012593,13.584,-2,31,33
158,TRN,P009903,P012594,8.7,4,23,19
158,TRN,P009903,P012595,10.901,0,26,26
158,TRN,P009903,P012597,12.851,-4,29,33
158,TRN,P012593,P012594,5.917,1,17,16
158,TRN,P012593,P012595,3.684,-3,8,11
158,TRN,P012593,P012596,4.2,7,11,4
158,TRN,P012593,P012597,12.584,3,28,25
158,TRN,P012594,P012595,8.317,-3,16,19
158,TRN,P012594,P012596,5.684,-6,7,13
158,TRN,P012594,P012597,5.234,-6,7,13
158,TRN,P012595,P012596,10.751,-8,15,23
158,TRN,P012595,P012597,17.119,-12,33,45
158,TRN,P012596,P012597,17.235,-4,28,32
159,CAN,P001607,P003637,0.683,0,0,0
159,CAN,P001607,P004160,14.95,11,33,22
159,CAN,P001607,P004466,8.483,2,17,15
159,CAN,P001607,P005005,5.25,8,13,5
159,CAN,P001607,P006588,0.55,0,0,0
159,CAN,P001607,P007560,1.9,1,3,2
159,CAN,P001607,P007644,7.083,6,16,10
159,CAN,P001607,P009864,6.183,3,15,12
159,CAN,P001607,P010385,9.45,8,18,10
159,CAN,P001607,P010452,8.0,5,17,12
159,CAN,P003425,P003637,15.633,12,41,29
159,CAN,P003425,P004160,2.034,1,4,3
159,CAN,P003425,P004466,0.767,-2,0,2
159,CAN,P003425,P005005,9.883,11,30,19
159,CAN,P003425,P006588,10.634,11,32,21
159,CAN,P003425,P007560,7.017,4,15,11
159,CAN,P003425,P007644,4.75,3,9,6
159,CAN,P003425,P009864,8.284,5,20,15
159,CAN,P003425,P010385,9.383,8,25,17
159,CAN,P003425,P010452,2.283,-1,4,5
159,CAN,P003637,P005005,9.299,8,26,18
159,CAN,P003637,P006588,8.6,10,28,18
159,CAN,P003637,P007560,7.017,4,15,11
159,CAN,P003637,P007644,4.75,3,9,6
159,CAN,P003637,P009864,6.25,4,16,12
159,CAN,P003637,P010385,10.066,8,25,17
159,CAN,P003637,P010452,2.966,-1,4,5
159,CAN,P004160,P004466,15.949,0,31,31
159,CAN,P004160,P005005,7.467,14,23,9
159,CAN,P004160,P006588,4.217,4,10,6
159,CAN,P004160,P007560,6.966,-2,11,13
159,CAN,P004160,P007644,12.149,3,24,21
159,CAN,P004160,P009864,10.333,9,27,18
159,CAN,P004160,P010385,8.767,8,18,10
159,CAN,P004160,P010452,11.9,0,23,23
159,CAN,P004466,P005005,1.633,3,6,3
159,CAN,P004466,P006588,2.95,1,6,5
159,CAN,P004466,P007560,5.066,-3,8,11
159,CAN,P004466,P007644,9.999,-3,17,20
159,CAN,P004466,P009864,9.066,6,23,17
159,CAN,P004466,P010385,2.3,-1,2,3
159,CAN,P004466,P010452,7.583,-3,14,17
159,CAN,P005005,P006588,9.033,13,30,17
159,CAN,P005005,P007644,3.2,6,9,3
159,CAN,P005005,P009864,5.833,9,18,9
159,CAN,P005005,P010385,10.933,13,31,18
159,CAN,P005005,P010452,4.533,3,10,7
159,CAN,P006588,P007560,2.467,3,8,5
159,CAN,P006588,P009864,7.134,9,20,11
159,CAN,P006588,P010385,5.683,5,18,13
159,CAN,P007560,P007644,8.766,0,15,15
159,CAN,P007560,P009864,3.8,3,10,7
159,CAN,P007560,P010385,5.6,4,10,6
159,CAN,P007560,P010452,7.333,-6,9,15
159,CAN,P007644,P009864,4.166,3,11,8
159,CAN,P007644,P010385,8.15,8,16,8
159,CAN,P007644,P010452,4.583,-5,6,11
159,CAN,P009864,P010452,5.283,1,12,11
159,CAN,P010385,P010452,5.0,3,9,6
159,WRO,P003034,P005531,5.284,-4,9,13
159,WRO,P003034,P011900,14.333,-12,22,34
159,WRO,P003034,P011901,11.034,-3,17,20
159,WRO,P003034,P011902,4.467,5,11,6
159,WRO,P003034,P012094,9.933,-7,19,26
159,WRO,P003034,P012308,4.467,5,11,6
159,WRO,P003034,P012601,3.601,-1,6,7
159,WRO,P003034,P012699,11.733,-3,22,25
159,WRO,P003034,P012736,17.016,0,31,31
159,WRO,P005531,P009896,18.934,-17,31,48
159,WRO,P005531,P011900,9.384,-6,14,20
159,WRO,P005531,P011901,10.318,-13,13,26
159,WRO,P005531,P011902,0.933,0,2,2
159,WRO,P005531,P012094,11.25,-8,23,31
159,WRO,P005531,P012308,1.35,-5,0,5
159,WRO,P005531,P012601,19.935,-18,33,51
159,WRO,P005531,P012699,14.484,-10,26,36
159,WRO,P005531,P012736,5.0,-3,9,12
159,WRO,P009896,P011900,5.767,0,9,9
159,WRO,P009896,P011901,7.634,-8,9,17
159,WRO,P009896,P011902,1.533,-2,2,4
159,WRO,P009896,P012094,11.083,-10,21,31
159,WRO,P009896,P012308,1.95,-7,0,7
159,WRO,P009896,P012601,18.001,-17,29,46
159,WRO,P009896,P012699,9.467,-9,17,26
159,WRO,P009896,P012736,3.767,-6,6,12
159,WRO,P011900,P011901,9.767,-10,9,19
159,WRO,P011900,P012094,10.833,-7,21,28
159,WRO,P011900,P012601,7.701,-3,11,14
159,WRO,P011900,P012699,10.066,-5,18,23
159,WRO,P011900,P012736,12.549,-5,20,25
159,WRO,P011901,P011902,3.667,6,9,3
159,WRO,P011901,P012094,2.333,-4,2,6
159,WRO,P011901,P012308,5.017,1,9,8
159,WRO,P011901,P012601,11.235,-9,15,24
159,WRO,P011901,P012699,3.9,-3,5,8
159,WRO,P011901,P012736,9.767,-1,16,17
159,WRO,P011902,P012094,2.333,-3,4,7
159,WRO,P011902,P012308,5.067,3,11,8
159,WRO,P011902,P012736,6.0,3,13,10
159,WRO,P012094,P012308,1.4,-3,2,5
159,WRO,P012094,P012601,9.55,-8,19,27
159,WRO,P012094,P012699,14.65,-9,30,39
159,WRO,P012094,P012736,10.699,-9,19,28
159,WRO,P012308,P012601,1.35,-5,0,5
159,WRO,P012308,P012736,5.067,3,11,8
159,WRO,P012601,P012699,11.134,-7,21,28
159,WRO,P012601,P012736,3.901,-4,6,10
159,WRO,P012699,P012736,9.366,-2,17,19
160,LKB,P004868,P005521,8.351,-2,17,19
160,LKB,P004868,P006230,8.334,-6,16,22
160,LKB,P004868,P006901,0.15,2,2,0
160,LKB,P004868,P007029,26.85,-3,48,51
160,LKB,P004868,P009898,18.35,4,38,34
160,LKB,P004868,P010190,10.033,-4,15,19
160,LKB,P004868,P010461,20.7,5,39,34
160,LKB,P004868,PLXI,23.368,0,45,45
160,LKB,P005521,P006230,7.668,-6,16,22
160,LKB,P005521,P006901,4.884,0,12,12
160,LKB,P005521,P007029,12.067,-15,21,36
160,LKB,P005521,P009898,10.484,-10,20,30
160,LKB,P005521,P010190,1.867,-3,3,6
160,LKB,P005521,P010461,9.3,-8,17,25
160,LKB,P005521,PLXI,13.251,-12,26,38
160,LKB,P006230,P006901,4.034,-1,10,11
160,LKB,P006230,P007029,10.167,-8,18,26
160,LKB,P006230,P009898,9.584,-4,20,24
160,LKB,P006230,P010190,4.5,-4,7,11
160,LKB,P006230,PLXI,9.117,-7,17,24
160,LKB,P006901,P007029,4.366,-3,7,10
160,LKB,P006901,P009898,5.05,-1,9,10
160,LKB,P006901,P010190,1.05,0,3,3
160,LKB,P006901,P010461,3.199,-1,4,5
160,LKB,P006901,PLXI,6.199,-4,9,13
160,LKB,P007029,P009898,22.532,-6,43,49
160,LKB,P007029,P010190,11.083,-4,18,22
160,LKB,P007029,P010461,24.932,-8,43,51
160,LKB,P007029,PLXI,28.399,-17,46,63
160,LKB,P009898,P010190,2.983,3,8,5
160,LKB,P009898,P010461,17.699,-3,33,36
160,LKB,P009898,PLXI,22.45,-11,41,52
160,LKB,P010190,P010461,6.583,0,11,11
160,LKB,P010190,PLXI,6.233,-4,7,11
160,LKB,P010461,PLXI,24.183,-9,41,50
160,TTK,P004801,P005000,9.299,-2,17,19
160,TTK,P004801,P006693,17.883,-3,28,31
160,TTK,P004801,P006883,18.799,8,37,29
160,TTK,P004801,P009845,6.816,-7,9,16
160,TTK,P004801,P011834,16.216,-2,27,29
160,TTK,P004801,P011925,17.983,2,30,28
160,TTK,P005000,P006693,18.65,10,49,39
160,TTK,P005000,P006883,21.616,17,58,41
160,TTK,P005000,P009845,8.999,-1,16,17
160,TTK,P005000,P010477,11.15,3,24,21
160,TTK,P005000,P011272,0.05,-1,0,1
160,TTK,P005000,P011834,14.249,13,38,25
160,TTK,P005000,P011925,22.983,17,58,41
160,TTK,P006693,P006883,25.65,20,65,45
160,TTK,P006693,P009845,6.25,-9,7,16
160,TTK,P006693,P010477,7.767,0,20,20
160,TTK,P006693,P011834,21.633,14,52,38
160,TTK,P006693,P011925,29.767,12,67,55
160,TTK,P006883,P009845,3.866,2,9,7
160,TTK,P006883,P010477,8.65,3,20,17
160,TTK,P006883,P011272,0.05,-1,0,1
160,TTK,P006883,P011834,26.382,20,61,41
160,TTK,P006883,P011925,29.983,27,74,47
160,TTK,P009845,P010477,3.3,0,7,7
160,TTK,P009845,P011834,2.75,-8,2,10
160,TTK,P009845,P011925,8.483,-5,14,19
160,TTK,P010477,P011834,4.983,3,10,7
160,TTK,P010477,P011925,11.95,3,27,24
160,TTK,P011272,P011834,0.05,-1,0,1
160,TTK,P011272,P011925,0.05,-1,0,1
160,TTK,P011834,P011925,23.733,17,54,37
161,PMT,P001686,P002020,1.433,-3,2,5
161,PMT,P001686,P002644,9.467,-13,23,36
161,PMT,P001686,P005301,7.649,-10,14,24
161,PMT,P001686,P010549,2.767,-7,3,10
161,PMT,P001686,P011823,9.583,-15,14,29
161,PMT,P001686,P011942,9.05,-18,17,35
161,PMT,P001686,P011943,2.2,-4,3,7
161,PMT,P001686,P011944,8.317,-14,12,26
161,PMT,P001686,P011947,7.6,-8,18,26
161,PMT,P001686,P011966,10.55,-10,25,35
161,PMT,P001686,P012600,7.584,-10,17,27
161,PMT,P002020,P002644,1.866,4,6,2
161,PMT,P002020,P005301,7.366,9,23,14
161,PMT,P002020,P011823,9.066,8,26,18
161,PMT,P002020,P011942,7.066,10,22,12
161,PMT,P002020,P011944,9.699,13,29,16
161,PMT,P002020,P011947,3.566,3,9,6
161,PMT,P002020,P011966,1.233,-1,3,4
161,PMT,P002020,P012600,2.433,5,8,3
161,PMT,P002644,P005301,14.165,0,31,31
161,PMT,P002644,P010549,7.4,-5,12,17
161,PMT,P002644,P011823,0.85,-2,0,2
161,PMT,P002644,P011942,7.683,-15,17,32
161,PMT,P002644,P011943,6.45,0,12,12
161,PMT,P002644,P011944,7.6,-5,12,17
161,PMT,P002644,P011947,5.75,1,17,16
161,PMT,P002644,P011966,12.932,-6,36,42
161,PMT,P002644,P012600,10.233,-7,26,33
161,PMT,P005301,P010549,7.966,0,18,18
161,PMT,P005301,P011823,11.716,-3,29,32
161,PMT,P005301,P011942,10.549,-1,27,28
161,PMT,P005301,P011943,8.349,-2,18,20
161,PMT,P005301,P011944,15.45,1,35,34
161,PMT,P005301,P011947,3.333,-1,7,8
161,PMT,P005301,P011966,7.115,1,19,18
161,PMT,P005301,P012600,6.466,2,19,17
161,PMT,P010549,P011823,3.333,-2,9,11
161,PMT,P010549,P011942,4.85,-8,9,17
161,PMT,P010549,P011943,9.783,-2,21,23
161,PMT,P010549,P011944,3.8,-3,4,7
161,PMT,P010549,P011966,3.033,-1,8,9
161,PMT,P011823,P011942,14.016,-2,32,34
161,PMT,P011823,P011943,3.716,-4,9,13
161,PMT,P011823,P011944,14.0,3,32,29
161,PMT,P011823,P011947,6.249,-3,13,16
161,PMT,P011823,P011966,4.05,-5,6,11
161,PMT,P011823,P012600,2.417,1,6,5
161,PMT,P011942,P011943,4.283,-5,9,14
161,PMT,P011942,P011944,10.917,2,25,23
161,PMT,P011942,P011947,3.999,0,13,13
161,PMT,P011942,P011966,7.666,-12,18,30
161,PMT,P011942,P012600,3.317,-11,7,18
161,PMT,P011943,P011944,2.85,2,4,2
161,PMT,P011943,P011966,3.033,-1,8,9
161,PMT,P011944,P011947,4.833,0,10,10
161,PMT,P011944,P011966,2.017,0,3,3
161,PMT,P011944,P012600,3.517,1,10,9
161,PMT,P011947,P011966,7.166,-2,20,22
161,PMT,P011947,P012600,5.5,2,13,11
161,PMT,P011966,P012600,9.133,-7,22,29
161,VNC,P000968,P003759,5.017,4,15,11
161,VNC,P000968,P004117,9.617,0,23,23
161,VNC,P000968,P008052,12.484,18,45,27
161,VNC,P000968,P011928,9.483,14,33,19
161,VNC,P000968,P012259,12.333,19,42,23
161,VNC,P000968,P012591,9.066,17,34,17
161,VNC,P003759,P004117,15.199,2,33,31
161,VNC,P003759,P004381,19.599,-13,40,53
161,VNC,P003759,P008052,11.483,-1,34,35
161,VNC,P003759,P009400,16.699,-5,34,39
161,VNC,P003759,P011928,4.35,-6,7,13
161,VNC,P003759,P012259,12.416,8,36,28
161,VNC,P003759,P012587,5.916,0,16,16
161,VNC,P003759,P012591,12.249,-5,25,30
161,VNC,P004117,P004381,9.083,-7,13,20
161,VNC,P004117,P008052,8.634,-4,20,24
161,VNC,P004117,P009400,9.166,2,18,16
161,VNC,P004117,P011928,4.617,-4,8,12
161,VNC,P004117,P012259,12.183,4,28,24
161,VNC,P004117,P012587,2.916,-1,5,6
161,VNC,P004117,P012591,7.849,0,16,16
161,VNC,P004381,P008052,11.515,4,35,31
161,VNC,P004381,P009400,18.366,-5,39,44
161,VNC,P004381,P011928,9.133,0,22,22
161,VNC,P004381,P012259,11.083,2,30,28
161,VNC,P004381,P012290,0.467,-2,0,2
161,VNC,P004381,P012587,6.233,-4,15,19
161,VNC,P004381,P012591,12.049,-3,26,29
161,VNC,P008052,P009400,5.499,6,19,13
161,VNC,P008052,P011928,12.516,23,46,23
161,VNC,P008052,P012259,17.8,18,60,42
161,VNC,P008052,P012587,3.483,2,13,11
161,VNC,P008052,P012591,12.582,22,48,26
161,VNC,P009400,P011928,7.133,-1,17,18
161,VNC,P009400,P012259,5.933,4,16,12
161,VNC,P009400,P012290,0.467,-2,0,2
161,VNC,P009400,P012587,3.866,-2,7,9
161,VNC,P009400,P012591,10.799,3,26,23
161,VNC,P011928,P012259,11.483,15,38,23
161,VNC,P011928,P012290,0.467,-2,0,2
161,VNC,P011928,P012587,0.95,-1,2,3
161,VNC,P011928,P012591,14.332,18,47,29
161,VNC,P012259,P012587,3.0,1,11,10
161,VNC,P012259,P012591,9.365,21,35,14
161,VNC,P012290,P012587,0.467,-2,0,2
161,VNC,P012587,P012591,0.633,3,3,0
162,HAM,P009663,P010070,14.801,0,30,30
162,HAM,P009663,P011168,19.101,-1,36,37
162,HAM,P009663,P011187,0.417,0,0,0
162,HAM,P009663,P012579,7.184,-5,13,18
162,HAM,P009663,P012580,12.284,8,29,21
162,HAM,P009663,P012581,20.384,2,46,44
162,HAM,P009663,P012582,3.966,3,11,8
162,HAM,P009663,P012648,3.367,-2,9,11
162,HAM,P009663,P012695,1.7,3,10,7
162,HAM,P010070,P011168,17.284,8,38,30
162,HAM,P010070,P011187,2.35,-1,6,7
162,HAM,P010070,P012579,8.667,-1,19,20
162,HAM,P010070,P012580,11.05,20,29,9
162,HAM,P010070,P012581,18.884,2,41,39
162,HAM,P010070,P012648,3.3,-5,7,12
162,HAM,P010070,P012695,2.4,-3,6,9
162,HAM,P011168,P011187,7.484,-8,18,26
162,HAM,P011168,P012579,15.167,-11,29,40
162,HAM,P011168,P012580,18.667,8,43,35
162,HAM,P011168,P012581,25.568,-4,54,58
162,HAM,P011168,P012582,11.717,-13,25,38
162,HAM,P011168,P012648,4.884,-3,13,16
162,HAM,P011187,P012579,9.951,-6,17,23
162,HAM,P011187,P012580,9.451,-1,17,18
162,HAM,P011187,P012581,4.817,-13,8,21
162,HAM,P011187,P012582,11.501,-13,19,32
162,HAM,P011187,P012648,4.317,-8,8,16
162,HAM,P011187,P012695,6.784,-6,7,13
162,HAM,P012579,P012580,14.384,1,30,29
162,HAM,P012579,P012581,13.034,-8,26,34
162,HAM,P012579,P012582,12.984,-8,24,32
162,HAM,P012579,P012695,6.901,2,14,12
162,HAM,P012580,P012581,17.217,10,42,32
162,HAM,P012580,P012582,13.584,-10,25,35
162,HAM,P012580,P012648,2.034,-1,5,6
162,HAM,P012580,P012695,8.001,1,16,15
162,HAM,P012581,P012582,10.05,-10,21,31
162,HAM,P012581,P012648,7.267,-10,17,27
162,HAM,P012581,P012695,4.983,-5,13,18
162,HAM,P012582,P012648,2.767,-4,5,9
162,HAM,P012582,P012695,6.567,-1,10,11
162,HAM,P012648,P012695,2.8,-7,4,11
162,WOL,P002387,P003212,7.8,1,18,17
162,WOL,P002387,P004645,0.333,-1,1,2
162,WOL,P002387,P005516,10.084,1,22,21
162,WOL,P002387,P006154,13.55,7,33,26
162,WOL,P002387,P006546,6.017,-4,12,16
162,WOL,P002387,P006907,5.117,-3,11,14
162,WOL,P002387,P012576,2.533,-2,4,6
162,WOL,P002387,P012577,11.201,3,26,23
162,WOL,P002387,P012789,14.901,6,33,27
162,WOL,P003212,P004645,8.049,-6,18,24
162,WOL,P003212,P006154,6.883,2,17,15
162,WOL,P003212,P006546,8.633,-6,18,24
162,WOL,P003212,P006907,0.45,-2,3,5
162,WOL,P003212,P012576,5.716,-10,8,18
162,WOL,P003212,P012577,15.183,-3,34,37
162,WOL,P003212,P012789,9.35,8,24,16
162,WOL,P004645,P005516,14.4,13,37,24
162,WOL,P004645,P006154,6.633,-11,6,17
162,WOL,P004645,P006546,21.766,6,52,46
162,WOL,P004645,P006907,0.333,-1,1,2
162,WOL,P004645,P012576,17.416,-1,38,39
162,WOL,P004645,P012577,16.166,20,51,31
162,WOL,P004645,P012789,4.7,9,16,7
162,WOL,P005516,P006154,12.967,-5,21,26
162,WOL,P005516,P006546,19.15,8,46,38
162,WOL,P005516,P006907,4.667,-1,8,9
162,WOL,P005516,P012576,14.233,7,34,27
162,WOL,P005516,P012577,12.184,26,43,17
162,WOL,P005516,P012789,10.251,7,25,18
162,WOL,P006154,P006546,7.833,-13,8,21
162,WOL,P006154,P006907,3.667,3,11,8
162,WOL,P006154,P012576,7.183,-11,5,16
162,WOL,P006154,P012577,8.467,6,21,15
162,WOL,P006154,P012789,12.217,10,30,20
162,WOL,P006546,P006907,1.25,-4,0,4
162,WOL,P006546,P012576,18.716,-4,40,44
162,WOL,P006546,P012577,18.7,19,56,37
162,WOL,P006546,P012789,9.067,6,24,18
162,WOL,P006907,P012577,0.317,-3,2,5
162,WOL,P006907,P012789,4.667,-1,8,9
162,WOL,P012576,P012577,13.999,9,39,30
162,WOL,P012577,P012789,13.251,15,36,21
163,LJU,P002561,P003452,4.184,0,10,10
163,LJU,P002561,P003514,7.883,-8,15,23
163,LJU,P002561,P007066,6.416,-11,9,20
163,LJU,P002561,P009392,3.95,-5,9,14
163,LJU,P002561,P009395,5.817,4,15,11
163,LJU,P002561,P010594,2.5,2,5,3
163,LJU,P002561,P010771,2.083,-2,2,4
163,LJU,P002561,P011261,2.5,2,5,3
163,LJU,P002561,P012700,6.199,-6,10,16
163,LJU,P003452,P003514,5.651,-2,13,15
163,LJU,P003452,P005969,25.434,2,58,56
163,LJU,P003452,P007066,11.45,-9,21,30
163,LJU,P003452,P009392,3.917,0,10,10
163,LJU,P003452,P009395,29.068,4,68,64
163,LJU,P003452,P010594,13.301,11,31,20
163,LJU,P003452,P010771,0.55,-2,0,2
163,LJU,P003452,P011261,4.167,4,13,9
163,LJU,P003452,P012700,20.75,0,48,48
163,LJU,P003514,P005969,3.584,1,8,7
163,LJU,P003514,P007066,8.483,-7,15,22
163,LJU,P003514,P009392,6.383,-6,13,19
163,LJU,P003514,P009395,5.451,-2,13,15
163,LJU,P003514,P010594,0.217,0,0,0
163,LJU,P003514,P010771,2.4,1,5,4
163,LJU,P003514,P012700,5.816,-5,10,15
163,LJU,P005969,P007066,12.117,-3,22,25
163,LJU,P005969,P009392,3.933,-3,6,9
163,LJU,P005969,P009395,26.551,-4,60,64
163,LJU,P005969,P010594,15.368,5,33,28
163,LJU,P005969,P010771,0.317,3,3,0
163,LJU,P005969,P011261,6.234,-2,15,17
163,LJU,P005969,P012700,24.934,-3,55,58
163,LJU,P007066,P009392,3.616,-6,5,11
163,LJU,P007066,P009395,10.9,-7,21,28
163,LJU,P007066,P010594,1.617,-2,0,2
163,LJU,P007066,P010771,2.4,1,5,4
163,LJU,P007066,P011261,4.517,2,7,5
163,LJU,P007066,P012700,12.616,-14,19,33
163,LJU,P009392,P009395,4.267,-2,10,12
163,LJU,P009392,P012700,5.466,-10,7,17
163,LJU,P009395,P010594,16.251,9,38,29
163,LJU,P009395,P011261,7.117,2,20,18
163,LJU,P009395,P012700,24.05,-4,55,59
163,LJU,P010594,P011261,4.884,-4,7,11
163,LJU,P010594,P012700,17.334,7,38,31
163,LJU,P010771,P012700,1.85,3,5,2
163,LJU,P011261,P012700,5.517,-4,13,17
163,LLI,P004479,P004773,12.499,10,32,22
163,LLI,P004479,P006600,1.2,0,2,2
163,LLI,P004479,P009649,4.717,-1,11,12
163,LLI,P004479,P009680,7.25,1,14,13
163,LLI,P004479,P012020,11.666,8,30,22
163,LLI,P004479,P012585,5.183,12,19,7
163,LLI,P004479,P012586,5.616,7,18,11
163,LLI,P004479,P012797,3.333,-5,2,7
163,LLI,P004773,P006600,6.983,18,30,12
163,LLI,P004773,P008274,1.95,6,8,2
163,LLI,P004773,P009649,5.533,2,14,12
163,LLI,P004773,P009680,14.6,16,45,29
163,LLI,P004773,P012020,14.416,6,36,30
163,LLI,P004773,P012585,13.716,28,53,25
163,LLI,P004773,P012586,8.266,5,24,19
163,LLI,P004773,P012797,7.633,5,22,17
163,LLI,P006600,P008274,6.067,6,13,7
163,LLI,P006600,P009649,19.451,-16,29,45
163,LLI,P006600,P009680,16.1,8,45,37
163,LLI,P006600,P012585,25.584,1,56,55
163,LLI,P006600,P012586,10.467,-5,13,18
163,LLI,P006600,P012797,16.484,-8,36,44
163,LLI,P008274,P009649,4.117,0,5,5
163,LLI,P008274,P009680,1.95,6,8,2
163,LLI,P008274,P012585,6.067,6,13,7
163,LLI,P008274,P012586,4.117,0,5,5
163,LLI,P009649,P009680,11.184,-7,22,29
163,LLI,P009649,P012020,4.683,1,11,10
163,LLI,P009649,P012585,19.784,-16,29,45
163,LLI,P009649,P012586,13.933,-6,20,26
163,LLI,P009649,P012797,13.134,-17,19,36
163,LLI,P009680,P012020,8.467,-1,18,19
163,LLI,P009680,P012585,20.017,10,57,47
163,LLI,P009680,P012586,2.45,-1,5,6
163,LLI,P009680,P012797,16.25,-4,38,42
163,LLI,P012020,P012585,6.733,10,23,13
163,LLI,P012020,P012586,7.416,4,21,17
163,LLI,P012020,P012797,4.283,-4,5,9
163,LLI,P012585,P012586,14.75,0,27,27
163,LLI,P012585,P012797,17.434,-7,39,46
163,LLI,P012586,P012797,4.517,-8,3,11
164,BES,P003783,P007914,10.751,-25,11,36
164,BES,P003783,P007917,3.351,-7,4,11
164,BES,P003783,P008945,4.683,-7,4,11
164,BES,P003783,P011379,8.917,-17,11,28
164,BES,P003783,P011924,5.567,-8,9,17
164,BES,P003783,P011936,8.767,-12,10,22
164,BES,P003783,P012622,9.084,-4,14,18
164,BES,P003783,P012647,8.899,-14,9,23
164,BES,P003783,P012711,3.517,-10,4,14
164,BES,P007914,P007917,2.484,-9,2,11
164,BES,P007914,P008945,7.5,-6,9,15
164,BES,P007914,P011379,11.501,-15,16,31
164,BES,P007914,P011924,4.55,-8,5,13
164,BES,P007914,P011936,10.601,-11,15,26
164,BES,P007914,P012622,5.201,-3,8,11
164,BES,P007914,P012647,10.583,-11,12,23
164,BES,P007914,P012711,3.633,-12,2,14
164,BES,P007917,P008945,10.767,2,25,23
164,BES,P007917,P011379,1.417,-6,0,6
164,BES,P007917,P011924,1.934,-1,4,5
164,BES,P007917,P011936,9.35,8,25,17
164,BES,P007917,P012622,10.217,10,27,17
164,BES,P007917,P012647,8.75,10,25,15
164,BES,P007917,P012711,2.534,-3,4,7
164,BES,P008945,P011379,8.084,-13,11,24
164,BES,P008945,P011924,4.116,-1,6,7
164,BES,P008945,P011936,22.3,1,47,46
164,BES,P008945,P012622,19.683,-1,41,42
164,BES,P008945,P012647,23.916,1,48,47
164,BES,P008945,P012711,2.683,-4,1,5
164,BES,P011357,P011379,2.033,1,5,4
164,BES,P011357,P011924,2.033,1,5,4
164,BES,P011357,P011936,2.033,1,5,4
164,BES,P011357,P012622,2.033,1,5,4
164,BES,P011379,P011924,5.366,1,14,13
164,BES,P011379,P011936,14.267,-13,26,39
164,BES,P011379,P012622,10.0,-7,21,28
164,BES,P011379,P012647,11.233,-11,20,31
164,BES,P011379,P012711,0.45,-4,0,4
164,BES,P011924,P011936,4.899,4,14,10
164,BES,P011924,P012622,9.366,2,22,20
164,BES,P011924,P012647,7.215,-6,12,18
164,BES,P011924,P012711,5.15,-8,5,13
164,BES,P011936,P012622,24.033,1,52,51
164,BES,P011936,P012647,25.9,-1,54,55
164,BES,P011936,P012711,1.05,-6,0,6
164,BES,P012622,P012647,21.816,-1,47,48
164,BES,P012622,P012711,2.567,-2,3,5
164,BES,P012647,P012711,3.216,-7,1,8
164,PRS,P004512,P011232,3.05,0,8,8
164,PRS,P004512,P012608,19.684,17,53,36
164,PRS,P004512,P012609,8.717,8,26,18
164,PRS,P004512,P012610,19.334,16,52,36
164,PRS,P004512,P012611,11.317,10,28,18
164,PRS,P004512,P012613,16.634,17,45,28
164,PRS,P005793,P009556,1.55,6,6,0
164,PRS,P005793,P011232,5.817,9,18,9
164,PRS,P005793,P012608,5.717,-6,7,13
164,PRS,P005793,P012609,4.267,3,12,9
164,PRS,P005793,P012610,5.717,-6,7,13
164,PRS,P005793,P012611,1.55,6,6,0
164,PRS,P005793,P012612,5.817,9,18,9
164,PRS,P005793,P012613,5.717,-6,7,13
164,PRS,P005793,P012640,9.984,-3,19,22
164,PRS,P009556,P011232,1.55,6,6,0
164,PRS,P009556,P012611,1.55,6,6,0
164,PRS,P009556,P012612,1.55,6,6,0
164,PRS,P011232,P012608,3.05,0,8,8
164,PRS,P011232,P012609,13.4,7,30,23
164,PRS,P011232,P012610,2.7,-1,7,8
164,PRS,P011232,P012611,13.383,9,31,22
164,PRS,P011232,P012612,14.6,12,35,23
164,PRS,P011232,P012640,13.05,6,29,23
164,PRS,P012608,P012609,8.717,8,26,18
164,PRS,P012608,P012610,25.051,10,59,49
164,PRS,P012608,P012611,11.317,10,28,18
164,PRS,P012608,P012613,22.351,11,52,41
164,PRS,P012608,P012640,5.717,-6,7,13
164,PRS,P012609,P012610,8.367,7,25,18
164,PRS,P012609,P012611,9.133,4,18,14
164,PRS,P012609,P012612,13.05,6,29,23
164,PRS,P012609,P012613,8.367,7,25,18
164,PRS,P012609,P012640,13.05,6,29,23
164,PRS,P012610,P012611,10.967,9,27,18
164,PRS,P012610,P012613,22.351,11,52,41
164,PRS,P012610,P012640,5.717,-6,7,13
164,PRS,P012611,P012612,10.333,9,23,14
164,PRS,P012611,P012613,8.267,10,20,10
164,PRS,P012611,P012640,8.783,3,17,14
164,PRS,P012612,P012640,13.05,6,29,23
164,PRS,P012613,P012640,5.717,-6,7,13
165,HTA,P003533,P004846,4.849,-1,13,14
165,HTA,P003533,P006835,7.116,2,19,17
165,HTA,P003533,P007759,7.283,0,18,18
165,HTA,P003533,P007867,4.6,5,15,10
165,HTA,P003533,P010550,1.25,0,4,4
165,HTA,P003533,P011991,6.233,2,17,15
165,HTA,P003533,P012794,2.133,0,6,6
165,HTA,P004846,P006835,11.549,-9,25,34
165,HTA,P004846,P007759,11.616,-11,23,34
165,HTA,P004846,P007867,7.182,-3,17,20
165,HTA,P004846,P010550,8.133,-8,10,18
165,HTA,P004846,P011973,9.733,-10,18,28
165,HTA,P004846,P011991,8.933,-9,14,23
165,HTA,P004846,P012794,6.533,-5,12,17
165,HTA,P006835,P007759,15.383,-13,32,45
165,HTA,P006835,P007867,12.0,7,31,24
165,HTA,P006835,P010465,1.017,5,5,0
165,HTA,P006835,P010550,3.467,-2,5,7
165,HTA,P006835,P011973,11.251,1,28,27
165,HTA,P006835,P011991,16.484,-1,35,36
165,HTA,P006835,P012794,8.401,10,24,14
165,HTA,P007759,P007867,22.316,7,53,46
165,HTA,P007759,P010550,18.55,9,42,33
165,HTA,P007759,P011973,20.05,2,48,46
165,HTA,P007759,P011991,12.184,-11,21,32
165,HTA,P007759,P012794,15.15,13,43,30
165,HTA,P007867,P010465,1.017,5,5,0
165,HTA,P007867,P010550,17.433,13,43,30
165,HTA,P007867,P011973,24.0,10,54,44
165,HTA,P007867,P011991,9.884,4,22,18
165,HTA,P007867,P012794,17.3,20,44,24
165,HTA,P010465,P011973,1.017,5,5,0
165,HTA,P010465,P012794,1.017,5,5,0
165,HTA,P010550,P011973,17.25,7,37,30
165,HTA,P010550,P011991,5.501,-10,3,13
165,HTA,P010550,P012794,15.616,7,36,29
165,HTA,P011973,P011991,9.651,-4,16,20
165,HTA,P011973,P012794,20.384,17,50,33
165,HTA,P011991,P012794,6.534,1,12,11
165,JOV,P002507,P006771,13.782,-11,25,36
165,JOV,P002507,P010161,14.616,5,32,27
165,JOV,P002507,P010458,12.433,-14,15,29
165,JOV,P002507,P010677,15.849,13,39,26
165,JOV,P002507,P011247,16.132,9,42,33
165,JOV,P002507,P012349,6.766,5,19,14
165,JOV,P002507,P012780,6.816,14,23,9
165,JOV,P002507,PJUG,17.666,-1,33,34
165,JOV,P006771,P010161,2.433,-13,0,13
165,JOV,P006771,P010458,10.733,-14,15,29
165,JOV,P006771,P010677,13.699,-7,26,33
165,JOV,P006771,P011247,18.282,-16,35,51
165,JOV,P006771,P012349,13.332,-5,28,33
165,JOV,P006771,P012780,10.333,-10,18,28
165,JOV,P006771,PJUG,13.866,-8,25,33
165,JOV,P010161,P010458,4.9,-9,3,12
165,JOV,P010161,P010677,14.467,7,36,29
165,JOV,P010161,P011247,8.666,5,22,17
165,JOV,P010161,P012349,6.234,-3,14,17
165,JOV,P010161,P012780,10.2,9,31,22
165,JOV,P010161,PJUG,10.484,-1,22,23
165,JOV,P010458,P010677,4.25,-6,4,10
165,JOV,P010458,P011247,8.516,-8,14,22
165,JOV,P010458,P012780,1.4,-2,3,5
165,JOV,P010458,PJUG,13.1,-11,18,29
165,JOV,P010677,P011247,15.45,8,38,30
165,JOV,P010677,P012349,17.317,-2,37,39
165,JOV,P010677,P012780,19.4,5,48,43
165,JOV,P010677,PJUG,13.3,-2,28,30
165,JOV,P011247,P012349,12.65,-4,29,33
165,JOV,P011247,P012780,14.6,3,33,30
165,JOV,P011247,PJUG,9.5,3,23,20
165,JOV,P012349,P012780,12.534,-7,25,32
165,JOV,P012349,PJUG,8.367,8,24,16
165,JOV,P012780,PJUG,7.917,0,23,23
166,BOU,P000498,P004525,12.466,1,21,20
166,BOU,P000498,P010431,4.833,3,9,6
166,BOU,P000498,P010718,0.3,0,2,2
166,BOU,P000498,P011161,10.2,1,20,19
166,BOU,P000498,P011836,2.65,3,8,5
166,BOU,P000498,P011837,2.483,-2,4,6
166,BOU,P000498,P012618,12.467,6,25,19
166,BOU,P000498,P012628,14.733,4,27,23
166,BOU,P004525,P010431,7.65,8,14,6
166,BOU,P004525,P010718,3.384,3,5,2
166,BOU,P004525,P011161,8.416,-2,12,14
166,BOU,P004525,P011836,0.083,0,0,0
166,BOU,P004525,P011837,4.55,1,9,8
166,BOU,P004525,P012617,4.167,3,5,2
166,BOU,P004525,P012618,12.0,3,17,14
166,BOU,P004525,P012628,13.816,-1,21,22
166,BOU,P010431,P010718,18.501,1,29,28
166,BOU,P010431,P011836,15.684,-4,24,28
166,BOU,P010431,P011837,12.6,3,27,24
166,BOU,P010431,P012617,18.501,1,29,28
166,BOU,P010431,P012618,10.734,1,11,10
166,BOU,P010431,P012628,4.833,3,9,6
166,BOU,P010718,P011161,4.366,1,10,9
166,BOU,P010718,P011836,21.1,-3,36,39
166,BOU,P010718,P011837,15.217,2,31,29
166,BOU,P010718,P012617,24.184,0,39,39
166,BOU,P010718,P012618,9.267,-2,10,12
166,BOU,P010718,P012628,1.617,-2,2,4
166,BOU,P011161,P011836,6.716,4,16,12
166,BOU,P011161,P011837,3.483,-1,6,7
166,BOU,P011161,P012617,4.849,1,8,7
166,BOU,P011161,P012618,11.483,3,22,19
166,BOU,P011161,P012628,10.683,1,18,17
166,BOU,P011836,P011837,13.15,-1,26,27
166,BOU,P011836,P012617,20.8,-3,34,37
166,BOU,P011836,P012618,10.217,1,16,15
166,BOU,P011836,P012628,3.4,3,8,5
166,BOU,P011837,P012617,15.217,2,31,29
166,BOU,P011837,P012628,4.1,-4,6,10
166,BOU,P012617,P012618,9.75,-2,8,10
166,BOU,P012617,P012628,2.4,-2,2,4
166,BOU,P012618,P012628,12.95,6,23,17
166,TTK,P004801,P005000,13.316,1,22,21
166,TTK,P004801,P006693,7.516,-7,10,17
166,TTK,P004801,P006883,7.416,5,11,6
166,TTK,P004801,P010477,4.4,-1,9,10
166,TTK,P004801,P011239,11.033,-3,16,19
166,TTK,P004801,P011272,3.717,-1,7,8
166,TTK,P004801,P011834,7.616,-6,8,14
166,TTK,P004801,P011925,17.799,3,30,27
166,TTK,P004801,P011975,3.783,5,7,2
166,TTK,P005000,P006693,6.883,-8,6,14
166,TTK,P005000,P006883,13.033,0,19,19
166,TTK,P005000,P009845,5.217,-5,7,12
166,TTK,P005000,P010477,9.234,1,14,13
166,TTK,P005000,P011239,6.117,-3,8,11
166,TTK,P005000,P011272,3.717,-1,7,8
166,TTK,P005000,P011834,10.7,-8,12,20
166,TTK,P005000,P011925,19.8,2,34,32
166,TTK,P005000,P011975,3.783,5,7,2
166,TTK,P006693,P006883,13.317,-3,22,25
166,TTK,P006693,P010477,13.5,-5,22,27
166,TTK,P006693,P011239,7.516,-7,10,17
166,TTK,P006693,P011834,16.917,-6,26,32
166,TTK,P006693,P011925,17.683,-4,32,36
166,TTK,P006883,P009845,4.3,-3,7,10
166,TTK,P006883,P010477,16.234,2,27,25
166,TTK,P006883,P011239,3.1,2,4,2
166,TTK,P006883,P011834,22.667,2,38,36
166,TTK,P006883,P011925,25.55,6,45,39
166,TTK,P006883,P011975,3.783,5,7,2
166,TTK,P009845,P010477,0.6,0,0,0
166,TTK,P009845,P011239,0.917,-2,0,2
166,TTK,P009845,P011834,4.617,-5,7,12
166,TTK,P009845,P011925,5.217,-5,7,12
166,TTK,P010477,P011239,0.6,0,2,2
166,TTK,P010477,P011272,3.717,-1,7,8
166,TTK,P010477,P011834,15.417,5,27,22
166,TTK,P010477,P011925,18.834,3,36,33
166,TTK,P011239,P011834,7.917,-6,8,14
166,TTK,P011239,P011925,10.6,-1,16,17
166,TTK,P011272,P011925,3.717,-1,7,8
166,TTK,P011834,P011925,24.417,0,42,42
166,TTK,P011925,P011975,3.783,5,7,2
167,LKB,P002012,P004868,9.85,10,27,17
167,LKB,P002012,P006901,9.884,6,25,19
167,LKB,P002012,P007029,19.65,8,41,33
167,LKB,P002012,P009898,22.084,1,45,44
167,LKB,P002012,P010190,15.733,19,43,24
167,LKB,P002012,P010461,17.967,5,36,31
167,LKB,P002012,PLXI,16.1,11,35,24
167,LKB,P004868,P006901,12.933,10,29,19
167,LKB,P004868,P007029,5.466,3,9,6
167,LKB,P004868,P009898,11.05,10,27,17
167,LKB,P004868,P010190,10.699,13,28,15
167,LKB,P004868,PLXI,3.066,2,4,2
167,LKB,P006901,P007029,11.283,-4,22,26
167,LKB,P006901,P009898,15.167,9,38,29
167,LKB,P006901,P010190,16.299,7,38,31
167,LKB,P006901,P010461,8.1,-5,19,24
167,LKB,P006901,P011329,1.383,0,2,2
167,LKB,P006901,PLXI,9.083,-3,19,22
167,LKB,P007029,P009898,18.65,-3,37,40
167,LKB,P007029,P010190,15.148,12,38,26
167,LKB,P007029,P010461,24.783,4,56,52
167,LKB,P007029,PLXI,26.016,8,57,49
167,LKB,P009898,P010190,13.299,11,36,25
167,LKB,P009898,P010461,17.35,-4,36,40
167,LKB,P009898,P011329,1.383,0,2,2
167,LKB,P009898,PLXI,14.617,0,31,31
167,LKB,P010190,P010461,14.199,8,36,28
167,LKB,P010190,P011329,1.383,0,2,2
167,LKB,P010190,PLXI,12.832,14,35,21
167,LKB,P010461,P011329,1.383,0,2,2
167,LKB,P010461,PLXI,23.15,8,55,47
167,WRO,P003034,P005531,10.583,2,25,23
167,WRO,P003034,P011900,12.516,2,33,31
167,WRO,P003034,P011901,5.166,1,10,9
167,WRO,P003034,P012094,13.716,7,37,30
167,WRO,P003034,P012601,12.266,-1,25,26
167,WRO,P003034,P012699,10.016,5,27,22
167,WRO,P003034,P012736,3.133,-4,3,7
167,WRO,P005531,P009896,13.017,0,22,22
167,WRO,P005531,P011900,9.734,2,24,22
167,WRO,P005531,P011901,9.05,-6,13,19
167,WRO,P005531,P011902,1.8,-3,1,4
167,WRO,P005531,P012094,17.45,11,43,32
167,WRO,P005531,P012601,13.233,-4,23,27
167,WRO,P005531,P012699,13.517,5,31,26
167,WRO,P005531,P012736,7.284,-11,6,17
167,WRO,P009896,P011900,12.983,-12,19,31
167,WRO,P009896,P011901,9.166,-10,12,22
167,WRO,P009896,P011902,3.383,-7,3,10
167,WRO,P009896,P012094,14.417,-9,25,34
167,WRO,P009896,P012601,15.466,-14,24,38
167,WRO,P009896,P012699,15.717,-5,27,32
167,WRO,P009896,P012736,7.183,-7,8,15
167,WRO,P011900,P011901,5.916,-9,9,18
167,WRO,P011900,P011902,1.583,-4,2,6
167,WRO,P011900,P012094,20.1,-8,43,51
167,WRO,P011900,P012601,17.349,-11,34,45
167,WRO,P011900,P012699,19.417,-6,39,45
167,WRO,P011900,P012736,3.666,-6,5,11
167,WRO,P011901,P011902,3.383,-7,3,10
167,WRO,P011901,P012094,2.783,2,9,7
167,WRO,P011901,P012601,9.216,-6,12,18
167,WRO,P011901,P012699,3.55,1,9,8
167,WRO,P011901,P012736,10.366,-14,11,25
167,WRO,P011902,P012094,0.2,-4,0,4
167,WRO,P011902,P012736,3.183,-3,3,6
167,WRO,P012094,P012601,19.366,-7,39,46
167,WRO,P012094,P012699,23.683,-1,50,51
167,WRO,P012094,P012736,0.817,1,2,1
167,WRO,P012601,P012699,17.716,-8,33,41
167,WRO,P012601,P012736,6.316,-9,6,15
167,WRO,P012699,P012736,0.584,-3,0,3
168,CAN,P001607,P003637,2.3,-1,4,5
168,CAN,P001607,P004160,3.783,-2,8,10
168,CAN,P001607,P005005,10.95,2,23,21
168,CAN,P001607,P006588,1.533,-2,2,4
168,CAN,P001607,P007560,9.151,6,23,17
168,CAN,P001607,P008121,4.95,1,12,11
168,CAN,P001607,P009864,11.8,-3,22,25
168,CAN,P001607,P010385,3.767,6,13,7
168,CAN,P001607,P010452,14.034,5,33,28
168,CAN,P003425,P003637,22.317,-6,55,61
168,CAN,P003425,P004160,0.916,-2,0,2
168,CAN,P003425,P005005,4.933,2,16,14
168,CAN,P003425,P006588,27.233,-5,70,75
168,CAN,P003425,P007560,1.5,1,5,4
168,CAN,P003425,P008121,29.2,-5,76,81
168,CAN,P003425,P009864,13.533,-10,32,42
168,CAN,P003425,P010385,15.9,5,44,39
168,CAN,P003425,P010452,2.2,0,6,6
168,CAN,P003637,P005005,2.3,-1,4,5
168,CAN,P003637,P006588,22.317,-6,55,61
168,CAN,P003637,P008121,22.317,-6,55,61
168,CAN,P003637,P009864,14.917,-9,36,45
168,CAN,P003637,P010385,9.7,2,23,21
168,CAN,P003637,P010452,2.3,-1,4,5
168,CAN,P004160,P005005,4.016,-2,8,10
168,CAN,P004160,P006588,0.916,-2,0,2
168,CAN,P004160,P008121,0.683,-2,0,2
168,CAN,P004160,P009864,4.699,-4,8,12
168,CAN,P004160,P010452,3.783,-2,8,10
168,CAN,P005005,P006588,3.716,5,15,10
168,CAN,P005005,P007560,4.534,5,11,6
168,CAN,P005005,P008121,5.033,2,16,14
168,CAN,P005005,P009864,8.983,-2,16,18
168,CAN,P005005,P010385,6.9,6,23,17
168,CAN,P005005,P010452,12.167,-1,24,25
168,CAN,P006588,P007560,2.05,-4,2,6
168,CAN,P006588,P008121,28.533,-7,72,79
168,CAN,P006588,P009864,15.066,-12,34,46
168,CAN,P006588,P010385,13.7,5,38,33
168,CAN,P007560,P008121,6.117,2,17,15
168,CAN,P007560,P009864,5.717,0,10,10
168,CAN,P007560,P010385,4.934,7,18,11
168,CAN,P007560,P010452,8.601,11,26,15
168,CAN,P008121,P009864,16.35,-11,38,49
168,CAN,P008121,P010385,17.8,7,50,43
168,CAN,P008121,P010452,5.617,3,16,13
168,CAN,P009864,P010452,10.267,-1,20,21
168,CAN,P010385,P010452,5.967,6,19,13
168,CLU,P005113,P005373,0.767,0,3,3
168,CLU,P005113,P005714,5.201,-6,7,13
168,CLU,P005113,P010569,15.886,-16,28,44
168,CLU,P005113,P010997,2.634,-1,5,6
168,CLU,P005113,P011801,8.618,-6,13,19
168,CLU,P005113,P012620,8.118,-9,16,25
168,CLU,P005113,P012621,12.002,-13,23,36
168,CLU,P005113,P012698,10.318,-13,17,30
168,CLU,P005373,P005714,13.733,2,40,38
168,CLU,P005373,P010569,24.55,17,70,53
168,CLU,P005373,P011801,29.883,18,88,70
168,CLU,P005373,P012620,3.366,8,13,5
168,CLU,P005373,P012621,23.983,9,68,59
168,CLU,P005373,P012698,23.25,18,70,52
168,CLU,P005714,P010569,13.601,-5,29,34
168,CLU,P005714,P010997,0.967,1,3,2
168,CLU,P005714,P011801,17.6,-5,44,49
168,CLU,P005714,P012620,0.367,0,0,0
168,CLU,P005714,P012621,13.25,-2,34,36
168,CLU,P005714,P012698,11.017,-1,31,32
168,CLU,P010569,P010997,2.634,-1,5,6
168,CLU,P010569,P011801,32.401,11,80,69
168,CLU,P010569,P012620,11.484,-1,29,30
168,CLU,P010569,P012621,29.885,-5,70,75
168,CLU,P010569,P012698,28.235,4,69,65
168,CLU,P010997,P011801,1.1,0,2,2
168,CLU,P010997,P012620,1.667,-2,2,4
168,CLU,P010997,P012698,1.534,-1,3,4
168,CLU,P011801,P012620,5.183,10,17,7
168,CLU,P011801,P012621,29.484,5,76,71
168,CLU,P011801,P012698,26.667,15,72,57
168,CLU,P012620,P012621,7.384,-9,17,26
168,CLU,P012620,P012698,8.367,-1,22,23
168,CLU,P012621,P012698,24.884,-1,64,65
169,BUD,P002740,P004945,1.517,-2,3,5
169,BUD,P002740,P005637,10.317,18,32,14
169,BUD,P002740,P006566,4.367,7,12,5
169,BUD,P002740,P008325,6.567,-2,13,15
169,BUD,P002740,P010248,8.15,13,25,12
169,BUD,P002740,P010389,3.751,-5,6,11
169,BUD,P002740,P011281,8.7,15,27,12
169,BUD,P002740,P011935,4.467,-7,6,13
169,BUD,P002740,P012606,8.134,2,21,19
169,BUD,P002740,P012630,3.166,5,7,2
169,BUD,P004945,P005637,10.6,11,26,15
169,BUD,P004945,P006566,9.083,13,23,10
169,BUD,P004945,P008325,8.083,4,20,16
169,BUD,P004945,P010248,9.5,10,23,13
169,BUD,P004945,P011281,9.5,10,23,13
169,BUD,P004945,P011935,6.983,3,17,14
169,BUD,P004945,P012606,8.083,4,20,16
169,BUD,P004945,P012630,6.983,3,17,14
169,BUD,P005637,P006566,13.383,20,35,15
169,BUD,P005637,P008325,2.167,5,7,2
169,BUD,P005637,P010248,17.233,26,48,22
169,BUD,P005637,P010389,0.517,2,2,0
169,BUD,P005637,P011281,17.783,28,50,22
169,BUD,P005637,P012606,3.667,9,15,6
169,BUD,P005637,P012630,1.933,5,5,0
169,BUD,P006566,P010248,17.1,15,43,28
169,BUD,P006566,P010389,0.067,0,0,0
169,BUD,P006566,P011281,17.1,15,43,28
169,BUD,P006566,P011935,3.784,-5,8,13
169,BUD,P006566,P012606,0.067,0,0,0
169,BUD,P006566,P012630,3.717,-5,8,13
169,BUD,P008325,P010389,5.734,-3,13,16
169,BUD,P008325,P011281,0.55,2,2,0
169,BUD,P008325,P011935,13.433,-2,30,32
169,BUD,P008325,P012606,15.6,3,37,34
169,BUD,P008325,P012630,10.266,5,26,21
169,BUD,P009214,P010389,3.383,-5,4,9
169,BUD,P009214,P011935,3.383,-5,4,9
169,BUD,P009214,P012606,3.383,-5,4,9
169,BUD,P009214,P012630,3.383,-5,4,9
169,BUD,P010248,P011281,20.95,21,56,35
169,BUD,P010248,P011935,3.717,-5,8,13
169,BUD,P010248,P012606,1.5,4,8,4
169,BUD,P010248,P012630,5.65,0,13,13
169,BUD,P010389,P011935,8.667,-10,15,25
169,BUD,P010389,P012606,9.184,-8,17,25
169,BUD,P010389,P012630,5.433,-3,11,14
169,BUD,P011281,P011935,3.717,-5,8,13
169,BUD,P011281,P012606,2.05,6,10,4
169,BUD,P011281,P012630,5.65,0,13,13
169,BUD,P011935,P012606,16.883,-7,34,41
169,BUD,P011935,P012630,17.366,-5,38,43
169,BUD,P012606,P012630,13.649,0,30,30
169,TRN,P001479,P005059,1.4,-5,0,5
169,TRN,P001479,P005738,3.383,5,9,4
169,TRN,P001479,P006382,1.117,0,2,2
169,TRN,P001479,P007828,5.383,7,14,7
169,TRN,P001479,P009903,2.0,2,5,3
169,TRN,P001479,P012595,9.0,1,18,17
169,TRN,P001479,P012596,3.617,-6,4,10
169,TRN,P001479,P012597,5.833,0,12,12
169,TRN,P001479,P012687,4.267,0,8,8
169,TRN,P005059,P005738,21.301,-11,42,53
169,TRN,P005059,P006382,12.167,-5,19,24
169,TRN,P005059,P007828,0.583,-4,2,6
169,TRN,P005059,P009903,15.516,-17,27,44
169,TRN,P005059,P012594,1.5,-4,4,8
169,TRN,P005059,P012595,15.501,-13,35,48
169,TRN,P005059,P012596,7.651,-3,17,20
169,TRN,P005059,P012597,17.517,-18,30,48
169,TRN,P005738,P006382,14.833,-7,23,30
169,TRN,P005738,P007828,3.383,5,9,4
169,TRN,P005738,P009903,14.933,-13,25,38
169,TRN,P005738,P012594,3.283,-6,6,12
169,TRN,P005738,P012595,19.567,-1,46,47
169,TRN,P005738,P012596,8.917,0,21,21
169,TRN,P005738,P012597,16.867,-5,33,38
169,TRN,P005738,P012687,2.933,1,6,5
169,TRN,P006382,P007828,0.833,2,2,0
169,TRN,P006382,P009903,11.633,-8,16,24
169,TRN,P006382,P012594,7.4,-7,12,19
169,TRN,P006382,P012595,14.617,-3,28,31
169,TRN,P006382,P012596,10.65,-2,21,23
169,TRN,P006382,P012597,11.933,-6,15,21
169,TRN,P006382,P012687,4.417,-4,10,14
169,TRN,P007828,P009903,2.583,-2,7,9
169,TRN,P007828,P012595,6.799,5,18,13
169,TRN,P007828,P012596,0.833,2,2,0
169,TRN,P007828,P012597,4.749,4,14,10
169,TRN,P007828,P012687,2.05,1,4,3
169,TRN,P009903,P012594,1.083,-1,4,5
169,TRN,P009903,P012595,9.733,-8,23,31
169,TRN,P009903,P012597,12.583,-13,21,34
169,TRN,P012594,P012595,8.9,-11,16,27
169,TRN,P012594,P012596,7.817,-10,12,22
169,TRN,P012594,P012597,3.2,-1,4,5
169,TRN,P012594,P012687,2.417,-4,6,10
169,TRN,P012595,P012596,18.984,-9,37,46
169,TRN,P012595,P012597,18.2,-5,39,44
169,TRN,P012595,P012687,7.567,-4,16,20
169,TRN,P012596,P012597,11.95,-3,22,25
169,TRN,P012596,P012687,5.517,-5,12,17
169,TRN,P012597,P012687,1.1,-1,2,3
170,ARI,P002867,P004292,2.533,-3,5,8
170,ARI,P002867,P010387,1.183,-1,2,3
170,ARI,P002867,P012615,2.999,-3,2,5
170,ARI,P002867,P012702,2.05,-1,5,6
170,ARI,P002867,P012708,1.917,-5,2,7
170,ARI,P002867,P012716,3.183,-1,5,6
170,ARI,P002867,P012717,3.767,-6,7,13
170,ARI,P002867,P012722,2.799,-3,2,5
170,ARI,P002867,P012760,1.917,-5,2,7
170,ARI,P002867,P012792,4.716,-8,4,12
170,ARI,P004292,P010387,10.817,20,32,12
170,ARI,P004292,P012615,9.284,2,16,14
170,ARI,P004292,P012702,9.8,8,28,20
170,ARI,P004292,P012708,4.734,-2,11,13
170,ARI,P004292,P012716,26.318,21,68,47
170,ARI,P004292,P012717,18.767,17,54,37
170,ARI,P004292,P012722,7.85,-1,15,16
170,ARI,P004292,P012760,10.284,9,24,15
170,ARI,P004292,P012792,11.817,5,27,22
170,ARI,P010177,P010387,1.1,2,4,2
170,ARI,P010177,P012615,1.1,2,4,2
170,ARI,P010177,P012702,1.1,2,4,2
170,ARI,P010177,P012716,1.1,2,4,2
170,ARI,P010387,P012615,10.017,7,18,11
170,ARI,P010387,P012702,5.75,9,13,4
170,ARI,P010387,P012708,0.6,2,2,0
170,ARI,P010387,P012716,16.684,25,40,15
170,ARI,P010387,P012717,9.7,19,28,9
170,ARI,P010387,P012722,5.85,1,11,10
170,ARI,P010387,P012760,8.0,13,19,6
170,ARI,P010387,P012792,9.167,7,15,8
170,ARI,P012615,P012702,3.95,3,9,6
170,ARI,P012615,P012708,0.8,2,2,0
170,ARI,P012615,P012716,14.934,10,26,16
170,ARI,P012615,P012722,5.183,-5,4,9
170,ARI,P012615,P012760,8.267,11,17,6
170,ARI,P012615,P012792,13.066,7,22,15
170,ARI,P012702,P012708,2.367,0,9,9
170,ARI,P012702,P012716,13.017,9,32,23
170,ARI,P012702,P012717,9.067,6,23,17
170,ARI,P012702,P012792,4.967,0,5,5
170,ARI,P012708,P012716,4.734,-2,11,13
170,ARI,P012708,P012717,6.451,-7,13,20
170,ARI,P012708,P012760,4.884,-5,6,11
170,ARI,P012708,P012792,2.517,-3,4,7
170,ARI,P012716,P012717,19.634,16,52,36
170,ARI,P012716,P012722,8.167,1,15,14
170,ARI,P012716,P012760,13.267,13,28,15
170,ARI,P012716,P012792,17.234,10,31,21
170,ARI,P012717,P012722,5.9,3,15,12
170,ARI,P012717,P012760,7.517,-1,15,16
170,ARI,P012717,P012792,9.601,-3,17,20
170,ARI,P012722,P012792,8.583,-4,14,18
170,ARI,P012760,P012792,9.0,5,17,12
170,ULM,P005422,P007952,3.633,-6,4,10
170,ULM,P005422,P010582,18.234,-7,37,44
170,ULM,P005422,P010726,6.666,-3,13,16
170,ULM,P005422,P011188,2.533,-2,2,4
170,ULM,P005422,P011457,0.25,-6,0,6
170,ULM,P005422,P012603,19.601,-8,41,49
170,ULM,P005422,P012604,18.634,-7,39,46
170,ULM,P005422,P012703,18.251,-10,36,46
170,ULM,P005422,P012704,1.266,-3,0,3
170,ULM,P007952,P010582,9.067,3,17,14
170,ULM,P007952,P010726,13.549,-4,18,22
170,ULM,P007952,P011188,12.717,-1,18,19
170,ULM,P007952,P011457,13.084,-8,18,26
170,ULM,P007952,P012603,3.617,-4,4,8
170,ULM,P007952,P012703,3.668,-4,6,10
170,ULM,P007952,P012704,6.533,-8,3,11
170,ULM,P010582,P010726,10.183,1,20,19
170,ULM,P010582,P011188,7.301,-3,13,16
170,ULM,P010582,P011457,9.417,0,15,15
170,ULM,P010582,P012603,20.35,-4,39,43
170,ULM,P010582,P012604,18.584,-10,35,45
170,ULM,P010582,P012703,16.351,-6,32,38
170,ULM,P010582,P012704,1.117,-2,0,2
170,ULM,P010726,P011188,13.983,-8,16,24
170,ULM,P010726,P011457,15.866,-9,21,30
170,ULM,P010726,P012603,8.3,2,18,16
170,ULM,P010726,P012604,8.867,-5,16,21
170,ULM,P010726,P012703,6.817,-4,11,15
170,ULM,P010726,P012704,5.433,-6,3,9
170,ULM,P011188,P011457,13.367,-8,16,24
170,ULM,P011188,P012604,3.2,-9,0,9
170,ULM,P011188,P012703,4.15,-4,4,8
170,ULM,P011188,P012704,6.417,-5,3,8
170,ULM,P011457,P012603,4.467,-2,7,9
170,ULM,P011457,P012604,4.883,-5,5,10
170,ULM,P011457,P012703,5.134,-6,7,13
170,ULM,P011457,P012704,5.4,-8,3,11
170,ULM,P012603,P012604,20.334,-3,44,47
170,ULM,P012603,P012703,19.135,-9,39,48
170,ULM,P012604,P012703,19.617,-9,37,46
170,ULM,P012604,P012704,0.017,0,0,0
170,ULM,P012703,P012704,0.017,0,0,0
171,JOV,P002361,P002507,13.417,-1,29,30
171,JOV,P002361,P006771,10.883,-2,17,19
171,JOV,P002361,P010161,5.883,-2,15,17
171,JOV,P002361,P010458,13.333,-5,27,32
171,JOV,P002361,P010677,8.066,-14,10,24
171,JOV,P002361,P011247,8.016,1,13,12
171,JOV,P002361,P012349,2.75,-1,4,5
171,JOV,P002361,P012780,4.599,-8,3,11
171,JOV,P002361,PJUG,5.117,-4,10,14
171,JOV,P002507,P006771,9.884,6,18,12
171,JOV,P002507,P010161,8.083,-3,22,25
171,JOV,P002507,P010458,15.533,-6,27,33
171,JOV,P002507,P010677,8.634,-5,18,23
171,JOV,P002507,P011247,8.266,-2,12,14
171,JOV,P002507,P012349,3.834,4,13,9
171,JOV,P002507,PJUG,9.817,-1,21,22
171,JOV,P006771,P010161,0.15,0,0,0
171,JOV,P006771,P010458,10.766,-7,15,22
171,JOV,P006771,P010677,16.933,-20,28,48
171,JOV,P006771,P011247,17.599,6,38,32
171,JOV,P006771,P012349,13.634,2,32,30
171,JOV,P006771,P012780,15.049,-12,27,39
171,JOV,P006771,PJUG,10.434,-5,17,22
171,JOV,P010161,P010458,6.766,-2,17,19
171,JOV,P010161,P010677,10.25,-3,24,27
171,JOV,P010161,P011247,2.433,2,7,5
171,JOV,P010161,P012349,5.5,1,15,14
171,JOV,P010161,P012780,4.333,2,10,8
171,JOV,P010161,PJUG,6.266,1,18,17
171,JOV,P010458,P010677,8.283,-15,12,27
171,JOV,P010458,P011247,10.366,1,17,16
171,JOV,P010458,P012780,1.566,-3,2,5
171,JOV,P010458,PJUG,7.383,-7,11,18
171,JOV,P010677,P011247,12.333,-5,27,32
171,JOV,P010677,P012349,17.117,-5,39,44
171,JOV,P010677,P012780,17.149,-16,31,47
171,JOV,P010677,PJUG,9.967,-9,19,28
171,JOV,P011247,P012349,9.283,5,27,22
171,JOV,P011247,P012780,11.766,7,30,23
171,JOV,P011247,PJUG,5.666,-3,9,12
171,JOV,P012349,P012780,15.733,-4,34,38
171,JOV,P012349,PJUG,10.417,-2,24,26
171,JOV,P012780,PJUG,6.733,-6,11,17
171,PMT,P001686,P002644,13.633,0,27,27
171,PMT,P001686,P010549,1.217,-3,0,3
171,PMT,P001686,P011823,2.35,-5,0,5
171,PMT,P001686,P011942,13.633,-3,25,28
171,PMT,P001686,P011944,13.683,-6,25,31
171,PMT,P001686,P011947,12.283,4,27,23
171,PMT,P001686,P011966,2.3,1,2,1
171,PMT,P001686,P012600,4.833,-8,2,10
171,PMT,P002020,P002644,2.45,-2,5,7
171,PMT,P002020,P010549,2.483,-4,4,8
171,PMT,P002020,P011823,8.383,-1,23,24
171,PMT,P002020,P011942,7.55,4,24,20
171,PMT,P002020,P011944,5.783,-3,15,18
171,PMT,P002020,P011947,0.8,-3,0,3
171,PMT,P002020,P011966,5.05,0,13,13
171,PMT,P002020,P012600,10.833,-3,28,31
171,PMT,P002644,P010549,1.05,0,2,2
171,PMT,P002644,P011942,26.933,20,67,47
171,PMT,P002644,P011944,23.033,23,64,41
171,PMT,P002644,P011947,25.316,27,66,39
171,PMT,P002644,P011966,6.083,-2,7,9
171,PMT,P002644,P012600,17.966,18,46,28
171,PMT,P010549,P011823,2.8,-8,2,10
171,PMT,P010549,P011944,1.367,-4,0,4
171,PMT,P010549,P011947,0.15,-1,0,1
171,PMT,P010549,P011966,2.483,-4,4,8
171,PMT,P010549,P012600,3.85,-8,4,12
171,PMT,P011823,P011942,7.283,4,21,17
171,PMT,P011823,P011944,6.883,-7,12,19
171,PMT,P011823,P011947,0.95,-4,0,4
171,PMT,P011823,P011966,4.0,0,11,11
171,PMT,P011823,P012600,10.883,-7,23,30
171,PMT,P011942,P011944,28.449,18,74,56
171,PMT,P011942,P011947,24.183,26,64,38
171,PMT,P011942,P011966,5.767,6,14,8
171,PMT,P011942,P012600,23.066,21,63,42
171,PMT,P011944,P011947,20.433,28,61,33
171,PMT,P011944,P012600,20.033,15,53,38
171,PMT,P011947,P011966,5.833,-5,5,10
171,PMT,P011947,P012600,15.116,20,41,21
171,PMT,P011966,P012600,8.816,-4,16,20
172,BES,P003783,P007914,8.167,-11,11,22
172,BES,P003783,P007917,10.2,-5,22,27
172,BES,P003783,P008945,0.117,0,0,0
172,BES,P003783,P011357,3.65,-4,6,10
172,BES,P003783,P011924,13.101,-9,24,33
172,BES,P003783,P011936,20.233,-15,37,52
172,BES,P003783,P012622,6.066,-8,10,18
172,BES,P003783,P012647,16.467,-13,29,42
172,BES,P003783,P012711,11.067,-11,17,28
172,BES,P007914,P007917,4.217,-2,8,10
172,BES,P007914,P008945,5.751,0,9,9
172,BES,P007914,P011357,2.834,-2,3,5
172,BES,P007914,P011924,6.734,-4,10,14
172,BES,P007914,P011936,9.934,-7,14,21
172,BES,P007914,P012622,8.25,-4,11,15
172,BES,P007914,P012647,11.684,-7,17,24
172,BES,P007914,P012711,9.101,-7,13,20
172,BES,P007917,P008945,0.183,0,0,0
172,BES,P007917,P011924,4.25,-2,10,12
172,BES,P007917,P011936,9.083,-3,20,23
172,BES,P007917,P012622,3.216,-3,6,9
172,BES,P007917,P012647,9.166,-6,18,24
172,BES,P007917,P012711,1.217,1,4,3
172,BES,P008945,P011357,2.834,-2,3,5
172,BES,P008945,P011924,11.3,-2,25,27
172,BES,P008945,P011936,8.651,-5,10,15
172,BES,P008945,P012622,11.85,1,27,26
172,BES,P008945,P012647,12.267,0,27,27
172,BES,P008945,P012711,7.451,0,19,19
172,BES,P011357,P011924,3.65,-4,6,10
172,BES,P011357,P011936,6.484,-6,9,15
172,BES,P011357,P012622,4.15,-3,5,8
172,BES,P011357,P012711,2.334,-3,4,7
172,BES,P011924,P011936,15.8,-10,27,37
172,BES,P011924,P012622,14.083,0,32,32
172,BES,P011924,P012647,23.334,-7,47,54
172,BES,P011924,P012711,15.884,-6,31,37
172,BES,P011936,P012622,11.466,-10,17,27
172,BES,P011936,P012647,20.183,-12,34,46
172,BES,P011936,P012711,13.234,-12,20,32
172,BES,P012622,P012647,15.583,-1,36,37
172,BES,P012622,P012711,8.0,0,20,20
172,BES,P012647,P012711,16.784,-6,32,38
172,HTA,P003533,P004846,6.5,-2,9,11
172,HTA,P003533,P006835,6.5,-2,9,11
172,HTA,P003533,P007759,2.117,2,6,4
172,HTA,P003533,P007867,4.733,3,8,5
172,HTA,P003533,P010465,3.884,-3,7,10
172,HTA,P003533,P010550,0.5,3,3,0
172,HTA,P003533,P011973,0.967,-2,0,2
172,HTA,P003533,P012592,0.65,1,3,2
172,HTA,P003533,P012794,8.617,0,15,15
172,HTA,P004846,P006835,16.984,12,38,26
172,HTA,P004846,P007759,2.466,1,6,5
172,HTA,P004846,P007867,11.967,5,26,21
172,HTA,P004846,P010465,5.951,1,13,12
172,HTA,P004846,P010550,8.55,6,18,12
172,HTA,P004846,P011973,8.067,4,21,17
172,HTA,P004846,P011991,8.601,10,22,12
172,HTA,P004846,P012794,11.45,7,23,16
172,HTA,P006835,P007759,3.35,5,9,4
172,HTA,P006835,P007867,8.817,6,20,14
172,HTA,P006835,P010465,9.001,2,18,16
172,HTA,P006835,P010550,5.517,9,14,5
172,HTA,P006835,P011973,8.084,8,22,14
172,HTA,P006835,P011991,10.901,13,27,14
172,HTA,P006835,P012794,11.45,7,23,16
172,HTA,P007759,P007867,15.916,8,43,35
172,HTA,P007759,P010465,6.417,3,13,10
172,HTA,P007759,P010550,17.549,9,46,37
172,HTA,P007759,P011973,21.0,5,48,43
172,HTA,P007759,P011991,16.217,6,40,34
172,HTA,P007759,P012592,0.65,1,3,2
172,HTA,P007759,P012794,3.65,4,10,6
172,HTA,P007867,P010465,0.117,2,2,0
172,HTA,P007867,P010550,18.75,4,46,42
172,HTA,P007867,P011973,18.417,9,50,41
172,HTA,P007867,P011991,15.268,8,42,34
172,HTA,P007867,P012794,7.683,3,15,12
172,HTA,P010465,P010550,2.55,3,5,2
172,HTA,P010465,P011973,8.484,3,17,14
172,HTA,P010465,P011991,7.334,3,15,12
172,HTA,P010465,P012592,0.65,1,3,2
172,HTA,P010465,P012794,5.084,1,11,10
172,HTA,P010550,P011973,17.616,2,41,39
172,HTA,P010550,P011991,16.8,8,40,32
172,HTA,P010550,P012794,6.7,12,19,7
172,HTA,P011973,P011991,21.768,9,55,46
172,HTA,P011973,P012794,2.733,2,6,4
172,HTA,P011991,P012794,2.383,7,7,0
172,HTA,P012592,P012794,0.65,1,3,2
173,LJU,P002561,P003452,1.017,-3,2,5
173,LJU,P002561,P003514,6.95,-15,6,21
173,LJU,P002561,P007066,1.017,-3,2,5
173,LJU,P002561,P009392,5.567,-11,4,15
173,LJU,P002561,P010594,10.117,-23,10,33
173,LJU,P002561,P010771,3.533,-9,4,13
173,LJU,P002561,P011261,8.734,-19,8,27
173,LJU,P002561,P012700,3.533,-9,4,13
173,LJU,P003452,P003514,11.882,-15,22,37
173,LJU,P003452,P005969,19.232,-17,40,57
173,LJU,P003452,P007066,14.683,-21,29,50
173,LJU,P003452,P009392,5.149,4,17,13
173,LJU,P003452,P010594,7.767,-17,12,29
173,LJU,P003452,P010771,5.566,1,13,12
173,LJU,P003452,P011261,2.967,-2,10,12
173,LJU,P003452,P012700,12.733,-10,23,33
173,LJU,P003514,P005969,18.798,-22,29,51
173,LJU,P003514,P007066,10.266,-15,16,31
173,LJU,P003514,P009392,11.732,-16,13,29
173,LJU,P003514,P010594,12.783,-23,15,38
173,LJU,P003514,P010771,9.382,-13,13,26
173,LJU,P003514,P011261,9.183,-12,11,23
173,LJU,P003514,P012700,12.016,-17,15,32
173,LJU,P005969,P007066,15.283,-20,27,47
173,LJU,P005969,P009392,14.181,-7,33,40
173,LJU,P005969,P010594,8.9,-14,12,26
173,LJU,P005969,P010771,14.065,-12,27,39
173,LJU,P005969,P011261,9.299,-6,24,30
173,LJU,P005969,P012700,19.766,-22,32,54
173,LJU,P007066,P009392,2.633,1,10,9
173,LJU,P007066,P010594,9.384,-19,12,31
173,LJU,P007066,P011261,2.967,-2,10,12
173,LJU,P007066,P012700,8.967,-13,10,23
173,LJU,P009392,P010594,6.1,-9,6,15
173,LJU,P009392,P010771,11.015,-10,21,31
173,LJU,P009392,P011261,14.866,-17,28,45
173,LJU,P009392,P012700,7.749,-7,16,23
173,LJU,P010594,P010771,3.533,-9,4,13
173,LJU,P010594,P011261,9.267,-17,10,27
173,LJU,P010594,P012700,8.217,-17,7,24
173,LJU,P010771,P011261,8.966,-14,16,30
173,LJU,P010771,P012700,14.332,-18,26,44
173,LJU,P011261,P012700,5.883,-11,11,22
173,PRS,P004512,P005793,4.417,7,16,9
173,PRS,P004512,P012608,17.9,33,59,26
173,PRS,P004512,P012610,17.9,33,59,26
173,PRS,P004512,P012611,17.9,33,59,26
173,PRS,P004512,P012613,13.483,26,43,17
173,PRS,P005793,P009556,16.283,18,43,25
173,PRS,P005793,P011232,16.433,16,43,27
173,PRS,P005793,P012608,4.567,5,16,11
173,PRS,P005793,P012610,4.417,7,16,9
173,PRS,P005793,P012611,4.417,7,16,9
173,PRS,P005793,P012612,16.433,16,43,27
173,PRS,P005793,P012640,16.433,16,43,27
173,PRS,P009556,P011232,17.883,20,49,29
173,PRS,P009556,P012611,1.6,2,6,4
173,PRS,P009556,P012612,17.883,20,49,29
173,PRS,P009556,P012640,17.883,20,49,29
173,PRS,P011232,P012608,4.217,0,11,11
173,PRS,P011232,P012610,4.067,2,11,9
173,PRS,P011232,P012611,1.9,2,6,4
173,PRS,P011232,P012612,18.033,18,49,31
173,PRS,P011232,P012613,4.067,2,11,9
173,PRS,P011232,P012640,21.8,20,60,40
173,PRS,P012608,P012610,21.967,35,70,35
173,PRS,P012608,P012611,18.2,33,59,26
173,PRS,P012608,P012612,0.15,-2,0,2
173,PRS,P012608,P012613,17.55,28,54,26
173,PRS,P012608,P012640,3.917,0,11,11
173,PRS,P012610,P012611,18.2,33,59,26
173,PRS,P012610,P012613,17.55,28,54,26
173,PRS,P012610,P012640,3.767,2,11,9
173,PRS,P012611,P012612,1.6,2,6,4
173,PRS,P012611,P012613,13.783,26,43,17
173,PRS,P012611,P012640,1.6,2,6,4
173,PRS,P012612,P012640,18.033,18,49,31
173,PRS,P012613,P012640,3.767,2,11,9
174,LLI,P004773,P005247,9.833,-4,17,21
174,LLI,P004773,P006600,8.166,-6,13,19
174,LLI,P004773,P008274,2.967,2,5,3
174,LLI,P004773,P009649,5.333,-10,7,17
174,LLI,P004773,P009680,12.633,-1,25,26
174,LLI,P004773,P012020,10.917,-4,20,24
174,LLI,P004773,P012585,4.583,2,9,7
174,LLI,P004773,P012586,13.517,-8,26,34
174,LLI,P004773,P012797,8.383,-11,10,21
174,LLI,P005247,P006600,12.0,-1,25,26
174,LLI,P005247,P008274,4.8,6,11,5
174,LLI,P005247,P009649,0.85,-2,2,4
174,LLI,P005247,P009680,18.5,3,41,38
174,LLI,P005247,P012020,10.183,3,23,20
174,LLI,P005247,P012585,11.149,8,27,19
174,LLI,P005247,P012586,11.567,-1,24,25
174,LLI,P005247,P012797,15.25,0,30,30
174,LLI,P006600,P008274,2.75,2,5,3
174,LLI,P006600,P009649,12.249,-9,23,32
174,LLI,P006600,P009680,9.1,-4,20,24
174,LLI,P006600,P012585,11.883,4,25,21
174,LLI,P006600,P012586,17.132,-10,32,42
174,LLI,P006600,P012797,20.316,-8,41,49
174,LLI,P008274,P009680,4.583,6,11,5
174,LLI,P008274,P012020,2.05,4,6,2
174,LLI,P008274,P012585,1.833,4,6,2
174,LLI,P008274,P012586,0.217,0,0,0
174,LLI,P009649,P009680,2.433,-5,6,11
174,LLI,P009649,P012020,0.817,-3,0,3
174,LLI,P009649,P012585,5.633,1,10,9
174,LLI,P009649,P012586,12.216,-10,21,31
174,LLI,P009649,P012797,12.733,-10,23,33
174,LLI,P009680,P012020,13.883,5,32,27
174,LLI,P009680,P012585,11.483,9,28,19
174,LLI,P009680,P012586,12.367,-2,28,30
174,LLI,P009680,P012797,12.35,-3,25,28
174,LLI,P012020,P012585,7.799,6,19,13
174,LLI,P012020,P012586,9.551,0,20,20
174,LLI,P012020,P012797,5.8,-3,8,11
174,LLI,P012585,P012586,15.149,5,29,24
174,LLI,P012585,P012797,14.616,5,31,26
174,LLI,P012586,P012797,20.416,-10,36,46
174,WOL,P002387,P003212,11.182,-3,25,28
174,WOL,P002387,P005516,1.034,3,3,0
174,WOL,P002387,P006154,8.066,1,18,17
174,WOL,P002387,P006546,4.15,-1,10,11
174,WOL,P002387,P006907,3.3,5,7,2
174,WOL,P002387,P012576,4.483,4,12,8
174,WOL,P002387,P012577,8.916,-5,21,26
174,WOL,P002387,P012789,7.733,-4,16,20
174,WOL,P003212,P004645,2.333,4,6,2
174,WOL,P003212,P005516,3.583,5,9,4
174,WOL,P003212,P006154,7.849,1,18,17
174,WOL,P003212,P006546,6.949,1,16,15
174,WOL,P003212,P006907,3.766,3,7,4
174,WOL,P003212,P012576,5.316,2,12,10
174,WOL,P003212,P012577,8.732,-5,21,26
174,WOL,P003212,P012789,9.482,0,22,22
174,WOL,P004645,P005516,23.4,6,48,42
174,WOL,P004645,P006154,16.15,1,32,31
174,WOL,P004645,P006546,20.583,8,45,37
174,WOL,P004645,P006907,5.2,2,11,9
174,WOL,P004645,P012576,13.65,7,31,24
174,WOL,P004645,P012577,4.117,-1,4,5
174,WOL,P004645,P012789,8.167,-3,15,18
174,WOL,P005516,P006154,17.833,3,38,35
174,WOL,P005516,P006546,25.416,10,57,47
174,WOL,P005516,P006907,10.366,4,23,19
174,WOL,P005516,P012576,18.483,9,43,34
174,WOL,P005516,P012577,6.3,-5,4,9
174,WOL,P005516,P012789,8.717,-3,15,18
174,WOL,P006154,P006546,14.466,5,35,30
174,WOL,P006154,P006907,5.532,6,12,6
174,WOL,P006154,P012576,14.432,10,39,29
174,WOL,P006154,P012577,8.733,-3,17,20
174,WOL,P006154,P012789,9.667,-8,15,23
174,WOL,P006546,P006907,10.066,4,23,19
174,WOL,P006546,P012576,18.483,9,43,34
174,WOL,P006546,P012577,6.299,-7,8,15
174,WOL,P006546,P012789,8.716,-5,19,24
174,WOL,P006907,P012576,10.416,4,23,19
174,WOL,P006907,P012577,1.999,-4,0,4
174,WOL,P006907,P012789,0.883,0,2,2
174,WOL,P012576,P012577,3.333,-5,5,10
174,WOL,P012577,P012789,11.699,-5,20,25
175,HAM,P001990,P009663,12.25,-4,25,29
175,HAM,P001990,P010070,4.367,-5,6,11
175,HAM,P001990,P011187,3.95,-2,5,7
175,HAM,P001990,P012579,9.751,2,19,17
175,HAM,P001990,P012580,12.483,-8,21,29
175,HAM,P001990,P012581,8.833,-7,18,25
175,HAM,P001990,P012582,2.55,-4,4,8
175,HAM,P001990,P012648,5.283,2,11,9
175,HAM,P001990,P012694,5.333,2,11,9
175,HAM,P009663,P010070,9.483,-1,21,22
175,HAM,P009663,P011168,12.299,1,33,32
175,HAM,P009663,P012579,14.684,6,35,29
175,HAM,P009663,P012580,17.015,-8,36,44
175,HAM,P009663,P012581,20.799,-2,51,53
175,HAM,P009663,P012582,4.8,-5,8,13
175,HAM,P009663,P012648,1.733,2,6,4
175,HAM,P009663,P012694,10.233,2,26,24
175,HAM,P009663,P012695,1.7,1,3,2
175,HAM,P010070,P011168,3.416,3,12,9
175,HAM,P010070,P011187,0.667,2,2,0
175,HAM,P010070,P012579,7.517,8,19,11
175,HAM,P010070,P012580,5.883,-7,10,17
175,HAM,P010070,P012581,6.9,1,17,16
175,HAM,P010070,P012695,2.367,3,5,2
175,HAM,P011168,P011187,2.084,-3,2,5
175,HAM,P011168,P012579,6.3,-2,15,17
175,HAM,P011168,P012580,8.616,-2,20,22
175,HAM,P011168,P012581,13.633,2,35,33
175,HAM,P011168,P012582,2.25,-1,4,5
175,HAM,P011168,P012648,0.217,-2,0,2
175,HAM,P011168,P012694,8.717,-4,19,23
175,HAM,P011187,P012579,8.818,-3,14,17
175,HAM,P011187,P012580,5.584,-7,5,12
175,HAM,P011187,P012581,6.817,-2,13,15
175,HAM,P011187,P012582,1.85,0,6,6
175,HAM,P011187,P012648,10.0,-4,15,19
175,HAM,P011187,P012694,7.517,-1,11,12
175,HAM,P011187,P012695,7.717,0,15,15
175,HAM,P012579,P012580,8.117,-7,10,17
175,HAM,P012579,P012581,11.118,6,30,24
175,HAM,P012579,P012582,1.184,0,3,3
175,HAM,P012579,P012648,8.184,-1,13,14
175,HAM,P012579,P012694,10.884,0,23,23
175,HAM,P012579,P012695,7.451,3,15,12
175,HAM,P012580,P012581,14.882,-10,31,41
175,HAM,P012580,P012582,4.8,-5,8,13
175,HAM,P012580,P012648,5.05,-2,9,11
175,HAM,P012580,P012694,6.466,1,14,13
175,HAM,P012580,P012695,1.5,-5,0,5
175,HAM,P012581,P012582,6.283,-5,14,19
175,HAM,P012581,P012648,3.549,-1,8,9
175,HAM,P012581,P012694,12.5,1,28,27
175,HAM,P012581,P012695,5.15,1,11,10
175,HAM,P012582,P012648,1.033,0,3,3
175,HAM,P012582,P012695,1.85,0,6,6
175,HAM,P012648,P012694,5.65,0,9,9
175,HAM,P012648,P012695,6.233,-2,10,12
175,HAM,P012694,P012695,3.7,3,7,4
175,VNC,P003759,P004117,12.367,10,34,24
175,VNC,P003759,P004381,13.85,19,42,23
175,VNC,P003759,P008052,11.117,12,31,19
175,VNC,P003759,P009400,9.133,2,22,20
175,VNC,P003759,P011928,5.283,5,13,8
175,VNC,P003759,P012259,7.65,-7,14,21
175,VNC,P003759,P012587,9.517,8,27,19
175,VNC,P003759,P012588,5.1,-5,12,17
175,VNC,P003759,P012591,11.983,4,29,25
175,VNC,P004117,P004381,14.25,6,33,27
175,VNC,P004117,P008052,20.45,9,48,39
175,VNC,P004117,P011928,11.266,-1,19,20
175,VNC,P004117,P012259,8.9,3,20,17
175,VNC,P004117,P012587,18.65,4,41,37
175,VNC,P004117,P012588,2.217,0,5,5
175,VNC,P004117,P012591,4.5,5,12,7
175,VNC,P004381,P008052,13.2,11,33,22
175,VNC,P004381,P009400,9.917,5,24,19
175,VNC,P004381,P011928,16.15,-5,30,35
175,VNC,P004381,P012587,13.6,7,33,26
175,VNC,P004381,P012588,9.534,3,23,20
175,VNC,P004381,P012591,14.967,10,38,28
175,VNC,P008052,P009400,1.6,-1,3,4
175,VNC,P008052,P011928,9.866,-7,17,24
175,VNC,P008052,P012259,9.433,-1,20,21
175,VNC,P008052,P012587,17.783,4,41,37
175,VNC,P008052,P012588,1.65,5,5,0
175,VNC,P008052,P012591,5.433,8,14,6
175,VNC,P009400,P011928,9.25,-5,18,23
175,VNC,P009400,P012259,4.733,-10,6,16
175,VNC,P009400,P012588,9.317,-6,17,23
175,VNC,P009400,P012591,14.65,-5,30,35
175,VNC,P011928,P012259,5.983,0,12,12
175,VNC,P011928,P012587,10.75,-3,19,22
175,VNC,P011928,P012588,6.984,-3,12,15
175,VNC,P011928,P012591,13.0,-1,28,29
175,VNC,P012259,P012587,7.25,0,15,15
175,VNC,P012259,P012588,4.2,-6,6,12
175,VNC,P012259,P012591,6.383,-7,11,18
175,VNC,P012587,P012588,3.65,5,9,4
175,VNC,P012587,P012591,2.2,3,7,4
175,VNC,P012588,P012591,12.284,-5,27,32
176,BOU,P000498,P010449,5.35,-3,7,10
176,BOU,P000498,P010450,3.6,-4,8,12
176,BOU,P000498,P010718,14.217,-13,22,35
176,BOU,P000498,P011836,10.617,-9,14,23
176,BOU,P000498,P011837,10.617,-9,14,23
176,BOU,P000498,P012617,8.867,-10,15,25
176,BOU,P000498,P012618,0.75,5,5,0
176,BOU,P000498,P012619,2.85,-9,3,12
176,BOU,P010449,P010450,12.383,-6,23,29
176,BOU,P010449,P010718,15.233,10,37,27
176,BOU,P010449,P011161,13.033,-5,27,32
176,BOU,P010449,P011836,13.1,4,28,24
176,BOU,P010449,P011837,5.35,-3,7,10
176,BOU,P010449,P012618,13.933,9,35,26
176,BOU,P010449,P012619,6.3,-10,11,21
176,BOU,P010449,P012628,17.45,-8,33,41
176,BOU,P010450,P010718,7.4,-2,16,18
176,BOU,P010450,P011161,16.017,5,35,30
176,BOU,P010450,P012617,9.034,5,22,17
176,BOU,P010450,P012618,9.333,7,24,17
176,BOU,P010450,P012619,12.084,-8,21,29
176,BOU,P010450,P012628,15.817,-1,31,32
176,BOU,P010718,P011161,3.05,8,12,4
176,BOU,P010718,P011836,16.967,3,35,32
176,BOU,P010718,P011837,10.617,-9,14,23
176,BOU,P010718,P012617,9.184,-10,15,25
176,BOU,P010718,P012618,9.583,14,29,15
176,BOU,P010718,P012619,4.267,-6,10,16
176,BOU,P010718,P012628,7.15,5,18,13
176,BOU,P011161,P011836,2.617,-1,6,7
176,BOU,P011161,P012617,5.601,9,14,5
176,BOU,P011161,P012618,6.783,4,17,13
176,BOU,P011161,P012619,11.851,0,24,24
176,BOU,P011161,P012628,15.584,-4,29,33
176,BOU,P011836,P011837,10.617,-9,14,23
176,BOU,P011836,P012617,5.434,-6,7,13
176,BOU,P011836,P012618,5.3,8,15,7
176,BOU,P011836,P012619,2.617,-1,6,7
176,BOU,P011836,P012628,6.867,3,15,12
176,BOU,P011837,P012617,5.267,-6,7,13
176,BOU,P012617,P012618,0.75,5,5,0
176,BOU,P012617,P012619,8.451,0,17,17
176,BOU,P012617,P012628,5.284,9,14,5
176,BOU,P012618,P012619,0.05,-1,1,2
176,BOU,P012618,P012628,12.25,5,29,24
176,BOU,P012619,P012628,10.534,-5,19,24
176,ULM,P005422,P007952,10.3,5,20,15
176,ULM,P005422,P010582,14.766,8,29,21
176,ULM,P005422,P010726,9.716,3,24,21
176,ULM,P005422,P011188,9.716,3,24,21
176,ULM,P005422,P011391,1.95,1,6,5
176,ULM,P005422,P011457,2.35,2,8,6
176,ULM,P005422,P012603,12.583,6,25,19
176,ULM,P005422,P012604,10.049,3,23,20
176,ULM,P005422,P012703,17.766,5,37,32
176,ULM,P007952,P010582,6.967,6,11,5
176,ULM,P007952,P010726,9.566,0,21,21
176,ULM,P007952,P011188,10.216,-1,21,22
176,ULM,P007952,P011457,5.683,-2,13,15
176,ULM,P007952,P012603,3.417,2,4,2
176,ULM,P007952,P012703,8.383,-6,10,16
176,ULM,P010582,P010726,6.35,11,18,7
176,ULM,P010582,P011188,4.433,3,9,6
176,ULM,P010582,P011391,1.967,3,6,3
176,ULM,P010582,P011457,9.334,4,22,18
176,ULM,P010582,P012066,3.517,1,9,8
176,ULM,P010582,P012603,23.184,10,51,41
176,ULM,P010582,P012604,18.683,4,43,39
176,ULM,P010582,P012703,21.267,2,42,40
176,ULM,P010726,P011188,11.333,2,28,26
176,ULM,P010726,P011391,3.6,4,12,8
176,ULM,P010726,P011457,11.367,1,27,26
176,ULM,P010726,P012603,7.4,0,15,15
176,ULM,P010726,P012604,5.567,-2,10,12
176,ULM,P010726,P012703,10.033,-11,17,28
176,ULM,P011188,P011391,1.95,1,6,5
176,ULM,P011188,P011457,7.0,-1,16,17
176,ULM,P011188,P012604,2.2,0,5,5
176,ULM,P011188,P012703,10.616,-7,19,26
176,ULM,P011391,P011457,1.967,3,6,3
176,ULM,P011391,P012603,1.967,3,6,3
176,ULM,P011391,P012703,2.267,1,6,5
176,ULM,P011457,P012603,9.534,-3,19,22
176,ULM,P011457,P012604,8.884,-5,16,21
176,ULM,P011457,P012703,10.017,-15,13,28
176,ULM,P012066,P012603,3.517,1,9,8
176,ULM,P012066,P012604,3.517,1,9,8
176,ULM,P012066,P012703,3.517,1,9,8
176,ULM,P012603,P012604,20.25,-1,43,44
176,ULM,P012603,P012703,20.684,-2,40,42
176,ULM,P012604,P012703,20.65,-4,43,47
177,ARI,P002867,P003240,14.15,5,27,22
177,ARI,P002867,P004292,6.034,7,14,7
177,ARI,P002867,P010387,0.017,0,0,0
177,ARI,P002867,P012615,9.517,6,19,13
177,ARI,P002867,P012702,7.617,-2,11,13
177,ARI,P002867,P012716,2.6,-1,3,4
177,ARI,P002867,P012717,5.65,-3,8,11
177,ARI,P002867,P012722,7.55,5,16,11
177,ARI,P002867,P012792,7.533,-5,10,15
177,ARI,P003240,P004292,11.651,8,25,17
177,ARI,P003240,P010387,5.184,5,16,11
177,ARI,P003240,P012615,19.151,14,44,30
177,ARI,P003240,P012702,10.183,0,19,19
177,ARI,P003240,P012716,11.85,7,28,21
177,ARI,P003240,P012717,6.799,-6,10,16
177,ARI,P003240,P012722,7.45,5,16,11
177,ARI,P003240,P012760,3.15,-2,3,5
177,ARI,P003240,P012792,14.232,-4,28,32
177,ARI,P004292,P010387,6.7,2,17,15
177,ARI,P004292,P012615,10.535,19,30,11
177,ARI,P004292,P012702,10.034,-3,20,23
177,ARI,P004292,P012716,16.401,2,36,34
177,ARI,P004292,P012717,13.433,-13,22,35
177,ARI,P004292,P012722,4.717,7,12,5
177,ARI,P004292,P012760,7.2,-6,10,16
177,ARI,P004292,P012792,9.167,1,22,21
177,ARI,P010177,P010387,0.25,1,1,0
177,ARI,P010177,P012615,0.25,1,1,0
177,ARI,P010177,P012716,0.25,1,1,0
177,ARI,P010177,P012792,0.25,1,1,0
177,ARI,P010387,P012615,7.434,14,27,13
177,ARI,P010387,P012702,0.017,0,0,0
177,ARI,P010387,P012716,12.584,10,36,26
177,ARI,P010387,P012717,5.167,-4,9,13
177,ARI,P010387,P012760,5.15,-4,9,13
177,ARI,P010387,P012792,7.901,16,29,13
177,ARI,P012615,P012702,7.05,2,14,12
177,ARI,P012615,P012716,11.901,17,36,19
177,ARI,P012615,P012722,4.417,7,11,4
177,ARI,P012615,P012760,2.517,0,3,3
177,ARI,P012615,P012792,12.9,12,35,23
177,ARI,P012702,P012716,10.067,-2,19,21
177,ARI,P012702,P012717,9.667,-8,15,23
177,ARI,P012702,P012792,12.233,-11,18,29
177,ARI,P012716,P012717,14.0,-11,22,33
177,ARI,P012716,P012722,0.1,0,0,0
177,ARI,P012716,P012760,8.3,-6,12,18
177,ARI,P012716,P012792,15.551,7,39,32
177,ARI,P012717,P012722,3.133,-2,5,7
177,ARI,P012717,P012760,5.783,-6,9,15
177,ARI,P012717,P012792,10.7,-11,16,27
177,ARI,P012722,P012792,2.833,-2,4,6
177,ARI,P012760,P012792,1.1,0,2,2
177,TRN,P001479,P005059,3.833,-5,3,8
177,TRN,P001479,P006382,13.05,1,20,19
177,TRN,P001479,P007828,15.7,-1,30,31
177,TRN,P001479,P009903,2.7,-9,0,9
177,TRN,P001479,P012595,9.55,-12,14,26
177,TRN,P001479,P012596,16.867,3,33,30
177,TRN,P001479,P012597,16.5,-1,32,33
177,TRN,P005059,P005738,19.417,4,42,38
177,TRN,P005059,P006382,8.183,-7,12,19
177,TRN,P005059,P009903,17.6,-4,39,43
177,TRN,P005059,P012595,23.35,-6,45,51
177,TRN,P005059,P012596,6.683,-2,8,10
177,TRN,P005059,P012597,18.066,-4,39,43
177,TRN,P005738,P006382,3.317,3,7,4
177,TRN,P005738,P009903,16.567,1,37,36
177,TRN,P005738,P012595,19.417,4,42,38
177,TRN,P005738,P012596,2.85,3,5,2
177,TRN,P005738,P012597,16.1,1,35,34
177,TRN,P006382,P007828,9.2,6,17,11
177,TRN,P006382,P009903,1.517,-5,4,9
177,TRN,P006382,P012595,7.4,-7,10,17
177,TRN,P006382,P012596,15.9,4,25,21
177,TRN,P006382,P012597,11.033,1,21,20
177,TRN,P007828,P009903,2.683,-9,0,9
177,TRN,P007828,P012595,6.65,-7,13,20
177,TRN,P007828,P012596,13.017,8,30,22
177,TRN,P007828,P012597,15.55,-1,30,31
177,TRN,P009903,P012595,20.283,-13,39,52
177,TRN,P009903,P012596,0.017,0,0,0
177,TRN,P009903,P012597,19.833,-13,37,50
177,TRN,P012595,P012596,9.717,0,19,19
177,TRN,P012595,P012597,23.633,-11,50,61
177,TRN,P012596,P012597,13.817,8,32,24
178,BUD,P004945,P005637,7.5,0,14,14
178,BUD,P004945,P006566,5.233,-1,10,11
178,BUD,P004945,P007398,2.267,1,4,3
178,BUD,P004945,P008325,1.717,1,4,3
178,BUD,P004945,P010248,5.783,-1,10,11
178,BUD,P004945,P011281,7.5,0,14,14
178,BUD,P005637,P006566,10.05,-2,19,21
178,BUD,P005637,P007398,2.267,1,4,3
178,BUD,P005637,P008325,1.717,1,4,3
178,BUD,P005637,P010248,10.6,-2,19,21
178,BUD,P005637,P010389,2.217,1,5,4
178,BUD,P005637,P011281,9.717,1,19,18
178,BUD,P005637,P012606,2.6,-2,4,6
178,BUD,P005637,P012630,2.6,-2,4,6
178,BUD,P006566,P007398,4.85,7,15,8
178,BUD,P006566,P008325,5.65,9,17,8
178,BUD,P006566,P010248,13.167,-5,22,27
178,BUD,P006566,P010389,6.134,0,10,10
178,BUD,P006566,P011281,15.017,6,33,27
178,BUD,P006566,P011935,8.767,6,20,14
178,BUD,P006566,P012606,3.8,-2,6,8
178,BUD,P006566,P012630,2.6,-2,4,6
178,BUD,P007398,P008325,15.483,21,42,21
178,BUD,P007398,P009214,6.666,-9,11,20
178,BUD,P007398,P010248,5.983,-10,9,19
178,BUD,P007398,P010389,10.166,0,22,22
178,BUD,P007398,P011281,11.65,13,32,19
178,BUD,P007398,P011935,12.533,19,36,17
178,BUD,P007398,P012606,6.333,8,16,8
178,BUD,P007398,P012630,7.666,-7,13,20
178,BUD,P008325,P009214,1.433,-1,2,3
178,BUD,P008325,P010389,12.25,15,36,21
178,BUD,P008325,P011281,10.35,11,28,17
178,BUD,P008325,P011935,17.9,26,53,27
178,BUD,P008325,P012606,10.7,15,31,16
178,BUD,P008325,P012630,7.0,6,19,13
178,BUD,P009214,P010248,5.233,-8,9,17
178,BUD,P009214,P010389,3.483,-10,3,13
178,BUD,P009214,P011281,3.183,1,8,7
178,BUD,P009214,P012630,6.666,-9,11,20
178,BUD,P010248,P010389,8.617,-10,11,21
178,BUD,P010248,P011281,12.667,1,24,23
178,BUD,P010248,P011935,3.117,-3,3,6
178,BUD,P010248,P012606,2.8,-4,4,8
178,BUD,P010248,P012630,7.833,-10,13,23
178,BUD,P010389,P011281,7.684,2,15,13
178,BUD,P010389,P011935,15.167,14,39,25
178,BUD,P010389,P012606,9.7,13,29,16
178,BUD,P010389,P012630,8.05,-5,18,23
178,BUD,P011281,P011935,10.117,10,25,15
178,BUD,P011281,P012630,4.183,3,10,7
178,BUD,P011935,P012606,10.9,13,31,18
178,BUD,P011935,P012630,5.567,7,17,10
178,BUD,P012606,P012630,7.167,3,19,16
178,CAN,P001607,P003637,4.2,-7,6,13
178,CAN,P001607,P004160,3.0,-6,2,8
178,CAN,P001607,P004466,5.951,3,15,12
178,CAN,P001607,P005005,1.433,-7,0,7
178,CAN,P001607,P006588,3.701,-6,5,11
178,CAN,P001607,P007560,7.968,1,17,16
178,CAN,P001607,P007644,5.45,-12,4,16
178,CAN,P001607,P008121,4.65,-10,6,16
178,CAN,P001607,P010385,8.151,-1,19,20
178,CAN,P001607,P010452,9.9,-7,18,25
178,CAN,P003425,P003637,8.4,-3,11,14
178,CAN,P003425,P004160,5.184,-5,12,17
178,CAN,P003425,P005005,10.583,5,26,21
178,CAN,P003425,P006588,22.367,-3,45,48
178,CAN,P003425,P007560,1.534,-4,2,6
178,CAN,P003425,P007644,14.233,3,30,27
178,CAN,P003425,P008121,22.633,1,47,46
178,CAN,P003425,P010385,9.017,-2,19,21
178,CAN,P003425,P010452,2.717,-4,4,8
178,CAN,P003637,P004160,0.983,-4,0,4
178,CAN,P003637,P006588,9.217,-5,13,18
178,CAN,P003637,P007644,6.533,-2,10,12
178,CAN,P003637,P008121,11.617,-6,17,23
178,CAN,P003637,P010385,6.067,-8,7,15
178,CAN,P003637,P010452,3.383,-5,4,9
178,CAN,P004160,P006588,4.567,-5,10,15
178,CAN,P004160,P007560,3.551,-6,4,10
178,CAN,P004160,P007644,3.65,-1,10,11
178,CAN,P004160,P008121,3.65,-1,10,11
178,CAN,P004160,P010385,3.617,-6,4,10
178,CAN,P004160,P010452,4.534,-10,4,14
178,CAN,P004466,P005005,2.234,3,5,2
178,CAN,P004466,P006588,1.884,-2,3,5
178,CAN,P004466,P007560,8.185,6,20,14
178,CAN,P004466,P007644,2.384,0,3,3
178,CAN,P004466,P010385,5.801,6,17,11
178,CAN,P004466,P010452,6.301,8,17,9
178,CAN,P005005,P006588,10.4,3,24,21
178,CAN,P005005,P007560,2.234,3,5,2
178,CAN,P005005,P007644,8.85,0,17,17
178,CAN,P005005,P008121,12.016,-2,26,28
178,CAN,P005005,P010385,5.4,1,14,13
178,CAN,P005005,P010452,3.85,-2,7,9
178,CAN,P006588,P007560,2.801,-6,3,9
178,CAN,P006588,P007644,17.567,-4,32,36
178,CAN,P006588,P008121,23.267,-3,47,50
178,CAN,P006588,P010385,7.584,-1,18,19
178,CAN,P006588,P010452,0.917,-4,0,4
178,CAN,P007560,P007644,2.384,0,3,3
178,CAN,P007560,P010385,8.435,4,21,17
178,CAN,P007560,P010452,9.852,2,21,19
178,CAN,P007644,P008121,18.166,-6,34,40
178,CAN,P007644,P010452,2.983,-2,5,7
178,CAN,P008121,P010385,9.117,-3,19,22
178,CAN,P008121,P010452,4.016,-6,6,12
178,CAN,P010385,P010452,10.951,-2,22,24
179,CLU,P004862,P005113,22.667,4,53,49
179,CLU,P004862,P005373,9.383,-9,17,26
179,CLU,P004862,P005714,14.267,-5,24,29
179,CLU,P004862,P010569,22.249,9,55,46
179,CLU,P004862,P011801,26.133,14,61,47
179,CLU,P004862,P012620,4.3,-14,5,19
179,CLU,P004862,P012621,26.165,-11,54,65
179,CLU,P004862,P012698,12.232,0,27,27
179,CLU,P005113,P005714,10.234,-8,17,25
179,CLU,P005113,P010569,15.283,9,41,32
179,CLU,P005113,P011801,16.234,14,42,28
179,CLU,P005113,P012620,2.817,-9,3,12
179,CLU,P005113,P012621,19.2,-6,43,49
179,CLU,P005113,P012698,10.233,0,21,21
179,CLU,P005373,P005714,3.367,-4,5,9
179,CLU,P005373,P010569,10.133,-2,23,25
179,CLU,P005373,P011801,12.017,-3,26,29
179,CLU,P005373,P012620,1.483,-5,2,7
179,CLU,P005373,P012621,10.316,-9,20,29
179,CLU,P005373,P012698,7.433,0,19,19
179,CLU,P005714,P010569,3.433,4,7,3
179,CLU,P005714,P011801,10.234,7,19,12
179,CLU,P005714,P012620,4.3,-14,5,19
179,CLU,P005714,P012621,10.716,-16,13,29
179,CLU,P005714,P012698,6.517,4,14,10
179,CLU,P010569,P011801,22.483,13,58,45
179,CLU,P010569,P012621,24.382,8,60,52
179,CLU,P010569,P012698,12.565,-5,28,33
179,CLU,P011801,P012621,22.366,5,52,47
179,CLU,P011801,P012698,12.733,2,30,28
179,CLU,P012620,P012621,4.3,-14,5,19
179,CLU,P012621,P012698,9.815,-9,21,30
179,LKB,P005521,P006901,11.633,-5,26,31
179,LKB,P005521,P007029,13.284,-6,25,31
179,LKB,P005521,P009898,9.3,-5,17,22
179,LKB,P005521,P010190,2.25,0,5,5
179,LKB,P005521,P010461,9.484,1,19,18
179,LKB,P005521,P011329,9.634,-1,23,24
179,LKB,P005521,PLXI,13.351,-8,25,33
179,LKB,P006901,P007029,15.816,-3,38,41
179,LKB,P006901,P009898,12.049,-4,25,29
179,LKB,P006901,P010190,5.283,2,15,13
179,LKB,P006901,P010461,9.649,6,26,20
179,LKB,P006901,P011329,6.283,1,18,17
179,LKB,P006901,PLXI,12.083,-9,24,33
179,LKB,P007029,P009898,25.216,-4,52,56
179,LKB,P007029,P010190,10.833,4,28,24
179,LKB,P007029,P010461,25.0,6,55,49
179,LKB,P007029,P011329,13.7,-4,28,32
179,LKB,P007029,PLXI,29.283,-13,54,67
179,LKB,P009898,P010190,15.717,14,45,31
179,LKB,P009898,P010461,27.766,12,68,56
179,LKB,P009898,P011329,10.1,7,27,20
179,LKB,P009898,PLXI,27.584,4,62,58
179,LKB,P010190,P010461,14.783,14,42,28
179,LKB,P010190,P011329,2.9,10,12,2
179,LKB,P010190,PLXI,11.634,12,33,21
179,LKB,P010461,P011329,13.784,9,34,25
179,LKB,P010461,PLXI,25.334,8,56,48
179,LKB,P011329,PLXI,16.267,2,38,36
180,TTK,P004801,P005000,7.384,-4,10,14
180,TTK,P004801,P006693,27.451,13,61,48
180,TTK,P004801,P006883,7.734,0,12,12
180,TTK,P004801,P009845,1.25,0,2,2
180,TTK,P004801,P011239,21.134,13,51,38
180,TTK,P004801,P011272,0.833,2,2,0
180,TTK,P004801,P011834,23.567,19,57,38
180,TTK,P004801,P011925,26.618,11,59,48
180,TTK,P004801,P011975,0.833,2,2,0
180,TTK,P005000,P006693,7.317,-5,10,15
180,TTK,P005000,P006883,11.633,4,20,16
180,TTK,P005000,P009845,1.25,0,2,2
180,TTK,P005000,P010477,5.816,8,14,6
180,TTK,P005000,P011239,6.2,9,16,7
180,TTK,P005000,P011834,2.8,3,5,2
180,TTK,P005000,P011925,10.4,1,19,18
180,TTK,P006693,P006883,9.434,-4,12,16
180,TTK,P006693,P010477,6.667,-6,11,17
180,TTK,P006693,P011239,23.851,9,58,49
180,TTK,P006693,P011272,0.833,2,2,0
180,TTK,P006693,P011834,26.801,12,62,50
180,TTK,P006693,P011925,33.285,5,70,65
180,TTK,P006693,P011975,0.833,2,2,0
180,TTK,P006883,P009845,1.25,0,2,2
180,TTK,P006883,P010477,7.583,5,14,9
180,TTK,P006883,P011239,4.633,9,12,3
180,TTK,P006883,P011834,6.484,4,11,7
180,TTK,P006883,P011925,12.517,2,21,19
180,TTK,P009845,P011834,1.25,0,2,2
180,TTK,P010477,P011239,7.35,5,19,14
180,TTK,P010477,P011834,6.034,-4,10,14
180,TTK,P010477,P011925,9.75,0,20,20
180,TTK,P011239,P011834,23.834,12,57,45
180,TTK,P011239,P011925,26.934,15,67,52
180,TTK,P011272,P011834,0.833,2,2,0
180,TTK,P011272,P011975,0.833,2,2,0
180,TTK,P011834,P011925,25.968,10,60,50
180,TTK,P011834,P011975,0.833,2,2,0
180,WRO,P005531,P007472,0.833,-2,0,2
180,WRO,P005531,P009896,27.9,-6,54,60
180,WRO,P005531,P011900,20.583,-11,36,47
180,WRO,P005531,P011902,10.483,-12,14,26
180,WRO,P005531,P012094,30.2,-6,63,69
180,WRO,P005531,P012308,4.283,1,5,4
180,WRO,P005531,P012699,24.567,-12,45,57
180,WRO,P005531,P012736,19.683,0,35,35
180,WRO,P007472,P009896,0.833,-2,0,2
180,WRO,P007472,P012308,0.833,-2,0,2
180,WRO,P007472,P012736,0.833,-2,0,2
180,WRO,P009896,P011900,20.333,-14,34,48
180,WRO,P009896,P011902,6.683,-3,10,13
180,WRO,P009896,P012094,25.95,-7,56,63
180,WRO,P009896,P012308,4.283,1,5,4
180,WRO,P009896,P012699,26.533,-11,49,60
180,WRO,P009896,P012736,19.549,2,36,34
180,WRO,P011900,P011902,11.899,-4,19,23
180,WRO,P011900,P012094,19.816,-14,38,52
180,WRO,P011900,P012699,18.916,-14,28,42
180,WRO,P011900,P012736,12.249,-3,17,20
180,WRO,P011902,P012094,9.366,-10,14,24
180,WRO,P011902,P012699,7.4,-4,8,12
180,WRO,P011902,P012736,8.833,-3,11,14
180,WRO,P012094,P012308,3.45,3,5,2
180,WRO,P012094,P012699,23.4,-15,47,62
180,WRO,P012094,P012736,18.35,-3,37,40
180,WRO,P012308,P012699,1.25,0,2,2
180,WRO,P012308,P012736,3.033,1,3,2
180,WRO,P012699,P012736,17.666,-8,29,37
181,LLI,P004773,P005247,13.133,2,29,27
181,LLI,P004773,P006600,1.484,0,4,4
181,LLI,P004773,P008274,1.383,-2,0,2
181,LLI,P004773,P009649,0.367,-2,0,2
181,LLI,P004773,P009672,11.0,0,25,25
181,LLI,P004773,P009680,12.016,0,25,25
181,LLI,P004773,P012020,12.016,0,25,25
181,LLI,P004773,P012586,1.484,0,4,4
181,LLI,P004773,P012797,1.117,2,4,2
181,LLI,P005247,P006600,2.517,3,9,6
181,LLI,P005247,P008274,1.383,-2,0,2
181,LLI,P005247,P009672,16.633,12,44,32
181,LLI,P005247,P009680,16.999,9,39,30
181,LLI,P005247,P012020,17.566,9,39,30
181,LLI,P005247,P012585,2.533,3,6,3
181,LLI,P005247,P012586,3.084,3,9,6
181,LLI,P005247,P012797,6.484,9,17,8
181,LLI,P006600,P009649,19.167,12,51,39
181,LLI,P006600,P009672,1.767,-1,5,6
181,LLI,P006600,P012585,18.8,14,51,37
181,LLI,P006600,P012586,21.684,15,60,45
181,LLI,P006600,P012797,21.317,17,60,43
181,LLI,P008274,P009680,1.383,-2,0,2
181,LLI,P008274,P012020,1.383,-2,0,2
181,LLI,P009649,P009672,0.367,-2,0,2
181,LLI,P009649,P012020,0.75,-1,1,2
181,LLI,P009649,P012585,19.55,13,52,39
181,LLI,P009649,P012586,19.917,11,52,41
181,LLI,P009649,P012797,19.55,13,52,39
181,LLI,P009672,P009680,15.233,11,39,28
181,LLI,P009672,P012020,15.233,11,39,28
181,LLI,P009672,P012585,1.583,3,6,3
181,LLI,P009672,P012586,1.767,-1,5,6
181,LLI,P009672,P012797,4.417,7,13,6
181,LLI,P009680,P012020,16.999,9,39,30
181,LLI,P009680,P012585,1.966,3,6,3
181,LLI,P009680,P012797,3.4,6,8,2
181,LLI,P012020,P012585,3.283,2,7,5
181,LLI,P012020,P012586,1.317,-1,1,2
181,LLI,P012020,P012797,4.717,5,9,4
181,LLI,P012585,P012586,20.117,13,52,39
181,LLI,P012585,P012797,20.5,13,52,39
181,LLI,P012586,P012797,22.634,16,61,45
181,TTK,P004801,P005000,12.201,-2,24,26
181,TTK,P004801,P006693,11.467,-2,25,27
181,TTK,P004801,P006883,7.332,-1,19,20
181,TTK,P004801,P009845,4.45,-2,10,12
181,TTK,P004801,P011239,15.817,-1,32,33
181,TTK,P004801,P011834,7.883,-2,19,21
181,TTK,P004801,P011925,17.599,-4,41,45
181,TTK,P004801,P011975,1.383,2,2,0
181,TTK,P005000,P006693,17.134,-18,27,45
181,TTK,P005000,P006883,4.067,-2,7,9
181,TTK,P005000,P009845,1.067,1,2,1
181,TTK,P005000,P010477,8.8,-12,12,24
181,TTK,P005000,P011239,16.934,-12,29,41
181,TTK,P005000,P011834,8.151,-6,11,17
181,TTK,P005000,P011925,15.65,-5,32,37
181,TTK,P006693,P006883,5.2,-3,14,17
181,TTK,P006693,P009845,1.783,-4,2,6
181,TTK,P006693,P010477,16.416,-21,27,48
181,TTK,P006693,P011239,20.9,-16,36,52
181,TTK,P006693,P011834,15.033,-15,27,42
181,TTK,P006693,P011925,23.599,-13,50,63
181,TTK,P006883,P009845,3.383,-3,8,11
181,TTK,P006883,P010477,8.917,-3,18,21
181,TTK,P006883,P011239,4.866,-1,8,9
181,TTK,P006883,P011834,14.866,-6,35,41
181,TTK,P006883,P011925,14.982,1,37,36
181,TTK,P006883,P011975,1.383,2,2,0
181,TTK,P009845,P010477,1.783,-4,2,6
181,TTK,P009845,P011239,1.067,1,2,1
181,TTK,P009845,P011834,6.233,-6,12,18
181,TTK,P009845,P011925,5.166,-7,10,17
181,TTK,P010477,P011239,11.016,-15,14,29
181,TTK,P010477,P011834,17.883,-15,31,46
181,TTK,P010477,P011925,17.049,-10,32,42
181,TTK,P011239,P011834,12.6,-10,19,29
181,TTK,P011239,P011925,22.749,-12,42,54
181,TTK,P011239,P011975,1.383,2,2,0
181,TTK,P011834,P011925,20.415,-8,46,54
181,TTK,P011925,P011975,1.383,2,2,0
182,JOV,P002361,P002507,10.184,0,18,18
182,JOV,P002361,P006771,3.301,-2,8,10
182,JOV,P002361,P010161,1.934,3,8,5
182,JOV,P002361,P010458,22.034,9,48,39
182,JOV,P002361,P010677,2.333,0,4,4
182,JOV,P002361,P011247,16.451,10,43,33
182,JOV,P002361,P011248,17.783,17,44,27
182,JOV,P002361,P012780,13.517,10,36,26
182,JOV,P002361,PJUG,7.867,1,15,14
182,JOV,P002507,P006771,5.934,-2,6,8
182,JOV,P002507,P010161,9.3,-1,15,16
182,JOV,P002507,P010458,14.568,4,31,27
182,JOV,P002507,P010677,14.984,2,30,28
182,JOV,P002507,P011247,22.868,2,43,41
182,JOV,P002507,P011248,15.167,8,36,28
182,JOV,P002507,PJUG,2.467,-1,5,6
182,JOV,P006771,P010161,8.601,-6,14,20
182,JOV,P006771,P010458,3.217,-4,4,8
182,JOV,P006771,P010677,8.417,-6,10,16
182,JOV,P006771,P011247,10.401,-10,17,27
182,JOV,P006771,P011248,1.166,-2,1,3
182,JOV,P006771,P012780,5.767,-8,12,20
182,JOV,P010161,P010458,0.117,0,0,0
182,JOV,P010161,P010677,10.6,-5,18,23
182,JOV,P010161,P011247,12.417,-2,26,28
182,JOV,P010161,P011248,3.933,4,12,8
182,JOV,P010161,P012780,3.234,-1,11,12
182,JOV,P010458,P010677,7.9,4,18,14
182,JOV,P010458,P011247,19.001,9,48,39
182,JOV,P010458,P011248,22.766,16,55,39
182,JOV,P010458,P012780,12.866,5,29,24
182,JOV,P010458,PJUG,7.867,1,15,14
182,JOV,P010677,P011247,16.434,0,35,35
182,JOV,P010677,P011248,9.966,6,25,19
182,JOV,P010677,P012780,3.366,-5,4,9
182,JOV,P011247,P011248,18.233,18,53,35
182,JOV,P011247,P012780,8.4,3,29,26
182,JOV,P011247,PJUG,1.467,-2,2,4
182,JOV,P011248,P012780,11.382,10,29,19
182,JOV,P011248,PJUG,6.4,3,13,10
182,JOV,P012780,PJUG,5.4,2,10,8
182,ULM,P005422,P007952,6.483,-7,9,16
182,ULM,P005422,P010106,16.817,9,33,24
182,ULM,P005422,P010582,19.567,2,37,35
182,ULM,P005422,P011188,3.384,0,7,7
182,ULM,P005422,P011457,4.384,5,11,6
182,ULM,P005422,P012603,20.567,7,41,34
182,ULM,P005422,P012604,17.468,14,39,25
182,ULM,P005422,P012703,7.134,-2,15,17
182,ULM,P006997,P010106,4.067,-1,8,9
182,ULM,P006997,P010582,3.8,2,6,4
182,ULM,P006997,P010726,1.367,-8,0,8
182,ULM,P006997,P011188,6.85,1,12,11
182,ULM,P006997,P011457,8.534,-7,12,19
182,ULM,P006997,P012604,1.684,-8,0,8
182,ULM,P006997,P012703,7.834,-7,10,17
182,ULM,P007952,P010106,2.883,0,4,4
182,ULM,P007952,P010582,6.483,-7,9,16
182,ULM,P007952,P012603,6.483,-7,9,16
182,ULM,P007952,P012703,3.6,-7,5,12
182,ULM,P010106,P010582,19.851,2,45,43
182,ULM,P010106,P010726,1.0,0,3,3
182,ULM,P010106,P011188,7.534,-7,15,22
182,ULM,P010106,P011457,7.101,-8,17,25
182,ULM,P010106,P012603,16.217,8,37,29
182,ULM,P010106,P012604,17.435,2,40,38
182,ULM,P010106,P012703,3.367,-1,6,7
182,ULM,P010582,P010726,2.967,1,6,5
182,ULM,P010582,P011188,7.084,-6,12,18
182,ULM,P010582,P011457,8.351,-8,19,27
182,ULM,P010582,P012603,23.801,1,50,49
182,ULM,P010582,P012604,20.602,0,47,47
182,ULM,P010582,P012703,11.034,-7,17,24
182,ULM,P010726,P011188,1.35,-2,3,5
182,ULM,P010726,P011457,1.367,-8,0,8
182,ULM,P010726,P012603,1.617,3,3,0
182,ULM,P010726,P012604,4.334,-7,6,13
182,ULM,P010726,P012703,3.334,-7,3,10
182,ULM,P011188,P011457,11.134,-7,18,25
182,ULM,P011188,P012604,6.151,-9,11,20
182,ULM,P011188,P012703,8.517,-2,14,16
182,ULM,P011457,P012603,4.651,3,18,15
182,ULM,P011457,P012604,10.619,-13,24,37
182,ULM,P011457,P012703,13.735,-5,25,30
182,ULM,P012603,P012604,18.835,14,47,33
182,ULM,P012603,P012703,9.101,-1,19,20
182,ULM,P012604,P012703,9.552,-5,18,23
183,BES,P003783,P007914,9.417,2,21,19
183,BES,P003783,P007917,4.8,-8,7,15
183,BES,P003783,P008945,5.25,1,17,16
183,BES,P003783,P011379,4.3,3,8,5
183,BES,P003783,P011924,11.301,-4,22,26
183,BES,P003783,P011936,3.216,0,8,8
183,BES,P003783,P012622,15.8,-1,37,38
183,BES,P003783,P012647,8.6,1,19,18
183,BES,P003783,P012711,9.384,-6,17,23
183,BES,P007914,P007917,0.7,-2,0,2
183,BES,P007914,P008945,7.333,6,19,13
183,BES,P007914,P011379,2.484,3,6,3
183,BES,P007914,P011924,7.75,0,15,15
183,BES,P007914,P011936,1.75,4,5,1
183,BES,P007914,P012622,9.133,3,22,19
183,BES,P007914,P012647,6.467,0,13,13
183,BES,P007914,P012711,6.966,4,15,11
183,BES,P007917,P011924,4.8,-8,7,15
183,BES,P007917,P012622,4.1,-6,7,13
183,BES,P007917,P012711,4.8,-8,7,15
183,BES,P008945,P011379,12.25,0,21,21
183,BES,P008945,P011924,3.866,0,9,9
183,BES,P008945,P011936,20.449,6,42,36
183,BES,P008945,P012622,25.582,2,53,51
183,BES,P008945,P012647,18.182,-4,36,40
183,BES,P008945,P012711,16.016,13,35,22
183,BES,P011379,P011924,2.417,1,4,3
183,BES,P011379,P011936,14.133,2,25,23
183,BES,P011379,P012622,15.733,0,26,26
183,BES,P011379,P012647,6.816,-5,10,15
183,BES,P011379,P012711,8.067,8,16,8
183,BES,P011924,P011936,0.583,1,2,1
183,BES,P011924,P012622,12.533,-4,25,29
183,BES,P011924,P012647,4.05,-3,4,7
183,BES,P011924,P012711,11.7,-7,20,27
183,BES,P011936,P012622,20.682,4,41,37
183,BES,P011936,P012647,14.982,1,31,30
183,BES,P011936,P012711,13.533,14,30,16
183,BES,P012622,P012647,19.599,-3,38,41
183,BES,P012622,P012711,21.366,5,43,38
183,BES,P012647,P012711,9.1,5,17,12
183,CAN,P001607,P003425,1.217,1,4,3
183,CAN,P001607,P003637,2.766,-7,1,8
183,CAN,P001607,P004160,4.217,-2,7,9
183,CAN,P001607,P005005,5.267,-7,6,13
183,CAN,P001607,P006588,1.65,2,5,3
183,CAN,P001607,P007560,2.95,-2,7,9
183,CAN,P001607,P008121,5.883,-3,13,16
183,CAN,P001607,P009864,6.1,-4,12,16
183,CAN,P001607,P010385,5.05,-6,7,13
183,CAN,P001607,P010452,9.5,-12,14,26
183,CAN,P003425,P003637,20.651,10,48,38
183,CAN,P003425,P004160,5.467,-2,9,11
183,CAN,P003425,P005005,8.317,1,15,14
183,CAN,P003425,P006588,18.967,1,34,33
183,CAN,P003425,P007560,0.25,-2,0,2
183,CAN,P003425,P007644,0.25,-2,0,2
183,CAN,P003425,P008121,23.584,4,46,42
183,CAN,P003425,P009864,12.0,1,21,20
183,CAN,P003425,P010385,17.368,8,40,32
183,CAN,P003425,P010452,10.401,8,27,19
183,CAN,P003637,P004160,0.45,2,2,0
183,CAN,P003637,P005005,5.667,1,13,12
183,CAN,P003637,P006588,16.067,3,34,31
183,CAN,P003637,P008121,18.2,4,38,34
183,CAN,P003637,P009864,10.133,2,21,19
183,CAN,P003637,P010385,13.734,3,30,27
183,CAN,P003637,P010452,7.8,2,17,15
183,CAN,P004160,P005005,5.668,-5,8,13
183,CAN,P004160,P006588,1.0,0,0,0
183,CAN,P004160,P007560,0.25,-2,0,2
183,CAN,P004160,P007644,0.25,-2,0,2
183,CAN,P004160,P008121,4.466,3,10,7
183,CAN,P004160,P009864,2.0,-1,5,6
183,CAN,P004160,P010385,7.884,1,13,12
183,CAN,P004160,P010452,8.884,0,18,18
183,CAN,P005005,P006588,1.9,-2,0,2
183,CAN,P005005,P007560,0.25,-2,0,2
183,CAN,P005005,P007644,0.25,-2,0,2
183,CAN,P005005,P008121,2.283,-2,0,2
183,CAN,P005005,P009864,4.0,-5,3,8
183,CAN,P005005,P010385,9.351,1,18,17
183,CAN,P005005,P010452,11.451,-2,21,23
183,CAN,P006588,P007560,1.65,2,5,3
183,CAN,P006588,P008121,20.617,3,39,36
183,CAN,P006588,P009864,12.9,3,26,23
183,CAN,P006588,P010385,7.717,0,13,13
183,CAN,P007560,P007644,0.25,-2,0,2
183,CAN,P007560,P008121,2.95,-2,7,9
183,CAN,P007560,P009864,2.95,-2,7,9
183,CAN,P007560,P010452,1.3,-4,2,6
183,CAN,P008121,P009864,16.016,0,30,30
183,CAN,P008121,P010385,12.667,2,27,25
183,CAN,P008121,P010452,8.066,-1,18,19
183,CAN,P009864,P010452,4.833,-6,7,13
183,CAN,P010385,P010452,14.301,3,32,29
184,ARI,P002867,P003240,2.017,2,4,2
184,ARI,P002867,P010387,1.7,-6,2,8
184,ARI,P002867,P012615,5.334,-8,5,13
184,ARI,P002867,P012702,5.0,-11,6,17
184,ARI,P002867,P012716,5.05,-7,5,12
184,ARI,P002867,P012717,3.433,-3,6,9
184,ARI,P002867,P012722,1.417,-2,1,3
184,ARI,P002867,P012760,2.35,2,4,2
184,ARI,P002867,P012792,8.767,-11,11,22
184,ARI,P003240,P004292,22.434,-16,35,51
184,ARI,P003240,P010387,2.917,-1,4,5
184,ARI,P003240,P012615,13.7,-7,24,31
184,ARI,P003240,P012702,6.184,0,13,13
184,ARI,P003240,P012716,20.384,-15,31,46
184,ARI,P003240,P012717,21.218,-15,35,50
184,ARI,P003240,P012722,2.9,0,5,5
184,ARI,P003240,P012760,12.601,-12,19,31
184,ARI,P003240,P012792,10.785,-4,22,26
184,ARI,P004292,P010177,1.817,0,2,2
184,ARI,P004292,P010387,4.317,3,9,6
184,ARI,P004292,P012615,11.75,-6,20,26
184,ARI,P004292,P012702,4.017,3,10,7
184,ARI,P004292,P012716,20.383,-9,36,45
184,ARI,P004292,P012717,21.017,-11,38,49
184,ARI,P004292,P012722,6.25,3,14,11
184,ARI,P004292,P012760,9.267,-13,12,25
184,ARI,P004292,P012792,5.284,-2,12,14
184,ARI,P010177,P010387,2.084,-2,2,4
184,ARI,P010177,P012717,2.084,-2,2,4
184,ARI,P010177,P012722,2.084,-2,2,4
184,ARI,P010177,P012792,0.267,-2,0,2
184,ARI,P010387,P012615,2.617,-4,4,8
184,ARI,P010387,P012702,3.65,-7,6,13
184,ARI,P010387,P012716,2.5,3,7,4
184,ARI,P010387,P012717,4.65,-2,11,13
184,ARI,P010387,P012722,4.584,1,9,8
184,ARI,P010387,P012792,3.917,-9,6,15
184,ARI,P012615,P012702,8.251,-8,12,20
184,ARI,P012615,P012716,11.983,-8,16,24
184,ARI,P012615,P012717,7.1,-5,11,16
184,ARI,P012615,P012722,3.35,-2,6,8
184,ARI,P012615,P012760,0.333,0,0,0
184,ARI,P012615,P012792,11.718,-12,18,30
184,ARI,P012702,P012716,7.267,-2,14,16
184,ARI,P012702,P012717,3.783,-2,10,12
184,ARI,P012702,P012792,9.984,-13,17,30
184,ARI,P012716,P012717,20.5,-13,39,52
184,ARI,P012716,P012722,4.0,1,8,7
184,ARI,P012716,P012760,10.917,-14,15,29
184,ARI,P012716,P012792,8.284,-8,13,21
184,ARI,P012717,P012722,3.617,1,9,8
184,ARI,P012717,P012760,12.601,-12,19,31
184,ARI,P012717,P012792,8.401,-8,16,24
184,ARI,P012722,P012792,3.534,-4,6,10
184,ARI,P012760,P012792,3.667,1,7,6
184,PMT,P001686,P002644,9.617,0,17,17
184,PMT,P001686,P011823,4.283,7,13,6
184,PMT,P001686,P011942,1.817,-2,2,4
184,PMT,P001686,P011943,6.133,6,16,10
184,PMT,P001686,P011944,10.483,9,26,17
184,PMT,P001686,P011947,9.367,1,16,15
184,PMT,P001686,P012600,13.9,7,30,23
184,PMT,P002020,P002691,2.083,2,4,2
184,PMT,P002020,P005301,2.083,2,4,2
184,PMT,P002020,P011943,2.083,2,4,2
184,PMT,P002020,P011944,0.95,2,2,0
184,PMT,P002020,P011947,1.133,0,2,2
184,PMT,P002644,P002691,2.317,-3,4,7
184,PMT,P002644,P005301,13.651,8,32,24
184,PMT,P002644,P011942,11.033,13,31,18
184,PMT,P002644,P011943,12.45,-1,23,24
184,PMT,P002644,P011944,15.917,7,34,27
184,PMT,P002644,P011947,14.251,6,31,25
184,PMT,P002644,P012600,15.368,10,36,26
184,PMT,P002691,P005301,4.4,-1,8,9
184,PMT,P002691,P011943,4.4,-1,8,9
184,PMT,P002691,P011944,0.95,2,2,0
184,PMT,P002691,P011947,3.45,-3,6,9
184,PMT,P005301,P011823,9.983,9,26,17
184,PMT,P005301,P011942,20.633,20,54,34
184,PMT,P005301,P011943,17.216,7,38,31
184,PMT,P005301,P011944,16.8,13,39,26
184,PMT,P005301,P011947,9.334,6,23,17
184,PMT,P005301,P012600,8.768,12,24,12
184,PMT,P011823,P011942,11.8,7,28,21
184,PMT,P011823,P011943,8.816,12,27,15
184,PMT,P011823,P011944,10.799,15,32,17
184,PMT,P011823,P011947,3.7,3,9,6
184,PMT,P011823,P012600,7.683,11,21,10
184,PMT,P011942,P011943,12.549,8,30,22
184,PMT,P011942,P011944,15.816,13,40,27
184,PMT,P011942,P011947,7.4,9,22,13
184,PMT,P011942,P012600,10.284,12,29,17
184,PMT,P011943,P011944,17.699,16,46,30
184,PMT,P011943,P011947,5.65,-3,8,11
184,PMT,P011943,P012600,6.4,6,16,10
184,PMT,P011944,P011947,6.75,5,15,10
184,PMT,P011944,P012600,14.5,14,36,22
184,PMT,P011947,P012600,15.301,12,36,24
185,JOV,P002361,P002507,16.284,0,33,33
185,JOV,P002361,P006771,2.55,1,3,2
185,JOV,P002361,P010161,2.067,-5,0,5
185,JOV,P002361,P010458,16.25,0,29,29
185,JOV,P002361,P010677,3.3,-5,3,8
185,JOV,P002361,P011247,18.451,2,41,39
185,JOV,P002361,P011248,20.701,-3,41,44
185,JOV,P002361,P012349,6.417,-2,14,16
185,JOV,P002361,P012780,8.584,-8,12,20
185,JOV,P002507,P006771,1.15,-2,0,2
185,JOV,P002507,P010161,3.566,-2,7,9
185,JOV,P002507,P010458,12.4,-2,24,26
185,JOV,P002507,P010677,7.533,-13,12,25
185,JOV,P002507,P011247,20.651,-6,42,48
185,JOV,P002507,P011248,21.134,-10,41,51
185,JOV,P002507,P012349,6.783,-1,15,16
185,JOV,P002507,P012780,4.567,-8,6,14
185,JOV,P006771,P010458,0.883,3,3,0
185,JOV,P006771,P010677,3.033,4,6,2
185,JOV,P006771,P011248,3.817,-1,3,4
185,JOV,P006771,P012349,3.55,4,6,2
185,JOV,P006771,P012780,3.817,-1,3,4
185,JOV,P010161,P010458,3.25,-6,3,9
185,JOV,P010161,P010677,5.433,-5,7,12
185,JOV,P010161,P011247,2.183,1,4,3
185,JOV,P010161,P011248,1.183,-1,3,4
185,JOV,P010161,P012349,2.183,1,4,3
185,JOV,P010161,P012780,1.867,-3,0,3
185,JOV,P010458,P010677,9.4,-11,16,27
185,JOV,P010458,P011247,17.634,0,36,36
185,JOV,P010458,P011248,19.4,-4,39,43
185,JOV,P010458,P012349,1.433,0,3,3
185,JOV,P010458,P012780,8.75,-4,15,19
185,JOV,P010677,P011247,13.017,-11,20,31
185,JOV,P010677,P011248,14.517,-15,22,37
185,JOV,P010677,P012349,8.983,3,14,11
185,JOV,P010677,P012780,13.384,-11,16,27
185,JOV,P011247,P011248,29.285,-10,57,67
185,JOV,P011247,P012349,10.734,-6,19,25
185,JOV,P011247,P012780,13.917,-6,25,31
185,JOV,P011248,P012349,11.451,-6,18,24
185,JOV,P011248,P012780,17.984,-10,28,38
185,JOV,P012349,P012780,6.534,-1,7,8
185,PRS,P003481,P005793,14.033,-4,22,26
185,PRS,P003481,P009556,11.983,-7,17,24
185,PRS,P003481,P011232,16.866,8,37,29
185,PRS,P003481,P012608,5.766,12,20,8
185,PRS,P003481,P012609,4.35,7,11,4
185,PRS,P003481,P012610,3.016,2,7,5
185,PRS,P003481,P012613,1.583,4,8,4
185,PRS,P003481,P012640,13.399,-2,26,28
185,PRS,P004512,P012608,6.883,-4,11,15
185,PRS,P004512,P012609,6.883,-4,11,15
185,PRS,P004512,P012610,6.883,-4,11,15
185,PRS,P004512,P012613,6.883,-4,11,15
185,PRS,P005793,P009556,11.983,-7,17,24
185,PRS,P005793,P011232,13.15,-1,22,23
185,PRS,P005793,P012608,3.233,4,9,5
185,PRS,P005793,P012609,3.4,3,8,5
185,PRS,P005793,P012610,2.066,-2,4,6
185,PRS,P005793,P012613,1.183,1,4,3
185,PRS,P005793,P012640,11.816,-6,18,24
185,PRS,P009556,P011232,11.1,-4,17,21
185,PRS,P009556,P012609,2.217,2,4,2
185,PRS,P009556,P012610,0.883,-3,0,3
185,PRS,P009556,P012640,9.766,-9,13,22
185,PRS,P011232,P012608,17.616,18,43,25
185,PRS,P011232,P012609,10.317,9,22,13
185,PRS,P011232,P012610,13.983,11,30,19
185,PRS,P011232,P012613,13.433,10,31,21
185,PRS,P011232,P012640,18.399,5,38,33
185,PRS,P012608,P012609,18.499,12,44,32
185,PRS,P012608,P012610,24.382,16,56,40
185,PRS,P012608,P012613,23.832,15,57,42
185,PRS,P012608,P012640,11.849,19,36,17
185,PRS,P012609,P012610,18.499,12,44,32
185,PRS,P012609,P012613,16.366,7,37,30
185,PRS,P012609,P012640,2.333,8,11,3
185,PRS,P012610,P012613,22.249,11,49,38
185,PRS,P012610,P012640,9.099,9,23,14
185,PRS,P012613,P012640,9.799,16,31,15
186,CLU,P004862,P005113,11.067,-7,20,27
186,CLU,P004862,P005373,4.016,-2,8,10
186,CLU,P004862,P005714,15.233,-7,27,34
186,CLU,P004862,P010569,14.983,-8,26,34
186,CLU,P004862,P011797,9.717,-9,17,26
186,CLU,P004862,P011801,2.049,-6,2,8
186,CLU,P004862,P012620,3.767,-1,7,8
186,CLU,P004862,P012621,19.617,-3,38,41
186,CLU,P004862,P012698,12.883,-5,23,28
186,CLU,P005113,P005714,5.883,-2,11,13
186,CLU,P005113,P010569,7.6,-9,12,21
186,CLU,P005113,P011797,9.917,-11,15,26
186,CLU,P005113,P011801,3.3,-10,2,12
186,CLU,P005113,P012620,4.783,2,9,7
186,CLU,P005113,P012621,15.8,-13,26,39
186,CLU,P005113,P012698,4.85,-2,9,11
186,CLU,P005373,P005714,10.417,4,27,23
186,CLU,P005373,P010569,3.0,-1,5,6
186,CLU,P005373,P011797,3.45,1,6,5
186,CLU,P005373,P011801,10.684,3,26,23
186,CLU,P005373,P012620,0.417,1,2,1
186,CLU,P005373,P012621,8.684,4,24,20
186,CLU,P005373,P012698,13.0,2,30,28
186,CLU,P005714,P010569,11.083,-2,21,23
186,CLU,P005714,P011797,6.517,0,15,15
186,CLU,P005714,P011801,12.466,-3,30,33
186,CLU,P005714,P012620,5.2,3,11,8
186,CLU,P005714,P012621,18.85,5,42,37
186,CLU,P005714,P012698,22.683,2,52,50
186,CLU,P010569,P011797,11.133,-10,21,31
186,CLU,P010569,P011801,7.166,-8,12,20
186,CLU,P010569,P012621,17.117,-8,29,37
186,CLU,P010569,P012698,13.45,-2,26,28
186,CLU,P011797,P011801,7.1,-2,13,15
186,CLU,P011797,P012621,9.917,-11,15,26
186,CLU,P011797,P012698,9.517,-2,18,20
186,CLU,P011801,P012621,10.667,-9,20,29
186,CLU,P011801,P012698,15.7,-5,35,40
186,CLU,P012620,P012621,5.2,3,11,8
186,CLU,P012620,P012698,1.433,4,4,0
186,CLU,P012621,P012698,19.684,4,43,39
186,LLI,P004479,P004773,2.133,5,7,2
186,LLI,P004479,P005247,2.85,3,9,6
186,LLI,P004479,P009672,2.85,3,9,6
186,LLI,P004479,P012020,2.85,3,9,6
186,LLI,P004479,P012797,0.717,-2,2,4
186,LLI,P004773,P005247,10.817,15,31,16
186,LLI,P004773,P009672,7.95,12,25,13
186,LLI,P004773,P009680,4.917,8,13,5
186,LLI,P004773,P012020,10.817,15,31,16
186,LLI,P004773,P012585,3.767,2,11,9
186,LLI,P004773,P012586,2.867,3,6,3
186,LLI,P005247,P009649,5.85,0,11,11
186,LLI,P005247,P009672,21.267,6,47,41
186,LLI,P005247,P009680,7.767,5,14,9
186,LLI,P005247,P012020,22.234,12,52,40
186,LLI,P005247,P012585,11.534,-2,25,27
186,LLI,P005247,P012586,7.25,-2,14,16
186,LLI,P005247,P012797,6.967,-1,9,10
186,LLI,P009649,P009672,8.366,-4,17,21
186,LLI,P009649,P009680,15.866,3,38,35
186,LLI,P009649,P012020,6.0,-3,11,14
186,LLI,P009649,P012585,18.316,-1,43,44
186,LLI,P009649,P012586,15.383,4,36,32
186,LLI,P009649,P012797,17.083,13,40,27
186,LLI,P009672,P009680,7.416,-2,14,16
186,LLI,P009672,P012020,19.367,9,46,37
186,LLI,P009672,P012585,14.05,-6,31,37
186,LLI,P009672,P012586,6.416,-8,12,20
186,LLI,P009672,P012797,7.45,-2,11,13
186,LLI,P009680,P012020,6.017,5,13,8
186,LLI,P009680,P012585,17.283,4,39,35
186,LLI,P009680,P012586,18.733,3,42,39
186,LLI,P009680,P012797,16.533,6,35,29
186,LLI,P012020,P012585,10.267,-6,24,30
186,LLI,P012020,P012586,6.917,-1,14,15
186,LLI,P012020,P012797,5.067,2,8,6
186,LLI,P012585,P012586,19.283,3,44,41
186,LLI,P012585,P012797,15.1,10,35,25
186,LLI,P012586,P012797,13.683,6,32,26
187,BOU,P004525,P010431,7.85,-6,20,26
187,BOU,P004525,P010449,12.317,-1,27,28
187,BOU,P004525,P010718,7.3,-6,18,24
187,BOU,P004525,P011161,10.634,3,23,20
187,BOU,P004525,P011836,5.033,-3,14,17
187,BOU,P004525,P011837,7.001,-2,18,20
187,BOU,P004525,P012617,6.167,-2,16,18
187,BOU,P004525,P012618,6.45,2,11,9
187,BOU,P004525,P012628,11.184,3,25,22
187,BOU,P010431,P010449,5.467,-7,9,16
187,BOU,P010431,P010718,16.9,0,39,39
187,BOU,P010431,P011836,21.9,8,54,46
187,BOU,P010431,P011837,16.017,11,39,28
187,BOU,P010431,P012617,19.25,12,51,39
187,BOU,P010431,P012618,3.667,-3,7,10
187,BOU,P010431,P012628,7.817,5,21,16
187,BOU,P010449,P010718,2.766,-7,4,11
187,BOU,P010449,P011161,11.75,0,25,25
187,BOU,P010449,P011836,6.033,-10,9,19
187,BOU,P010449,P011837,5.134,1,14,13
187,BOU,P010449,P012618,10.95,-4,18,22
187,BOU,P010449,P012628,14.451,0,30,30
187,BOU,P010718,P011161,2.367,-3,2,5
187,BOU,P010718,P011836,17.85,2,41,39
187,BOU,P010718,P011837,13.234,5,29,24
187,BOU,P010718,P012617,17.351,6,41,35
187,BOU,P010718,P012618,1.85,-3,2,5
187,BOU,P010718,P012628,0.85,2,4,2
187,BOU,P011161,P011836,3.8,3,8,5
187,BOU,P011161,P011837,4.984,1,14,13
187,BOU,P011161,P012617,2.684,6,6,0
187,BOU,P011161,P012618,9.45,5,17,12
187,BOU,P011161,P012628,12.067,9,29,20
187,BOU,P011836,P011837,14.85,16,39,23
187,BOU,P011836,P012617,20.517,23,57,34
187,BOU,P011836,P012618,6.667,0,13,13
187,BOU,P011836,P012628,9.55,13,29,16
187,BOU,P011837,P012617,16.717,13,43,30
187,BOU,P011837,P012628,9.467,11,32,21
187,BOU,P012617,P012618,2.167,6,6,0
187,BOU,P012617,P012628,6.283,16,24,8
187,BOU,P012618,P012628,11.267,5,22,17
187,PMT,P001686,P002644,7.701,-6,12,18
187,PMT,P001686,P002691,6.751,-3,12,15
187,PMT,P001686,P005301,10.301,1,23,22
187,PMT,P001686,P011823,4.934,3,11,8
187,PMT,P001686,P011942,1.767,-2,2,4
187,PMT,P001686,P011943,0.617,-2,0,2
187,PMT,P001686,P011944,7.601,-2,11,13
187,PMT,P001686,P012600,10.868,-1,21,22
187,PMT,P002020,P002644,3.483,-4,11,15
187,PMT,P002020,P002691,3.35,-4,11,15
187,PMT,P002020,P005301,0.133,0,0,0
187,PMT,P002020,P011942,0.85,-2,2,4
187,PMT,P002020,P011944,2.633,-2,9,11
187,PMT,P002020,P012600,3.483,-4,11,15
187,PMT,P002644,P002691,13.984,1,35,34
187,PMT,P002644,P005301,13.134,-6,26,32
187,PMT,P002644,P011942,12.8,5,33,28
187,PMT,P002644,P011943,10.05,10,29,19
187,PMT,P002644,P011944,13.483,-5,26,31
187,PMT,P002644,P011966,7.634,1,16,15
187,PMT,P002644,P012600,23.467,0,52,52
187,PMT,P002691,P005301,4.417,1,12,11
187,PMT,P002691,P011823,0.617,-2,0,2
187,PMT,P002691,P011942,7.117,2,16,14
187,PMT,P002691,P011943,5.117,4,12,8
187,PMT,P002691,P011944,4.217,-4,9,13
187,PMT,P002691,P012600,12.834,1,33,32
187,PMT,P005301,P011823,9.917,-2,19,21
187,PMT,P005301,P011942,9.117,-3,17,20
187,PMT,P005301,P011943,6.584,-6,13,19
187,PMT,P005301,P011944,14.483,-8,23,31
187,PMT,P005301,P011966,7.284,-5,13,18
187,PMT,P005301,P012600,16.834,-4,34,38
187,PMT,P011823,P011942,6.9,-13,6,19
187,PMT,P011823,P011943,8.417,-15,10,25
187,PMT,P011823,P011944,11.983,-10,20,30
187,PMT,P011823,P011966,4.833,-10,6,16
187,PMT,P011823,P012600,6.667,1,16,15
187,PMT,P011942,P011943,14.8,-7,29,36
187,PMT,P011942,P011944,9.399,-9,15,24
187,PMT,P011942,P011966,6.217,-9,11,20
187,PMT,P011942,P012600,9.833,6,25,19
187,PMT,P011943,P011944,10.566,-8,19,27
187,PMT,P011943,P011966,7.967,-5,17,22
187,PMT,P011943,P012600,9.75,9,27,18
187,PMT,P011944,P011966,8.316,-8,12,20
187,PMT,P011944,P012600,19.183,-4,40,44
187,PMT,P011966,P012600,7.617,0,13,13
188,BES,P003783,P007914,4.566,-4,7,11
188,BES,P003783,P008945,1.9,-4,0,4
188,BES,P003783,P011379,5.617,-7,7,14
188,BES,P003783,P011924,12.984,-13,22,35
188,BES,P003783,P011936,15.184,0,35,35
188,BES,P003783,P012622,9.767,4,18,14
188,BES,P003783,P012647,13.684,6,35,29
188,BES,P003783,P012711,17.834,-6,36,42
188,BES,P007914,P008945,4.083,-7,9,16
188,BES,P007914,P011379,3.716,-7,9,16
188,BES,P007914,P011924,5.05,0,10,10
188,BES,P007914,P011936,2.533,-3,6,9
188,BES,P007914,P012622,2.9,-1,2,3
188,BES,P007914,P012647,6.333,-2,16,18
188,BES,P007914,P012711,3.283,-4,5,9
188,BES,P007917,P008945,0.917,0,4,4
188,BES,P007917,P011936,0.917,0,4,4
188,BES,P007917,P012622,0.917,0,4,4
188,BES,P007917,P012647,0.917,0,4,4
188,BES,P008945,P011379,13.566,-10,22,32
188,BES,P008945,P011924,4.316,3,14,11
188,BES,P008945,P011936,17.633,13,49,36
188,BES,P008945,P012622,17.583,14,45,31
188,BES,P008945,P012647,16.35,10,49,39
188,BES,P008945,P012711,9.716,9,24,15
188,BES,P011379,P011924,5.767,-5,12,17
188,BES,P011379,P011936,13.417,-3,24,27
188,BES,P011379,P012622,10.417,-7,13,20
188,BES,P011379,P012647,9.85,-7,19,26
188,BES,P011379,P012711,7.65,-6,10,16
188,BES,P011924,P011936,11.583,-6,26,32
188,BES,P011924,P012622,6.783,-4,11,15
188,BES,P011924,P012647,12.0,-2,31,33
188,BES,P011924,P012711,10.717,-13,18,31
188,BES,P011936,P012622,21.483,23,61,38
188,BES,P011936,P012647,26.017,15,74,59
188,BES,P011936,P012711,21.633,13,57,44
188,BES,P012622,P012647,18.65,26,58,32
188,BES,P012622,P012711,16.3,17,40,23
188,BES,P012647,P012711,15.467,18,50,32
188,HTA,P003533,P004267,4.0,3,10,7
188,HTA,P003533,P004846,4.0,3,10,7
188,HTA,P003533,P006835,4.0,3,10,7
188,HTA,P003533,P007759,2.267,-1,3,4
188,HTA,P003533,P007867,1.733,4,7,3
188,HTA,P004267,P004846,9.334,4,25,21
188,HTA,P004267,P006835,9.335,6,26,20
188,HTA,P004267,P007759,4.068,0,7,7
188,HTA,P004267,P007867,7.117,4,20,16
188,HTA,P004267,P010465,0.017,-2,0,2
188,HTA,P004267,P010550,4.917,1,12,11
188,HTA,P004267,P011973,2.284,-4,4,8
188,HTA,P004846,P006835,22.502,10,56,46
188,HTA,P004846,P007759,10.535,1,19,18
188,HTA,P004846,P007867,21.817,2,55,53
188,HTA,P004846,P010465,8.0,-9,19,28
188,HTA,P004846,P010550,19.234,-1,44,45
188,HTA,P004846,P011973,12.334,-14,26,40
188,HTA,P004846,P011991,3.384,6,9,3
188,HTA,P004846,P012794,5.0,-6,9,15
188,HTA,P006835,P007759,14.653,-1,24,25
188,HTA,P006835,P007867,19.419,9,48,39
188,HTA,P006835,P010465,9.084,-17,16,33
188,HTA,P006835,P010550,14.568,7,34,27
188,HTA,P006835,P011973,8.069,-4,17,21
188,HTA,P006835,P011991,3.651,7,9,2
188,HTA,P006835,P012794,1.267,4,4,0
188,HTA,P007759,P007867,9.385,-1,17,18
188,HTA,P007759,P010465,6.617,-5,11,16
188,HTA,P007759,P010550,8.134,-2,17,19
188,HTA,P007759,P011973,8.152,-4,16,20
188,HTA,P007759,P011991,1.834,2,4,2
188,HTA,P007759,P012794,0.767,-5,2,7
188,HTA,P007867,P010465,14.317,-5,34,39
188,HTA,P007867,P010550,25.784,-4,59,63
188,HTA,P007867,P011973,18.634,-13,38,51
188,HTA,P007867,P011991,7.167,7,15,8
188,HTA,P007867,P012794,5.767,-11,11,22
188,HTA,P010465,P010550,14.266,2,32,30
188,HTA,P010465,P011973,10.484,-3,26,29
188,HTA,P010465,P011991,4.883,3,10,7
188,HTA,P010550,P011973,13.366,-11,28,39
188,HTA,P010550,P011991,6.8,7,15,8
188,HTA,P010550,P012794,4.667,-15,7,22
188,HTA,P011973,P011991,6.817,4,14,10
188,HTA,P011973,P012794,5.6,-11,11,22
189,LLI,P004479,P004773,2.084,0,7,7
189,LLI,P004479,P005247,0.6,-1,3,4
189,LLI,P004479,P006600,5.75,0,19,19
189,LLI,P004479,P009649,3.783,0,11,11
189,LLI,P004479,P009672,3.717,-1,13,14
189,LLI,P004479,P009680,2.25,0,9,9
189,LLI,P004479,P012586,4.433,2,14,12
189,LLI,P004479,P012797,0.383,0,0,0
189,LLI,P004773,P005247,5.533,-6,12,18
189,LLI,P004773,P006600,4.683,5,12,7
189,LLI,P004773,P009649,5.967,1,8,7
189,LLI,P004773,P009672,12.85,-3,25,28
189,LLI,P004773,P009680,8.7,-10,13,23
189,LLI,P004773,P012020,2.6,-5,5,10
189,LLI,P004773,P012585,1.083,0,4,4
189,LLI,P004773,P012586,5.867,-4,8,12
189,LLI,P004773,P012797,2.633,6,6,0
189,LLI,P005247,P006600,4.166,-2,11,13
189,LLI,P005247,P009672,12.149,-12,26,38
189,LLI,P005247,P009680,12.582,-11,26,37
189,LLI,P005247,P012020,2.467,-5,5,10
189,LLI,P005247,P012585,8.982,-5,19,24
189,LLI,P005247,P012586,3.166,-1,5,6
189,LLI,P005247,P012797,6.483,-5,13,18
189,LLI,P006600,P009649,17.4,-1,39,40
189,LLI,P006600,P009672,8.066,3,22,19
189,LLI,P006600,P009680,4.633,3,16,13
189,LLI,P006600,P012020,0.133,0,0,0
189,LLI,P006600,P012585,14.717,-7,31,38
189,LLI,P006600,P012586,15.25,-7,34,41
189,LLI,P006600,P012797,17.466,-2,36,38
189,LLI,P009649,P009672,9.083,-5,13,18
189,LLI,P009649,P009680,4.784,2,10,8
189,LLI,P009649,P012020,4.05,2,11,9
189,LLI,P009649,P012585,15.434,-4,34,38
189,LLI,P009649,P012586,19.317,-4,39,43
189,LLI,P009649,P012797,18.05,1,39,38
189,LLI,P009672,P009680,13.716,-14,23,37
189,LLI,P009672,P012020,4.233,-10,7,17
189,LLI,P009672,P012585,9.032,-10,17,27
189,LLI,P009672,P012586,8.583,-3,14,17
189,LLI,P009672,P012797,8.899,-5,16,21
189,LLI,P009680,P012020,2.467,-5,5,10
189,LLI,P009680,P012585,7.799,-1,18,19
189,LLI,P009680,P012586,7.833,-3,12,15
189,LLI,P009680,P012797,5.3,-1,12,13
189,LLI,P012020,P012585,4.05,2,11,9
189,LLI,P012020,P012586,2.417,7,9,2
189,LLI,P012020,P012797,4.183,2,11,9
189,LLI,P012585,P012586,14.917,-1,32,33
189,LLI,P012585,P012797,21.65,-10,46,56
189,LLI,P012586,P012797,13.617,-2,29,31
189,PRS,P004512,P005793,7.567,2,15,13
189,PRS,P004512,P012608,14.784,10,32,22
189,PRS,P004512,P012609,1.75,2,3,1
189,PRS,P004512,P012610,13.834,9,31,22
189,PRS,P004512,P012611,11.067,9,23,14
189,PRS,P004512,P012613,7.217,8,17,9
189,PRS,P004512,P012640,2.917,0,7,7
189,PRS,P005793,P009556,1.5,-2,4,6
189,PRS,P005793,P011232,3.866,1,12,11
189,PRS,P005793,P012608,9.933,5,23,18
189,PRS,P005793,P012609,0.8,1,2,1
189,PRS,P005793,P012610,11.433,3,27,24
189,PRS,P005793,P012611,8.75,3,19,16
189,PRS,P005793,P012640,1.883,-1,6,7
189,PRS,P009556,P011232,13.45,-3,34,37
189,PRS,P009556,P012609,11.95,-1,30,31
189,PRS,P009556,P012610,1.5,-2,4,6
189,PRS,P009556,P012613,11.95,-1,30,31
189,PRS,P009556,P012640,13.45,-3,34,37
189,PRS,P011232,P012608,10.282,8,30,22
189,PRS,P011232,P012609,19.366,9,52,43
189,PRS,P011232,P012610,11.082,6,34,28
189,PRS,P011232,P012611,2.483,-3,6,9
189,PRS,P011232,P012613,14.333,-4,32,36
189,PRS,P011232,P012640,20.066,6,56,50
189,PRS,P012608,P012609,10.649,10,28,18
189,PRS,P012608,P012610,24.899,15,64,49
189,PRS,P012608,P012611,15.033,4,32,28
189,PRS,P012608,P012613,11.083,3,22,19
189,PRS,P012608,P012640,9.533,9,29,20
189,PRS,P012609,P012610,8.999,9,27,18
189,PRS,P012609,P012611,1.483,-2,3,5
189,PRS,P012609,P012613,16.266,0,36,36
189,PRS,P012609,P012640,19.133,8,51,43
189,PRS,P012610,P012611,15.033,4,32,28
189,PRS,P012610,P012613,9.433,2,21,19
189,PRS,P012610,P012640,9.383,6,32,26
189,PRS,P012611,P012613,6.283,1,13,12
189,PRS,P012613,P012640,15.567,-1,37,38
190,BES,P003783,P007914,11.717,1,26,25
190,BES,P003783,P007917,1.25,-5,1,6
190,BES,P003783,P008945,7.251,1,17,16
190,BES,P003783,P011357,0.367,0,0,0
190,BES,P003783,P011379,7.651,4,20,16
190,BES,P003783,P011924,9.684,-2,20,22
190,BES,P003783,P011936,4.517,-2,8,10
190,BES,P003783,P012622,6.501,-4,6,10
190,BES,P003783,P012647,10.401,0,20,20
190,BES,P003783,P012711,12.401,3,30,27
190,BES,P007914,P007917,1.25,-5,1,6
190,BES,P007914,P008945,10.867,-5,18,23
190,BES,P007914,P011379,10.885,0,24,24
190,BES,P007914,P011924,11.867,-1,28,29
190,BES,P007914,P011936,4.667,-11,0,11
190,BES,P007914,P012622,5.65,-4,9,13
190,BES,P007914,P012647,12.15,-7,16,23
190,BES,P007914,P012711,8.683,4,22,18
190,BES,P007917,P011924,1.25,-5,1,6
190,BES,P007917,P012711,1.25,-5,1,6
190,BES,P008945,P011379,17.702,-5,33,38
190,BES,P008945,P011924,9.283,-7,18,25
190,BES,P008945,P011936,20.501,-11,35,46
190,BES,P008945,P012622,17.667,-6,30,36
190,BES,P008945,P012647,24.368,-5,47,52
190,BES,P008945,P012711,9.633,-2,18,20
190,BES,P011357,P011924,0.367,0,0,0
190,BES,P011357,P012622,0.367,0,0,0
190,BES,P011357,P012711,0.367,0,0,0
190,BES,P011379,P011924,10.268,3,29,26
190,BES,P011379,P011936,13.984,-5,24,29
190,BES,P011379,P012622,10.684,4,22,18
190,BES,P011379,P012647,17.852,-7,31,38
190,BES,P011379,P012711,3.65,6,13,7
190,BES,P011924,P011936,4.2,-5,8,13
190,BES,P011924,P012622,7.183,-2,11,13
190,BES,P011924,P012647,10.283,-5,18,23
190,BES,P011924,P012711,10.483,-4,19,23
190,BES,P011936,P012622,14.8,-8,21,29
190,BES,P011936,P012647,18.468,-7,33,40
190,BES,P011936,P012711,5.867,-3,11,14
190,BES,P012622,P012647,16.25,-5,25,30
190,BES,P012622,P012711,7.434,-7,8,15
190,BES,P012647,P012711,8.1,4,18,14
190,BOU,P004525,P010431,1.867,2,5,3
190,BOU,P004525,P010449,6.383,-4,8,12
190,BOU,P004525,P010718,6.051,3,19,16
190,BOU,P004525,P011161,9.766,4,19,15
190,BOU,P004525,P011836,4.75,-6,10,16
190,BOU,P004525,P011837,6.534,11,19,8
190,BOU,P004525,P012617,8.734,11,27,16
190,BOU,P004525,P012618,3.833,2,6,4
190,BOU,P004525,P012628,12.55,5,27,22
190,BOU,P010431,P010449,4.199,5,8,3
190,BOU,P010431,P010718,15.233,0,32,32
190,BOU,P010431,P011161,3.383,-1,5,6
190,BOU,P010431,P011836,18.999,0,37,37
190,BOU,P010431,P011837,13.933,-1,24,25
190,BOU,P010431,P012617,16.917,-3,34,37
190,BOU,P010431,P012618,7.183,3,18,15
190,BOU,P010431,P012628,2.75,3,5,2
190,BOU,P010449,P010718,2.916,2,4,2
190,BOU,P010449,P011161,10.283,0,18,18
190,BOU,P010449,P011836,9.799,2,18,16
190,BOU,P010449,P011837,4.117,3,8,5
190,BOU,P010449,P012618,7.349,7,14,7
190,BOU,P010449,P012628,10.75,1,18,17
190,BOU,P010718,P011161,4.967,3,12,9
190,BOU,P010718,P011836,19.4,1,44,43
190,BOU,P010718,P011837,13.984,7,34,27
190,BOU,P010718,P012617,20.518,2,51,49
190,BOU,P010718,P012618,7.183,-3,13,16
190,BOU,P010718,P012628,3.484,1,11,10
190,BOU,P011161,P011836,11.95,-2,24,26
190,BOU,P011161,P011837,7.917,5,17,12
190,BOU,P011161,P012617,8.5,8,20,12
190,BOU,P011161,P012618,7.683,9,16,7
190,BOU,P011161,P012628,10.683,6,21,15
190,BOU,P011836,P011837,15.2,-1,28,29
190,BOU,P011836,P012617,19.584,-3,43,46
190,BOU,P011836,P012618,9.433,6,23,17
190,BOU,P011836,P012628,8.417,-1,17,18
190,BOU,P011837,P012617,17.617,7,39,32
190,BOU,P011837,P012628,7.634,9,19,10
190,BOU,P012617,P012618,6.167,1,15,14
190,BOU,P012617,P012628,6.167,9,19,10
190,BOU,P012618,P012628,5.233,7,11,4
191,LLI,P004773,P005247,8.467,9,25,16
191,LLI,P004773,P006600,4.784,-10,3,13
191,LLI,P004773,P009649,5.218,-4,9,13
191,LLI,P004773,P009672,13.684,6,34,28
191,LLI,P004773,P009680,8.451,-14,13,27
191,LLI,P004773,P012020,11.218,8,30,22
191,LLI,P004773,P012585,6.15,-7,13,20
191,LLI,P004773,P012586,6.384,8,17,9
191,LLI,P004773,P012797,8.852,-4,16,20
191,LLI,P005247,P006600,11.033,3,24,21
191,LLI,P005247,P009672,16.067,13,49,36
191,LLI,P005247,P009680,12.45,7,35,28
191,LLI,P005247,P012020,6.167,9,18,9
191,LLI,P005247,P012585,13.033,5,36,31
191,LLI,P005247,P012586,4.067,6,11,5
191,LLI,P005247,P012797,8.584,4,18,14
191,LLI,P006600,P009649,6.967,-9,10,19
191,LLI,P006600,P009672,10.433,-3,22,25
191,LLI,P006600,P009680,20.267,-12,36,48
191,LLI,P006600,P012585,21.15,-12,37,49
191,LLI,P006600,P012586,0.45,0,0,0
191,LLI,P006600,P012797,12.784,-13,16,29
191,LLI,P009649,P009672,4.867,-4,7,11
191,LLI,P009649,P009680,8.684,-13,12,25
191,LLI,P009649,P012020,8.451,-6,15,21
191,LLI,P009649,P012585,10.2,-11,16,27
191,LLI,P009649,P012586,5.467,-3,10,13
191,LLI,P009649,P012797,11.818,-10,21,31
191,LLI,P009672,P009680,12.05,2,36,34
191,LLI,P009672,P012020,11.684,6,28,22
191,LLI,P009672,P012585,16.683,-5,41,46
191,LLI,P009672,P012586,8.117,1,15,14
191,LLI,P009672,P012797,5.951,4,16,12
191,LLI,P009680,P012020,2.367,-3,5,8
191,LLI,P009680,P012585,22.45,-6,53,59
191,LLI,P009680,P012797,14.485,-13,22,35
191,LLI,P012020,P012585,4.7,-3,9,12
191,LLI,P012020,P012586,9.434,3,21,18
191,LLI,P012020,P012797,7.051,2,18,16
191,LLI,P012585,P012586,4.15,-5,4,9
191,LLI,P012585,P012797,12.884,-8,23,31
191,LLI,P012586,P012797,1.867,2,6,4
191,PRS,P004512,P005793,7.917,1,17,16
191,PRS,P004512,P011232,2.567,3,9,6
191,PRS,P004512,P012608,20.417,8,50,42
191,PRS,P004512,P012609,2.183,2,3,1
191,PRS,P004512,P012610,20.184,8,50,42
191,PRS,P004512,P012611,18.183,8,44,36
191,PRS,P004512,P012613,8.5,2,21,19
191,PRS,P004512,P012640,1.717,0,6,6
191,PRS,P005793,P012608,7.917,1,17,16
191,PRS,P005793,P012609,0.1,0,0,0
191,PRS,P005793,P012610,7.917,1,17,16
191,PRS,P005793,P012611,7.817,1,17,16
191,PRS,P009556,P011232,12.75,4,28,24
191,PRS,P009556,P012609,12.75,4,28,24
191,PRS,P009556,P012613,12.75,4,28,24
191,PRS,P009556,P012640,12.75,4,28,24
191,PRS,P011232,P012608,9.401,-1,24,25
191,PRS,P011232,P012609,19.05,-2,41,43
191,PRS,P011232,P012610,9.168,-1,24,25
191,PRS,P011232,P012611,1.533,-2,5,7
191,PRS,P011232,P012613,13.934,6,30,24
191,PRS,P011232,P012640,20.201,5,47,42
191,PRS,P012608,P012609,8.25,-4,16,20
191,PRS,P012608,P012610,27.018,4,65,61
191,PRS,P012608,P012611,19.283,3,46,43
191,PRS,P012608,P012613,9.267,4,23,19
191,PRS,P012608,P012640,7.451,1,19,18
191,PRS,P012609,P012610,8.017,-4,16,20
191,PRS,P012609,P012611,3.183,-3,5,8
191,PRS,P012609,P012613,12.75,4,28,24
191,PRS,P012609,P012640,17.717,3,39,36
191,PRS,P012610,P012611,19.05,3,46,43
191,PRS,P012610,P012613,9.267,4,23,19
191,PRS,P012610,P012640,7.451,1,19,18
191,PRS,P012611,P012613,8.083,2,21,19
191,PRS,P012613,P012640,13.517,6,30,24
192,BES,P003783,P007914,11.801,9,30,21
192,BES,P003783,P008945,4.034,5,12,7
192,BES,P003783,P011379,7.267,16,25,9
192,BES,P003783,P011924,2.283,3,7,4
192,BES,P003783,P011936,12.752,19,38,19
192,BES,P003783,P012622,9.901,12,28,16
192,BES,P003783,P012647,11.435,20,34,14
192,BES,P003783,P012711,7.667,4,18,14
192,BES,P007914,P008945,13.517,-9,19,28
192,BES,P007914,P011379,2.833,0,7,7
192,BES,P007914,P011924,3.233,5,9,4
192,BES,P007914,P011936,15.868,-2,30,32
192,BES,P007914,P012622,15.451,-3,27,30
192,BES,P007914,P012647,13.901,-3,22,25
192,BES,P007914,P012711,15.8,3,32,29
192,BES,P008945,P011379,9.834,1,19,18
192,BES,P008945,P011924,3.817,-2,4,6
192,BES,P008945,P011936,22.301,-5,39,44
192,BES,P008945,P012622,22.384,-9,33,42
192,BES,P008945,P012647,23.401,-7,38,45
192,BES,P008945,P012711,9.716,2,20,18
192,BES,P011379,P011924,2.316,3,7,4
192,BES,P011379,P011936,12.968,9,30,21
192,BES,P011379,P012622,10.634,7,23,16
192,BES,P011379,P012647,12.968,9,30,21
192,BES,P011379,P012711,2.316,3,7,4
192,BES,P011924,P011936,2.867,-4,2,6
192,BES,P011924,P012622,3.784,-2,4,6
192,BES,P011924,P012647,2.867,-4,2,6
192,BES,P011924,P012711,3.233,5,9,4
192,BES,P011936,P012622,25.618,4,51,47
192,BES,P011936,P012647,26.802,11,55,44
192,BES,P011936,P012711,11.9,4,27,23
192,BES,P012622,P012647,23.651,3,43,40
192,BES,P012622,P012711,10.717,0,23,23
192,BES,P012647,P012711,8.183,3,16,13
192,BOU,P004525,P010431,4.299,9,11,2
192,BOU,P004525,P010449,8.966,4,18,14
192,BOU,P004525,P010718,1.916,5,5,0
192,BOU,P004525,P011161,11.733,-10,16,26
192,BOU,P004525,P011837,1.916,5,5,0
192,BOU,P004525,P012617,7.066,-5,9,14
192,BOU,P004525,P012618,14.116,-6,22,28
192,BOU,P004525,P012628,14.116,-6,22,28
192,BOU,P010431,P010449,8.883,3,21,18
192,BOU,P010431,P010718,19.133,-2,36,38
192,BOU,P010431,P011161,1.917,-5,2,7
192,BOU,P010431,P011836,19.617,-12,33,45
192,BOU,P010431,P011837,18.483,-12,31,43
192,BOU,P010431,P012617,15.5,-8,25,33
192,BOU,P010431,P012618,5.9,7,15,8
192,BOU,P010431,P012628,3.8,0,10,10
192,BOU,P010449,P010718,8.033,4,18,14
192,BOU,P010449,P011161,9.883,2,19,17
192,BOU,P010449,P011836,9.333,3,20,17
192,BOU,P010449,P011837,3.883,-4,8,12
192,BOU,P010449,P012618,14.883,9,32,23
192,BOU,P010449,P012628,11.2,-1,24,25
192,BOU,P010718,P011161,2.483,3,5,2
192,BOU,P010718,P011836,19.233,-2,34,36
192,BOU,P010718,P011837,16.566,-7,29,36
192,BOU,P010718,P012617,13.583,-3,23,26
192,BOU,P010718,P012618,5.05,8,12,4
192,BOU,P010718,P012628,0.467,-2,2,4
192,BOU,P011161,P011836,5.8,-1,11,12
192,BOU,P011161,P011837,1.917,-5,2,7
192,BOU,P011161,P012617,7.65,-13,8,21
192,BOU,P011161,P012618,15.616,-6,25,31
192,BOU,P011161,P012628,13.133,-9,20,29
192,BOU,P011836,P011837,16.1,-15,24,39
192,BOU,P011836,P012617,14.167,-11,22,33
192,BOU,P011836,P012618,7.4,7,18,11
192,BOU,P011836,P012628,2.35,-1,6,7
192,BOU,P011837,P012617,14.6,-8,23,31
192,BOU,P011837,P012628,0.467,-2,2,4
192,BOU,P012617,P012618,6.633,-8,8,16
192,BOU,P012617,P012628,5.733,-8,6,14
192,BOU,P012618,P012628,16.466,-7,28,35
194,BES,P003783,P007914,9.783,3,22,19
194,BES,P003783,P007917,4.133,-6,3,9
194,BES,P003783,P008945,12.7,-10,21,31
194,BES,P003783,P011357,5.9,-6,7,13
194,BES,P003783,P011379,10.633,-10,18,28
194,BES,P003783,P011924,14.95,-12,21,33
194,BES,P003783,P011936,6.999,-8,8,16
194,BES,P003783,P012647,4.884,0,15,15
194,BES,P003783,P012711,13.482,-7,21,28
194,BES,P007914,P007917,1.033,0,0,0
194,BES,P007914,P008945,23.85,-6,43,49
194,BES,P007914,P011357,8.417,-9,9,18
194,BES,P007914,P011379,22.882,-9,39,48
194,BES,P007914,P011924,17.733,-14,22,36
194,BES,P007914,P011936,7.933,4,17,13
194,BES,P007914,P012647,9.067,5,22,17
194,BES,P007914,P012711,12.566,-2,26,28
194,BES,P007917,P008945,4.849,-9,2,11
194,BES,P007917,P011379,0.383,0,0,0
194,BES,P007917,P011924,4.133,-6,4,10
194,BES,P007917,P011936,3.15,-3,3,6
194,BES,P007917,P012647,1.517,-1,3,4
194,BES,P007917,P012711,3.866,-7,1,8
194,BES,P008945,P011357,10.334,-15,10,25
194,BES,P008945,P011379,23.55,-17,37,54
194,BES,P008945,P011924,17.984,-24,20,44
194,BES,P008945,P011936,11.832,-3,20,23
194,BES,P008945,P012647,9.334,3,25,22
194,BES,P008945,P012711,12.899,-7,22,29
194,BES,P011357,P011379,7.9,-16,6,22
194,BES,P011357,P011924,7.484,-8,8,16
194,BES,P011357,P011936,2.233,-6,0,6
194,BES,P011379,P011924,17.417,-21,23,44
194,BES,P011379,P011936,11.066,-3,21,24
194,BES,P011379,P012647,7.517,2,19,17
194,BES,P011379,P012711,12.716,-6,21,27
194,BES,P011924,P011936,4.333,-5,7,12
194,BES,P011924,P012647,8.184,-5,17,22
194,BES,P011924,P012711,12.382,-17,10,27
194,BES,P011936,P012647,5.833,3,14,11
194,BES,P011936,P012711,8.749,-3,14,17
194,BES,P012647,P012711,3.4,1,9,8
194,BOU,P000498,P010449,0.383,0,0,0
194,BOU,P000498,P010450,2.116,1,4,3
194,BOU,P000498,P010718,2.116,1,4,3
194,BOU,P000498,P011837,1.733,1,4,3
194,BOU,P000498,P012628,2.116,1,4,3
194,BOU,P004525,P010431,8.05,5,20,15
194,BOU,P004525,P010449,10.3,1,22,21
194,BOU,P004525,P010450,1.367,1,2,1
194,BOU,P004525,P010718,5.183,2,12,10
194,BOU,P004525,P011161,14.617,13,34,21
194,BOU,P004525,P011836,11.1,10,28,18
194,BOU,P004525,P012617,8.683,11,20,9
194,BOU,P004525,P012618,6.516,1,12,11
194,BOU,P004525,P012628,10.116,4,18,14
194,BOU,P010431,P010449,8.417,7,22,15
194,BOU,P010431,P010450,2.884,5,8,3
194,BOU,P010431,P010718,10.3,3,23,20
194,BOU,P010431,P011161,6.068,11,19,8
194,BOU,P010431,P011836,14.034,8,35,27
194,BOU,P010431,P011837,8.6,10,21,11
194,BOU,P010431,P012617,9.1,7,22,15
194,BOU,P010431,P012618,1.6,0,4,4
194,BOU,P010431,P012628,1.283,0,2,2
194,BOU,P010449,P010450,7.317,18,18,0
194,BOU,P010449,P010718,9.149,8,18,10
194,BOU,P010449,P011161,15.35,17,37,20
194,BOU,P010449,P011836,7.783,-1,18,19
194,BOU,P010449,P011837,9.25,19,24,5
194,BOU,P010449,P012618,8.199,-1,14,15
194,BOU,P010449,P012628,10.316,4,19,15
194,BOU,P010450,P010718,7.8,14,17,3
194,BOU,P010450,P011161,6.534,13,16,3
194,BOU,P010450,P011836,0.617,-1,1,2
194,BOU,P010450,P011837,8.25,19,22,3
194,BOU,P010450,P012617,1.5,0,3,3
194,BOU,P010450,P012628,4.083,6,9,3
194,BOU,P010718,P011161,7.667,6,18,12
194,BOU,P010718,P011836,14.25,1,33,32
194,BOU,P010718,P011837,15.183,18,36,18
194,BOU,P010718,P012617,11.034,6,28,22
194,BOU,P010718,P012618,1.167,-5,2,7
194,BOU,P010718,P012628,4.083,6,9,3
194,BOU,P011161,P011836,13.251,2,30,28
194,BOU,P011161,P011837,6.417,14,18,4
194,BOU,P011161,P012617,8.984,0,18,18
194,BOU,P011161,P012618,7.983,-8,12,20
194,BOU,P011161,P012628,10.733,0,18,18
194,BOU,P011836,P011837,8.7,5,20,15
194,BOU,P011836,P012617,15.634,6,35,29
194,BOU,P011836,P012618,3.067,-9,4,13
194,BOU,P011836,P012628,5.5,-1,8,9
194,BOU,P011837,P012617,5.967,4,14,10
194,BOU,P011837,P012628,3.7,6,9,3
194,BOU,P012617,P012618,1.384,-7,2,9
194,BOU,P012617,P012628,4.05,1,6,5
194,BOU,P012618,P012628,8.416,-3,14,17
195,BOU,P000498,P004525,4.466,0,12,12
195,BOU,P000498,P010431,3.766,-5,10,15
195,BOU,P000498,P010449,2.416,5,8,3
195,BOU,P000498,P010718,10.033,-4,20,24
195,BOU,P000498,P011161,1.867,-4,2,6
195,BOU,P000498,P011836,10.933,-2,22,24
195,BOU,P000498,P011837,4.766,-2,10,12
195,BOU,P000498,P012617,4.4,5,8,3
195,BOU,P000498,P012618,4.733,6,12,6
195,BOU,P000498,P012628,2.416,5,8,3
195,BOU,P004525,P010431,6.283,-4,12,16
195,BOU,P004525,P010449,8.866,0,14,14
195,BOU,P004525,P010718,6.75,-5,11,16
195,BOU,P004525,P011161,10.533,-4,13,17
195,BOU,P004525,P011836,2.95,-3,6,9
195,BOU,P004525,P011837,8.366,0,14,14
195,BOU,P004525,P012617,6.516,-2,11,13
195,BOU,P004525,P012618,7.016,-2,11,13
195,BOU,P004525,P012628,11.582,0,20,20
195,BOU,P010431,P010718,7.116,-8,15,23
195,BOU,P010431,P011836,7.116,-8,15,23
195,BOU,P010431,P011837,3.6,-1,9,10
195,BOU,P010431,P012617,6.683,-4,11,15
195,BOU,P010431,P012618,3.899,-5,6,11
195,BOU,P010431,P012628,3.333,-1,6,7
195,BOU,P010449,P010718,2.133,-2,2,4
195,BOU,P010449,P011161,12.533,-3,16,19
195,BOU,P010449,P011836,6.083,2,10,8
195,BOU,P010449,P011837,6.216,0,11,11
195,BOU,P010449,P012618,8.733,2,13,11
195,BOU,P010449,P012628,12.816,4,22,18
195,BOU,P010718,P011161,8.683,-9,11,20
195,BOU,P010718,P011836,20.049,-14,31,45
195,BOU,P010718,P011837,11.883,-7,19,26
195,BOU,P010718,P012617,16.083,-5,22,27
195,BOU,P010718,P012618,9.016,-6,11,17
195,BOU,P010718,P012628,3.65,-4,2,6
195,BOU,P011161,P011836,8.55,-6,12,18
195,BOU,P011161,P011837,10.483,-5,15,20
195,BOU,P011161,P012617,4.683,-3,7,10
195,BOU,P011161,P012618,8.6,-5,10,15
195,BOU,P011161,P012628,10.4,-1,14,15
195,BOU,P011836,P011837,8.083,-5,14,19
195,BOU,P011836,P012617,12.9,-4,17,21
195,BOU,P011836,P012618,13.583,-3,19,22
195,BOU,P011836,P012628,8.217,-1,10,11
195,BOU,P011837,P012617,7.833,-2,11,13
195,BOU,P011837,P012628,4.566,2,9,7
195,BOU,P012617,P012618,11.583,-4,17,21
195,BOU,P012617,P012628,6.983,-5,8,13
195,BOU,P012618,P012628,15.233,-3,21,24
195,PRS,P003481,P009556,14.0,1,25,24
195,PRS,P003481,P011232,14.0,1,25,24
195,PRS,P003481,P012609,14.0,1,25,24
195,PRS,P003481,P012640,14.0,1,25,24
195,PRS,P004512,P005793,2.15,-6,1,7
195,PRS,P004512,P009556,0.433,-5,0,5
195,PRS,P004512,P011232,5.05,5,11,6
195,PRS,P004512,P012608,17.467,9,31,22
195,PRS,P004512,P012610,17.467,9,31,22
195,PRS,P004512,P012611,17.9,4,31,27
195,PRS,P004512,P012613,10.7,5,19,14
195,PRS,P004512,P012640,0.433,-5,0,5
195,PRS,P005793,P009556,1.516,-5,3,8
195,PRS,P005793,P011232,2.883,0,7,7
195,PRS,P005793,P011887,1.083,0,3,3
195,PRS,P005793,P012608,3.767,0,6,6
195,PRS,P005793,P012610,1.967,0,2,2
195,PRS,P005793,P012611,4.2,-5,6,11
195,PRS,P005793,P012613,2.05,1,5,4
195,PRS,P005793,P012640,1.516,-5,3,8
195,PRS,P009556,P011232,15.083,1,28,27
195,PRS,P009556,P011887,1.083,0,3,3
195,PRS,P009556,P012609,14.0,1,25,24
195,PRS,P009556,P012611,0.433,-5,0,5
195,PRS,P009556,P012640,15.516,-4,28,32
195,PRS,P011232,P011887,1.083,0,3,3
195,PRS,P011232,P012608,8.084,3,15,12
195,PRS,P011232,P012609,14.367,-1,25,26
195,PRS,P011232,P012610,5.917,5,11,6
195,PRS,P011232,P012611,7.717,5,15,10
195,PRS,P011232,P012613,3.034,-2,4,6
195,PRS,P011232,P012640,15.45,-1,28,29
195,PRS,P011887,P012640,1.083,0,3,3
195,PRS,P012608,P012609,4.1,7,13,6
195,PRS,P012608,P012610,22.317,19,45,26
195,PRS,P012608,P012611,20.384,10,36,26
195,PRS,P012608,P012613,17.717,13,37,24
195,PRS,P012608,P012640,4.1,7,13,6
195,PRS,P012609,P012610,3.733,9,13,4
195,PRS,P012609,P012613,4.1,7,13,6
195,PRS,P012609,P012640,18.1,8,38,30
195,PRS,P012610,P012611,18.584,10,32,22
195,PRS,P012610,P012613,15.55,15,33,18
195,PRS,P012610,P012640,3.733,9,13,4
195,PRS,P012611,P012613,13.617,6,24,18
195,PRS,P012611,P012640,0.433,-5,0,5
195,PRS,P012613,P012640,4.1,7,13,6
196,BOU,P004525,P010431,7.0,2,15,13
196,BOU,P004525,P010449,6.55,8,18,10
196,BOU,P004525,P010718,8.267,3,19,16
196,BOU,P004525,P011161,8.7,7,22,15
196,BOU,P004525,P011836,1.933,0,5,5
196,BOU,P004525,P011837,6.717,3,14,11
196,BOU,P004525,P012617,7.65,-3,15,18
196,BOU,P004525,P012618,5.55,2,14,12
196,BOU,P004525,P012628,4.433,-2,10,12
196,BOU,P010431,P010449,4.2,-3,7,10
196,BOU,P010431,P010718,8.25,5,22,17
196,BOU,P010431,P011161,2.6,4,7,3
196,BOU,P010431,P011836,10.133,-4,24,28
196,BOU,P010431,P011837,9.75,9,26,17
196,BOU,P010431,P012617,11.0,1,27,26
196,BOU,P010431,P012618,3.517,-11,3,14
196,BOU,P010431,P012628,4.35,-11,5,16
196,BOU,P010449,P010450,2.233,-3,3,6
196,BOU,P010449,P010718,8.05,3,18,15
196,BOU,P010449,P011161,13.983,5,31,26
196,BOU,P010449,P011836,16.783,-11,28,39
196,BOU,P010449,P011837,7.267,-5,10,15
196,BOU,P010449,P012617,7.75,-1,15,16
196,BOU,P010449,P012618,16.066,2,36,34
196,BOU,P010449,P012628,10.45,-7,18,25
196,BOU,P010450,P011161,2.233,-3,3,6
196,BOU,P010450,P011836,2.233,-3,3,6
196,BOU,P010450,P012618,2.233,-3,3,6
196,BOU,P010718,P011161,6.334,5,16,11
196,BOU,P010718,P011836,13.3,-1,29,30
196,BOU,P010718,P011837,17.7,-5,36,41
196,BOU,P010718,P012617,17.85,-4,36,40
196,BOU,P010718,P012618,3.867,7,12,5
196,BOU,P010718,P012628,2.65,-5,4,9
196,BOU,P011161,P011836,8.3,-3,13,16
196,BOU,P011161,P011837,4.367,2,8,6
196,BOU,P011161,P012617,3.017,-1,4,5
196,BOU,P011161,P012618,12.633,2,27,25
196,BOU,P011161,P012628,5.833,-2,9,11
196,BOU,P011836,P011837,13.7,-7,26,33
196,BOU,P011836,P012617,18.7,-3,40,43
196,BOU,P011836,P012618,12.1,-6,22,28
196,BOU,P011836,P012628,13.75,-14,22,36
196,BOU,P011837,P012617,18.3,-5,36,41
196,BOU,P011837,P012628,3.867,-8,4,12
196,BOU,P012617,P012618,4.184,-1,9,10
196,BOU,P012617,P012628,9.217,-7,18,25
196,BOU,P012618,P012628,10.45,-8,18,26
196,PRS,P003481,P009556,9.683,8,19,11
196,PRS,P003481,P011232,13.8,10,33,23
196,PRS,P003481,P012608,4.117,2,14,12
196,PRS,P003481,P012609,13.8,10,33,23
196,PRS,P003481,P012640,13.8,10,33,23
196,PRS,P004512,P011232,0.933,-5,1,6
196,PRS,P004512,P012608,18.166,-6,36,42
196,PRS,P004512,P012610,18.216,-8,36,44
196,PRS,P004512,P012611,17.333,-5,35,40
196,PRS,P004512,P012613,17.533,-4,36,40
196,PRS,P004512,P012640,0.683,-4,0,4
196,PRS,P009556,P011232,9.683,8,19,11
196,PRS,P009556,P012609,9.683,8,19,11
196,PRS,P009556,P012640,9.683,8,19,11
196,PRS,P011232,P012608,6.617,0,21,21
196,PRS,P011232,P012609,13.8,10,33,23
196,PRS,P011232,P012610,2.55,-4,7,11
196,PRS,P011232,P012611,0.05,-2,0,2
196,PRS,P011232,P012613,1.867,0,7,7
196,PRS,P011232,P012640,16.1,7,39,32
196,PRS,P012608,P012609,10.417,8,28,20
196,PRS,P012608,P012610,26.15,0,56,56
196,PRS,P012608,P012611,17.35,-4,35,39
196,PRS,P012608,P012613,25.467,4,56,52
196,PRS,P012608,P012640,12.784,4,34,30
196,PRS,P012609,P012610,6.3,6,14,8
196,PRS,P012609,P012613,6.3,6,14,8
196,PRS,P012609,P012640,20.1,16,47,31
196,PRS,P012610,P012611,17.4,-6,35,41
196,PRS,P012610,P012613,25.517,2,56,54
196,PRS,P012610,P012640,8.667,2,20,18
196,PRS,P012611,P012613,17.4,-6,35,41
196,PRS,P012611,P012640,0.067,-1,0,1
196,PRS,P012613,P012640,7.984,6,20,14
