GAMECODE,CODETEAM,joueur_1,TIME,DELTA_SCORE,OFF,DEF
1,RED,P006436,0 days 00:27:51,24,77,53
1,RED,P005099,0 days 00:22:21,4,42,38
1,RED,P002553,0 days 00:21:32,20,58,38
1,RED,P011224,0 days 00:20:40,20,58,38
1,RED,P012711,0 days 00:18:22,8,46,38
1,RED,P000848,0 days 00:16:57,3,31,28
1,RED,PJDR,0 days 00:14:37,6,29,23
1,RED,P011964,0 days 00:14:33,-1,25,26
1,RED,P008966,0 days 00:13:04,3,20,17
1,RED,PLUO,0 days 00:12:46,7,36,29
1,RED,P003479,0 days 00:12:13,12,39,27
1,RED,P004720,0 days 00:05:04,-1,9,10
1,ASV,P012080,0 days 00:29:57,-20,58,78
1,ASV,P011225,0 days 00:29:42,-14,57,71
1,ASV,P002100,0 days 00:25:37,-25,49,74
1,ASV,P012730,0 days 00:24:34,-14,48,62
1,ASV,P004194,0 days 00:22:39,-17,45,62
1,ASV,P012729,0 days 00:22:22,-6,38,44
1,ASV,P012732,0 days 00:15:59,1,26,25
1,ASV,P012731,0 days 00:12:28,-2,22,24
1,ASV,P006568,0 days 00:10:25,-5,15,20
1,ASV,P011386,0 days 00:06:17,-3,7,10
2,BAR,P006435,0 days 00:24:43,7,54,47
2,BAR,P002939,0 days 00:23:26,7,54,47
2,BAR,P000925,0 days 00:21:58,14,47,33
2,BAR,P004866,0 days 00:21:30,6,48,42
2,BAR,P011244,0 days 00:20:08,3,51,48
2,BAR,P012745,0 days 00:17:54,8,38,30
2,BAR,P007519,0 days 00:16:34,10,37,27
2,BAR,P003196,0 days 00:16:05,1,38,37
2,BAR,P003478,0 days 00:15:56,15,37,22
2,BAR,P009992,0 days 00:14:00,13,35,22
2,BAR,P007464,0 days 00:07:46,1,16,15
2,IST,P007200,0 days 00:32:28,-10,59,69
2,IST,P004888,0 days 00:27:33,-14,53,67
2,IST,P009664,0 days 00:26:57,-13,45,58
2,IST,P011078,0 days 00:26:18,-2,56,58
2,IST,P011981,0 days 00:19:26,-16,31,47
2,IST,P004554,0 days 00:18:28,1,39,38
2,IST,P009846,0 days 00:16:25,-13,29,42
2,IST,P006590,0 days 00:15:30,-15,21,36
2,IST,P006372,0 days 00:10:02,-3,21,24
2,IST,PLHK,0 days 00:03:41,7,14,7
2,IST,P009513,0 days 00:03:12,-7,2,9
3,MUN,P007056,0 days 00:30:57,8,57,49
3,MUN,P006760,0 days 00:25:52,0,44,44
3,MUN,P010391,0 days 00:25:35,22,56,34
3,MUN,P008985,0 days 00:21:17,13,42,29
3,MUN,P004508,0 days 00:19:39,7,41,34
3,MUN,P007975,0 days 00:18:43,-1,38,39
3,MUN,P011987,0 days 00:17:58,-12,32,44
3,MUN,P003583,0 days 00:17:57,6,34,28
3,MUN,P005478,0 days 00:11:53,8,30,22
3,MUN,P011941,0 days 00:07:49,12,21,9
3,MUN,P007639,0 days 00:02:20,-3,5,8
3,BER,P012720,0 days 00:28:33,-3,53,56
3,BER,P006919,0 days 00:26:01,10,52,42
3,BER,P003958,0 days 00:25:37,-5,39,44
3,BER,P008967,0 days 00:23:18,4,45,41
3,BER,P008173,0 days 00:17:11,-14,29,43
3,BER,P007550,0 days 00:16:53,-7,26,33
3,BER,P012721,0 days 00:16:18,-12,29,41
3,BER,P008384,0 days 00:15:52,-12,25,37
3,BER,P008211,0 days 00:13:32,-3,23,26
3,BER,P007025,0 days 00:09:32,-6,11,17
3,BER,P006819,0 days 00:07:13,-12,8,20
4,TEL,P009622,0 days 00:24:57,14,61,47
4,TEL,P007990,0 days 00:22:31,16,61,45
4,TEL,P012744,0 days 00:22:28,7,50,43
4,TEL,P009783,0 days 00:21:50,19,54,35
4,TEL,P011219,0 days 00:21:23,1,48,47
4,TEL,P011193,0 days 00:20:12,6,50,44
4,TEL,P011971,0 days 00:15:32,4,37,33
4,TEL,P011199,0 days 00:15:24,11,37,26
4,TEL,P005145,0 days 00:15:11,14,39,25
4,TEL,P011214,0 days 00:13:56,-8,31,39
4,TEL,P004233,0 days 00:06:36,-9,12,21
4,PAR,P008987,0 days 00:26:04,-18,46,64
4,PAR,P003983,0 days 00:25:52,-7,56,63
4,PAR,P011051,0 days 00:25:19,1,53,52
4,PAR,P009862,0 days 00:24:31,-21,38,59
4,PAR,P007400,0 days 00:23:49,-5,54,59
4,PAR,P012742,0 days 00:19:05,2,43,41
4,PAR,P007673,0 days 00:14:06,0,33,33
4,PAR,P004058,0 days 00:13:14,-7,22,29
4,PAR,P011050,0 days 00:11:09,-11,20,31
4,PAR,P012743,0 days 00:06:19,-5,15,20
4,PAR,P000956,0 days 00:05:37,5,16,11
4,PAR,P004172,0 days 00:04:55,-9,9,18
5,VIR,P001133,0 days 00:31:01,-1,66,67
5,VIR,P009549,0 days 00:28:53,-7,58,65
5,VIR,P001844,0 days 00:28:38,-19,46,65
5,VIR,P008847,0 days 00:25:14,11,58,47
5,VIR,P004007,0 days 00:24:44,9,56,47
5,VIR,PBCN,0 days 00:14:40,-9,23,32
5,VIR,P011192,0 days 00:11:46,0,21,21
5,VIR,P006739,0 days 00:11:22,16,33,17
5,VIR,P002084,0 days 00:10:40,-8,13,21
5,VIR,P003048,0 days 00:07:42,-3,10,13
5,VIR,P012714,0 days 00:05:20,-4,11,15
5,ZAL,P002329,0 days 00:28:19,4,59,55
5,ZAL,P010390,0 days 00:27:31,21,63,42
5,ZAL,P011218,0 days 00:27:22,10,59,49
5,ZAL,P003211,0 days 00:26:38,22,64,42
5,ZAL,P007109,0 days 00:25:55,6,52,46
5,ZAL,P002676,0 days 00:20:04,-6,36,42
5,ZAL,P012715,0 days 00:15:31,-4,31,35
5,ZAL,P011965,0 days 00:11:56,-3,24,27
5,ZAL,P005504,0 days 00:08:48,-22,9,31
5,ZAL,P003210,0 days 00:07:47,-10,13,23
5,ZAL,P007513,0 days 00:00:09,-3,0,3
6,ULK,P010560,0 days 00:33:01,-3,61,64
6,ULK,P005844,0 days 00:31:34,6,62,56
6,ULK,P006661,0 days 00:31:07,6,58,52
6,ULK,P008962,0 days 00:30:42,1,63,62
6,ULK,P009849,0 days 00:30:25,1,59,58
6,ULK,P004004,0 days 00:18:38,1,34,33
6,ULK,P011052,0 days 00:13:37,-4,26,30
6,ULK,P011157,0 days 00:13:18,-6,20,26
6,ULK,P011980,0 days 00:08:33,0,13,13
6,ULK,P001932,0 days 00:07:56,7,16,9
6,ULK,P002968,0 days 00:06:02,4,11,7
6,ULK,P002969,0 days 00:00:07,2,2,0
6,MIL,P007831,0 days 00:37:19,5,71,66
6,MIL,P000796,0 days 00:35:43,-11,65,76
6,MIL,P007201,0 days 00:32:45,-2,63,65
6,MIL,P002849,0 days 00:28:12,6,53,47
6,MIL,P006433,0 days 00:27:31,0,46,46
6,MIL,P006509,0 days 00:17:31,-2,30,32
6,MIL,P005670,0 days 00:15:53,-1,33,34
6,MIL,P002812,0 days 00:14:30,1,29,28
6,MIL,P009960,0 days 00:12:57,-6,17,23
6,MIL,P006701,0 days 00:02:31,-3,3,6
6,MIL,P001518,0 days 00:00:08,-2,0,2
7,PAN,P012712,0 days 00:43:12,-15,73,88
7,PAN,P003842,0 days 00:33:40,-6,58,64
7,PAN,P011204,0 days 00:32:30,-7,57,64
7,PAN,P001926,0 days 00:31:12,-1,55,56
7,PAN,P002328,0 days 00:30:23,-10,55,65
7,PAN,P007947,0 days 00:21:13,-17,27,44
7,PAN,P007553,0 days 00:12:27,-9,20,29
7,PAN,P011826,0 days 00:11:28,5,28,23
7,PAN,P008084,0 days 00:08:03,10,17,7
7,PAN,P011209,0 days 00:00:26,0,0,0
7,PAN,P011221,0 days 00:00:26,0,0,0
7,OLY,P008855,0 days 00:38:45,20,82,62
7,OLY,P008829,0 days 00:36:50,21,78,57
7,OLY,P003941,0 days 00:35:34,18,75,57
7,OLY,P010612,0 days 00:31:49,18,69,51
7,OLY,P007982,0 days 00:27:13,5,49,44
7,OLY,P001255,0 days 00:26:18,-8,51,59
7,OLY,P010392,0 days 00:11:55,-6,17,23
7,OLY,P006589,0 days 00:10:00,-8,13,21
7,OLY,P007853,0 days 00:06:15,-10,6,16
7,OLY,P006302,0 days 00:00:21,0,0,0
8,BAS,P007230,0 days 00:27:18,0,48,48
8,BAS,P008072,0 days 00:23:56,7,51,44
8,BAS,P012201,0 days 00:23:36,-5,41,46
8,BAS,P011948,0 days 00:23:25,5,48,43
8,BAS,P010444,0 days 00:21:14,-1,40,41
8,BAS,P009048,0 days 00:19:47,-2,39,41
8,BAS,P011064,0 days 00:19:00,6,38,32
8,BAS,P004761,0 days 00:16:14,-7,29,36
8,BAS,P011085,0 days 00:12:35,-2,29,31
8,BAS,P004603,0 days 00:11:14,-5,22,27
8,BAS,P008850,0 days 00:01:41,-6,0,6
8,MAD,P010357,0 days 00:34:50,9,70,61
8,MAD,P004887,0 days 00:24:56,3,47,44
8,MAD,P006540,0 days 00:23:29,-10,42,52
8,MAD,P005928,0 days 00:22:44,4,44,40
8,MAD,PTGB,0 days 00:20:39,-4,42,46
8,MAD,P001392,0 days 00:19:49,6,37,31
8,MAD,PBMT,0 days 00:17:38,11,39,28
8,MAD,PCVM,0 days 00:17:16,-2,35,37
8,MAD,P003108,0 days 00:10:17,-1,26,27
8,MAD,P010868,0 days 00:06:09,-2,9,11
8,MAD,P003733,0 days 00:02:13,-4,4,8
9,PAM,P012740,0 days 00:25:23,4,43,39
9,PAM,P010568,0 days 00:25:08,-1,40,41
9,PAM,P011982,0 days 00:21:44,6,43,37
9,PAM,P003960,0 days 00:20:13,-9,26,35
9,PAM,P004863,0 days 00:19:24,16,40,24
9,PAM,P012739,0 days 00:18:26,-4,30,34
9,PAM,P012738,0 days 00:17:01,13,39,26
9,PAM,P006643,0 days 00:15:24,-6,24,30
9,PAM,P007870,0 days 00:15:07,-2,22,24
9,PAM,P010393,0 days 00:09:29,8,21,13
9,PAM,P011970,0 days 00:08:24,-1,17,18
9,PAM,P000556,0 days 00:04:17,1,5,4
9,MCO,P005985,0 days 00:33:34,6,60,54
9,MCO,P010588,0 days 00:32:15,11,60,49
9,MCO,P011212,0 days 00:29:27,1,51,50
9,MCO,P011226,0 days 00:24:10,-13,33,46
9,MCO,PLCZ,0 days 00:23:34,18,45,27
9,MCO,P011231,0 days 00:18:00,-13,26,39
9,MCO,P012515,0 days 00:11:05,1,17,16
9,MCO,P011196,0 days 00:10:06,-13,10,23
9,MCO,P008099,0 days 00:10:05,-17,10,27
9,MCO,P004790,0 days 00:07:44,-6,13,19
10,BER,P003958,0 days 00:24:46,-7,47,54
10,BER,P006919,0 days 00:23:58,-12,40,52
10,BER,P008967,0 days 00:23:52,-9,49,58
10,BER,P008173,0 days 00:22:57,3,56,53
10,BER,P012720,0 days 00:20:47,-13,38,51
10,BER,P008384,0 days 00:19:28,8,52,44
10,BER,P006251,0 days 00:17:19,6,48,42
10,BER,P007550,0 days 00:17:03,-8,30,38
10,BER,P012721,0 days 00:13:57,3,37,34
10,BER,P008211,0 days 00:11:51,7,27,20
10,BER,P006819,0 days 00:04:02,-3,6,9
10,BAS,P007230,0 days 00:28:57,12,67,55
10,BAS,P009048,0 days 00:26:51,1,53,52
10,BAS,P010444,0 days 00:24:31,11,52,41
10,BAS,P012201,0 days 00:22:37,-11,53,64
10,BAS,P004761,0 days 00:22:35,2,54,52
10,BAS,P011948,0 days 00:20:57,-2,41,43
10,BAS,P004603,0 days 00:18:11,-6,43,49
10,BAS,P011064,0 days 00:16:11,2,44,42
10,BAS,P008072,0 days 00:14:19,15,33,18
10,BAS,P011085,0 days 00:04:51,1,15,14
11,IST,P011078,0 days 00:32:29,-10,68,78
11,IST,P007200,0 days 00:23:53,-45,33,78
11,IST,P004554,0 days 00:23:08,0,53,53
11,IST,P006372,0 days 00:22:31,3,51,48
11,IST,P006590,0 days 00:21:53,4,53,49
11,IST,P009664,0 days 00:21:37,-7,48,55
11,IST,P004888,0 days 00:17:14,-30,26,56
11,IST,P011981,0 days 00:15:10,-18,25,43
11,IST,PLHK,0 days 00:11:09,-14,19,33
11,IST,P009513,0 days 00:09:25,2,22,20
11,IST,P012415,0 days 00:01:31,0,2,2
11,MAD,P005928,0 days 00:26:35,40,83,43
11,MAD,P010357,0 days 00:26:18,22,74,52
11,MAD,P001392,0 days 00:26:08,32,76,44
11,MAD,P003108,0 days 00:22:16,5,54,49
11,MAD,P006540,0 days 00:21:44,22,58,36
11,MAD,P004887,0 days 00:19:02,1,45,44
11,MAD,P005791,0 days 00:17:27,18,49,31
11,MAD,PTGB,0 days 00:13:52,-9,27,36
11,MAD,P009005,0 days 00:13:41,1,29,28
11,MAD,PCVM,0 days 00:11:26,-19,16,35
11,MAD,P009213,0 days 00:01:31,2,4,2
12,MIL,P007831,0 days 00:33:31,-12,80,92
12,MIL,P000796,0 days 00:31:13,-6,74,80
12,MIL,P007201,0 days 00:30:40,-2,78,80
12,MIL,P002849,0 days 00:23:40,-9,56,65
12,MIL,P007032,0 days 00:20:09,-5,50,55
12,MIL,P006433,0 days 00:19:49,-1,40,41
12,MIL,P009960,0 days 00:13:23,8,33,25
12,MIL,P011205,0 days 00:09:59,0,18,18
12,MIL,P006509,0 days 00:06:37,-5,10,15
12,MIL,P002812,0 days 00:05:32,-6,4,10
12,MIL,P001518,0 days 00:05:27,-2,7,9
12,TEL,P009783,0 days 00:31:15,6,82,76
12,TEL,P009622,0 days 00:30:34,6,76,70
12,TEL,P011971,0 days 00:24:48,11,66,55
12,TEL,P011199,0 days 00:23:02,3,62,59
12,TEL,P012744,0 days 00:22:55,5,66,61
12,TEL,P011193,0 days 00:19:48,7,43,36
12,TEL,P011214,0 days 00:19:25,12,45,33
12,TEL,P005145,0 days 00:11:16,-10,16,26
12,TEL,P004233,0 days 00:08:29,5,18,13
12,TEL,P011219,0 days 00:06:07,-2,11,13
12,TEL,P007990,0 days 00:02:21,-3,5,8
13,PAN,P011204,0 days 00:33:32,9,65,56
13,PAN,P003842,0 days 00:33:27,6,68,62
13,PAN,P007947,0 days 00:29:49,3,56,53
13,PAN,P012712,0 days 00:25:07,9,51,42
13,PAN,P005161,0 days 00:24:18,-2,42,44
13,PAN,P002328,0 days 00:23:41,15,58,43
13,PAN,P008084,0 days 00:15:21,0,32,32
13,PAN,P011826,0 days 00:06:28,2,11,9
13,PAN,P007553,0 days 00:05:42,-4,4,8
13,PAN,P006544,0 days 00:01:28,-2,2,4
13,PAN,P011221,0 days 00:01:07,-1,1,2
13,MUN,P007056,0 days 00:30:17,-11,55,66
13,MUN,P006760,0 days 00:29:15,-7,55,62
13,MUN,P008985,0 days 00:27:23,6,55,49
13,MUN,P003583,0 days 00:19:57,-4,35,39
13,MUN,P001557,0 days 00:19:14,7,37,30
13,MUN,P007975,0 days 00:18:54,-3,32,35
13,MUN,P004508,0 days 00:17:53,-3,35,38
13,MUN,P011987,0 days 00:16:07,-9,22,31
13,MUN,P010391,0 days 00:13:21,-5,18,23
13,MUN,P011941,0 days 00:07:39,-6,11,17
14,ASV,P012080,0 days 00:31:15,-18,56,74
14,ASV,P012729,0 days 00:28:03,-26,43,69
14,ASV,P011225,0 days 00:27:03,-21,38,59
14,ASV,P012732,0 days 00:21:35,-28,32,60
14,ASV,P004194,0 days 00:20:11,-19,30,49
14,ASV,P012730,0 days 00:19:26,-6,31,37
14,ASV,P002100,0 days 00:19:19,-12,28,40
14,ASV,P000229,0 days 00:12:44,2,22,20
14,ASV,PKIR,0 days 00:12:20,-1,20,21
14,ASV,P012731,0 days 00:08:04,-1,10,11
14,PAR,P007400,0 days 00:32:07,22,71,49
14,PAR,P008987,0 days 00:27:59,26,67,41
14,PAR,P003983,0 days 00:22:52,23,58,35
14,PAR,P009862,0 days 00:22:51,9,45,36
14,PAR,P012743,0 days 00:16:06,10,36,26
14,PAR,P000956,0 days 00:15:43,16,39,23
14,PAR,P012742,0 days 00:15:28,6,29,23
14,PAR,P011051,0 days 00:15:17,15,36,21
14,PAR,P007673,0 days 00:13:55,3,27,24
14,PAR,P004172,0 days 00:09:05,-1,16,17
14,PAR,P011050,0 days 00:08:37,1,16,15
15,MCO,P005985,0 days 00:29:51,-21,42,63
15,MCO,P011212,0 days 00:27:38,-20,39,59
15,MCO,P011226,0 days 00:20:12,-12,28,40
15,MCO,P004790,0 days 00:18:32,-6,31,37
15,MCO,P004197,0 days 00:18:30,-11,28,39
15,MCO,P008099,0 days 00:17:22,-2,30,32
15,MCO,P011231,0 days 00:17:11,-11,24,35
15,MCO,PLCZ,0 days 00:15:14,-13,24,37
15,MCO,P011196,0 days 00:14:46,-9,24,33
15,MCO,P010588,0 days 00:14:17,-9,15,24
15,MCO,P012515,0 days 00:06:27,-6,10,16
15,VIR,P001133,0 days 00:25:58,19,56,37
15,VIR,P003048,0 days 00:23:42,18,52,34
15,VIR,P010781,0 days 00:22:15,8,42,34
15,VIR,P008847,0 days 00:20:51,12,43,31
15,VIR,P004007,0 days 00:20:47,13,43,30
15,VIR,PBCN,0 days 00:19:39,13,42,29
15,VIR,P001844,0 days 00:17:31,12,40,28
15,VIR,P009549,0 days 00:16:03,13,35,22
15,VIR,P011192,0 days 00:13:16,13,30,17
15,VIR,P006739,0 days 00:10:55,2,19,17
15,VIR,P012714,0 days 00:05:38,0,9,9
15,VIR,P003527,0 days 00:03:25,-3,4,7
16,OLY,P008855,0 days 00:35:35,-13,59,72
16,OLY,P008829,0 days 00:32:13,-7,56,63
16,OLY,P001255,0 days 00:29:38,-12,49,61
16,OLY,P003941,0 days 00:27:10,-10,47,57
16,OLY,P011983,0 days 00:18:16,0,30,30
16,OLY,P010392,0 days 00:18:11,1,31,30
16,OLY,P010612,0 days 00:17:38,-10,31,41
16,OLY,P008811,0 days 00:12:48,1,21,20
16,OLY,P006302,0 days 00:08:31,5,16,11
16,BAR,P006435,0 days 00:28:00,10,58,48
16,BAR,P004866,0 days 00:26:56,10,56,46
16,BAR,P000925,0 days 00:22:15,14,49,35
16,BAR,P007519,0 days 00:20:44,0,37,37
16,BAR,P011244,0 days 00:20:42,-1,39,40
16,BAR,P002939,0 days 00:20:16,8,40,32
16,BAR,P003196,0 days 00:17:41,-5,28,33
16,BAR,P003478,0 days 00:14:59,13,34,21
16,BAR,P012745,0 days 00:13:24,-4,20,24
16,BAR,P007464,0 days 00:12:14,2,21,19
16,BAR,P009992,0 days 00:02:45,-2,3,5
16,BAR,P010641,0 days 00:00:04,0,0,0
17,PAM,P010568,0 days 00:27:16,0,48,48
17,PAM,P012740,0 days 00:24:32,-2,41,43
17,PAM,P011982,0 days 00:23:54,-1,43,44
17,PAM,P007870,0 days 00:21:17,10,46,36
17,PAM,P003960,0 days 00:20:37,8,45,37
17,PAM,P012738,0 days 00:16:44,3,29,26
17,PAM,P000556,0 days 00:16:41,4,37,33
17,PAM,P012739,0 days 00:16:04,-8,26,34
17,PAM,P006643,0 days 00:12:04,1,27,26
17,PAM,P009101,0 days 00:09:58,-1,20,21
17,PAM,P004863,0 days 00:05:31,8,15,7
17,PAM,P010393,0 days 00:05:22,-7,8,15
17,ULK,P008962,0 days 00:33:22,5,65,60
17,ULK,P009849,0 days 00:24:33,4,50,46
17,ULK,P005844,0 days 00:22:48,-6,36,42
17,ULK,P011052,0 days 00:22:02,2,46,44
17,ULK,P004004,0 days 00:21:25,-2,38,40
17,ULK,P006661,0 days 00:21:22,-2,40,42
17,ULK,P002968,0 days 00:15:46,-1,33,34
17,ULK,P010560,0 days 00:14:28,-6,21,27
17,ULK,P011980,0 days 00:13:50,0,28,28
17,ULK,P011157,0 days 00:06:15,-1,11,12
17,ULK,P001932,0 days 00:04:05,-6,2,8
17,ULK,P002969,0 days 00:00:04,-2,0,2
18,ZAL,P002329,0 days 00:34:02,13,74,61
18,ZAL,P003211,0 days 00:29:12,23,65,42
18,ZAL,P007109,0 days 00:25:38,18,59,41
18,ZAL,P011218,0 days 00:25:18,5,53,48
18,ZAL,P010390,0 days 00:22:21,-1,43,44
18,ZAL,P002676,0 days 00:19:53,-7,36,43
18,ZAL,P012715,0 days 00:16:12,-1,30,31
18,ZAL,P011965,0 days 00:11:21,-14,14,28
18,ZAL,P005504,0 days 00:11:17,-7,15,22
18,ZAL,P003210,0 days 00:03:01,3,6,3
18,ZAL,P007513,0 days 00:01:45,-7,0,7
18,RED,P006436,0 days 00:32:01,-16,56,72
18,RED,P007960,0 days 00:26:38,-5,55,60
18,RED,PJDR,0 days 00:25:28,2,53,51
18,RED,P000848,0 days 00:23:20,5,51,46
18,RED,P002553,0 days 00:22:27,5,41,36
18,RED,P005099,0 days 00:20:22,11,38,27
18,RED,P011224,0 days 00:14:49,-6,22,28
18,RED,P009035,0 days 00:12:41,-6,23,29
18,RED,P011964,0 days 00:12:15,-9,13,22
18,RED,P008966,0 days 00:06:50,-2,14,16
18,RED,P012711,0 days 00:03:09,-4,4,8
19,IST,P007200,0 days 00:32:19,16,75,59
19,IST,P004888,0 days 00:31:48,11,75,64
19,IST,P009664,0 days 00:31:35,4,65,61
19,IST,P006590,0 days 00:28:52,7,69,62
19,IST,P004554,0 days 00:24:11,10,55,45
19,IST,P011078,0 days 00:16:36,2,36,34
19,IST,P011981,0 days 00:11:51,-2,30,32
19,IST,P006372,0 days 00:08:50,-11,16,27
19,IST,P012710,0 days 00:05:43,5,14,9
19,IST,PLHK,0 days 00:03:58,-3,4,7
19,IST,P009513,0 days 00:02:12,-9,2,11
19,IST,P012415,0 days 00:02:05,-5,4,9
19,ASV,P011225,0 days 00:31:23,-3,71,74
19,ASV,P002100,0 days 00:26:35,19,70,51
19,ASV,P012729,0 days 00:23:51,10,61,51
19,ASV,P004194,0 days 00:23:30,-6,49,55
19,ASV,P012732,0 days 00:18:33,-14,29,43
19,ASV,P012730,0 days 00:17:07,-6,31,37
19,ASV,P006568,0 days 00:16:16,-10,29,39
19,ASV,P012731,0 days 00:15:32,9,42,33
19,ASV,P012080,0 days 00:15:12,-14,23,37
19,ASV,P011386,0 days 00:08:37,-2,13,15
19,ASV,P000229,0 days 00:03:24,-8,2,10
20,MIL,P007831,0 days 00:31:12,10,56,46
20,MIL,P002849,0 days 00:30:18,15,53,38
20,MIL,P006433,0 days 00:29:53,11,55,44
20,MIL,P000796,0 days 00:29:50,12,56,44
20,MIL,P007201,0 days 00:27:15,13,47,34
20,MIL,P011205,0 days 00:12:14,-6,9,15
20,MIL,P005670,0 days 00:10:29,5,14,9
20,MIL,P006509,0 days 00:10:06,1,14,13
20,MIL,P009960,0 days 00:08:49,-8,10,18
20,MIL,P002812,0 days 00:06:55,5,7,2
20,MIL,P011926,0 days 00:02:59,2,4,2
20,OLY,P001255,0 days 00:33:01,-13,45,58
20,OLY,P008855,0 days 00:30:55,-3,46,49
20,OLY,P003941,0 days 00:28:23,-8,41,49
20,OLY,P008829,0 days 00:22:20,-6,34,40
20,OLY,P011983,0 days 00:18:38,-6,19,25
20,OLY,P006302,0 days 00:17:22,-15,17,32
20,OLY,P010392,0 days 00:15:10,-2,19,21
20,OLY,P008811,0 days 00:11:37,-4,12,16
20,OLY,P006589,0 days 00:10:14,-6,7,13
20,OLY,P010612,0 days 00:07:30,7,17,10
20,OLY,P012023,0 days 00:04:50,-4,8,12
21,ULK,P001932,0 days 00:29:17,22,69,47
21,ULK,P010560,0 days 00:28:44,27,64,37
21,ULK,P008962,0 days 00:27:17,21,65,44
21,ULK,P004004,0 days 00:23:11,8,48,40
21,ULK,P005844,0 days 00:21:05,-9,32,41
21,ULK,P006661,0 days 00:20:25,-3,37,40
21,ULK,P011157,0 days 00:18:55,23,51,28
21,ULK,P011052,0 days 00:14:01,-8,23,31
21,ULK,P006961,0 days 00:12:33,-7,18,25
21,ULK,P011980,0 days 00:04:32,-4,8,12
21,PAN,P003842,0 days 00:26:54,-10,48,58
21,PAN,P011204,0 days 00:26:06,8,55,47
21,PAN,P001926,0 days 00:22:18,-25,28,53
21,PAN,P002328,0 days 00:22:04,-23,34,57
21,PAN,P012712,0 days 00:20:42,-16,30,46
21,PAN,P007947,0 days 00:19:34,-9,34,43
21,PAN,P008084,0 days 00:19:18,2,39,37
21,PAN,P011826,0 days 00:18:44,6,36,30
21,PAN,P011209,0 days 00:11:14,1,20,19
21,PAN,P011221,0 days 00:08:56,-2,13,15
21,PAN,P007553,0 days 00:04:10,-2,8,10
22,PAR,P008987,0 days 00:30:56,-11,58,69
22,PAR,P009862,0 days 00:27:02,-16,59,75
22,PAR,P007400,0 days 00:25:25,-11,58,69
22,PAR,P012742,0 days 00:21:55,-14,48,62
22,PAR,P003983,0 days 00:20:44,2,37,35
22,PAR,P011051,0 days 00:19:29,-7,42,49
22,PAR,P007673,0 days 00:16:19,8,38,30
22,PAR,P012743,0 days 00:13:54,2,26,24
22,PAR,P011050,0 days 00:09:55,1,24,23
22,PAR,P000956,0 days 00:09:07,5,18,13
22,PAR,P004058,0 days 00:05:14,-4,7,11
22,BAR,P006435,0 days 00:27:57,11,73,62
22,BAR,P002939,0 days 00:24:56,6,64,58
22,BAR,P000925,0 days 00:22:18,13,53,40
22,BAR,P004866,0 days 00:21:21,10,52,42
22,BAR,P011244,0 days 00:21:12,13,54,41
22,BAR,P003478,0 days 00:18:53,-1,40,41
22,BAR,P012745,0 days 00:18:48,-4,38,42
22,BAR,P003196,0 days 00:17:34,-4,39,43
22,BAR,P007519,0 days 00:16:01,4,32,28
22,BAR,P009992,0 days 00:06:12,-5,6,11
22,BAR,P007464,0 days 00:04:40,2,9,7
22,BAR,P010641,0 days 00:00:08,0,0,0
23,MAD,P010357,0 days 00:23:50,0,46,46
23,MAD,P005928,0 days 00:23:18,5,52,47
23,MAD,P009005,0 days 00:22:49,2,51,49
23,MAD,PBMT,0 days 00:21:37,24,64,40
23,MAD,P004887,0 days 00:20:45,8,53,45
23,MAD,PTGB,0 days 00:20:01,16,55,39
23,MAD,P005791,0 days 00:19:15,6,40,34
23,MAD,PCVM,0 days 00:16:42,9,41,32
23,MAD,P006540,0 days 00:13:23,0,23,23
23,MAD,P001392,0 days 00:10:33,-6,17,23
23,MAD,P003108,0 days 00:07:47,6,23,17
23,ZAL,P002329,0 days 00:28:13,-14,57,71
23,ZAL,P007109,0 days 00:24:16,-4,47,51
23,ZAL,P011218,0 days 00:23:16,-13,41,54
23,ZAL,P007513,0 days 00:21:35,3,41,38
23,ZAL,P011965,0 days 00:20:07,-9,43,52
23,ZAL,P012715,0 days 00:19:12,-17,40,57
23,ZAL,P010390,0 days 00:18:43,-11,32,43
23,ZAL,P003210,0 days 00:16:39,-1,38,39
23,ZAL,P005504,0 days 00:12:52,2,29,27
23,ZAL,P003211,0 days 00:10:10,-8,17,25
23,ZAL,P006860,0 days 00:04:57,2,10,8
24,BAS,P007230,0 days 00:28:59,-9,46,55
24,BAS,P004761,0 days 00:23:18,-5,40,45
24,BAS,P009048,0 days 00:22:23,-9,39,48
24,BAS,P004603,0 days 00:22:19,-7,42,49
24,BAS,P010444,0 days 00:21:35,-9,42,51
24,BAS,P011948,0 days 00:20:20,-4,35,39
24,BAS,P012201,0 days 00:18:33,-1,26,27
24,BAS,P011064,0 days 00:17:37,1,29,28
24,BAS,P008072,0 days 00:17:33,1,26,25
24,BAS,P011085,0 days 00:07:15,4,15,11
24,BAS,P008850,0 days 00:00:08,-2,0,2
24,MUN,P007056,0 days 00:27:47,3,55,52
24,MUN,P010391,0 days 00:27:26,13,51,38
24,MUN,P007975,0 days 00:23:06,11,46,35
24,MUN,P001557,0 days 00:22:17,17,43,26
24,MUN,P004508,0 days 00:20:54,14,39,25
24,MUN,P011987,0 days 00:18:55,-3,40,43
24,MUN,P008985,0 days 00:16:30,0,30,30
24,MUN,P006760,0 days 00:13:12,-7,24,31
24,MUN,P011941,0 days 00:13:08,-2,24,26
24,MUN,P007639,0 days 00:12:14,-2,18,20
24,MUN,P005478,0 days 00:04:07,-1,10,11
24,MUN,P006245,0 days 00:00:24,-3,0,3
25,RED,P006436,0 days 00:29:43,-5,63,68
25,RED,P000848,0 days 00:25:18,1,51,50
25,RED,P005099,0 days 00:24:46,-6,42,48
25,RED,P011224,0 days 00:21:56,-5,39,44
25,RED,P007960,0 days 00:21:33,10,43,33
25,RED,PJDR,0 days 00:17:55,-5,33,38
25,RED,P009035,0 days 00:15:31,3,35,32
25,RED,P002553,0 days 00:12:35,-7,19,26
25,RED,P008966,0 days 00:12:23,-5,22,27
25,RED,P012711,0 days 00:10:26,-4,21,25
25,RED,P004720,0 days 00:06:15,-6,8,14
25,RED,P011964,0 days 00:01:39,-1,4,5
25,MCO,P005985,0 days 00:35:45,6,78,72
25,MCO,P011212,0 days 00:31:30,11,62,51
25,MCO,P010588,0 days 00:24:15,17,53,36
25,MCO,P011226,0 days 00:20:38,0,44,44
25,MCO,P011231,0 days 00:17:45,15,44,29
25,MCO,PLCZ,0 days 00:17:27,19,42,23
25,MCO,P011196,0 days 00:13:50,-1,27,28
25,MCO,P004197,0 days 00:12:22,0,25,25
25,MCO,P012709,0 days 00:10:19,-9,14,23
25,MCO,P004790,0 days 00:10:04,-16,13,29
25,MCO,P002581,0 days 00:06:05,-12,8,20
26,PAM,P010568,0 days 00:25:33,3,46,43
26,PAM,P012740,0 days 00:24:34,-17,32,49
26,PAM,P000556,0 days 00:22:48,12,48,36
26,PAM,P006643,0 days 00:21:13,-5,36,41
26,PAM,P003960,0 days 00:20:10,-9,38,47
26,PAM,P004863,0 days 00:19:27,23,47,24
26,PAM,P007870,0 days 00:17:48,-5,32,37
26,PAM,P012738,0 days 00:15:29,15,30,15
26,PAM,P010393,0 days 00:14:44,14,29,15
26,PAM,P012739,0 days 00:11:49,3,21,18
26,PAM,P009101,0 days 00:03:59,7,11,4
26,PAM,P010754,0 days 00:02:26,4,5,1
26,TEL,P009622,0 days 00:33:46,7,65,58
26,TEL,P009783,0 days 00:31:32,7,61,54
26,TEL,P011199,0 days 00:21:16,3,34,31
26,TEL,P011193,0 days 00:21:02,-8,34,42
26,TEL,P011214,0 days 00:20:54,-11,34,45
26,TEL,P007990,0 days 00:20:11,-24,21,45
26,TEL,P011971,0 days 00:14:37,-6,17,23
26,TEL,P005145,0 days 00:13:17,8,35,27
26,TEL,P012744,0 days 00:12:10,-9,19,28
26,TEL,P011219,0 days 00:11:15,-12,10,22
27,VIR,P001133,0 days 00:27:22,14,68,54
27,VIR,P009549,0 days 00:25:31,0,54,54
27,VIR,PBCN,0 days 00:24:24,7,56,49
27,VIR,P003048,0 days 00:21:19,8,50,42
27,VIR,P001844,0 days 00:20:42,-8,42,50
27,VIR,P006739,0 days 00:19:18,19,45,26
27,VIR,P008847,0 days 00:18:41,3,37,34
27,VIR,P004007,0 days 00:14:54,5,31,26
27,VIR,P003527,0 days 00:12:38,-3,19,22
27,VIR,P011192,0 days 00:09:00,4,19,15
27,VIR,P010781,0 days 00:06:11,6,14,8
27,BER,P008967,0 days 00:27:39,-2,57,59
27,BER,P003958,0 days 00:26:49,8,60,52
27,BER,P012720,0 days 00:26:32,2,57,55
27,BER,P006919,0 days 00:20:23,-4,45,49
27,BER,P012721,0 days 00:16:56,-8,27,35
27,BER,P006251,0 days 00:14:52,-18,18,36
27,BER,P008173,0 days 00:14:52,-4,30,34
27,BER,P007550,0 days 00:14:06,-18,17,35
27,BER,P008384,0 days 00:13:28,-13,19,32
27,BER,P007025,0 days 00:12:21,-9,19,28
27,BER,P008211,0 days 00:11:02,11,29,18
27,BER,P006819,0 days 00:01:00,0,2,2
28,ULK,P011157,0 days 00:30:00,14,74,60
28,ULK,P008962,0 days 00:27:53,22,76,54
28,ULK,P001932,0 days 00:23:42,13,60,47
28,ULK,P010560,0 days 00:22:39,-8,50,58
28,ULK,P006961,0 days 00:22:14,27,67,40
28,ULK,P004004,0 days 00:20:58,5,48,43
28,ULK,P006661,0 days 00:20:04,6,51,45
28,ULK,P011052,0 days 00:15:04,6,41,35
28,ULK,P005844,0 days 00:10:00,1,27,26
28,ULK,P002968,0 days 00:07:11,-11,11,22
28,ULK,P011980,0 days 00:00:15,0,0,0
28,ASV,PKIR,0 days 00:29:29,-12,62,74
28,ASV,P012732,0 days 00:28:23,-9,59,68
28,ASV,P004194,0 days 00:25:16,-10,57,67
28,ASV,P002100,0 days 00:24:49,-19,51,70
28,ASV,P006568,0 days 00:24:42,-7,49,56
28,ASV,P011225,0 days 00:20:14,9,50,41
28,ASV,P012729,0 days 00:18:16,-13,37,50
28,ASV,P012731,0 days 00:11:19,-5,25,30
28,ASV,P012730,0 days 00:11:14,1,28,27
28,ASV,P011386,0 days 00:05:16,-6,11,17
28,ASV,P000229,0 days 00:01:02,-4,1,5
29,OLY,P001255,0 days 00:39:35,9,88,79
29,OLY,P008855,0 days 00:37:16,7,84,77
29,OLY,P007982,0 days 00:31:09,8,71,63
29,OLY,P003941,0 days 00:26:25,14,67,53
29,OLY,P010612,0 days 00:24:25,-5,51,56
29,OLY,P010392,0 days 00:22:00,14,57,43
29,OLY,P008829,0 days 00:20:05,-13,33,46
29,OLY,P008811,0 days 00:18:35,-10,31,41
29,OLY,P006302,0 days 00:05:30,-4,8,12
29,PAR,P008987,0 days 00:41:29,-5,86,91
29,PAR,P009862,0 days 00:36:31,3,76,73
29,PAR,P000956,0 days 00:34:43,0,74,74
29,PAR,P007400,0 days 00:34:18,-7,70,77
29,PAR,P003983,0 days 00:19:35,-6,33,39
29,PAR,P012743,0 days 00:16:24,6,37,31
29,PAR,P011051,0 days 00:15:47,9,32,23
29,PAR,P011050,0 days 00:10:01,-11,21,32
29,PAR,P012742,0 days 00:09:48,-5,25,30
29,PAR,P004058,0 days 00:03:13,-2,8,10
29,PAR,P007673,0 days 00:03:11,-2,8,10
30,MAD,P010357,0 days 00:25:17,14,59,45
30,MAD,P003108,0 days 00:21:22,7,41,34
30,MAD,PTGB,0 days 00:21:19,11,47,36
30,MAD,P009005,0 days 00:20:34,14,53,39
30,MAD,P005928,0 days 00:19:51,6,46,40
30,MAD,PBMT,0 days 00:19:03,2,35,33
30,MAD,PCVM,0 days 00:18:12,15,40,25
30,MAD,P004887,0 days 00:18:05,11,38,27
30,MAD,P006540,0 days 00:17:41,6,41,35
30,MAD,P005791,0 days 00:11:01,3,27,24
30,MAD,P009213,0 days 00:07:35,-4,13,17
30,MIL,P007831,0 days 00:32:26,-18,54,72
30,MIL,P000796,0 days 00:26:41,-13,48,61
30,MIL,P011205,0 days 00:24:17,-4,42,46
30,MIL,P007201,0 days 00:21:28,-12,37,49
30,MIL,P006433,0 days 00:21:24,-7,41,48
30,MIL,P005670,0 days 00:18:47,-6,31,37
30,MIL,P002849,0 days 00:18:22,-7,33,40
30,MIL,P009960,0 days 00:14:56,-4,30,34
30,MIL,P006509,0 days 00:09:25,-7,17,24
30,MIL,P001518,0 days 00:05:24,-5,9,14
30,MIL,P002812,0 days 00:04:03,-2,9,11
30,MIL,P011926,0 days 00:02:47,0,4,4
31,BAS,P012201,0 days 00:27:33,5,64,59
31,BAS,P007230,0 days 00:26:45,-26,47,73
31,BAS,P011948,0 days 00:25:56,-9,53,62
31,BAS,P010444,0 days 00:24:38,-11,52,63
31,BAS,P009048,0 days 00:24:05,2,53,51
31,BAS,P004761,0 days 00:17:58,-22,31,53
31,BAS,P011085,0 days 00:15:54,5,39,34
31,BAS,P011064,0 days 00:15:05,-14,31,45
31,BAS,P004603,0 days 00:13:43,-5,26,31
31,BAS,P003198,0 days 00:08:23,-10,14,24
31,ZAL,P002329,0 days 00:33:25,13,84,71
31,ZAL,P012715,0 days 00:28:00,19,75,56
31,ZAL,P007109,0 days 00:25:30,16,67,51
31,ZAL,P011218,0 days 00:24:41,-1,55,56
31,ZAL,P007513,0 days 00:22:37,24,67,43
31,ZAL,P003211,0 days 00:17:23,-7,32,39
31,ZAL,P002676,0 days 00:15:18,3,36,33
31,ZAL,P011965,0 days 00:13:06,13,36,23
31,ZAL,P010390,0 days 00:11:16,-10,19,29
31,ZAL,P005504,0 days 00:08:12,14,23,9
31,ZAL,P006860,0 days 00:00:32,1,1,0
32,IST,P004888,0 days 00:34:11,0,63,63
32,IST,P007200,0 days 00:32:08,2,59,57
32,IST,P011078,0 days 00:28:18,2,55,53
32,IST,P011981,0 days 00:26:54,9,54,45
32,IST,P009664,0 days 00:24:25,10,49,39
32,IST,P006590,0 days 00:23:26,12,51,39
32,IST,P004554,0 days 00:12:56,-7,21,28
32,IST,P006372,0 days 00:09:39,-2,21,23
32,IST,P012710,0 days 00:08:03,-6,12,18
32,PAM,P010568,0 days 00:27:02,6,53,47
32,PAM,P012740,0 days 00:23:46,10,49,39
32,PAM,P004863,0 days 00:22:11,-12,36,48
32,PAM,P007870,0 days 00:22:03,4,47,43
32,PAM,P000556,0 days 00:20:37,-4,34,38
32,PAM,P003960,0 days 00:19:39,10,46,36
32,PAM,P006643,0 days 00:18:44,-4,34,38
32,PAM,P010393,0 days 00:17:46,-9,26,35
32,PAM,P012739,0 days 00:10:44,-5,15,20
32,PAM,P012738,0 days 00:10:25,-6,14,20
32,PAM,P009101,0 days 00:07:03,-10,11,21
33,MCO,P011226,0 days 00:29:24,7,60,53
33,MCO,P005985,0 days 00:27:48,12,60,48
33,MCO,P011212,0 days 00:21:55,-1,44,45
33,MCO,P010588,0 days 00:19:50,17,41,24
33,MCO,P011196,0 days 00:16:41,1,39,38
33,MCO,PLCZ,0 days 00:14:50,16,34,18
33,MCO,P008099,0 days 00:14:17,9,22,13
33,MCO,P004197,0 days 00:13:50,1,41,40
33,MCO,P004790,0 days 00:13:38,-4,22,26
33,MCO,P012709,0 days 00:12:42,5,31,26
33,MCO,P011231,0 days 00:11:36,-1,30,31
33,MCO,P002581,0 days 00:03:29,-7,6,13
33,BER,P008967,0 days 00:26:40,-17,41,58
33,BER,P003958,0 days 00:25:06,-21,37,58
33,BER,P012720,0 days 00:24:20,-3,52,55
33,BER,P006919,0 days 00:21:31,-7,34,41
33,BER,P008211,0 days 00:20:08,5,45,40
33,BER,P008173,0 days 00:19:52,-16,30,46
33,BER,P006251,0 days 00:15:22,-2,30,32
33,BER,P008384,0 days 00:15:08,1,35,34
33,BER,P012721,0 days 00:14:57,-5,32,37
33,BER,P006819,0 days 00:11:52,9,26,17
33,BER,P007025,0 days 00:05:04,1,13,12
34,BAR,P012745,0 days 00:23:19,20,57,37
34,BAR,P007464,0 days 00:22:48,16,53,37
34,BAR,P007519,0 days 00:21:33,25,57,32
34,BAR,P009992,0 days 00:20:45,16,48,32
34,BAR,P002939,0 days 00:18:27,14,41,27
34,BAR,P003196,0 days 00:17:39,20,40,20
34,BAR,P004866,0 days 00:17:12,23,45,22
34,BAR,P011244,0 days 00:16:41,19,41,22
34,BAR,P006435,0 days 00:13:58,18,37,19
34,BAR,P000925,0 days 00:11:58,14,31,17
34,BAR,P010641,0 days 00:10:23,5,27,22
34,BAR,P003478,0 days 00:05:17,5,13,8
34,MUN,P010391,0 days 00:24:07,-15,41,56
34,MUN,P004508,0 days 00:24:06,-15,37,52
34,MUN,P003583,0 days 00:22:31,-16,39,55
34,MUN,P001557,0 days 00:22:12,-18,30,48
34,MUN,P007975,0 days 00:17:33,-18,26,44
34,MUN,P008985,0 days 00:16:47,-19,21,40
34,MUN,P006760,0 days 00:15:21,-17,24,41
34,MUN,P011987,0 days 00:13:49,-24,15,39
34,MUN,P007056,0 days 00:13:00,-16,20,36
34,MUN,P011941,0 days 00:12:35,-20,13,33
34,MUN,P005460,0 days 00:10:14,-15,10,25
34,MUN,P006245,0 days 00:07:45,-2,19,21
35,PAN,P002328,0 days 00:34:25,6,71,65
35,PAN,P001926,0 days 00:32:08,-4,53,57
35,PAN,P007947,0 days 00:27:48,-9,51,60
35,PAN,P007866,0 days 00:26:04,8,43,35
35,PAN,P003842,0 days 00:23:03,-2,41,43
35,PAN,P011204,0 days 00:21:16,1,35,34
35,PAN,P012712,0 days 00:14:43,-11,30,41
35,PAN,P011221,0 days 00:13:29,-4,24,28
35,PAN,P011209,0 days 00:09:42,3,23,20
35,PAN,P007553,0 days 00:08:29,-1,16,17
35,PAN,P008084,0 days 00:08:19,-6,12,18
35,PAN,P011826,0 days 00:05:34,-6,6,12
35,TEL,P009622,0 days 00:36:28,8,69,61
35,TEL,P009783,0 days 00:35:58,2,68,66
35,TEL,P011199,0 days 00:28:50,7,52,45
35,TEL,P007990,0 days 00:26:03,-1,49,50
35,TEL,P011193,0 days 00:23:24,4,48,44
35,TEL,P005145,0 days 00:18:02,2,34,32
35,TEL,P012744,0 days 00:15:13,5,30,25
35,TEL,P011214,0 days 00:14:53,1,30,29
35,TEL,P011219,0 days 00:14:36,-8,26,34
35,TEL,P004233,0 days 00:06:47,0,11,11
35,TEL,P011971,0 days 00:04:46,5,13,8
36,VIR,P001133,0 days 00:29:33,-3,59,62
36,VIR,P009549,0 days 00:27:41,0,62,62
36,VIR,P008847,0 days 00:27:13,-7,53,60
36,VIR,PBCN,0 days 00:23:33,10,51,41
36,VIR,P003048,0 days 00:19:19,17,43,26
36,VIR,P010781,0 days 00:19:07,-2,36,38
36,VIR,P001844,0 days 00:17:27,2,38,36
36,VIR,P006739,0 days 00:14:52,2,34,32
36,VIR,P004007,0 days 00:11:23,-2,22,24
36,VIR,P011192,0 days 00:06:29,11,17,6
36,VIR,P012714,0 days 00:03:23,2,10,8
36,RED,P009035,0 days 00:31:46,-1,62,63
36,RED,P011224,0 days 00:28:20,0,59,59
36,RED,PJDR,0 days 00:25:16,3,55,52
36,RED,P002553,0 days 00:22:35,-8,49,57
36,RED,P006436,0 days 00:21:22,-9,43,52
36,RED,P005099,0 days 00:18:23,-3,36,39
36,RED,P007960,0 days 00:16:31,0,25,25
36,RED,PLUO,0 days 00:13:47,-2,22,24
36,RED,P000848,0 days 00:09:10,-10,17,27
36,RED,P012711,0 days 00:08:41,0,20,20
36,RED,P012044,0 days 00:04:09,0,7,7
37,BER,P003958,0 days 00:29:46,15,70,55
37,BER,P012720,0 days 00:27:48,21,69,48
37,BER,P006919,0 days 00:25:40,14,62,48
37,BER,P008967,0 days 00:19:44,-5,40,45
37,BER,P008173,0 days 00:19:16,7,41,34
37,BER,P008211,0 days 00:17:12,7,42,35
37,BER,P006251,0 days 00:16:31,-17,29,46
37,BER,P010791,0 days 00:13:54,8,33,25
37,BER,P008384,0 days 00:11:47,-13,18,31
37,BER,P006819,0 days 00:09:11,0,15,15
37,BER,P012721,0 days 00:05:39,-11,4,15
37,BER,P007550,0 days 00:03:32,-11,2,13
37,MIL,P007831,0 days 00:33:15,-9,67,76
37,MIL,P000796,0 days 00:30:45,7,68,61
37,MIL,P006433,0 days 00:25:12,-8,47,55
37,MIL,P011205,0 days 00:24:33,20,62,42
37,MIL,P002849,0 days 00:17:04,-4,31,35
37,MIL,P007032,0 days 00:17:03,3,42,39
37,MIL,P007201,0 days 00:16:52,-1,31,32
37,MIL,P002812,0 days 00:11:29,-13,23,36
37,MIL,P006509,0 days 00:10:57,-7,17,24
37,MIL,P009960,0 days 00:10:27,0,18,18
37,MIL,P005670,0 days 00:02:23,-3,4,7
38,OLY,P001255,0 days 00:28:05,21,61,40
38,OLY,P010612,0 days 00:26:14,13,54,41
38,OLY,P007982,0 days 00:23:51,20,49,29
38,OLY,P008855,0 days 00:21:49,8,45,37
38,OLY,P003941,0 days 00:21:48,15,52,37
38,OLY,P008829,0 days 00:19:24,8,31,23
38,OLY,P010392,0 days 00:18:30,10,30,20
38,OLY,P008811,0 days 00:18:12,3,23,20
38,OLY,P011983,0 days 00:17:07,5,30,25
38,OLY,P006302,0 days 00:02:25,-5,0,5
38,OLY,P012023,0 days 00:01:30,-5,0,5
38,OLY,P010631,0 days 00:01:05,-3,0,3
38,IST,P007200,0 days 00:29:07,-19,42,61
38,IST,P004888,0 days 00:25:50,-13,36,49
38,IST,P009846,0 days 00:23:35,-12,31,43
38,IST,P006590,0 days 00:23:07,-12,34,46
38,IST,P009664,0 days 00:22:38,-11,35,46
38,IST,P011078,0 days 00:18:59,-3,27,30
38,IST,P004554,0 days 00:16:39,-7,26,33
38,IST,PLHK,0 days 00:16:11,-10,23,33
38,IST,P011981,0 days 00:10:09,-4,8,12
38,IST,P006372,0 days 00:10:06,-4,14,18
38,IST,P009513,0 days 00:03:39,5,9,4
39,PAR,P008987,0 days 00:31:20,-5,58,63
39,PAR,P007400,0 days 00:28:09,11,71,60
39,PAR,P009862,0 days 00:27:57,-3,51,54
39,PAR,P004058,0 days 00:25:49,10,60,50
39,PAR,P003983,0 days 00:22:12,-3,52,55
39,PAR,P012743,0 days 00:21:53,-3,43,46
39,PAR,P011051,0 days 00:17:15,5,43,38
39,PAR,P012742,0 days 00:13:18,10,38,28
39,PAR,P000956,0 days 00:11:16,-10,24,34
39,PAR,P007673,0 days 00:00:51,-2,0,2
39,RED,P011224,0 days 00:28:14,-5,61,66
39,RED,P005099,0 days 00:27:51,3,57,54
39,RED,P009035,0 days 00:26:58,-13,55,68
39,RED,PJDR,0 days 00:24:18,2,59,57
39,RED,P002553,0 days 00:23:10,19,60,41
39,RED,P012044,0 days 00:20:47,11,49,38
39,RED,P007960,0 days 00:19:44,-16,34,50
39,RED,P006436,0 days 00:18:49,-18,31,49
39,RED,P008966,0 days 00:10:09,7,24,17
40,MAD,P009005,0 days 00:28:34,-1,46,47
40,MAD,P005928,0 days 00:23:22,5,41,36
40,MAD,P003108,0 days 00:21:14,10,42,32
40,MAD,PTGB,0 days 00:20:53,-9,32,41
40,MAD,P004887,0 days 00:19:39,14,41,27
40,MAD,PBMT,0 days 00:18:38,-5,24,29
40,MAD,P006540,0 days 00:18:36,11,34,23
40,MAD,PCVM,0 days 00:16:41,-4,24,28
40,MAD,P005791,0 days 00:16:38,-20,17,37
40,MAD,P009213,0 days 00:08:33,12,18,6
40,MAD,P003733,0 days 00:07:12,-8,6,14
40,BAR,P004866,0 days 00:28:42,7,53,46
40,BAR,P003478,0 days 00:27:02,6,49,43
40,BAR,P002939,0 days 00:26:06,8,43,35
40,BAR,P000925,0 days 00:24:18,13,46,33
40,BAR,P007519,0 days 00:22:21,1,41,40
40,BAR,P011244,0 days 00:18:18,-2,28,30
40,BAR,P003196,0 days 00:15:38,-11,18,29
40,BAR,P007464,0 days 00:13:50,-10,13,23
40,BAR,P009992,0 days 00:13:23,-8,18,26
40,BAR,P012745,0 days 00:10:18,-6,11,17
40,BAR,P010641,0 days 00:00:04,-3,0,3
41,MCO,P011212,0 days 00:25:48,12,66,54
41,MCO,P011226,0 days 00:25:31,28,68,40
41,MCO,P010588,0 days 00:24:29,27,64,37
41,MCO,P005985,0 days 00:21:23,24,58,34
41,MCO,P004790,0 days 00:17:53,1,47,46
41,MCO,PLCZ,0 days 00:17:41,21,46,25
41,MCO,P012709,0 days 00:17:03,8,51,43
41,MCO,P004197,0 days 00:14:21,17,38,21
41,MCO,P011231,0 days 00:12:28,4,37,33
41,MCO,P011196,0 days 00:11:22,4,34,30
41,MCO,P002581,0 days 00:06:21,-3,13,16
41,MCO,P012515,0 days 00:05:40,-3,13,16
41,TEL,P009622,0 days 00:24:45,-22,38,60
41,TEL,P011199,0 days 00:22:28,-9,46,55
41,TEL,P011193,0 days 00:21:14,-10,53,63
41,TEL,P009783,0 days 00:19:39,-29,25,54
41,TEL,P011219,0 days 00:19:24,-20,38,58
41,TEL,P007990,0 days 00:18:58,-10,36,46
41,TEL,P011971,0 days 00:16:59,-3,43,46
41,TEL,P012744,0 days 00:16:57,-12,39,51
41,TEL,P011214,0 days 00:13:41,-22,16,38
41,TEL,P005145,0 days 00:10:18,-6,19,25
41,TEL,P004233,0 days 00:09:16,0,26,26
41,TEL,P011433,0 days 00:06:21,3,16,13
42,ASV,P011225,0 days 00:29:03,7,66,59
42,ASV,P012729,0 days 00:25:45,-4,55,59
42,ASV,P004194,0 days 00:24:28,7,53,46
42,ASV,P006568,0 days 00:24:25,3,53,50
42,ASV,PKIR,0 days 00:21:43,1,44,43
42,ASV,P012732,0 days 00:21:17,3,47,44
42,ASV,P002100,0 days 00:17:26,-6,35,41
42,ASV,P011386,0 days 00:10:56,-10,18,28
42,ASV,P003526,0 days 00:09:27,-8,16,24
42,ASV,P012730,0 days 00:07:50,-11,14,25
42,ASV,P000229,0 days 00:04:03,4,8,4
42,ASV,P003274,0 days 00:03:37,-1,11,12
42,VIR,P001133,0 days 00:34:18,11,79,68
42,VIR,P009549,0 days 00:29:58,12,72,60
42,VIR,P001844,0 days 00:24:10,0,52,52
42,VIR,PBCN,0 days 00:23:59,6,59,53
42,VIR,P008847,0 days 00:20:48,6,47,41
42,VIR,P003048,0 days 00:16:40,0,40,40
42,VIR,P006739,0 days 00:16:01,3,35,32
42,VIR,P004007,0 days 00:12:12,-7,20,27
42,VIR,P010781,0 days 00:11:05,-2,21,23
42,VIR,P012714,0 days 00:05:27,-6,6,12
42,VIR,P011192,0 days 00:02:46,-3,2,5
42,VIR,P003527,0 days 00:02:36,-5,2,7
43,MUN,P006760,0 days 00:27:35,-2,43,45
43,MUN,P010391,0 days 00:26:00,-9,48,57
43,MUN,P007056,0 days 00:24:15,3,37,34
43,MUN,P007975,0 days 00:22:42,-10,38,48
43,MUN,P003583,0 days 00:19:55,-5,31,36
43,MUN,P008985,0 days 00:19:51,8,37,29
43,MUN,P004508,0 days 00:18:11,5,31,26
43,MUN,P011987,0 days 00:17:23,-17,29,46
43,MUN,P011941,0 days 00:16:06,-4,31,35
43,MUN,P001557,0 days 00:04:38,-9,8,17
43,MUN,P006245,0 days 00:03:24,-5,2,7
43,ULK,P008962,0 days 00:31:44,1,54,53
43,ULK,P004004,0 days 00:29:04,2,48,46
43,ULK,P006661,0 days 00:23:56,15,53,38
43,ULK,P010560,0 days 00:21:06,-9,31,40
43,ULK,P011157,0 days 00:20:18,-3,31,34
43,ULK,P005844,0 days 00:19:42,12,45,33
43,ULK,P001932,0 days 00:19:33,-5,29,34
43,ULK,P009849,0 days 00:16:00,12,38,26
43,ULK,P006961,0 days 00:09:53,7,25,18
43,ULK,P011980,0 days 00:08:44,13,26,13
44,PAN,P002328,0 days 00:31:04,17,74,57
44,PAN,P007866,0 days 00:29:19,12,76,64
44,PAN,P003842,0 days 00:28:26,19,77,58
44,PAN,P011204,0 days 00:28:23,24,75,51
44,PAN,P001926,0 days 00:25:49,0,56,56
44,PAN,P011826,0 days 00:19:52,15,55,40
44,PAN,P012712,0 days 00:13:30,0,26,26
44,PAN,P007947,0 days 00:10:34,-9,17,26
44,PAN,P011221,0 days 00:06:47,-4,11,15
44,PAN,P007553,0 days 00:04:47,-1,7,8
44,PAN,P011209,0 days 00:01:29,-3,1,4
44,BAS,P007230,0 days 00:29:22,-12,55,67
44,BAS,P004603,0 days 00:29:09,-17,55,72
44,BAS,P011948,0 days 00:29:08,-5,61,66
44,BAS,P009048,0 days 00:27:59,-8,60,68
44,BAS,P004761,0 days 00:22:54,-9,47,56
44,BAS,P008850,0 days 00:22:10,-11,45,56
44,BAS,P011064,0 days 00:21:51,-8,45,53
44,BAS,P010444,0 days 00:17:27,0,37,37
45,ZAL,P007109,0 days 00:26:24,-9,49,58
45,ZAL,P011218,0 days 00:26:07,-3,47,50
45,ZAL,P002676,0 days 00:24:04,-11,44,55
45,ZAL,P002329,0 days 00:22:15,-17,34,51
45,ZAL,P012715,0 days 00:19:54,-12,34,46
45,ZAL,P010390,0 days 00:18:40,-3,37,40
45,ZAL,P003211,0 days 00:18:29,1,39,38
45,ZAL,P005504,0 days 00:11:27,-4,19,23
45,ZAL,P003210,0 days 00:11:11,-4,21,25
45,ZAL,P011965,0 days 00:10:20,-14,17,31
45,ZAL,P007513,0 days 00:09:39,-2,16,18
45,ZAL,P010184,0 days 00:01:30,3,3,0
45,PAM,P007870,0 days 00:23:15,-3,43,46
45,PAM,P010568,0 days 00:23:09,1,43,42
45,PAM,P012740,0 days 00:22:51,3,44,41
45,PAM,P004863,0 days 00:19:33,13,48,35
45,PAM,P000556,0 days 00:17:55,4,33,29
45,PAM,P011982,0 days 00:16:50,11,42,31
45,PAM,P012739,0 days 00:16:41,18,44,26
45,PAM,P003960,0 days 00:16:05,-7,26,33
45,PAM,P012738,0 days 00:15:45,21,46,25
45,PAM,P011970,0 days 00:13:53,16,38,22
45,PAM,P010393,0 days 00:08:10,1,15,14
45,PAM,P006643,0 days 00:05:53,-3,13,16
46,MIL,P007831,0 days 00:30:34,-5,51,56
46,MIL,P006509,0 days 00:29:53,-8,50,58
46,MIL,P000796,0 days 00:28:58,2,47,45
46,MIL,P007032,0 days 00:23:33,1,41,40
46,MIL,P011205,0 days 00:20:29,-8,29,37
46,MIL,P009960,0 days 00:19:04,-2,32,34
46,MIL,P002849,0 days 00:18:08,1,32,31
46,MIL,P005670,0 days 00:10:58,-3,18,21
46,MIL,P007201,0 days 00:10:03,-4,19,23
46,MIL,P002812,0 days 00:04:56,-6,5,11
46,MIL,P001518,0 days 00:03:24,2,6,4
46,MCO,P005985,0 days 00:31:19,2,56,54
46,MCO,P011226,0 days 00:30:33,11,60,49
46,MCO,P011212,0 days 00:29:31,2,51,49
46,MCO,P011231,0 days 00:21:13,-1,32,33
46,MCO,P010588,0 days 00:20:03,-6,34,40
46,MCO,P009754,0 days 00:19:30,12,42,30
46,MCO,PLCZ,0 days 00:18:50,-8,22,30
46,MCO,P011196,0 days 00:13:33,8,31,23
46,MCO,P002581,0 days 00:06:05,1,12,11
46,MCO,P008099,0 days 00:05:04,4,10,6
46,MCO,P004790,0 days 00:04:19,5,10,5
47,RED,P006436,0 days 00:27:36,18,58,40
47,RED,PJDR,0 days 00:26:59,21,62,41
47,RED,P009035,0 days 00:26:17,-13,44,57
47,RED,P002553,0 days 00:24:01,-10,36,46
47,RED,P011224,0 days 00:21:18,-14,34,48
47,RED,P007960,0 days 00:20:16,10,42,32
47,RED,P012044,0 days 00:18:12,14,36,22
47,RED,P005099,0 days 00:15:43,-13,22,35
47,RED,P008966,0 days 00:13:35,16,27,11
47,RED,P012711,0 days 00:05:38,1,9,8
47,RED,P004720,0 days 00:00:25,0,0,0
47,MUN,P003583,0 days 00:32:26,6,63,57
47,MUN,P007056,0 days 00:29:59,7,59,52
47,MUN,P006760,0 days 00:26:57,-7,43,50
47,MUN,P011987,0 days 00:25:54,4,48,44
47,MUN,P007975,0 days 00:24:06,-7,36,43
47,MUN,P010391,0 days 00:16:14,-16,25,41
47,MUN,P008985,0 days 00:15:06,9,31,22
47,MUN,P004508,0 days 00:13:20,-13,17,30
47,MUN,P011941,0 days 00:07:15,-10,5,15
47,MUN,P005460,0 days 00:05:19,-3,8,11
47,MUN,P001557,0 days 00:03:24,0,5,5
48,TEL,P009622,0 days 00:33:34,-7,64,71
48,TEL,P009863,0 days 00:26:31,-28,40,68
48,TEL,P011199,0 days 00:23:40,-11,39,50
48,TEL,P009783,0 days 00:23:39,-15,41,56
48,TEL,P012744,0 days 00:18:54,-20,30,50
48,TEL,P011971,0 days 00:18:18,-9,38,47
48,TEL,P011214,0 days 00:16:20,-14,32,46
48,TEL,P011193,0 days 00:13:35,-11,28,39
48,TEL,P005145,0 days 00:09:39,-8,17,25
48,TEL,P011219,0 days 00:07:16,-10,12,22
48,TEL,P004233,0 days 00:05:57,-11,5,16
48,TEL,P011433,0 days 00:02:37,-1,4,5
48,MAD,P009005,0 days 00:26:17,20,67,47
48,MAD,P005928,0 days 00:26:02,17,67,50
48,MAD,P003108,0 days 00:22:42,12,57,45
48,MAD,P006540,0 days 00:20:54,21,56,35
48,MAD,P005791,0 days 00:20:28,14,46,32
48,MAD,P003733,0 days 00:17:11,9,38,29
48,MAD,P004887,0 days 00:15:54,17,45,28
48,MAD,PBMT,0 days 00:15:28,14,40,26
48,MAD,PCVM,0 days 00:13:58,12,32,20
48,MAD,P009213,0 days 00:13:30,10,33,23
48,MAD,PTGB,0 days 00:03:51,-3,7,10
48,MAD,P011649,0 days 00:03:45,2,7,5
49,ZAL,P011218,0 days 00:28:53,-10,59,69
49,ZAL,P002329,0 days 00:27:07,-1,54,55
49,ZAL,P003211,0 days 00:24:26,-2,53,55
49,ZAL,P010390,0 days 00:21:32,14,54,40
49,ZAL,P007109,0 days 00:20:30,3,48,45
49,ZAL,P002676,0 days 00:18:15,-10,30,40
49,ZAL,P012715,0 days 00:15:23,-8,34,42
49,ZAL,P003210,0 days 00:15:10,17,46,29
49,ZAL,P005504,0 days 00:13:45,-6,32,38
49,ZAL,P011965,0 days 00:08:02,-7,18,25
49,ZAL,P007513,0 days 00:06:57,-5,12,17
49,ASV,P004194,0 days 00:34:14,-1,73,74
49,ASV,P012729,0 days 00:26:27,17,66,49
49,ASV,P012080,0 days 00:25:59,14,60,46
49,ASV,P002100,0 days 00:22:22,9,60,51
49,ASV,P011225,0 days 00:20:14,-12,45,57
49,ASV,P006568,0 days 00:19:19,-10,43,53
49,ASV,PKIR,0 days 00:18:55,19,46,27
49,ASV,P012732,0 days 00:15:07,-3,29,32
49,ASV,P003526,0 days 00:09:54,-12,18,30
49,ASV,P000229,0 days 00:04:07,-2,9,11
49,ASV,P012731,0 days 00:03:22,-4,6,10
50,ULK,P008962,0 days 00:40:00,2,79,77
50,ULK,P006661,0 days 00:24:54,-6,46,52
50,ULK,P005844,0 days 00:24:21,1,48,47
50,ULK,P009849,0 days 00:22:34,-7,40,47
50,ULK,P004004,0 days 00:20:30,7,44,37
50,ULK,P001932,0 days 00:19:51,2,38,36
50,ULK,P011157,0 days 00:15:39,1,31,30
50,ULK,P011052,0 days 00:12:37,2,29,27
50,ULK,P011980,0 days 00:11:14,-6,13,19
50,ULK,P010560,0 days 00:08:20,14,27,13
50,OLY,P001255,0 days 00:35:04,-7,66,73
50,OLY,P008829,0 days 00:31:58,5,68,63
50,OLY,P010612,0 days 00:29:36,-2,58,60
50,OLY,P007982,0 days 00:23:48,-4,42,46
50,OLY,P008855,0 days 00:23:08,3,51,48
50,OLY,P008811,0 days 00:20:28,1,39,38
50,OLY,P003941,0 days 00:19:32,-3,38,41
50,OLY,P011983,0 days 00:11:51,-1,18,19
50,OLY,P010392,0 days 00:04:35,-2,5,7
51,BAR,P012745,0 days 00:26:09,12,58,46
51,BAR,P004866,0 days 00:25:08,11,57,46
51,BAR,P009992,0 days 00:24:23,5,51,46
51,BAR,P003204,0 days 00:20:56,-8,35,43
51,BAR,P002939,0 days 00:19:21,18,45,27
51,BAR,P000925,0 days 00:16:59,23,42,19
51,BAR,P003196,0 days 00:15:36,0,31,31
51,BAR,P007464,0 days 00:14:52,-3,23,26
51,BAR,P003478,0 days 00:14:03,6,27,21
51,BAR,P011244,0 days 00:13:46,-3,22,25
51,BAR,P010641,0 days 00:07:25,-15,7,22
51,BAR,P011666,0 days 00:01:22,-6,2,8
51,PAN,P011204,0 days 00:32:04,-19,53,72
51,PAN,P007866,0 days 00:30:31,-10,47,57
51,PAN,P002328,0 days 00:24:34,-20,37,57
51,PAN,P011826,0 days 00:19:47,1,32,31
51,PAN,P003842,0 days 00:18:53,-11,31,42
51,PAN,P012712,0 days 00:18:23,-11,31,42
51,PAN,P007553,0 days 00:17:07,11,39,28
51,PAN,P011209,0 days 00:14:53,-16,25,41
51,PAN,P008084,0 days 00:11:52,12,29,17
51,PAN,P006544,0 days 00:10:34,17,28,11
51,PAN,P011442,0 days 00:01:22,6,8,2
52,BAS,P007230,0 days 00:31:26,-3,64,67
52,BAS,P004761,0 days 00:30:06,5,60,55
52,BAS,P009048,0 days 00:29:55,3,66,63
52,BAS,P011948,0 days 00:24:24,4,55,51
52,BAS,P004603,0 days 00:23:15,1,49,48
52,BAS,P012201,0 days 00:19:36,4,41,37
52,BAS,P010444,0 days 00:15:41,-1,31,32
52,BAS,P012765,0 days 00:14:01,1,30,29
52,BAS,P008850,0 days 00:11:36,-9,24,33
52,PAR,P007400,0 days 00:29:07,2,63,61
52,PAR,P012743,0 days 00:23:37,4,53,49
52,PAR,P008987,0 days 00:22:30,-3,51,54
52,PAR,P003983,0 days 00:22:01,-5,40,45
52,PAR,P007673,0 days 00:21:04,-1,45,46
52,PAR,P004058,0 days 00:20:44,1,45,44
52,PAR,P009212,0 days 00:18:44,0,35,35
52,PAR,P000956,0 days 00:18:07,2,38,36
52,PAR,P011051,0 days 00:15:09,-3,27,30
52,PAR,P012742,0 days 00:08:57,-2,18,20
53,PAM,P011982,0 days 00:24:42,13,52,39
53,PAM,P010568,0 days 00:23:38,16,51,35
53,PAM,P003960,0 days 00:21:43,6,44,38
53,PAM,P011970,0 days 00:20:13,13,46,33
53,PAM,P007870,0 days 00:18:16,11,45,34
53,PAM,P012740,0 days 00:17:34,-6,29,35
53,PAM,P012738,0 days 00:16:02,-5,24,29
53,PAM,P012739,0 days 00:15:24,-2,24,26
53,PAM,P004863,0 days 00:14:28,0,27,27
53,PAM,P006643,0 days 00:13:43,-4,23,27
53,PAM,P010393,0 days 00:08:05,-1,16,17
53,PAM,P009101,0 days 00:06:12,-1,14,15
53,BER,P003958,0 days 00:30:28,-12,50,62
53,BER,P012720,0 days 00:26:48,-8,45,53
53,BER,P006919,0 days 00:25:09,-11,39,50
53,BER,P008173,0 days 00:21:26,-4,37,41
53,BER,P008967,0 days 00:21:11,-6,42,48
53,BER,P008211,0 days 00:18:34,-4,34,38
53,BER,P006251,0 days 00:15:43,3,33,30
53,BER,P008384,0 days 00:12:51,0,25,25
53,BER,P012721,0 days 00:11:25,5,25,20
53,BER,P010791,0 days 00:11:18,-4,16,20
53,BER,P006819,0 days 00:05:07,1,9,8
54,VIR,P001133,0 days 00:31:11,12,74,62
54,VIR,P006739,0 days 00:28:12,21,75,54
54,VIR,P009549,0 days 00:26:11,19,64,45
54,VIR,P003048,0 days 00:20:45,3,48,45
54,VIR,PBCN,0 days 00:19:23,9,53,44
54,VIR,P011192,0 days 00:17:50,1,41,40
54,VIR,P004007,0 days 00:17:10,3,34,31
54,VIR,P008847,0 days 00:16:47,6,41,35
54,VIR,P010781,0 days 00:11:58,-7,20,27
54,VIR,P003527,0 days 00:05:21,-13,4,17
54,VIR,P012714,0 days 00:05:12,6,11,5
54,IST,P006590,0 days 00:33:46,-8,70,78
54,IST,P007200,0 days 00:32:13,-11,65,76
54,IST,P011078,0 days 00:25:36,-4,51,55
54,IST,P004888,0 days 00:25:16,-12,53,65
54,IST,P011981,0 days 00:23:06,-11,44,55
54,IST,P009664,0 days 00:22:49,-8,41,49
54,IST,P009846,0 days 00:19:51,-5,44,49
54,IST,P004554,0 days 00:17:23,-1,37,38
55,IST,P004888,0 days 00:40:25,10,82,72
55,IST,P009664,0 days 00:39:39,-6,69,75
55,IST,P007200,0 days 00:34:04,-4,66,70
55,IST,P011078,0 days 00:33:40,15,71,56
55,IST,P006590,0 days 00:24:14,7,45,38
55,IST,P004554,0 days 00:22:50,3,47,44
55,IST,P011981,0 days 00:22:10,1,39,38
55,IST,P006372,0 days 00:04:35,-6,4,10
55,IST,P012710,0 days 00:02:49,0,7,7
55,IST,P009513,0 days 00:00:34,0,0,0
55,ZAL,P002329,0 days 00:33:45,6,69,63
55,ZAL,P010390,0 days 00:31:42,4,63,59
55,ZAL,P007109,0 days 00:30:44,-1,52,53
55,ZAL,P011218,0 days 00:29:49,12,63,51
55,ZAL,P003211,0 days 00:27:19,0,55,55
55,ZAL,P002676,0 days 00:18:30,-14,31,45
55,ZAL,P007513,0 days 00:18:02,0,24,24
55,ZAL,P012715,0 days 00:17:12,-2,34,36
55,ZAL,P005504,0 days 00:07:59,-2,12,14
55,ZAL,P011965,0 days 00:05:19,-13,5,18
55,ZAL,P003210,0 days 00:04:39,-10,2,12
56,MIL,P007032,0 days 00:23:08,11,45,34
56,MIL,P009960,0 days 00:21:47,19,48,29
56,MIL,P000796,0 days 00:20:55,14,44,30
56,MIL,P002849,0 days 00:19:57,16,44,28
56,MIL,P011205,0 days 00:19:08,13,37,24
56,MIL,P007831,0 days 00:18:47,11,38,27
56,MIL,P005670,0 days 00:16:52,20,38,18
56,MIL,P007201,0 days 00:16:10,15,31,16
56,MIL,P006509,0 days 00:15:08,18,34,16
56,MIL,P002812,0 days 00:14:00,9,27,18
56,MIL,P001518,0 days 00:07:39,5,16,11
56,MIL,P006701,0 days 00:06:29,4,13,9
56,PAM,P007870,0 days 00:25:25,-15,37,52
56,PAM,P005356,0 days 00:24:08,-29,30,59
56,PAM,P011970,0 days 00:21:04,-16,29,45
56,PAM,P006643,0 days 00:21:03,-16,25,41
56,PAM,P012738,0 days 00:18:06,-18,19,37
56,PAM,P011982,0 days 00:18:03,-10,26,36
56,PAM,P009101,0 days 00:17:55,-15,21,36
56,PAM,P003960,0 days 00:16:48,-1,27,28
56,PAM,P012740,0 days 00:12:56,-4,20,24
56,PAM,P010393,0 days 00:11:02,-7,16,23
56,PAM,P000556,0 days 00:09:17,-21,5,26
56,PAM,P004863,0 days 00:04:13,-3,5,8
57,TEL,P009783,0 days 00:33:18,5,80,75
57,TEL,P009622,0 days 00:30:28,8,71,63
57,TEL,P011199,0 days 00:26:49,8,65,57
57,TEL,P009863,0 days 00:25:25,0,58,58
57,TEL,P011193,0 days 00:16:10,5,41,36
57,TEL,P011971,0 days 00:14:20,9,37,28
57,TEL,P011214,0 days 00:13:34,-9,30,39
57,TEL,P007990,0 days 00:11:22,-7,21,28
57,TEL,P012744,0 days 00:09:46,3,26,23
57,TEL,P011219,0 days 00:09:38,-2,22,24
57,TEL,P005145,0 days 00:09:10,-5,14,19
57,MUN,P007056,0 days 00:26:39,-8,52,60
57,MUN,P003583,0 days 00:24:19,-7,50,57
57,MUN,P004508,0 days 00:24:01,-5,50,55
57,MUN,P006760,0 days 00:23:17,8,50,42
57,MUN,P010391,0 days 00:23:16,-4,44,48
57,MUN,P011987,0 days 00:18:26,2,50,48
57,MUN,P008985,0 days 00:16:35,-5,41,46
57,MUN,P001557,0 days 00:13:29,0,34,34
57,MUN,P007975,0 days 00:12:54,3,34,31
57,MUN,P007639,0 days 00:09:12,2,26,24
57,MUN,P005460,0 days 00:04:06,-2,11,13
57,MUN,P011941,0 days 00:03:46,1,8,7
58,PAR,P008987,0 days 00:32:06,5,68,63
58,PAR,P007400,0 days 00:27:05,2,52,50
58,PAR,P012742,0 days 00:24:58,6,53,47
58,PAR,P011051,0 days 00:20:36,2,40,38
58,PAR,P000956,0 days 00:19:43,12,49,37
58,PAR,P012743,0 days 00:19:22,-1,45,46
58,PAR,P007673,0 days 00:15:38,-10,32,42
58,PAR,P004058,0 days 00:14:21,-8,30,38
58,PAR,P003983,0 days 00:13:06,-3,26,29
58,PAR,P009212,0 days 00:07:52,-4,17,21
58,PAR,P004172,0 days 00:05:13,4,13,9
58,ULK,P008962,0 days 00:39:58,-1,84,85
58,ULK,P009849,0 days 00:28:16,4,61,57
58,ULK,P011052,0 days 00:27:45,-5,48,53
58,ULK,P005844,0 days 00:25:58,-12,47,59
58,ULK,P006661,0 days 00:25:54,-8,55,63
58,ULK,P011980,0 days 00:20:15,10,53,43
58,ULK,P006961,0 days 00:18:31,-3,39,42
58,ULK,P011157,0 days 00:13:04,12,33,21
58,ULK,P011201,0 days 00:00:13,-2,0,2
58,ULK,P002969,0 days 00:00:06,0,0,0
59,MAD,P005928,0 days 00:28:29,27,87,60
59,MAD,P005791,0 days 00:24:59,22,68,46
59,MAD,P010357,0 days 00:23:18,3,45,42
59,MAD,P006540,0 days 00:18:20,14,51,37
59,MAD,P001392,0 days 00:18:04,4,44,40
59,MAD,PTGB,0 days 00:16:55,1,29,28
59,MAD,P009005,0 days 00:16:10,23,53,30
59,MAD,P004887,0 days 00:15:01,4,32,28
59,MAD,P003108,0 days 00:14:32,6,34,28
59,MAD,PBMT,0 days 00:12:41,27,44,17
59,MAD,PCVM,0 days 00:11:31,-1,13,14
59,VIR,P001133,0 days 00:30:45,-29,53,82
59,VIR,P006739,0 days 00:26:33,-25,47,72
59,VIR,P008847,0 days 00:25:06,1,51,50
59,VIR,PBCN,0 days 00:23:51,-20,46,66
59,VIR,P003048,0 days 00:23:45,-19,44,63
59,VIR,P009549,0 days 00:18:09,-10,36,46
59,VIR,P004007,0 days 00:15:05,-4,28,32
59,VIR,P001844,0 days 00:13:27,-1,27,28
59,VIR,P011192,0 days 00:11:18,-8,21,29
59,VIR,P010781,0 days 00:10:33,-8,17,25
59,VIR,P003527,0 days 00:01:28,-7,0,7
60,OLY,P008811,0 days 00:36:59,4,68,64
60,OLY,P010612,0 days 00:32:10,15,68,53
60,OLY,P008829,0 days 00:31:37,6,66,60
60,OLY,P001255,0 days 00:28:50,9,60,51
60,OLY,P007982,0 days 00:22:42,-10,35,45
60,OLY,P010392,0 days 00:16:17,-6,22,28
60,OLY,P008855,0 days 00:16:13,14,39,25
60,OLY,P011983,0 days 00:09:14,-23,6,29
60,OLY,P003941,0 days 00:03:01,-5,6,11
60,OLY,P006302,0 days 00:02:57,-9,0,9
60,BAS,P007230,0 days 00:34:51,8,64,56
60,BAS,P012201,0 days 00:27:35,19,60,41
60,BAS,P011948,0 days 00:24:04,-12,41,53
60,BAS,P010444,0 days 00:22:44,-13,29,42
60,BAS,P009048,0 days 00:21:53,-3,36,39
60,BAS,P004761,0 days 00:21:52,9,43,34
60,BAS,P012765,0 days 00:18:07,4,39,35
60,BAS,P004603,0 days 00:16:47,10,42,32
60,BAS,P008850,0 days 00:12:07,-17,21,38
61,BER,P012720,0 days 00:26:58,-12,50,62
61,BER,P003958,0 days 00:25:43,-10,52,62
61,BER,P008384,0 days 00:25:12,0,60,60
61,BER,P006919,0 days 00:19:56,-3,38,41
61,BER,P008967,0 days 00:19:49,-12,40,52
61,BER,P008211,0 days 00:19:26,-6,43,49
61,BER,P011934,0 days 00:16:02,-11,34,45
61,BER,P010791,0 days 00:15:12,-5,31,36
61,BER,P006251,0 days 00:14:31,1,35,34
61,BER,P007550,0 days 00:09:17,-7,22,29
61,BER,P012721,0 days 00:04:42,0,13,13
61,BER,P007025,0 days 00:03:12,-5,7,12
61,PAN,P007866,0 days 00:36:06,12,85,73
61,PAN,P002328,0 days 00:34:15,10,80,70
61,PAN,P001926,0 days 00:30:47,22,78,56
61,PAN,P011204,0 days 00:29:47,13,74,61
61,PAN,P003842,0 days 00:22:50,-2,45,47
61,PAN,P007553,0 days 00:17:28,10,53,43
61,PAN,P007947,0 days 00:17:08,10,51,41
61,PAN,P012774,0 days 00:07:45,-7,15,22
61,PAN,P008084,0 days 00:03:54,2,14,12
62,MCO,P005985,0 days 00:27:40,0,53,53
62,MCO,P011226,0 days 00:27:16,8,52,44
62,MCO,P009754,0 days 00:25:28,21,60,39
62,MCO,P010588,0 days 00:23:18,9,53,44
62,MCO,P011212,0 days 00:21:44,0,37,37
62,MCO,P011231,0 days 00:20:27,9,39,30
62,MCO,P011196,0 days 00:19:37,11,40,29
62,MCO,P004197,0 days 00:11:58,-2,24,26
62,MCO,PLCZ,0 days 00:11:49,-7,18,25
62,MCO,P012709,0 days 00:05:54,3,14,11
62,MCO,P002581,0 days 00:04:49,-2,10,12
62,ASV,P012080,0 days 00:34:30,-9,64,73
62,ASV,P004194,0 days 00:32:38,0,65,65
62,ASV,P011225,0 days 00:30:44,-3,58,61
62,ASV,P002100,0 days 00:24:07,-4,41,45
62,ASV,P012729,0 days 00:21:15,-7,34,41
62,ASV,P003526,0 days 00:18:57,-5,32,37
62,ASV,P006568,0 days 00:18:45,-3,36,39
62,ASV,P012730,0 days 00:07:22,-10,5,15
62,ASV,PKIR,0 days 00:07:12,-6,6,12
62,ASV,P011386,0 days 00:04:30,-3,9,12
63,BAR,P004866,0 days 00:26:58,7,61,54
63,BAR,P002939,0 days 00:26:31,4,54,50
63,BAR,P012745,0 days 00:22:41,13,55,42
63,BAR,P000925,0 days 00:22:22,2,43,41
63,BAR,P007519,0 days 00:21:32,1,45,44
63,BAR,P003478,0 days 00:20:57,0,45,45
63,BAR,P006435,0 days 00:18:02,4,41,37
63,BAR,P003196,0 days 00:17:38,3,43,40
63,BAR,P011244,0 days 00:17:19,-8,31,39
63,BAR,P009992,0 days 00:06:00,-1,12,13
63,RED,P002553,0 days 00:31:31,-19,54,73
63,RED,P009035,0 days 00:26:22,0,51,51
63,RED,P011224,0 days 00:25:02,-16,43,59
63,RED,P000848,0 days 00:23:49,-3,45,48
63,RED,PJDR,0 days 00:23:23,5,57,52
63,RED,P007960,0 days 00:23:05,2,44,42
63,RED,P006436,0 days 00:21:07,2,53,51
63,RED,P008966,0 days 00:10:12,1,22,21
63,RED,P012044,0 days 00:08:45,4,20,16
63,RED,P011964,0 days 00:03:53,5,11,6
63,RED,P003479,0 days 00:02:51,-6,5,11
64,MCO,P010588,0 days 00:33:03,-5,71,76
64,MCO,P005985,0 days 00:31:36,-9,68,77
64,MCO,P009754,0 days 00:31:00,-5,65,70
64,MCO,P011226,0 days 00:24:25,-14,45,59
64,MCO,P011212,0 days 00:19:28,7,35,28
64,MCO,PLCZ,0 days 00:18:59,-9,45,54
64,MCO,P011231,0 days 00:16:30,1,30,29
64,MCO,P011196,0 days 00:07:33,-4,11,15
64,MCO,P004197,0 days 00:07:29,-1,20,21
64,MCO,P012709,0 days 00:05:34,-1,9,10
64,MCO,P004790,0 days 00:04:23,5,11,6
64,IST,P007200,0 days 00:35:39,12,85,73
64,IST,P011078,0 days 00:32:32,16,75,59
64,IST,P006590,0 days 00:30:51,-1,66,67
64,IST,P009664,0 days 00:29:07,2,66,64
64,IST,P004554,0 days 00:22:47,16,66,50
64,IST,P004888,0 days 00:21:58,-1,43,44
64,IST,P006372,0 days 00:10:01,-2,15,17
64,IST,P011981,0 days 00:07:33,-6,9,15
64,IST,PLHK,0 days 00:06:04,1,11,10
64,IST,P009513,0 days 00:03:28,-2,9,11
65,RED,P012044,0 days 00:25:47,11,49,38
65,RED,P006436,0 days 00:25:28,14,55,41
65,RED,P000848,0 days 00:24:44,17,56,39
65,RED,P002553,0 days 00:21:22,10,37,27
65,RED,PJDR,0 days 00:19:46,28,47,19
65,RED,P004720,0 days 00:19:14,20,43,23
65,RED,P007960,0 days 00:18:40,19,48,29
65,RED,P008966,0 days 00:18:03,23,40,17
65,RED,P009035,0 days 00:16:29,6,32,26
65,RED,P003479,0 days 00:05:28,2,15,13
65,RED,P011964,0 days 00:03:51,1,9,8
65,RED,P011224,0 days 00:01:08,4,4,0
65,ULK,P008962,0 days 00:27:45,-21,40,61
65,ULK,P011052,0 days 00:25:01,-11,42,53
65,ULK,P006661,0 days 00:23:51,-17,31,48
65,ULK,P005844,0 days 00:22:24,-26,28,54
65,ULK,P009849,0 days 00:22:18,-20,27,47
65,ULK,P011157,0 days 00:22:00,-10,30,40
65,ULK,P011980,0 days 00:20:01,-11,29,40
65,ULK,P006961,0 days 00:15:27,-17,22,39
65,ULK,P011201,0 days 00:13:54,-15,19,34
65,ULK,P002969,0 days 00:07:19,-7,12,19
66,TEL,P009783,0 days 00:32:02,-8,54,62
66,TEL,P009622,0 days 00:31:22,-6,51,57
66,TEL,P011193,0 days 00:26:06,-7,50,57
66,TEL,P011199,0 days 00:21:17,-2,31,33
66,TEL,P007990,0 days 00:17:05,2,30,28
66,TEL,P011971,0 days 00:16:45,0,26,26
66,TEL,P011214,0 days 00:16:10,3,36,33
66,TEL,P011219,0 days 00:14:48,-4,30,34
66,TEL,P012744,0 days 00:12:36,-6,26,32
66,TEL,P004233,0 days 00:08:17,4,25,21
66,TEL,P005145,0 days 00:03:32,-1,11,12
66,OLY,P008811,0 days 00:35:00,5,64,59
66,OLY,P008855,0 days 00:33:15,0,57,57
66,OLY,P001255,0 days 00:26:21,-3,40,43
66,OLY,P008829,0 days 00:23:32,10,55,45
66,OLY,P010612,0 days 00:22:11,2,46,44
66,OLY,P010392,0 days 00:14:48,9,30,21
66,OLY,P011983,0 days 00:14:45,-5,32,37
66,OLY,P006302,0 days 00:12:56,8,30,22
66,OLY,P006589,0 days 00:10:39,-3,22,25
66,OLY,P007982,0 days 00:06:33,2,19,17
67,PAM,P007870,0 days 00:28:38,-4,57,61
67,PAM,P010568,0 days 00:27:27,-10,50,60
67,PAM,P003960,0 days 00:25:23,-9,47,56
67,PAM,P005356,0 days 00:21:46,-11,41,52
67,PAM,P011982,0 days 00:19:40,0,31,31
67,PAM,P004863,0 days 00:16:10,11,31,20
67,PAM,P000556,0 days 00:13:25,-11,25,36
67,PAM,P012740,0 days 00:12:34,5,21,16
67,PAM,P012738,0 days 00:11:35,6,19,13
67,PAM,P012739,0 days 00:11:24,2,17,15
67,PAM,P006643,0 days 00:09:09,8,21,13
67,PAM,P010393,0 days 00:02:49,-2,5,7
67,MAD,P005928,0 days 00:29:51,12,64,52
67,MAD,P005791,0 days 00:29:10,8,59,51
67,MAD,P009005,0 days 00:23:00,5,47,42
67,MAD,P003108,0 days 00:20:28,-7,31,38
67,MAD,P010357,0 days 00:18:53,0,38,38
67,MAD,P006540,0 days 00:17:20,8,41,33
67,MAD,PTGB,0 days 00:14:40,6,27,21
67,MAD,PCVM,0 days 00:11:33,-6,15,21
67,MAD,P004887,0 days 00:10:50,-5,17,22
67,MAD,PBMT,0 days 00:09:32,-2,19,21
67,MAD,P001392,0 days 00:08:57,6,17,11
67,MAD,P003733,0 days 00:05:46,-10,5,15
68,VIR,P001133,0 days 00:28:23,3,64,61
68,VIR,P003048,0 days 00:24:22,-10,48,58
68,VIR,P001844,0 days 00:24:15,-9,53,62
68,VIR,P003527,0 days 00:21:44,22,48,26
68,VIR,P009549,0 days 00:21:23,-5,48,53
68,VIR,P004007,0 days 00:20:36,16,44,28
68,VIR,PBCN,0 days 00:17:45,-7,41,48
68,VIR,P010781,0 days 00:15:08,11,37,26
68,VIR,P006739,0 days 00:10:42,7,19,12
68,VIR,P011192,0 days 00:08:46,8,16,8
68,VIR,P012714,0 days 00:06:56,-1,12,13
68,MIL,P007831,0 days 00:31:51,4,74,70
68,MIL,P007032,0 days 00:30:17,1,68,67
68,MIL,P000796,0 days 00:29:33,3,67,64
68,MIL,P002849,0 days 00:24:28,8,63,55
68,MIL,P007201,0 days 00:21:24,3,50,47
68,MIL,P002812,0 days 00:15:04,-9,19,28
68,MIL,P006509,0 days 00:13:42,-17,15,32
68,MIL,P011205,0 days 00:11:47,-11,12,23
68,MIL,P005670,0 days 00:09:40,-8,11,19
68,MIL,P001518,0 days 00:07:24,-8,6,14
68,MIL,P009960,0 days 00:04:50,-1,10,11
69,BER,P003958,0 days 00:25:51,0,48,48
69,BER,P012720,0 days 00:25:04,2,48,46
69,BER,P006919,0 days 00:21:32,7,43,36
69,BER,P006251,0 days 00:19:26,-2,31,33
69,BER,P008211,0 days 00:17:52,6,32,26
69,BER,P011934,0 days 00:17:16,-11,29,40
69,BER,P008173,0 days 00:17:08,-14,26,40
69,BER,P008384,0 days 00:17:06,-6,23,29
69,BER,P008967,0 days 00:16:22,-15,22,37
69,BER,P010791,0 days 00:09:31,-3,14,17
69,BER,P012721,0 days 00:07:56,6,14,8
69,BER,P007550,0 days 00:04:56,5,10,5
69,ASV,P012080,0 days 00:34:18,8,66,58
69,ASV,P011225,0 days 00:30:30,6,53,47
69,ASV,P004194,0 days 00:27:21,-1,50,51
69,ASV,P006568,0 days 00:26:01,15,55,40
69,ASV,P003526,0 days 00:21:36,2,42,40
69,ASV,P012729,0 days 00:19:21,5,35,30
69,ASV,P002100,0 days 00:17:21,-10,27,37
69,ASV,PKIR,0 days 00:16:15,9,31,22
69,ASV,P012730,0 days 00:07:17,-9,6,15
70,MUN,P007056,0 days 00:28:24,0,67,67
70,MUN,P011987,0 days 00:27:17,7,67,60
70,MUN,P007975,0 days 00:27:01,-8,66,74
70,MUN,P010391,0 days 00:23:34,0,52,52
70,MUN,P001557,0 days 00:21:22,13,49,36
70,MUN,P008985,0 days 00:19:35,27,52,25
70,MUN,P003583,0 days 00:15:58,-3,30,33
70,MUN,P011941,0 days 00:14:40,7,38,31
70,MUN,P005478,0 days 00:11:36,9,27,18
70,MUN,P007639,0 days 00:06:01,-2,14,16
70,MUN,P012123,0 days 00:04:32,-5,8,13
70,PAR,P008987,0 days 00:35:15,-6,74,80
70,PAR,P007400,0 days 00:33:12,-3,71,74
70,PAR,P007673,0 days 00:26:49,-7,64,71
70,PAR,P012742,0 days 00:20:01,-1,46,47
70,PAR,P012096,0 days 00:19:51,-9,36,45
70,PAR,P012743,0 days 00:16:14,0,38,38
70,PAR,P004058,0 days 00:13:58,-3,30,33
70,PAR,P003983,0 days 00:11:37,-3,27,30
70,PAR,P000956,0 days 00:09:45,1,14,13
70,PAR,P011051,0 days 00:08:38,-3,22,25
70,PAR,P004172,0 days 00:04:40,-11,3,14
71,PAN,P007866,0 days 00:38:02,-2,66,68
71,PAN,P002328,0 days 00:35:05,8,67,59
71,PAN,P003842,0 days 00:29:53,7,59,52
71,PAN,P001926,0 days 00:29:20,6,59,53
71,PAN,P011204,0 days 00:28:29,8,52,44
71,PAN,P007947,0 days 00:15:08,-6,24,30
71,PAN,P007553,0 days 00:06:56,-3,14,17
71,PAN,P012774,0 days 00:05:50,-4,8,12
71,PAN,P008084,0 days 00:05:32,2,13,11
71,PAN,P011221,0 days 00:03:11,-2,0,2
71,PAN,P011826,0 days 00:01:21,-4,0,4
71,PAN,P011209,0 days 00:01:13,0,3,3
71,ZAL,P002676,0 days 00:33:02,-5,59,64
71,ZAL,P011218,0 days 00:31:09,-4,56,60
71,ZAL,P002329,0 days 00:26:43,3,50,47
71,ZAL,P003211,0 days 00:23:41,0,42,42
71,ZAL,P007109,0 days 00:20:19,-2,33,35
71,ZAL,P012715,0 days 00:19:01,3,37,34
71,ZAL,P010390,0 days 00:18:54,-7,27,34
71,ZAL,P005504,0 days 00:13:37,-1,24,25
71,ZAL,P011965,0 days 00:08:35,4,17,13
71,ZAL,P003210,0 days 00:04:59,-1,10,11
72,BAS,P007230,0 days 00:29:50,20,69,49
72,BAS,P003198,0 days 00:28:48,15,67,52
72,BAS,P009048,0 days 00:27:53,20,69,49
72,BAS,P012201,0 days 00:24:59,15,59,44
72,BAS,P011948,0 days 00:24:39,24,65,41
72,BAS,P010444,0 days 00:21:13,20,53,33
72,BAS,P004603,0 days 00:16:30,7,38,31
72,BAS,P012765,0 days 00:15:50,3,34,31
72,BAS,P008850,0 days 00:08:01,-5,13,18
72,BAS,P008072,0 days 00:02:17,-4,3,7
72,BAR,P002939,0 days 00:23:46,-13,44,57
72,BAR,P004866,0 days 00:22:23,-23,37,60
72,BAR,P007464,0 days 00:20:16,-16,34,50
72,BAR,P003196,0 days 00:20:07,-13,33,46
72,BAR,P006435,0 days 00:19:56,-6,41,47
72,BAR,P011244,0 days 00:16:50,-17,26,43
72,BAR,P007519,0 days 00:16:14,-10,27,37
72,BAR,P000925,0 days 00:16:12,-15,28,43
72,BAR,P012745,0 days 00:15:45,0,30,30
72,BAR,P003478,0 days 00:12:53,-1,24,25
72,BAR,P009992,0 days 00:11:57,-6,21,27
72,BAR,P010641,0 days 00:03:41,5,10,5
73,MIL,P007831,0 days 00:31:30,19,80,61
73,MIL,P002849,0 days 00:28:34,17,73,56
73,MIL,P000796,0 days 00:25:51,2,58,56
73,MIL,P006509,0 days 00:22:31,20,55,35
73,MIL,P007032,0 days 00:22:24,-6,48,54
73,MIL,P011205,0 days 00:21:06,13,47,34
73,MIL,P009960,0 days 00:18:44,13,40,27
73,MIL,P007201,0 days 00:15:48,-6,31,37
73,MIL,P001518,0 days 00:05:48,4,10,6
73,MIL,P002812,0 days 00:03:58,0,9,9
73,MIL,P005670,0 days 00:03:08,2,4,2
73,MIL,P006701,0 days 00:00:38,2,5,3
73,IST,P007200,0 days 00:35:35,-17,69,86
73,IST,P004888,0 days 00:34:50,-10,68,78
73,IST,P011078,0 days 00:34:48,-12,69,81
73,IST,P009664,0 days 00:29:00,-14,50,64
73,IST,P011981,0 days 00:17:44,-6,39,45
73,IST,P006590,0 days 00:17:00,-8,30,38
73,IST,P004554,0 days 00:16:04,-2,29,31
73,IST,P012710,0 days 00:08:04,-3,14,17
73,IST,P006372,0 days 00:06:55,-8,12,20
74,TEL,P009863,0 days 00:32:31,8,69,61
74,TEL,P009622,0 days 00:28:27,0,55,55
74,TEL,P009783,0 days 00:28:08,-1,50,51
74,TEL,P011214,0 days 00:23:15,10,54,44
74,TEL,P011971,0 days 00:17:45,4,36,32
74,TEL,P011193,0 days 00:17:14,1,32,31
74,TEL,P011219,0 days 00:16:34,6,36,30
74,TEL,P011199,0 days 00:15:38,-3,22,25
74,TEL,P012744,0 days 00:10:05,7,18,11
74,TEL,P005145,0 days 00:07:51,-4,18,22
74,TEL,P007990,0 days 00:02:32,-3,0,3
74,ULK,P008962,0 days 00:39:14,-5,73,78
74,ULK,P006661,0 days 00:28:52,-7,53,60
74,ULK,P006961,0 days 00:28:09,-4,52,56
74,ULK,P011157,0 days 00:26:37,4,59,55
74,ULK,P011980,0 days 00:20:33,-7,37,44
74,ULK,P005844,0 days 00:18:27,-5,24,29
74,ULK,P011052,0 days 00:17:33,-2,32,34
74,ULK,P009849,0 days 00:14:05,0,20,20
74,ULK,P011201,0 days 00:06:30,1,15,14
75,OLY,P008829,0 days 00:39:07,3,86,83
75,OLY,P008811,0 days 00:33:34,2,73,71
75,OLY,P001255,0 days 00:30:46,3,65,62
75,OLY,P010612,0 days 00:29:33,1,58,57
75,OLY,P008855,0 days 00:28:20,-2,57,59
75,OLY,P006302,0 days 00:15:13,5,39,34
75,OLY,P010392,0 days 00:09:49,4,30,26
75,OLY,P011983,0 days 00:07:19,6,17,11
75,OLY,P006589,0 days 00:06:19,3,15,12
75,RED,P000848,0 days 00:31:28,-11,64,75
75,RED,P012044,0 days 00:25:54,7,56,49
75,RED,PJDR,0 days 00:25:00,1,61,60
75,RED,P006436,0 days 00:23:16,6,62,56
75,RED,P009035,0 days 00:22:38,-11,38,49
75,RED,P002553,0 days 00:21:20,5,52,47
75,RED,P007960,0 days 00:18:29,-8,31,39
75,RED,P004720,0 days 00:17:04,-11,21,32
75,RED,P008966,0 days 00:14:31,-3,30,33
75,RED,P011964,0 days 00:00:20,0,0,0
76,MAD,P006540,0 days 00:22:18,23,62,39
76,MAD,P004887,0 days 00:21:54,2,39,37
76,MAD,PTGB,0 days 00:21:12,5,40,35
76,MAD,P005928,0 days 00:20:30,26,62,36
76,MAD,PBMT,0 days 00:20:21,-11,34,45
76,MAD,P009005,0 days 00:19:16,33,60,27
76,MAD,PCVM,0 days 00:17:44,-7,25,32
76,MAD,P001392,0 days 00:17:16,20,50,30
76,MAD,P005791,0 days 00:15:27,22,47,25
76,MAD,P010357,0 days 00:12:26,-2,25,27
76,MAD,P003108,0 days 00:11:36,-21,11,32
76,MCO,P005985,0 days 00:26:41,-1,54,55
76,MCO,P011212,0 days 00:25:52,-15,42,57
76,MCO,P011226,0 days 00:24:15,-15,42,57
76,MCO,P010588,0 days 00:23:37,-18,48,66
76,MCO,P011196,0 days 00:20:39,-17,30,47
76,MCO,P009754,0 days 00:16:41,7,36,29
76,MCO,P011231,0 days 00:15:42,-4,25,29
76,MCO,PLCZ,0 days 00:15:16,-4,31,35
76,MCO,P012709,0 days 00:12:35,-17,17,34
76,MCO,P004790,0 days 00:12:25,-3,26,29
76,MCO,P012515,0 days 00:06:17,-3,14,17
77,BAR,P002939,0 days 00:28:06,11,57,46
77,BAR,P006435,0 days 00:27:35,8,51,43
77,BAR,P004866,0 days 00:26:12,7,51,44
77,BAR,P012745,0 days 00:25:23,6,52,46
77,BAR,P003478,0 days 00:22:19,-3,42,45
77,BAR,P000925,0 days 00:21:58,9,48,39
77,BAR,P003196,0 days 00:16:55,1,29,28
77,BAR,P007519,0 days 00:11:54,-7,17,24
77,BAR,P011244,0 days 00:11:39,0,19,19
77,BAR,P010641,0 days 00:04:05,-8,0,8
77,BAR,P007464,0 days 00:03:54,-4,4,8
77,PAM,P005356,0 days 00:28:13,-8,50,58
77,PAM,P010568,0 days 00:27:11,2,49,47
77,PAM,P007870,0 days 00:21:58,1,39,38
77,PAM,P011982,0 days 00:21:46,-2,41,43
77,PAM,P003960,0 days 00:18:08,-4,30,34
77,PAM,P000556,0 days 00:16:52,-2,26,28
77,PAM,P012738,0 days 00:15:43,-8,29,37
77,PAM,P004863,0 days 00:14:45,-2,23,25
77,PAM,P012739,0 days 00:14:06,-2,25,27
77,PAM,P010393,0 days 00:10:38,7,20,13
77,PAM,P006643,0 days 00:06:31,-6,10,16
77,PAM,P009101,0 days 00:04:09,4,8,4
78,ASV,P011225,0 days 00:33:54,3,71,68
78,ASV,P004194,0 days 00:31:46,-9,62,71
78,ASV,P012080,0 days 00:28:35,-7,60,67
78,ASV,P003526,0 days 00:24:27,-8,52,60
78,ASV,P012729,0 days 00:22:46,5,49,44
78,ASV,PKIR,0 days 00:22:12,4,41,37
78,ASV,P012730,0 days 00:12:14,-7,25,32
78,ASV,P006568,0 days 00:10:49,-5,22,27
78,ASV,P000229,0 days 00:09:38,-9,16,25
78,ASV,P011386,0 days 00:03:39,-2,7,9
78,BAS,P012201,0 days 00:36:55,10,82,72
78,BAS,P011948,0 days 00:29:55,16,76,60
78,BAS,P010444,0 days 00:28:42,10,65,55
78,BAS,P003198,0 days 00:27:21,2,52,50
78,BAS,P009048,0 days 00:26:12,-8,53,61
78,BAS,P012765,0 days 00:19:47,9,41,32
78,BAS,P004603,0 days 00:14:23,-6,29,35
78,BAS,P008850,0 days 00:11:41,-3,29,32
78,BAS,P011064,0 days 00:05:04,5,13,8
79,PAN,P007866,0 days 00:35:05,16,83,67
79,PAN,P011204,0 days 00:30:44,18,72,54
79,PAN,P001926,0 days 00:24:15,15,53,38
79,PAN,P002328,0 days 00:23:33,17,61,44
79,PAN,P012774,0 days 00:22:07,-1,51,52
79,PAN,P003842,0 days 00:21:09,18,47,29
79,PAN,P007947,0 days 00:19:09,-9,31,40
79,PAN,P007553,0 days 00:18:31,-4,41,45
79,PAN,P011221,0 days 00:02:40,0,5,5
79,PAN,P008084,0 days 00:02:15,-2,2,4
79,PAN,P011209,0 days 00:00:32,2,4,2
79,VIR,P001133,0 days 00:32:12,-7,65,72
79,VIR,PBCN,0 days 00:28:28,-1,62,63
79,VIR,P003048,0 days 00:24:43,-2,52,54
79,VIR,P006739,0 days 00:20:31,2,36,34
79,VIR,P011192,0 days 00:17:19,-4,28,32
79,VIR,P001844,0 days 00:16:27,-12,33,45
79,VIR,P009549,0 days 00:15:47,-8,29,37
79,VIR,P010781,0 days 00:12:04,-14,26,40
79,VIR,P003527,0 days 00:11:51,-12,20,32
79,VIR,P012714,0 days 00:11:14,-7,15,22
79,VIR,P004007,0 days 00:09:24,-5,14,19
80,PAR,P008987,0 days 00:28:32,3,60,57
80,PAR,P000956,0 days 00:26:47,16,60,44
80,PAR,P003983,0 days 00:24:54,21,65,44
80,PAR,P012742,0 days 00:23:39,16,51,35
80,PAR,P012743,0 days 00:23:13,9,51,42
80,PAR,P007400,0 days 00:20:26,1,46,45
80,PAR,P012096,0 days 00:19:39,11,48,37
80,PAR,P004058,0 days 00:11:02,-6,16,22
80,PAR,P004172,0 days 00:09:01,2,20,18
80,PAR,P007673,0 days 00:08:04,-2,16,18
80,PAR,P009212,0 days 00:04:43,4,12,8
80,BER,P012720,0 days 00:29:20,2,59,57
80,BER,P003958,0 days 00:27:31,5,59,54
80,BER,P006919,0 days 00:26:35,1,54,53
80,BER,P008211,0 days 00:26:23,-6,56,62
80,BER,P006251,0 days 00:18:17,-23,25,48
80,BER,P010791,0 days 00:16:56,-6,37,43
80,BER,P011934,0 days 00:16:18,-1,27,28
80,BER,P008384,0 days 00:12:51,-19,19,38
80,BER,P007550,0 days 00:11:36,-5,15,20
80,BER,P008967,0 days 00:10:29,-9,16,25
80,BER,P007025,0 days 00:02:46,-9,3,12
80,BER,P006819,0 days 00:00:58,-5,0,5
81,ZAL,P007109,0 days 00:29:28,-16,42,58
81,ZAL,P005504,0 days 00:24:11,9,50,41
81,ZAL,P002676,0 days 00:22:28,-11,31,42
81,ZAL,P002329,0 days 00:20:28,10,45,35
81,ZAL,P003211,0 days 00:20:07,8,45,37
81,ZAL,P011218,0 days 00:20:07,-3,30,33
81,ZAL,P003210,0 days 00:20:06,3,41,38
81,ZAL,P012715,0 days 00:15:55,6,39,33
81,ZAL,P007513,0 days 00:15:47,-6,23,29
81,ZAL,P010390,0 days 00:08:00,4,15,11
81,ZAL,P011965,0 days 00:03:23,1,9,8
81,MUN,P007056,0 days 00:30:45,9,58,49
81,MUN,P008985,0 days 00:29:34,9,56,47
81,MUN,P011987,0 days 00:28:44,-12,48,60
81,MUN,P003583,0 days 00:23:43,-7,37,44
81,MUN,P010391,0 days 00:21:50,8,41,33
81,MUN,P001557,0 days 00:21:37,-10,35,45
81,MUN,P005478,0 days 00:13:40,-9,24,33
81,MUN,P007975,0 days 00:10:35,-10,17,27
81,MUN,P007639,0 days 00:08:04,12,22,10
81,MUN,P012123,0 days 00:07:49,12,22,10
81,MUN,P011941,0 days 00:03:39,-7,5,12
82,ASV,P011225,0 days 00:37:51,7,91,84
82,ASV,P004194,0 days 00:32:59,-1,79,80
82,ASV,P012080,0 days 00:32:16,-7,76,83
82,ASV,P012729,0 days 00:32:02,2,75,73
82,ASV,P003526,0 days 00:24:10,-1,65,66
82,ASV,P000229,0 days 00:19:19,-4,34,38
82,ASV,P006568,0 days 00:17:13,1,35,34
82,ASV,PKIR,0 days 00:15:29,4,26,22
82,ASV,P012730,0 days 00:07:42,-5,9,14
82,ASV,P011386,0 days 00:05:59,-1,10,11
82,MUN,P007056,0 days 00:35:32,9,91,82
82,MUN,P010391,0 days 00:30:13,-6,68,74
82,MUN,P001557,0 days 00:26:43,2,63,61
82,MUN,P003583,0 days 00:25:38,7,66,59
82,MUN,P008985,0 days 00:22:50,10,50,40
82,MUN,P004508,0 days 00:18:53,-3,30,33
82,MUN,P011987,0 days 00:18:32,0,40,40
82,MUN,P007975,0 days 00:18:08,-8,33,41
82,MUN,P011941,0 days 00:14:39,-5,22,27
82,MUN,P006760,0 days 00:13:44,1,42,41
82,MUN,P005478,0 days 00:00:06,-2,0,2
82,MUN,P007639,0 days 00:00:02,0,0,0
83,TEL,P009622,0 days 00:33:46,1,80,79
83,TEL,P009783,0 days 00:31:43,-1,69,70
83,TEL,P009863,0 days 00:29:03,-5,65,70
83,TEL,P011219,0 days 00:20:03,7,48,41
83,TEL,P011214,0 days 00:20:00,7,44,37
83,TEL,P012744,0 days 00:19:36,3,45,42
83,TEL,P011199,0 days 00:16:37,-8,37,45
83,TEL,P005145,0 days 00:15:36,-3,35,38
83,TEL,P011971,0 days 00:07:45,-7,16,23
83,TEL,P004233,0 days 00:05:51,-4,11,15
83,BAR,P004866,0 days 00:26:25,0,60,60
83,BAR,P002939,0 days 00:26:02,1,53,52
83,BAR,P003478,0 days 00:23:28,10,56,46
83,BAR,P006435,0 days 00:21:00,-13,46,59
83,BAR,P012745,0 days 00:18:45,6,43,37
83,BAR,P003196,0 days 00:18:39,-11,45,56
83,BAR,P007464,0 days 00:15:12,-1,32,33
83,BAR,P010641,0 days 00:14:41,10,32,22
83,BAR,P003204,0 days 00:13:58,1,39,38
83,BAR,P011244,0 days 00:11:42,3,29,26
83,BAR,P009992,0 days 00:10:08,4,25,21
84,PAN,P002328,0 days 00:32:42,18,77,59
84,PAN,P007866,0 days 00:31:05,13,75,62
84,PAN,P003842,0 days 00:27:41,18,70,52
84,PAN,P001926,0 days 00:25:19,19,67,48
84,PAN,P011204,0 days 00:23:04,19,56,37
84,PAN,P007947,0 days 00:19:49,-5,34,39
84,PAN,P012774,0 days 00:13:32,1,25,24
84,PAN,P007553,0 days 00:12:00,0,20,20
84,PAN,P008084,0 days 00:10:46,4,21,17
84,PAN,P011209,0 days 00:04:02,-2,5,7
84,PAM,P010568,0 days 00:26:58,-16,49,65
84,PAM,P012738,0 days 00:23:04,0,43,43
84,PAM,P011982,0 days 00:19:58,-13,34,47
84,PAM,P005356,0 days 00:18:12,-8,33,41
84,PAM,P011970,0 days 00:16:30,-5,30,35
84,PAM,P006643,0 days 00:16:11,-3,31,34
84,PAM,P012740,0 days 00:16:04,-3,31,34
84,PAM,P012739,0 days 00:15:33,-4,28,32
84,PAM,P007870,0 days 00:15:22,-13,27,40
84,PAM,P000556,0 days 00:12:32,-6,25,31
84,PAM,P003960,0 days 00:11:35,-20,16,36
84,PAM,P010393,0 days 00:08:01,6,18,12
85,MAD,P005928,0 days 00:23:25,18,61,43
85,MAD,P003108,0 days 00:22:58,21,70,49
85,MAD,P005791,0 days 00:22:51,17,62,45
85,MAD,P009213,0 days 00:20:06,16,54,38
85,MAD,P001392,0 days 00:18:07,17,49,32
85,MAD,P004887,0 days 00:17:05,7,37,30
85,MAD,PCVM,0 days 00:16:35,6,38,32
85,MAD,P006540,0 days 00:13:58,6,36,30
85,MAD,P009005,0 days 00:11:45,7,20,13
85,MAD,PTGB,0 days 00:11:29,1,33,32
85,MAD,PBMT,0 days 00:11:17,-2,18,20
85,MAD,P003733,0 days 00:10:24,6,17,11
85,BER,P008384,0 days 00:27:47,-14,49,63
85,BER,P008211,0 days 00:27:30,-19,56,75
85,BER,P010791,0 days 00:23:01,-23,45,68
85,BER,P007025,0 days 00:22:11,-11,41,52
85,BER,P008173,0 days 00:21:01,-13,40,53
85,BER,P007550,0 days 00:18:59,-11,35,46
85,BER,P003958,0 days 00:18:37,-8,39,47
85,BER,P011934,0 days 00:16:42,-16,26,42
85,BER,P006251,0 days 00:16:26,-7,27,34
85,BER,P006819,0 days 00:07:46,2,17,15
86,VIR,P001133,0 days 00:28:57,13,71,58
86,VIR,P001844,0 days 00:28:43,4,63,59
86,VIR,P011192,0 days 00:20:56,1,41,40
86,VIR,P010781,0 days 00:20:55,5,51,46
86,VIR,P012714,0 days 00:20:29,8,48,40
86,VIR,PBCN,0 days 00:20:01,-1,47,48
86,VIR,P004007,0 days 00:17:58,9,35,26
86,VIR,P003048,0 days 00:17:33,-1,35,36
86,VIR,P003527,0 days 00:12:44,-2,20,22
86,VIR,P006739,0 days 00:11:44,4,24,20
86,ULK,P008962,0 days 00:33:03,-6,68,74
86,ULK,P006661,0 days 00:28:59,0,64,64
86,ULK,P011157,0 days 00:25:36,-2,57,59
86,ULK,P005844,0 days 00:23:00,-1,54,55
86,ULK,P001932,0 days 00:21:47,-14,34,48
86,ULK,P004004,0 days 00:21:34,6,51,45
86,ULK,P002968,0 days 00:14:25,-9,23,32
86,ULK,P011052,0 days 00:13:26,-3,21,24
86,ULK,P002969,0 days 00:09:33,-4,11,15
86,ULK,P011980,0 days 00:08:37,-7,12,19
87,IST,P004888,0 days 00:36:23,7,90,83
87,IST,P011078,0 days 00:33:48,0,83,83
87,IST,P007200,0 days 00:33:14,11,87,76
87,IST,P006590,0 days 00:27:57,10,77,67
87,IST,P004554,0 days 00:20:23,0,43,43
87,IST,P011981,0 days 00:19:35,8,57,49
87,IST,P009664,0 days 00:17:47,11,47,36
87,IST,P012710,0 days 00:06:24,-8,9,17
87,IST,P006372,0 days 00:02:18,-4,5,9
87,IST,P010516,0 days 00:02:11,-5,2,7
87,PAR,P012742,0 days 00:30:48,10,81,71
87,PAR,P007400,0 days 00:28:34,0,75,75
87,PAR,P012743,0 days 00:27:19,2,69,67
87,PAR,P004172,0 days 00:26:46,-5,64,69
87,PAR,P008987,0 days 00:26:23,-16,59,75
87,PAR,P012096,0 days 00:20:18,3,46,43
87,PAR,P004058,0 days 00:18:12,-4,37,41
87,PAR,P011051,0 days 00:11:05,-5,21,26
87,PAR,P000956,0 days 00:10:35,-15,18,33
88,RED,P006436,0 days 00:28:43,-17,47,64
88,RED,P002553,0 days 00:28:17,-21,47,68
88,RED,P007960,0 days 00:26:20,-10,50,60
88,RED,P000848,0 days 00:25:55,-16,49,65
88,RED,P009035,0 days 00:23:43,-12,43,55
88,RED,PJDR,0 days 00:19:51,-7,37,44
88,RED,P012044,0 days 00:17:54,-15,32,47
88,RED,P008966,0 days 00:12:30,1,24,23
88,RED,P004720,0 days 00:08:28,-5,17,22
88,RED,P012711,0 days 00:04:47,-9,4,13
88,RED,P011224,0 days 00:03:32,1,5,4
88,MIL,P007032,0 days 00:32:46,23,77,54
88,MIL,P000796,0 days 00:29:27,27,72,45
88,MIL,P007831,0 days 00:29:16,16,68,52
88,MIL,P002849,0 days 00:27:11,32,71,39
88,MIL,P011205,0 days 00:23:39,6,53,47
88,MIL,P007201,0 days 00:23:30,23,60,37
88,MIL,P006509,0 days 00:12:32,-7,23,30
88,MIL,P009960,0 days 00:08:55,-7,15,22
88,MIL,P006701,0 days 00:06:54,4,16,12
88,MIL,P002812,0 days 00:04:28,-5,8,13
88,MIL,P001518,0 days 00:00:41,-1,1,2
88,MIL,P011926,0 days 00:00:41,-1,1,2
89,OLY,P008829,0 days 00:30:12,13,68,55
89,OLY,P010612,0 days 00:27:57,17,69,52
89,OLY,P008855,0 days 00:25:30,14,54,40
89,OLY,P008811,0 days 00:23:17,11,52,41
89,OLY,P011983,0 days 00:19:05,11,47,36
89,OLY,P001255,0 days 00:18:20,2,36,34
89,OLY,P010392,0 days 00:17:09,3,31,28
89,OLY,P006302,0 days 00:14:30,3,35,32
89,OLY,P003941,0 days 00:14:12,7,32,25
89,OLY,P006589,0 days 00:09:48,4,21,17
89,ZAL,P010390,0 days 00:27:54,-4,48,52
89,ZAL,P002676,0 days 00:27:34,-13,46,59
89,ZAL,P002329,0 days 00:25:15,-17,46,63
89,ZAL,P011218,0 days 00:23:43,-3,41,44
89,ZAL,P003210,0 days 00:22:42,-13,45,58
89,ZAL,P007109,0 days 00:21:16,-11,35,46
89,ZAL,P012715,0 days 00:17:04,1,38,37
89,ZAL,P003211,0 days 00:13:20,-9,19,28
89,ZAL,P007513,0 days 00:08:40,-1,17,18
89,ZAL,P005504,0 days 00:05:48,-15,8,23
89,ZAL,P006860,0 days 00:05:42,-2,13,15
89,ZAL,P012784,0 days 00:01:02,2,4,2
90,BAS,P007230,0 days 00:35:13,-1,68,69
90,BAS,P010444,0 days 00:31:14,6,60,54
90,BAS,P009048,0 days 00:26:58,-1,49,50
90,BAS,P004761,0 days 00:26:22,-5,45,50
90,BAS,P012201,0 days 00:21:43,-13,34,47
90,BAS,P011948,0 days 00:19:58,6,41,35
90,BAS,P003198,0 days 00:15:34,7,35,28
90,BAS,P012765,0 days 00:13:02,-1,26,27
90,BAS,P004603,0 days 00:08:30,-12,11,23
90,BAS,P008850,0 days 00:01:26,4,6,2
90,MCO,P005985,0 days 00:34:12,5,66,61
90,MCO,P011212,0 days 00:29:27,-2,52,54
90,MCO,P010588,0 days 00:28:38,1,53,52
90,MCO,P011226,0 days 00:28:37,-6,48,54
90,MCO,PLCZ,0 days 00:17:49,13,46,33
90,MCO,P011231,0 days 00:15:58,-9,22,31
90,MCO,P012709,0 days 00:14:26,5,34,29
90,MCO,P004197,0 days 00:13:18,4,31,27
90,MCO,P011196,0 days 00:10:24,0,21,21
90,MCO,P004790,0 days 00:07:11,-1,12,13
91,MCO,P005985,0 days 00:30:02,12,69,57
91,MCO,P011226,0 days 00:28:08,13,66,53
91,MCO,P010588,0 days 00:26:18,13,64,51
91,MCO,P011212,0 days 00:24:19,3,47,44
91,MCO,PLCZ,0 days 00:17:14,10,39,29
91,MCO,P011196,0 days 00:16:12,-1,32,33
91,MCO,P004197,0 days 00:14:57,0,29,29
91,MCO,P011231,0 days 00:14:46,0,32,32
91,MCO,P004790,0 days 00:12:30,-2,21,23
91,MCO,P012709,0 days 00:11:37,-5,19,24
91,MCO,P002581,0 days 00:03:57,-3,7,10
91,OLY,P008855,0 days 00:34:09,-14,64,78
91,OLY,P010612,0 days 00:31:09,-12,59,71
91,OLY,P008829,0 days 00:30:42,-7,62,69
91,OLY,P001255,0 days 00:23:42,-1,46,47
91,OLY,P008811,0 days 00:22:06,9,48,39
91,OLY,P003941,0 days 00:17:51,-17,29,46
91,OLY,P011983,0 days 00:15:20,-6,30,36
91,OLY,P006589,0 days 00:08:55,-1,15,16
91,OLY,P010392,0 days 00:06:21,1,13,12
91,OLY,P006302,0 days 00:05:43,3,10,7
91,OLY,P007853,0 days 00:04:02,5,9,4
92,MUN,P011987,0 days 00:30:22,20,71,51
92,MUN,P010391,0 days 00:26:38,17,61,44
92,MUN,P007975,0 days 00:25:57,2,54,52
92,MUN,P007056,0 days 00:23:58,1,55,54
92,MUN,P003583,0 days 00:23:15,10,50,40
92,MUN,P006760,0 days 00:22:21,13,56,43
92,MUN,P001557,0 days 00:16:17,2,36,34
92,MUN,P007639,0 days 00:15:10,14,37,23
92,MUN,P005478,0 days 00:07:24,-3,12,15
92,MUN,P011941,0 days 00:05:05,-3,12,15
92,MUN,P006245,0 days 00:03:33,-3,6,9
92,VIR,P001133,0 days 00:33:52,-7,67,74
92,VIR,PBCN,0 days 00:29:40,-12,56,68
92,VIR,P001844,0 days 00:25:27,-11,43,54
92,VIR,P003048,0 days 00:21:35,-13,44,57
92,VIR,P008847,0 days 00:19:04,-4,31,35
92,VIR,P009549,0 days 00:15:58,-3,31,34
92,VIR,P010781,0 days 00:14:26,-4,27,31
92,VIR,P006739,0 days 00:14:25,-4,33,37
92,VIR,P004007,0 days 00:12:13,-4,20,24
92,VIR,P011192,0 days 00:07:51,-4,18,22
92,VIR,P012714,0 days 00:05:29,-4,10,14
93,ULK,P008962,0 days 00:37:10,-6,83,89
93,ULK,P004004,0 days 00:33:09,9,83,74
93,ULK,P011157,0 days 00:28:48,19,71,52
93,ULK,P006661,0 days 00:25:14,12,60,48
93,ULK,P011052,0 days 00:22:22,4,47,43
93,ULK,P001932,0 days 00:20:42,3,53,50
93,ULK,P009849,0 days 00:17:44,-6,33,39
93,ULK,P010560,0 days 00:14:16,-13,24,37
93,ULK,P002968,0 days 00:14:09,-1,28,29
93,ULK,P005844,0 days 00:11:26,-16,18,34
93,MAD,P009005,0 days 00:38:04,8,93,85
93,MAD,P005928,0 days 00:37:05,13,90,77
93,MAD,PTGB,0 days 00:31:19,4,75,71
93,MAD,P004887,0 days 00:23:46,-18,45,63
93,MAD,PBMT,0 days 00:21:56,-13,40,53
93,MAD,P005791,0 days 00:21:10,16,53,37
93,MAD,P006540,0 days 00:17:16,0,40,40
93,MAD,P003108,0 days 00:15:58,-12,25,37
93,MAD,P009213,0 days 00:07:58,9,23,14
93,MAD,PCVM,0 days 00:07:12,-9,9,18
93,MAD,P003733,0 days 00:03:16,-3,2,5
94,TEL,P009863,0 days 00:23:29,14,61,47
94,TEL,P011193,0 days 00:22:35,14,59,45
94,TEL,P004233,0 days 00:22:16,23,62,39
94,TEL,P011219,0 days 00:22:04,18,59,41
94,TEL,P009783,0 days 00:20:47,4,45,41
94,TEL,P009622,0 days 00:20:00,10,57,47
94,TEL,P011214,0 days 00:18:22,3,43,40
94,TEL,P005145,0 days 00:15:18,4,40,36
94,TEL,P012744,0 days 00:14:48,5,32,27
94,TEL,P011971,0 days 00:14:23,13,41,28
94,TEL,P011433,0 days 00:05:58,-3,11,14
94,BER,P008384,0 days 00:23:19,7,61,54
94,BER,P012721,0 days 00:22:55,-14,46,60
94,BER,P008211,0 days 00:21:31,-6,40,46
94,BER,P008173,0 days 00:21:19,-22,45,67
94,BER,P003958,0 days 00:20:53,0,53,53
94,BER,P011934,0 days 00:19:50,-17,41,58
94,BER,P010791,0 days 00:17:02,1,34,33
94,BER,P006251,0 days 00:16:27,-17,23,40
94,BER,P011631,0 days 00:14:14,-5,29,34
94,BER,P007025,0 days 00:13:51,-21,16,37
94,BER,P006819,0 days 00:08:39,-11,17,28
95,PAR,P008987,0 days 00:39:29,10,86,76
95,PAR,P012742,0 days 00:31:15,15,73,58
95,PAR,P009862,0 days 00:26:22,-2,53,55
95,PAR,P007400,0 days 00:25:54,-6,41,47
95,PAR,P000956,0 days 00:25:04,26,64,38
95,PAR,P011051,0 days 00:20:36,-3,41,44
95,PAR,P012096,0 days 00:19:55,15,49,34
95,PAR,P012743,0 days 00:10:49,-11,15,26
95,PAR,P003983,0 days 00:09:42,-1,15,16
95,PAR,P004172,0 days 00:07:13,-6,13,19
95,PAR,P009212,0 days 00:05:01,-5,6,11
95,PAR,P004058,0 days 00:03:40,-7,4,11
95,PAN,P007866,0 days 00:41:04,-1,80,81
95,PAN,P002328,0 days 00:39:26,0,79,79
95,PAN,P011204,0 days 00:38:49,-4,76,80
95,PAN,P003842,0 days 00:33:10,-5,66,71
95,PAN,P012774,0 days 00:26:15,1,57,56
95,PAN,P001926,0 days 00:22:50,-9,39,48
95,PAN,P007553,0 days 00:11:50,0,21,21
95,PAN,P007947,0 days 00:10:05,-2,17,19
95,PAN,P008084,0 days 00:01:31,-5,0,5
96,MIL,P007831,0 days 00:31:48,-17,54,71
96,MIL,P000796,0 days 00:29:29,-13,52,65
96,MIL,P007032,0 days 00:28:13,-17,48,65
96,MIL,P002849,0 days 00:27:59,-7,49,56
96,MIL,P007201,0 days 00:19:01,-15,32,47
96,MIL,P011205,0 days 00:17:21,5,34,29
96,MIL,P006509,0 days 00:16:29,-6,26,32
96,MIL,P002812,0 days 00:13:19,0,27,27
96,MIL,P009960,0 days 00:07:56,-1,12,13
96,MIL,P001518,0 days 00:04:15,2,8,6
96,MIL,P006701,0 days 00:04:10,4,8,4
96,ZAL,P002329,0 days 00:34:44,13,75,62
96,ZAL,P010390,0 days 00:34:13,17,72,55
96,ZAL,P011218,0 days 00:29:55,12,64,52
96,ZAL,P007109,0 days 00:22:11,9,46,37
96,ZAL,P007513,0 days 00:21:26,0,40,40
96,ZAL,P002676,0 days 00:17:11,15,39,24
96,ZAL,P006860,0 days 00:13:56,6,28,22
96,ZAL,P003211,0 days 00:11:10,-3,23,26
96,ZAL,P003210,0 days 00:08:06,0,14,14
96,ZAL,P005504,0 days 00:07:08,-4,14,18
97,RED,P009035,0 days 00:28:46,14,80,66
97,RED,P002553,0 days 00:26:12,5,65,60
97,RED,P000848,0 days 00:25:44,12,70,58
97,RED,P012044,0 days 00:24:52,16,69,53
97,RED,PJDR,0 days 00:18:14,4,39,35
97,RED,P006436,0 days 00:15:58,-5,28,33
97,RED,P011224,0 days 00:14:24,-5,28,33
97,RED,P007960,0 days 00:13:42,6,29,23
97,RED,PLUO,0 days 00:11:37,7,31,24
97,RED,P008966,0 days 00:10:55,0,17,17
97,RED,P004720,0 days 00:09:36,16,29,13
97,IST,P007200,0 days 00:34:11,-19,71,90
97,IST,P004888,0 days 00:33:32,-13,67,80
97,IST,P011981,0 days 00:32:22,0,70,70
97,IST,P006590,0 days 00:31:50,-5,65,70
97,IST,P011078,0 days 00:30:24,-15,58,73
97,IST,P006372,0 days 00:17:11,-7,32,39
97,IST,P012786,0 days 00:15:13,0,41,41
97,IST,P012710,0 days 00:05:11,-8,11,19
97,IST,P009513,0 days 00:00:06,-3,0,3
98,BAR,P002939,0 days 00:28:12,19,79,60
98,BAR,P004866,0 days 00:26:45,11,66,55
98,BAR,P006435,0 days 00:25:45,28,78,50
98,BAR,P000925,0 days 00:25:21,13,64,51
98,BAR,P011244,0 days 00:20:40,-10,42,52
98,BAR,P012745,0 days 00:19:58,16,58,42
98,BAR,P003196,0 days 00:13:51,-4,35,39
98,BAR,P003478,0 days 00:12:03,-13,24,37
98,BAR,P007519,0 days 00:10:04,-8,19,27
98,BAR,P007464,0 days 00:09:43,2,26,24
98,BAR,P009992,0 days 00:05:39,0,14,14
98,BAR,P003204,0 days 00:01:59,-9,0,9
98,ASV,P012080,0 days 00:30:13,-7,68,75
98,ASV,P004194,0 days 00:29:37,-13,69,82
98,ASV,P003526,0 days 00:25:35,-18,52,70
98,ASV,P012729,0 days 00:24:24,4,58,54
98,ASV,P011225,0 days 00:23:14,-20,45,65
98,ASV,P006568,0 days 00:21:13,-13,45,58
98,ASV,P002100,0 days 00:20:25,10,57,47
98,ASV,P000229,0 days 00:19:40,11,54,43
98,ASV,P012730,0 days 00:04:46,4,12,8
98,ASV,P011386,0 days 00:00:43,0,0,0
98,ASV,P012731,0 days 00:00:10,-3,0,3
99,PAM,P011982,0 days 00:31:11,-20,65,85
99,PAM,P010568,0 days 00:26:52,-19,60,79
99,PAM,P011970,0 days 00:24:19,-6,50,56
99,PAM,P003960,0 days 00:23:20,-15,37,52
99,PAM,P007870,0 days 00:21:56,-11,41,52
99,PAM,P005356,0 days 00:20:00,-9,45,54
99,PAM,P012739,0 days 00:15:58,-4,36,40
99,PAM,P012740,0 days 00:13:21,7,27,20
99,PAM,P012738,0 days 00:12:25,2,34,32
99,PAM,P000556,0 days 00:08:17,7,23,16
99,PAM,P006643,0 days 00:02:21,-2,2,4
99,BAS,P007230,0 days 00:37:05,21,96,75
99,BAS,P009048,0 days 00:30:32,18,75,57
99,BAS,P012201,0 days 00:28:16,18,69,51
99,BAS,P004761,0 days 00:25:07,5,63,58
99,BAS,P004603,0 days 00:23:04,13,50,37
99,BAS,P011948,0 days 00:20:57,11,54,43
99,BAS,P010444,0 days 00:14:51,3,42,39
99,BAS,P003198,0 days 00:08:36,-14,13,27
99,BAS,P011064,0 days 00:07:28,-2,15,17
99,BAS,P012765,0 days 00:02:00,-2,8,10
99,BAS,P008072,0 days 00:01:45,-1,5,6
99,BAS,P008850,0 days 00:00:19,0,0,0
100,BER,P003958,0 days 00:31:41,10,61,51
100,BER,P011934,0 days 00:29:04,-8,41,49
100,BER,P007025,0 days 00:24:27,-1,39,40
100,BER,P006251,0 days 00:22:12,2,35,33
100,BER,P008173,0 days 00:20:40,-4,30,34
100,BER,P008211,0 days 00:19:20,6,34,28
100,BER,P008384,0 days 00:18:12,0,28,28
100,BER,P012721,0 days 00:18:00,4,27,23
100,BER,P010791,0 days 00:16:24,1,25,24
100,ZAL,P002329,0 days 00:30:30,-9,49,58
100,ZAL,P010390,0 days 00:27:37,12,55,43
100,ZAL,P011218,0 days 00:26:19,3,49,46
100,ZAL,P007109,0 days 00:24:39,9,41,32
100,ZAL,P007513,0 days 00:23:50,-1,35,36
100,ZAL,P003211,0 days 00:20:21,-6,30,36
100,ZAL,P006860,0 days 00:16:29,-10,18,28
100,ZAL,P003210,0 days 00:10:43,-2,13,15
100,ZAL,P012787,0 days 00:09:40,7,13,6
100,ZAL,P005504,0 days 00:09:28,-13,7,20
100,ZAL,P012784,0 days 00:00:24,0,0,0
101,IST,P007200,0 days 00:34:28,9,67,58
101,IST,P011981,0 days 00:30:50,12,66,54
101,IST,P011078,0 days 00:29:25,7,59,52
101,IST,P012710,0 days 00:23:22,6,40,34
101,IST,P009513,0 days 00:21:04,-7,31,38
101,IST,P012786,0 days 00:20:52,-3,37,40
101,IST,P010516,0 days 00:15:47,-12,21,33
101,IST,P006372,0 days 00:12:37,10,25,15
101,IST,P012788,0 days 00:11:35,-7,9,16
101,PAN,P007866,0 days 00:33:46,-1,59,60
101,PAN,P011204,0 days 00:33:35,-2,60,62
101,PAN,P003842,0 days 00:31:40,-2,54,56
101,PAN,P012774,0 days 00:29:32,-2,52,54
101,PAN,P001926,0 days 00:27:38,1,49,48
101,PAN,P002328,0 days 00:20:54,-7,33,40
101,PAN,P011221,0 days 00:08:37,-2,13,15
101,PAN,P007947,0 days 00:06:25,-1,8,9
101,PAN,P007553,0 days 00:04:13,2,8,6
101,PAN,P011826,0 days 00:01:56,2,2,0
101,PAN,P008084,0 days 00:01:44,-3,2,5
102,MUN,P011987,0 days 00:36:49,18,83,65
102,MUN,P003583,0 days 00:34:46,21,80,59
102,MUN,P007056,0 days 00:34:32,11,74,63
102,MUN,P010391,0 days 00:31:52,-4,57,61
102,MUN,P006760,0 days 00:30:58,13,71,58
102,MUN,P007975,0 days 00:20:58,2,40,38
102,MUN,P001557,0 days 00:13:56,-15,14,29
102,MUN,P006543,0 days 00:06:46,5,14,9
102,MUN,P011941,0 days 00:05:13,-5,8,13
102,MUN,P007639,0 days 00:05:01,-9,3,12
102,MUN,P006245,0 days 00:04:09,-2,11,13
102,MIL,P007831,0 days 00:35:30,-15,63,78
102,MIL,P002849,0 days 00:30:49,-20,55,75
102,MIL,P011205,0 days 00:29:33,-4,55,59
102,MIL,P007032,0 days 00:25:24,5,49,44
102,MIL,P006509,0 days 00:24:33,-7,48,55
102,MIL,P007201,0 days 00:24:19,10,49,39
102,MIL,P002812,0 days 00:17:50,3,34,31
102,MIL,P005670,0 days 00:17:01,-1,31,32
102,MIL,P009960,0 days 00:16:43,-9,28,37
102,MIL,P006701,0 days 00:02:59,1,6,5
102,MIL,P001518,0 days 00:00:19,2,2,0
103,OLY,P008855,0 days 00:31:54,-3,55,58
103,OLY,P001255,0 days 00:29:05,-4,52,56
103,OLY,P008829,0 days 00:26:20,-5,52,57
103,OLY,P008811,0 days 00:24:51,-3,43,46
103,OLY,P007853,0 days 00:17:28,2,28,26
103,OLY,P010392,0 days 00:16:37,0,27,27
103,OLY,P003941,0 days 00:15:09,-3,28,31
103,OLY,P010612,0 days 00:14:32,-4,28,32
103,OLY,P006302,0 days 00:10:37,-6,19,25
103,OLY,P011983,0 days 00:07:00,-2,15,17
103,OLY,P006589,0 days 00:06:27,-2,8,10
103,MAD,P003108,0 days 00:28:51,5,55,50
103,MAD,P005928,0 days 00:27:41,13,58,45
103,MAD,P009005,0 days 00:27:05,6,51,45
103,MAD,P006540,0 days 00:25:35,5,54,49
103,MAD,P005791,0 days 00:22:32,11,48,37
103,MAD,PTGB,0 days 00:21:47,-5,32,37
103,MAD,P004887,0 days 00:17:28,-5,29,34
103,MAD,P001392,0 days 00:11:28,2,26,24
103,MAD,P009213,0 days 00:10:26,-1,20,21
103,MAD,P010623,0 days 00:07:07,-1,12,13
104,PAR,P007400,0 days 00:39:31,-3,78,81
104,PAR,P009862,0 days 00:38:54,10,80,70
104,PAR,P012742,0 days 00:36:46,8,76,68
104,PAR,P008987,0 days 00:36:32,1,72,71
104,PAR,P011051,0 days 00:21:04,-4,42,46
104,PAR,P012096,0 days 00:17:59,16,38,22
104,PAR,P000956,0 days 00:08:43,2,15,13
104,PAR,P009212,0 days 00:07:38,-4,13,17
104,PAR,P003983,0 days 00:07:15,-5,11,16
104,PAR,P011050,0 days 00:05:53,2,12,10
104,PAR,P004172,0 days 00:04:45,-3,8,11
104,MCO,P005985,0 days 00:38:55,0,74,74
104,MCO,P011226,0 days 00:35:36,9,72,63
104,MCO,P010588,0 days 00:34:44,-6,67,73
104,MCO,P011212,0 days 00:24:13,3,53,50
104,MCO,P009754,0 days 00:22:55,-6,42,48
104,MCO,PLCZ,0 days 00:22:14,-9,39,48
104,MCO,P011231,0 days 00:19:42,-2,34,36
104,MCO,P011196,0 days 00:14:01,-1,25,26
104,MCO,P012709,0 days 00:06:04,-2,11,13
104,MCO,P004197,0 days 00:03:54,-9,2,11
104,MCO,P004790,0 days 00:02:42,3,6,3
105,ASV,P012080,0 days 00:31:09,-9,65,74
105,ASV,P011225,0 days 00:29:24,10,71,61
105,ASV,P004194,0 days 00:28:17,5,62,57
105,ASV,P012729,0 days 00:27:17,1,73,72
105,ASV,P002100,0 days 00:22:57,-4,60,64
105,ASV,P000229,0 days 00:22:56,4,59,55
105,ASV,P006568,0 days 00:16:09,-3,30,33
105,ASV,P003526,0 days 00:12:15,-1,18,19
105,ASV,P012730,0 days 00:08:17,-9,17,26
105,ASV,P011386,0 days 00:01:19,-9,0,9
105,TEL,P009863,0 days 00:34:33,7,84,77
105,TEL,P009783,0 days 00:28:40,-2,64,66
105,TEL,P009622,0 days 00:28:31,-4,65,69
105,TEL,P011219,0 days 00:25:46,9,64,55
105,TEL,P011214,0 days 00:21:38,10,51,41
105,TEL,P011199,0 days 00:18:12,-7,43,50
105,TEL,P011193,0 days 00:14:53,4,38,34
105,TEL,P005145,0 days 00:09:32,0,18,18
105,TEL,P012744,0 days 00:08:58,6,24,18
105,TEL,P004233,0 days 00:05:06,-1,11,12
105,TEL,P011971,0 days 00:04:11,-7,8,15
106,BAS,P009048,0 days 00:31:14,3,61,58
106,BAS,P004603,0 days 00:28:46,12,64,52
106,BAS,P011948,0 days 00:27:34,9,64,55
106,BAS,P012201,0 days 00:27:16,9,64,55
106,BAS,P004761,0 days 00:23:08,5,47,42
106,BAS,P007230,0 days 00:20:03,-5,35,40
106,BAS,P011085,0 days 00:17:18,-7,30,37
106,BAS,P008072,0 days 00:11:00,-14,13,27
106,BAS,P011064,0 days 00:08:07,-5,14,19
106,BAS,P003198,0 days 00:05:34,-2,8,10
106,ULK,P008962,0 days 00:36:28,7,75,68
106,ULK,P010560,0 days 00:27:55,-3,51,54
106,ULK,P004004,0 days 00:25:43,-4,45,49
106,ULK,P011157,0 days 00:23:37,-3,44,47
106,ULK,P011052,0 days 00:22:47,4,52,48
106,ULK,P009849,0 days 00:18:31,5,42,37
106,ULK,P002968,0 days 00:16:23,2,35,33
106,ULK,P001932,0 days 00:14:35,-6,24,30
106,ULK,P006661,0 days 00:10:29,1,23,22
106,ULK,P011980,0 days 00:03:32,-8,4,12
107,PAM,P007870,0 days 00:28:53,-1,59,60
107,PAM,P000556,0 days 00:25:12,6,58,52
107,PAM,P010568,0 days 00:24:11,-10,50,60
107,PAM,P011970,0 days 00:22:49,1,42,41
107,PAM,P004863,0 days 00:22:32,14,47,33
107,PAM,P011982,0 days 00:21:09,8,54,46
107,PAM,P006643,0 days 00:18:51,-4,31,35
107,PAM,P003960,0 days 00:12:59,1,25,24
107,PAM,P005356,0 days 00:12:20,2,35,33
107,PAM,P012739,0 days 00:11:04,3,24,21
107,RED,P007960,0 days 00:26:54,0,60,60
107,RED,P009035,0 days 00:26:19,2,50,48
107,RED,P006436,0 days 00:22:24,-14,37,51
107,RED,P002553,0 days 00:21:47,8,44,36
107,RED,PJDR,0 days 00:21:27,16,54,38
107,RED,P000848,0 days 00:18:19,-10,28,38
107,RED,P011224,0 days 00:17:53,3,42,39
107,RED,P008966,0 days 00:13:38,-4,31,35
107,RED,PLUO,0 days 00:13:16,6,31,25
107,RED,P012044,0 days 00:10:10,-14,13,27
107,RED,P004720,0 days 00:07:14,-8,15,23
107,RED,P012711,0 days 00:00:39,-5,0,5
108,VIR,P001844,0 days 00:32:05,3,63,60
108,VIR,P001133,0 days 00:31:51,17,68,51
108,VIR,PBCN,0 days 00:21:53,-5,43,48
108,VIR,P008847,0 days 00:20:53,-11,34,45
108,VIR,P009549,0 days 00:20:47,2,37,35
108,VIR,P003048,0 days 00:19:51,10,44,34
108,VIR,P010781,0 days 00:19:30,4,44,40
108,VIR,P004007,0 days 00:18:28,13,40,27
108,VIR,P012714,0 days 00:04:21,-10,6,16
108,VIR,P012713,0 days 00:04:03,9,11,2
108,VIR,P011192,0 days 00:03:52,-7,6,13
108,VIR,P003527,0 days 00:02:26,0,4,4
108,BAR,P002939,0 days 00:27:32,-3,51,54
108,BAR,P006435,0 days 00:26:05,-13,41,54
108,BAR,P004866,0 days 00:25:45,-12,43,55
108,BAR,P000925,0 days 00:23:51,-3,39,42
108,BAR,P011244,0 days 00:19:20,-7,29,36
108,BAR,P012745,0 days 00:18:49,-1,39,40
108,BAR,P003196,0 days 00:16:09,-2,36,38
108,BAR,P003478,0 days 00:16:05,8,37,29
108,BAR,P009992,0 days 00:13:34,8,34,26
108,BAR,P007519,0 days 00:12:28,-2,24,26
108,BAR,P003204,0 days 00:00:22,2,2,0
109,BER,P003958,0 days 00:28:55,-4,65,69
109,BER,P012721,0 days 00:25:59,-12,51,63
109,BER,P008384,0 days 00:24:41,2,59,57
109,BER,P006251,0 days 00:23:19,0,61,61
109,BER,P008173,0 days 00:22:10,-1,51,52
109,BER,P007025,0 days 00:20:23,-11,44,55
109,BER,P008211,0 days 00:19:36,-5,45,50
109,BER,P011934,0 days 00:14:38,-4,23,27
109,BER,P010791,0 days 00:11:00,-6,25,31
109,BER,P006819,0 days 00:08:52,1,19,18
109,BER,P011631,0 days 00:00:27,0,2,2
109,IST,P009513,0 days 00:35:52,11,93,82
109,IST,P011078,0 days 00:35:24,10,90,80
109,IST,P007200,0 days 00:32:09,7,76,69
109,IST,P011981,0 days 00:24:15,3,58,55
109,IST,P012786,0 days 00:22:50,12,66,54
109,IST,P012788,0 days 00:18:22,0,44,44
109,IST,P012710,0 days 00:17:05,1,32,31
109,IST,P010516,0 days 00:14:03,-4,26,30
110,PAN,P007947,0 days 00:32:28,2,70,68
110,PAN,P012774,0 days 00:32:11,-13,66,79
110,PAN,P003842,0 days 00:30:03,-11,63,74
110,PAN,P007866,0 days 00:28:24,-12,55,67
110,PAN,P002328,0 days 00:24:34,-5,45,50
110,PAN,P011204,0 days 00:18:11,-11,37,48
110,PAN,P001926,0 days 00:12:36,-9,16,25
110,PAN,P008084,0 days 00:11:57,-2,23,25
110,PAN,P007553,0 days 00:09:36,1,15,14
110,MAD,P005928,0 days 00:32:25,23,83,60
110,MAD,P009005,0 days 00:29:56,17,71,54
110,MAD,P005791,0 days 00:23:26,17,59,42
110,MAD,P003108,0 days 00:22:52,-2,52,54
110,MAD,P006540,0 days 00:20:14,1,38,37
110,MAD,P001392,0 days 00:18:21,5,37,32
110,MAD,P004887,0 days 00:16:03,-5,29,34
110,MAD,PBMT,0 days 00:15:30,8,41,33
110,MAD,PTGB,0 days 00:15:25,-5,28,33
110,MAD,P009213,0 days 00:05:48,1,12,11
111,PAR,P008987,0 days 00:35:17,13,75,62
111,PAR,P007400,0 days 00:29:29,10,59,49
111,PAR,P009862,0 days 00:29:27,10,61,51
111,PAR,P011051,0 days 00:24:58,8,47,39
111,PAR,P012096,0 days 00:22:58,0,49,49
111,PAR,P012742,0 days 00:21:34,8,47,39
111,PAR,P000956,0 days 00:12:27,10,24,14
111,PAR,P004058,0 days 00:10:49,11,23,12
111,PAR,P004172,0 days 00:07:54,-2,15,17
111,PAR,P003983,0 days 00:05:07,-3,10,13
111,MIL,P007831,0 days 00:33:27,-3,65,68
111,MIL,P002849,0 days 00:29:45,4,59,55
111,MIL,P002812,0 days 00:25:17,-6,40,46
111,MIL,P007032,0 days 00:24:49,-5,44,49
111,MIL,P011205,0 days 00:23:28,-12,35,47
111,MIL,P006509,0 days 00:21:07,-16,30,46
111,MIL,P007201,0 days 00:18:30,-21,26,47
111,MIL,P005670,0 days 00:14:10,-6,25,31
111,MIL,P001518,0 days 00:04:19,-1,8,9
111,MIL,P009960,0 days 00:02:47,3,8,5
111,MIL,P011926,0 days 00:02:21,-2,5,7
112,OLY,P008829,0 days 00:31:36,3,60,57
112,OLY,P008855,0 days 00:30:00,12,60,48
112,OLY,P001255,0 days 00:26:36,15,51,36
112,OLY,P008811,0 days 00:21:36,2,36,34
112,OLY,P010612,0 days 00:21:04,11,39,28
112,OLY,P010392,0 days 00:20:00,-6,40,46
112,OLY,P003941,0 days 00:18:24,6,41,35
112,OLY,P011983,0 days 00:13:24,-7,26,33
112,OLY,P006589,0 days 00:08:24,5,17,12
112,OLY,P007853,0 days 00:06:05,1,11,10
112,OLY,P006302,0 days 00:02:51,-2,4,6
112,MUN,P011987,0 days 00:22:14,-12,32,44
112,MUN,P007975,0 days 00:20:58,-2,42,44
112,MUN,P007056,0 days 00:20:46,-6,29,35
112,MUN,P006760,0 days 00:20:08,3,34,31
112,MUN,P010391,0 days 00:18:43,-7,31,38
112,MUN,P006543,0 days 00:18:38,0,40,40
112,MUN,P005460,0 days 00:16:40,12,36,24
112,MUN,P012123,0 days 00:15:46,3,35,32
112,MUN,P007639,0 days 00:15:22,-15,21,36
112,MUN,P001557,0 days 00:15:02,-12,17,29
112,MUN,P011941,0 days 00:07:58,-5,12,17
112,MUN,P006245,0 days 00:07:45,1,16,15
113,BAR,P002939,0 days 00:27:16,11,62,51
113,BAR,P012745,0 days 00:24:25,10,61,51
113,BAR,P004866,0 days 00:22:50,8,53,45
113,BAR,P003196,0 days 00:20:57,-6,49,55
113,BAR,P006435,0 days 00:20:21,18,42,24
113,BAR,P000925,0 days 00:19:03,14,40,26
113,BAR,P003478,0 days 00:17:05,-3,43,46
113,BAR,P007464,0 days 00:16:13,1,35,34
113,BAR,P011244,0 days 00:15:35,-2,28,30
113,BAR,P007519,0 days 00:12:44,-3,27,30
113,BAR,P009992,0 days 00:03:31,-8,5,13
113,ULK,P008962,0 days 00:38:40,-4,81,85
113,ULK,P010560,0 days 00:31:04,-12,58,70
113,ULK,P009849,0 days 00:30:24,1,75,74
113,ULK,P011157,0 days 00:27:56,-12,51,63
113,ULK,P006661,0 days 00:22:59,-2,55,57
113,ULK,P004004,0 days 00:13:03,-13,16,29
113,ULK,P002968,0 days 00:12:01,4,30,26
113,ULK,P011052,0 days 00:09:39,2,16,14
113,ULK,P006961,0 days 00:07:53,4,19,15
113,ULK,P001932,0 days 00:04:58,-4,4,8
113,ULK,P011980,0 days 00:01:23,-4,0,4
114,ASV,P012080,0 days 00:30:23,-12,50,62
114,ASV,P004194,0 days 00:29:44,-26,40,66
114,ASV,P006568,0 days 00:24:59,-4,36,40
114,ASV,P011225,0 days 00:24:42,-16,36,52
114,ASV,P002100,0 days 00:24:16,-18,34,52
114,ASV,PKIR,0 days 00:18:38,-14,19,33
114,ASV,P012729,0 days 00:17:26,-6,27,33
114,ASV,P003526,0 days 00:16:11,-8,21,29
114,ASV,P000229,0 days 00:07:41,-9,5,14
114,ASV,P012730,0 days 00:06:00,-2,7,9
114,PAM,P010568,0 days 00:23:59,12,48,36
114,PAM,P011982,0 days 00:21:53,14,43,29
114,PAM,P003960,0 days 00:20:38,15,40,25
114,PAM,P012739,0 days 00:19:38,-7,30,37
114,PAM,P006643,0 days 00:18:58,17,40,23
114,PAM,P004863,0 days 00:18:54,22,42,20
114,PAM,P012738,0 days 00:17:44,3,32,29
114,PAM,P007870,0 days 00:17:30,26,42,16
114,PAM,P012740,0 days 00:16:08,7,28,21
114,PAM,P011970,0 days 00:12:31,3,24,21
114,PAM,P000556,0 days 00:07:37,-6,9,15
114,PAM,P010393,0 days 00:04:30,9,12,3
115,BAS,P009048,0 days 00:29:54,4,61,57
115,BAS,P007230,0 days 00:28:18,1,66,65
115,BAS,P004603,0 days 00:27:48,7,53,46
115,BAS,P011085,0 days 00:26:25,-2,49,51
115,BAS,P004761,0 days 00:23:47,6,50,44
115,BAS,P012201,0 days 00:16:20,-2,32,34
115,BAS,P011948,0 days 00:13:46,0,39,39
115,BAS,P003198,0 days 00:13:06,8,36,28
115,BAS,P012765,0 days 00:10:06,-2,26,28
115,BAS,P008072,0 days 00:08:40,-4,21,25
115,BAS,P008850,0 days 00:01:50,-6,2,8
115,RED,P006436,0 days 00:33:16,5,74,69
115,RED,P009035,0 days 00:27:23,-5,50,55
115,RED,PJDR,0 days 00:27:21,3,57,54
115,RED,P002553,0 days 00:23:12,9,52,43
115,RED,P000848,0 days 00:21:39,-14,33,47
115,RED,PLUO,0 days 00:18:18,10,53,43
115,RED,P007960,0 days 00:16:45,-9,33,42
115,RED,P008966,0 days 00:12:37,3,35,32
115,RED,P012044,0 days 00:12:19,-5,28,33
115,RED,P004720,0 days 00:07:10,-7,10,17
116,VIR,P001133,0 days 00:33:52,16,86,70
116,VIR,P001844,0 days 00:29:21,7,78,71
116,VIR,PBCN,0 days 00:26:04,9,70,61
116,VIR,P003048,0 days 00:25:08,5,68,63
116,VIR,P010781,0 days 00:21:09,-5,44,49
116,VIR,P004007,0 days 00:16:51,4,37,33
116,VIR,P011192,0 days 00:16:38,5,37,32
116,VIR,P008847,0 days 00:14:36,0,33,33
116,VIR,P009549,0 days 00:13:30,9,39,30
116,VIR,P012714,0 days 00:02:51,0,8,8
116,TEL,P009622,0 days 00:34:16,-7,80,87
116,TEL,P009863,0 days 00:30:02,-12,65,77
116,TEL,P009783,0 days 00:26:48,-13,52,65
116,TEL,P011199,0 days 00:23:16,-7,51,58
116,TEL,P011193,0 days 00:22:11,5,51,46
116,TEL,P011214,0 days 00:20:44,-3,50,53
116,TEL,P011219,0 days 00:16:51,-1,41,42
116,TEL,P012744,0 days 00:13:23,-2,36,38
116,TEL,P005145,0 days 00:07:32,-8,15,23
116,TEL,P004233,0 days 00:04:57,-2,9,11
117,ZAL,P002329,0 days 00:35:05,-6,67,73
117,ZAL,P007513,0 days 00:29:35,-1,54,55
117,ZAL,P007109,0 days 00:27:28,2,56,54
117,ZAL,P011218,0 days 00:26:40,-1,56,57
117,ZAL,P003211,0 days 00:20:21,-2,46,48
117,ZAL,P005504,0 days 00:19:58,8,39,31
117,ZAL,P012787,0 days 00:15:48,-8,35,43
117,ZAL,P010390,0 days 00:15:05,-10,21,31
117,ZAL,P006860,0 days 00:10:00,-2,21,23
117,MCO,P005985,0 days 00:32:40,-1,66,67
117,MCO,P011212,0 days 00:29:54,-3,63,66
117,MCO,P011226,0 days 00:26:20,5,61,56
117,MCO,P010588,0 days 00:25:18,-8,48,56
117,MCO,P011231,0 days 00:21:40,3,43,40
117,MCO,PLCZ,0 days 00:15:05,5,25,20
117,MCO,P004790,0 days 00:14:52,8,35,27
117,MCO,P008099,0 days 00:11:25,6,24,18
117,MCO,P002581,0 days 00:09:16,-2,20,22
117,MCO,P012709,0 days 00:07:20,5,17,12
117,MCO,P011196,0 days 00:06:10,2,13,11
118,ASV,P012080,0 days 00:31:21,-1,65,66
118,ASV,P004194,0 days 00:26:32,-2,55,57
118,ASV,P003526,0 days 00:25:56,-2,54,56
118,ASV,P002100,0 days 00:22:58,-7,48,55
118,ASV,P006568,0 days 00:21:51,-3,45,48
118,ASV,P011225,0 days 00:18:02,-9,34,43
118,ASV,P012729,0 days 00:16:24,-11,30,41
118,ASV,P012730,0 days 00:14:50,0,32,32
118,ASV,P000229,0 days 00:14:44,2,31,29
118,ASV,PKIR,0 days 00:07:22,-7,11,18
118,PAN,P001926,0 days 00:34:20,9,81,72
118,PAN,P007866,0 days 00:28:14,0,61,61
118,PAN,P002328,0 days 00:27:23,10,66,56
118,PAN,P011204,0 days 00:25:35,4,59,55
118,PAN,P003842,0 days 00:25:20,9,60,51
118,PAN,P012774,0 days 00:24:19,10,52,42
118,PAN,P012712,0 days 00:12:53,4,28,24
118,PAN,P011221,0 days 00:07:22,2,17,15
118,PAN,P007947,0 days 00:07:16,-5,9,14
118,PAN,P007553,0 days 00:07:12,-3,12,15
118,PAN,P011209,0 days 00:00:06,0,0,0
119,MAD,P005928,0 days 00:23:57,8,48,40
119,MAD,P005791,0 days 00:21:28,3,44,41
119,MAD,P003108,0 days 00:20:16,6,46,40
119,MAD,PTGB,0 days 00:19:30,13,46,33
119,MAD,P009005,0 days 00:18:37,15,48,33
119,MAD,P004887,0 days 00:18:32,12,44,32
119,MAD,P001392,0 days 00:17:23,-4,34,38
119,MAD,PBMT,0 days 00:15:54,12,36,24
119,MAD,P006540,0 days 00:15:03,3,31,28
119,MAD,P009213,0 days 00:14:42,1,27,26
119,MAD,PCVM,0 days 00:14:38,6,36,30
119,MUN,P003583,0 days 00:29:04,-11,52,63
119,MUN,P011987,0 days 00:28:52,-2,59,61
119,MUN,P006760,0 days 00:27:01,-6,53,59
119,MUN,P008985,0 days 00:23:02,-11,40,51
119,MUN,P007056,0 days 00:20:16,-6,39,45
119,MUN,P010391,0 days 00:19:47,-12,34,46
119,MUN,P007975,0 days 00:16:58,-4,33,37
119,MUN,P001557,0 days 00:15:08,-13,22,35
119,MUN,P006543,0 days 00:14:52,-6,26,32
119,MUN,P007639,0 days 00:05:00,-4,7,11
120,BAS,P009048,0 days 00:32:54,-5,68,73
120,BAS,P012201,0 days 00:26:45,0,57,57
120,BAS,P004761,0 days 00:25:18,5,64,59
120,BAS,P004603,0 days 00:22:58,-9,44,53
120,BAS,P011085,0 days 00:22:53,-6,51,57
120,BAS,P011948,0 days 00:19:21,-7,32,39
120,BAS,P007230,0 days 00:16:53,-12,33,45
120,BAS,P008072,0 days 00:14:51,0,29,29
120,BAS,P012765,0 days 00:07:06,-5,13,18
120,BAS,P008850,0 days 00:06:15,-4,8,12
120,BAS,P003198,0 days 00:04:46,-7,6,13
120,VIR,P001133,0 days 00:29:15,12,71,59
120,VIR,PBCN,0 days 00:28:42,20,76,56
120,VIR,P001844,0 days 00:28:12,12,65,53
120,VIR,P009549,0 days 00:23:25,17,59,42
120,VIR,P003048,0 days 00:21:05,1,41,40
120,VIR,P012714,0 days 00:16:44,8,41,33
120,VIR,P006739,0 days 00:16:08,-3,37,40
120,VIR,P010781,0 days 00:12:15,-6,21,27
120,VIR,P003527,0 days 00:09:45,7,25,18
120,VIR,P002084,0 days 00:07:17,-6,11,17
120,VIR,P004007,0 days 00:07:12,-12,8,20
121,ZAL,P011218,0 days 00:35:16,3,79,76
121,ZAL,P007109,0 days 00:34:17,-6,72,78
121,ZAL,P003211,0 days 00:29:42,8,71,63
121,ZAL,P002329,0 days 00:26:44,-8,50,58
121,ZAL,P007513,0 days 00:17:44,-21,29,50
121,ZAL,P006860,0 days 00:16:02,12,39,27
121,ZAL,P010390,0 days 00:15:48,-3,38,41
121,ZAL,P009917,0 days 00:10:44,-11,18,29
121,ZAL,P012787,0 days 00:07:02,1,21,20
121,ZAL,P005504,0 days 00:06:41,-15,8,23
121,PAR,P009862,0 days 00:35:07,11,84,73
121,PAR,P012742,0 days 00:33:41,3,79,76
121,PAR,P008987,0 days 00:31:00,0,63,63
121,PAR,P007400,0 days 00:29:29,5,71,66
121,PAR,P012096,0 days 00:23:37,-4,52,56
121,PAR,P011051,0 days 00:22:21,9,46,37
121,PAR,P004172,0 days 00:11:35,0,23,23
121,PAR,P009212,0 days 00:06:45,8,25,17
121,PAR,P011050,0 days 00:06:22,8,22,14
121,PAR,P000956,0 days 00:00:03,0,0,0
122,TEL,P009622,0 days 00:29:51,7,73,66
122,TEL,P009783,0 days 00:27:44,2,64,62
122,TEL,P011193,0 days 00:24:10,11,66,55
122,TEL,P011199,0 days 00:22:41,9,55,46
122,TEL,P011971,0 days 00:20:56,14,61,47
122,TEL,P009863,0 days 00:19:51,-10,36,46
122,TEL,P011214,0 days 00:16:45,4,40,36
122,TEL,P011219,0 days 00:16:00,4,31,27
122,TEL,P005145,0 days 00:11:46,-1,21,22
122,TEL,P012744,0 days 00:10:16,5,28,23
122,IST,P011078,0 days 00:36:39,-5,83,88
122,IST,P007200,0 days 00:33:42,0,71,71
122,IST,P011981,0 days 00:28:43,-4,57,61
122,IST,P012710,0 days 00:27:57,-11,55,66
122,IST,P012786,0 days 00:27:28,5,60,55
122,IST,P010516,0 days 00:17:35,-19,33,52
122,IST,P012788,0 days 00:13:08,-1,34,35
122,IST,P009513,0 days 00:11:58,-10,29,39
122,IST,P004093,0 days 00:01:33,-1,5,6
122,IST,P012415,0 days 00:01:17,1,3,2
123,ULK,P008962,0 days 00:34:34,7,70,63
123,ULK,P001932,0 days 00:26:56,9,58,49
123,ULK,P004004,0 days 00:26:46,4,57,53
123,ULK,P006661,0 days 00:24:56,4,53,49
123,ULK,P002968,0 days 00:23:20,12,50,38
123,ULK,P010560,0 days 00:14:59,6,32,26
123,ULK,P011157,0 days 00:14:33,6,32,26
123,ULK,P009849,0 days 00:14:00,10,33,23
123,ULK,P011052,0 days 00:13:04,3,28,25
123,ULK,P011980,0 days 00:06:52,-1,17,18
123,MCO,P005985,0 days 00:34:32,-13,58,71
123,MCO,P011226,0 days 00:33:32,-6,65,71
123,MCO,P011212,0 days 00:27:11,-9,48,57
123,MCO,PLCZ,0 days 00:24:55,-6,45,51
123,MCO,P011231,0 days 00:22:46,-3,42,45
123,MCO,P010588,0 days 00:21:40,-10,43,53
123,MCO,P011196,0 days 00:13:10,-5,25,30
123,MCO,P012709,0 days 00:10:43,-4,20,24
123,MCO,P012515,0 days 00:07:35,1,22,21
123,MCO,P004790,0 days 00:03:56,-5,2,7
124,RED,P006436,0 days 00:29:42,12,68,56
124,RED,P009035,0 days 00:23:30,19,60,41
124,RED,P012044,0 days 00:21:56,6,44,38
124,RED,P000848,0 days 00:21:37,18,55,37
124,RED,P007960,0 days 00:20:50,3,42,39
124,RED,PJDR,0 days 00:18:04,8,41,33
124,RED,P011224,0 days 00:15:33,2,30,28
124,RED,P002553,0 days 00:14:55,7,33,26
124,RED,P008966,0 days 00:13:40,1,25,24
124,RED,PLUO,0 days 00:13:08,-4,17,21
124,RED,P012711,0 days 00:07:05,-2,10,12
124,BER,P003958,0 days 00:25:44,-14,41,55
124,BER,P011934,0 days 00:22:30,-9,36,45
124,BER,P008173,0 days 00:20:16,-4,35,39
124,BER,P008211,0 days 00:19:44,-10,36,46
124,BER,P008967,0 days 00:19:22,-6,35,41
124,BER,P012720,0 days 00:19:04,-11,34,45
124,BER,P006251,0 days 00:18:11,-4,36,40
124,BER,P006919,0 days 00:17:37,-6,33,39
124,BER,P008384,0 days 00:16:30,-6,29,35
124,BER,P012721,0 days 00:11:51,2,26,24
124,BER,P007025,0 days 00:04:37,-5,5,10
124,BER,P006819,0 days 00:04:34,3,9,6
125,BAR,P002939,0 days 00:26:02,-4,59,63
125,BAR,P004866,0 days 00:24:29,1,63,62
125,BAR,P006435,0 days 00:23:28,-1,46,47
125,BAR,P003478,0 days 00:23:26,2,45,43
125,BAR,P007464,0 days 00:21:40,2,42,40
125,BAR,P000925,0 days 00:18:52,8,41,33
125,BAR,P009992,0 days 00:15:35,-4,45,49
125,BAR,P003196,0 days 00:14:45,-11,37,48
125,BAR,P007519,0 days 00:13:41,-2,24,26
125,BAR,P011244,0 days 00:11:39,-10,20,30
125,BAR,P010641,0 days 00:06:23,-1,8,9
125,MIL,P005670,0 days 00:32:42,8,72,64
125,MIL,P007831,0 days 00:31:45,4,78,74
125,MIL,P002849,0 days 00:28:40,3,69,66
125,MIL,P007201,0 days 00:25:10,10,56,46
125,MIL,P011205,0 days 00:24:11,-3,62,65
125,MIL,P001518,0 days 00:17:02,5,30,25
125,MIL,P006509,0 days 00:13:10,-4,26,30
125,MIL,P009960,0 days 00:13:09,-3,26,29
125,MIL,P002812,0 days 00:11:48,0,27,27
125,MIL,P006701,0 days 00:02:23,0,4,4
126,OLY,P008855,0 days 00:35:05,-1,50,51
126,OLY,P001255,0 days 00:30:00,3,45,42
126,OLY,P010612,0 days 00:30:00,3,45,42
126,OLY,P008811,0 days 00:26:35,6,46,40
126,OLY,P006589,0 days 00:16:11,2,24,22
126,OLY,P010392,0 days 00:14:57,-13,14,27
126,OLY,P003941,0 days 00:13:25,-13,10,23
126,OLY,P007853,0 days 00:12:15,-1,21,22
126,OLY,P011983,0 days 00:08:36,-5,12,17
126,OLY,P011194,0 days 00:08:01,-10,7,17
126,OLY,P007982,0 days 00:04:55,-6,6,12
126,PAM,P010568,0 days 00:29:57,3,48,45
126,PAM,P000556,0 days 00:25:07,-8,36,44
126,PAM,P007870,0 days 00:20:14,12,36,24
126,PAM,P004863,0 days 00:19:27,12,36,24
126,PAM,P012739,0 days 00:17:33,-7,22,29
126,PAM,P006643,0 days 00:16:37,10,27,17
126,PAM,P008780,0 days 00:15:42,5,24,19
126,PAM,P012740,0 days 00:14:50,-4,18,22
126,PAM,P012738,0 days 00:14:40,-5,20,25
126,PAM,P003960,0 days 00:14:08,13,33,20
126,PAM,P010393,0 days 00:11:45,4,15,11
127,BER,P003958,0 days 00:29:18,3,58,55
127,BER,P008967,0 days 00:25:26,9,54,45
127,BER,P011934,0 days 00:24:13,3,49,46
127,BER,P012720,0 days 00:21:39,2,41,39
127,BER,P008384,0 days 00:20:52,-4,33,37
127,BER,P008173,0 days 00:20:24,8,38,30
127,BER,P008211,0 days 00:19:36,-4,36,40
127,BER,P006251,0 days 00:12:46,5,20,15
127,BER,P007025,0 days 00:12:03,1,20,19
127,BER,P010791,0 days 00:08:56,2,14,12
127,BER,P012721,0 days 00:04:47,-5,7,12
127,BAR,P002939,0 days 00:26:19,3,50,47
127,BAR,P006435,0 days 00:25:30,-2,50,52
127,BAR,P000925,0 days 00:24:12,7,51,44
127,BAR,P004866,0 days 00:22:58,13,46,33
127,BAR,P012745,0 days 00:19:38,1,37,36
127,BAR,P011244,0 days 00:18:59,-5,31,36
127,BAR,P009992,0 days 00:14:48,-3,20,23
127,BAR,P003196,0 days 00:14:22,-11,17,28
127,BAR,P007519,0 days 00:13:23,-6,20,26
127,BAR,P007464,0 days 00:13:17,-13,16,29
127,BAR,P003204,0 days 00:05:11,-4,10,14
127,BAR,P010641,0 days 00:01:23,0,2,2
128,RED,P009035,0 days 00:30:11,-9,39,48
128,RED,P002553,0 days 00:24:05,-8,35,43
128,RED,P012044,0 days 00:20:33,-2,31,33
128,RED,PJDR,0 days 00:20:19,-15,29,44
128,RED,P007960,0 days 00:20:19,-10,27,37
128,RED,P005099,0 days 00:19:40,-1,32,33
128,RED,P000848,0 days 00:17:04,-10,24,34
128,RED,P006436,0 days 00:15:45,-10,21,31
128,RED,PLUO,0 days 00:15:32,-1,20,21
128,RED,P012711,0 days 00:08:35,-4,15,19
128,RED,P008966,0 days 00:06:02,-5,12,17
128,RED,P004720,0 days 00:01:55,5,5,0
128,MAD,P003108,0 days 00:30:54,25,62,37
128,MAD,P005928,0 days 00:24:14,1,36,35
128,MAD,PTGB,0 days 00:22:00,16,46,30
128,MAD,P009213,0 days 00:20:53,-1,35,36
128,MAD,P005791,0 days 00:19:55,5,36,31
128,MAD,P006540,0 days 00:19:03,-2,27,29
128,MAD,PCVM,0 days 00:18:25,12,38,26
128,MAD,P003733,0 days 00:18:24,11,36,25
128,MAD,P004887,0 days 00:18:15,12,36,24
128,MAD,P001392,0 days 00:06:14,-6,8,14
128,MAD,P011649,0 days 00:01:43,-3,0,3
129,TEL,P009622,0 days 00:31:12,-1,64,65
129,TEL,P011971,0 days 00:29:12,14,70,56
129,TEL,P009863,0 days 00:26:36,18,66,48
129,TEL,P009783,0 days 00:25:41,11,54,43
129,TEL,P011193,0 days 00:20:45,-1,48,49
129,TEL,P011199,0 days 00:19:15,1,37,36
129,TEL,P011219,0 days 00:17:21,9,48,39
129,TEL,P011214,0 days 00:15:21,-10,25,35
129,TEL,P005145,0 days 00:07:35,2,17,15
129,TEL,P012744,0 days 00:07:02,-3,16,19
129,BAS,P004761,0 days 00:34:24,2,71,69
129,BAS,P009048,0 days 00:33:08,-15,61,76
129,BAS,P007230,0 days 00:31:11,-5,62,67
129,BAS,P011948,0 days 00:24:01,-6,50,56
129,BAS,P012201,0 days 00:22:29,3,50,47
129,BAS,P004603,0 days 00:20:46,6,49,43
129,BAS,P012765,0 days 00:13:12,6,32,26
129,BAS,P008072,0 days 00:09:23,-14,13,27
129,BAS,P011085,0 days 00:05:46,-10,8,18
129,BAS,P003198,0 days 00:05:40,-7,9,16
130,PAM,P010568,0 days 00:30:07,1,56,55
130,PAM,P007870,0 days 00:28:50,0,53,53
130,PAM,P003960,0 days 00:23:17,-14,35,49
130,PAM,P012740,0 days 00:19:12,10,41,31
130,PAM,P004863,0 days 00:19:10,-12,26,38
130,PAM,P006643,0 days 00:16:30,-4,28,32
130,PAM,P000556,0 days 00:15:49,-11,19,30
130,PAM,P010393,0 days 00:13:32,14,31,17
130,PAM,P005356,0 days 00:12:53,1,18,17
130,PAM,P012739,0 days 00:11:10,-5,14,19
130,PAM,P012738,0 days 00:07:24,-4,10,14
130,PAM,P008780,0 days 00:02:06,-1,4,5
130,PAR,P009862,0 days 00:34:23,5,60,55
130,PAR,P008987,0 days 00:32:08,7,61,54
130,PAR,P007400,0 days 00:30:35,2,55,53
130,PAR,P012742,0 days 00:22:49,16,46,30
130,PAR,P011051,0 days 00:22:44,7,44,37
130,PAR,P012743,0 days 00:14:28,-6,20,26
130,PAR,P004172,0 days 00:12:45,-2,21,23
130,PAR,P012096,0 days 00:12:13,7,25,18
130,PAR,P009212,0 days 00:07:52,-2,11,13
130,PAR,P000956,0 days 00:05:15,-5,10,15
130,PAR,P004058,0 days 00:04:48,-4,7,11
131,VIR,P001133,0 days 00:29:39,3,51,48
131,VIR,P009549,0 days 00:28:43,9,51,42
131,VIR,P001844,0 days 00:25:16,5,42,37
131,VIR,P003048,0 days 00:24:40,-6,39,45
131,VIR,PBCN,0 days 00:21:24,-1,37,38
131,VIR,P004007,0 days 00:17:10,4,31,27
131,VIR,P006739,0 days 00:14:44,-3,27,30
131,VIR,P010781,0 days 00:13:14,-8,19,27
131,VIR,P012714,0 days 00:10:34,9,24,15
131,VIR,P003527,0 days 00:08:07,4,16,12
131,VIR,P002084,0 days 00:06:29,-6,8,14
131,OLY,P008829,0 days 00:28:17,-3,45,48
131,OLY,P008855,0 days 00:25:00,-8,39,47
131,OLY,P003941,0 days 00:23:15,-2,38,40
131,OLY,P010612,0 days 00:20:43,-3,36,39
131,OLY,P007982,0 days 00:20:37,-2,33,35
131,OLY,P001255,0 days 00:20:00,-2,34,36
131,OLY,P008811,0 days 00:16:45,0,29,29
131,OLY,P010392,0 days 00:15:45,-1,26,27
131,OLY,P011983,0 days 00:14:23,8,28,20
131,OLY,P011194,0 days 00:11:43,1,22,21
131,OLY,P007853,0 days 00:03:32,2,5,3
132,MCO,P011226,0 days 00:31:05,-2,67,69
132,MCO,P005985,0 days 00:30:54,-9,68,77
132,MCO,P010588,0 days 00:27:10,-8,57,65
132,MCO,P011212,0 days 00:25:16,10,66,56
132,MCO,PLCZ,0 days 00:20:31,-6,40,46
132,MCO,P011196,0 days 00:18:36,1,46,45
132,MCO,P004197,0 days 00:18:04,-10,31,41
132,MCO,P012709,0 days 00:14:41,8,38,30
132,MCO,P004790,0 days 00:13:37,10,36,26
132,MCO,P011231,0 days 00:00:06,1,1,0
132,PAN,P001926,0 days 00:31:26,16,80,64
132,PAN,P003842,0 days 00:28:12,4,67,63
132,PAN,P007866,0 days 00:26:35,-4,53,57
132,PAN,P007947,0 days 00:24:32,-3,54,57
132,PAN,P002328,0 days 00:24:31,6,58,52
132,PAN,P011204,0 days 00:20:16,-4,42,46
132,PAN,P012774,0 days 00:20:11,-6,46,52
132,PAN,P012712,0 days 00:12:53,1,34,33
132,PAN,P011221,0 days 00:07:05,0,14,14
132,PAN,P007553,0 days 00:04:19,-5,7,12
133,MIL,P011205,0 days 00:28:19,22,67,45
133,MIL,P007831,0 days 00:27:51,20,62,42
133,MIL,P005670,0 days 00:23:52,12,45,33
133,MIL,P002849,0 days 00:21:48,8,43,35
133,MIL,P007201,0 days 00:20:59,26,53,27
133,MIL,P005775,0 days 00:19:03,7,40,33
133,MIL,P006509,0 days 00:17:40,2,30,28
133,MIL,P002812,0 days 00:15:17,12,35,23
133,MIL,P009960,0 days 00:10:40,-4,18,22
133,MIL,P011926,0 days 00:08:26,0,13,13
133,MIL,P006701,0 days 00:03:15,6,8,2
133,MIL,P006721,0 days 00:02:50,4,6,2
133,ASV,P012080,0 days 00:28:12,-22,41,63
133,ASV,P011225,0 days 00:27:15,-20,40,60
133,ASV,P004194,0 days 00:25:13,-33,32,65
133,ASV,P003526,0 days 00:23:33,-12,35,47
133,ASV,PKIR,0 days 00:20:02,-14,29,43
133,ASV,P012730,0 days 00:19:55,-6,31,37
133,ASV,P012729,0 days 00:18:43,6,33,27
133,ASV,P000229,0 days 00:16:50,-2,28,30
133,ASV,P006568,0 days 00:16:49,-15,26,41
133,ASV,P002100,0 days 00:03:28,3,10,7
134,MUN,P003583,0 days 00:27:16,22,61,39
134,MUN,P007056,0 days 00:26:08,-2,49,51
134,MUN,P006760,0 days 00:23:09,15,45,30
134,MUN,P011987,0 days 00:22:50,15,51,36
134,MUN,P008985,0 days 00:21:44,15,43,28
134,MUN,P007975,0 days 00:18:30,3,46,43
134,MUN,P010391,0 days 00:14:21,8,33,25
134,MUN,P004508,0 days 00:13:37,-5,28,33
134,MUN,P001288,0 days 00:13:08,10,35,25
134,MUN,P005460,0 days 00:07:15,-3,11,14
134,MUN,P001557,0 days 00:06:03,-3,15,18
134,MUN,P006543,0 days 00:05:59,0,13,13
134,IST,P012786,0 days 00:35:22,-8,62,70
134,IST,P007200,0 days 00:33:18,-13,58,71
134,IST,P011078,0 days 00:28:22,-8,51,59
134,IST,P012788,0 days 00:27:09,0,55,55
134,IST,P009846,0 days 00:24:45,-12,48,60
134,IST,P011981,0 days 00:24:20,-9,45,54
134,IST,P010516,0 days 00:12:27,-4,20,24
134,IST,P009513,0 days 00:11:31,-16,14,30
134,IST,P004554,0 days 00:02:46,-5,2,7
135,ULK,P008962,0 days 00:32:09,7,69,62
135,ULK,P006661,0 days 00:27:31,16,62,46
135,ULK,P011157,0 days 00:25:26,17,58,41
135,ULK,P010560,0 days 00:23:23,-10,38,48
135,ULK,P009849,0 days 00:23:19,3,48,45
135,ULK,P004004,0 days 00:22:43,6,49,43
135,ULK,P001932,0 days 00:20:22,-5,38,43
135,ULK,P002968,0 days 00:08:10,-5,15,20
135,ULK,P011052,0 days 00:05:11,-7,7,14
135,ULK,P005844,0 days 00:04:22,-4,7,11
135,ULK,P011980,0 days 00:03:47,-5,4,9
135,ULK,P006961,0 days 00:03:37,-3,5,8
135,ZAL,P007109,0 days 00:33:47,-3,64,67
135,ZAL,P011218,0 days 00:32:59,-7,62,69
135,ZAL,P002329,0 days 00:28:46,-7,52,59
135,ZAL,P005504,0 days 00:20:40,-18,32,50
135,ZAL,P003211,0 days 00:20:12,11,44,33
135,ZAL,P009917,0 days 00:17:08,-13,29,42
135,ZAL,P010390,0 days 00:14:52,11,34,23
135,ZAL,P012787,0 days 00:12:57,4,29,25
135,ZAL,P007513,0 days 00:09:56,9,24,15
135,ZAL,P006860,0 days 00:08:43,3,20,17
136,TEL,P009622,0 days 00:30:14,2,74,72
136,TEL,P009863,0 days 00:27:49,-6,61,67
136,TEL,P009783,0 days 00:25:22,-2,54,56
136,TEL,P011199,0 days 00:25:21,-7,55,62
136,TEL,P011193,0 days 00:24:36,-4,59,63
136,TEL,P011971,0 days 00:14:05,-10,31,41
136,TEL,P011219,0 days 00:13:05,-5,32,37
136,TEL,P011214,0 days 00:12:07,-5,29,34
136,TEL,P012744,0 days 00:11:50,-4,29,33
136,TEL,P005145,0 days 00:09:02,5,19,14
136,TEL,P004233,0 days 00:06:29,6,17,11
136,RED,P006436,0 days 00:32:10,1,72,71
136,RED,PJDR,0 days 00:28:45,20,83,63
136,RED,P009035,0 days 00:26:39,5,65,60
136,RED,P005099,0 days 00:21:23,-6,53,59
136,RED,P002553,0 days 00:15:38,1,38,37
136,RED,P007960,0 days 00:15:37,4,40,36
136,RED,PLUO,0 days 00:14:41,5,32,27
136,RED,P008966,0 days 00:13:21,1,33,32
136,RED,P000848,0 days 00:12:49,2,34,32
136,RED,P012711,0 days 00:11:27,9,32,23
136,RED,P012044,0 days 00:07:30,-12,8,20
137,MAD,P009213,0 days 00:25:20,11,60,49
137,MAD,PCVM,0 days 00:23:34,-3,42,45
137,MAD,P001392,0 days 00:23:00,18,63,45
137,MAD,PBMT,0 days 00:20:38,-13,32,45
137,MAD,P005928,0 days 00:19:52,21,55,34
137,MAD,P006540,0 days 00:19:22,29,59,30
137,MAD,P005791,0 days 00:18:55,18,49,31
137,MAD,P004887,0 days 00:18:01,3,38,35
137,MAD,P003108,0 days 00:17:20,0,35,35
137,MAD,PTGB,0 days 00:13:30,-4,22,26
137,MAD,P010623,0 days 00:00:28,0,0,0
137,PAR,P004172,0 days 00:26:34,3,56,53
137,PAR,P007400,0 days 00:23:24,-9,45,54
137,PAR,P009862,0 days 00:23:15,-27,36,63
137,PAR,P012096,0 days 00:23:07,-12,44,56
137,PAR,P011051,0 days 00:22:50,-8,39,47
137,PAR,P008987,0 days 00:19:36,-21,30,51
137,PAR,P004058,0 days 00:16:53,2,31,29
137,PAR,P012742,0 days 00:13:26,-19,19,38
137,PAR,P009212,0 days 00:12:11,8,30,22
137,PAR,P000956,0 days 00:09:57,0,23,23
137,PAR,P011050,0 days 00:07:38,9,22,13
137,PAR,P012743,0 days 00:01:09,-6,0,6
138,PAM,P010568,0 days 00:26:59,8,55,47
138,PAM,P012740,0 days 00:25:47,6,49,43
138,PAM,P005356,0 days 00:22:33,11,50,39
138,PAM,P007870,0 days 00:21:31,7,49,42
138,PAM,P004863,0 days 00:21:02,12,44,32
138,PAM,P012739,0 days 00:18:29,1,30,29
138,PAM,P003960,0 days 00:18:12,19,43,24
138,PAM,P010393,0 days 00:15:43,-2,29,31
138,PAM,P006643,0 days 00:14:10,-3,25,28
138,PAM,P008780,0 days 00:09:33,-10,14,24
138,PAM,P012738,0 days 00:06:01,-9,7,16
138,VIR,P001133,0 days 00:31:56,4,60,56
138,VIR,P001844,0 days 00:30:33,-6,51,57
138,VIR,P009549,0 days 00:24:44,-4,44,48
138,VIR,PBCN,0 days 00:22:32,-8,39,47
138,VIR,P003048,0 days 00:21:18,-13,30,43
138,VIR,P010781,0 days 00:20:17,-3,36,39
138,VIR,P012714,0 days 00:18:27,7,41,34
138,VIR,P004007,0 days 00:13:47,-3,25,28
138,VIR,P006739,0 days 00:08:22,-2,18,20
138,VIR,P002084,0 days 00:08:04,-12,11,23
139,BER,P003958,0 days 00:27:10,-14,52,66
139,BER,P012720,0 days 00:27:10,-14,52,66
139,BER,P011934,0 days 00:24:59,0,53,53
139,BER,P008967,0 days 00:21:31,-3,45,48
139,BER,P008173,0 days 00:20:55,-11,36,47
139,BER,P008211,0 days 00:19:05,2,46,44
139,BER,P008384,0 days 00:18:33,4,43,39
139,BER,P006251,0 days 00:15:39,3,37,34
139,BER,P012721,0 days 00:12:46,-5,24,29
139,BER,P010791,0 days 00:12:12,-7,22,29
139,ULK,P008962,0 days 00:32:53,6,71,65
139,ULK,P010560,0 days 00:31:59,9,71,62
139,ULK,P001932,0 days 00:30:23,19,67,48
139,ULK,P006661,0 days 00:26:21,12,60,48
139,ULK,P011157,0 days 00:20:52,3,43,40
139,ULK,P009849,0 days 00:13:39,-3,31,34
139,ULK,P005844,0 days 00:13:23,7,35,28
139,ULK,P011052,0 days 00:09:37,-10,24,34
139,ULK,P004004,0 days 00:08:01,0,20,20
139,ULK,P011980,0 days 00:06:31,5,20,15
139,ULK,P002968,0 days 00:05:45,-1,13,14
139,ULK,P006961,0 days 00:00:36,-2,0,2
140,IST,P007200,0 days 00:33:58,-4,70,74
140,IST,P011078,0 days 00:29:19,-4,60,64
140,IST,P012788,0 days 00:26:32,5,53,48
140,IST,P009846,0 days 00:26:06,-9,44,53
140,IST,P006590,0 days 00:21:31,-9,46,55
140,IST,P012710,0 days 00:20:11,-13,38,51
140,IST,P011981,0 days 00:13:05,5,34,29
140,IST,P012786,0 days 00:11:05,-6,18,24
140,IST,P010516,0 days 00:07:54,4,20,16
140,IST,P009513,0 days 00:06:02,-3,10,13
140,IST,P004554,0 days 00:04:17,-1,7,8
140,BAS,P009048,0 days 00:36:19,8,80,72
140,BAS,P007230,0 days 00:30:41,8,70,62
140,BAS,P004761,0 days 00:28:59,10,61,51
140,BAS,P012201,0 days 00:23:57,-6,54,60
140,BAS,P011948,0 days 00:21:44,6,55,49
140,BAS,P004603,0 days 00:20:10,14,43,29
140,BAS,P011085,0 days 00:15:42,-3,37,40
140,BAS,P008850,0 days 00:11:22,1,17,16
140,BAS,P012765,0 days 00:05:34,1,11,10
140,BAS,P008072,0 days 00:05:32,-4,7,11
141,MIL,P011205,0 days 00:32:04,-11,49,60
141,MIL,P007831,0 days 00:31:21,-5,56,61
141,MIL,P002849,0 days 00:26:59,-2,45,47
141,MIL,P007201,0 days 00:26:25,-1,48,49
141,MIL,P006509,0 days 00:18:37,-2,33,35
141,MIL,P005670,0 days 00:15:38,-9,20,29
141,MIL,P005775,0 days 00:13:03,-7,24,31
141,MIL,P009960,0 days 00:12:37,-4,20,24
141,MIL,P002812,0 days 00:10:54,-2,20,22
141,MIL,P006701,0 days 00:09:17,10,22,12
141,MIL,P006721,0 days 00:02:11,-4,3,7
141,MIL,P011926,0 days 00:00:54,-3,0,3
141,PAN,P011204,0 days 00:32:07,12,66,54
141,PAN,P001926,0 days 00:32:06,3,57,54
141,PAN,P003842,0 days 00:28:22,-8,46,54
141,PAN,P012774,0 days 00:26:46,10,54,44
141,PAN,P007866,0 days 00:24:34,-2,40,42
141,PAN,P002328,0 days 00:22:28,-4,40,44
141,PAN,P012712,0 days 00:16:42,16,41,25
141,PAN,P007947,0 days 00:08:39,3,15,12
141,PAN,P011221,0 days 00:08:16,10,21,11
142,MUN,P007056,0 days 00:25:19,-19,43,62
142,MUN,P010391,0 days 00:25:18,-13,46,59
142,MUN,P007975,0 days 00:22:52,-4,46,50
142,MUN,P011987,0 days 00:22:49,-6,46,52
142,MUN,P001288,0 days 00:19:16,2,42,40
142,MUN,P006760,0 days 00:19:07,3,48,45
142,MUN,P003583,0 days 00:17:47,-10,24,34
142,MUN,P004508,0 days 00:16:21,-3,36,39
142,MUN,P008985,0 days 00:10:55,-13,19,32
142,MUN,P005478,0 days 00:08:29,2,24,22
142,MUN,P007639,0 days 00:06:44,0,16,16
142,MUN,P001557,0 days 00:05:03,6,10,4
142,MCO,P005985,0 days 00:31:19,10,75,65
142,MCO,P011231,0 days 00:28:16,9,62,53
142,MCO,P011226,0 days 00:27:53,2,66,64
142,MCO,P010588,0 days 00:26:46,4,60,56
142,MCO,P011212,0 days 00:24:18,2,59,57
142,MCO,P012709,0 days 00:17:37,8,35,27
142,MCO,P011196,0 days 00:15:17,1,37,36
142,MCO,PLCZ,0 days 00:13:00,4,25,21
142,MCO,P004790,0 days 00:08:48,13,23,10
142,MCO,P008099,0 days 00:06:46,2,13,11
143,ASV,P011225,0 days 00:35:41,-9,63,72
143,ASV,P004194,0 days 00:31:08,-4,52,56
143,ASV,P012729,0 days 00:27:48,-9,54,63
143,ASV,P012080,0 days 00:27:43,-11,49,60
143,ASV,P012730,0 days 00:19:18,-6,37,43
143,ASV,P006568,0 days 00:14:48,-1,25,26
143,ASV,P003526,0 days 00:14:11,-8,21,29
143,ASV,PKIR,0 days 00:14:04,-3,31,34
143,ASV,P000229,0 days 00:11:51,-1,28,29
143,ASV,P012731,0 days 00:02:57,-5,5,10
143,ASV,P011386,0 days 00:00:31,-3,0,3
143,OLY,P008811,0 days 00:33:58,10,70,60
143,OLY,P010612,0 days 00:30:00,7,61,54
143,OLY,P007982,0 days 00:25:58,7,57,50
143,OLY,P008829,0 days 00:25:12,8,52,44
143,OLY,P001255,0 days 00:18:57,5,43,38
143,OLY,P007853,0 days 00:18:00,5,36,31
143,OLY,P011194,0 days 00:14:48,4,33,29
143,OLY,P008855,0 days 00:14:02,5,28,23
143,OLY,P010392,0 days 00:10:00,7,26,19
143,OLY,P006589,0 days 00:05:00,3,12,9
143,OLY,P011983,0 days 00:03:03,0,4,4
143,OLY,P003941,0 days 00:01:02,-1,3,4
144,ZAL,P007109,0 days 00:31:31,10,67,57
144,ZAL,P002329,0 days 00:29:29,-12,54,66
144,ZAL,P011218,0 days 00:26:52,16,59,43
144,ZAL,P005504,0 days 00:24:21,-1,52,53
144,ZAL,P003211,0 days 00:22:40,-12,38,50
144,ZAL,P007513,0 days 00:16:55,7,37,30
144,ZAL,P009917,0 days 00:15:27,-5,30,35
144,ZAL,P010390,0 days 00:14:29,0,28,28
144,ZAL,P012787,0 days 00:09:04,-7,20,27
144,ZAL,P006860,0 days 00:06:43,-14,12,26
144,ZAL,P003210,0 days 00:02:29,-7,3,10
144,BAR,P004866,0 days 00:36:12,4,72,68
144,BAR,P006435,0 days 00:28:44,9,64,55
144,BAR,P012745,0 days 00:28:18,3,61,58
144,BAR,P002939,0 days 00:27:23,1,58,57
144,BAR,P000925,0 days 00:25:11,12,52,40
144,BAR,P007519,0 days 00:14:52,2,32,30
144,BAR,P011244,0 days 00:11:42,2,24,22
144,BAR,P009992,0 days 00:11:16,-4,21,25
144,BAR,P003196,0 days 00:10:16,-8,23,31
144,BAR,P010641,0 days 00:04:33,1,10,9
144,BAR,P007464,0 days 00:01:33,3,8,5
145,IST,P007200,0 days 00:35:20,-10,71,81
145,IST,P012788,0 days 00:29:50,1,63,62
145,IST,P012786,0 days 00:28:51,-1,60,61
145,IST,P011078,0 days 00:27:42,-2,63,65
145,IST,P006590,0 days 00:25:45,-10,46,56
145,IST,P009846,0 days 00:22:11,3,52,49
145,IST,P011981,0 days 00:15:53,-5,33,38
145,IST,P012710,0 days 00:07:57,5,23,18
145,IST,P004554,0 days 00:04:53,-6,7,13
145,IST,P009513,0 days 00:01:38,0,2,2
145,ULK,P008962,0 days 00:36:18,5,83,78
145,ULK,P006661,0 days 00:28:31,13,69,56
145,ULK,P001932,0 days 00:25:40,9,61,52
145,ULK,P006961,0 days 00:21:40,11,43,32
145,ULK,P005844,0 days 00:18:33,12,41,29
145,ULK,P004004,0 days 00:17:24,7,40,33
145,ULK,P010560,0 days 00:13:09,-3,33,36
145,ULK,P009849,0 days 00:11:24,-8,20,28
145,ULK,P002968,0 days 00:11:12,-10,22,32
145,ULK,P011157,0 days 00:09:54,-1,24,25
145,ULK,P011052,0 days 00:04:05,-7,6,13
145,ULK,P011980,0 days 00:02:10,-3,3,6
146,MIL,P002849,0 days 00:31:58,12,62,50
146,MIL,P011205,0 days 00:31:16,12,64,52
146,MIL,P005670,0 days 00:28:05,23,66,43
146,MIL,P007201,0 days 00:27:47,18,60,42
146,MIL,P002812,0 days 00:22:50,7,42,35
146,MIL,P006509,0 days 00:21:59,-7,35,42
146,MIL,P009960,0 days 00:16:22,2,30,28
146,MIL,P005775,0 days 00:15:05,-12,17,29
146,MIL,P006701,0 days 00:02:54,-6,0,6
146,MIL,P006721,0 days 00:00:52,-2,2,4
146,MIL,P011926,0 days 00:00:52,-2,2,4
146,BAS,P007230,0 days 00:36:02,-4,61,65
146,BAS,P012201,0 days 00:26:59,2,46,44
146,BAS,P009048,0 days 00:26:05,-20,40,60
146,BAS,P004761,0 days 00:23:30,-12,42,54
146,BAS,P010444,0 days 00:19:25,0,34,34
146,BAS,P011948,0 days 00:16:52,-7,26,33
146,BAS,P012765,0 days 00:15:46,11,27,16
146,BAS,P011085,0 days 00:13:48,5,30,25
146,BAS,P004603,0 days 00:12:49,-15,18,33
146,BAS,P008072,0 days 00:05:52,2,9,7
146,BAS,P003198,0 days 00:02:52,-7,2,9
147,MUN,P007056,0 days 00:26:46,-11,49,60
147,MUN,P001288,0 days 00:25:51,2,60,58
147,MUN,P008985,0 days 00:24:01,5,57,52
147,MUN,P006760,0 days 00:23:21,7,55,48
147,MUN,P004508,0 days 00:22:34,3,52,49
147,MUN,P007639,0 days 00:19:14,17,47,30
147,MUN,P011987,0 days 00:17:28,4,36,32
147,MUN,P007975,0 days 00:12:49,-11,19,30
147,MUN,P010391,0 days 00:12:31,-3,25,28
147,MUN,P001557,0 days 00:07:57,-1,14,15
147,MUN,P006543,0 days 00:04:16,-3,5,8
147,MUN,P005460,0 days 00:03:12,-4,6,10
147,PAM,P010568,0 days 00:29:32,-4,61,65
147,PAM,P007870,0 days 00:24:59,-7,52,59
147,PAM,P012740,0 days 00:23:46,0,51,51
147,PAM,P010393,0 days 00:21:49,-7,44,51
147,PAM,P006643,0 days 00:20:33,-4,35,39
147,PAM,P012795,0 days 00:19:46,-2,46,48
147,PAM,P012738,0 days 00:19:15,11,44,33
147,PAM,P005356,0 days 00:13:47,1,29,28
147,PAM,P012739,0 days 00:13:22,4,28,24
147,PAM,P008780,0 days 00:13:11,3,30,27
148,ASV,P011225,0 days 00:35:09,3,68,65
148,ASV,P012080,0 days 00:29:38,9,65,56
148,ASV,PKIR,0 days 00:28:38,14,66,52
148,ASV,P004194,0 days 00:26:16,13,59,46
148,ASV,P012729,0 days 00:24:13,-16,38,54
148,ASV,P006568,0 days 00:17:17,11,38,27
148,ASV,P012730,0 days 00:16:43,-17,21,38
148,ASV,P000229,0 days 00:14:01,-13,17,30
148,ASV,P003526,0 days 00:08:05,-9,8,17
148,MAD,P005791,0 days 00:28:21,-14,50,64
148,MAD,P006540,0 days 00:25:25,10,53,43
148,MAD,P005928,0 days 00:23:49,-13,40,53
148,MAD,P001392,0 days 00:23:00,-12,42,54
148,MAD,P003733,0 days 00:21:51,11,49,38
148,MAD,P004887,0 days 00:20:46,19,47,28
148,MAD,PTGB,0 days 00:19:18,5,38,33
148,MAD,P009213,0 days 00:15:27,-21,21,42
148,MAD,PCVM,0 days 00:14:33,16,33,17
148,MAD,P011649,0 days 00:07:28,4,12,8
148,MAD,P010868,0 days 00:00:02,0,0,0
149,ZAL,P011218,0 days 00:30:42,3,60,57
149,ZAL,P002329,0 days 00:29:15,4,56,52
149,ZAL,P007109,0 days 00:27:01,6,54,48
149,ZAL,P007513,0 days 00:23:29,-1,41,42
149,ZAL,P005504,0 days 00:18:12,-1,35,36
149,ZAL,P012787,0 days 00:16:52,-3,30,33
149,ZAL,P012715,0 days 00:13:48,-11,17,28
149,ZAL,P010390,0 days 00:13:09,-7,22,29
149,ZAL,P003211,0 days 00:09:32,-5,13,18
149,ZAL,P006860,0 days 00:07:45,-3,12,15
149,ZAL,P003210,0 days 00:05:14,-11,4,15
149,ZAL,P009917,0 days 00:05:01,-11,6,17
149,TEL,P009622,0 days 00:33:18,-2,60,62
149,TEL,P009783,0 days 00:27:58,2,55,53
149,TEL,P011193,0 days 00:26:59,20,62,42
149,TEL,P011199,0 days 00:25:17,1,50,49
149,TEL,P011219,0 days 00:21:53,-4,38,42
149,TEL,P007990,0 days 00:18:18,-4,31,35
149,TEL,P011214,0 days 00:14:38,7,28,21
149,TEL,P011971,0 days 00:10:47,8,26,18
149,TEL,P004233,0 days 00:10:14,15,25,10
149,TEL,P012744,0 days 00:05:43,-5,6,11
149,TEL,P005145,0 days 00:04:55,2,9,7
150,PAN,P003842,0 days 00:29:24,17,69,52
150,PAN,P001926,0 days 00:28:24,16,62,46
150,PAN,P011204,0 days 00:25:52,16,60,44
150,PAN,P012774,0 days 00:24:18,9,45,36
150,PAN,P007866,0 days 00:23:19,10,55,45
150,PAN,P002328,0 days 00:16:57,8,39,31
150,PAN,P012712,0 days 00:16:42,7,27,20
150,PAN,P007947,0 days 00:15:08,3,26,23
150,PAN,P011221,0 days 00:09:28,3,13,10
150,PAN,P011209,0 days 00:09:21,-1,14,15
150,PAN,P007553,0 days 00:01:07,-3,0,3
150,RED,P000848,0 days 00:25:17,-3,43,46
150,RED,P009035,0 days 00:24:21,-13,40,53
150,RED,P012044,0 days 00:24:10,-11,44,55
150,RED,P002553,0 days 00:20:47,-3,38,41
150,RED,PJDR,0 days 00:19:25,-12,30,42
150,RED,P007960,0 days 00:19:12,-5,27,32
150,RED,P006436,0 days 00:17:56,-16,24,40
150,RED,P005099,0 days 00:17:23,-5,26,31
150,RED,PLUO,0 days 00:14:40,-9,26,35
150,RED,P008966,0 days 00:09:19,-3,15,18
150,RED,P012711,0 days 00:03:59,-5,6,11
150,RED,P004720,0 days 00:03:31,0,6,6
151,BER,P008173,0 days 00:22:44,-25,39,64
151,BER,P008967,0 days 00:22:26,-20,43,63
151,BER,P010791,0 days 00:21:59,-8,36,44
151,BER,P012720,0 days 00:21:06,-6,34,40
151,BER,P011934,0 days 00:20:56,-24,35,59
151,BER,P006251,0 days 00:19:18,-8,31,39
151,BER,P012721,0 days 00:18:37,-25,27,52
151,BER,P003958,0 days 00:17:47,-14,32,46
151,BER,P008211,0 days 00:17:16,-2,28,30
151,BER,P007025,0 days 00:14:25,-1,24,25
151,BER,P011631,0 days 00:03:26,-2,6,8
151,OLY,P008829,0 days 00:26:06,23,63,40
151,OLY,P008855,0 days 00:24:08,21,61,40
151,OLY,P001255,0 days 00:23:04,13,52,39
151,OLY,P007982,0 days 00:20:44,14,48,34
151,OLY,P003941,0 days 00:20:42,8,47,39
151,OLY,P010392,0 days 00:20:00,14,48,34
151,OLY,P008811,0 days 00:19:18,19,47,28
151,OLY,P010612,0 days 00:18:42,18,46,28
151,OLY,P007853,0 days 00:13:39,1,27,26
151,OLY,P006589,0 days 00:13:37,4,31,27
152,MCO,P005985,0 days 00:27:52,13,66,53
152,MCO,P011231,0 days 00:24:05,-3,41,44
152,MCO,P011212,0 days 00:23:04,22,57,35
152,MCO,P011226,0 days 00:22:56,21,61,40
152,MCO,P011196,0 days 00:19:59,24,56,32
152,MCO,P004790,0 days 00:19:28,15,52,37
152,MCO,P010588,0 days 00:18:42,-2,32,34
152,MCO,P008099,0 days 00:16:56,-2,34,36
152,MCO,PLCZ,0 days 00:14:50,5,31,26
152,MCO,P012709,0 days 00:12:08,7,25,18
152,BAR,P012745,0 days 00:26:44,-16,47,63
152,BAR,P006435,0 days 00:24:13,-18,40,58
152,BAR,P002939,0 days 00:23:52,-16,39,55
152,BAR,P000925,0 days 00:22:39,-13,37,50
152,BAR,P007464,0 days 00:19:19,-10,38,48
152,BAR,P004866,0 days 00:18:32,-11,31,42
152,BAR,P007519,0 days 00:17:53,-3,34,37
152,BAR,P009992,0 days 00:11:42,-9,19,28
152,BAR,P010641,0 days 00:10:15,-9,18,27
152,BAR,P011244,0 days 00:09:25,-8,12,20
152,BAR,P003204,0 days 00:08:20,11,24,13
152,BAR,P003196,0 days 00:07:06,2,16,14
153,PAR,P009862,0 days 00:32:35,-17,53,70
153,PAR,P007400,0 days 00:32:01,7,65,58
153,PAR,P004058,0 days 00:29:31,7,61,54
153,PAR,P008987,0 days 00:26:35,5,55,50
153,PAR,P012096,0 days 00:24:25,-9,41,50
153,PAR,P012743,0 days 00:15:35,7,34,27
153,PAR,P004172,0 days 00:13:27,-3,21,24
153,PAR,P012742,0 days 00:12:26,0,25,25
153,PAR,P009212,0 days 00:07:59,-9,10,19
153,PAR,P000956,0 days 00:05:26,2,10,8
153,VIR,P001133,0 days 00:31:40,-5,57,62
153,VIR,P001844,0 days 00:25:37,4,49,45
153,VIR,P010781,0 days 00:21:51,4,47,43
153,VIR,PBCN,0 days 00:21:50,5,41,36
153,VIR,P003048,0 days 00:21:09,-3,37,40
153,VIR,P009549,0 days 00:20:06,2,36,34
153,VIR,P006739,0 days 00:14:32,-2,28,30
153,VIR,P012714,0 days 00:13:51,10,37,27
153,VIR,P003527,0 days 00:13:38,4,28,24
153,VIR,P004007,0 days 00:09:01,-11,12,23
153,VIR,P002084,0 days 00:06:45,2,13,11
154,ULK,P008962,0 days 00:31:21,-17,60,77
154,ULK,P001932,0 days 00:26:00,-7,47,54
154,ULK,P006661,0 days 00:23:53,-2,50,52
154,ULK,P004004,0 days 00:23:26,-4,36,40
154,ULK,P011157,0 days 00:19:41,0,41,41
154,ULK,P009849,0 days 00:18:46,-10,35,45
154,ULK,P011052,0 days 00:14:00,-2,29,31
154,ULK,P006961,0 days 00:13:54,0,31,31
154,ULK,P005844,0 days 00:12:10,-2,23,25
154,ULK,P011980,0 days 00:08:39,8,16,8
154,ULK,P002968,0 days 00:08:10,-9,12,21
154,RED,P009035,0 days 00:30:56,4,63,59
154,RED,P006436,0 days 00:30:27,9,74,65
154,RED,PJDR,0 days 00:21:06,14,48,34
154,RED,P000848,0 days 00:20:43,17,48,31
154,RED,P010985,0 days 00:19:14,-2,42,44
154,RED,P005099,0 days 00:19:02,0,38,38
154,RED,P007960,0 days 00:17:53,-10,28,38
154,RED,P012044,0 days 00:12:54,3,26,23
154,RED,P008966,0 days 00:12:38,6,29,23
154,RED,PLUO,0 days 00:12:19,10,26,16
154,RED,P011941,0 days 00:02:48,-6,3,9
155,TEL,P009622,0 days 00:33:35,6,80,74
155,TEL,P009863,0 days 00:27:28,7,63,56
155,TEL,P009783,0 days 00:24:59,8,62,54
155,TEL,P011219,0 days 00:23:57,12,60,48
155,TEL,P011199,0 days 00:20:30,-4,48,52
155,TEL,P011193,0 days 00:20:06,5,47,42
155,TEL,P011971,0 days 00:16:56,0,38,38
155,TEL,P011214,0 days 00:13:33,15,30,15
155,TEL,P004233,0 days 00:08:44,5,21,16
155,TEL,P012744,0 days 00:05:21,-4,9,13
155,TEL,P005145,0 days 00:04:51,0,7,7
155,MCO,P011226,0 days 00:32:54,-4,74,78
155,MCO,P005985,0 days 00:32:14,-14,63,77
155,MCO,P010588,0 days 00:29:08,1,66,65
155,MCO,P012709,0 days 00:21:19,8,52,44
155,MCO,P011212,0 days 00:21:14,-12,43,55
155,MCO,P011231,0 days 00:17:31,-11,33,44
155,MCO,P011196,0 days 00:13:07,-8,24,32
155,MCO,P002581,0 days 00:11:40,4,28,24
155,MCO,PLCZ,0 days 00:08:34,-6,15,21
155,MCO,P004790,0 days 00:07:06,-6,9,15
155,MCO,P004197,0 days 00:05:13,-2,8,10
156,OLY,P008829,0 days 00:30:03,-1,57,58
156,OLY,P010612,0 days 00:26:06,4,55,51
156,OLY,P008855,0 days 00:23:29,9,45,36
156,OLY,P007982,0 days 00:22:18,-8,42,50
156,OLY,P008811,0 days 00:21:37,21,50,29
156,OLY,P001255,0 days 00:20:00,7,41,34
156,OLY,P003941,0 days 00:18:20,-16,29,45
156,OLY,P010392,0 days 00:14:35,-4,27,31
156,OLY,P007853,0 days 00:13:32,7,27,20
156,OLY,P011194,0 days 00:10:00,6,22,16
156,MIL,P011224,0 days 00:30:31,-5,54,59
156,MIL,P006509,0 days 00:28:06,-1,53,54
156,MIL,P002849,0 days 00:25:44,-8,42,50
156,MIL,P011205,0 days 00:24:06,-13,38,51
156,MIL,P007201,0 days 00:22:07,-14,32,46
156,MIL,P002812,0 days 00:21:31,9,47,38
156,MIL,P005670,0 days 00:20:59,2,46,44
156,MIL,P009960,0 days 00:12:18,5,29,24
156,MIL,P006701,0 days 00:10:46,8,27,19
156,MIL,P011926,0 days 00:03:52,-8,2,10
157,PAR,P009212,0 days 00:22:51,8,53,45
157,PAR,P004058,0 days 00:22:43,-6,46,52
157,PAR,P007400,0 days 00:21:05,-2,38,40
157,PAR,P012096,0 days 00:20:03,11,44,33
157,PAR,P000956,0 days 00:20:00,-6,40,46
157,PAR,P012743,0 days 00:19:54,2,46,44
157,PAR,P009862,0 days 00:18:17,14,44,30
157,PAR,P011192,0 days 00:18:14,28,51,23
157,PAR,P004172,0 days 00:11:16,4,30,26
157,PAR,P011051,0 days 00:10:30,14,28,14
157,PAR,P012742,0 days 00:08:31,7,21,14
157,PAR,P011050,0 days 00:06:36,-9,9,18
157,ASV,P011225,0 days 00:33:36,-13,64,77
157,ASV,PKIR,0 days 00:30:12,-10,58,68
157,ASV,P012080,0 days 00:27:29,-19,47,66
157,ASV,P012729,0 days 00:26:22,3,59,56
157,ASV,P004194,0 days 00:19:33,-21,27,48
157,ASV,P000229,0 days 00:18:56,6,43,37
157,ASV,P003526,0 days 00:15:15,2,38,36
157,ASV,P006568,0 days 00:15:13,-14,23,37
157,ASV,P012730,0 days 00:13:24,1,26,25
158,ZAL,P011218,0 days 00:31:44,7,66,59
158,ZAL,P002329,0 days 00:28:59,7,59,52
158,ZAL,P003210,0 days 00:24:21,1,44,43
158,ZAL,P003211,0 days 00:23:00,10,36,26
158,ZAL,P010390,0 days 00:21:14,11,40,29
158,ZAL,P009917,0 days 00:18:34,-2,40,42
158,ZAL,P012715,0 days 00:17:04,2,37,35
158,ZAL,P005504,0 days 00:14:11,-6,31,37
158,ZAL,P007109,0 days 00:10:57,-4,13,17
158,ZAL,P012787,0 days 00:09:38,4,19,15
158,ZAL,P007513,0 days 00:00:18,0,0,0
158,BER,P012720,0 days 00:31:08,2,66,64
158,BER,P003958,0 days 00:30:25,1,61,60
158,BER,P011934,0 days 00:29:30,4,63,59
158,BER,P008173,0 days 00:24:30,-8,45,53
158,BER,P008967,0 days 00:20:14,-5,28,33
158,BER,P012721,0 days 00:16:43,2,39,37
158,BER,P008211,0 days 00:15:40,0,26,26
158,BER,P007025,0 days 00:11:57,-11,9,20
158,BER,P006251,0 days 00:11:41,-7,12,19
158,BER,P010791,0 days 00:08:12,-8,6,14
159,BAR,P004866,0 days 00:31:06,10,67,57
159,BAR,P012745,0 days 00:30:01,4,64,60
159,BAR,P000925,0 days 00:27:00,12,61,49
159,BAR,P002939,0 days 00:26:03,-2,48,50
159,BAR,P006435,0 days 00:25:11,-4,50,54
159,BAR,P007519,0 days 00:19:07,4,42,38
159,BAR,P007464,0 days 00:15:54,-3,26,29
159,BAR,P003196,0 days 00:12:59,-7,22,29
159,BAR,P011244,0 days 00:08:56,3,22,19
159,BAR,P009992,0 days 00:03:22,5,10,5
159,BAR,P003204,0 days 00:00:21,3,3,0
159,MAD,P006540,0 days 00:29:19,-6,58,64
159,MAD,P003108,0 days 00:28:55,-9,51,60
159,MAD,P005928,0 days 00:25:41,-1,52,53
159,MAD,P005791,0 days 00:24:18,3,49,46
159,MAD,P009213,0 days 00:16:01,1,35,34
159,MAD,P001392,0 days 00:15:55,4,38,34
159,MAD,P004887,0 days 00:15:41,-8,29,37
159,MAD,P003733,0 days 00:15:28,3,30,27
159,MAD,PTGB,0 days 00:14:55,-10,22,32
159,MAD,PCVM,0 days 00:13:47,-2,26,28
160,BAS,P007230,0 days 00:31:44,4,60,56
160,BAS,P004761,0 days 00:29:17,-4,51,55
160,BAS,P012201,0 days 00:25:08,17,61,44
160,BAS,P009048,0 days 00:24:43,1,43,42
160,BAS,P010444,0 days 00:21:55,-4,40,44
160,BAS,P011948,0 days 00:21:16,-3,40,43
160,BAS,P012765,0 days 00:14:54,1,32,31
160,BAS,P008850,0 days 00:09:34,-5,9,14
160,BAS,P003198,0 days 00:08:13,10,22,12
160,BAS,P004603,0 days 00:04:45,-6,2,8
160,BAS,P011085,0 days 00:04:33,-3,6,9
160,BAS,P008072,0 days 00:03:58,2,9,7
160,PAN,P012774,0 days 00:35:00,3,64,61
160,PAN,P002328,0 days 00:30:38,4,58,54
160,PAN,P007866,0 days 00:30:37,6,64,58
160,PAN,P011204,0 days 00:26:17,4,52,48
160,PAN,P003842,0 days 00:24:48,-12,42,54
160,PAN,P001926,0 days 00:20:46,-10,38,48
160,PAN,P012712,0 days 00:10:32,-7,11,18
160,PAN,P011221,0 days 00:10:08,11,25,14
160,PAN,P007947,0 days 00:08:02,-10,8,18
160,PAN,P007553,0 days 00:03:12,1,3,2
161,PAM,P010568,0 days 00:27:49,0,59,59
161,PAM,P011982,0 days 00:25:05,5,60,55
161,PAM,P003960,0 days 00:23:12,9,61,52
161,PAM,P007870,0 days 00:19:59,10,53,43
161,PAM,P012739,0 days 00:18:43,-4,38,42
161,PAM,P004863,0 days 00:16:30,7,46,39
161,PAM,P012738,0 days 00:16:24,-6,30,36
161,PAM,P012795,0 days 00:16:15,2,37,35
161,PAM,P005356,0 days 00:14:36,0,34,34
161,PAM,P011970,0 days 00:13:46,7,38,31
161,PAM,P012740,0 days 00:07:41,-5,9,14
161,IST,P007200,0 days 00:33:12,-2,73,75
161,IST,P006590,0 days 00:31:44,6,73,67
161,IST,PLHK,0 days 00:29:07,3,64,61
161,IST,P009846,0 days 00:27:29,-7,59,66
161,IST,P011078,0 days 00:25:54,-10,57,67
161,IST,P011981,0 days 00:19:42,-7,42,49
161,IST,P012788,0 days 00:19:09,-9,37,46
161,IST,P012786,0 days 00:10:37,1,27,26
161,IST,P009513,0 days 00:03:06,0,8,8
162,VIR,P001133,0 days 00:31:43,0,68,68
162,VIR,P001844,0 days 00:29:03,5,60,55
162,VIR,PBCN,0 days 00:25:14,10,56,46
162,VIR,P010781,0 days 00:23:54,-5,50,55
162,VIR,P009549,0 days 00:23:32,8,51,43
162,VIR,P003048,0 days 00:21:14,3,43,40
162,VIR,P003527,0 days 00:12:55,-12,23,35
162,VIR,P004554,0 days 00:12:28,6,34,28
162,VIR,P006739,0 days 00:11:50,-6,25,31
162,VIR,P002084,0 days 00:08:07,1,15,14
162,MUN,P003583,0 days 00:28:03,-4,54,58
162,MUN,P007056,0 days 00:27:00,0,54,54
162,MUN,P010391,0 days 00:24:44,-1,53,54
162,MUN,P008985,0 days 00:24:17,-2,47,49
162,MUN,P011987,0 days 00:21:14,2,42,40
162,MUN,P004508,0 days 00:18:46,-4,41,45
162,MUN,P007975,0 days 00:15:43,0,36,36
162,MUN,P001288,0 days 00:15:42,4,36,32
162,MUN,P006760,0 days 00:15:20,1,32,31
162,MUN,P007639,0 days 00:06:07,-3,13,16
162,MUN,P006543,0 days 00:02:52,0,7,7
162,MUN,P001557,0 days 00:00:12,-3,0,3
163,RED,P012044,0 days 00:26:10,5,60,55
163,RED,P006436,0 days 00:25:50,12,64,52
163,RED,P000848,0 days 00:24:05,8,51,43
163,RED,P005099,0 days 00:21:57,20,55,35
163,RED,PJDR,0 days 00:21:53,16,56,40
163,RED,P009035,0 days 00:21:00,5,40,35
163,RED,P011941,0 days 00:19:00,11,48,37
163,RED,P007960,0 days 00:14:51,7,27,20
163,RED,PLUO,0 days 00:13:43,-6,21,27
163,RED,P010985,0 days 00:11:31,2,18,16
163,PAR,P009862,0 days 00:33:14,-7,64,71
163,PAR,P007400,0 days 00:31:02,-12,61,73
163,PAR,P012742,0 days 00:28:34,-9,46,55
163,PAR,P012096,0 days 00:24:30,-4,41,45
163,PAR,P011192,0 days 00:16:19,-9,33,42
163,PAR,P000956,0 days 00:15:10,-7,31,38
163,PAR,P012743,0 days 00:12:02,-2,28,30
163,PAR,P004172,0 days 00:11:11,-3,19,22
163,PAR,P011051,0 days 00:11:05,-22,13,35
163,PAR,P004058,0 days 00:08:54,-6,13,19
163,PAR,P009212,0 days 00:07:59,1,11,10
164,ASV,P011225,0 days 00:35:37,21,86,65
164,ASV,P012080,0 days 00:31:30,20,82,62
164,ASV,PKIR,0 days 00:30:59,22,78,56
164,ASV,P006568,0 days 00:28:30,23,73,50
164,ASV,P004194,0 days 00:27:02,17,66,49
164,ASV,P012729,0 days 00:20:11,-7,38,45
164,ASV,P003526,0 days 00:09:12,-9,15,24
164,ASV,P000229,0 days 00:09:09,-9,11,20
164,ASV,P012730,0 days 00:04:10,-4,9,13
164,ASV,P011386,0 days 00:03:40,-4,7,11
164,ZAL,P011218,0 days 00:31:54,-6,64,70
164,ZAL,P007109,0 days 00:27:42,-12,58,70
164,ZAL,P002329,0 days 00:23:45,-16,44,60
164,ZAL,P003211,0 days 00:19:53,-7,41,48
164,ZAL,P003210,0 days 00:18:04,-16,30,46
164,ZAL,P012715,0 days 00:17:36,5,43,38
164,ZAL,P012787,0 days 00:16:00,-3,32,35
164,ZAL,P009917,0 days 00:15:00,1,31,30
164,ZAL,P005504,0 days 00:13:12,-15,20,35
164,ZAL,P010390,0 days 00:12:03,4,26,22
164,ZAL,P006860,0 days 00:04:51,-5,6,11
165,ULK,P008962,0 days 00:24:50,30,71,41
165,ULK,P011052,0 days 00:23:54,27,69,42
165,ULK,P006661,0 days 00:23:00,27,61,34
165,ULK,P004004,0 days 00:22:33,28,68,40
165,ULK,P009849,0 days 00:17:00,8,48,40
165,ULK,P001932,0 days 00:16:06,8,40,32
165,ULK,P005844,0 days 00:16:01,30,49,19
165,ULK,P002968,0 days 00:15:56,-1,37,38
165,ULK,P011157,0 days 00:14:21,4,37,33
165,ULK,P006961,0 days 00:14:17,2,32,30
165,ULK,P011980,0 days 00:06:42,5,16,11
165,ULK,P002969,0 days 00:05:20,7,17,10
165,TEL,P009622,0 days 00:27:47,-32,44,76
165,TEL,P009863,0 days 00:27:27,-29,44,73
165,TEL,P009783,0 days 00:25:24,-19,46,65
165,TEL,P011199,0 days 00:22:02,-16,36,52
165,TEL,P011219,0 days 00:17:13,-13,26,39
165,TEL,P011214,0 days 00:15:54,-14,36,50
165,TEL,P011971,0 days 00:14:42,-17,33,50
165,TEL,P007990,0 days 00:13:53,-8,30,38
165,TEL,P012744,0 days 00:12:36,-12,23,35
165,TEL,P011193,0 days 00:12:33,-6,30,36
165,TEL,P005145,0 days 00:07:01,-4,15,19
165,TEL,P004233,0 days 00:03:28,-5,7,12
166,OLY,P008855,0 days 00:33:21,1,65,64
166,OLY,P008829,0 days 00:26:04,3,49,46
166,OLY,P010612,0 days 00:25:28,1,54,53
166,OLY,P008811,0 days 00:24:16,0,51,51
166,OLY,P007853,0 days 00:19:47,9,36,27
166,OLY,P001255,0 days 00:18:37,-8,38,46
166,OLY,P003941,0 days 00:15:36,1,23,22
166,OLY,P011194,0 days 00:13:40,1,24,23
166,OLY,P007982,0 days 00:13:10,0,18,18
166,OLY,P011983,0 days 00:06:37,1,11,10
166,OLY,P010392,0 days 00:03:24,1,6,5
166,MCO,P010588,0 days 00:31:40,2,62,60
166,MCO,P005985,0 days 00:30:23,-3,59,62
166,MCO,P011226,0 days 00:25:15,0,50,50
166,MCO,P011212,0 days 00:22:40,-7,37,44
166,MCO,P011231,0 days 00:18:59,-4,29,33
166,MCO,P002581,0 days 00:18:46,5,37,32
166,MCO,PLCZ,0 days 00:17:50,-6,31,37
166,MCO,P004197,0 days 00:13:59,7,32,25
166,MCO,P012709,0 days 00:12:55,-1,18,19
166,MCO,P004790,0 days 00:04:18,-1,6,7
166,MCO,P011196,0 days 00:03:15,-2,4,6
167,BER,P012720,0 days 00:26:29,-7,45,52
167,BER,P003958,0 days 00:25:52,-17,44,61
167,BER,P008173,0 days 00:22:06,-8,36,44
167,BER,P011934,0 days 00:22:03,-11,35,46
167,BER,P008967,0 days 00:20:39,3,45,42
167,BER,P010791,0 days 00:18:46,3,35,32
167,BER,P008211,0 days 00:14:55,-6,27,33
167,BER,P007025,0 days 00:14:18,-8,24,32
167,BER,P006251,0 days 00:13:19,-5,22,27
167,BER,P012721,0 days 00:13:03,-19,10,29
167,BER,P008384,0 days 00:08:30,0,17,17
167,VIR,P003048,0 days 00:27:03,6,58,52
167,VIR,P009549,0 days 00:25:58,11,56,45
167,VIR,P001133,0 days 00:23:29,7,52,45
167,VIR,P001844,0 days 00:20:30,6,43,37
167,VIR,P003527,0 days 00:18:59,8,36,28
167,VIR,P010781,0 days 00:18:45,19,41,22
167,VIR,PBCN,0 days 00:15:17,1,31,30
167,VIR,P006739,0 days 00:14:09,12,30,18
167,VIR,P004554,0 days 00:12:35,9,25,16
167,VIR,P002084,0 days 00:11:34,4,22,18
167,VIR,P005553,0 days 00:05:58,-5,11,16
167,VIR,P012713,0 days 00:05:43,-3,10,13
168,MIL,P011205,0 days 00:26:50,13,56,43
168,MIL,P011224,0 days 00:25:58,12,50,38
168,MIL,P009960,0 days 00:23:20,21,49,28
168,MIL,P005670,0 days 00:21:46,8,38,30
168,MIL,P002849,0 days 00:20:28,8,34,26
168,MIL,P007201,0 days 00:18:04,-2,28,30
168,MIL,P006701,0 days 00:17:55,18,40,22
168,MIL,P002812,0 days 00:15:17,-8,25,33
168,MIL,P006509,0 days 00:15:13,-10,24,34
168,MIL,P001518,0 days 00:13:35,8,32,24
168,MIL,P006721,0 days 00:00:47,1,2,1
168,MIL,P011926,0 days 00:00:47,1,2,1
168,MUN,P003583,0 days 00:30:46,-7,45,52
168,MUN,P011987,0 days 00:28:10,-12,44,56
168,MUN,P007056,0 days 00:24:59,-4,39,43
168,MUN,P001288,0 days 00:24:10,-10,36,46
168,MUN,P006760,0 days 00:20:04,-11,33,44
168,MUN,P008985,0 days 00:18:49,-1,32,33
168,MUN,P007975,0 days 00:18:47,-11,30,41
168,MUN,P004508,0 days 00:15:49,-6,27,33
168,MUN,P010391,0 days 00:10:00,-5,10,15
168,MUN,P001557,0 days 00:05:54,-2,9,11
168,MUN,P007639,0 days 00:02:32,-1,5,6
169,BAR,P012745,0 days 00:30:58,3,70,67
169,BAR,P004866,0 days 00:30:52,12,74,62
169,BAR,P002939,0 days 00:27:31,-8,55,63
169,BAR,P007464,0 days 00:26:38,7,61,54
169,BAR,P006435,0 days 00:23:11,0,51,51
169,BAR,P000925,0 days 00:21:38,11,53,42
169,BAR,P003196,0 days 00:18:22,-7,36,43
169,BAR,P009992,0 days 00:13:11,-2,28,30
169,BAR,P003204,0 days 00:07:39,4,17,13
169,BAS,P009048,0 days 00:33:30,1,75,74
169,BAS,P007230,0 days 00:31:16,-5,63,68
169,BAS,P004761,0 days 00:26:01,-4,56,60
169,BAS,P011948,0 days 00:25:24,8,54,46
169,BAS,P012201,0 days 00:22:07,-14,43,57
169,BAS,P010444,0 days 00:20:05,-8,38,46
169,BAS,P004603,0 days 00:16:29,9,42,33
169,BAS,P003198,0 days 00:10:46,7,30,23
169,BAS,P012765,0 days 00:06:30,-5,10,15
169,BAS,P008850,0 days 00:04:26,-4,9,13
169,BAS,P008072,0 days 00:03:26,-5,5,10
170,MAD,P006540,0 days 00:35:25,3,103,100
170,MAD,P003108,0 days 00:34:24,18,117,99
170,MAD,P005791,0 days 00:34:09,18,117,99
170,MAD,P001392,0 days 00:33:55,23,107,84
170,MAD,P005928,0 days 00:30:32,14,101,87
170,MAD,P010357,0 days 00:12:29,-7,20,27
170,MAD,PCVM,0 days 00:12:11,-12,18,30
170,MAD,P004887,0 days 00:10:51,-14,13,27
170,MAD,P003733,0 days 00:09:45,-5,13,18
170,MAD,PTGB,0 days 00:06:42,-6,35,41
170,MAD,P009213,0 days 00:04:37,-12,6,18
170,IST,P007200,0 days 00:38:11,-9,109,118
170,IST,PLHK,0 days 00:37:13,5,116,111
170,IST,P011078,0 days 00:34:13,19,110,91
170,IST,P006590,0 days 00:29:45,-18,81,99
170,IST,P012786,0 days 00:25:41,2,57,55
170,IST,P009846,0 days 00:23:34,2,71,69
170,IST,P012788,0 days 00:19:41,-11,49,60
170,IST,P011981,0 days 00:16:42,-10,37,47
171,PAM,P010568,0 days 00:28:40,-6,55,61
171,PAM,P011982,0 days 00:26:49,-7,50,57
171,PAM,P007870,0 days 00:21:13,-6,37,43
171,PAM,P003960,0 days 00:21:05,4,51,47
171,PAM,P012795,0 days 00:16:55,-1,33,34
171,PAM,P012738,0 days 00:15:28,11,35,24
171,PAM,P010393,0 days 00:14:10,-5,26,31
171,PAM,P012740,0 days 00:13:32,-2,26,28
171,PAM,P004863,0 days 00:13:19,2,29,27
171,PAM,P011970,0 days 00:12:44,7,36,29
171,PAM,P005356,0 days 00:11:46,-3,16,19
171,PAM,P006643,0 days 00:04:19,1,11,10
171,PAN,P011204,0 days 00:37:00,3,82,79
171,PAN,P002328,0 days 00:29:35,7,62,55
171,PAN,P003842,0 days 00:27:25,6,53,47
171,PAN,P007947,0 days 00:25:46,0,53,53
171,PAN,P012774,0 days 00:24:49,-5,45,50
171,PAN,P007866,0 days 00:23:07,-8,40,48
171,PAN,P012712,0 days 00:16:53,9,42,33
171,PAN,P011221,0 days 00:12:21,-7,27,34
171,PAN,P011209,0 days 00:03:04,0,6,6
172,ULK,P011980,0 days 00:27:51,21,62,41
172,ULK,P001932,0 days 00:24:16,7,59,52
172,ULK,P004004,0 days 00:23:52,7,50,43
172,ULK,P009849,0 days 00:23:16,28,57,29
172,ULK,P010560,0 days 00:22:20,21,56,35
172,ULK,P008962,0 days 00:19:20,-2,42,44
172,ULK,P011052,0 days 00:18:42,10,41,31
172,ULK,P006661,0 days 00:14:35,-9,31,40
172,ULK,P005844,0 days 00:13:19,6,33,27
172,ULK,P011157,0 days 00:06:29,-5,12,17
172,ULK,P002968,0 days 00:05:18,-7,12,19
172,ULK,P006961,0 days 00:00:42,-2,0,2
172,PAR,P009862,0 days 00:36:27,-9,73,82
172,PAR,P007400,0 days 00:31:34,-6,64,70
172,PAR,P011192,0 days 00:28:14,-14,50,64
172,PAR,P008987,0 days 00:25:36,0,51,51
172,PAR,P012096,0 days 00:23:05,-3,48,51
172,PAR,P012742,0 days 00:20:51,-16,38,54
172,PAR,P007673,0 days 00:12:30,-8,19,27
172,PAR,P012743,0 days 00:12:25,-9,22,31
172,PAR,P000956,0 days 00:06:57,-8,10,18
172,PAR,P009212,0 days 00:02:21,-2,5,7
173,MCO,P005985,0 days 00:32:48,20,82,62
173,MCO,P010588,0 days 00:26:01,4,60,56
173,MCO,P011226,0 days 00:23:26,5,55,50
173,MCO,P004197,0 days 00:23:24,-3,52,55
173,MCO,P009754,0 days 00:21:10,11,47,36
173,MCO,P011231,0 days 00:16:42,18,44,26
173,MCO,PLCZ,0 days 00:16:23,0,36,36
173,MCO,P002581,0 days 00:15:35,-4,36,40
173,MCO,P012709,0 days 00:13:12,-2,31,33
173,MCO,P008099,0 days 00:06:00,-1,12,13
173,MCO,P004790,0 days 00:05:19,2,10,8
173,BAS,P004761,0 days 00:34:32,-8,74,82
173,BAS,P012201,0 days 00:31:06,-9,67,76
173,BAS,P011948,0 days 00:28:57,3,66,63
173,BAS,P009048,0 days 00:25:22,-10,48,58
173,BAS,P004603,0 days 00:23:01,5,54,49
173,BAS,P007230,0 days 00:21:28,-23,30,53
173,BAS,P010444,0 days 00:15:11,-3,35,38
173,BAS,P012765,0 days 00:14:38,0,35,35
173,BAS,P008850,0 days 00:04:28,-1,6,7
173,BAS,P003198,0 days 00:01:17,-4,0,4
174,PAN,P007866,0 days 00:36:11,14,81,67
174,PAN,P011204,0 days 00:35:58,-6,68,74
174,PAN,P002328,0 days 00:35:02,12,75,63
174,PAN,P003842,0 days 00:29:58,17,73,56
174,PAN,P012774,0 days 00:24:58,8,51,43
174,PAN,P001926,0 days 00:21:51,3,47,44
174,PAN,P011221,0 days 00:10:02,-10,10,20
174,PAN,P012712,0 days 00:03:49,-7,2,9
174,PAN,P011209,0 days 00:02:11,4,8,4
174,IST,P007200,0 days 00:33:25,-12,61,73
174,IST,P009846,0 days 00:31:54,0,62,62
174,IST,P011078,0 days 00:30:00,1,60,59
174,IST,PLHK,0 days 00:29:28,3,62,59
174,IST,P009664,0 days 00:28:30,2,59,57
174,IST,P006590,0 days 00:21:05,-4,40,44
174,IST,P012786,0 days 00:12:02,-20,13,33
174,IST,P012788,0 days 00:06:58,-3,12,15
174,IST,P009513,0 days 00:03:21,1,6,5
174,IST,P010516,0 days 00:03:17,-3,5,8
175,ASV,P012080,0 days 00:27:43,0,65,65
175,ASV,P011225,0 days 00:26:06,0,72,72
175,ASV,PKIR,0 days 00:24:04,15,62,47
175,ASV,P012729,0 days 00:21:11,0,44,44
175,ASV,P012731,0 days 00:21:04,11,60,49
175,ASV,P004194,0 days 00:21:02,11,58,47
175,ASV,P006568,0 days 00:17:09,1,40,39
175,ASV,P011386,0 days 00:13:54,9,28,19
175,ASV,P000229,0 days 00:13:15,8,40,32
175,ASV,P003526,0 days 00:09:44,-2,22,24
175,ASV,P003274,0 days 00:03:52,-3,9,12
175,ASV,P012730,0 days 00:00:56,-5,0,5
175,RED,P012044,0 days 00:28:13,2,71,69
175,RED,P006436,0 days 00:27:52,-13,64,77
175,RED,P009035,0 days 00:26:08,0,68,68
175,RED,P000848,0 days 00:25:25,-6,61,67
175,RED,P007960,0 days 00:22:15,8,52,44
175,RED,PJDR,0 days 00:16:48,-14,34,48
175,RED,P005099,0 days 00:14:57,-16,25,41
175,RED,PLUO,0 days 00:14:47,6,35,29
175,RED,P008966,0 days 00:09:08,2,18,16
175,RED,P004720,0 days 00:05:52,6,20,14
175,RED,P011941,0 days 00:04:44,-11,5,16
175,RED,P011964,0 days 00:03:51,-9,2,11
176,PAM,P010568,0 days 00:25:35,-4,58,62
176,PAM,P007870,0 days 00:25:32,1,60,59
176,PAM,P003960,0 days 00:21:40,-4,51,55
176,PAM,P011982,0 days 00:20:37,13,49,36
176,PAM,P006433,0 days 00:16:02,5,36,31
176,PAM,P012795,0 days 00:15:55,-16,28,44
176,PAM,P004863,0 days 00:15:37,-2,27,29
176,PAM,P012738,0 days 00:15:25,-6,21,27
176,PAM,P011970,0 days 00:14:26,-3,25,28
176,PAM,P005356,0 days 00:12:03,-10,14,24
176,PAM,P010393,0 days 00:11:43,2,19,17
176,PAM,P012739,0 days 00:05:25,-1,7,8
176,ZAL,P002329,0 days 00:30:57,11,77,66
176,ZAL,P007109,0 days 00:30:36,4,68,64
176,ZAL,P011218,0 days 00:27:33,10,71,61
176,ZAL,P012715,0 days 00:24:40,3,46,43
176,ZAL,P003210,0 days 00:20:26,4,37,33
176,ZAL,P003211,0 days 00:16:17,12,35,23
176,ZAL,P005504,0 days 00:14:16,1,35,34
176,ZAL,P007513,0 days 00:12:29,-8,27,35
176,ZAL,P012787,0 days 00:10:30,-5,9,14
176,ZAL,P010390,0 days 00:07:39,-1,12,13
176,ZAL,P009917,0 days 00:04:37,-6,3,9
177,MIL,P011205,0 days 00:30:12,8,61,53
177,MIL,P011224,0 days 00:29:15,5,60,55
177,MIL,P002849,0 days 00:25:14,6,53,47
177,MIL,P005670,0 days 00:23:12,-1,47,48
177,MIL,P006701,0 days 00:22:23,8,52,44
177,MIL,P007201,0 days 00:21:44,-3,41,44
177,MIL,P002812,0 days 00:21:32,2,44,42
177,MIL,P006509,0 days 00:11:36,4,23,19
177,MIL,P001518,0 days 00:09:03,1,16,15
177,MIL,P009960,0 days 00:05:49,0,13,13
177,BER,P008967,0 days 00:28:24,-7,52,59
177,BER,P012720,0 days 00:27:48,-7,53,60
177,BER,P008173,0 days 00:25:45,-9,49,58
177,BER,P003958,0 days 00:24:05,1,41,40
177,BER,P011934,0 days 00:22:34,-2,47,49
177,BER,P010791,0 days 00:17:13,-4,29,33
177,BER,P006251,0 days 00:15:55,-7,35,42
177,BER,P008384,0 days 00:15:20,-3,28,31
177,BER,P008211,0 days 00:14:15,3,27,24
177,BER,P007025,0 days 00:08:41,5,19,14
178,MUN,P010391,0 days 00:24:50,-22,41,63
178,MUN,P007056,0 days 00:24:29,-11,44,55
178,MUN,P003583,0 days 00:23:22,-12,38,50
178,MUN,P011987,0 days 00:22:32,-13,38,51
178,MUN,P007975,0 days 00:20:56,-13,33,46
178,MUN,P006760,0 days 00:18:20,-3,35,38
178,MUN,P001288,0 days 00:17:52,-18,30,48
178,MUN,P004508,0 days 00:17:28,-8,33,41
178,MUN,P008985,0 days 00:15:54,-4,33,37
178,MUN,P007639,0 days 00:14:17,-1,30,31
178,MAD,P005928,0 days 00:24:13,16,58,42
178,MAD,P001392,0 days 00:22:10,-2,41,43
178,MAD,P003108,0 days 00:21:24,13,53,40
178,MAD,P004887,0 days 00:20:52,14,53,39
178,MAD,P006540,0 days 00:20:26,8,43,35
178,MAD,P003733,0 days 00:19:34,13,49,36
178,MAD,P005791,0 days 00:19:08,7,39,32
178,MAD,PTGB,0 days 00:17:50,23,51,28
178,MAD,P010357,0 days 00:16:42,7,35,28
178,MAD,P010623,0 days 00:15:47,5,34,29
178,MAD,P011649,0 days 00:01:54,1,4,3
179,BAR,P002939,0 days 00:35:26,17,80,63
179,BAR,P012745,0 days 00:30:30,15,70,55
179,BAR,P004866,0 days 00:26:54,17,65,48
179,BAR,P003196,0 days 00:21:53,-1,40,41
179,BAR,P007519,0 days 00:21:30,-3,41,44
179,BAR,P009992,0 days 00:19:31,8,47,39
179,BAR,P000925,0 days 00:18:03,9,46,37
179,BAR,P007464,0 days 00:16:39,-15,25,40
179,BAR,P011244,0 days 00:09:30,-7,16,23
179,BAR,P003204,0 days 00:00:04,0,0,0
179,OLY,P010612,0 days 00:30:04,-12,57,69
179,OLY,P008829,0 days 00:28:42,-8,57,65
179,OLY,P007982,0 days 00:23:23,9,46,37
179,OLY,P007853,0 days 00:22:33,11,45,34
179,OLY,P008811,0 days 00:20:46,-20,37,57
179,OLY,P003941,0 days 00:19:10,12,41,29
179,OLY,P008855,0 days 00:16:37,-17,32,49
179,OLY,P001255,0 days 00:16:05,-15,33,48
179,OLY,P006589,0 days 00:11:18,0,21,21
179,OLY,P010392,0 days 00:07:17,-3,9,12
179,OLY,P011983,0 days 00:04:05,3,12,9
180,TEL,P009863,0 days 00:32:12,21,83,62
180,TEL,P011199,0 days 00:29:07,24,73,49
180,TEL,P011219,0 days 00:27:37,9,54,45
180,TEL,P009783,0 days 00:25:49,15,63,48
180,TEL,P009622,0 days 00:24:54,10,57,47
180,TEL,P007990,0 days 00:23:20,7,59,52
180,TEL,P004233,0 days 00:11:53,11,34,23
180,TEL,P011214,0 days 00:11:41,-7,22,29
180,TEL,P011971,0 days 00:10:09,3,25,22
180,TEL,P012744,0 days 00:03:09,-7,3,10
180,TEL,P011433,0 days 00:00:09,-1,2,3
180,VIR,P001133,0 days 00:28:10,-23,46,69
180,VIR,P003048,0 days 00:25:35,-20,47,67
180,VIR,P001844,0 days 00:24:16,-17,44,61
180,VIR,PBCN,0 days 00:24:01,-3,57,60
180,VIR,P009549,0 days 00:23:01,-18,34,52
180,VIR,P003527,0 days 00:20:23,-17,26,43
180,VIR,P006739,0 days 00:16:43,-1,43,44
180,VIR,P010781,0 days 00:16:35,0,38,38
180,VIR,P004554,0 days 00:13:43,5,30,25
180,VIR,P002084,0 days 00:07:33,9,25,16
181,ULK,P001932,0 days 00:31:56,22,83,61
181,ULK,P006661,0 days 00:29:12,17,71,54
181,ULK,P011157,0 days 00:28:15,2,65,63
181,ULK,P010560,0 days 00:27:56,8,69,61
181,ULK,P009849,0 days 00:23:33,-2,46,48
181,ULK,P006961,0 days 00:21:48,-10,41,51
181,ULK,P004004,0 days 00:20:48,-6,38,44
181,ULK,P011980,0 days 00:15:03,9,33,24
181,ULK,P002968,0 days 00:10:47,-4,14,18
181,ULK,P011052,0 days 00:09:44,-10,11,21
181,ULK,P005844,0 days 00:05:58,9,19,10
181,MUN,P007056,0 days 00:36:48,-2,80,82
181,MUN,P001288,0 days 00:30:55,-15,62,77
181,MUN,P004508,0 days 00:27:32,-2,56,58
181,MUN,P007975,0 days 00:25:16,4,54,50
181,MUN,P010391,0 days 00:19:36,0,45,45
181,MUN,P008985,0 days 00:19:36,-11,37,48
181,MUN,P005460,0 days 00:13:13,7,25,18
181,MUN,P007639,0 days 00:12:46,-14,21,35
181,MUN,P006760,0 days 00:11:55,1,22,21
181,MUN,P006543,0 days 00:11:20,-2,18,20
181,MUN,P011987,0 days 00:10:46,-1,25,26
181,MUN,P001557,0 days 00:05:17,0,10,10
182,PAN,P002328,0 days 00:32:41,29,75,46
182,PAN,P011204,0 days 00:31:41,22,73,51
182,PAN,P003842,0 days 00:30:34,33,72,39
182,PAN,P012774,0 days 00:29:52,17,68,51
182,PAN,P007866,0 days 00:21:49,15,49,34
182,PAN,P012712,0 days 00:18:11,10,39,29
182,PAN,P001926,0 days 00:17:38,-6,27,33
182,PAN,P011221,0 days 00:08:36,-6,16,22
182,PAN,P011209,0 days 00:07:07,5,15,10
182,PAN,P006544,0 days 00:01:51,6,6,0
182,MCO,P005985,0 days 00:36:13,-26,56,82
182,MCO,P010588,0 days 00:23:23,-23,28,51
182,MCO,P008099,0 days 00:21:10,-18,36,54
182,MCO,PLCZ,0 days 00:19:50,-7,31,38
182,MCO,P011226,0 days 00:19:18,-2,31,33
182,MCO,P011231,0 days 00:16:44,-23,20,43
182,MCO,P004197,0 days 00:16:43,-8,26,34
182,MCO,P012709,0 days 00:14:42,-5,25,30
182,MCO,P004790,0 days 00:14:10,1,33,32
182,MCO,P011196,0 days 00:13:07,-7,24,31
182,MCO,P002581,0 days 00:04:40,-7,5,12
183,MIL,P011224,0 days 00:32:17,-5,57,62
183,MIL,P011205,0 days 00:28:58,-9,37,46
183,MIL,P005670,0 days 00:26:06,-5,33,38
183,MIL,P002849,0 days 00:24:44,-6,34,40
183,MIL,P007201,0 days 00:22:46,-12,38,50
183,MIL,P006701,0 days 00:19:10,-16,32,48
183,MIL,P009960,0 days 00:15:39,3,27,24
183,MIL,P006509,0 days 00:13:29,-7,27,34
183,MIL,P002812,0 days 00:12:57,-4,25,29
183,MIL,P001518,0 days 00:03:54,-9,0,9
183,RED,P009035,0 days 00:33:04,4,64,60
183,RED,P006436,0 days 00:28:20,19,59,40
183,RED,P005099,0 days 00:25:01,14,46,32
183,RED,PJDR,0 days 00:22:55,19,44,25
183,RED,P007960,0 days 00:21:26,18,42,24
183,RED,PLUO,0 days 00:20:27,-8,33,41
183,RED,P012044,0 days 00:16:08,-1,34,35
183,RED,P002553,0 days 00:12:34,-7,20,27
183,RED,P000848,0 days 00:07:41,1,14,13
183,RED,P011941,0 days 00:06:56,10,12,2
183,RED,P011964,0 days 00:05:01,-1,10,11
183,RED,P008966,0 days 00:00:27,2,2,0
184,MAD,P005791,0 days 00:38:18,7,80,73
184,MAD,P005928,0 days 00:29:55,7,64,57
184,MAD,P006540,0 days 00:28:55,14,65,51
184,MAD,PTGB,0 days 00:26:05,4,57,53
184,MAD,P003108,0 days 00:24:52,8,56,48
184,MAD,P010357,0 days 00:22:59,-3,45,48
184,MAD,P001392,0 days 00:16:30,4,33,29
184,MAD,P003733,0 days 00:15:39,3,32,29
184,MAD,PCVM,0 days 00:14:15,7,34,27
184,MAD,P009213,0 days 00:06:41,1,14,13
184,MAD,P010623,0 days 00:00:51,-2,0,2
184,PAM,P010568,0 days 00:29:34,-14,51,65
184,PAM,P003960,0 days 00:29:10,-1,66,67
184,PAM,P011970,0 days 00:26:38,-10,44,54
184,PAM,P007870,0 days 00:23:21,4,54,50
184,PAM,P012795,0 days 00:22:08,-11,40,51
184,PAM,P004863,0 days 00:18:55,4,47,43
184,PAM,P012738,0 days 00:18:17,-12,26,38
184,PAM,P012740,0 days 00:17:04,1,35,34
184,PAM,P006643,0 days 00:16:08,6,37,31
184,PAM,P010393,0 days 00:09:32,-6,13,19
184,PAM,P012739,0 days 00:09:04,-5,11,16
184,PAM,P005356,0 days 00:05:09,-6,6,12
185,IST,P007200,0 days 00:34:25,28,91,63
185,IST,P009846,0 days 00:31:39,13,78,65
185,IST,P009664,0 days 00:30:09,24,80,56
185,IST,P011078,0 days 00:22:47,21,65,44
185,IST,P006590,0 days 00:22:33,7,48,41
185,IST,P011981,0 days 00:17:55,6,43,37
185,IST,P012788,0 days 00:16:08,14,43,29
185,IST,PLHK,0 days 00:11:37,2,23,21
185,IST,P010400,0 days 00:09:37,6,20,14
185,IST,P012710,0 days 00:03:10,-1,4,5
185,VIR,P001844,0 days 00:26:37,-7,51,58
185,VIR,P003048,0 days 00:24:39,-22,44,66
185,VIR,P009549,0 days 00:22:30,-7,43,50
185,VIR,PBCN,0 days 00:20:34,-6,40,46
185,VIR,P010781,0 days 00:18:55,-21,31,52
185,VIR,P002084,0 days 00:16:14,-4,32,36
185,VIR,P003527,0 days 00:15:05,-21,27,48
185,VIR,P001133,0 days 00:14:36,-14,24,38
185,VIR,P008847,0 days 00:13:12,-1,30,31
185,VIR,P006739,0 days 00:10:43,-10,19,29
185,VIR,P005553,0 days 00:08:42,-4,21,25
185,VIR,P004554,0 days 00:08:13,-3,13,16
186,ASV,P011225,0 days 00:29:40,-17,51,68
186,ASV,P012080,0 days 00:29:21,-21,52,73
186,ASV,P004194,0 days 00:24:01,-12,37,49
186,ASV,PKIR,0 days 00:23:07,-5,40,45
186,ASV,P012731,0 days 00:19:17,4,35,31
186,ASV,P006568,0 days 00:19:08,-16,33,49
186,ASV,P012729,0 days 00:17:34,-26,21,47
186,ASV,P000229,0 days 00:15:47,-10,20,30
186,ASV,P003526,0 days 00:11:45,-14,14,28
186,ASV,P011386,0 days 00:10:20,-8,12,20
186,BER,P012720,0 days 00:24:19,14,56,42
186,BER,P003958,0 days 00:23:48,15,52,37
186,BER,P008173,0 days 00:20:51,14,45,31
186,BER,P008967,0 days 00:20:38,14,49,35
186,BER,P006251,0 days 00:19:46,7,38,31
186,BER,P008384,0 days 00:19:44,14,42,28
186,BER,P008211,0 days 00:19:09,11,43,32
186,BER,P011934,0 days 00:18:48,10,40,30
186,BER,P010791,0 days 00:16:15,18,44,26
186,BER,P012721,0 days 00:13:56,8,27,19
186,BER,P006819,0 days 00:01:23,0,2,2
186,BER,P007025,0 days 00:01:23,0,2,2
187,BAR,P004866,0 days 00:28:17,21,69,48
187,BAR,P009992,0 days 00:27:54,30,71,41
187,BAR,P012745,0 days 00:26:38,28,68,40
187,BAR,P002939,0 days 00:25:24,6,55,49
187,BAR,P003196,0 days 00:21:27,13,48,35
187,BAR,P007464,0 days 00:17:44,-9,30,39
187,BAR,P000925,0 days 00:17:43,5,41,36
187,BAR,P007519,0 days 00:15:46,4,34,30
187,BAR,P011244,0 days 00:13:15,-7,25,32
187,BAR,P003204,0 days 00:02:44,-1,6,7
187,BAR,P011666,0 days 00:01:34,0,4,4
187,BAR,P012197,0 days 00:01:34,0,4,4
187,ZAL,P002329,0 days 00:29:10,-6,52,58
187,ZAL,P005504,0 days 00:26:31,-4,57,61
187,ZAL,P012715,0 days 00:24:59,1,55,54
187,ZAL,P012787,0 days 00:24:20,-1,50,51
187,ZAL,P011218,0 days 00:24:09,6,46,40
187,ZAL,P007109,0 days 00:21:21,-31,23,54
187,ZAL,P003211,0 days 00:17:01,-27,21,48
187,ZAL,P003210,0 days 00:13:51,-12,27,39
187,ZAL,P009917,0 days 00:10:09,-11,14,25
187,ZAL,P010390,0 days 00:06:24,-8,13,21
187,ZAL,P007513,0 days 00:02:05,3,7,4
188,BAS,P004603,0 days 00:32:04,10,62,52
188,BAS,P009048,0 days 00:26:57,8,59,51
188,BAS,P012201,0 days 00:25:09,13,59,46
188,BAS,P011948,0 days 00:22:42,12,54,42
188,BAS,P004761,0 days 00:21:27,-4,33,37
188,BAS,P003198,0 days 00:20:40,10,44,34
188,BAS,P007230,0 days 00:20:08,-2,31,33
188,BAS,P012765,0 days 00:13:03,3,21,18
188,BAS,P011085,0 days 00:09:54,4,19,15
188,BAS,P010444,0 days 00:07:50,1,18,17
188,BAS,P008850,0 days 00:00:06,0,0,0
188,OLY,P007982,0 days 00:32:54,-5,63,68
188,OLY,P010612,0 days 00:29:51,-4,55,59
188,OLY,P003941,0 days 00:24:32,0,44,44
188,OLY,P008829,0 days 00:22:06,-9,38,47
188,OLY,P011194,0 days 00:18:00,-2,31,33
188,OLY,P001255,0 days 00:16:37,-4,25,29
188,OLY,P008811,0 days 00:15:22,-11,25,36
188,OLY,P008855,0 days 00:13:02,-3,19,22
188,OLY,P010392,0 days 00:09:33,-5,18,23
188,OLY,P011983,0 days 00:09:02,1,14,13
188,OLY,P007853,0 days 00:09:01,-13,13,26
189,PAR,P008987,0 days 00:30:42,3,64,61
189,PAR,P007673,0 days 00:27:51,11,62,51
189,PAR,P007400,0 days 00:26:46,13,67,54
189,PAR,P012096,0 days 00:24:45,6,56,50
189,PAR,P012742,0 days 00:22:34,3,46,43
189,PAR,P011051,0 days 00:21:34,7,46,39
189,PAR,P009862,0 days 00:21:09,-12,36,48
189,PAR,P004058,0 days 00:20:24,30,60,30
189,PAR,P011192,0 days 00:03:32,-13,0,13
189,PAR,P004172,0 days 00:00:43,-3,3,6
189,TEL,P009863,0 days 00:28:19,-2,53,55
189,TEL,P009622,0 days 00:27:54,-10,47,57
189,TEL,P009783,0 days 00:26:29,-11,48,59
189,TEL,P011219,0 days 00:24:54,-8,44,52
189,TEL,P011199,0 days 00:20:38,-1,39,40
189,TEL,P011971,0 days 00:19:13,-5,40,45
189,TEL,P011193,0 days 00:16:29,-6,41,47
189,TEL,P011214,0 days 00:14:15,-2,35,37
189,TEL,P007990,0 days 00:13:48,-7,29,36
189,TEL,P012744,0 days 00:08:01,7,19,12
190,BER,P012720,0 days 00:25:48,2,50,48
190,BER,P008173,0 days 00:25:42,4,48,44
190,BER,P003958,0 days 00:24:56,5,51,46
190,BER,P011934,0 days 00:23:16,7,48,41
190,BER,P008967,0 days 00:23:06,-12,35,47
190,BER,P012721,0 days 00:21:52,-10,34,44
190,BER,P010791,0 days 00:16:44,-24,17,41
190,BER,P008780,0 days 00:14:18,-21,17,38
190,BER,P008384,0 days 00:12:18,-18,13,31
190,BER,P006251,0 days 00:06:15,-13,4,17
190,BER,P008211,0 days 00:05:45,-5,8,13
190,MUN,P011987,0 days 00:23:27,-5,43,48
190,MUN,P008985,0 days 00:23:14,-9,39,48
190,MUN,P003583,0 days 00:22:41,-10,37,47
190,MUN,P007056,0 days 00:22:37,-7,40,47
190,MUN,P010391,0 days 00:18:58,13,44,31
190,MUN,P007639,0 days 00:17:19,27,45,18
190,MUN,P007975,0 days 00:16:46,26,43,17
190,MUN,P004508,0 days 00:16:33,22,39,17
190,MUN,P001288,0 days 00:16:17,26,43,17
190,MUN,P001557,0 days 00:12:10,8,25,17
190,MUN,P006760,0 days 00:06:11,-10,4,14
190,MUN,P006543,0 days 00:03:47,4,8,4
191,RED,P006436,0 days 00:35:11,-3,77,80
191,RED,P009035,0 days 00:31:31,-2,68,70
191,RED,P012044,0 days 00:26:03,14,65,51
191,RED,PLUO,0 days 00:24:26,5,63,58
191,RED,P002553,0 days 00:23:44,6,57,51
191,RED,P005099,0 days 00:17:41,-11,31,42
191,RED,P012801,0 days 00:16:53,-8,37,45
191,RED,P007960,0 days 00:16:02,-7,30,37
191,RED,P011941,0 days 00:08:29,1,22,21
191,BAS,P009048,0 days 00:33:38,7,80,73
191,BAS,P012201,0 days 00:32:29,8,75,67
191,BAS,P010444,0 days 00:31:33,15,73,58
191,BAS,P004761,0 days 00:27:52,3,66,63
191,BAS,P011948,0 days 00:22:52,4,53,49
191,BAS,P007230,0 days 00:19:21,-19,38,57
191,BAS,P011085,0 days 00:14:25,-1,30,31
191,BAS,P003198,0 days 00:07:30,0,19,19
191,BAS,P004603,0 days 00:06:36,-9,13,22
191,BAS,P008850,0 days 00:03:44,-3,8,11
192,VIR,PBCN,0 days 00:29:27,-1,53,54
192,VIR,P001844,0 days 00:27:59,9,50,41
192,VIR,P009549,0 days 00:24:10,-5,39,44
192,VIR,P002084,0 days 00:22:37,14,49,35
192,VIR,P008847,0 days 00:21:54,-4,28,32
192,VIR,P006739,0 days 00:18:57,18,44,26
192,VIR,P003048,0 days 00:18:11,1,32,31
192,VIR,P004554,0 days 00:16:39,10,36,26
192,VIR,P010781,0 days 00:15:44,11,28,17
192,VIR,P003527,0 days 00:04:22,-3,6,9
192,ASV,P012080,0 days 00:30:18,-10,50,60
192,ASV,P011225,0 days 00:30:00,-9,52,61
192,ASV,P006568,0 days 00:26:17,0,48,48
192,ASV,P005094,0 days 00:24:49,-12,39,51
192,ASV,P003526,0 days 00:20:09,0,34,34
192,ASV,P012731,0 days 00:19:54,-10,27,37
192,ASV,P004194,0 days 00:18:12,-11,22,33
192,ASV,P012729,0 days 00:10:39,3,19,16
192,ASV,P000229,0 days 00:10:05,0,13,13
192,ASV,P011386,0 days 00:09:37,-1,11,12
193,IST,P007200,0 days 00:33:22,24,88,64
193,IST,P009846,0 days 00:31:40,18,75,57
193,IST,P009664,0 days 00:26:38,21,64,43
193,IST,P011078,0 days 00:25:14,6,54,48
193,IST,P012788,0 days 00:21:48,21,65,44
193,IST,PLHK,0 days 00:19:29,2,38,36
193,IST,P006590,0 days 00:18:06,13,49,36
193,IST,P004888,0 days 00:09:58,10,26,16
193,IST,P012786,0 days 00:08:05,2,18,16
193,IST,P011981,0 days 00:05:06,3,13,10
193,IST,P010400,0 days 00:00:34,0,0,0
193,BAR,P002939,0 days 00:29:23,-16,58,74
193,BAR,P004866,0 days 00:28:33,-23,51,74
193,BAR,P012745,0 days 00:27:08,-15,45,60
193,BAR,P009992,0 days 00:26:36,-18,43,61
193,BAR,P007519,0 days 00:24:21,-19,43,62
193,BAR,P003196,0 days 00:20:29,-13,37,50
193,BAR,P000925,0 days 00:19:16,-11,37,48
193,BAR,P011244,0 days 00:13:07,-9,29,38
193,BAR,P007464,0 days 00:11:07,4,27,23
194,OLY,P003941,0 days 00:31:31,28,81,53
194,OLY,P010612,0 days 00:25:28,19,65,46
194,OLY,P001255,0 days 00:25:21,11,59,48
194,OLY,P008855,0 days 00:23:50,20,58,38
194,OLY,P007982,0 days 00:20:42,-3,39,42
194,OLY,P010392,0 days 00:20:00,3,36,33
194,OLY,P008829,0 days 00:19:55,24,51,27
194,OLY,P011194,0 days 00:19:02,-10,35,45
194,OLY,P007853,0 days 00:05:49,3,11,8
194,OLY,P006589,0 days 00:04:11,-5,5,10
194,OLY,P011965,0 days 00:04:11,-5,5,10
194,TEL,P007990,0 days 00:27:38,2,56,54
194,TEL,P009863,0 days 00:27:31,-20,44,64
194,TEL,P009783,0 days 00:25:03,-24,37,61
194,TEL,P011219,0 days 00:24:51,-23,38,61
194,TEL,P011193,0 days 00:23:47,-14,42,56
194,TEL,P011199,0 days 00:22:37,-12,33,45
194,TEL,P011971,0 days 00:15:31,4,36,32
194,TEL,P004233,0 days 00:13:30,9,30,21
194,TEL,P011214,0 days 00:12:03,-5,26,31
194,TEL,P012744,0 days 00:07:17,-2,18,20
194,TEL,P011433,0 days 00:00:12,0,0,0
195,MCO,P005985,0 days 00:32:37,27,84,57
195,MCO,P011226,0 days 00:25:51,14,63,49
195,MCO,P011212,0 days 00:24:33,10,56,46
195,MCO,P011231,0 days 00:21:39,7,47,40
195,MCO,P009754,0 days 00:18:30,8,49,41
195,MCO,P004197,0 days 00:18:29,13,42,29
195,MCO,P004790,0 days 00:18:21,17,51,34
195,MCO,P011196,0 days 00:16:46,5,37,32
195,MCO,PLCZ,0 days 00:13:54,7,37,30
195,MCO,P002581,0 days 00:09:20,12,24,12
195,MAD,P004887,0 days 00:23:46,-18,44,62
195,MAD,P010357,0 days 00:23:02,-5,48,53
195,MAD,PBMT,0 days 00:20:09,-1,43,44
195,MAD,P005928,0 days 00:18:48,-16,36,52
195,MAD,P003108,0 days 00:18:16,-21,29,50
195,MAD,P006540,0 days 00:17:28,-16,30,46
195,MAD,P009005,0 days 00:16:05,-12,24,36
195,MAD,P001392,0 days 00:15:39,-11,34,45
195,MAD,P003733,0 days 00:15:06,-10,26,36
195,MAD,PCVM,0 days 00:12:06,-13,18,31
195,MAD,P009213,0 days 00:10:29,-2,18,20
195,MAD,P010623,0 days 00:09:06,5,20,15
196,PAN,P011204,0 days 00:35:38,14,75,61
196,PAN,P007866,0 days 00:33:50,10,70,60
196,PAN,P012774,0 days 00:31:41,5,64,59
196,PAN,P003842,0 days 00:30:55,14,67,53
196,PAN,P001926,0 days 00:26:46,15,62,47
196,PAN,P002328,0 days 00:25:05,3,49,46
196,PAN,P012712,0 days 00:07:52,3,16,13
196,PAN,P011221,0 days 00:07:23,-1,15,16
196,PAN,P011209,0 days 00:00:50,2,2,0
196,PAR,P012742,0 days 00:33:29,-8,62,70
196,PAR,P008987,0 days 00:24:54,-3,45,48
196,PAR,P007400,0 days 00:24:42,-9,46,55
196,PAR,P007673,0 days 00:21:55,-7,37,44
196,PAR,P011051,0 days 00:21:44,-10,40,50
196,PAR,P012096,0 days 00:16:13,-1,28,29
196,PAR,P011050,0 days 00:13:48,-4,24,28
196,PAR,P000956,0 days 00:12:24,-3,22,25
196,PAR,P011192,0 days 00:11:19,-10,19,29
196,PAR,P004058,0 days 00:09:21,-1,17,18
196,PAR,P004172,0 days 00:08:53,-5,13,18
196,PAR,P012743,0 days 00:01:18,-4,2,6
197,PAM,P010568,0 days 00:28:48,14,65,51
197,PAM,P011982,0 days 00:26:37,21,63,42
197,PAM,P007870,0 days 00:24:31,2,46,44
197,PAM,P012740,0 days 00:21:32,7,44,37
197,PAM,P012738,0 days 00:16:00,8,37,29
197,PAM,P011970,0 days 00:15:27,15,39,24
197,PAM,P010393,0 days 00:15:09,10,34,24
197,PAM,P003960,0 days 00:14:41,0,29,29
197,PAM,P006433,0 days 00:11:12,-2,19,21
197,PAM,P005356,0 days 00:10:58,-10,15,25
197,PAM,P012795,0 days 00:07:36,-6,12,18
197,PAM,P012739,0 days 00:07:29,1,17,16
197,MIL,P011205,0 days 00:33:13,-11,56,67
197,MIL,P011224,0 days 00:29:31,-7,47,54
197,MIL,P002849,0 days 00:27:27,3,51,48
197,MIL,P007201,0 days 00:21:36,-16,37,53
197,MIL,P012800,0 days 00:18:44,-2,29,31
197,MIL,P002812,0 days 00:16:53,-3,27,30
197,MIL,P006509,0 days 00:16:27,1,35,34
197,MIL,P007831,0 days 00:13:24,-14,27,41
197,MIL,P009960,0 days 00:12:10,-10,25,35
197,MIL,P005670,0 days 00:08:41,-3,22,25
197,MIL,P001518,0 days 00:01:54,2,4,2
198,ZAL,P012715,0 days 00:32:10,28,80,52
198,ZAL,P011218,0 days 00:28:20,22,71,49
198,ZAL,P002329,0 days 00:22:56,17,59,42
198,ZAL,P005504,0 days 00:22:00,35,59,24
198,ZAL,P007109,0 days 00:19:08,-8,42,50
198,ZAL,P012787,0 days 00:18:08,18,42,24
198,ZAL,P002676,0 days 00:14:33,3,39,36
198,ZAL,P003211,0 days 00:13:54,11,36,25
198,ZAL,P003210,0 days 00:13:14,1,29,28
198,ZAL,P010390,0 days 00:12:58,-15,25,40
198,ZAL,P006860,0 days 00:01:36,6,6,0
198,ZAL,P007513,0 days 00:01:03,-3,2,5
198,ULK,P006661,0 days 00:26:13,-16,50,66
198,ULK,P010560,0 days 00:24:31,-25,33,58
198,ULK,P009849,0 days 00:23:51,-4,56,60
198,ULK,P004004,0 days 00:23:13,-1,56,57
198,ULK,P002968,0 days 00:22:17,-15,32,47
198,ULK,P005844,0 days 00:20:24,-13,30,43
198,ULK,P001932,0 days 00:19:47,-5,34,39
198,ULK,P011052,0 days 00:13:10,-12,21,33
198,ULK,P011157,0 days 00:13:09,-3,37,40
198,ULK,P002969,0 days 00:08:35,-9,20,29
198,ULK,P011201,0 days 00:02:25,-6,3,9
198,ULK,P012724,0 days 00:02:25,-6,3,9
199,BER,P008967,0 days 00:26:54,11,62,51
199,BER,P008780,0 days 00:26:16,8,57,49
199,BER,P011934,0 days 00:25:26,8,60,52
199,BER,P012720,0 days 00:22:57,4,47,43
199,BER,P012721,0 days 00:18:00,4,39,35
199,BER,P008384,0 days 00:16:59,3,42,39
199,BER,P003958,0 days 00:16:02,11,41,30
199,BER,P010791,0 days 00:14:34,1,29,28
199,BER,P008211,0 days 00:13:40,-2,29,31
199,BER,P008173,0 days 00:13:14,3,30,27
199,BER,P006251,0 days 00:05:58,-6,9,15
199,RED,P009035,0 days 00:34:11,-2,71,73
199,RED,P006436,0 days 00:30:12,-8,60,68
199,RED,P012801,0 days 00:24:34,5,52,47
199,RED,P012044,0 days 00:24:29,-10,47,57
199,RED,P005099,0 days 00:23:23,-2,48,50
199,RED,P007960,0 days 00:15:41,-12,25,37
199,RED,P002553,0 days 00:14:59,-3,28,31
199,RED,P000848,0 days 00:12:47,-7,22,29
199,RED,PLUO,0 days 00:12:41,2,33,31
199,RED,P011941,0 days 00:04:13,-5,6,11
199,RED,P008966,0 days 00:02:50,-3,8,11
200,MUN,P001288,0 days 00:30:43,-12,45,57
200,MUN,P011987,0 days 00:30:29,0,54,54
200,MUN,P007975,0 days 00:22:32,-2,37,39
200,MUN,P005460,0 days 00:20:38,4,39,35
200,MUN,P004508,0 days 00:19:32,-19,24,43
200,MUN,P007639,0 days 00:16:44,-18,19,37
200,MUN,P006760,0 days 00:15:42,-2,28,30
200,MUN,P010391,0 days 00:13:19,-8,16,24
200,MUN,P008985,0 days 00:12:08,-3,22,25
200,MUN,P007056,0 days 00:10:25,1,21,20
200,MUN,P001557,0 days 00:07:48,-1,15,16
200,ASV,P011225,0 days 00:34:24,23,72,49
200,ASV,P000229,0 days 00:33:42,3,60,57
200,ASV,P012731,0 days 00:27:24,8,49,41
200,ASV,P006568,0 days 00:25:19,13,52,39
200,ASV,P012729,0 days 00:24:53,14,52,38
200,ASV,P005094,0 days 00:15:09,0,26,26
200,ASV,P004194,0 days 00:14:41,-1,24,25
200,ASV,P003526,0 days 00:13:00,1,25,24
200,ASV,P011386,0 days 00:07:35,-3,12,15
200,ASV,PKIR,0 days 00:03:53,2,8,6
201,ULK,P006661,0 days 00:30:48,21,73,52
201,ULK,P004004,0 days 00:29:54,9,62,53
201,ULK,P011157,0 days 00:28:32,3,61,58
201,ULK,P001932,0 days 00:23:02,20,58,38
201,ULK,P006068,0 days 00:21:14,20,53,33
201,ULK,P005844,0 days 00:16:41,-6,30,36
201,ULK,P011052,0 days 00:16:04,-5,28,33
201,ULK,P009849,0 days 00:16:01,-5,33,38
201,ULK,P002968,0 days 00:11:28,10,27,17
201,ULK,P002969,0 days 00:06:16,-2,15,17
201,VIR,P010781,0 days 00:35:31,-6,70,76
201,VIR,P001844,0 days 00:30:12,-15,52,67
201,VIR,P009549,0 days 00:27:50,-7,58,65
201,VIR,P003527,0 days 00:21:22,-6,37,43
201,VIR,P004554,0 days 00:21:14,2,43,41
201,VIR,P008847,0 days 00:19:31,-8,40,48
201,VIR,P003048,0 days 00:14:58,-10,25,35
201,VIR,P002084,0 days 00:14:09,-10,22,32
201,VIR,P006739,0 days 00:12:37,-2,24,26
201,VIR,P005553,0 days 00:02:36,-3,4,7
202,TEL,P009783,0 days 00:33:47,26,83,57
202,TEL,P009622,0 days 00:32:21,19,72,53
202,TEL,P009863,0 days 00:30:40,14,74,60
202,TEL,P011199,0 days 00:30:35,30,78,48
202,TEL,P011971,0 days 00:22:38,18,58,40
202,TEL,P011193,0 days 00:12:25,-16,20,36
202,TEL,P011219,0 days 00:10:40,-14,15,29
202,TEL,P011214,0 days 00:09:25,-15,12,27
202,TEL,P005145,0 days 00:09:15,5,19,14
202,TEL,P007990,0 days 00:04:34,13,14,1
202,TEL,P004233,0 days 00:03:40,-5,5,10
202,PAN,P011204,0 days 00:34:45,-10,67,77
202,PAN,P007866,0 days 00:27:03,-20,46,66
202,PAN,P002328,0 days 00:26:34,-13,49,62
202,PAN,P003842,0 days 00:23:40,-26,35,61
202,PAN,P012774,0 days 00:21:34,-18,35,53
202,PAN,P011209,0 days 00:20:42,4,45,41
202,PAN,P012712,0 days 00:16:35,4,35,31
202,PAN,P011221,0 days 00:16:20,11,40,29
202,PAN,P005161,0 days 00:12:47,-7,23,30
203,MAD,P004887,0 days 00:28:48,9,73,64
203,MAD,P005928,0 days 00:26:33,9,66,57
203,MAD,P009005,0 days 00:25:51,2,61,59
203,MAD,P006540,0 days 00:23:10,1,53,52
203,MAD,P003733,0 days 00:21:35,15,53,38
203,MAD,P001392,0 days 00:17:15,-11,35,46
203,MAD,P003108,0 days 00:17:04,0,36,36
203,MAD,PBMT,0 days 00:15:09,6,32,26
203,MAD,PCVM,0 days 00:13:23,-2,24,26
203,MAD,P009213,0 days 00:11:12,-4,17,21
203,OLY,P008829,0 days 00:27:08,-5,59,64
203,OLY,P008855,0 days 00:26:29,2,61,59
203,OLY,P001255,0 days 00:25:34,14,66,52
203,OLY,P006589,0 days 00:24:02,-1,51,52
203,OLY,P007853,0 days 00:23:24,-9,49,58
203,OLY,P010612,0 days 00:19:56,-10,36,46
203,OLY,P011965,0 days 00:18:16,1,42,41
203,OLY,P011194,0 days 00:14:37,-7,27,34
203,OLY,P011983,0 days 00:10:30,-7,15,22
203,OLY,P010392,0 days 00:10:04,-3,19,22
204,IST,P006590,0 days 00:29:07,9,63,54
204,IST,P009846,0 days 00:27:25,13,63,50
204,IST,P011078,0 days 00:25:53,-12,47,59
204,IST,P009664,0 days 00:24:53,2,48,46
204,IST,P007200,0 days 00:23:53,-3,44,47
204,IST,P004888,0 days 00:23:46,-9,41,50
204,IST,P012788,0 days 00:17:23,5,40,35
204,IST,PLHK,0 days 00:15:43,-13,28,41
204,IST,P011981,0 days 00:11:57,-2,16,18
204,MCO,P005985,0 days 00:33:14,1,66,65
204,MCO,P011226,0 days 00:29:48,-4,58,62
204,MCO,P010588,0 days 00:25:28,-5,47,52
204,MCO,P009754,0 days 00:22:09,4,48,44
204,MCO,P011212,0 days 00:22:04,6,45,39
204,MCO,P011231,0 days 00:18:00,6,42,36
204,MCO,PLCZ,0 days 00:16:48,15,38,23
204,MCO,P011196,0 days 00:12:36,-11,15,26
204,MCO,P002581,0 days 00:10:21,2,26,24
204,MCO,P004197,0 days 00:05:05,3,12,9
204,MCO,P012709,0 days 00:04:27,-7,3,10
205,MIL,P007831,0 days 00:32:48,5,66,61
205,MIL,P011224,0 days 00:28:50,3,59,56
205,MIL,P002849,0 days 00:26:54,0,53,53
205,MIL,P011205,0 days 00:26:30,-12,43,55
205,MIL,P012800,0 days 00:20:28,15,42,27
205,MIL,P009960,0 days 00:15:29,-4,26,30
205,MIL,P007201,0 days 00:14:49,13,31,18
205,MIL,P001518,0 days 00:12:09,-2,17,19
205,MIL,P002812,0 days 00:11:25,0,20,20
205,MIL,P005670,0 days 00:08:44,5,13,8
205,MIL,P007032,0 days 00:01:54,-3,0,3
205,BAR,P004866,0 days 00:33:15,1,58,57
205,BAR,P002939,0 days 00:28:58,0,57,57
205,BAR,P012745,0 days 00:27:59,4,59,55
205,BAR,P000925,0 days 00:26:45,13,58,45
205,BAR,P007519,0 days 00:24:09,8,50,42
205,BAR,P009992,0 days 00:17:56,-10,30,40
205,BAR,P003196,0 days 00:13:15,-17,12,29
205,BAR,P006435,0 days 00:12:41,-7,10,17
205,BAR,P011244,0 days 00:12:01,-8,11,19
205,BAR,P007464,0 days 00:03:01,-4,5,9
206,PAR,P007400,0 days 00:31:25,18,66,48
206,PAR,P008987,0 days 00:28:47,0,57,57
206,PAR,P012742,0 days 00:27:40,6,61,55
206,PAR,P009862,0 days 00:25:54,4,57,53
206,PAR,P011051,0 days 00:21:39,-1,40,41
206,PAR,P007673,0 days 00:17:24,3,29,26
206,PAR,P012096,0 days 00:16:50,-7,30,37
206,PAR,P003983,0 days 00:15:33,6,26,20
206,PAR,P012743,0 days 00:14:48,16,39,23
206,ZAL,P011218,0 days 00:31:38,4,61,57
206,ZAL,P007513,0 days 00:25:34,-11,49,60
206,ZAL,P007109,0 days 00:25:18,-10,43,53
206,ZAL,P010390,0 days 00:21:56,-3,40,43
206,ZAL,P002676,0 days 00:21:11,-5,43,48
206,ZAL,P012715,0 days 00:17:28,-1,31,32
206,ZAL,P002329,0 days 00:17:08,0,32,32
206,ZAL,P005504,0 days 00:16:37,-4,32,36
206,ZAL,P003210,0 days 00:10:06,-13,13,26
206,ZAL,P003211,0 days 00:08:16,1,10,9
206,ZAL,P012787,0 days 00:04:48,-3,6,9
207,BAS,P007230,0 days 00:32:25,-13,49,62
207,BAS,P012201,0 days 00:27:41,-2,45,47
207,BAS,P004761,0 days 00:26:14,-10,35,45
207,BAS,P009048,0 days 00:25:26,-20,26,46
207,BAS,P010444,0 days 00:19:38,3,38,35
207,BAS,P007946,0 days 00:18:31,2,41,39
207,BAS,P011948,0 days 00:17:52,-12,30,42
207,BAS,P004603,0 days 00:16:19,-14,20,34
207,BAS,P008850,0 days 00:08:13,-6,14,20
207,BAS,P003198,0 days 00:04:50,1,8,7
207,BAS,P011085,0 days 00:02:51,-4,4,8
207,PAM,P007870,0 days 00:28:43,7,51,44
207,PAM,P010568,0 days 00:27:48,14,51,37
207,PAM,P005356,0 days 00:22:50,10,45,35
207,PAM,P003960,0 days 00:22:35,25,46,21
207,PAM,P012795,0 days 00:21:37,17,46,29
207,PAM,P011982,0 days 00:19:31,-4,37,41
207,PAM,P004863,0 days 00:16:36,2,33,31
207,PAM,P011970,0 days 00:11:54,-5,25,30
207,PAM,P006433,0 days 00:11:49,6,18,12
207,PAM,P010393,0 days 00:11:19,0,22,22
207,PAM,P012740,0 days 00:05:18,3,11,8
208,RED,P006436,0 days 00:24:06,12,48,36
208,RED,P007960,0 days 00:24:03,19,57,38
208,RED,P008966,0 days 00:22:45,16,50,34
208,RED,P012044,0 days 00:20:43,2,37,35
208,RED,PJDR,0 days 00:20:26,17,46,29
208,RED,P012801,0 days 00:20:11,7,37,30
208,RED,P000848,0 days 00:18:27,9,46,37
208,RED,P009035,0 days 00:15:12,4,28,24
208,RED,P005099,0 days 00:11:18,10,27,17
208,RED,PLUO,0 days 00:11:17,-1,18,19
208,RED,P002553,0 days 00:09:29,-3,12,15
208,RED,P011941,0 days 00:02:03,-2,4,6
208,PAM,P010568,0 days 00:25:27,0,46,46
208,PAM,P003960,0 days 00:22:56,-1,38,39
208,PAM,P011982,0 days 00:22:48,-11,36,47
208,PAM,P012738,0 days 00:21:50,-4,39,43
208,PAM,P011970,0 days 00:21:42,-11,35,46
208,PAM,P012740,0 days 00:18:28,-6,34,40
208,PAM,P005356,0 days 00:13:11,-6,18,24
208,PAM,P010393,0 days 00:12:35,-19,17,36
208,PAM,P006643,0 days 00:11:18,-6,17,23
208,PAM,P006433,0 days 00:10:14,-15,13,28
208,PAM,P000556,0 days 00:09:58,-6,14,20
208,PAM,P012795,0 days 00:09:33,-5,13,18
209,MUN,P001288,0 days 00:34:06,-5,81,86
209,MUN,P003583,0 days 00:31:38,-1,70,71
209,MUN,P007975,0 days 00:25:18,3,60,57
209,MUN,P010391,0 days 00:24:57,7,65,58
209,MUN,P004508,0 days 00:22:07,3,54,51
209,MUN,P001557,0 days 00:21:57,-6,46,52
209,MUN,P011987,0 days 00:21:47,-1,58,59
209,MUN,P008985,0 days 00:19:06,3,53,50
209,MUN,P006543,0 days 00:12:24,9,39,30
209,MUN,P005460,0 days 00:11:40,3,34,31
209,BAS,P009048,0 days 00:39:53,-1,100,101
209,BAS,P003198,0 days 00:33:10,-2,77,79
209,BAS,P010444,0 days 00:28:59,1,73,72
209,BAS,P011948,0 days 00:28:13,7,73,66
209,BAS,P004761,0 days 00:26:38,-13,59,72
209,BAS,P007946,0 days 00:20:17,-2,48,50
209,BAS,P004603,0 days 00:19:02,-6,42,48
209,BAS,P012201,0 days 00:18:51,0,45,45
209,BAS,P008850,0 days 00:05:38,5,21,16
209,BAS,P011085,0 days 00:04:19,-4,7,11
210,ASV,P011225,0 days 00:30:55,-13,59,72
210,ASV,P000229,0 days 00:26:55,-10,46,56
210,ASV,P012729,0 days 00:26:11,2,58,56
210,ASV,PKIR,0 days 00:22:52,1,50,49
210,ASV,P006568,0 days 00:22:12,-11,36,47
210,ASV,P012731,0 days 00:21:51,1,39,38
210,ASV,P003526,0 days 00:20:49,-8,31,39
210,ASV,P005094,0 days 00:19:10,-15,32,47
210,ASV,P011386,0 days 00:09:05,3,14,11
210,ULK,P006661,0 days 00:33:05,22,79,57
210,ULK,P006068,0 days 00:29:57,8,59,51
210,ULK,P001932,0 days 00:27:38,9,53,44
210,ULK,P005844,0 days 00:24:11,17,58,41
210,ULK,P004004,0 days 00:23:25,1,49,48
210,ULK,P011157,0 days 00:23:16,0,47,47
210,ULK,P002968,0 days 00:16:44,10,36,26
210,ULK,P009849,0 days 00:08:15,-11,9,20
210,ULK,P006961,0 days 00:05:07,3,16,13
210,ULK,P011980,0 days 00:04:49,-2,7,9
210,ULK,P002969,0 days 00:03:33,-7,2,9
211,OLY,P010612,0 days 00:30:08,16,72,56
211,OLY,P001255,0 days 00:25:09,10,71,61
211,OLY,P012878,0 days 00:24:18,24,68,44
211,OLY,P007982,0 days 00:22:36,0,56,56
211,OLY,P011983,0 days 00:21:01,21,55,34
211,OLY,P008829,0 days 00:18:33,4,41,37
211,OLY,P006589,0 days 00:15:42,-10,33,43
211,OLY,P010392,0 days 00:14:18,-3,36,39
211,OLY,P008855,0 days 00:13:19,24,40,16
211,OLY,P011965,0 days 00:07:56,-15,13,28
211,OLY,P007853,0 days 00:07:00,-1,20,21
211,BER,P008173,0 days 00:25:09,4,64,60
211,BER,P008384,0 days 00:24:16,-6,54,60
211,BER,P012721,0 days 00:20:41,-1,48,49
211,BER,P011934,0 days 00:19:34,-10,42,52
211,BER,P006251,0 days 00:18:52,-13,39,52
211,BER,P010791,0 days 00:16:35,-9,32,41
211,BER,P012720,0 days 00:15:44,-8,33,41
211,BER,P008780,0 days 00:14:51,-18,23,41
211,BER,P008211,0 days 00:14:40,-8,28,36
211,BER,P008967,0 days 00:12:53,-16,20,36
211,BER,P007025,0 days 00:12:27,10,39,29
211,BER,P006819,0 days 00:04:18,5,13,8
212,MAD,P003108,0 days 00:26:16,11,73,62
212,MAD,P006540,0 days 00:25:53,0,69,69
212,MAD,P004887,0 days 00:25:38,7,72,65
212,MAD,P005928,0 days 00:24:45,9,70,61
212,MAD,P009005,0 days 00:22:11,-2,59,61
212,MAD,PBMT,0 days 00:18:26,1,48,47
212,MAD,P010357,0 days 00:17:09,0,41,41
212,MAD,PCVM,0 days 00:16:20,-7,40,47
212,MAD,P001392,0 days 00:08:11,-4,20,24
212,MAD,P003733,0 days 00:08:06,6,22,16
212,MAD,P009213,0 days 00:06:38,4,16,12
212,MAD,P010623,0 days 00:00:27,0,0,0
212,TEL,P009783,0 days 00:33:27,6,89,83
212,TEL,P009622,0 days 00:31:17,2,83,81
212,TEL,P009863,0 days 00:28:39,6,75,69
212,TEL,P011971,0 days 00:25:30,8,73,65
212,TEL,P011199,0 days 00:23:09,0,54,54
212,TEL,P011219,0 days 00:20:16,-7,53,60
212,TEL,P011193,0 days 00:16:07,-10,37,47
212,TEL,P011214,0 days 00:08:00,-15,17,32
212,TEL,P007990,0 days 00:06:53,-6,13,19
212,TEL,P005145,0 days 00:06:18,-7,11,18
212,TEL,P012744,0 days 00:00:24,-2,0,2
213,MCO,P005985,0 days 00:31:57,23,75,52
213,MCO,P010588,0 days 00:28:20,17,67,50
213,MCO,P011226,0 days 00:27:03,1,52,51
213,MCO,P011212,0 days 00:26:53,9,57,48
213,MCO,P002581,0 days 00:17:36,6,33,27
213,MCO,P009754,0 days 00:16:16,3,35,32
213,MCO,PLCZ,0 days 00:16:14,1,32,31
213,MCO,P004197,0 days 00:15:59,7,31,24
213,MCO,P011231,0 days 00:14:17,0,25,25
213,MCO,P011196,0 days 00:05:25,8,18,10
213,PAR,P008987,0 days 00:36:51,-9,70,79
213,PAR,P009862,0 days 00:35:53,-8,70,78
213,PAR,P007400,0 days 00:35:37,-14,65,79
213,PAR,P012743,0 days 00:22:20,6,46,40
213,PAR,P003983,0 days 00:21:32,4,46,42
213,PAR,P012742,0 days 00:20:38,-19,27,46
213,PAR,P012096,0 days 00:15:18,-20,19,39
213,PAR,P011051,0 days 00:05:17,-7,5,12
213,PAR,P007673,0 days 00:04:01,-4,2,6
213,PAR,P004058,0 days 00:02:33,-4,0,4
214,BAR,P004866,0 days 00:28:06,21,62,41
214,BAR,P002939,0 days 00:27:54,14,60,46
214,BAR,P012745,0 days 00:26:06,22,61,39
214,BAR,P006435,0 days 00:20:20,21,48,27
214,BAR,P000925,0 days 00:19:48,13,43,30
214,BAR,P009992,0 days 00:19:40,6,36,30
214,BAR,P003196,0 days 00:18:40,9,36,27
214,BAR,P007519,0 days 00:15:01,11,28,17
214,BAR,P011244,0 days 00:13:54,5,23,18
214,BAR,P007464,0 days 00:07:27,3,13,10
214,BAR,P003204,0 days 00:01:32,5,5,0
214,BAR,P010641,0 days 00:01:32,5,5,0
214,VIR,P001844,0 days 00:29:15,-22,40,62
214,VIR,P009549,0 days 00:25:25,-13,35,48
214,VIR,P010781,0 days 00:23:46,-26,31,57
214,VIR,P008847,0 days 00:21:11,-18,30,48
214,VIR,PBCN,0 days 00:20:39,-9,34,43
214,VIR,P003048,0 days 00:17:51,-14,26,40
214,VIR,P002084,0 days 00:16:58,-6,27,33
214,VIR,P004554,0 days 00:15:34,-5,23,28
214,VIR,P003527,0 days 00:14:19,-15,15,30
214,VIR,P006739,0 days 00:08:52,-1,14,15
214,VIR,P004007,0 days 00:04:38,-1,10,11
214,VIR,P005553,0 days 00:01:32,-5,0,5
215,PAN,P002328,0 days 00:31:56,15,61,46
215,PAN,P011204,0 days 00:30:20,13,53,40
215,PAN,P012774,0 days 00:27:35,13,55,42
215,PAN,P003842,0 days 00:23:49,15,51,36
215,PAN,P012712,0 days 00:21:43,11,47,36
215,PAN,P007866,0 days 00:19:07,6,32,26
215,PAN,P011209,0 days 00:18:19,10,39,29
215,PAN,P011221,0 days 00:16:11,2,28,26
215,PAN,P007947,0 days 00:09:11,4,24,20
215,PAN,P006544,0 days 00:01:49,-4,5,9
215,MIL,P011224,0 days 00:28:40,-13,45,58
215,MIL,P007831,0 days 00:27:38,-19,36,55
215,MIL,P011205,0 days 00:23:33,-12,38,50
215,MIL,P002849,0 days 00:20:07,-10,32,42
215,MIL,P012800,0 days 00:17:42,2,32,30
215,MIL,P007201,0 days 00:16:55,-9,25,34
215,MIL,P002812,0 days 00:16:17,-3,25,28
215,MIL,P009960,0 days 00:15:37,-8,21,29
215,MIL,P000796,0 days 00:15:10,-6,23,29
215,MIL,P007032,0 days 00:10:43,-4,25,29
215,MIL,P005670,0 days 00:07:38,-3,8,11
216,ZAL,P002676,0 days 00:24:38,13,56,43
216,ZAL,P003211,0 days 00:24:14,6,58,52
216,ZAL,P005504,0 days 00:23:36,19,59,40
216,ZAL,P007513,0 days 00:23:34,20,54,34
216,ZAL,P002329,0 days 00:20:33,20,51,31
216,ZAL,P012715,0 days 00:16:48,-2,42,44
216,ZAL,P011218,0 days 00:16:31,23,44,21
216,ZAL,P010390,0 days 00:16:19,9,37,28
216,ZAL,P007109,0 days 00:15:54,17,41,24
216,ZAL,P012787,0 days 00:13:45,2,28,26
216,ZAL,P006860,0 days 00:02:12,2,2,0
216,ZAL,P003210,0 days 00:01:56,1,8,7
216,IST,P004888,0 days 00:35:50,-18,63,81
216,IST,P007200,0 days 00:26:11,-38,32,70
216,IST,P011078,0 days 00:24:00,-8,46,54
216,IST,P009664,0 days 00:23:45,-5,52,57
216,IST,P006590,0 days 00:20:54,1,51,50
216,IST,PLHK,0 days 00:20:32,-15,35,50
216,IST,P011981,0 days 00:19:50,-2,43,45
216,IST,P009846,0 days 00:12:37,-18,15,33
216,IST,P012788,0 days 00:09:00,-16,10,26
216,IST,P010516,0 days 00:04:16,-5,3,8
216,IST,P012710,0 days 00:03:05,-6,0,6
217,BER,P006251,0 days 00:23:37,-20,29,49
217,BER,P012721,0 days 00:22:14,2,45,43
217,BER,P008967,0 days 00:21:45,-18,33,51
217,BER,P008173,0 days 00:20:25,5,43,38
217,BER,P008780,0 days 00:19:35,-20,23,43
217,BER,P008384,0 days 00:18:30,-9,29,38
217,BER,P011934,0 days 00:18:01,-22,21,43
217,BER,P012720,0 days 00:15:11,-17,18,35
217,BER,P010791,0 days 00:14:32,5,32,27
217,BER,P007025,0 days 00:12:42,8,29,21
217,BER,P008211,0 days 00:11:52,6,23,17
217,BER,P006819,0 days 00:01:36,5,5,0
217,PAM,P010393,0 days 00:22:54,13,48,35
217,PAM,P010568,0 days 00:21:28,15,48,33
217,PAM,P005356,0 days 00:19:52,0,41,41
217,PAM,P012738,0 days 00:19:45,-3,38,41
217,PAM,P012795,0 days 00:19:08,15,40,25
217,PAM,P011982,0 days 00:18:44,18,43,25
217,PAM,P012740,0 days 00:18:43,17,42,25
217,PAM,P003960,0 days 00:18:23,4,33,29
217,PAM,P006433,0 days 00:16:03,-5,26,31
217,PAM,P004863,0 days 00:13:32,7,25,18
217,PAM,P011970,0 days 00:11:28,-6,21,27
218,MUN,P001288,0 days 00:24:49,9,50,41
218,MUN,P003583,0 days 00:24:47,7,47,40
218,MUN,P010391,0 days 00:21:54,-4,44,48
218,MUN,P008985,0 days 00:19:40,-5,28,33
218,MUN,P007975,0 days 00:19:36,-4,39,43
218,MUN,P011987,0 days 00:18:36,-3,26,29
218,MUN,P001557,0 days 00:17:42,5,29,24
218,MUN,P004508,0 days 00:13:34,-5,28,33
218,MUN,P006760,0 days 00:12:21,-11,19,30
218,MUN,P006543,0 days 00:11:48,2,25,23
218,MUN,P005460,0 days 00:08:57,-2,19,21
218,MUN,P007639,0 days 00:06:16,-9,6,15
218,OLY,P008855,0 days 00:28:20,10,52,42
218,OLY,P008829,0 days 00:20:00,10,37,27
218,OLY,P011983,0 days 00:20:00,10,37,27
218,OLY,P001255,0 days 00:20:00,-6,39,45
218,OLY,P010392,0 days 00:19:29,-6,39,45
218,OLY,P011194,0 days 00:18:57,5,42,37
218,OLY,P012878,0 days 00:16:45,3,26,23
218,OLY,P007982,0 days 00:16:40,10,44,34
218,OLY,P007853,0 days 00:16:34,-6,32,38
218,OLY,P010612,0 days 00:13:15,-3,15,18
218,OLY,P011965,0 days 00:05:42,-3,9,12
218,OLY,P006589,0 days 00:04:18,-4,8,12
219,MAD,P003108,0 days 00:24:16,0,48,48
219,MAD,P009005,0 days 00:23:16,9,51,42
219,MAD,P004887,0 days 00:22:51,14,49,35
219,MAD,P010357,0 days 00:21:19,1,49,48
219,MAD,PCVM,0 days 00:21:08,1,46,45
219,MAD,P006540,0 days 00:20:57,-2,47,49
219,MAD,PBMT,0 days 00:18:13,-2,40,42
219,MAD,P003733,0 days 00:17:15,8,36,28
219,MAD,P005928,0 days 00:14:17,0,28,28
219,MAD,P001392,0 days 00:06:49,4,15,11
219,MAD,P009213,0 days 00:05:04,-4,9,13
219,MAD,P010623,0 days 00:04:35,6,12,6
219,ASV,P011225,0 days 00:32:24,3,71,68
219,ASV,P000229,0 days 00:31:33,-7,60,67
219,ASV,P005094,0 days 00:28:03,-8,56,64
219,ASV,P012731,0 days 00:26:19,1,53,52
219,ASV,P012729,0 days 00:24:52,11,57,46
219,ASV,P003526,0 days 00:24:03,-10,49,59
219,ASV,P006568,0 days 00:15:12,-18,22,40
219,ASV,PKIR,0 days 00:11:53,1,23,22
219,ASV,P011386,0 days 00:05:41,-8,4,12
220,BAS,P004603,0 days 00:36:57,16,86,70
220,BAS,P012201,0 days 00:36:21,17,88,71
220,BAS,P009048,0 days 00:31:52,-5,66,71
220,BAS,P004761,0 days 00:29:24,13,65,52
220,BAS,P011948,0 days 00:23:09,13,58,45
220,BAS,P011085,0 days 00:22:20,9,50,41
220,BAS,P007946,0 days 00:11:29,7,33,26
220,BAS,P008850,0 days 00:04:19,-11,8,19
220,BAS,P003198,0 days 00:04:09,-9,6,15
220,TEL,P009863,0 days 00:29:22,-4,60,64
220,TEL,P009783,0 days 00:28:36,-6,55,61
220,TEL,P009622,0 days 00:28:09,-9,58,67
220,TEL,P011199,0 days 00:26:29,-13,45,58
220,TEL,P011193,0 days 00:20:38,-3,44,47
220,TEL,P011971,0 days 00:17:17,-10,31,41
220,TEL,P012744,0 days 00:14:44,3,35,32
220,TEL,P011214,0 days 00:14:13,-8,32,40
220,TEL,P011219,0 days 00:12:41,5,35,30
220,TEL,P005145,0 days 00:04:22,3,11,8
220,TEL,P007990,0 days 00:03:29,-8,4,12
221,IST,P009664,0 days 00:34:11,17,68,51
221,IST,P007200,0 days 00:32:40,2,61,59
221,IST,P004888,0 days 00:32:08,6,65,59
221,IST,P011078,0 days 00:28:24,18,63,45
221,IST,PLHK,0 days 00:27:42,14,56,42
221,IST,P006590,0 days 00:13:41,-11,25,36
221,IST,P009846,0 days 00:13:41,-11,25,36
221,IST,P011981,0 days 00:12:18,-8,23,31
221,IST,P010516,0 days 00:05:15,3,9,6
221,MIL,P007831,0 days 00:29:23,-11,46,57
221,MIL,P011224,0 days 00:27:24,-1,46,47
221,MIL,P002849,0 days 00:24:41,2,44,42
221,MIL,P007201,0 days 00:24:12,-2,41,43
221,MIL,P012800,0 days 00:21:46,9,50,41
221,MIL,P011205,0 days 00:20:37,-19,25,44
221,MIL,P000796,0 days 00:15:19,-8,29,37
221,MIL,P007032,0 days 00:12:36,-5,27,32
221,MIL,P002812,0 days 00:11:49,0,27,27
221,MIL,P006509,0 days 00:08:27,7,25,18
221,MIL,P009960,0 days 00:03:46,-2,5,7
222,MCO,P010588,0 days 00:36:11,8,68,60
222,MCO,P005985,0 days 00:33:36,4,61,57
222,MCO,P011226,0 days 00:29:16,3,58,55
222,MCO,P011212,0 days 00:27:05,19,57,38
222,MCO,PLCZ,0 days 00:20:11,-3,33,36
222,MCO,P009754,0 days 00:19:24,1,35,34
222,MCO,P011196,0 days 00:12:43,6,25,19
222,MCO,P011231,0 days 00:09:15,-2,17,19
222,MCO,P002581,0 days 00:07:06,4,18,14
222,MCO,P004197,0 days 00:05:13,-5,8,13
222,ULK,P006661,0 days 00:32:26,-5,56,61
222,ULK,P001932,0 days 00:25:11,-5,35,40
222,ULK,P002968,0 days 00:22:45,-9,40,49
222,ULK,P004004,0 days 00:22:23,-12,35,47
222,ULK,P008962,0 days 00:22:18,-4,40,44
222,ULK,P006068,0 days 00:21:15,4,42,38
222,ULK,P005844,0 days 00:17:57,-2,30,32
222,ULK,P011157,0 days 00:16:38,0,27,27
222,ULK,P006961,0 days 00:08:56,1,19,18
222,ULK,P009849,0 days 00:07:59,-4,15,19
222,ULK,P011052,0 days 00:02:12,1,6,5
223,RED,P000848,0 days 00:29:25,4,63,59
223,RED,P006436,0 days 00:26:39,-2,49,51
223,RED,P012044,0 days 00:23:38,-5,46,51
223,RED,P009035,0 days 00:22:30,-10,33,43
223,RED,PJDR,0 days 00:18:43,-8,32,40
223,RED,P005099,0 days 00:16:25,-5,33,38
223,RED,P007960,0 days 00:14:34,-10,23,33
223,RED,P012801,0 days 00:12:17,2,32,30
223,RED,P008966,0 days 00:11:19,-7,20,27
223,RED,P002553,0 days 00:10:14,-7,20,27
223,RED,P011941,0 days 00:07:39,8,23,15
223,RED,PLUO,0 days 00:06:37,-5,6,11
223,BAR,P002939,0 days 00:32:13,8,69,61
223,BAR,P012745,0 days 00:29:33,11,60,49
223,BAR,P004866,0 days 00:26:33,2,49,47
223,BAR,P000925,0 days 00:24:56,12,51,39
223,BAR,P006435,0 days 00:22:07,6,44,38
223,BAR,P007519,0 days 00:18:21,8,45,37
223,BAR,P009992,0 days 00:17:53,3,41,38
223,BAR,P003196,0 days 00:14:30,0,34,34
223,BAR,P007464,0 days 00:07:17,1,16,15
223,BAR,P011244,0 days 00:05:46,0,16,16
223,BAR,P010641,0 days 00:00:34,-3,0,3
223,BAR,P003204,0 days 00:00:17,-3,0,3
224,VIR,PBCN,0 days 00:27:21,2,59,57
224,VIR,P003048,0 days 00:27:16,10,67,57
224,VIR,P009549,0 days 00:26:28,6,58,52
224,VIR,P001844,0 days 00:24:21,13,59,46
224,VIR,P001133,0 days 00:21:41,2,43,41
224,VIR,P010781,0 days 00:21:33,0,49,49
224,VIR,P003527,0 days 00:20:09,2,45,43
224,VIR,P006739,0 days 00:15:39,-9,29,38
224,VIR,P008847,0 days 00:15:17,-3,30,33
224,VIR,P004007,0 days 00:00:15,-3,1,4
224,PAR,P009862,0 days 00:29:19,1,63,62
224,PAR,P012742,0 days 00:26:42,2,59,57
224,PAR,P003983,0 days 00:23:14,1,56,55
224,PAR,P007400,0 days 00:22:29,3,55,52
224,PAR,P011051,0 days 00:19:31,-1,45,46
224,PAR,P011050,0 days 00:19:01,3,35,32
224,PAR,P011192,0 days 00:18:45,-6,33,39
224,PAR,P004172,0 days 00:13:18,-6,25,31
224,PAR,P012743,0 days 00:13:17,-10,24,34
224,PAR,P008987,0 days 00:12:18,-10,20,30
224,PAR,P012096,0 days 00:02:06,3,5,2
225,ZAL,P002329,0 days 00:30:03,19,68,49
225,ZAL,P011218,0 days 00:27:49,16,59,43
225,ZAL,P007513,0 days 00:22:16,14,56,42
225,ZAL,P002676,0 days 00:21:04,3,32,29
225,ZAL,P005504,0 days 00:20:38,-1,45,46
225,ZAL,P012715,0 days 00:18:57,13,46,33
225,ZAL,P007109,0 days 00:15:53,-2,26,28
225,ZAL,P012787,0 days 00:14:39,0,24,24
225,ZAL,P010390,0 days 00:14:22,5,23,18
225,ZAL,P003211,0 days 00:09:59,-1,14,15
225,ZAL,P003210,0 days 00:04:13,-5,7,12
225,ZAL,P006860,0 days 00:00:07,-1,0,1
225,PAN,P003842,0 days 00:34:22,-12,60,72
225,PAN,P012774,0 days 00:34:14,-10,60,70
225,PAN,P002328,0 days 00:33:44,-4,64,68
225,PAN,P011204,0 days 00:30:13,-16,52,68
225,PAN,P007866,0 days 00:25:16,-11,45,56
225,PAN,P007947,0 days 00:16:47,-2,24,26
225,PAN,P012712,0 days 00:16:10,1,25,24
225,PAN,P011221,0 days 00:04:12,-2,6,8
225,PAN,P011209,0 days 00:03:18,-2,2,4
225,PAN,P005161,0 days 00:01:37,-2,2,4
225,PAN,P006544,0 days 00:00:07,0,0,0
226,MIL,P007831,0 days 00:30:30,-7,60,67
226,MIL,P000796,0 days 00:25:59,9,57,48
226,MIL,P011205,0 days 00:25:51,10,57,47
226,MIL,P002849,0 days 00:22:31,-9,44,53
226,MIL,P007032,0 days 00:21:55,13,49,36
226,MIL,P012800,0 days 00:17:47,16,38,22
226,MIL,P007201,0 days 00:17:47,-12,27,39
226,MIL,P002812,0 days 00:16:23,17,37,20
226,MIL,P011224,0 days 00:16:22,-8,28,36
226,MIL,P001518,0 days 00:04:55,-4,8,12
226,MAD,P009005,0 days 00:21:56,8,49,41
226,MAD,P005791,0 days 00:21:42,1,43,42
226,MAD,PCVM,0 days 00:21:22,0,40,40
226,MAD,P006540,0 days 00:20:57,3,45,42
226,MAD,P010357,0 days 00:20:49,-5,35,40
226,MAD,PTGB,0 days 00:20:32,-3,35,38
226,MAD,P005928,0 days 00:18:38,-5,36,41
226,MAD,P003108,0 days 00:18:31,2,41,39
226,MAD,P004887,0 days 00:18:18,-6,33,39
226,MAD,PBMT,0 days 00:10:50,-23,7,30
226,MAD,P001392,0 days 00:06:25,3,16,13
227,IST,P007200,0 days 00:37:54,15,100,85
227,IST,P004888,0 days 00:26:06,2,67,65
227,IST,PLHK,0 days 00:21:17,1,58,57
227,IST,P011078,0 days 00:21:09,-1,44,45
227,IST,P009664,0 days 00:21:02,5,58,53
227,IST,P012710,0 days 00:18:58,9,47,38
227,IST,P011981,0 days 00:18:43,13,47,34
227,IST,P009846,0 days 00:15:17,14,43,29
227,IST,P006590,0 days 00:14:51,17,50,33
227,IST,P010516,0 days 00:04:43,-5,11,16
227,TEL,P009863,0 days 00:31:26,-11,72,83
227,TEL,P009783,0 days 00:31:20,-17,71,88
227,TEL,P011199,0 days 00:25:15,-6,59,65
227,TEL,P007990,0 days 00:20:44,-5,50,55
227,TEL,P012744,0 days 00:20:29,-1,43,44
227,TEL,P011193,0 days 00:19:43,-11,41,52
227,TEL,P011219,0 days 00:16:49,-7,40,47
227,TEL,P011214,0 days 00:14:43,-4,34,38
227,TEL,P011971,0 days 00:13:44,-6,28,34
227,TEL,P004233,0 days 00:05:47,-2,17,19
228,PAM,P003960,0 days 00:26:06,5,47,42
228,PAM,P011982,0 days 00:25:41,-6,44,50
228,PAM,P010568,0 days 00:23:38,-4,40,44
228,PAM,P005356,0 days 00:19:10,2,35,33
228,PAM,P012795,0 days 00:18:35,-8,29,37
228,PAM,P004863,0 days 00:16:08,-8,24,32
228,PAM,P011970,0 days 00:15:39,-6,25,31
228,PAM,P012738,0 days 00:13:58,-7,22,29
228,PAM,P012740,0 days 00:13:54,-11,17,28
228,PAM,P010393,0 days 00:13:11,-22,13,35
228,PAM,P006643,0 days 00:07:26,-9,10,19
228,PAM,P006433,0 days 00:06:34,9,19,10
228,OLY,P008855,0 days 00:28:39,7,51,44
228,OLY,P007853,0 days 00:24:33,9,51,42
228,OLY,P012878,0 days 00:23:31,4,47,43
228,OLY,P010612,0 days 00:22:45,14,45,31
228,OLY,P008829,0 days 00:21:16,10,39,29
228,OLY,P007982,0 days 00:20:25,4,41,37
228,OLY,P011194,0 days 00:18:55,3,39,36
228,OLY,P008811,0 days 00:16:18,9,31,22
228,OLY,P001255,0 days 00:12:51,2,25,23
228,OLY,P011983,0 days 00:08:31,5,17,12
228,OLY,P010392,0 days 00:02:16,-2,4,6
229,PAR,P008987,0 days 00:29:35,-8,53,61
229,PAR,P009862,0 days 00:26:03,-4,54,58
229,PAR,P007400,0 days 00:23:07,-9,47,56
229,PAR,P012743,0 days 00:21:51,8,50,42
229,PAR,P012742,0 days 00:20:25,-13,33,46
229,PAR,P004058,0 days 00:17:49,12,39,27
229,PAR,P004172,0 days 00:17:25,8,31,23
229,PAR,P003983,0 days 00:15:43,3,30,27
229,PAR,P012096,0 days 00:12:58,-8,21,29
229,PAR,P011051,0 days 00:11:23,7,25,18
229,PAR,P011050,0 days 00:03:41,-1,7,8
229,MUN,P001288,0 days 00:30:46,-3,62,65
229,MUN,P010391,0 days 00:28:47,-3,59,62
229,MUN,P006760,0 days 00:24:33,-1,47,48
229,MUN,P003583,0 days 00:22:02,-4,45,49
229,MUN,P011987,0 days 00:20:18,-2,43,45
229,MUN,P007975,0 days 00:20:18,7,40,33
229,MUN,P007639,0 days 00:17:58,5,34,29
229,MUN,P001557,0 days 00:14:16,-3,27,30
229,MUN,P004508,0 days 00:12:45,6,24,18
229,MUN,P006543,0 days 00:08:17,3,14,11
230,BAS,P009048,0 days 00:35:31,12,84,72
230,BAS,P010444,0 days 00:28:10,16,66,50
230,BAS,P004761,0 days 00:24:27,17,55,38
230,BAS,P012201,0 days 00:21:32,9,60,51
230,BAS,P003198,0 days 00:19:43,5,36,31
230,BAS,P011948,0 days 00:19:10,1,47,46
230,BAS,P008850,0 days 00:17:34,5,36,31
230,BAS,P011085,0 days 00:17:02,5,46,41
230,BAS,P004603,0 days 00:11:34,0,28,28
230,BAS,P007946,0 days 00:03:10,4,8,4
230,BAS,P012765,0 days 00:01:19,-2,2,4
230,BAS,P012365,0 days 00:00:48,-2,2,4
230,ASV,P004194,0 days 00:25:04,-4,59,63
230,ASV,P012729,0 days 00:23:31,-13,42,55
230,ASV,P011386,0 days 00:23:07,-13,49,62
230,ASV,P000229,0 days 00:20:11,1,52,51
230,ASV,P012080,0 days 00:19:49,-15,28,43
230,ASV,P012731,0 days 00:19:39,-7,31,38
230,ASV,P003526,0 days 00:19:15,-6,46,52
230,ASV,P005094,0 days 00:17:39,-3,38,41
230,ASV,PKIR,0 days 00:14:52,-9,24,33
230,ASV,P011225,0 days 00:11:06,0,26,26
230,ASV,P003274,0 days 00:05:47,-1,5,6
231,RED,P012044,0 days 00:31:47,-1,78,79
231,RED,P006436,0 days 00:29:32,-1,72,73
231,RED,P000848,0 days 00:24:03,-1,58,59
231,RED,P007960,0 days 00:20:45,12,52,40
231,RED,P009035,0 days 00:20:28,-3,51,54
231,RED,P002553,0 days 00:19:01,-14,37,51
231,RED,P012801,0 days 00:15:24,5,34,29
231,RED,P011941,0 days 00:12:44,3,28,25
231,RED,P005099,0 days 00:09:47,-4,15,19
231,RED,P004720,0 days 00:09:16,-4,18,22
231,RED,P008966,0 days 00:06:39,-2,12,14
231,RED,P011964,0 days 00:00:34,0,0,0
231,ZAL,P005504,0 days 00:28:41,0,71,71
231,ZAL,P002329,0 days 00:27:30,4,68,64
231,ZAL,P007513,0 days 00:26:12,4,66,62
231,ZAL,P011218,0 days 00:25:20,10,66,56
231,ZAL,P007109,0 days 00:23:07,11,63,52
231,ZAL,P003211,0 days 00:20:10,3,49,46
231,ZAL,P002676,0 days 00:12:26,-7,19,26
231,ZAL,P012715,0 days 00:11:47,-5,19,24
231,ZAL,P010390,0 days 00:10:52,2,20,18
231,ZAL,P012787,0 days 00:08:53,-8,15,23
231,ZAL,P003210,0 days 00:05:02,-4,9,13
232,BAR,P011244,0 days 00:27:55,29,78,49
232,BAR,P009992,0 days 00:21:54,-13,33,46
232,BAR,P007519,0 days 00:21:52,-3,39,42
232,BAR,P003196,0 days 00:19:06,14,42,28
232,BAR,P006435,0 days 00:18:13,29,60,31
232,BAR,P002939,0 days 00:18:08,19,54,35
232,BAR,P003204,0 days 00:17:31,-3,32,35
232,BAR,P004866,0 days 00:17:17,24,54,30
232,BAR,P000925,0 days 00:12:10,18,40,22
232,BAR,P007464,0 days 00:08:40,-13,11,24
232,BAR,P010641,0 days 00:08:37,-16,11,27
232,BAR,P012745,0 days 00:08:37,-5,11,16
232,BER,P008384,0 days 00:22:23,2,45,43
232,BER,P006251,0 days 00:21:38,-13,40,53
232,BER,P008173,0 days 00:18:57,-10,27,37
232,BER,P007025,0 days 00:18:31,6,41,35
232,BER,P008211,0 days 00:18:00,1,48,47
232,BER,P008967,0 days 00:16:16,-21,28,49
232,BER,P003958,0 days 00:15:50,-10,27,37
232,BER,P012721,0 days 00:15:20,0,28,28
232,BER,P010791,0 days 00:15:09,-6,27,33
232,BER,P008780,0 days 00:14:59,-19,28,47
232,BER,P006819,0 days 00:11:40,6,26,20
232,BER,P011934,0 days 00:11:17,-16,20,36
233,PAN,P012774,0 days 00:35:45,14,66,52
233,PAN,P011204,0 days 00:34:14,9,62,53
233,PAN,P003842,0 days 00:34:02,9,62,53
233,PAN,P012712,0 days 00:22:53,27,55,28
233,PAN,P002328,0 days 00:21:55,-10,36,46
233,PAN,P011209,0 days 00:18:29,13,35,22
233,PAN,P007866,0 days 00:18:09,-11,24,35
233,PAN,P007947,0 days 00:08:35,2,18,16
233,PAN,P011221,0 days 00:05:58,2,12,10
233,ULK,P008962,0 days 00:33:09,-12,50,62
233,ULK,P001932,0 days 00:27:56,-12,39,51
233,ULK,P006661,0 days 00:27:03,0,46,46
233,ULK,P006961,0 days 00:24:06,-15,36,51
233,ULK,P011157,0 days 00:20:42,-8,35,43
233,ULK,P002968,0 days 00:17:35,1,28,27
233,ULK,P006068,0 days 00:16:45,14,34,20
233,ULK,P004004,0 days 00:11:42,-10,14,24
233,ULK,P011052,0 days 00:08:23,5,20,15
233,ULK,P009849,0 days 00:07:55,-11,9,20
233,ULK,P005844,0 days 00:04:44,-7,4,11
234,VIR,P001133,0 days 00:26:40,7,55,48
234,VIR,P001844,0 days 00:26:12,7,51,44
234,VIR,P010781,0 days 00:25:19,-4,53,57
234,VIR,P009549,0 days 00:24:33,-3,43,46
234,VIR,PBCN,0 days 00:24:21,4,52,48
234,VIR,P008847,0 days 00:18:54,-2,43,45
234,VIR,P003048,0 days 00:15:53,0,25,25
234,VIR,P006739,0 days 00:15:49,-9,31,40
234,VIR,P004554,0 days 00:07:11,-3,13,16
234,VIR,P002084,0 days 00:05:44,-2,12,14
234,VIR,P003527,0 days 00:05:19,-6,8,14
234,VIR,P004007,0 days 00:04:05,-4,4,8
234,MCO,P005985,0 days 00:33:22,1,63,62
234,MCO,P011226,0 days 00:30:17,-6,59,65
234,MCO,P009754,0 days 00:25:42,-4,50,54
234,MCO,P011212,0 days 00:22:48,6,47,41
234,MCO,P010588,0 days 00:19:40,-7,31,38
234,MCO,P011231,0 days 00:19:29,6,47,41
234,MCO,PLCZ,0 days 00:17:14,-4,26,30
234,MCO,P002581,0 days 00:16:20,8,36,28
234,MCO,P004197,0 days 00:08:57,13,27,14
234,MCO,P011196,0 days 00:06:11,2,19,17
235,BER,P003958,0 days 00:23:57,-32,37,69
235,BER,P008780,0 days 00:22:31,-29,36,65
235,BER,P011934,0 days 00:21:16,-24,37,61
235,BER,P012721,0 days 00:19:32,-7,42,49
235,BER,P006919,0 days 00:18:32,-17,26,43
235,BER,P012720,0 days 00:18:27,-26,29,55
235,BER,P008967,0 days 00:15:54,-21,19,40
235,BER,P008211,0 days 00:15:33,-9,32,41
235,BER,P006251,0 days 00:14:33,1,34,33
235,BER,P008173,0 days 00:13:30,-6,27,33
235,BER,P007025,0 days 00:11:25,-1,28,29
235,BER,P008384,0 days 00:04:50,-4,8,12
235,TEL,P011971,0 days 00:22:23,20,60,40
235,TEL,P009622,0 days 00:21:55,16,61,45
235,TEL,P009863,0 days 00:21:54,22,63,41
235,TEL,P011199,0 days 00:20:22,30,60,30
235,TEL,P012744,0 days 00:19:39,5,47,42
235,TEL,P009783,0 days 00:17:51,26,55,29
235,TEL,P005145,0 days 00:17:37,15,46,31
235,TEL,P011214,0 days 00:17:04,9,42,33
235,TEL,P011193,0 days 00:16:36,21,46,25
235,TEL,P007990,0 days 00:12:11,7,27,20
235,TEL,P012095,0 days 00:07:24,4,15,11
235,TEL,P004233,0 days 00:05:04,0,8,8
236,PAR,P008987,0 days 00:40:00,10,100,90
236,PAR,P009862,0 days 00:25:58,12,65,53
236,PAR,P004172,0 days 00:25:36,4,60,56
236,PAR,P003983,0 days 00:21:32,13,65,52
236,PAR,P000956,0 days 00:20:46,7,63,56
236,PAR,P007673,0 days 00:19:55,0,49,49
236,PAR,P012743,0 days 00:17:00,7,36,29
236,PAR,P012096,0 days 00:16:31,2,42,40
236,PAR,P012742,0 days 00:10:28,-1,17,18
236,PAR,P011051,0 days 00:02:14,-4,3,7
236,IST,P007200,0 days 00:34:26,-8,78,86
236,IST,P004888,0 days 00:26:34,-8,68,76
236,IST,P006590,0 days 00:25:34,4,73,69
236,IST,PLHK,0 days 00:23:26,-8,48,56
236,IST,P009664,0 days 00:20:53,1,53,52
236,IST,P009513,0 days 00:15:12,-3,24,27
236,IST,P012710,0 days 00:14:47,-3,24,27
236,IST,P011981,0 days 00:13:38,-3,37,40
236,IST,P009846,0 days 00:12:11,-13,20,33
236,IST,P011078,0 days 00:08:46,-7,17,24
236,IST,P012788,0 days 00:04:08,-2,8,10
236,IST,P006372,0 days 00:00:25,0,0,0
237,MAD,P005928,0 days 00:27:19,-4,62,66
237,MAD,P010357,0 days 00:26:58,12,68,56
237,MAD,P003108,0 days 00:24:43,-15,55,70
237,MAD,P001392,0 days 00:22:57,6,58,52
237,MAD,P005791,0 days 00:21:43,3,50,47
237,MAD,P006540,0 days 00:18:59,-22,35,57
237,MAD,P004887,0 days 00:16:10,-11,30,41
237,MAD,P009005,0 days 00:14:07,-6,26,32
237,MAD,PCVM,0 days 00:12:41,-7,24,31
237,MAD,PTGB,0 days 00:07:31,-16,6,22
237,MAD,P003733,0 days 00:06:52,5,16,11
237,PAN,P012774,0 days 00:33:24,7,77,70
237,PAN,P003842,0 days 00:29:24,16,76,60
237,PAN,P007866,0 days 00:27:15,3,65,62
237,PAN,P001926,0 days 00:24:52,11,62,51
237,PAN,P005161,0 days 00:22:16,14,59,45
237,PAN,P011204,0 days 00:19:52,0,45,45
237,PAN,P002328,0 days 00:19:15,0,45,45
237,PAN,P012712,0 days 00:17:46,10,44,34
237,PAN,P007553,0 days 00:05:56,-6,12,18
238,VIR,P008847,0 days 00:27:28,19,66,47
238,VIR,P002084,0 days 00:25:29,15,56,41
238,VIR,P009549,0 days 00:24:36,1,50,49
238,VIR,PBCN,0 days 00:23:15,5,54,49
238,VIR,P006739,0 days 00:21:53,8,49,41
238,VIR,P001844,0 days 00:18:27,3,38,35
238,VIR,P003527,0 days 00:16:21,10,35,25
238,VIR,P010781,0 days 00:16:07,13,38,25
238,VIR,P003048,0 days 00:12:12,-4,21,25
238,VIR,P004554,0 days 00:07:57,0,16,16
238,VIR,P001133,0 days 00:06:15,-5,12,17
238,PAM,P012795,0 days 00:22:54,-2,44,46
238,PAM,P010568,0 days 00:22:30,-2,47,49
238,PAM,P011982,0 days 00:22:22,-8,40,48
238,PAM,P007870,0 days 00:22:00,8,51,43
238,PAM,P006433,0 days 00:20:54,8,46,38
238,PAM,P010393,0 days 00:18:43,-14,36,50
238,PAM,P004863,0 days 00:16:58,-13,28,41
238,PAM,P011970,0 days 00:14:50,-13,18,31
238,PAM,P003960,0 days 00:13:51,-5,26,31
238,PAM,P012738,0 days 00:11:33,-7,18,25
238,PAM,P012740,0 days 00:07:40,-9,11,20
238,PAM,P006643,0 days 00:05:45,-8,5,13
239,ZAL,P002329,0 days 00:25:28,-15,47,62
239,ZAL,P011218,0 days 00:25:01,-17,44,61
239,ZAL,P003211,0 days 00:23:36,-9,49,58
239,ZAL,P003210,0 days 00:19:57,-8,41,49
239,ZAL,P002676,0 days 00:19:25,-9,38,47
239,ZAL,P007109,0 days 00:17:54,-7,36,43
239,ZAL,P005504,0 days 00:15:43,-10,25,35
239,ZAL,P012715,0 days 00:14:51,-9,24,33
239,ZAL,P010390,0 days 00:13:22,-4,29,33
239,ZAL,P012787,0 days 00:13:02,-7,23,30
239,ZAL,P006158,0 days 00:11:41,0,24,24
239,OLY,P008855,0 days 00:29:18,21,73,52
239,OLY,P001255,0 days 00:27:39,15,69,54
239,OLY,P008829,0 days 00:27:32,15,69,54
239,OLY,P007853,0 days 00:23:38,7,53,46
239,OLY,P008811,0 days 00:21:00,15,52,37
239,OLY,P011194,0 days 00:20:33,6,45,39
239,OLY,P010612,0 days 00:20:04,16,53,37
239,OLY,P012878,0 days 00:13:16,7,32,25
239,OLY,P011983,0 days 00:09:56,-3,16,19
239,OLY,P006302,0 days 00:07:04,-4,13,17
240,BAR,P012745,0 days 00:30:29,-5,54,59
240,BAR,P000925,0 days 00:26:23,0,50,50
240,BAR,P006435,0 days 00:25:03,-2,48,50
240,BAR,P002939,0 days 00:23:13,2,47,45
240,BAR,P004866,0 days 00:20:57,-6,41,47
240,BAR,P003478,0 days 00:15:18,-4,20,24
240,BAR,P003196,0 days 00:13:37,-10,17,27
240,BAR,P009992,0 days 00:13:34,-5,20,25
240,BAR,P007519,0 days 00:12:27,-6,16,22
240,BAR,PLFW,0 days 00:11:14,-9,13,22
240,BAR,P011244,0 days 00:07:45,-5,9,14
240,MCO,P005985,0 days 00:30:39,0,58,58
240,MCO,P011226,0 days 00:27:55,7,49,42
240,MCO,P011212,0 days 00:25:33,8,40,32
240,MCO,P010588,0 days 00:24:06,4,45,41
240,MCO,P011231,0 days 00:21:24,5,47,42
240,MCO,P011196,0 days 00:18:33,11,38,27
240,MCO,P008099,0 days 00:17:45,4,43,39
240,MCO,PLCZ,0 days 00:12:30,4,30,26
240,MCO,P004790,0 days 00:10:40,6,19,13
240,MCO,P012709,0 days 00:06:06,8,13,5
240,MCO,P002581,0 days 00:04:49,-7,3,10
241,MUN,P007056,0 days 00:30:29,12,63,51
241,MUN,P001288,0 days 00:26:44,4,51,47
241,MUN,P010391,0 days 00:25:13,6,46,40
241,MUN,P003583,0 days 00:24:13,-1,43,44
241,MUN,P004508,0 days 00:21:21,11,38,27
241,MUN,P011987,0 days 00:18:02,0,34,34
241,MUN,P008985,0 days 00:15:36,3,34,31
241,MUN,P006760,0 days 00:15:26,4,28,24
241,MUN,P007639,0 days 00:11:31,6,20,14
241,MUN,P001557,0 days 00:11:25,-5,13,18
241,RED,P009035,0 days 00:24:46,2,48,46
241,RED,P012044,0 days 00:22:12,0,40,40
241,RED,P012801,0 days 00:22:00,1,39,38
241,RED,P006436,0 days 00:21:28,-1,40,41
241,RED,P000848,0 days 00:21:07,-10,35,45
241,RED,P002553,0 days 00:18:25,1,40,39
241,RED,P007960,0 days 00:17:12,-1,24,25
241,RED,P005099,0 days 00:15:59,-7,23,30
241,RED,PLUO,0 days 00:13:41,-7,17,24
241,RED,P008966,0 days 00:12:10,-9,16,25
241,RED,P011941,0 days 00:07:27,-9,4,13
241,RED,P004720,0 days 00:03:33,0,4,4
242,ULK,P001932,0 days 00:29:45,20,88,68
242,ULK,P008962,0 days 00:25:55,9,68,59
242,ULK,P011157,0 days 00:24:50,16,77,61
242,ULK,P006961,0 days 00:23:48,23,77,54
242,ULK,P004004,0 days 00:19:43,14,59,45
242,ULK,P006661,0 days 00:16:31,-1,43,44
242,ULK,P006068,0 days 00:15:54,-5,34,39
242,ULK,P011980,0 days 00:14:28,4,43,39
242,ULK,P009849,0 days 00:14:19,-6,32,38
242,ULK,P002968,0 days 00:08:29,1,22,21
242,ULK,P005844,0 days 00:06:18,0,12,12
242,BAS,P004761,0 days 00:31:21,-13,70,83
242,BAS,P009048,0 days 00:28:50,-16,71,87
242,BAS,P012201,0 days 00:26:43,-13,67,80
242,BAS,P007230,0 days 00:26:02,-13,54,67
242,BAS,P010444,0 days 00:25:07,-7,56,63
242,BAS,P003198,0 days 00:21:20,-5,60,65
242,BAS,P007946,0 days 00:14:53,-3,32,35
242,BAS,P004603,0 days 00:10:09,-5,30,35
242,BAS,P011948,0 days 00:08:39,-2,26,28
242,BAS,P011085,0 days 00:06:56,2,14,12
243,ASV,P012080,0 days 00:27:55,1,57,56
243,ASV,P002100,0 days 00:27:08,9,56,47
243,ASV,P012729,0 days 00:22:39,2,46,44
243,ASV,PKIR,0 days 00:22:12,5,47,42
243,ASV,P004194,0 days 00:20:31,7,43,36
243,ASV,P011386,0 days 00:18:16,0,37,37
243,ASV,P000229,0 days 00:17:36,-2,36,38
243,ASV,P011225,0 days 00:16:15,3,32,29
243,ASV,P012731,0 days 00:15:23,-8,27,35
243,ASV,P003526,0 days 00:12:05,3,24,21
243,MIL,P007831,0 days 00:35:43,0,72,72
243,MIL,P007032,0 days 00:27:18,4,58,54
243,MIL,P011205,0 days 00:26:39,9,57,48
243,MIL,P002849,0 days 00:25:17,-5,51,56
243,MIL,P012800,0 days 00:23:38,-19,40,59
243,MIL,P007201,0 days 00:20:54,2,45,43
243,MIL,P001518,0 days 00:14:11,-11,21,32
243,MIL,P002812,0 days 00:13:30,7,26,19
243,MIL,P006701,0 days 00:06:42,-6,4,10
243,MIL,P009960,0 days 00:06:08,-1,11,12
244,IST,P004888,0 days 00:28:53,18,80,62
244,IST,P007200,0 days 00:26:22,21,82,61
244,IST,P011078,0 days 00:20:14,19,59,40
244,IST,P011981,0 days 00:19:58,4,47,43
244,IST,P006590,0 days 00:19:57,5,45,40
244,IST,P009846,0 days 00:19:03,8,52,44
244,IST,P009664,0 days 00:17:31,10,46,36
244,IST,P012710,0 days 00:14:33,10,40,30
244,IST,P012788,0 days 00:13:54,27,51,24
244,IST,P009513,0 days 00:13:27,1,32,31
244,IST,PLHK,0 days 00:06:08,-8,11,19
244,MUN,P001288,0 days 00:28:40,0,70,70
244,MUN,P007056,0 days 00:27:18,-6,63,69
244,MUN,P003583,0 days 00:25:48,-14,62,76
244,MUN,P008985,0 days 00:22:47,-7,54,61
244,MUN,P007975,0 days 00:21:02,-12,42,54
244,MUN,P011987,0 days 00:17:16,-14,43,57
244,MUN,P004508,0 days 00:14:55,-7,29,36
244,MUN,P010391,0 days 00:11:44,-11,20,31
244,MUN,P006760,0 days 00:11:20,-14,18,32
244,MUN,P001557,0 days 00:07:59,-14,14,28
244,MUN,P005478,0 days 00:06:32,-8,8,16
244,MUN,P007639,0 days 00:04:39,-8,7,15
245,MCO,P005985,0 days 00:30:09,12,73,61
245,MCO,P011226,0 days 00:24:51,27,73,46
245,MCO,P010588,0 days 00:24:32,8,58,50
245,MCO,P011231,0 days 00:23:28,4,55,51
245,MCO,P011212,0 days 00:22:03,24,59,35
245,MCO,PLCZ,0 days 00:20:47,2,47,45
245,MCO,P008099,0 days 00:18:35,-3,42,45
245,MCO,P011196,0 days 00:13:59,13,40,27
245,MCO,P004197,0 days 00:07:31,5,16,11
245,MCO,P002581,0 days 00:05:14,3,11,8
245,MCO,P012709,0 days 00:04:45,-3,10,13
245,MCO,P004790,0 days 00:04:06,-2,6,8
245,RED,P012044,0 days 00:31:43,1,73,72
245,RED,P006436,0 days 00:28:19,-6,65,71
245,RED,P002553,0 days 00:28:08,-5,64,69
245,RED,P009035,0 days 00:27:20,5,65,60
245,RED,P004720,0 days 00:17:10,-4,33,37
245,RED,PLUO,0 days 00:14:22,-4,31,35
245,RED,P005099,0 days 00:14:11,-17,22,39
245,RED,P011941,0 days 00:10:56,-12,15,27
245,RED,P008966,0 days 00:10:56,-17,14,31
245,RED,P012801,0 days 00:09:42,-22,9,31
245,RED,P000848,0 days 00:07:13,-9,9,18
246,TEL,P009783,0 days 00:26:10,-1,59,60
246,TEL,P009622,0 days 00:24:17,-2,56,58
246,TEL,P009863,0 days 00:23:18,-8,43,51
246,TEL,P011199,0 days 00:22:45,3,53,50
246,TEL,P011214,0 days 00:22:05,-1,39,40
246,TEL,P012744,0 days 00:18:47,14,40,26
246,TEL,P011193,0 days 00:18:37,8,32,24
246,TEL,P011971,0 days 00:17:25,5,27,22
246,TEL,P007990,0 days 00:14:14,16,35,19
246,TEL,P005145,0 days 00:12:22,1,31,30
246,ZAL,P002329,0 days 00:30:30,-3,63,66
246,ZAL,P011218,0 days 00:26:55,6,66,60
246,ZAL,P010390,0 days 00:22:34,6,40,34
246,ZAL,P002676,0 days 00:21:33,5,40,35
246,ZAL,P007109,0 days 00:18:53,7,47,40
246,ZAL,P012715,0 days 00:18:41,-11,30,41
246,ZAL,P003210,0 days 00:17:31,-8,20,28
246,ZAL,P003211,0 days 00:15:09,-17,17,34
246,ZAL,P012787,0 days 00:14:50,-7,31,38
246,ZAL,P005504,0 days 00:13:24,-13,26,39
247,OLY,P001255,0 days 00:32:05,13,64,51
247,OLY,P008811,0 days 00:26:02,7,53,46
247,OLY,P007853,0 days 00:25:03,-5,42,47
247,OLY,P010612,0 days 00:22:50,1,47,46
247,OLY,P008829,0 days 00:22:42,5,44,39
247,OLY,P011194,0 days 00:21:32,2,38,36
247,OLY,P007982,0 days 00:20:20,13,37,24
247,OLY,P006302,0 days 00:10:11,-3,18,21
247,OLY,P012878,0 days 00:09:44,-4,13,17
247,OLY,P011983,0 days 00:05:52,-5,7,12
247,OLY,P011965,0 days 00:03:39,1,7,6
247,VIR,P001133,0 days 00:28:13,-1,48,49
247,VIR,P008847,0 days 00:22:43,-7,37,44
247,VIR,P001844,0 days 00:22:32,-15,33,48
247,VIR,P006739,0 days 00:20:55,6,43,37
247,VIR,P010781,0 days 00:20:06,3,36,33
247,VIR,PBCN,0 days 00:18:10,-7,31,38
247,VIR,P009549,0 days 00:17:03,-5,28,33
247,VIR,P004007,0 days 00:14:48,-3,22,25
247,VIR,P003048,0 days 00:14:37,-1,28,29
247,VIR,P004554,0 days 00:13:51,0,23,23
247,VIR,P003527,0 days 00:07:02,5,16,11
248,MAD,P003108,0 days 00:29:52,-5,62,67
248,MAD,P010357,0 days 00:29:30,-5,62,67
248,MAD,P005791,0 days 00:25:51,3,53,50
248,MAD,PTGB,0 days 00:25:40,1,59,58
248,MAD,P005928,0 days 00:22:56,-5,48,53
248,MAD,P006540,0 days 00:17:51,-4,35,39
248,MAD,P009005,0 days 00:17:23,-11,26,37
248,MAD,P004887,0 days 00:11:53,-10,24,34
248,MAD,PCVM,0 days 00:11:40,-10,16,26
248,MAD,P001392,0 days 00:07:24,-4,10,14
248,ULK,P008962,0 days 00:32:04,8,75,67
248,ULK,P006961,0 days 00:27:29,14,64,50
248,ULK,P001932,0 days 00:26:32,7,62,55
248,ULK,P006661,0 days 00:22:58,8,56,48
248,ULK,P002968,0 days 00:18:03,-11,35,46
248,ULK,P004004,0 days 00:17:50,8,36,28
248,ULK,P011157,0 days 00:11:21,16,32,16
248,ULK,P006068,0 days 00:10:54,-2,21,23
248,ULK,P005844,0 days 00:10:36,5,22,17
248,ULK,P009849,0 days 00:08:53,-5,16,21
248,ULK,P011980,0 days 00:07:56,2,14,12
248,ULK,P011052,0 days 00:05:24,0,12,12
249,PAM,P003960,0 days 00:29:16,-4,52,56
249,PAM,P010568,0 days 00:28:59,-13,47,60
249,PAM,P007870,0 days 00:23:29,-13,37,50
249,PAM,P012795,0 days 00:20:33,0,41,41
249,PAM,P011982,0 days 00:17:33,2,42,40
249,PAM,P005356,0 days 00:16:37,3,40,37
249,PAM,P006433,0 days 00:15:33,-5,26,31
249,PAM,P010393,0 days 00:14:04,3,35,32
249,PAM,P006643,0 days 00:13:40,-13,20,33
249,PAM,P000556,0 days 00:10:42,-6,26,32
249,PAM,P011970,0 days 00:08:19,-3,23,26
249,PAM,P012740,0 days 00:01:15,-1,1,2
249,BAR,P004866,0 days 00:32:54,21,78,57
249,BAR,P012745,0 days 00:29:13,5,58,53
249,BAR,P000925,0 days 00:27:13,10,57,47
249,BAR,P002939,0 days 00:25:16,11,53,42
249,BAR,P006435,0 days 00:20:38,2,49,47
249,BAR,PLFW,0 days 00:13:38,-3,33,36
249,BAR,P007519,0 days 00:13:33,12,29,17
249,BAR,P007464,0 days 00:12:50,4,35,31
249,BAR,P003196,0 days 00:12:47,0,31,31
249,BAR,P009992,0 days 00:06:55,-2,12,14
249,BAR,P003478,0 days 00:05:03,-10,5,15
250,MIL,P007831,0 days 00:33:10,13,73,60
250,MIL,P011205,0 days 00:29:27,7,63,56
250,MIL,P011224,0 days 00:28:34,14,62,48
250,MIL,P002849,0 days 00:27:40,4,54,50
250,MIL,P000796,0 days 00:20:52,-2,48,50
250,MIL,P007201,0 days 00:20:29,10,44,34
250,MIL,P007032,0 days 00:13:36,-8,29,37
250,MIL,P002812,0 days 00:11:21,-10,24,34
250,MIL,P001518,0 days 00:08:02,-9,15,24
250,MIL,P012800,0 days 00:06:49,-9,13,22
250,PAR,P008987,0 days 00:32:53,0,70,70
250,PAR,P003983,0 days 00:32:36,9,73,64
250,PAR,P004172,0 days 00:23:52,-18,48,66
250,PAR,P000956,0 days 00:21:14,13,50,37
250,PAR,P012096,0 days 00:20:05,10,47,37
250,PAR,P009862,0 days 00:19:10,11,42,31
250,PAR,P012743,0 days 00:13:45,-7,25,32
250,PAR,P012742,0 days 00:12:56,-10,22,32
250,PAR,P011051,0 days 00:12:46,-7,24,31
250,PAR,P007673,0 days 00:10:43,-11,14,25
251,PAN,P011204,0 days 00:30:22,17,68,51
251,PAN,P003842,0 days 00:29:42,16,68,52
251,PAN,P002328,0 days 00:28:35,17,59,42
251,PAN,P001926,0 days 00:27:20,19,63,44
251,PAN,P007866,0 days 00:21:50,-2,37,39
251,PAN,P012774,0 days 00:21:44,6,49,43
251,PAN,P012712,0 days 00:20:54,20,53,33
251,PAN,P005161,0 days 00:07:05,-3,9,12
251,PAN,P007553,0 days 00:05:09,2,8,6
251,PAN,P011209,0 days 00:05:03,-6,7,13
251,PAN,P006544,0 days 00:01:08,2,2,0
251,PAN,P008084,0 days 00:01:08,2,2,0
251,ASV,P002100,0 days 00:23:05,-3,42,45
251,ASV,P011386,0 days 00:22:31,-19,37,56
251,ASV,P004194,0 days 00:22:10,-9,40,49
251,ASV,P012731,0 days 00:21:55,-4,41,45
251,ASV,P005094,0 days 00:19:39,-17,30,47
251,ASV,P012080,0 days 00:19:26,1,34,33
251,ASV,P000229,0 days 00:18:59,-17,31,48
251,ASV,PKIR,0 days 00:18:14,2,32,30
251,ASV,P006568,0 days 00:17:46,-11,25,36
251,ASV,P003526,0 days 00:16:15,-13,23,36
252,BAS,P009048,0 days 00:30:50,14,69,55
252,BAS,P004761,0 days 00:26:27,25,62,37
252,BAS,P007230,0 days 00:26:14,9,60,51
252,BAS,P012201,0 days 00:21:55,8,48,40
252,BAS,P011948,0 days 00:20:28,6,42,36
252,BAS,P004603,0 days 00:20:08,6,44,38
252,BAS,P010444,0 days 00:19:52,11,44,33
252,BAS,P011085,0 days 00:14:38,12,32,20
252,BAS,P008850,0 days 00:10:18,-9,20,29
252,BAS,P007946,0 days 00:09:10,3,19,16
252,BER,P006919,0 days 00:24:53,-1,47,48
252,BER,P010791,0 days 00:24:08,5,54,49
252,BER,P008780,0 days 00:23:48,-9,45,54
252,BER,P008967,0 days 00:22:09,3,53,50
252,BER,P012720,0 days 00:22:06,-10,35,45
252,BER,P008211,0 days 00:19:11,-8,37,45
252,BER,P007025,0 days 00:16:34,-19,17,36
252,BER,P007550,0 days 00:16:12,-8,26,34
252,BER,P011934,0 days 00:15:52,-22,17,39
252,BER,P006251,0 days 00:09:46,-17,8,25
252,BER,P011631,0 days 00:05:21,1,16,15
253,BER,P012720,0 days 00:28:24,-11,58,69
253,BER,P008967,0 days 00:25:53,1,55,54
253,BER,P008211,0 days 00:24:19,-9,48,57
253,BER,P003958,0 days 00:21:58,-4,44,48
253,BER,P011934,0 days 00:20:31,-8,41,49
253,BER,P006919,0 days 00:19:53,-3,41,44
253,BER,P010791,0 days 00:16:51,0,37,37
253,BER,P007550,0 days 00:15:41,1,34,33
253,BER,P006251,0 days 00:14:30,-4,29,33
253,BER,P007025,0 days 00:11:53,-3,23,26
253,BER,P011631,0 days 00:00:07,0,0,0
253,MCO,P005985,0 days 00:29:13,0,62,62
253,MCO,P011212,0 days 00:26:16,4,56,52
253,MCO,P012515,0 days 00:22:50,18,56,38
253,MCO,P011196,0 days 00:22:22,23,57,34
253,MCO,P011231,0 days 00:20:30,-3,43,46
253,MCO,P010588,0 days 00:18:06,-6,37,43
253,MCO,P012709,0 days 00:13:04,13,35,22
253,MCO,PLCZ,0 days 00:12:53,-4,29,33
253,MCO,P004790,0 days 00:12:49,14,33,19
253,MCO,P008099,0 days 00:12:09,2,30,28
253,MCO,P004197,0 days 00:05:03,-10,8,18
253,MCO,P002581,0 days 00:04:45,-11,4,15
254,BAR,P000925,0 days 00:24:56,5,60,55
254,BAR,P006435,0 days 00:23:40,1,49,48
254,BAR,P004866,0 days 00:23:36,6,59,53
254,BAR,P002939,0 days 00:23:18,-1,50,51
254,BAR,P012745,0 days 00:21:52,9,57,48
254,BAR,P011244,0 days 00:19:23,11,41,30
254,BAR,P007519,0 days 00:18:59,21,51,30
254,BAR,PLFW,0 days 00:16:42,19,44,25
254,BAR,P003196,0 days 00:13:49,11,30,19
254,BAR,P003478,0 days 00:13:45,8,29,21
254,PAR,P008987,0 days 00:32:49,-7,68,75
254,PAR,P003983,0 days 00:30:31,3,66,63
254,PAR,P009862,0 days 00:24:59,-12,52,64
254,PAR,P011051,0 days 00:20:04,-7,34,41
254,PAR,P007400,0 days 00:19:04,-10,40,50
254,PAR,P012743,0 days 00:17:01,-4,36,40
254,PAR,P000956,0 days 00:14:33,-5,24,29
254,PAR,P004172,0 days 00:13:59,-12,24,36
254,PAR,P007673,0 days 00:12:43,-9,16,25
254,PAR,P012742,0 days 00:08:24,-18,10,28
254,PAR,P012096,0 days 00:05:53,-9,10,19
255,OLY,P008829,0 days 00:26:36,4,45,41
255,OLY,P008855,0 days 00:26:28,16,53,37
255,OLY,P008811,0 days 00:24:27,-2,33,35
255,OLY,P001255,0 days 00:24:06,6,43,37
255,OLY,P011194,0 days 00:21:06,0,41,41
255,OLY,P010612,0 days 00:19:09,-4,22,26
255,OLY,P007982,0 days 00:18:29,-3,33,36
255,OLY,P007853,0 days 00:16:03,0,28,28
255,OLY,P012878,0 days 00:15:33,8,38,30
255,OLY,P011965,0 days 00:05:49,4,11,7
255,OLY,P011983,0 days 00:02:14,1,8,7
255,PAN,P007866,0 days 00:34:40,-2,58,60
255,PAN,P012774,0 days 00:33:49,-6,55,61
255,PAN,P003842,0 days 00:32:44,-9,46,55
255,PAN,P011204,0 days 00:32:42,4,60,56
255,PAN,P001926,0 days 00:20:36,-7,35,42
255,PAN,P002328,0 days 00:17:36,-7,25,32
255,PAN,P005161,0 days 00:13:30,-1,21,22
255,PAN,P012712,0 days 00:09:39,-7,16,23
255,PAN,P007553,0 days 00:04:44,5,9,4
256,BAS,P004761,0 days 00:29:45,12,60,48
256,BAS,P007230,0 days 00:27:26,16,58,42
256,BAS,P009048,0 days 00:25:32,10,63,53
256,BAS,P011948,0 days 00:24:49,5,56,51
256,BAS,P012201,0 days 00:23:58,13,56,43
256,BAS,P004603,0 days 00:21:23,8,45,37
256,BAS,P010444,0 days 00:18:37,7,43,36
256,BAS,P007946,0 days 00:14:28,5,25,20
256,BAS,P003198,0 days 00:12:55,-1,30,31
256,BAS,P008850,0 days 00:01:07,0,4,4
256,MIL,P007831,0 days 00:31:08,-13,52,65
256,MIL,P000796,0 days 00:30:06,0,61,61
256,MIL,P011205,0 days 00:26:36,-3,53,56
256,MIL,P002849,0 days 00:26:00,-10,44,54
256,MIL,P011224,0 days 00:25:42,-17,39,56
256,MIL,P007201,0 days 00:22:55,-17,44,61
256,MIL,P005670,0 days 00:11:05,-1,28,29
256,MIL,P002812,0 days 00:08:22,-12,5,17
256,MIL,P006509,0 days 00:07:07,-3,12,15
256,MIL,P007032,0 days 00:06:56,-6,13,19
256,MIL,P006721,0 days 00:04:03,7,14,7
257,RED,P012801,0 days 00:32:54,-3,64,67
257,RED,P012044,0 days 00:31:04,-14,57,71
257,RED,P009035,0 days 00:28:01,-1,59,60
257,RED,P006436,0 days 00:27:19,-10,52,62
257,RED,P007960,0 days 00:18:59,1,46,45
257,RED,P002553,0 days 00:18:43,-5,29,34
257,RED,P005099,0 days 00:18:22,7,46,39
257,RED,P011941,0 days 00:11:54,-2,21,23
257,RED,P008966,0 days 00:06:06,3,14,11
257,RED,P011964,0 days 00:03:35,7,10,3
257,RED,P004720,0 days 00:03:03,-3,2,5
257,TEL,P009863,0 days 00:33:54,7,76,69
257,TEL,P009622,0 days 00:31:43,9,68,59
257,TEL,P009783,0 days 00:31:27,5,68,63
257,TEL,P011199,0 days 00:29:54,7,67,60
257,TEL,P012744,0 days 00:18:53,7,42,35
257,TEL,P007990,0 days 00:14:36,-5,31,36
257,TEL,P011214,0 days 00:12:42,-8,19,27
257,TEL,P011971,0 days 00:11:33,5,23,18
257,TEL,P005145,0 days 00:09:46,-2,17,19
257,TEL,P011193,0 days 00:05:32,-5,9,14
258,ULK,P008962,0 days 00:24:02,18,66,48
258,ULK,P009849,0 days 00:22:53,19,69,50
258,ULK,P006661,0 days 00:19:55,13,58,45
258,ULK,P001932,0 days 00:19:15,14,53,39
258,ULK,P006068,0 days 00:19:09,13,50,37
258,ULK,P011157,0 days 00:17:52,7,46,39
258,ULK,P011980,0 days 00:15:58,12,52,40
258,ULK,P006961,0 days 00:15:50,16,53,37
258,ULK,P004004,0 days 00:13:48,10,41,31
258,ULK,P005844,0 days 00:12:03,14,46,32
258,ULK,P011052,0 days 00:10:00,6,33,27
258,ULK,P002968,0 days 00:09:15,8,23,15
258,PAM,P007870,0 days 00:24:57,-17,52,69
258,PAM,P010393,0 days 00:20:10,-17,50,67
258,PAM,P003960,0 days 00:19:50,-13,38,51
258,PAM,P012795,0 days 00:19:48,-12,45,57
258,PAM,P011970,0 days 00:18:15,-15,44,59
258,PAM,P006433,0 days 00:16:35,-15,29,44
258,PAM,P010568,0 days 00:16:16,-13,28,41
258,PAM,P011982,0 days 00:15:11,-10,30,40
258,PAM,P012738,0 days 00:15:03,-13,36,49
258,PAM,P004863,0 days 00:12:50,-5,31,36
258,PAM,P005356,0 days 00:12:34,-14,32,46
258,PAM,P006643,0 days 00:08:31,-6,25,31
259,VIR,P009549,0 days 00:26:44,-8,45,53
259,VIR,P001133,0 days 00:23:38,-21,34,55
259,VIR,P006739,0 days 00:23:26,-12,40,52
259,VIR,P010781,0 days 00:22:08,-6,48,54
259,VIR,PBCN,0 days 00:22:03,-7,38,45
259,VIR,P004554,0 days 00:20:05,-10,30,40
259,VIR,P008847,0 days 00:18:55,-4,40,44
259,VIR,P004007,0 days 00:16:11,-10,32,42
259,VIR,P002084,0 days 00:08:14,5,23,18
259,VIR,P003048,0 days 00:06:52,-1,15,16
259,VIR,P003527,0 days 00:06:09,-3,12,15
259,VIR,P005553,0 days 00:05:35,2,13,11
259,MAD,P010357,0 days 00:25:38,18,59,41
259,MAD,P005791,0 days 00:25:28,8,52,44
259,MAD,P005928,0 days 00:25:04,13,55,42
259,MAD,P009005,0 days 00:21:45,7,52,45
259,MAD,P006540,0 days 00:19:55,11,42,31
259,MAD,P003108,0 days 00:19:15,2,43,41
259,MAD,PTGB,0 days 00:19:07,3,46,43
259,MAD,P003733,0 days 00:17:03,10,33,23
259,MAD,P004887,0 days 00:14:32,7,37,30
259,MAD,P010623,0 days 00:12:13,-4,26,30
260,MUN,P010391,0 days 00:26:40,7,44,37
260,MUN,P007056,0 days 00:26:06,12,43,31
260,MUN,P001288,0 days 00:25:31,6,43,37
260,MUN,P011987,0 days 00:22:26,5,37,32
260,MUN,P008985,0 days 00:20:25,10,37,27
260,MUN,P003583,0 days 00:19:15,1,33,32
260,MUN,P006760,0 days 00:18:36,-5,27,32
260,MUN,P007639,0 days 00:18:03,4,25,21
260,MUN,P001557,0 days 00:12:29,0,21,21
260,MUN,P007975,0 days 00:10:29,-10,10,20
260,ZAL,P002329,0 days 00:30:13,-14,37,51
260,ZAL,P011218,0 days 00:26:33,-1,38,39
260,ZAL,P012715,0 days 00:24:25,2,44,42
260,ZAL,P003210,0 days 00:21:50,4,40,36
260,ZAL,P010390,0 days 00:20:45,-10,30,40
260,ZAL,P002676,0 days 00:19:27,3,29,26
260,ZAL,P005504,0 days 00:16:03,1,23,22
260,ZAL,P007513,0 days 00:12:28,-5,15,20
260,ZAL,P012787,0 days 00:11:35,-1,17,18
260,ZAL,P007109,0 days 00:08:31,2,11,9
260,ZAL,P003211,0 days 00:08:10,-11,6,17
261,ASV,P005094,0 days 00:31:39,10,66,56
261,ASV,P012080,0 days 00:25:35,-2,56,58
261,ASV,P002100,0 days 00:24:56,5,58,53
261,ASV,P011225,0 days 00:22:13,0,49,49
261,ASV,P012731,0 days 00:20:55,-3,47,50
261,ASV,P006568,0 days 00:20:19,5,39,34
261,ASV,P011386,0 days 00:17:47,4,35,31
261,ASV,P000229,0 days 00:15:06,-1,26,27
261,ASV,P003526,0 days 00:13:28,7,25,18
261,ASV,PKIR,0 days 00:08:02,-5,19,24
261,IST,P004888,0 days 00:36:18,-1,72,73
261,IST,P007200,0 days 00:30:31,-10,56,66
261,IST,P011078,0 days 00:26:32,3,61,58
261,IST,P006590,0 days 00:22:51,-1,53,54
261,IST,P011981,0 days 00:20:44,1,48,47
261,IST,P009664,0 days 00:13:45,-8,24,32
261,IST,PLHK,0 days 00:13:28,-7,18,25
261,IST,P009846,0 days 00:12:38,9,32,23
261,IST,P012710,0 days 00:11:09,-5,16,21
261,IST,P009513,0 days 00:08:23,-5,11,16
261,IST,P012788,0 days 00:03:41,4,9,5
262,BER,P010791,0 days 00:27:19,18,60,42
262,BER,P003958,0 days 00:26:51,4,55,51
262,BER,P008967,0 days 00:25:42,11,55,44
262,BER,P008780,0 days 00:24:04,6,49,43
262,BER,P012720,0 days 00:23:00,-6,48,54
262,BER,P006919,0 days 00:22:18,-2,39,41
262,BER,P006251,0 days 00:14:39,-14,27,41
262,BER,P008211,0 days 00:11:52,-1,28,29
262,BER,P011934,0 days 00:11:03,-22,16,38
262,BER,P007025,0 days 00:09:15,-17,16,33
262,BER,P007550,0 days 00:03:57,-12,2,14
262,MAD,P010357,0 days 00:28:38,19,72,53
262,MAD,P003108,0 days 00:26:39,6,60,54
262,MAD,P005928,0 days 00:25:12,3,55,52
262,MAD,P005791,0 days 00:23:19,3,50,47
262,MAD,P003733,0 days 00:21:43,7,50,43
262,MAD,P004887,0 days 00:16:33,4,36,32
262,MAD,P009005,0 days 00:16:08,4,32,28
262,MAD,P001392,0 days 00:15:38,-3,30,33
262,MAD,P010623,0 days 00:14:48,4,31,27
262,MAD,P009213,0 days 00:11:22,-12,14,26
263,IST,P007200,0 days 00:26:33,8,60,52
263,IST,P004888,0 days 00:25:16,7,57,50
263,IST,P009846,0 days 00:22:19,14,47,33
263,IST,P009664,0 days 00:20:27,10,43,33
263,IST,P012788,0 days 00:20:24,1,37,36
263,IST,P006590,0 days 00:19:45,6,37,31
263,IST,P011078,0 days 00:18:37,-4,35,39
263,IST,PLHK,0 days 00:16:22,8,40,32
263,IST,P012710,0 days 00:14:32,3,33,30
263,IST,P009513,0 days 00:12:31,8,28,20
263,IST,P011981,0 days 00:03:14,4,8,4
263,OLY,P008829,0 days 00:30:00,-7,56,63
263,OLY,P001255,0 days 00:28:33,7,60,53
263,OLY,P008855,0 days 00:27:17,-8,55,63
263,OLY,P008811,0 days 00:26:06,-6,49,55
263,OLY,P010612,0 days 00:25:57,-3,54,57
263,OLY,P007982,0 days 00:20:00,-14,27,41
263,OLY,P012878,0 days 00:13:54,-7,23,30
263,OLY,P011194,0 days 00:10:00,-6,16,22
263,OLY,P010392,0 days 00:07:30,-10,10,20
263,OLY,P007853,0 days 00:06:46,-1,8,9
263,OLY,P011983,0 days 00:03:57,-10,2,12
264,TEL,P009783,0 days 00:34:44,9,89,80
264,TEL,P009863,0 days 00:32:51,15,89,74
264,TEL,P011199,0 days 00:28:42,17,74,57
264,TEL,P012744,0 days 00:23:49,12,64,52
264,TEL,P009622,0 days 00:22:34,-1,51,52
264,TEL,P007990,0 days 00:21:40,8,55,47
264,TEL,P011971,0 days 00:11:24,-8,19,27
264,TEL,P005145,0 days 00:09:54,4,25,21
264,TEL,P011214,0 days 00:07:36,-11,10,21
264,TEL,P011193,0 days 00:06:46,-5,14,19
264,ASV,P005094,0 days 00:26:59,-17,58,75
264,ASV,P011225,0 days 00:25:01,-9,61,70
264,ASV,P002100,0 days 00:24:20,-2,60,62
264,ASV,P006568,0 days 00:23:00,-5,54,59
264,ASV,P012080,0 days 00:21:44,-10,48,58
264,ASV,P004194,0 days 00:15:48,-3,33,36
264,ASV,P000229,0 days 00:15:38,-6,30,36
264,ASV,P011386,0 days 00:14:49,1,29,28
264,ASV,P012731,0 days 00:14:08,10,35,25
264,ASV,P003526,0 days 00:12:51,-4,24,28
264,ASV,PKIR,0 days 00:05:42,5,18,13
265,PAR,P012096,0 days 00:38:22,4,83,79
265,PAR,P009862,0 days 00:28:13,6,62,56
265,PAR,P012743,0 days 00:24:41,14,59,45
265,PAR,P004172,0 days 00:23:19,4,52,48
265,PAR,P007400,0 days 00:22:08,0,44,44
265,PAR,P012742,0 days 00:22:05,7,52,45
265,PAR,P003983,0 days 00:13:29,-1,27,28
265,PAR,P007673,0 days 00:11:25,-8,24,32
265,PAR,P000956,0 days 00:05:23,-1,14,15
265,PAR,P011051,0 days 00:05:10,-3,7,10
265,PAR,P004058,0 days 00:04:21,-2,7,9
265,PAR,P011050,0 days 00:01:24,0,4,4
265,BAS,P004761,0 days 00:29:01,-6,62,68
265,BAS,P010444,0 days 00:27:33,5,60,55
265,BAS,P009048,0 days 00:27:24,-3,59,62
265,BAS,P012201,0 days 00:24:56,-5,48,53
265,BAS,P011948,0 days 00:21:01,-1,42,43
265,BAS,P007230,0 days 00:18:08,-15,31,46
265,BAS,P003198,0 days 00:15:03,4,34,30
265,BAS,P007946,0 days 00:11:25,-1,22,23
265,BAS,P012765,0 days 00:10:16,5,23,18
265,BAS,P004603,0 days 00:09:59,-6,19,25
265,BAS,P011085,0 days 00:04:46,4,14,10
265,BAS,P008850,0 days 00:00:28,-1,1,2
266,ZAL,P002329,0 days 00:27:03,7,70,63
266,ZAL,P002676,0 days 00:26:20,21,64,43
266,ZAL,P007513,0 days 00:23:54,8,58,50
266,ZAL,P011218,0 days 00:23:30,7,63,56
266,ZAL,P010390,0 days 00:20:47,8,45,37
266,ZAL,P005504,0 days 00:19:08,10,51,41
266,ZAL,P012787,0 days 00:15:54,7,33,26
266,ZAL,P003210,0 days 00:11:38,6,25,19
266,ZAL,P012715,0 days 00:11:01,-8,20,28
266,ZAL,P003211,0 days 00:10:31,0,22,22
266,ZAL,P006860,0 days 00:09:26,8,26,18
266,ZAL,P012784,0 days 00:00:48,1,3,2
266,VIR,P006739,0 days 00:30:03,-6,65,71
266,VIR,P001133,0 days 00:29:11,-4,67,71
266,VIR,P003527,0 days 00:25:55,-13,48,61
266,VIR,PBCN,0 days 00:24:30,-9,45,54
266,VIR,P005553,0 days 00:20:48,-12,38,50
266,VIR,P010781,0 days 00:17:21,-12,34,46
266,VIR,P008847,0 days 00:16:50,-12,36,48
266,VIR,P004007,0 days 00:13:37,1,31,30
266,VIR,P004554,0 days 00:11:30,-5,27,32
266,VIR,P003048,0 days 00:10:15,-3,14,17
267,MCO,P005985,0 days 00:28:35,-19,56,75
267,MCO,P011226,0 days 00:24:47,-10,51,61
267,MCO,P010588,0 days 00:24:17,-21,44,65
267,MCO,P011212,0 days 00:22:50,2,52,50
267,MCO,P011231,0 days 00:20:56,-2,46,48
267,MCO,P011196,0 days 00:20:10,4,41,37
267,MCO,P009754,0 days 00:17:27,-17,28,45
267,MCO,P012709,0 days 00:16:21,-5,36,41
267,MCO,PLCZ,0 days 00:11:03,-15,19,34
267,MCO,P004197,0 days 00:10:00,-5,17,22
267,MCO,P002581,0 days 00:03:34,-2,10,12
267,MIL,P000796,0 days 00:29:30,18,78,60
267,MIL,P007831,0 days 00:28:45,28,79,51
267,MIL,P011224,0 days 00:26:48,15,71,56
267,MIL,P006509,0 days 00:26:37,10,62,52
267,MIL,P011205,0 days 00:22:55,7,56,49
267,MIL,P002849,0 days 00:20:10,11,57,46
267,MIL,P007201,0 days 00:15:57,-1,28,29
267,MIL,P007032,0 days 00:15:29,-2,32,34
267,MIL,P002812,0 days 00:12:43,4,27,23
267,MIL,P005670,0 days 00:00:33,0,0,0
267,MIL,P006701,0 days 00:00:33,0,0,0
268,RED,P009035,0 days 00:32:36,-7,64,71
268,RED,P007960,0 days 00:27:39,-6,50,56
268,RED,P000848,0 days 00:24:54,-4,53,57
268,RED,P011964,0 days 00:23:17,0,43,43
268,RED,P005099,0 days 00:22:43,-6,37,43
268,RED,PJDR,0 days 00:17:13,-5,39,44
268,RED,P012801,0 days 00:15:09,-9,23,32
268,RED,P006436,0 days 00:14:59,-6,31,37
268,RED,P002553,0 days 00:09:21,-7,17,24
268,RED,P008966,0 days 00:05:18,-9,11,20
268,RED,P011941,0 days 00:04:47,-4,6,10
268,RED,P004720,0 days 00:02:04,-2,6,8
268,PAN,P012774,0 days 00:37:45,12,86,74
268,PAN,P003842,0 days 00:36:48,16,81,65
268,PAN,P007866,0 days 00:32:06,10,69,59
268,PAN,P011204,0 days 00:29:53,9,64,55
268,PAN,P001926,0 days 00:27:09,10,65,55
268,PAN,P002328,0 days 00:24:29,11,53,42
268,PAN,P012712,0 days 00:08:42,1,20,19
268,PAN,P007553,0 days 00:02:40,-3,6,9
268,PAN,P011209,0 days 00:00:24,-1,1,2
268,PAN,P006544,0 days 00:00:04,0,0,0
269,ULK,P008962,0 days 00:31:01,5,63,58
269,ULK,P001932,0 days 00:25:54,10,54,44
269,ULK,P011157,0 days 00:24:35,4,54,50
269,ULK,P006661,0 days 00:22:52,16,60,44
269,ULK,P004004,0 days 00:22:27,6,50,44
269,ULK,P006961,0 days 00:21:50,19,57,38
269,ULK,P002968,0 days 00:14:18,10,34,24
269,ULK,P010560,0 days 00:13:40,-5,23,28
269,ULK,P009849,0 days 00:12:26,-1,20,21
269,ULK,P006068,0 days 00:09:50,6,25,19
269,ULK,P005844,0 days 00:01:07,0,0,0
269,BAR,P002939,0 days 00:26:14,-15,45,60
269,BAR,P012745,0 days 00:23:57,-18,41,59
269,BAR,PLFW,0 days 00:21:13,-5,42,47
269,BAR,P000925,0 days 00:19:31,-13,31,44
269,BAR,P006435,0 days 00:19:21,-16,29,45
269,BAR,P003478,0 days 00:18:08,3,38,35
269,BAR,P003196,0 days 00:17:50,-3,35,38
269,BAR,P004866,0 days 00:17:42,-11,27,38
269,BAR,P011244,0 days 00:16:03,4,33,29
269,BAR,P009992,0 days 00:13:53,7,36,29
269,BAR,P007519,0 days 00:03:29,-5,5,10
269,BAR,P010641,0 days 00:02:39,2,8,6
270,PAM,P011982,0 days 00:29:46,9,55,46
270,PAM,P010568,0 days 00:28:48,7,56,49
270,PAM,P010393,0 days 00:26:00,11,52,41
270,PAM,P004863,0 days 00:25:47,7,46,39
270,PAM,P003960,0 days 00:24:04,7,50,43
270,PAM,P012795,0 days 00:17:03,-6,21,27
270,PAM,P000556,0 days 00:13:02,-6,20,26
270,PAM,P005356,0 days 00:11:44,-4,17,21
270,PAM,P012739,0 days 00:09:55,-13,9,22
270,PAM,P006433,0 days 00:09:11,-2,16,18
270,PAM,P012740,0 days 00:04:40,0,8,8
270,MUN,P001288,0 days 00:27:26,-4,45,49
270,MUN,P007056,0 days 00:25:43,-13,39,52
270,MUN,P011987,0 days 00:24:14,-2,41,43
270,MUN,P007975,0 days 00:21:40,1,37,36
270,MUN,P010391,0 days 00:21:14,2,34,32
270,MUN,P003583,0 days 00:20:31,2,35,33
270,MUN,P008985,0 days 00:18:17,-2,32,34
270,MUN,P001557,0 days 00:10:59,3,21,18
270,MUN,P005460,0 days 00:08:39,7,20,13
270,MUN,P006543,0 days 00:08:39,4,16,12
270,MUN,P006760,0 days 00:07:52,-8,9,17
270,MUN,P005478,0 days 00:04:46,0,11,11
271,IST,P009846,0 days 00:24:24,14,60,46
271,IST,P011078,0 days 00:23:53,12,59,47
271,IST,P004888,0 days 00:22:24,-15,38,53
271,IST,P009664,0 days 00:22:21,10,53,43
271,IST,P006590,0 days 00:22:14,8,50,42
271,IST,P011981,0 days 00:17:55,10,43,33
271,IST,P012710,0 days 00:17:39,-9,32,41
271,IST,PLHK,0 days 00:14:51,-7,28,35
271,IST,P007200,0 days 00:14:08,-4,28,32
271,IST,P009513,0 days 00:12:57,-12,20,32
271,IST,P012788,0 days 00:07:14,-2,14,16
271,BER,P008967,0 days 00:25:47,12,61,49
271,BER,P003958,0 days 00:24:33,9,54,45
271,BER,P008780,0 days 00:24:24,11,58,47
271,BER,P006919,0 days 00:23:42,10,56,46
271,BER,P010791,0 days 00:21:52,-4,43,47
271,BER,P012720,0 days 00:18:20,-12,32,44
271,BER,P011934,0 days 00:18:08,3,41,38
271,BER,P008211,0 days 00:15:36,-12,26,38
271,BER,P007025,0 days 00:14:13,-13,23,36
271,BER,P006251,0 days 00:13:25,-9,26,35
272,OLY,P008829,0 days 00:32:34,10,61,51
272,OLY,P008811,0 days 00:23:04,11,45,34
272,OLY,P007982,0 days 00:20:53,7,42,35
272,OLY,P008855,0 days 00:20:47,3,40,37
272,OLY,P001255,0 days 00:20:00,-1,31,32
272,OLY,P007853,0 days 00:20:00,17,49,32
272,OLY,P010392,0 days 00:19:39,19,49,30
272,OLY,P010612,0 days 00:18:41,3,29,26
272,OLY,P012878,0 days 00:16:56,5,35,30
272,OLY,P011194,0 days 00:07:26,6,19,13
272,ASV,P011225,0 days 00:28:18,-18,44,62
272,ASV,P012080,0 days 00:26:56,-11,45,56
272,ASV,P002100,0 days 00:23:05,-12,32,44
272,ASV,P004194,0 days 00:20:18,-1,33,34
272,ASV,P012729,0 days 00:20:02,-17,32,49
272,ASV,P012731,0 days 00:19:58,1,32,31
272,ASV,P006568,0 days 00:19:42,-15,31,46
272,ASV,PKIR,0 days 00:16:09,-11,22,33
272,ASV,P000229,0 days 00:13:50,2,29,27
272,ASV,P011386,0 days 00:11:42,2,20,18
273,PAR,P009862,0 days 00:33:13,-2,67,69
273,PAR,P007400,0 days 00:32:24,-9,71,80
273,PAR,P012743,0 days 00:28:04,6,61,55
273,PAR,P003983,0 days 00:26:15,-9,60,69
273,PAR,P012096,0 days 00:22:05,-14,36,50
273,PAR,P011051,0 days 00:18:56,-18,31,49
273,PAR,P004172,0 days 00:16:47,-4,24,28
273,PAR,P012742,0 days 00:12:14,-8,16,24
273,PAR,P000956,0 days 00:06:30,4,14,10
273,PAR,P004058,0 days 00:03:32,-6,0,6
273,MAD,P003108,0 days 00:31:45,20,79,59
273,MAD,P010357,0 days 00:26:08,5,61,56
273,MAD,P001392,0 days 00:22:21,18,54,36
273,MAD,P005928,0 days 00:22:06,9,52,43
273,MAD,P004887,0 days 00:19:41,16,43,27
273,MAD,P009005,0 days 00:19:02,4,35,31
273,MAD,P003733,0 days 00:18:48,-7,38,45
273,MAD,P005791,0 days 00:17:05,-2,39,41
273,MAD,P010623,0 days 00:11:52,-3,18,21
273,MAD,P006540,0 days 00:08:26,-4,14,18
273,MAD,P011649,0 days 00:02:46,4,7,3
274,ZAL,P010390,0 days 00:27:54,17,66,49
274,ZAL,P011218,0 days 00:24:54,2,55,53
274,ZAL,P007513,0 days 00:23:10,3,53,50
274,ZAL,P002676,0 days 00:22:29,17,56,39
274,ZAL,P002329,0 days 00:20:37,1,44,43
274,ZAL,P012715,0 days 00:17:45,19,47,28
274,ZAL,P003211,0 days 00:16:44,13,44,31
274,ZAL,P012787,0 days 00:14:13,17,34,17
274,ZAL,P003210,0 days 00:13:29,6,30,24
274,ZAL,P005504,0 days 00:12:06,1,28,27
274,ZAL,P006860,0 days 00:05:31,-4,11,15
274,ZAL,P012784,0 days 00:01:08,-2,2,4
274,BAS,P009048,0 days 00:30:38,-9,62,71
274,BAS,P004761,0 days 00:30:34,-2,66,68
274,BAS,P011948,0 days 00:27:42,-11,53,64
274,BAS,P012201,0 days 00:26:21,-14,50,64
274,BAS,P010444,0 days 00:23:14,-9,42,51
274,BAS,P007230,0 days 00:18:20,-10,32,42
274,BAS,P004603,0 days 00:12:38,-1,30,31
274,BAS,P011085,0 days 00:10:51,-15,18,33
274,BAS,P012765,0 days 00:08:27,-4,14,18
274,BAS,P003198,0 days 00:08:12,-8,11,19
274,BAS,P007946,0 days 00:03:03,-7,2,9
275,MCO,P005985,0 days 00:33:14,13,71,58
275,MCO,P011226,0 days 00:25:52,-11,45,56
275,MCO,P008099,0 days 00:24:33,2,53,51
275,MCO,P010588,0 days 00:24:20,13,56,43
275,MCO,P011231,0 days 00:21:39,5,46,41
275,MCO,P011196,0 days 00:21:07,-6,39,45
275,MCO,PLCZ,0 days 00:16:56,5,36,31
275,MCO,P011212,0 days 00:12:58,2,24,22
275,MCO,P012709,0 days 00:10:00,-15,10,25
275,MCO,P004790,0 days 00:09:21,-3,15,18
275,PAM,P010568,0 days 00:27:14,-4,51,55
275,PAM,P012795,0 days 00:27:03,-11,47,58
275,PAM,P011982,0 days 00:24:56,17,61,44
275,PAM,P003960,0 days 00:24:29,-3,46,49
275,PAM,P004863,0 days 00:19:34,14,45,31
275,PAM,P000556,0 days 00:17:26,1,32,31
275,PAM,P010393,0 days 00:13:51,-9,15,24
275,PAM,P005356,0 days 00:13:01,1,29,28
275,PAM,P012738,0 days 00:11:36,-1,28,29
275,PAM,P006433,0 days 00:11:18,-12,19,31
275,PAM,P012740,0 days 00:09:32,2,17,15
276,MIL,P007831,0 days 00:32:48,3,66,63
276,MIL,P011224,0 days 00:26:56,5,54,49
276,MIL,P000796,0 days 00:26:43,7,55,48
276,MIL,P011205,0 days 00:26:30,4,49,45
276,MIL,P002849,0 days 00:23:54,-1,47,48
276,MIL,P006509,0 days 00:21:21,-10,41,51
276,MIL,P007201,0 days 00:14:33,-6,25,31
276,MIL,P009960,0 days 00:11:47,4,23,19
276,MIL,P005670,0 days 00:08:40,3,16,13
276,MIL,P006701,0 days 00:03:45,-2,5,7
276,MIL,P002812,0 days 00:03:03,-2,4,6
276,ULK,P006661,0 days 00:27:51,10,57,47
276,ULK,P006961,0 days 00:26:48,-4,51,55
276,ULK,P004004,0 days 00:26:16,2,49,47
276,ULK,P008962,0 days 00:25:51,-1,52,53
276,ULK,P001932,0 days 00:24:15,-10,42,52
276,ULK,P011157,0 days 00:21:51,-6,41,47
276,ULK,P009849,0 days 00:17:42,12,43,31
276,ULK,P011980,0 days 00:10:18,2,17,15
276,ULK,P005844,0 days 00:06:38,-3,8,11
276,ULK,P006068,0 days 00:06:28,-8,10,18
276,ULK,P002968,0 days 00:06:02,1,10,9
277,RED,P009035,0 days 00:28:05,16,70,54
277,RED,P005099,0 days 00:26:22,6,59,53
277,RED,P000848,0 days 00:23:36,10,60,50
277,RED,P006436,0 days 00:20:11,11,48,37
277,RED,P007960,0 days 00:19:49,3,45,42
277,RED,P002553,0 days 00:18:38,7,43,36
277,RED,P008966,0 days 00:17:27,9,48,39
277,RED,PJDR,0 days 00:16:37,14,43,29
277,RED,P011964,0 days 00:15:41,-2,27,29
277,RED,P012801,0 days 00:13:13,1,27,26
277,RED,P004720,0 days 00:00:21,0,0,0
277,VIR,P010781,0 days 00:29:49,-9,58,67
277,VIR,P001133,0 days 00:29:21,-15,57,72
277,VIR,PBCN,0 days 00:27:13,-7,54,61
277,VIR,P003527,0 days 00:23:26,-11,47,58
277,VIR,P003048,0 days 00:19:32,-5,42,47
277,VIR,P006739,0 days 00:19:09,-5,42,47
277,VIR,P008847,0 days 00:18:04,-4,31,35
277,VIR,P004007,0 days 00:11:34,-15,24,39
277,VIR,P002084,0 days 00:11:19,0,24,24
277,VIR,P005553,0 days 00:10:33,-4,16,20
278,MUN,P001288,0 days 00:29:45,-7,50,57
278,MUN,P011987,0 days 00:29:44,-18,51,69
278,MUN,P003583,0 days 00:26:23,-8,43,51
278,MUN,P008985,0 days 00:25:58,-1,56,57
278,MUN,P006760,0 days 00:16:47,-11,36,47
278,MUN,P010391,0 days 00:16:19,-6,23,29
278,MUN,P001557,0 days 00:15:07,6,29,23
278,MUN,P007975,0 days 00:14:03,-17,23,40
278,MUN,P005460,0 days 00:10:45,6,29,23
278,MUN,P006543,0 days 00:10:15,-8,24,32
278,MUN,P005478,0 days 00:04:54,-11,6,17
278,TEL,P009783,0 days 00:34:21,17,75,58
278,TEL,P009863,0 days 00:28:14,3,53,50
278,TEL,P011199,0 days 00:28:07,14,60,46
278,TEL,P009622,0 days 00:27:44,15,58,43
278,TEL,P011971,0 days 00:20:45,6,51,45
278,TEL,P012744,0 days 00:17:19,9,41,32
278,TEL,P011193,0 days 00:12:16,0,31,31
278,TEL,P007990,0 days 00:12:00,14,38,24
278,TEL,P011214,0 days 00:11:53,1,29,28
278,TEL,P005145,0 days 00:07:21,-4,9,13
279,PAN,P007866,0 days 00:37:47,15,89,74
279,PAN,P003842,0 days 00:35:04,6,78,72
279,PAN,P001926,0 days 00:33:31,21,81,60
279,PAN,P012774,0 days 00:29:24,8,67,59
279,PAN,P002328,0 days 00:29:13,1,62,61
279,PAN,P011204,0 days 00:24:04,6,54,48
279,PAN,P012712,0 days 00:03:33,-5,4,9
279,PAN,P007553,0 days 00:03:22,-4,5,9
279,PAN,P011209,0 days 00:03:04,-6,3,9
279,PAN,P007947,0 days 00:00:58,-2,2,4
279,BAR,P002939,0 days 00:27:52,-5,58,63
279,BAR,P012745,0 days 00:26:28,-9,51,60
279,BAR,P000925,0 days 00:25:18,-11,45,56
279,BAR,P004866,0 days 00:24:05,-12,42,54
279,BAR,P006435,0 days 00:21:21,-7,41,48
279,BAR,P003478,0 days 00:15:55,4,39,35
279,BAR,P007519,0 days 00:15:41,-3,31,34
279,BAR,PLFW,0 days 00:15:32,-4,32,36
279,BAR,P003196,0 days 00:14:42,3,36,33
279,BAR,P011244,0 days 00:13:06,4,30,26
280,MUN,P001288,0 days 00:29:35,-9,55,64
280,MUN,P006760,0 days 00:26:04,-7,49,56
280,MUN,P003583,0 days 00:26:03,-9,43,52
280,MUN,P011987,0 days 00:23:37,-8,42,50
280,MUN,P007975,0 days 00:20:37,3,47,44
280,MUN,P010391,0 days 00:20:06,-2,46,48
280,MUN,P008985,0 days 00:17:00,-9,27,36
280,MUN,P006543,0 days 00:12:49,5,34,29
280,MUN,P005460,0 days 00:10:55,-5,27,32
280,MUN,P012123,0 days 00:06:58,2,16,14
280,MUN,P005478,0 days 00:06:16,-1,9,10
280,BAR,P012745,0 days 00:23:01,9,55,46
280,BAR,P002939,0 days 00:21:17,11,49,38
280,BAR,P006435,0 days 00:20:43,-2,43,45
280,BAR,P004866,0 days 00:20:35,3,41,38
280,BAR,P000925,0 days 00:20:33,-7,38,45
280,BAR,P003196,0 days 00:19:27,15,49,34
280,BAR,P003478,0 days 00:17:09,5,42,37
280,BAR,P011244,0 days 00:16:59,-1,32,33
280,BAR,PLFW,0 days 00:16:52,2,38,36
280,BAR,P009992,0 days 00:15:15,9,35,26
280,BAR,P007519,0 days 00:08:09,-4,13,17
281,ASV,P012080,0 days 00:28:42,-13,54,67
281,ASV,P011225,0 days 00:25:58,-11,52,63
281,ASV,P012731,0 days 00:22:05,-1,40,41
281,ASV,P002100,0 days 00:21:20,-4,44,48
281,ASV,P000229,0 days 00:20:31,-10,37,47
281,ASV,P004194,0 days 00:20:14,-8,43,51
281,ASV,P006568,0 days 00:18:50,4,34,30
281,ASV,P011386,0 days 00:13:45,4,25,21
281,ASV,PKIR,0 days 00:13:43,-9,33,42
281,ASV,P003526,0 days 00:09:44,4,19,15
281,ASV,P012729,0 days 00:05:08,-6,4,10
281,MCO,P011226,0 days 00:30:33,17,75,58
281,MCO,P005985,0 days 00:28:36,20,73,53
281,MCO,P011212,0 days 00:26:42,13,60,47
281,MCO,P011231,0 days 00:25:05,11,58,47
281,MCO,P009754,0 days 00:20:49,-2,39,41
281,MCO,P011196,0 days 00:19:34,7,41,34
281,MCO,P010588,0 days 00:17:15,4,40,36
281,MCO,PLCZ,0 days 00:12:43,2,27,25
281,MCO,P004197,0 days 00:08:19,-7,10,17
281,MCO,P002581,0 days 00:05:23,-4,8,12
281,MCO,P012709,0 days 00:05:01,-11,4,15
282,BAS,P009048,0 days 00:27:07,-6,54,60
282,BAS,P004761,0 days 00:26:32,-20,44,64
282,BAS,P011948,0 days 00:25:24,-10,53,63
282,BAS,P007230,0 days 00:24:17,-24,42,66
282,BAS,P004603,0 days 00:23:08,-24,40,64
282,BAS,P011085,0 days 00:18:37,-3,37,40
282,BAS,P010444,0 days 00:15:38,0,29,29
282,BAS,P012201,0 days 00:14:30,-6,32,38
282,BAS,P012765,0 days 00:13:18,-13,24,37
282,BAS,P003198,0 days 00:11:29,1,25,24
282,IST,P004888,0 days 00:29:41,20,78,58
282,IST,P007200,0 days 00:28:21,28,79,51
282,IST,P012710,0 days 00:24:18,29,65,36
282,IST,P011078,0 days 00:19:34,-5,40,45
282,IST,P011981,0 days 00:17:45,16,43,27
282,IST,P009513,0 days 00:16:30,28,49,21
282,IST,P006590,0 days 00:15:29,-2,31,33
282,IST,P009846,0 days 00:15:26,-8,28,36
282,IST,PLHK,0 days 00:13:44,13,38,25
282,IST,P009664,0 days 00:10:47,-5,20,25
282,IST,P012788,0 days 00:08:00,-7,14,21
282,IST,P006372,0 days 00:00:25,-2,0,2
283,TEL,P009783,0 days 00:31:37,5,68,63
283,TEL,P009863,0 days 00:28:31,15,68,53
283,TEL,P009622,0 days 00:27:41,13,65,52
283,TEL,P011199,0 days 00:27:09,16,67,51
283,TEL,P012744,0 days 00:17:40,-1,45,46
283,TEL,P011214,0 days 00:15:48,-3,34,37
283,TEL,P005145,0 days 00:12:44,11,31,20
283,TEL,P011193,0 days 00:12:15,3,30,27
283,TEL,P007990,0 days 00:11:29,0,27,27
283,TEL,P011971,0 days 00:11:06,19,33,14
283,TEL,P012095,0 days 00:04:00,-3,7,10
283,PAM,P011982,0 days 00:24:42,-8,52,60
283,PAM,P003960,0 days 00:24:12,-5,49,54
283,PAM,P012795,0 days 00:22:53,-12,45,57
283,PAM,P010568,0 days 00:20:57,-7,40,47
283,PAM,P004863,0 days 00:20:30,-1,40,41
283,PAM,P005356,0 days 00:19:35,-8,39,47
283,PAM,P012740,0 days 00:18:37,-5,40,45
283,PAM,P006433,0 days 00:17:26,-12,36,48
283,PAM,P010393,0 days 00:17:20,-11,31,42
283,PAM,P000556,0 days 00:10:58,-1,24,25
283,PAM,P012738,0 days 00:02:50,-5,4,9
284,PAR,P009862,0 days 00:37:27,-9,63,72
284,PAR,P012743,0 days 00:34:19,2,62,60
284,PAR,P012742,0 days 00:32:29,6,64,58
284,PAR,P012096,0 days 00:27:25,-10,43,53
284,PAR,P004172,0 days 00:27:15,9,56,47
284,PAR,P007400,0 days 00:15:45,-6,26,32
284,PAR,P011051,0 days 00:09:26,-1,14,15
284,PAR,P007673,0 days 00:06:00,-9,7,16
284,PAR,P003983,0 days 00:05:37,-6,5,11
284,PAR,P011050,0 days 00:04:17,-1,5,6
284,OLY,P001255,0 days 00:30:00,8,59,51
284,OLY,P008811,0 days 00:30:00,8,59,51
284,OLY,P008855,0 days 00:29:05,6,55,49
284,OLY,P007982,0 days 00:23:45,15,52,37
284,OLY,P010612,0 days 00:20:08,-8,33,41
284,OLY,P010392,0 days 00:19:52,13,41,28
284,OLY,P008829,0 days 00:13:47,-13,19,32
284,OLY,P007853,0 days 00:12:47,-4,20,24
284,OLY,P006589,0 days 00:10:36,3,17,14
284,OLY,P012878,0 days 00:10:00,-3,15,18
285,ZAL,P002676,0 days 00:30:30,13,64,51
285,ZAL,P011218,0 days 00:27:56,11,61,50
285,ZAL,P002329,0 days 00:25:15,13,54,41
285,ZAL,P007513,0 days 00:24:31,-1,41,42
285,ZAL,P010390,0 days 00:20:38,11,51,40
285,ZAL,P005504,0 days 00:18:46,2,35,33
285,ZAL,P012787,0 days 00:15:06,16,45,29
285,ZAL,P012715,0 days 00:14:09,0,32,32
285,ZAL,P003211,0 days 00:11:05,2,26,24
285,ZAL,P003210,0 days 00:10:52,1,24,23
285,ZAL,P006860,0 days 00:00:36,1,1,0
285,ZAL,P010184,0 days 00:00:36,1,1,0
285,MIL,P007831,0 days 00:31:49,-11,55,66
285,MIL,P002849,0 days 00:27:29,-11,46,57
285,MIL,P011224,0 days 00:26:13,-5,53,58
285,MIL,P000796,0 days 00:25:34,-12,43,55
285,MIL,P006509,0 days 00:22:03,-12,33,45
285,MIL,P011205,0 days 00:20:48,-8,43,51
285,MIL,P007032,0 days 00:17:30,-3,35,38
285,MIL,P007201,0 days 00:13:08,-1,27,28
285,MIL,P009960,0 days 00:10:01,-5,21,26
285,MIL,P002812,0 days 00:03:48,1,9,8
285,MIL,P005670,0 days 00:01:37,-3,0,3
286,ULK,P008962,0 days 00:29:56,39,87,48
286,ULK,P006661,0 days 00:20:40,19,48,29
286,ULK,P001932,0 days 00:19:37,13,50,37
286,ULK,P011052,0 days 00:17:23,17,46,29
286,ULK,P010560,0 days 00:17:16,13,45,32
286,ULK,P011980,0 days 00:16:06,4,33,29
286,ULK,P009849,0 days 00:15:53,15,45,30
286,ULK,P006961,0 days 00:15:49,17,40,23
286,ULK,P011157,0 days 00:13:55,17,41,24
286,ULK,P002968,0 days 00:13:20,7,32,25
286,ULK,P005844,0 days 00:12:45,11,30,19
286,ULK,P011201,0 days 00:07:20,3,18,15
286,BER,P010791,0 days 00:23:45,-8,45,53
286,BER,P012721,0 days 00:22:15,-6,41,47
286,BER,P008967,0 days 00:21:33,-11,44,55
286,BER,P008780,0 days 00:20:25,-7,40,47
286,BER,P012720,0 days 00:20:10,-26,28,54
286,BER,P006919,0 days 00:19:58,-24,35,59
286,BER,P006251,0 days 00:19:10,-29,28,57
286,BER,P007025,0 days 00:16:57,-11,27,38
286,BER,P008211,0 days 00:13:01,-11,18,29
286,BER,P006819,0 days 00:12:41,-25,18,43
286,BER,P007550,0 days 00:10:05,-17,16,33
287,MAD,P010357,0 days 00:29:43,7,78,71
287,MAD,P003108,0 days 00:26:15,22,80,58
287,MAD,P006540,0 days 00:25:22,13,71,58
287,MAD,P005791,0 days 00:24:33,6,63,57
287,MAD,PBMT,0 days 00:19:06,6,49,43
287,MAD,PTGB,0 days 00:19:04,5,51,46
287,MAD,P009213,0 days 00:15:07,-5,32,37
287,MAD,PCVM,0 days 00:12:25,0,27,27
287,MAD,P011649,0 days 00:08:53,-6,16,22
287,MAD,P010623,0 days 00:08:26,1,20,19
287,MAD,P001392,0 days 00:05:33,-7,9,16
287,MAD,P003733,0 days 00:05:33,-7,9,16
287,RED,P000848,0 days 00:31:53,-1,78,79
287,RED,P005099,0 days 00:30:05,-1,69,70
287,RED,P009035,0 days 00:19:47,-13,39,52
287,RED,P012801,0 days 00:17:19,-10,42,52
287,RED,P011941,0 days 00:16:02,15,45,30
287,RED,P006436,0 days 00:15:59,-8,38,46
287,RED,P007960,0 days 00:15:56,-4,38,42
287,RED,PLUO,0 days 00:15:17,-9,30,39
287,RED,P011964,0 days 00:14:12,4,37,33
287,RED,P002553,0 days 00:11:35,-3,27,30
287,RED,P008966,0 days 00:07:08,-7,14,21
287,RED,P004720,0 days 00:04:47,2,13,11
288,VIR,P001133,0 days 00:29:13,-4,58,62
288,VIR,P006739,0 days 00:27:16,6,59,53
288,VIR,P004007,0 days 00:24:52,-3,46,49
288,VIR,PBCN,0 days 00:24:30,2,50,48
288,VIR,P010781,0 days 00:22:44,2,46,44
288,VIR,P003048,0 days 00:19:36,-2,41,43
288,VIR,P004554,0 days 00:13:49,2,28,26
288,VIR,P001844,0 days 00:12:22,-7,20,27
288,VIR,P008847,0 days 00:08:52,3,15,12
288,VIR,P003527,0 days 00:08:25,-6,16,22
288,VIR,P002084,0 days 00:08:21,-3,16,19
288,PAN,P012774,0 days 00:37:14,-5,70,75
288,PAN,P003842,0 days 00:34:35,-3,69,72
288,PAN,P001926,0 days 00:32:19,14,73,59
288,PAN,P007866,0 days 00:30:22,2,63,61
288,PAN,P011204,0 days 00:26:42,-5,52,57
288,PAN,P002328,0 days 00:15:26,6,33,27
288,PAN,P012712,0 days 00:09:38,0,18,18
288,PAN,P005161,0 days 00:07:10,1,15,14
288,PAN,P011221,0 days 00:05:02,5,12,7
288,PAN,P011209,0 days 00:01:32,-5,0,5
289,BER,P008967,0 days 00:26:59,-6,63,69
289,BER,P003958,0 days 00:26:58,4,69,65
289,BER,P008780,0 days 00:26:39,0,63,63
289,BER,P012720,0 days 00:25:59,-2,62,64
289,BER,P011934,0 days 00:25:01,-3,57,60
289,BER,P010791,0 days 00:13:04,-10,19,29
289,BER,P008211,0 days 00:12:24,-8,17,25
289,BER,P007550,0 days 00:11:39,-7,17,24
289,BER,P006251,0 days 00:11:17,-15,14,29
289,BER,P007025,0 days 00:10:52,-7,17,24
289,BER,P012721,0 days 00:09:08,-1,17,18
289,PAR,P007400,0 days 00:32:54,10,79,69
289,PAR,P008987,0 days 00:30:23,9,73,64
289,PAR,P009862,0 days 00:30:22,10,77,67
289,PAR,P012742,0 days 00:25:11,6,59,53
289,PAR,P012743,0 days 00:18:41,1,43,42
289,PAR,P012096,0 days 00:16:10,5,38,33
289,PAR,P003983,0 days 00:15:53,8,37,29
289,PAR,P011051,0 days 00:14:00,0,28,28
289,PAR,P000956,0 days 00:09:08,0,19,19
289,PAR,P011050,0 days 00:07:18,6,17,11
290,MCO,P005985,0 days 00:30:24,8,53,45
290,MCO,P010588,0 days 00:28:21,0,45,45
290,MCO,P011231,0 days 00:24:56,-2,45,47
290,MCO,P011226,0 days 00:24:37,-10,41,51
290,MCO,P011212,0 days 00:23:50,1,43,42
290,MCO,PLCZ,0 days 00:20:49,16,36,20
290,MCO,P009754,0 days 00:19:51,2,40,38
290,MCO,P011196,0 days 00:14:44,-4,26,30
290,MCO,P008099,0 days 00:12:28,4,16,12
290,ZAL,P002329,0 days 00:33:56,0,59,59
290,ZAL,P011218,0 days 00:32:14,-4,50,54
290,ZAL,P012715,0 days 00:25:01,-2,45,47
290,ZAL,P007513,0 days 00:24:33,0,39,39
290,ZAL,P010390,0 days 00:22:51,5,37,32
290,ZAL,P012787,0 days 00:18:31,-7,29,36
290,ZAL,P003210,0 days 00:14:22,6,28,22
290,ZAL,P002676,0 days 00:10:40,-3,18,21
290,ZAL,P007109,0 days 00:08:00,-1,16,17
290,ZAL,P003211,0 days 00:06:40,-4,7,11
290,ZAL,P005504,0 days 00:02:42,-5,2,7
290,ZAL,P006860,0 days 00:00:30,0,0,0
291,RED,P009035,0 days 00:34:15,-1,76,77
291,RED,P005099,0 days 00:29:31,-5,62,67
291,RED,P000848,0 days 00:29:13,-5,62,67
291,RED,P006436,0 days 00:29:12,13,76,63
291,RED,PJDR,0 days 00:24:30,2,56,54
291,RED,P011964,0 days 00:17:45,2,36,34
291,RED,P002553,0 days 00:14:56,-2,32,34
291,RED,P012044,0 days 00:06:46,-2,14,16
291,RED,P007960,0 days 00:06:34,-5,11,16
291,RED,PLUO,0 days 00:04:51,-8,2,10
291,RED,P011941,0 days 00:02:27,-4,3,7
291,OLY,P008855,0 days 00:31:40,-3,66,69
291,OLY,P001255,0 days 00:30:00,9,70,61
291,OLY,P008811,0 days 00:22:13,2,47,45
291,OLY,P007982,0 days 00:17:23,9,49,40
291,OLY,P012878,0 days 00:16:34,0,38,38
291,OLY,P008829,0 days 00:16:21,7,37,30
291,OLY,P010612,0 days 00:14:51,4,31,27
291,OLY,P010392,0 days 00:12:45,2,26,24
291,OLY,P011965,0 days 00:12:28,1,31,30
291,OLY,P007853,0 days 00:10:07,-6,19,25
291,OLY,P006589,0 days 00:10:00,-6,19,25
291,OLY,P011983,0 days 00:05:38,-4,12,16
292,BAR,P002939,0 days 00:28:20,15,65,50
292,BAR,P000925,0 days 00:26:22,13,62,49
292,BAR,P006435,0 days 00:26:22,24,71,47
292,BAR,P004866,0 days 00:25:48,5,54,49
292,BAR,P012745,0 days 00:21:04,-5,49,54
292,BAR,P003478,0 days 00:20:58,-4,48,52
292,BAR,P011244,0 days 00:18:25,9,43,34
292,BAR,PLFW,0 days 00:13:52,-18,30,48
292,BAR,P003196,0 days 00:11:17,-14,25,39
292,BAR,P007519,0 days 00:05:11,-14,8,22
292,BAR,P010641,0 days 00:02:21,4,5,1
292,TEL,P009783,0 days 00:30:10,-11,59,70
292,TEL,P009863,0 days 00:29:01,-11,58,69
292,TEL,P009622,0 days 00:23:41,-24,36,60
292,TEL,P011199,0 days 00:22:47,-26,34,60
292,TEL,P011193,0 days 00:19:07,21,60,39
292,TEL,P011214,0 days 00:18:26,19,56,37
292,TEL,P007990,0 days 00:16:57,23,53,30
292,TEL,P012744,0 days 00:13:56,2,34,32
292,TEL,P011971,0 days 00:11:48,3,33,30
292,TEL,P011219,0 days 00:07:48,-8,16,24
292,TEL,P005145,0 days 00:06:19,-3,6,9
293,PAM,P010568,0 days 00:25:19,-13,36,49
293,PAM,P007870,0 days 00:24:09,-15,39,54
293,PAM,P012795,0 days 00:22:11,-4,42,46
293,PAM,P011982,0 days 00:21:02,-17,36,53
293,PAM,P011970,0 days 00:18:52,-12,41,53
293,PAM,P010393,0 days 00:18:38,-14,33,47
293,PAM,P003960,0 days 00:18:24,-27,24,51
293,PAM,P005356,0 days 00:16:39,-19,28,47
293,PAM,P004863,0 days 00:13:58,-8,25,33
293,PAM,P000556,0 days 00:11:43,-16,21,37
293,PAM,P012740,0 days 00:09:05,0,20,20
293,ASV,P005094,0 days 00:29:08,34,80,46
293,ASV,P011225,0 days 00:26:39,23,72,49
293,ASV,PKIR,0 days 00:22:20,24,59,35
293,ASV,P004194,0 days 00:22:11,17,55,38
293,ASV,P006568,0 days 00:20:56,9,43,34
293,ASV,P000229,0 days 00:20:01,3,46,43
293,ASV,P002100,0 days 00:19:59,26,52,26
293,ASV,P003526,0 days 00:18:13,3,39,36
293,ASV,P011386,0 days 00:18:01,8,40,32
293,ASV,P012731,0 days 00:02:32,-2,4,6
294,MIL,P007831,0 days 00:29:43,22,70,48
294,MIL,P000796,0 days 00:27:07,26,66,40
294,MIL,P011224,0 days 00:25:13,23,63,40
294,MIL,P011205,0 days 00:24:24,-6,51,57
294,MIL,P006509,0 days 00:23:29,15,57,42
294,MIL,P009960,0 days 00:17:38,6,38,32
294,MIL,P002849,0 days 00:16:37,11,40,29
294,MIL,P007032,0 days 00:14:47,-8,27,35
294,MIL,P001518,0 days 00:09:52,-5,17,22
294,MIL,P002812,0 days 00:05:45,-2,12,14
294,MIL,P007201,0 days 00:05:25,-7,9,16
294,VIR,P006739,0 days 00:25:21,-15,43,58
294,VIR,PBCN,0 days 00:24:41,-4,49,53
294,VIR,P001133,0 days 00:23:42,-28,39,67
294,VIR,P010781,0 days 00:18:43,-10,31,41
294,VIR,P002084,0 days 00:17:27,9,36,27
294,VIR,P001844,0 days 00:16:42,-9,34,43
294,VIR,P003048,0 days 00:15:45,2,35,33
294,VIR,P003527,0 days 00:14:32,-7,25,32
294,VIR,P004007,0 days 00:13:09,-1,27,28
294,VIR,P008847,0 days 00:12:22,-5,22,27
294,VIR,P004554,0 days 00:10:44,-8,18,26
294,VIR,P005553,0 days 00:06:52,1,16,15
295,MUN,P006760,0 days 00:28:20,-1,56,57
295,MUN,P010391,0 days 00:27:49,-7,51,58
295,MUN,P011987,0 days 00:27:28,-3,50,53
295,MUN,P003583,0 days 00:26:18,0,53,53
295,MUN,P001288,0 days 00:25:19,-8,45,53
295,MUN,P008985,0 days 00:17:31,5,38,33
295,MUN,P001557,0 days 00:13:00,0,26,26
295,MUN,P007975,0 days 00:12:08,-12,20,32
295,MUN,P005460,0 days 00:09:58,-5,16,21
295,MUN,P006543,0 days 00:08:24,-2,14,16
295,MUN,P007639,0 days 00:03:45,-2,6,8
295,PAN,P012774,0 days 00:29:14,1,55,54
295,PAN,P003842,0 days 00:26:50,10,60,50
295,PAN,P012712,0 days 00:25:57,15,65,50
295,PAN,P011204,0 days 00:25:24,6,53,47
295,PAN,P005161,0 days 00:23:11,2,50,48
295,PAN,P001926,0 days 00:21:35,1,41,40
295,PAN,P007866,0 days 00:16:57,-8,23,31
295,PAN,P002328,0 days 00:15:21,1,28,27
295,PAN,P011221,0 days 00:10:16,-3,16,19
295,PAN,P007947,0 days 00:05:15,10,19,9
296,ULK,P006661,0 days 00:28:43,6,69,63
296,ULK,P008962,0 days 00:28:43,-10,59,69
296,ULK,P001932,0 days 00:24:26,-8,43,51
296,ULK,P010560,0 days 00:20:40,5,42,37
296,ULK,P004004,0 days 00:19:23,0,45,45
296,ULK,P006961,0 days 00:17:57,-4,33,37
296,ULK,P005844,0 days 00:16:56,3,41,38
296,ULK,P011157,0 days 00:16:15,-1,34,35
296,ULK,P011980,0 days 00:11:17,8,21,13
296,ULK,P009849,0 days 00:08:54,-6,8,14
296,ULK,P002968,0 days 00:06:46,-3,5,8
296,IST,P004888,0 days 00:32:54,9,74,65
296,IST,P007200,0 days 00:31:27,9,71,62
296,IST,P006590,0 days 00:21:25,-3,48,51
296,IST,P012710,0 days 00:20:30,7,40,33
296,IST,P009846,0 days 00:19:30,-5,42,47
296,IST,PLHK,0 days 00:17:28,9,34,25
296,IST,P009513,0 days 00:16:33,12,34,22
296,IST,P012788,0 days 00:12:55,2,37,35
296,IST,P011078,0 days 00:09:47,-11,11,22
296,IST,P011981,0 days 00:09:37,-9,11,20
296,IST,P009664,0 days 00:07:54,-10,8,18
297,MAD,P005928,0 days 00:26:22,10,70,60
297,MAD,P010357,0 days 00:25:30,11,68,57
297,MAD,P003108,0 days 00:23:43,2,55,53
297,MAD,P006540,0 days 00:21:55,-6,54,60
297,MAD,P009005,0 days 00:19:39,-16,36,52
297,MAD,P005791,0 days 00:19:20,3,44,41
297,MAD,P001392,0 days 00:17:21,2,37,35
297,MAD,PTGB,0 days 00:17:01,-6,36,42
297,MAD,P004887,0 days 00:15:31,-6,34,40
297,MAD,PCVM,0 days 00:13:38,-14,21,35
297,BAS,P012201,0 days 00:35:07,8,79,71
297,BAS,P007230,0 days 00:33:09,7,86,79
297,BAS,P009048,0 days 00:31:10,6,76,70
297,BAS,P011948,0 days 00:29:48,17,76,59
297,BAS,P010444,0 days 00:27:41,19,73,54
297,BAS,P011085,0 days 00:11:43,-5,28,33
297,BAS,P003198,0 days 00:10:00,-10,17,27
297,BAS,P012765,0 days 00:08:50,-2,19,21
297,BAS,P004603,0 days 00:08:29,-15,14,29
297,BAS,P004761,0 days 00:04:03,-5,7,12
298,IST,P012710,0 days 00:21:45,20,51,31
298,IST,P009846,0 days 00:21:25,32,63,31
298,IST,P009513,0 days 00:21:14,11,43,32
298,IST,P004888,0 days 00:20:14,16,42,26
298,IST,P007200,0 days 00:19:36,13,45,32
298,IST,P012788,0 days 00:19:01,27,55,28
298,IST,P009664,0 days 00:18:15,25,49,24
298,IST,P011078,0 days 00:16:31,29,50,21
298,IST,PLHK,0 days 00:14:52,8,26,18
298,IST,P006590,0 days 00:12:30,26,38,12
298,IST,P006372,0 days 00:08:33,8,19,11
298,IST,P011981,0 days 00:06:04,10,19,9
298,RED,P006436,0 days 00:25:34,-12,44,56
298,RED,P002553,0 days 00:23:44,-23,33,56
298,RED,P012044,0 days 00:21:42,-32,24,56
298,RED,P009035,0 days 00:21:32,-24,31,55
298,RED,P000848,0 days 00:19:17,-14,30,44
298,RED,P005099,0 days 00:18:34,-15,31,46
298,RED,PJDR,0 days 00:13:22,-19,19,38
298,RED,P008966,0 days 00:12:40,-6,18,24
298,RED,P011964,0 days 00:11:54,-18,13,31
298,RED,PLUO,0 days 00:10:59,-26,6,32
298,RED,P012801,0 days 00:10:32,-17,11,28
298,RED,P005836,0 days 00:10:10,-19,15,34
299,MCO,P005985,0 days 00:30:09,5,73,68
299,MCO,P011226,0 days 00:25:53,2,60,58
299,MCO,P009754,0 days 00:24:59,-5,51,56
299,MCO,PLCZ,0 days 00:21:27,1,46,45
299,MCO,P010588,0 days 00:20:32,9,57,48
299,MCO,P011231,0 days 00:19:06,-5,35,40
299,MCO,P011212,0 days 00:15:57,-3,27,30
299,MCO,P011196,0 days 00:14:54,0,27,27
299,MCO,P004197,0 days 00:11:55,5,32,27
299,MCO,P004790,0 days 00:07:47,5,14,9
299,MCO,P012709,0 days 00:06:01,4,16,12
299,MCO,P002581,0 days 00:01:20,2,7,5
299,MUN,P011987,0 days 00:32:13,7,79,72
299,MUN,P001288,0 days 00:26:20,4,68,64
299,MUN,P007056,0 days 00:25:26,-5,54,59
299,MUN,P006760,0 days 00:21:29,3,44,41
299,MUN,P007975,0 days 00:19:39,10,48,38
299,MUN,P010391,0 days 00:19:35,-9,33,42
299,MUN,P008985,0 days 00:17:59,-8,32,40
299,MUN,P005478,0 days 00:13:51,-2,29,31
299,MUN,P007639,0 days 00:12:04,-4,27,31
299,MUN,P001557,0 days 00:08:35,-13,6,19
299,MUN,P006543,0 days 00:02:49,-3,5,8
300,TEL,P009863,0 days 00:25:54,7,63,56
300,TEL,P009622,0 days 00:23:09,0,50,50
300,TEL,P009783,0 days 00:20:05,10,56,46
300,TEL,P011199,0 days 00:19:21,7,48,41
300,TEL,P011193,0 days 00:18:12,5,44,39
300,TEL,P011219,0 days 00:16:01,-3,36,39
300,TEL,P011214,0 days 00:15:46,-2,27,29
300,TEL,P011971,0 days 00:15:06,5,35,30
300,TEL,P012095,0 days 00:13:26,0,29,29
300,TEL,P004233,0 days 00:12:55,-5,24,29
300,TEL,P005145,0 days 00:11:00,8,33,25
300,TEL,P012744,0 days 00:09:05,-2,15,17
300,MIL,P011224,0 days 00:24:48,2,56,54
300,MIL,P007831,0 days 00:24:34,-1,58,59
300,MIL,P000796,0 days 00:22:12,-6,52,58
300,MIL,P009960,0 days 00:21:09,-3,42,45
300,MIL,P006509,0 days 00:19:25,-9,47,56
300,MIL,P007201,0 days 00:16:45,-3,34,37
300,MIL,P007032,0 days 00:15:26,-5,28,33
300,MIL,P002812,0 days 00:13:41,1,30,29
300,MIL,P001518,0 days 00:13:31,-2,23,25
300,MIL,P006701,0 days 00:13:01,2,25,23
300,MIL,P002849,0 days 00:12:44,-9,28,37
300,MIL,P005670,0 days 00:02:44,3,7,4
301,PAN,P012774,0 days 00:31:16,4,64,60
301,PAN,P002328,0 days 00:30:59,12,63,51
301,PAN,P001926,0 days 00:29:43,18,69,51
301,PAN,P003842,0 days 00:24:08,0,52,52
301,PAN,P012712,0 days 00:21:28,8,45,37
301,PAN,P007866,0 days 00:18:33,1,39,38
301,PAN,P011221,0 days 00:11:54,14,27,13
301,PAN,P011204,0 days 00:11:01,-7,21,28
301,PAN,P007947,0 days 00:09:46,-3,19,22
301,PAN,P005161,0 days 00:05:31,2,13,11
301,PAN,P007553,0 days 00:03:58,-5,5,10
301,PAN,P011209,0 days 00:01:43,1,3,2
301,BER,P012720,0 days 00:28:35,-16,45,61
301,BER,P008967,0 days 00:26:22,-1,50,51
301,BER,P010791,0 days 00:21:59,-10,34,44
301,BER,P007550,0 days 00:20:17,-20,35,55
301,BER,P006251,0 days 00:19:38,0,36,36
301,BER,P006919,0 days 00:17:30,-6,32,38
301,BER,P012721,0 days 00:17:10,-7,33,40
301,BER,P011934,0 days 00:14:37,1,33,32
301,BER,P008211,0 days 00:14:35,6,30,24
301,BER,P008780,0 days 00:12:59,4,26,22
301,BER,P006819,0 days 00:03:24,0,8,8
301,BER,P011631,0 days 00:02:54,4,13,9
302,ZAL,P002329,0 days 00:33:49,-1,56,57
302,ZAL,P011218,0 days 00:29:01,-3,42,45
302,ZAL,P007513,0 days 00:27:09,3,44,41
302,ZAL,P012715,0 days 00:23:07,5,42,37
302,ZAL,P010390,0 days 00:20:14,5,35,30
302,ZAL,P007109,0 days 00:16:56,-12,16,28
302,ZAL,P012787,0 days 00:13:45,0,23,23
302,ZAL,P005504,0 days 00:11:58,-2,21,23
302,ZAL,P003210,0 days 00:10:04,-4,15,19
302,ZAL,P010184,0 days 00:09:12,1,10,9
302,ZAL,P006860,0 days 00:04:45,-2,6,8
302,MAD,P003108,0 days 00:25:23,0,42,42
302,MAD,P006540,0 days 00:23:18,8,34,26
302,MAD,PTGB,0 days 00:21:39,5,34,29
302,MAD,P005791,0 days 00:20:57,6,32,26
302,MAD,P009005,0 days 00:20:48,3,32,29
302,MAD,P010623,0 days 00:19:58,-6,32,38
302,MAD,P010357,0 days 00:19:12,-1,32,33
302,MAD,P004887,0 days 00:19:03,-4,32,36
302,MAD,P003733,0 days 00:14:54,-1,22,23
302,MAD,P001392,0 days 00:14:48,0,28,28
303,VIR,P001844,0 days 00:25:31,-6,58,64
303,VIR,P010781,0 days 00:25:07,8,64,56
303,VIR,P001133,0 days 00:22:23,-6,45,51
303,VIR,PBCN,0 days 00:18:13,-11,36,47
303,VIR,P002084,0 days 00:17:37,2,46,44
303,VIR,P003048,0 days 00:15:28,7,37,30
303,VIR,P006739,0 days 00:14:16,2,31,29
303,VIR,P003527,0 days 00:13:31,11,34,23
303,VIR,P008847,0 days 00:12:36,-1,27,28
303,VIR,P004554,0 days 00:11:56,-10,27,37
303,VIR,P009549,0 days 00:11:46,1,26,25
303,VIR,P004007,0 days 00:11:36,-17,24,41
303,BAS,P004761,0 days 00:35:48,6,87,81
303,BAS,P009048,0 days 00:33:48,7,80,73
303,BAS,P011948,0 days 00:32:04,8,78,70
303,BAS,P010444,0 days 00:25:31,13,67,54
303,BAS,P012201,0 days 00:23:22,-12,48,60
303,BAS,P007230,0 days 00:20:24,16,56,40
303,BAS,P004603,0 days 00:14:29,-9,28,37
303,BAS,P008850,0 days 00:06:46,-4,14,18
303,BAS,P012765,0 days 00:04:05,-3,9,12
303,BAS,P007946,0 days 00:02:07,0,6,6
303,BAS,P011085,0 days 00:01:36,-2,2,4
304,ASV,P011225,0 days 00:26:12,-4,51,55
304,ASV,P012080,0 days 00:25:39,2,50,48
304,ASV,P002100,0 days 00:23:54,-1,46,47
304,ASV,P012731,0 days 00:22:09,3,44,41
304,ASV,P006568,0 days 00:20:33,-5,34,39
304,ASV,P005094,0 days 00:20:21,-2,35,37
304,ASV,P004194,0 days 00:16:58,12,39,27
304,ASV,P000229,0 days 00:15:03,7,30,23
304,ASV,P003526,0 days 00:14:21,2,26,24
304,ASV,P011386,0 days 00:13:48,8,25,17
304,ASV,PKIR,0 days 00:01:02,-2,0,2
304,BAR,PLFW,0 days 00:24:36,3,44,41
304,BAR,P010641,0 days 00:23:46,-9,38,47
304,BAR,P012745,0 days 00:20:10,-5,36,41
304,BAR,P003478,0 days 00:18:59,4,36,32
304,BAR,P007519,0 days 00:18:02,-6,31,37
304,BAR,P000925,0 days 00:16:12,5,34,29
304,BAR,P007464,0 days 00:15:46,-14,25,39
304,BAR,P009992,0 days 00:14:54,-3,28,31
304,BAR,P011244,0 days 00:13:43,5,24,19
304,BAR,P003204,0 days 00:12:22,2,24,22
304,BAR,P002939,0 days 00:11:37,-7,19,26
304,BAR,P004866,0 days 00:09:53,5,21,16
305,OLY,P008855,0 days 00:31:06,0,59,59
305,OLY,P008811,0 days 00:30:45,4,61,57
305,OLY,P010612,0 days 00:27:16,1,54,53
305,OLY,P001255,0 days 00:26:18,-7,44,51
305,OLY,P007853,0 days 00:25:00,6,50,44
305,OLY,P006589,0 days 00:20:39,9,42,33
305,OLY,P007982,0 days 00:20:32,4,38,34
305,OLY,P008829,0 days 00:18:23,-10,26,36
305,OLY,P010392,0 days 00:11:13,9,25,16
305,OLY,P012878,0 days 00:09:21,1,14,13
305,OLY,P003941,0 days 00:04:27,-2,7,9
305,ULK,P008962,0 days 00:31:02,5,60,55
305,ULK,P001932,0 days 00:30:04,0,55,55
305,ULK,P006661,0 days 00:25:29,-17,41,58
305,ULK,P005844,0 days 00:22:18,-10,37,47
305,ULK,P002968,0 days 00:21:51,5,38,33
305,ULK,P010560,0 days 00:19:47,3,35,32
305,ULK,P009849,0 days 00:18:12,13,37,24
305,ULK,P004004,0 days 00:17:31,0,37,37
305,ULK,P006961,0 days 00:16:51,-5,31,36
305,ULK,P006068,0 days 00:13:58,-8,21,29
305,ULK,P011052,0 days 00:07:12,-2,10,12
305,ULK,P011980,0 days 00:00:45,1,3,2
306,PAR,P009862,0 days 00:30:59,13,64,51
306,PAR,P011192,0 days 00:30:00,19,64,45
306,PAR,P007400,0 days 00:25:34,7,52,45
306,PAR,P004172,0 days 00:24:37,10,52,42
306,PAR,P008987,0 days 00:23:50,-3,39,42
306,PAR,P003983,0 days 00:19:49,6,37,31
306,PAR,P012743,0 days 00:18:37,9,38,29
306,PAR,P012096,0 days 00:17:05,9,33,24
306,PAR,P000956,0 days 00:06:19,-2,10,12
306,PAR,P011051,0 days 00:03:10,-3,6,9
306,PAM,P000556,0 days 00:19:54,-2,37,39
306,PAM,P010393,0 days 00:19:03,-13,25,38
306,PAM,P011970,0 days 00:18:16,5,37,32
306,PAM,P010568,0 days 00:17:26,-10,27,37
306,PAM,P006643,0 days 00:16:51,-13,24,37
306,PAM,P005356,0 days 00:16:48,-8,25,33
306,PAM,P011982,0 days 00:16:43,2,32,30
306,PAM,P012795,0 days 00:16:39,0,30,30
306,PAM,P010750,0 days 00:16:32,-1,28,29
306,PAM,P012738,0 days 00:15:43,-12,23,35
306,PAM,P007870,0 days 00:15:07,-1,27,28
306,PAM,P012740,0 days 00:10:58,-12,15,27
307,TEL,P009863,0 days 00:30:43,23,90,67
307,TEL,P009622,0 days 00:29:41,32,87,55
307,TEL,P011199,0 days 00:24:59,21,75,54
307,TEL,P009783,0 days 00:24:55,21,73,52
307,TEL,P011971,0 days 00:20:23,7,57,50
307,TEL,P011193,0 days 00:20:12,10,59,49
307,TEL,P012744,0 days 00:18:01,13,52,39
307,TEL,P011214,0 days 00:15:02,7,38,31
307,TEL,P005145,0 days 00:14:09,7,32,25
307,TEL,P012095,0 days 00:01:55,-1,2,3
307,BAS,P007230,0 days 00:34:01,-23,69,92
307,BAS,P009048,0 days 00:31:17,-15,70,85
307,BAS,P011948,0 days 00:27:38,-20,65,85
307,BAS,P004603,0 days 00:25:40,-11,56,67
307,BAS,P004761,0 days 00:19:57,-31,32,63
307,BAS,P011085,0 days 00:16:34,-8,38,46
307,BAS,P010444,0 days 00:14:20,-17,29,46
307,BAS,P012201,0 days 00:08:34,-8,15,23
307,BAS,P007946,0 days 00:07:57,1,22,21
307,BAS,P012765,0 days 00:06:46,-7,12,19
307,BAS,P003198,0 days 00:06:30,-3,15,18
307,BAS,P008850,0 days 00:00:46,2,2,0
308,IST,P007200,0 days 00:30:12,0,53,53
308,IST,P004888,0 days 00:29:03,5,52,47
308,IST,PLHK,0 days 00:25:10,2,47,45
308,IST,P006590,0 days 00:21:18,-6,26,32
308,IST,P011981,0 days 00:16:59,-8,25,33
308,IST,P009513,0 days 00:15:55,3,32,29
308,IST,P009846,0 days 00:14:52,-6,19,25
308,IST,P011078,0 days 00:12:35,-3,17,20
308,IST,P009664,0 days 00:12:30,0,16,16
308,IST,P012710,0 days 00:11:27,2,25,23
308,IST,P012788,0 days 00:09:59,-4,8,12
308,VIR,P010781,0 days 00:31:01,15,53,38
308,VIR,P001844,0 days 00:25:00,-14,38,52
308,VIR,P003527,0 days 00:23:31,10,38,28
308,VIR,P001133,0 days 00:22:08,-4,38,42
308,VIR,P003048,0 days 00:20:01,2,39,37
308,VIR,PBCN,0 days 00:19:12,-1,35,36
308,VIR,P002084,0 days 00:17:17,-4,23,27
308,VIR,P006739,0 days 00:16:33,9,32,23
308,VIR,P004554,0 days 00:12:30,5,23,18
308,VIR,P009549,0 days 00:07:26,-4,11,15
308,VIR,P008847,0 days 00:05:21,1,5,4
309,BAS,P007230,0 days 00:35:45,14,81,67
309,BAS,P009048,0 days 00:35:20,11,81,70
309,BAS,P011948,0 days 00:24:51,20,66,46
309,BAS,P004761,0 days 00:23:05,-6,49,55
309,BAS,P010444,0 days 00:23:04,-1,46,47
309,BAS,P011085,0 days 00:21:46,15,48,33
309,BAS,P004603,0 days 00:17:26,16,46,30
309,BAS,P008850,0 days 00:10:18,-5,15,20
309,BAS,P012765,0 days 00:04:40,1,8,7
309,BAS,P003198,0 days 00:03:45,-5,5,10
309,VIR,P001844,0 days 00:23:42,-15,38,53
309,VIR,P009549,0 days 00:23:35,-13,41,54
309,VIR,P001133,0 days 00:22:41,-17,37,54
309,VIR,P003527,0 days 00:21:05,5,46,41
309,VIR,P010781,0 days 00:20:13,1,45,44
309,VIR,PBCN,0 days 00:19:59,-5,40,45
309,VIR,P006739,0 days 00:17:03,-4,33,37
309,VIR,P002084,0 days 00:16:04,3,35,32
309,VIR,P003048,0 days 00:12:52,-11,21,32
309,VIR,P004554,0 days 00:11:46,0,28,28
309,VIR,P008847,0 days 00:10:31,-3,20,23
309,VIR,P004007,0 days 00:00:29,-1,1,2
310,MAD,P010357,0 days 00:28:08,13,70,57
310,MAD,P009005,0 days 00:21:52,9,42,33
310,MAD,P004887,0 days 00:21:08,-4,40,44
310,MAD,PCVM,0 days 00:19:40,-2,41,43
310,MAD,P005791,0 days 00:18:36,20,50,30
310,MAD,P005928,0 days 00:18:15,19,46,27
310,MAD,P006540,0 days 00:17:21,21,47,26
310,MAD,PTGB,0 days 00:16:16,5,33,28
310,MAD,P003108,0 days 00:14:18,8,32,24
310,MAD,P003733,0 days 00:13:08,-5,24,29
310,MAD,PBMT,0 days 00:11:13,-2,25,27
310,MAD,P001392,0 days 00:00:05,-2,0,2
310,BAS,P004761,0 days 00:28:20,-6,55,61
310,BAS,P009048,0 days 00:27:34,-10,53,63
310,BAS,P010444,0 days 00:26:16,-12,52,64
310,BAS,P007230,0 days 00:26:14,-10,51,61
310,BAS,P011085,0 days 00:22:32,-11,46,57
310,BAS,P011948,0 days 00:18:41,-20,28,48
310,BAS,P012765,0 days 00:15:19,-4,26,30
310,BAS,P003198,0 days 00:13:46,-6,23,29
310,BAS,P004603,0 days 00:13:44,-4,22,26
310,BAS,P008850,0 days 00:07:34,3,14,11
311,BAR,P012745,0 days 00:28:20,-4,49,53
311,BAR,P006435,0 days 00:25:34,0,43,43
311,BAR,P004866,0 days 00:22:25,-2,36,38
311,BAR,P002939,0 days 00:21:54,-5,29,34
311,BAR,P000925,0 days 00:20:38,-9,32,41
311,BAR,P003196,0 days 00:19:22,7,43,36
311,BAR,PLFW,0 days 00:18:06,3,46,43
311,BAR,P003478,0 days 00:18:01,0,39,39
311,BAR,P007519,0 days 00:14:00,-2,32,34
311,BAR,P011244,0 days 00:11:40,2,26,24
311,OLY,P010612,0 days 00:31:25,8,63,55
311,OLY,P007982,0 days 00:25:23,-10,53,63
311,OLY,P007853,0 days 00:21:49,-6,35,41
311,OLY,P008811,0 days 00:21:30,6,41,35
311,OLY,P008855,0 days 00:18:26,6,31,25
311,OLY,P006589,0 days 00:17:25,4,31,27
311,OLY,P008829,0 days 00:16:03,5,29,24
311,OLY,P011194,0 days 00:15:38,1,32,31
311,OLY,P012878,0 days 00:12:40,0,24,24
311,OLY,P011983,0 days 00:07:53,-8,17,25
311,OLY,P010392,0 days 00:06:42,7,19,12
311,OLY,P003941,0 days 00:05:06,-3,10,13
312,MCO,P005985,0 days 00:40:07,-7,79,86
312,MCO,P011231,0 days 00:35:41,4,72,68
312,MCO,P010588,0 days 00:31:34,-4,66,70
312,MCO,P011212,0 days 00:31:00,-4,62,66
312,MCO,P011226,0 days 00:27:47,-8,52,60
312,MCO,P009754,0 days 00:24:58,-7,53,60
312,MCO,PLCZ,0 days 00:21:43,6,50,44
312,MCO,P011196,0 days 00:07:44,-1,13,14
312,MCO,P008099,0 days 00:04:15,1,8,7
312,MCO,P004790,0 days 00:00:11,0,0,0
312,ULK,P008962,0 days 00:38:13,5,79,74
312,ULK,P001932,0 days 00:32:14,1,66,65
312,ULK,P011980,0 days 00:31:13,18,75,57
312,ULK,P009849,0 days 00:31:02,6,71,65
312,ULK,P004004,0 days 00:29:25,21,66,45
312,ULK,P006961,0 days 00:14:29,-8,31,39
312,ULK,P006661,0 days 00:12:39,-4,22,26
312,ULK,P010560,0 days 00:10:50,-3,20,23
312,ULK,P005844,0 days 00:09:10,-6,16,22
312,ULK,P002968,0 days 00:06:53,-6,13,19
312,ULK,P011052,0 days 00:04:36,-1,9,10
312,ULK,P006068,0 days 00:04:16,-3,7,10
313,PAN,P003842,0 days 00:33:59,-7,73,80
313,PAN,P001926,0 days 00:32:18,-16,65,81
313,PAN,P011204,0 days 00:25:14,11,55,44
313,PAN,P002328,0 days 00:24:27,-1,55,56
313,PAN,P007866,0 days 00:21:00,-13,46,59
313,PAN,P012774,0 days 00:20:51,-9,46,55
313,PAN,P012712,0 days 00:20:39,9,43,34
313,PAN,P007947,0 days 00:09:58,6,27,21
313,PAN,P011209,0 days 00:04:33,-4,9,13
313,PAN,P011221,0 days 00:04:17,3,12,9
313,PAN,P005161,0 days 00:02:44,1,4,3
313,TEL,P009622,0 days 00:33:52,-3,72,75
313,TEL,P009783,0 days 00:31:25,-2,67,69
313,TEL,P009863,0 days 00:25:55,-4,58,62
313,TEL,P011199,0 days 00:23:01,-9,48,57
313,TEL,P011193,0 days 00:21:49,8,52,44
313,TEL,P012744,0 days 00:17:19,17,49,32
313,TEL,P011214,0 days 00:15:19,13,42,29
313,TEL,P005145,0 days 00:12:44,-1,30,31
313,TEL,P011971,0 days 00:10:55,5,24,19
313,TEL,P011219,0 days 00:04:24,3,10,7
313,TEL,P007990,0 days 00:03:17,-7,3,10
314,MAD,P003108,0 days 00:27:19,10,67,57
314,MAD,P005928,0 days 00:26:55,2,65,63
314,MAD,P010357,0 days 00:24:36,18,67,49
314,MAD,P005791,0 days 00:21:05,12,57,45
314,MAD,P004887,0 days 00:18:54,-1,44,45
314,MAD,P006540,0 days 00:17:25,-4,37,41
314,MAD,PTGB,0 days 00:17:07,27,54,27
314,MAD,PCVM,0 days 00:16:39,4,44,40
314,MAD,P009005,0 days 00:16:27,0,42,42
314,MAD,PBMT,0 days 00:13:33,-13,28,41
314,BAS,P009048,0 days 00:34:29,-13,77,90
314,BAS,P004761,0 days 00:32:42,5,82,77
314,BAS,P007230,0 days 00:31:13,-16,64,80
314,BAS,P010444,0 days 00:21:22,2,54,52
314,BAS,P004603,0 days 00:18:38,-13,36,49
314,BAS,P011948,0 days 00:16:25,-20,30,50
314,BAS,P011085,0 days 00:13:35,9,37,28
314,BAS,P008850,0 days 00:11:20,-14,21,35
314,BAS,P003198,0 days 00:10:42,6,30,24
314,BAS,P012765,0 days 00:08:06,4,19,15
314,BAS,P007946,0 days 00:01:28,-5,0,5
315,BAR,P012745,0 days 00:32:08,10,65,55
315,BAR,P004866,0 days 00:22:54,6,47,41
315,BAR,P000925,0 days 00:22:37,2,40,38
315,BAR,P002939,0 days 00:22:16,7,48,41
315,BAR,PLFW,0 days 00:20:06,-3,30,33
315,BAR,P007519,0 days 00:19:07,14,40,26
315,BAR,P006435,0 days 00:18:46,-7,36,43
315,BAR,P003196,0 days 00:17:23,6,37,31
315,BAR,P003478,0 days 00:16:51,7,30,23
315,BAR,P011244,0 days 00:07:52,-2,12,14
315,OLY,P008855,0 days 00:31:13,-8,51,59
315,OLY,P008829,0 days 00:29:26,-15,46,61
315,OLY,P008811,0 days 00:20:33,-10,33,43
315,OLY,P011194,0 days 00:20:00,2,35,33
315,OLY,P007982,0 days 00:19:37,2,37,35
315,OLY,P007853,0 days 00:18:43,-3,31,34
315,OLY,P010612,0 days 00:17:48,-12,28,40
315,OLY,P006589,0 days 00:16:22,-2,32,34
315,OLY,P012878,0 days 00:11:37,5,25,20
315,OLY,P003941,0 days 00:07:50,-3,11,14
315,OLY,P010392,0 days 00:06:51,4,16,12
316,MCO,P011212,0 days 00:28:19,8,62,54
316,MCO,P005985,0 days 00:28:08,8,72,64
316,MCO,P011231,0 days 00:26:02,-5,50,55
316,MCO,P009754,0 days 00:24:34,18,59,41
316,MCO,P010588,0 days 00:23:29,0,59,59
316,MCO,P011226,0 days 00:19:56,-11,41,52
316,MCO,PLCZ,0 days 00:19:44,8,54,46
316,MCO,P002581,0 days 00:12:40,4,22,18
316,MCO,P008099,0 days 00:11:41,-3,31,34
316,MCO,P011196,0 days 00:05:27,-2,15,17
316,ULK,P008962,0 days 00:29:09,-5,67,72
316,ULK,P009849,0 days 00:27:11,-16,60,76
316,ULK,P006661,0 days 00:25:07,-1,57,58
316,ULK,P005844,0 days 00:25:00,0,58,58
316,ULK,P001932,0 days 00:24:36,-5,55,60
316,ULK,P011980,0 days 00:20:34,-2,40,42
316,ULK,P004004,0 days 00:19:11,4,41,37
316,ULK,P010560,0 days 00:15:08,1,29,28
316,ULK,P006961,0 days 00:10:18,5,28,23
316,ULK,P002968,0 days 00:03:46,-6,5,11
317,PAN,P007866,0 days 00:34:33,12,81,69
317,PAN,P003842,0 days 00:31:56,23,81,58
317,PAN,P001926,0 days 00:29:23,25,74,49
317,PAN,P005161,0 days 00:27:52,23,74,51
317,PAN,P012774,0 days 00:25:54,8,62,54
317,PAN,P002328,0 days 00:17:41,-6,34,40
317,PAN,P011204,0 days 00:14:42,5,36,31
317,PAN,P011221,0 days 00:07:55,-5,14,19
317,PAN,P007947,0 days 00:07:24,-6,14,20
317,PAN,P011209,0 days 00:02:20,1,5,4
317,PAN,P008084,0 days 00:00:20,0,0,0
317,TEL,P009783,0 days 00:35:10,-12,71,83
317,TEL,P009622,0 days 00:29:09,-22,51,73
317,TEL,P011193,0 days 00:24:31,-9,52,61
317,TEL,P011214,0 days 00:19:48,5,44,39
317,TEL,P011199,0 days 00:19:19,-15,35,50
317,TEL,P012744,0 days 00:18:43,7,43,36
317,TEL,P011971,0 days 00:18:00,-8,38,46
317,TEL,P007990,0 days 00:16:38,-8,28,36
317,TEL,P005145,0 days 00:11:08,-5,22,27
317,TEL,P011219,0 days 00:07:34,-13,11,24
318,BAS,P009048,0 days 00:35:59,1,88,87
318,BAS,P011085,0 days 00:29:04,5,68,63
318,BAS,P010444,0 days 00:27:37,-7,65,72
318,BAS,P004761,0 days 00:26:38,-4,69,73
318,BAS,P011948,0 days 00:24:18,-9,59,68
318,BAS,P007230,0 days 00:19:12,-15,39,54
318,BAS,P003198,0 days 00:16:59,7,44,37
318,BAS,P004603,0 days 00:12:23,3,33,30
318,BAS,P012765,0 days 00:04:01,-5,10,15
318,BAS,P008850,0 days 00:03:49,4,15,11
318,MAD,P003108,0 days 00:31:02,-3,75,78
318,MAD,P010357,0 days 00:30:56,9,78,69
318,MAD,P005791,0 days 00:30:31,10,76,66
318,MAD,P005928,0 days 00:26:59,-4,59,63
318,MAD,P009005,0 days 00:21:55,5,59,54
318,MAD,PTGB,0 days 00:17:28,2,47,45
318,MAD,PCVM,0 days 00:13:05,12,45,33
318,MAD,P006540,0 days 00:12:16,-7,24,31
318,MAD,P004887,0 days 00:08:57,-8,24,32
318,MAD,PBMT,0 days 00:06:51,4,23,19
319,OLY,P008855,0 days 00:36:07,-7,61,68
319,OLY,P007982,0 days 00:29:52,1,56,55
319,OLY,P011194,0 days 00:29:52,13,62,49
319,OLY,P007853,0 days 00:26:32,7,53,46
319,OLY,P008811,0 days 00:22:48,-12,31,43
319,OLY,P012878,0 days 00:22:07,10,49,39
319,OLY,P008829,0 days 00:18:29,-9,27,36
319,OLY,P010612,0 days 00:17:01,-5,24,29
319,OLY,P010392,0 days 00:17:00,-4,33,37
319,OLY,P006589,0 days 00:05:12,-4,4,8
319,BAR,P012745,0 days 00:37:54,2,68,66
319,BAR,P000925,0 days 00:31:03,1,57,56
319,BAR,P006435,0 days 00:29:52,4,59,55
319,BAR,P002939,0 days 00:28:11,2,53,51
319,BAR,P003478,0 days 00:24:55,3,49,46
319,BAR,P004866,0 days 00:22:55,-1,35,36
319,BAR,PLFW,0 days 00:16:40,0,29,29
319,BAR,P003196,0 days 00:13:57,1,25,24
319,BAR,P007519,0 days 00:09:00,-2,14,16
319,BAR,P011244,0 days 00:07:06,0,14,14
319,BAR,P009992,0 days 00:03:27,0,7,7
320,ULK,P008962,0 days 00:32:52,4,69,65
320,ULK,P001932,0 days 00:27:41,4,57,53
320,ULK,P006661,0 days 00:23:02,1,54,53
320,ULK,P005844,0 days 00:22:21,2,47,45
320,ULK,P006961,0 days 00:19:58,15,51,36
320,ULK,P004004,0 days 00:18:05,6,41,35
320,ULK,P010560,0 days 00:17:34,5,37,32
320,ULK,P009849,0 days 00:17:00,6,38,32
320,ULK,P011980,0 days 00:10:58,11,27,16
320,ULK,P006068,0 days 00:06:54,4,18,14
320,ULK,P002968,0 days 00:03:35,-3,6,9
320,MCO,P011226,0 days 00:32:59,-15,58,73
320,MCO,P005985,0 days 00:31:58,-2,66,68
320,MCO,P011231,0 days 00:27:21,-11,54,65
320,MCO,P009754,0 days 00:25:44,-3,51,54
320,MCO,PLCZ,0 days 00:23:59,-1,48,49
320,MCO,P011212,0 days 00:17:40,-7,38,45
320,MCO,P008099,0 days 00:12:45,-6,25,31
320,MCO,P004790,0 days 00:11:33,0,20,20
320,MCO,P002581,0 days 00:10:52,-8,21,29
320,MCO,P011196,0 days 00:05:09,-2,9,11
321,TEL,P009622,0 days 00:32:20,1,70,69
321,TEL,P009783,0 days 00:30:56,-6,66,72
321,TEL,P011199,0 days 00:29:51,0,67,67
321,TEL,P012744,0 days 00:25:11,-6,52,58
321,TEL,P011193,0 days 00:18:51,-15,35,50
321,TEL,P011971,0 days 00:15:15,7,35,28
321,TEL,P011214,0 days 00:14:21,9,30,21
321,TEL,P005145,0 days 00:12:30,8,27,19
321,TEL,P007990,0 days 00:11:49,15,29,14
321,TEL,P011219,0 days 00:08:56,-3,14,17
321,PAN,P003842,0 days 00:32:39,0,70,70
321,PAN,P012774,0 days 00:32:13,1,72,71
321,PAN,P011204,0 days 00:29:40,1,65,64
321,PAN,P005161,0 days 00:28:34,9,61,52
321,PAN,P007866,0 days 00:21:00,-18,35,53
321,PAN,P001926,0 days 00:20:19,1,39,38
321,PAN,P007947,0 days 00:18:41,8,48,40
321,PAN,P002328,0 days 00:08:57,-10,12,22
321,PAN,P007553,0 days 00:06:18,-3,10,13
321,PAN,P011221,0 days 00:00:54,-2,0,2
321,PAN,P011209,0 days 00:00:45,3,3,0
323,OLY,P007853,0 days 00:27:12,36,70,34
323,OLY,P007982,0 days 00:22:44,28,54,26
323,OLY,P008829,0 days 00:22:37,0,43,43
323,OLY,P003941,0 days 00:21:47,31,60,29
323,OLY,P010612,0 days 00:20:21,1,37,36
323,OLY,P008855,0 days 00:19:43,19,48,29
323,OLY,P001255,0 days 00:19:25,8,38,30
323,OLY,P008811,0 days 00:18:13,3,32,29
323,OLY,P011194,0 days 00:17:23,34,49,15
323,OLY,P011965,0 days 00:08:46,2,21,19
323,OLY,P010392,0 days 00:01:49,8,8,0
323,BAR,P004866,0 days 00:24:33,-12,42,54
323,BAR,P011244,0 days 00:21:07,-25,20,45
323,BAR,P009992,0 days 00:19:41,-18,30,48
323,BAR,P012745,0 days 00:18:53,-9,38,47
323,BAR,P003196,0 days 00:18:45,-18,23,41
323,BAR,P000925,0 days 00:16:20,-13,27,40
323,BAR,PLFW,0 days 00:16:18,-14,30,44
323,BAR,P006435,0 days 00:16:05,-1,26,27
323,BAR,P002939,0 days 00:15:46,-13,18,31
323,BAR,P003478,0 days 00:15:28,-22,16,38
323,BAR,P007519,0 days 00:12:09,-22,12,34
323,BAR,P010641,0 days 00:04:55,-3,8,11
324,ULK,P008962,0 days 00:33:11,-3,52,55
324,ULK,P005844,0 days 00:32:32,2,53,51
324,ULK,P006661,0 days 00:25:54,-1,44,45
324,ULK,P001932,0 days 00:25:13,-8,39,47
324,ULK,P006961,0 days 00:24:30,-2,34,36
324,ULK,P004004,0 days 00:18:44,5,34,29
324,ULK,P009849,0 days 00:14:06,-2,18,20
324,ULK,P010560,0 days 00:13:08,-3,17,20
324,ULK,P011980,0 days 00:07:53,-5,10,15
324,ULK,P002968,0 days 00:04:49,2,9,7
324,MCO,P005985,0 days 00:33:09,11,62,51
324,MCO,P009754,0 days 00:27:10,2,45,43
324,MCO,P011212,0 days 00:26:15,6,43,37
324,MCO,P011226,0 days 00:25:43,0,42,42
324,MCO,P011231,0 days 00:24:21,-2,38,40
324,MCO,PLCZ,0 days 00:23:57,-5,33,38
324,MCO,P011196,0 days 00:19:39,3,30,27
324,MCO,P004197,0 days 00:14:17,3,23,20
324,MCO,P002581,0 days 00:05:29,-3,9,12
325,TEL,P009783,0 days 00:31:55,-13,66,79
325,TEL,P009622,0 days 00:30:43,-16,58,74
325,TEL,P011199,0 days 00:29:21,-7,62,69
325,TEL,P011193,0 days 00:26:43,8,63,55
325,TEL,P011214,0 days 00:18:17,6,44,38
325,TEL,P007990,0 days 00:14:11,-2,30,32
325,TEL,P012744,0 days 00:13:51,0,37,37
325,TEL,P011971,0 days 00:13:34,5,31,26
325,TEL,P005145,0 days 00:07:27,-8,16,24
325,TEL,P009863,0 days 00:07:25,-7,16,23
325,TEL,P011219,0 days 00:06:33,-1,17,18
325,PAN,P003842,0 days 00:37:37,12,90,78
325,PAN,P007866,0 days 00:37:04,6,88,82
325,PAN,P001926,0 days 00:33:57,12,87,75
325,PAN,P012774,0 days 00:32:38,12,85,73
325,PAN,P005161,0 days 00:26:40,13,69,56
325,PAN,P002328,0 days 00:14:37,-5,33,38
325,PAN,P011204,0 days 00:10:34,-10,15,25
325,PAN,P011209,0 days 00:04:43,1,6,5
325,PAN,P011221,0 days 00:02:10,-6,2,8
327,BAR,P012745,0 days 00:30:51,-7,42,49
327,BAR,P000925,0 days 00:27:37,-7,42,49
327,BAR,P002939,0 days 00:26:24,-10,38,48
327,BAR,P006435,0 days 00:25:13,6,42,36
327,BAR,P003478,0 days 00:22:40,-5,37,42
327,BAR,PLFW,0 days 00:19:53,-4,26,30
327,BAR,P004866,0 days 00:19:07,1,24,23
327,BAR,P003196,0 days 00:12:23,3,17,14
327,BAR,P011244,0 days 00:09:09,3,17,14
327,BAR,P007519,0 days 00:06:43,0,10,10
327,OLY,P001255,0 days 00:28:27,2,44,42
327,OLY,P007982,0 days 00:27:45,4,48,44
327,OLY,P003941,0 days 00:25:16,4,44,40
327,OLY,P007853,0 days 00:24:14,6,44,38
327,OLY,P008855,0 days 00:19:58,7,36,29
327,OLY,P010612,0 days 00:19:31,3,29,26
327,OLY,P011194,0 days 00:18:39,1,27,26
327,OLY,P008829,0 days 00:15:36,-3,18,21
327,OLY,P008811,0 days 00:12:18,-2,15,17
327,OLY,P010392,0 days 00:05:50,-4,6,10
327,OLY,P012878,0 days 00:02:26,2,4,2
328,MCO,P005985,0 days 00:38:22,-4,64,68
328,MCO,P011212,0 days 00:32:34,3,65,62
328,MCO,PLCZ,0 days 00:29:51,3,48,45
328,MCO,P011226,0 days 00:29:22,14,65,51
328,MCO,P010588,0 days 00:28:38,-5,45,50
328,MCO,P009754,0 days 00:24:50,-8,35,43
328,MCO,P011231,0 days 00:21:44,-2,42,44
328,MCO,P004197,0 days 00:10:30,-6,10,16
328,MCO,P011196,0 days 00:09:09,0,21,21
328,ULK,P001932,0 days 00:37:49,1,65,64
328,ULK,P008962,0 days 00:36:29,-6,63,69
328,ULK,P006661,0 days 00:34:46,9,65,56
328,ULK,P004004,0 days 00:27:37,-3,52,55
328,ULK,P005844,0 days 00:23:43,-4,37,41
328,ULK,P006961,0 days 00:19:37,0,34,34
328,ULK,P011980,0 days 00:14:48,8,33,25
328,ULK,P010560,0 days 00:12:13,2,19,17
328,ULK,P011157,0 days 00:09:56,4,16,12
328,ULK,P002968,0 days 00:04:28,0,11,11
328,ULK,P009849,0 days 00:03:34,-6,5,11
329,PAN,P012774,0 days 00:38:20,10,78,68
329,PAN,P003842,0 days 00:35:10,8,74,66
329,PAN,P005161,0 days 00:28:55,5,57,52
329,PAN,P007866,0 days 00:25:42,-3,49,52
329,PAN,P001926,0 days 00:19:38,-2,38,40
329,PAN,P012712,0 days 00:14:25,8,30,22
329,PAN,P011204,0 days 00:14:00,6,30,24
329,PAN,P011209,0 days 00:12:49,4,26,22
329,PAN,P002328,0 days 00:07:05,6,16,10
329,PAN,P011221,0 days 00:03:56,3,7,4
329,TEL,P009622,0 days 00:33:42,-7,59,66
329,TEL,P009783,0 days 00:30:46,-5,55,60
329,TEL,P011199,0 days 00:30:19,0,57,57
329,TEL,P007990,0 days 00:25:57,-1,47,48
329,TEL,P011193,0 days 00:20:15,-13,35,48
329,TEL,P005145,0 days 00:16:07,4,31,27
329,TEL,P012744,0 days 00:15:24,-10,27,37
329,TEL,P011214,0 days 00:14:33,-9,26,35
329,TEL,P011971,0 days 00:12:57,-4,23,27
330,MAD,P003108,0 days 00:33:19,2,65,63
330,MAD,P005928,0 days 00:29:55,11,65,54
330,MAD,P006540,0 days 00:26:09,13,54,41
330,MAD,P010357,0 days 00:22:44,13,54,41
330,MAD,P005791,0 days 00:22:30,10,45,35
330,MAD,P004887,0 days 00:17:30,1,42,41
330,MAD,PCVM,0 days 00:14:34,1,30,29
330,MAD,PTGB,0 days 00:10:43,-1,22,23
330,MAD,P009213,0 days 00:10:34,-2,20,22
330,MAD,P001392,0 days 00:06:19,5,19,14
330,MAD,PBMT,0 days 00:05:32,5,19,14
330,MAD,P003733,0 days 00:00:11,-3,0,3
330,OLY,P007982,0 days 00:29:54,-5,61,66
330,OLY,P008829,0 days 00:28:40,0,57,57
330,OLY,P008811,0 days 00:27:21,-9,53,62
330,OLY,P008855,0 days 00:26:42,-5,49,54
330,OLY,P007853,0 days 00:26:06,-11,47,58
330,OLY,P001255,0 days 00:21:35,1,46,45
330,OLY,P010612,0 days 00:19:09,-15,33,48
330,OLY,P003941,0 days 00:10:10,2,17,15
330,OLY,P011194,0 days 00:07:54,-9,11,20
330,OLY,P012878,0 days 00:02:29,-4,6,10
331,PAN,P012774,0 days 00:34:34,14,66,52
331,PAN,P003842,0 days 00:31:47,14,58,44
331,PAN,P011204,0 days 00:27:02,20,49,29
331,PAN,P007866,0 days 00:26:25,9,48,39
331,PAN,P005161,0 days 00:22:53,13,43,30
331,PAN,P001926,0 days 00:17:45,5,33,28
331,PAN,P002328,0 days 00:17:32,6,33,27
331,PAN,P011209,0 days 00:08:13,1,11,10
331,PAN,P011221,0 days 00:07:12,-1,12,13
331,PAN,P012712,0 days 00:06:37,-1,12,13
331,ULK,P001932,0 days 00:33:42,-13,47,60
331,ULK,P008962,0 days 00:31:37,-9,47,56
331,ULK,P004004,0 days 00:24:55,-4,33,37
331,ULK,P006661,0 days 00:23:57,-24,26,50
331,ULK,P002968,0 days 00:21:13,-1,39,40
331,ULK,P011980,0 days 00:19:28,-12,20,32
331,ULK,P006961,0 days 00:18:26,6,37,31
331,ULK,P009849,0 days 00:09:52,-2,15,17
331,ULK,P010560,0 days 00:09:08,-11,13,24
331,ULK,P005844,0 days 00:04:20,-2,8,10
331,ULK,P011157,0 days 00:03:22,-8,0,8
332,OLY,P008829,0 days 00:28:20,-2,59,61
332,OLY,P007982,0 days 00:26:31,5,64,59
332,OLY,P010392,0 days 00:22:57,2,53,51
332,OLY,P003941,0 days 00:20:13,12,54,42
332,OLY,P001255,0 days 00:17:25,2,37,35
332,OLY,P007853,0 days 00:16:25,7,44,37
332,OLY,P008855,0 days 00:16:04,-3,28,31
332,OLY,P010612,0 days 00:13:54,-8,20,28
332,OLY,P012878,0 days 00:13:54,-4,27,31
332,OLY,P008811,0 days 00:11:32,-4,15,19
332,OLY,P011965,0 days 00:06:50,7,18,11
332,OLY,P011194,0 days 00:05:55,1,16,15
332,ULK,P001932,0 days 00:28:53,4,58,54
332,ULK,P006661,0 days 00:26:48,9,58,49
332,ULK,P008962,0 days 00:24:31,7,56,49
332,ULK,P010560,0 days 00:24:18,12,55,43
332,ULK,P002968,0 days 00:18:55,11,39,28
332,ULK,P011980,0 days 00:16:28,-15,28,43
332,ULK,P011157,0 days 00:15:14,-7,37,44
332,ULK,P004004,0 days 00:15:09,-3,37,40
332,ULK,P009849,0 days 00:13:12,-12,26,38
332,ULK,P011052,0 days 00:06:59,-6,15,21
332,ULK,P005844,0 days 00:05:51,-7,8,15
332,ULK,P011201,0 days 00:03:42,-8,3,11
333,MAD,P003108,0 days 00:31:49,-4,68,72
333,MAD,P006540,0 days 00:28:29,-7,61,68
333,MAD,P005928,0 days 00:22:10,0,52,52
333,MAD,P005791,0 days 00:21:26,-13,34,47
333,MAD,PTGB,0 days 00:20:36,-18,38,56
333,MAD,P010357,0 days 00:19:53,-22,25,47
333,MAD,PCVM,0 days 00:17:27,-15,26,41
333,MAD,P004887,0 days 00:16:18,1,41,40
333,MAD,PBMT,0 days 00:10:16,-7,17,24
333,MAD,P009213,0 days 00:07:11,8,27,19
333,MAD,P001392,0 days 00:04:25,2,11,9
333,PAN,P003842,0 days 00:33:13,15,81,66
333,PAN,P011204,0 days 00:32:38,18,81,63
333,PAN,P001926,0 days 00:25:00,9,56,47
333,PAN,P012774,0 days 00:24:12,9,61,52
333,PAN,P012712,0 days 00:19:49,8,41,33
333,PAN,P005161,0 days 00:18:23,4,43,39
333,PAN,P007866,0 days 00:17:35,5,50,45
333,PAN,P007947,0 days 00:13:16,12,30,18
333,PAN,P002328,0 days 00:06:40,-5,12,17
333,PAN,P011209,0 days 00:06:04,2,15,13
333,PAN,P011221,0 days 00:03:10,-2,5,7
