Gamecode,CODETEAM,J1,TIME,DELTA_SCORE,OFF,DEF
1,BER,P006919,25.3,-10,42,52
1,BER,P007025,21.15,-7,34,41
1,BER,P008062,15.25,-8,33,41
1,BER,P008173,16.3,-6,35,41
1,BER,P008780,27.3,1,52,51
1,BER,P010791,22.417,-6,40,46
1,BER,P011631,10.817,0,17,17
1,BER,P011934,19.05,-12,36,48
1,BER,P012604,24.283,-8,50,58
1,BER,P012721,18.133,6,46,40
1,PAN,P001926,16.001,5,40,35
1,PAN,P002328,17.251,11,36,25
1,PAN,P003842,27.134,8,57,49
1,PAN,P004088,14.65,-2,27,29
1,PAN,P005353,14.267,3,33,30
1,PAN,P007866,14.934,8,30,22
1,PAN,P009622,20.184,15,45,30
1,PAN,P011204,21.267,-4,49,53
1,PAN,P011209,0.833,-5,0,5
1,PAN,P012712,21.267,-4,49,53
1,PAN,P012774,32.217,15,69,54
2,MCO,P002581,20.6,4,49,45
2,MCO,P005763,14.333,4,30,26
2,MCO,P005844,19.401,9,44,35
2,MCO,P005985,18.567,9,42,33
2,MCO,P008099,21.434,4,51,47
2,MCO,P011212,25.668,9,63,54
2,MCO,P011226,29.45,8,67,59
2,MCO,P011231,20.618,11,53,42
2,MCO,P013365,6.417,0,15,15
2,MCO,PLCZ,23.517,7,51,44
2,MIL,P000796,27.317,-15,53,68
2,MIL,P001392,15.417,-6,21,27
2,MIL,P001518,9.767,-6,20,26
2,MIL,P006085,24.067,-10,54,64
2,MIL,P006509,4.35,5,14,9
2,MIL,P007831,28.317,-18,53,71
2,MIL,P008985,22.816,-5,44,49
2,MIL,P008987,17.866,-2,37,39
2,MIL,P011199,22.4,-15,41,56
2,MIL,P013384,15.266,1,34,33
2,MIL,P013386,12.417,6,29,23
3,BAR,P000925,20.801,-7,24,31
3,BAR,P002939,28.0,-5,50,55
3,BAR,P003196,11.566,-4,23,27
3,BAR,P003478,23.0,-3,41,44
3,BAR,P006435,23.483,11,44,33
3,BAR,P009862,24.866,-14,42,56
3,BAR,P010106,7.466,-1,6,7
3,BAR,P012745,23.966,6,45,39
3,BAR,P012795,14.265,-10,22,32
3,BAR,P013379,22.582,-8,38,46
3,ZAL,P002329,15.183,7,21,14
3,ZAL,P002676,24.817,0,53,53
3,ZAL,P003048,16.367,10,36,26
3,ZAL,P003210,0.467,0,0,0
3,ZAL,P005504,19.216,-7,34,41
3,ZAL,P007029,12.382,-2,20,22
3,ZAL,P007513,26.484,5,57,52
3,ZAL,P007975,17.733,11,41,30
3,ZAL,P011051,4.417,4,4,0
3,ZAL,P011925,15.666,-4,22,26
3,ZAL,P011983,25.651,8,48,40
3,ZAL,P012622,21.617,3,34,31
4,BAS,P004058,1.05,1,4,3
4,BAS,P007230,27.134,-4,61,65
4,BAS,P008072,17.199,2,39,37
4,BAS,P011085,6.916,-3,11,14
4,BAS,P011196,22.333,4,49,45
4,BAS,P011948,20.116,9,46,37
4,BAS,P012080,30.883,8,70,62
4,BAS,P012201,35.415,8,76,68
4,BAS,P012597,16.766,-2,28,30
4,BAS,P013367,22.183,7,56,49
4,PAR,P004761,28.934,6,68,62
4,PAR,P006591,17.868,-7,35,42
4,PAR,P006760,23.634,-3,53,56
4,PAR,P007870,30.634,-5,61,66
4,PAR,P010781,22.916,1,47,46
4,PAR,P011981,31.218,-9,59,68
4,PAR,P012720,24.816,-8,44,52
4,PAR,P013369,19.985,-5,43,48
5,MAD,P003583,16.434,-7,40,47
5,MAD,P003733,17.101,9,42,33
5,MAD,P005791,21.084,2,47,45
5,MAD,P005928,27.368,6,62,56
5,MAD,P006540,24.267,1,54,53
5,MAD,P007630,4.634,-4,9,13
5,MAD,P009005,27.535,-12,60,72
5,MAD,P009213,14.117,-1,29,30
5,MAD,P011247,11.634,-11,23,34
5,MAD,P011649,7.467,2,22,20
5,MAD,P013378,14.45,-9,34,43
5,MAD,PTGB,13.919,-16,23,39
5,MUN,P001288,23.116,-9,49,58
5,MUN,P001557,18.599,15,53,38
5,MUN,P004508,13.083,-2,27,29
5,MUN,P007056,24.95,13,57,44
5,MUN,P007201,33.866,-6,72,78
5,MUN,P007639,4.25,6,17,11
5,MUN,P010391,17.149,-6,38,44
5,MUN,P011224,23.183,21,66,45
5,MUN,P011244,14.883,-2,36,38
5,MUN,P011987,26.916,10,70,60
6,ASV,P000229,21.951,-8,43,51
6,ASV,P002100,13.367,3,30,27
6,ASV,P003526,14.0,0,28,28
6,ASV,P004194,25.784,-15,48,63
6,ASV,P007027,26.634,-10,52,62
6,ASV,P008991,17.767,3,38,35
6,ASV,P010545,16.717,-4,40,44
6,ASV,P011225,24.851,-13,47,60
6,ASV,P012731,19.734,2,38,36
6,ASV,P013371,15.767,6,35,29
6,ASV,PKIR,3.433,1,11,10
6,TEL,P004233,4.367,-8,7,15
6,TEL,P006835,21.384,-1,43,44
6,TEL,P007519,15.101,-11,24,35
6,TEL,P007855,2.284,-2,5,7
6,TEL,P007990,18.317,0,32,32
6,TEL,P009754,26.516,19,71,52
6,TEL,P011193,28.849,18,73,55
6,TEL,P011214,29.066,2,64,62
6,TEL,P011219,22.483,5,54,49
6,TEL,P013381,3.367,1,5,4
6,TEL,P013382,28.266,12,67,55
7,OLY,P001255,14.551,-1,25,26
7,OLY,P003469,30.518,-4,58,62
7,OLY,P007853,20.0,-2,38,40
7,OLY,P007947,3.867,2,10,8
7,OLY,P007982,20.968,-10,33,43
7,OLY,P008829,9.484,-7,13,20
7,OLY,P008855,21.751,-7,38,45
7,OLY,P009849,16.451,-8,29,37
7,OLY,P011194,18.018,-9,30,39
7,OLY,P012878,21.984,-2,41,43
7,OLY,P013380,22.418,-7,40,47
7,ULK,P002849,19.933,6,43,37
7,ULK,P002968,9.633,-5,20,25
7,ULK,P004004,20.6,-1,40,41
7,ULK,P006661,2.084,-3,2,5
7,ULK,P007182,7.885,1,12,11
7,ULK,P008104,2.584,3,5,2
7,ULK,P008962,27.351,16,58,42
7,ULK,P009783,28.268,8,55,47
7,ULK,P009863,31.55,14,72,58
7,ULK,P010560,11.733,3,27,24
7,ULK,P011205,22.851,7,43,36
7,ULK,PLMG,15.533,6,33,27
8,PRS,P004197,13.284,0,23,23
8,PRS,P004512,11.434,-5,27,32
8,PRS,P007032,18.401,-4,36,40
8,PRS,P010390,28.567,2,50,48
8,PRS,P012608,27.85,4,50,46
8,PRS,P012609,11.434,-5,27,32
8,PRS,P012610,28.567,2,50,48
8,PRS,P012613,25.851,7,53,46
8,PRS,P012640,20.467,-6,45,51
8,PRS,P013373,14.15,-10,24,34
8,RED,P000848,22.7,5,52,47
8,RED,P002553,21.148,1,43,42
8,RED,P004007,3.833,-9,5,14
8,RED,P004866,27.633,7,51,44
8,RED,P006240,2.517,-5,6,11
8,RED,P006436,23.516,-1,52,53
8,RED,P007960,2.5,-4,2,6
8,RED,P009035,16.334,7,31,24
8,RED,P009048,27.049,6,63,57
8,RED,P010612,29.282,14,63,49
8,RED,P012044,14.25,-6,20,26
8,RED,P012786,9.233,0,12,12
9,IST,P004887,13.8,1,25,24
9,IST,P006590,18.117,11,40,29
9,IST,P007109,20.834,8,40,32
9,IST,P007200,23.317,-10,34,44
9,IST,P009513,4.0,-6,2,8
9,IST,P009664,12.0,8,26,18
9,IST,P009846,23.116,3,43,40
9,IST,P011078,24.416,22,58,36
9,IST,P012710,16.149,3,30,27
9,IST,P012788,26.2,8,51,43
9,IST,P013363,12.151,-3,18,21
9,IST,P013364,5.9,0,13,13
9,VIR,P001133,29.549,8,58,50
9,VIR,P001844,19.583,-7,36,43
9,VIR,P002084,16.866,-15,22,37
9,VIR,P004554,21.0,0,35,35
9,VIR,P004888,18.116,-11,24,35
9,VIR,P006739,15.098,-9,21,30
9,VIR,P009549,31.366,-5,58,63
9,VIR,P011816,0.783,-2,2,4
9,VIR,P012585,13.666,8,25,17
9,VIR,P012591,6.283,0,10,10
9,VIR,P013374,11.798,-9,17,26
9,VIR,PBCN,15.882,-3,27,30
10,MCO,P002581,22.283,7,53,46
10,MCO,P005844,17.716,-1,32,33
10,MCO,P005985,31.299,9,69,60
10,MCO,P008099,26.949,0,57,57
10,MCO,P011212,26.983,3,55,52
10,MCO,P011226,29.283,8,62,54
10,MCO,P011231,20.732,3,43,40
10,MCO,P012515,0.15,0,0,0
10,MCO,P013365,2.85,-5,2,7
10,MCO,PLCZ,21.75,6,52,46
10,TEL,P005145,5.867,-2,14,16
10,TEL,P006835,28.249,-9,54,63
10,TEL,P007519,12.967,1,25,24
10,TEL,P007855,2.884,-2,4,6
10,TEL,P007990,17.716,-3,32,35
10,TEL,P009754,28.616,-6,57,63
10,TEL,P011193,26.999,-6,54,60
10,TEL,P011214,24.682,-3,50,53
10,TEL,P011219,19.933,3,41,38
10,TEL,P013381,3.483,-5,6,11
10,TEL,P013382,28.599,2,58,56
11,BAS,P007230,28.584,-12,41,53
11,BAS,P008072,12.05,-11,16,27
11,BAS,P011085,14.217,-2,25,27
11,BAS,P011196,28.501,3,55,52
11,BAS,P011948,20.683,7,47,40
11,BAS,P012080,21.418,-15,29,44
11,BAS,P012201,33.634,-1,65,66
11,BAS,P012597,18.084,-1,38,39
11,BAS,P013367,22.834,-3,39,42
11,RED,P000848,11.333,4,20,16
11,RED,P002553,12.715,-1,25,26
11,RED,P004007,17.865,1,38,37
11,RED,P004866,27.066,2,51,49
11,RED,P006436,14.783,-3,31,34
11,RED,P007960,8.317,5,16,11
11,RED,P009035,27.167,8,53,45
11,RED,P009048,28.0,2,57,55
11,RED,P010612,24.366,5,49,44
11,RED,P012044,11.966,7,21,14
11,RED,P012786,16.267,7,29,22
11,RED,PLUO,0.15,-2,0,2
12,IST,P004887,11.884,-16,14,30
12,IST,P006590,21.849,4,48,44
12,IST,P006640,1.217,-6,0,6
12,IST,P007109,11.083,-7,13,20
12,IST,P007200,24.45,-11,49,60
12,IST,P009664,18.083,2,31,29
12,IST,P009846,21.567,1,42,41
12,IST,P011078,23.65,11,55,44
12,IST,P012710,11.833,-4,27,31
12,IST,P012788,22.25,3,49,46
12,IST,P013363,13.8,-5,28,33
12,IST,P013364,18.334,3,34,31
12,ULK,P002849,20.749,15,43,28
12,ULK,P002968,6.233,0,13,13
12,ULK,P004004,20.5,-1,43,44
12,ULK,P006961,12.849,9,27,18
12,ULK,P007182,26.715,7,63,56
12,ULK,P008104,13.95,14,34,20
12,ULK,P008962,25.582,-13,44,57
12,ULK,P009783,22.598,-10,44,54
12,ULK,P009863,30.632,-11,56,67
12,ULK,P011205,20.182,15,48,33
13,ASV,P000229,12.6,-4,21,25
13,ASV,P002100,25.249,-11,52,63
13,ASV,P003526,21.933,11,57,46
13,ASV,P004194,15.466,-4,31,35
13,ASV,P007027,30.649,11,71,60
13,ASV,P008991,10.233,-3,16,19
13,ASV,P010545,26.133,6,60,54
13,ASV,P012731,10.95,-2,27,29
13,ASV,P013371,24.1,4,51,47
13,ASV,P013372,16.166,6,39,33
13,ASV,PKIR,6.516,-4,10,14
13,VIR,P001133,29.151,-3,58,61
13,VIR,P001844,5.617,-4,15,19
13,VIR,P002084,15.7,2,36,34
13,VIR,P004554,16.967,-14,33,47
13,VIR,P004888,21.767,-7,46,53
13,VIR,P006739,25.201,-4,55,59
13,VIR,P009549,31.017,2,66,64
13,VIR,P012585,18.167,2,34,32
13,VIR,P013374,17.351,11,43,32
13,VIR,PBCN,19.067,5,39,34
14,MUN,P001288,20.501,-11,36,47
14,MUN,P004508,20.767,-8,41,49
14,MUN,P007056,25.934,-12,49,61
14,MUN,P007201,29.384,-16,52,68
14,MUN,P007639,14.067,-3,30,33
14,MUN,P010391,18.617,-6,35,41
14,MUN,P011052,17.583,0,43,43
14,MUN,P011224,18.351,-7,33,40
14,MUN,P011244,10.617,1,27,26
14,MUN,P011987,21.917,-11,42,53
14,MUN,P012123,2.267,-2,7,9
14,PAN,P001926,13.417,-6,27,33
14,PAN,P002328,10.45,-3,19,22
14,PAN,P003842,27.465,22,71,49
14,PAN,P004088,13.816,8,36,28
14,PAN,P005161,13.366,1,31,30
14,PAN,P005353,12.466,-7,23,30
14,PAN,P007866,11.899,9,29,20
14,PAN,P009622,18.799,15,45,30
14,PAN,P011204,19.448,18,53,35
14,PAN,P011209,5.716,6,18,12
14,PAN,P012712,23.766,8,52,44
14,PAN,P012774,29.382,4,66,62
15,MAD,P003108,17.085,-1,33,34
15,MAD,P003583,21.285,4,52,48
15,MAD,P003733,10.701,5,28,23
15,MAD,P005791,13.418,-3,26,29
15,MAD,P005928,27.753,10,68,58
15,MAD,P006540,19.917,5,41,36
15,MAD,P009005,23.818,7,62,55
15,MAD,P009213,25.085,-2,51,53
15,MAD,P011247,6.5,-7,10,17
15,MAD,P013378,20.835,19,63,44
15,MAD,PTGB,13.618,-2,31,33
15,PAR,P004761,21.316,-5,50,55
15,PAR,P006591,20.951,-2,50,52
15,PAR,P006760,34.217,-8,70,78
15,PAR,P007632,10.883,0,17,17
15,PAR,P007870,25.084,0,58,58
15,PAR,P008232,3.566,-4,9,13
15,PAR,P010781,12.916,2,26,24
15,PAR,P011981,22.4,-6,44,50
15,PAR,P012720,24.267,-3,58,61
15,PAR,P013369,24.4,-9,48,57
16,MIL,P000796,28.231,3,61,58
16,MIL,P001392,19.166,3,36,33
16,MIL,P001518,18.85,18,43,25
16,MIL,P006085,26.282,6,59,53
16,MIL,P006509,14.7,-5,26,31
16,MIL,P006701,3.683,-3,3,6
16,MIL,P007831,30.298,6,64,58
16,MIL,P008987,28.598,7,58,51
16,MIL,P013384,12.515,-8,14,22
16,MIL,P013385,9.984,2,18,16
16,MIL,P013386,7.683,-4,13,17
16,PRS,P004197,14.167,1,27,26
16,PRS,P004512,10.65,5,22,17
16,PRS,P005793,14.6,4,31,27
16,PRS,P007032,15.7,0,26,26
16,PRS,P010390,25.399,-9,43,52
16,PRS,P012608,27.082,-9,49,58
16,PRS,P012609,21.566,-1,46,47
16,PRS,P012610,26.249,-13,45,58
16,PRS,P012613,27.082,-9,49,58
16,PRS,P012640,15.233,7,29,22
16,PRS,P013373,2.267,-1,3,4
17,BAR,P000925,18.518,4,33,29
17,BAR,P002939,18.868,4,42,38
17,BAR,P003196,15.484,13,42,29
17,BAR,P003478,19.667,15,46,31
17,BAR,P006435,17.467,4,35,31
17,BAR,P006568,4.367,1,10,9
17,BAR,P009862,21.684,6,42,36
17,BAR,P009992,15.251,12,42,30
17,BAR,P010106,8.801,6,21,15
17,BAR,P012745,23.235,2,43,41
17,BAR,P012795,18.268,-2,36,38
17,BAR,P013379,18.4,10,48,38
17,BER,P006251,5.434,-6,11,17
17,BER,P006919,23.8,-8,43,51
17,BER,P007025,2.467,-2,3,5
17,BER,P008062,13.467,-9,29,38
17,BER,P008173,25.917,-6,42,48
17,BER,P008384,10.717,-12,19,31
17,BER,P008780,27.434,-1,53,54
17,BER,P010791,24.717,3,52,49
17,BER,P011631,10.383,-2,19,21
17,BER,P011934,19.617,-18,26,44
17,BER,P012604,19.851,-7,38,45
17,BER,P012721,16.201,-7,30,37
18,OLY,P001255,19.333,-5,37,42
18,OLY,P003469,24.632,-3,43,46
18,OLY,P007853,1.8,-1,0,1
18,OLY,P007947,23.55,16,46,30
18,OLY,P007982,14.566,11,28,17
18,OLY,P008811,6.467,-3,11,14
18,OLY,P008829,15.6,11,33,22
18,OLY,P008855,19.616,-4,35,39
18,OLY,P009849,16.383,-8,26,34
18,OLY,P011194,11.615,-6,20,26
18,OLY,P012878,21.684,13,41,28
18,OLY,P013380,24.749,9,50,41
18,ZAL,P002329,20.782,-17,21,38
18,ZAL,P002676,18.984,13,47,34
18,ZAL,P003048,21.266,-4,33,37
18,ZAL,P003210,10.132,3,19,16
18,ZAL,P005504,9.55,-4,15,19
18,ZAL,P007029,25.216,-5,53,58
18,ZAL,P007513,28.55,0,49,49
18,ZAL,P007975,23.166,-5,46,51
18,ZAL,P011051,11.333,3,25,22
18,ZAL,P011925,6.684,-5,3,8
18,ZAL,P011983,17.549,-1,22,23
18,ZAL,P012622,6.783,-8,7,15
19,ASV,P000229,27.283,1,57,56
19,ASV,P002100,15.983,-24,21,45
19,ASV,P003526,26.734,6,59,53
19,ASV,P007027,27.317,13,62,49
19,ASV,P008991,8.433,-14,13,27
19,ASV,P010545,31.284,10,66,56
19,ASV,P011225,28.367,18,66,48
19,ASV,P013371,9.166,-18,11,29
19,ASV,P013372,9.534,0,18,18
19,ASV,PKIR,15.899,-17,22,39
19,BER,P006251,13.833,16,39,23
19,BER,P006919,26.616,-16,45,61
19,BER,P007025,15.816,24,45,21
19,BER,P008173,23.082,7,50,43
19,BER,P008384,14.517,-14,20,34
19,BER,P008780,25.633,-6,53,59
19,BER,P010791,14.75,-14,20,34
19,BER,P011934,22.233,-14,34,48
19,BER,P012604,21.099,28,59,31
19,BER,P012721,22.416,14,55,41
20,RED,P000848,19.767,10,41,31
20,RED,P002553,8.817,2,16,14
20,RED,P004007,1.933,-1,3,4
20,RED,P004866,32.166,15,59,44
20,RED,P006436,10.734,-2,13,15
20,RED,P007960,5.901,7,16,9
20,RED,P009035,31.183,17,60,43
20,RED,P009048,26.533,18,53,35
20,RED,P010612,19.716,8,34,26
20,RED,P012044,5.85,-2,10,12
20,RED,P012786,30.3,21,63,42
20,RED,PJDR,7.1,2,12,10
20,ULK,P002849,16.616,0,29,29
20,ULK,P002968,14.999,-11,22,33
20,ULK,P002969,8.1,-11,12,23
20,ULK,P007182,10.966,-1,13,14
20,ULK,P008104,15.966,-12,18,30
20,ULK,P008962,31.317,-12,45,57
20,ULK,P009783,23.866,-17,34,51
20,ULK,P009863,29.332,-14,45,59
20,ULK,P010560,17.333,-4,23,27
20,ULK,P011205,26.233,-1,39,40
20,ULK,PLMG,5.267,-12,5,17
21,MIL,P000796,24.967,-4,42,46
21,MIL,P001392,16.251,-5,34,39
21,MIL,P001518,18.15,-12,35,47
21,MIL,P005670,1.75,0,4,4
21,MIL,P006085,27.567,-11,46,57
21,MIL,P006509,5.883,-9,5,14
21,MIL,P007831,27.984,-9,47,56
21,MIL,P008985,19.218,-14,31,45
21,MIL,P008987,26.451,-14,49,63
21,MIL,P013384,4.433,-4,4,8
21,MIL,P013385,20.951,-26,27,53
21,MIL,P013386,6.4,3,16,13
21,OLY,P001255,25.416,14,64,50
21,OLY,P003469,23.649,12,54,42
21,OLY,P007853,22.548,13,49,36
21,OLY,P007947,17.715,13,40,27
21,OLY,P008811,12.433,11,30,19
21,OLY,P008829,16.349,9,35,26
21,OLY,P008855,22.283,8,49,41
21,OLY,P009849,8.499,9,14,5
21,OLY,P010392,1.75,0,4,4
21,OLY,P011194,6.549,3,13,10
21,OLY,P012878,21.016,7,46,39
21,OLY,P013380,21.783,6,47,41
22,BAS,P004058,3.667,0,5,5
22,BAS,P007230,24.1,-5,47,52
22,BAS,P008072,28.317,9,53,44
22,BAS,P011085,14.75,9,29,20
22,BAS,P011196,9.35,-5,16,21
22,BAS,P011948,17.816,3,38,35
22,BAS,P012058,14.517,-5,27,32
22,BAS,P012080,23.517,3,40,37
22,BAS,P012201,27.65,7,54,47
22,BAS,P012597,20.45,0,43,43
22,BAS,P013367,15.866,4,28,24
22,MAD,P003108,27.617,-8,49,57
22,MAD,P003583,6.817,-7,7,14
22,MAD,P003733,7.983,-11,9,20
22,MAD,P005791,33.033,1,63,62
22,MAD,P006540,33.45,3,65,62
22,MAD,P009005,25.783,-5,45,50
22,MAD,P009213,26.667,5,50,45
22,MAD,P013378,15.117,0,27,27
22,MAD,PTGB,23.533,2,45,43
23,PAN,P001926,14.868,-7,29,36
23,PAN,P002328,15.733,6,34,28
23,PAN,P003842,29.852,2,58,56
23,PAN,P004088,11.917,-1,28,29
23,PAN,P005161,11.267,4,22,18
23,PAN,P005353,7.55,-12,10,22
23,PAN,P007866,14.868,-4,27,31
23,PAN,P009622,18.502,-7,39,46
23,PAN,P011204,30.885,-1,62,63
23,PAN,P011209,1.583,0,2,2
23,PAN,P012712,15.717,1,35,34
23,PAN,P012774,27.268,-1,54,55
23,PRS,P004197,19.717,1,40,39
23,PRS,P005793,13.333,12,29,17
23,PRS,P010390,18.55,-14,36,50
23,PRS,P012608,27.417,-6,57,63
23,PRS,P012609,23.6,10,51,41
23,PRS,P012610,23.283,-19,43,62
23,PRS,P012611,9.683,14,24,10
23,PRS,P012612,11.416,4,28,24
23,PRS,P012613,23.334,5,52,47
23,PRS,P012640,20.283,3,44,41
23,PRS,P013373,9.384,10,16,6
24,VIR,P001133,28.45,1,51,50
24,VIR,P001844,13.884,-9,19,28
24,VIR,P002084,13.7,-1,18,19
24,VIR,P004554,6.984,-7,8,15
24,VIR,P004888,36.317,8,67,59
24,VIR,P005738,4.167,-10,7,17
24,VIR,P006739,24.45,5,43,38
24,VIR,P009549,18.201,-4,29,33
24,VIR,P012585,5.15,-6,11,17
24,VIR,P012591,5.067,-4,8,12
24,VIR,P013374,24.151,15,48,33
24,VIR,PBCN,19.484,-3,31,34
24,ZAL,P002329,26.833,-8,45,53
24,ZAL,P002676,16.45,15,34,19
24,ZAL,P003048,16.483,-20,11,31
24,ZAL,P003210,9.267,-6,12,18
24,ZAL,P005504,14.717,4,31,27
24,ZAL,P007029,19.901,4,30,26
24,ZAL,P007513,30.366,-5,52,57
24,ZAL,P007975,25.567,11,54,43
24,ZAL,P011051,8.8,19,29,10
24,ZAL,P011983,13.366,-14,15,29
24,ZAL,P012622,18.25,15,42,27
26,MUN,P004508,27.732,-2,61,63
26,MUN,P005460,10.916,12,26,14
26,MUN,P007056,26.199,-6,55,61
26,MUN,P007201,19.216,-7,39,46
26,MUN,P007639,5.833,-11,6,17
26,MUN,P010391,27.466,4,63,59
26,MUN,P011052,5.883,-10,6,16
26,MUN,P011224,24.965,-4,47,51
26,MUN,P011244,15.999,-2,26,28
26,MUN,P011987,26.048,-10,47,57
26,MUN,P012123,9.733,-4,14,18
26,PAR,P004761,22.152,4,50,46
26,PAR,P006591,27.669,13,61,48
26,PAR,P006760,22.701,8,52,44
26,PAR,P007632,7.116,-7,6,13
26,PAR,P007870,12.834,4,30,26
26,PAR,P008232,15.2,-2,28,30
26,PAR,P010781,17.018,6,41,35
26,PAR,P011050,7.2,-9,8,17
26,PAR,P011981,19.951,13,48,35
26,PAR,P012720,24.935,3,56,53
26,PAR,P013369,23.234,7,50,43
27,IST,P004887,30.217,8,79,71
27,IST,P006590,18.05,1,41,40
27,IST,P006640,7.583,-9,13,22
27,IST,P007109,14.601,-14,20,34
27,IST,P007200,23.416,5,61,56
27,IST,P009664,11.383,-3,25,28
27,IST,P011078,28.101,6,67,61
27,IST,P012710,21.233,1,48,47
27,IST,P012788,6.016,-4,10,14
27,IST,P013363,30.849,4,73,69
27,IST,P013364,8.551,-5,18,23
27,TEL,P004233,5.367,-7,9,16
27,TEL,P005145,10.385,16,35,19
27,TEL,P006835,34.203,-2,79,81
27,TEL,P007990,21.369,13,54,41
27,TEL,P011193,26.502,-7,64,71
27,TEL,P011214,21.634,4,47,43
27,TEL,P011219,24.951,-10,52,62
27,TEL,P013381,0.167,-2,0,2
27,TEL,P013382,32.968,-9,67,76
27,TEL,P013389,22.469,14,58,44
25,BAR,P000925,19.1,8,40,32
25,BAR,P002939,20.217,13,44,31
25,BAR,P003196,18.417,18,49,31
25,BAR,P003478,12.65,10,27,17
25,BAR,P006435,17.316,4,37,33
25,BAR,P009862,24.984,18,58,40
25,BAR,P009992,15.033,1,32,31
25,BAR,P010106,6.767,-1,13,14
25,BAR,P012745,29.3,7,61,54
25,BAR,P012795,17.483,-5,33,38
25,BAR,P013379,18.733,2,36,34
25,MCO,P002581,28.35,-10,51,61
25,MCO,P005844,9.484,-9,13,22
25,MCO,P005985,23.533,-21,36,57
25,MCO,P008099,14.818,2,31,29
25,MCO,P009754,23.25,-12,37,49
25,MCO,P011212,25.201,-4,46,50
25,MCO,P011226,26.368,-2,52,54
25,MCO,P011231,29.767,-19,48,67
25,MCO,P013365,6.234,5,16,11
25,MCO,PLCZ,13.0,-5,25,30
28,BER,P006251,15.35,1,36,35
28,BER,P006919,25.582,2,55,53
28,BER,P007025,11.4,0,19,19
28,BER,P008062,14.483,-9,19,28
28,BER,P008173,24.166,1,48,47
28,BER,P008384,4.433,-8,4,12
28,BER,P008780,25.516,2,52,50
28,BER,P010791,16.9,-4,22,26
28,BER,P011934,20.516,-10,31,41
28,BER,P012604,24.349,1,46,45
28,BER,P012721,17.3,-11,23,34
28,ULK,P002849,21.098,1,42,41
28,ULK,P002968,6.533,-6,6,12
28,ULK,P006961,23.798,8,50,42
28,ULK,P007182,7.865,2,14,12
28,ULK,P008104,17.332,8,31,23
28,ULK,P008962,26.515,0,54,54
28,ULK,P009783,16.882,-1,30,31
28,ULK,P009863,27.331,-1,56,57
28,ULK,P010560,17.332,9,33,24
28,ULK,P011205,17.766,3,39,36
28,ULK,PLMG,17.533,12,35,23
29,MIL,P000796,31.234,6,69,63
29,MIL,P001392,4.516,2,9,7
29,MIL,P001518,19.018,-2,36,38
29,MIL,P006085,23.817,-9,43,52
29,MIL,P006509,15.367,-2,34,36
29,MIL,P007831,29.084,-2,59,61
29,MIL,P008985,22.601,-12,48,60
29,MIL,P008987,28.95,-7,55,62
29,MIL,P013384,11.234,1,24,23
29,MIL,P013385,8.934,5,21,16
29,MIL,P013386,5.25,5,12,7
29,ZAL,P002329,27.916,2,59,57
29,ZAL,P002676,15.633,-9,24,33
29,ZAL,P003048,8.866,-6,12,18
29,ZAL,P003210,10.434,0,23,23
29,ZAL,P005504,14.251,1,30,29
29,ZAL,P007029,22.6,19,61,42
29,ZAL,P007513,34.399,9,76,67
29,ZAL,P007975,21.734,2,44,42
29,ZAL,P011051,16.833,8,43,35
29,ZAL,P011983,4.017,-10,3,13
29,ZAL,P012622,21.85,-2,47,49
29,ZAL,P012715,1.467,1,3,2
30,MUN,P004508,23.233,-2,59,61
30,MUN,P005460,11.033,9,38,29
30,MUN,P007056,26.267,-6,64,70
30,MUN,P007201,19.583,1,55,54
30,MUN,P010391,26.784,3,68,65
30,MUN,P011052,11.833,1,33,32
30,MUN,P011224,25.867,6,79,73
30,MUN,P011244,24.25,-1,64,65
30,MUN,P011987,29.817,2,83,81
30,MUN,P012123,1.333,-3,2,5
30,PRS,P004197,17.083,-7,35,42
30,PRS,P005793,13.517,1,40,39
30,PRS,P010390,15.767,-8,32,40
30,PRS,P012608,27.215,-1,69,70
30,PRS,P012609,22.916,5,66,61
30,PRS,P012610,26.232,0,72,72
30,PRS,P012611,11.734,-1,33,34
30,PRS,P012612,6.75,-1,13,14
30,PRS,P012613,26.482,-3,67,70
30,PRS,P012640,16.8,1,57,56
30,PRS,P013373,15.499,4,51,47
31,MAD,P003108,20.817,-13,37,50
31,MAD,P003583,10.65,-4,17,21
31,MAD,P003733,13.984,19,42,23
31,MAD,P005791,29.301,7,72,65
31,MAD,P005928,31.684,9,77,68
31,MAD,P006540,23.051,13,60,47
31,MAD,P009005,23.467,-12,43,55
31,MAD,P009213,16.234,19,48,29
31,MAD,P011649,6.584,-2,14,16
31,MAD,P013378,7.733,-3,12,15
31,MAD,PTGB,16.5,-13,28,41
31,PAN,P001926,24.333,0,54,54
31,PAN,P002328,2.4,5,7,2
31,PAN,P003842,23.766,-4,51,55
31,PAN,P004088,16.266,0,40,40
31,PAN,P005161,21.333,-9,39,48
31,PAN,P005353,15.0,-1,31,32
31,PAN,P007866,11.816,-2,29,31
31,PAN,P009622,3.65,-11,3,14
31,PAN,P011204,23.216,1,47,46
31,PAN,P012712,29.416,-1,61,62
31,PAN,P012774,28.799,2,68,66
32,PAR,P004761,9.933,-2,25,27
32,PAR,P006591,25.367,9,51,42
32,PAR,P006760,24.2,1,54,53
32,PAR,P007632,2.767,-2,2,4
32,PAR,P007870,19.751,2,46,44
32,PAR,P008232,12.95,14,31,17
32,PAR,P010781,29.0,12,73,61
32,PAR,P011981,22.749,5,49,44
32,PAR,P012720,26.766,3,60,57
32,PAR,P013369,26.517,18,64,46
32,TEL,P004233,1.633,4,4,0
32,TEL,P005145,9.132,5,19,14
32,TEL,P006835,27.132,-7,58,65
32,TEL,P007855,2.55,-3,6,9
32,TEL,P007990,22.565,-12,41,53
32,TEL,P011193,32.032,-9,60,69
32,TEL,P011214,23.532,-5,49,54
32,TEL,P011219,26.266,-8,50,58
32,TEL,P013381,1.8,2,4,2
32,TEL,P013382,31.932,-13,61,74
32,TEL,P013389,21.416,-14,43,57
33,MCO,P002581,24.583,22,68,46
33,MCO,P005844,15.433,-4,35,39
33,MCO,P005985,26.199,16,68,52
33,MCO,P008099,20.3,14,54,40
33,MCO,P008161,2.517,-4,7,11
33,MCO,P009754,21.4,0,51,51
33,MCO,P011212,23.316,3,59,56
33,MCO,P011226,26.265,19,64,45
33,MCO,P013365,16.982,3,40,37
33,MCO,PLCZ,23.0,11,59,48
33,VIR,P001133,29.051,-16,62,78
33,VIR,P001844,18.533,-1,40,41
33,VIR,P002084,12.617,6,32,26
33,VIR,P004554,15.534,-9,38,47
33,VIR,P004888,27.651,-9,57,66
33,VIR,P006739,18.468,-14,37,51
33,VIR,P009549,22.451,-8,48,56
33,VIR,P012585,20.366,-8,44,52
33,VIR,P012591,0.184,-1,1,2
33,VIR,P013374,19.417,-9,34,43
33,VIR,PBCN,15.733,-11,32,43
34,IST,P004887,29.799,-6,59,65
34,IST,P006372,4.933,3,12,9
34,IST,P006590,9.599,4,27,23
34,IST,P007109,13.415,9,38,29
34,IST,P007200,26.282,18,63,45
34,IST,P009664,20.432,16,56,40
34,IST,P009846,31.149,-5,68,73
34,IST,P011078,27.382,-9,61,70
34,IST,P012710,16.35,-15,29,44
34,IST,P013363,20.649,-5,42,47
34,OLY,P001255,17.966,11,40,29
34,OLY,P003469,30.082,9,73,64
34,OLY,P007853,22.033,-13,49,62
34,OLY,P007947,16.85,-10,39,49
34,OLY,P008811,18.699,11,42,31
34,OLY,P008829,17.384,-15,37,52
34,OLY,P008855,23.149,8,50,42
34,OLY,P009849,16.15,2,35,33
34,OLY,P011194,7.283,-7,14,21
34,OLY,P012878,13.783,-9,28,37
34,OLY,P013380,16.616,3,38,35
35,BAR,P000925,26.967,-4,56,60
35,BAR,P002939,26.366,-6,51,57
35,BAR,P003196,17.483,10,42,32
35,BAR,P003478,12.301,9,32,23
35,BAR,P006435,29.833,6,64,58
35,BAR,P009862,26.817,13,64,51
35,BAR,P009992,14.3,4,29,25
35,BAR,P010106,12.317,-2,29,31
35,BAR,P012745,28.467,3,64,61
35,BAR,P012795,13.066,-12,25,37
35,BAR,P013379,17.083,-1,34,35
35,RED,P000848,11.184,7,24,17
35,RED,P002553,19.417,-12,30,42
35,RED,P004007,9.551,-2,17,19
35,RED,P004866,29.752,-6,68,74
35,RED,P006436,20.301,-10,37,47
35,RED,P009035,25.168,3,59,56
35,RED,P009048,18.119,-1,39,40
35,RED,P010612,19.135,-6,37,43
35,RED,P012044,25.849,3,55,52
35,RED,P012786,25.351,0,54,54
35,RED,PJDR,12.05,12,38,26
35,RED,PLUO,9.133,-8,12,20
36,ASV,P000229,19.866,4,37,33
36,ASV,P002100,19.267,5,40,35
36,ASV,P003526,23.018,20,55,35
36,ASV,P004194,11.967,-8,14,22
36,ASV,P007027,27.667,16,58,42
36,ASV,P010545,32.468,16,66,50
36,ASV,P011225,24.584,3,47,44
36,ASV,P012731,4.633,-10,5,15
36,ASV,P013371,11.034,-12,11,23
36,ASV,P013372,16.367,8,36,28
36,ASV,PKIR,9.134,-7,11,18
36,BAS,P008072,10.717,11,22,11
36,BAS,P011196,29.283,-18,47,65
36,BAS,P011948,34.85,-8,63,71
36,BAS,P012058,14.816,-13,18,31
36,BAS,P012080,27.183,-3,45,48
36,BAS,P012201,30.134,-6,54,60
36,BAS,P012597,30.3,-4,52,56
36,BAS,P013367,22.717,6,44,38
37,PAR,P004761,19.616,0,39,39
37,PAR,P006591,21.7,-9,22,31
37,PAR,P006760,33.833,-2,60,62
37,PAR,P007632,4.567,3,9,6
37,PAR,P007870,14.9,5,27,22
37,PAR,P008232,6.167,1,9,8
37,PAR,P010781,27.033,-1,53,54
37,PAR,P011981,28.4,-2,49,51
37,PAR,P012720,29.117,1,56,55
37,PAR,P013369,14.667,-1,21,22
37,VIR,P001133,35.8,9,68,59
37,VIR,P001844,13.9,5,17,12
37,VIR,P002084,3.367,-5,2,7
37,VIR,P004554,16.45,-4,29,33
37,VIR,P004888,28.266,1,57,56
37,VIR,P009549,30.5,-1,54,55
37,VIR,P012585,24.883,-2,53,55
37,VIR,P012591,17.084,-1,23,24
37,VIR,P013374,22.317,4,39,35
37,VIR,PBCN,7.433,-1,8,9
39,TEL,P004233,6.6,-7,10,17
39,TEL,P005145,8.334,-5,8,13
39,TEL,P006835,33.868,-14,55,69
39,TEL,P007990,16.034,-13,22,35
39,TEL,P011214,24.651,-10,35,45
39,TEL,P011219,18.234,-7,31,38
39,TEL,P011433,18.001,-2,25,27
39,TEL,P013381,14.484,6,25,19
39,TEL,P013382,31.619,-8,54,62
39,TEL,P013389,28.185,-15,50,65
39,ZAL,P002329,28.334,10,62,52
39,ZAL,P002676,18.783,8,31,23
39,ZAL,P003048,21.2,9,43,34
39,ZAL,P003210,3.867,-3,3,6
39,ZAL,P005504,8.333,13,21,8
39,ZAL,P007029,13.765,14,29,15
39,ZAL,P007513,22.534,9,50,41
39,ZAL,P007975,19.815,11,42,31
39,ZAL,P011051,10.517,-7,14,21
39,ZAL,P011983,17.618,-1,31,32
39,ZAL,P012622,30.501,5,55,50
39,ZAL,P012715,4.733,7,9,2
38,MCO,P002581,18.818,-13,30,43
38,MCO,P005844,15.067,8,37,29
38,MCO,P005985,25.434,-10,47,57
38,MCO,P008099,13.701,-12,17,29
38,MCO,P009754,26.301,5,63,58
38,MCO,P011212,23.318,3,54,51
38,MCO,P011226,32.568,-11,58,69
38,MCO,P011231,20.268,6,50,44
38,MCO,P013365,10.001,-3,21,24
38,MCO,PLCZ,14.534,-8,23,31
38,PRS,P004197,16.034,10,38,28
38,PRS,P005793,11.683,-12,17,29
38,PRS,P007032,14.166,-2,25,27
38,PRS,P010390,19.734,17,48,31
38,PRS,P012608,29.118,15,73,58
38,PRS,P012609,19.867,-11,36,47
38,PRS,P012610,26.551,13,63,50
38,PRS,P012612,8.434,2,18,16
38,PRS,P012613,28.318,19,70,51
38,PRS,P012640,15.75,0,33,33
38,PRS,P013373,10.35,-16,14,30
40,IST,P004887,25.065,9,65,56
40,IST,P006590,21.35,9,53,44
40,IST,P007109,20.001,16,53,37
40,IST,P007200,12.516,10,26,16
40,IST,P009846,30.848,2,70,68
40,IST,P011078,29.0,14,73,59
40,IST,P012710,19.998,-4,43,47
40,IST,P012788,14.934,3,31,28
40,IST,P013363,26.283,1,66,65
40,MIL,P000796,29.501,-9,68,77
40,MIL,P001518,11.417,-11,17,28
40,MIL,P005670,6.95,3,19,16
40,MIL,P006085,13.2,-14,21,35
40,MIL,P006509,14.801,-12,27,39
40,MIL,P006721,15.75,-21,22,43
40,MIL,P007831,32.918,-11,74,85
40,MIL,P008985,26.133,1,54,53
40,MIL,P008987,26.101,9,63,54
40,MIL,P013384,23.234,5,55,50
41,BAS,P004058,13.267,12,25,13
41,BAS,P008072,22.234,11,41,30
41,BAS,P010784,1.867,3,6,3
41,BAS,P011085,14.817,18,34,16
41,BAS,P011196,17.766,12,39,27
41,BAS,P011948,23.816,13,50,37
41,BAS,P012058,18.717,15,43,28
41,BAS,P012080,25.183,5,46,41
41,BAS,P012201,21.283,8,37,29
41,BAS,P012597,25.467,25,58,33
41,BAS,P013367,15.583,-7,21,28
41,BER,P006251,16.635,-9,22,31
41,BER,P006919,20.684,-10,33,43
41,BER,P007025,10.351,-16,9,25
41,BER,P007550,4.984,-7,5,12
41,BER,P008062,16.834,-11,22,33
41,BER,P008173,23.4,-5,38,43
41,BER,P008384,20.302,-24,23,47
41,BER,P008780,23.451,4,41,37
41,BER,P010791,18.001,-7,24,31
41,BER,P011934,20.134,-13,30,43
41,BER,P012721,25.234,-17,38,55
42,MAD,P003108,22.134,13,51,38
42,MAD,P003583,13.8,4,26,22
42,MAD,P003733,17.35,9,42,33
42,MAD,P005791,19.1,18,50,32
42,MAD,P005928,19.317,23,54,31
42,MAD,P006540,17.183,7,41,34
42,MAD,P009005,17.867,13,42,29
42,MAD,P009213,26.6,14,66,52
42,MAD,P011649,4.75,0,12,12
42,MAD,P012168,1.983,-3,4,7
42,MAD,P013378,18.6,10,41,31
42,MAD,PTGB,21.316,7,46,39
42,RED,P002553,15.316,-10,28,38
42,RED,P004007,8.116,-1,14,15
42,RED,P004866,22.299,-11,44,55
42,RED,P006240,18.782,-12,32,44
42,RED,P006436,9.733,2,22,20
42,RED,P007960,19.582,-13,33,46
42,RED,P009048,21.883,-23,37,60
42,RED,P010612,21.183,-15,41,56
42,RED,P012044,17.632,0,35,35
42,RED,P012786,16.516,-10,23,33
42,RED,PJDR,18.599,-16,33,49
42,RED,PLUO,10.349,-6,18,24
43,PAN,P001926,19.849,-2,45,47
43,PAN,P003842,24.317,15,56,41
43,PAN,P004088,20.1,5,42,37
43,PAN,P005353,15.682,-10,25,35
43,PAN,P009622,23.183,-4,40,44
43,PAN,P011204,32.633,15,70,55
43,PAN,P012712,28.399,0,52,52
43,PAN,P012774,35.832,6,75,69
43,ULK,P002849,23.667,-11,41,52
43,ULK,P004004,20.583,-6,32,38
43,ULK,P006961,19.818,1,44,43
43,ULK,P007182,13.884,9,31,22
43,ULK,P008962,23.9,-11,38,49
43,ULK,P009783,31.067,5,61,56
43,ULK,P009863,35.017,4,70,66
43,ULK,P011205,19.968,-2,44,46
43,ULK,P013396,4.984,-9,6,15
43,ULK,PLMG,7.117,-5,13,18
44,ASV,P000229,22.001,-3,47,50
44,ASV,P002100,19.066,-3,42,45
44,ASV,P003526,22.051,-5,34,39
44,ASV,P007027,29.65,-6,61,67
44,ASV,P010316,13.433,-3,29,32
44,ASV,P010545,32.917,-2,71,73
44,ASV,P013371,16.5,-5,33,38
44,ASV,P013372,21.3,-4,40,44
44,ASV,P013377,1.633,-1,5,6
44,ASV,PKIR,21.449,-3,53,56
44,BAR,P000925,22.785,16,60,44
44,BAR,P002939,24.868,15,56,41
44,BAR,P003196,14.117,-9,28,37
44,BAR,P003478,20.851,12,48,36
44,BAR,P009862,26.652,6,64,58
44,BAR,P009992,16.3,-1,38,39
44,BAR,P010106,15.134,-8,34,42
44,BAR,P011666,7.383,0,17,17
44,BAR,P012745,25.635,7,60,53
44,BAR,P012795,9.018,-3,15,18
44,BAR,P013379,17.267,0,30,30
45,MUN,P004508,21.134,6,47,41
45,MUN,P007056,29.617,10,69,59
45,MUN,P007201,28.184,6,65,59
45,MUN,P007639,10.384,-6,15,21
45,MUN,P010391,30.801,16,75,59
45,MUN,P011224,25.717,-12,46,58
45,MUN,P011244,12.75,-4,19,23
45,MUN,P011987,35.951,5,76,71
45,MUN,P012123,5.467,-1,8,9
45,OLY,P001255,17.916,-8,37,45
45,OLY,P003469,27.416,-11,53,64
45,OLY,P007853,16.65,7,35,28
45,OLY,P007947,20.0,6,43,37
45,OLY,P008811,17.317,-8,34,42
45,OLY,P008829,12.766,7,27,20
45,OLY,P008855,23.349,-11,45,56
45,OLY,P009849,22.083,4,43,39
45,OLY,P012878,22.499,4,46,42
45,OLY,P013380,19.999,-10,37,47
46,BAR,P000925,15.35,9,41,32
46,BAR,P002939,17.683,3,44,41
46,BAR,P003196,16.483,10,40,30
46,BAR,P003478,17.083,11,40,29
46,BAR,P006568,3.75,-1,8,9
46,BAR,P009862,24.95,5,59,54
46,BAR,P009992,16.217,-2,38,40
46,BAR,P010106,22.317,6,53,47
46,BAR,P012745,24.233,4,57,53
46,BAR,P012795,21.75,4,57,53
46,BAR,P013379,20.184,-4,48,52
46,IST,P004887,19.817,-8,37,45
46,IST,P006590,21.55,1,49,48
46,IST,P006640,7.033,-2,13,15
46,IST,P007109,17.1,-5,42,47
46,IST,P009846,29.284,-10,63,73
46,IST,P011078,31.45,-1,71,72
46,IST,P012710,18.1,-7,35,42
46,IST,P012788,20.183,-1,51,52
46,IST,P013363,28.067,-12,60,72
46,IST,P013364,7.416,0,19,19
47,TEL,P004233,0.133,-2,0,2
47,TEL,P005145,2.266,0,6,6
47,TEL,P006835,34.216,-5,73,78
47,TEL,P007519,28.75,-5,53,58
47,TEL,P007855,0.133,-2,0,2
47,TEL,P007990,16.983,-9,32,41
47,TEL,P011214,22.401,-2,42,44
47,TEL,P011219,23.067,2,47,45
47,TEL,P013381,16.467,10,37,27
47,TEL,P013382,31.966,-3,68,71
47,TEL,P013389,23.618,6,52,46
47,ULK,P002849,25.216,14,60,46
47,ULK,P004004,7.933,-2,16,18
47,ULK,P006961,28.05,-4,56,60
47,ULK,P007182,13.566,-8,20,28
47,ULK,P008962,26.601,1,60,59
47,ULK,P009783,11.984,0,29,29
47,ULK,P009863,22.95,-16,36,52
47,ULK,P010560,11.083,12,29,17
47,ULK,P011205,25.117,2,52,50
47,ULK,P013396,16.283,12,38,26
47,ULK,PLMG,11.217,-1,24,25
49,BER,P006251,21.633,-11,41,52
49,BER,P006919,21.834,2,49,47
49,BER,P008062,18.133,-13,36,49
49,BER,P008173,14.1,-2,32,34
49,BER,P008384,28.267,-7,59,66
49,BER,P008780,27.15,-6,54,60
49,BER,P011631,6.783,-1,14,15
49,BER,P012604,31.767,-8,66,74
49,BER,P012721,30.333,1,64,63
49,PRS,P004197,12.583,10,36,26
49,PRS,P004512,12.316,-12,19,31
49,PRS,P007032,12.483,-4,20,24
49,PRS,P010390,25.166,24,68,44
49,PRS,P012608,27.516,13,72,59
49,PRS,P012609,18.466,-14,31,45
49,PRS,P012610,27.383,13,72,59
49,PRS,P012613,27.516,13,72,59
49,PRS,P012640,21.566,9,45,36
49,PRS,P013373,15.0,-7,25,32
50,MAD,P003108,35.865,-11,63,74
50,MAD,P003583,8.233,-10,12,22
50,MAD,P003733,13.4,-5,21,26
50,MAD,P005791,31.766,0,57,57
50,MAD,P005928,23.166,-2,47,49
50,MAD,P006540,25.299,-4,47,51
50,MAD,P009005,32.649,1,62,61
50,MAD,P009213,12.317,-12,13,25
50,MAD,PTGB,17.3,-7,23,30
50,OLY,P001255,15.166,-5,31,36
50,OLY,P003469,29.35,-7,56,63
50,OLY,P003941,7.684,-7,10,17
50,OLY,P007853,24.833,15,48,33
50,OLY,P007947,7.434,-6,9,15
50,OLY,P007982,13.299,13,26,13
50,OLY,P008811,19.999,7,45,38
50,OLY,P008829,17.366,14,33,19
50,OLY,P008855,23.832,15,56,41
50,OLY,P012878,12.316,10,24,14
50,OLY,P013380,28.716,1,57,56
52,BAS,P008072,25.5,7,62,55
52,BAS,P010784,9.866,-4,15,19
52,BAS,P011085,11.451,1,30,29
52,BAS,P011196,14.033,-2,26,28
52,BAS,P011948,29.8,7,71,64
52,BAS,P012058,15.883,8,34,26
52,BAS,P012080,28.95,6,60,54
52,BAS,P012201,24.517,-3,54,57
52,BAS,P012597,15.067,10,42,32
52,BAS,P013367,24.933,-5,46,51
52,MIL,P000796,26.45,3,60,57
52,MIL,P001392,21.6,8,47,39
52,MIL,P001518,10.016,-15,16,31
52,MIL,P006085,17.934,1,36,35
52,MIL,P006509,16.45,-9,32,41
52,MIL,P006721,12.284,3,23,20
52,MIL,P008985,28.966,-6,61,67
52,MIL,P008987,16.983,-3,38,41
52,MIL,P011199,20.55,-11,38,49
52,MIL,P013384,28.767,4,64,60
54,MUN,P004508,13.833,-8,26,34
54,MUN,P005460,18.549,6,40,34
54,MUN,P007056,25.3,2,59,57
54,MUN,P007201,19.95,-6,44,50
54,MUN,P010391,35.516,2,75,73
54,MUN,P011224,32.249,17,73,56
54,MUN,P011244,16.249,4,33,29
54,MUN,P011987,30.066,-6,66,72
54,MUN,P012123,8.283,4,19,15
54,VIR,P001133,31.682,-12,64,76
54,VIR,P001844,11.982,-4,20,24
54,VIR,P002084,20.749,3,48,45
54,VIR,P004888,30.699,-1,66,67
54,VIR,P005738,3.766,1,8,7
54,VIR,P009549,32.349,11,78,67
54,VIR,P012585,31.416,-2,68,70
54,VIR,P012591,4.249,-11,2,13
54,VIR,P013374,18.999,-6,34,40
54,VIR,PBCN,14.099,6,32,26
48,RED,P000848,27.999,14,62,48
48,RED,P002553,9.317,-5,20,25
48,RED,P004007,12.199,-3,26,29
48,RED,P004866,27.332,-7,58,65
48,RED,P006240,22.448,9,52,43
48,RED,P006436,7.534,-6,10,16
48,RED,P007960,5.267,-3,8,11
48,RED,P009048,26.582,0,60,60
48,RED,P010612,23.899,0,50,50
48,RED,P011194,8.234,-6,12,18
48,RED,P012044,14.867,-4,32,36
48,RED,P012786,14.317,1,30,29
48,ZAL,P002329,18.016,-1,34,35
48,ZAL,P002676,27.949,4,64,60
48,ZAL,P003048,17.534,-3,36,39
48,ZAL,P005504,5.849,5,18,13
48,ZAL,P007029,24.099,1,51,50
48,ZAL,P007513,30.767,2,67,65
48,ZAL,P007975,23.531,13,58,45
48,ZAL,P011051,17.133,-5,32,37
48,ZAL,P011983,5.817,-7,10,17
48,ZAL,P012622,21.483,1,42,41
48,ZAL,P012715,7.817,0,18,18
51,ASV,P000229,16.85,-8,27,35
51,ASV,P002100,14.316,0,29,29
51,ASV,P003526,17.867,-14,31,45
51,ASV,P007027,21.117,-25,30,55
51,ASV,P008991,12.984,-7,26,33
51,ASV,P010316,20.466,-3,36,39
51,ASV,P010545,19.199,-18,27,45
51,ASV,P012731,17.616,-18,27,45
51,ASV,P013371,25.332,-16,43,59
51,ASV,P013372,17.816,-2,36,38
51,ASV,P013377,2.467,-2,5,7
51,ASV,PKIR,13.965,-7,23,30
51,PAN,P001926,12.3,6,28,22
51,PAN,P003842,18.867,7,43,36
51,PAN,P004088,23.834,17,60,43
51,PAN,P005161,17.467,10,37,27
51,PAN,P005353,18.401,16,42,26
51,PAN,P007866,21.167,8,48,40
51,PAN,P009622,18.9,11,46,35
51,PAN,P011204,21.684,13,52,39
51,PAN,P011209,7.734,0,11,11
51,PAN,P011221,4.65,0,9,9
51,PAN,P012712,16.917,17,42,25
51,PAN,P012774,18.084,15,42,27
53,MCO,P002581,11.8,-7,21,28
53,MCO,P005844,24.216,5,46,41
53,MCO,P005985,26.283,-5,49,54
53,MCO,P008099,13.716,10,30,20
53,MCO,P009754,19.049,-2,36,38
53,MCO,P011212,24.916,13,52,39
53,MCO,P011226,29.799,11,63,52
53,MCO,P011231,17.65,-5,34,39
53,MCO,P013365,16.8,4,32,28
53,MCO,PLCZ,15.766,1,32,31
53,PAR,P004761,22.866,4,43,39
53,PAR,P006760,33.867,4,69,65
53,PAR,P007632,11.483,-1,19,20
53,PAR,P007870,18.133,-9,28,37
53,PAR,P008232,9.217,-4,17,21
53,PAR,P010781,27.034,4,55,51
53,PAR,P011836,6.583,-5,9,14
53,PAR,P011981,21.867,4,46,42
53,PAR,P012720,20.117,-5,40,45
53,PAR,P013369,23.4,-15,37,52
53,PAR,P013370,5.433,-2,7,9
55,BER,P006251,23.85,-14,44,58
55,BER,P006919,24.667,-1,46,47
55,BER,P007550,14.75,-2,27,29
55,BER,P008062,18.634,-15,32,47
55,BER,P008384,22.983,-13,34,47
55,BER,P008780,24.983,-8,46,54
55,BER,P011631,16.233,-13,24,37
55,BER,P012100,1.55,1,4,3
55,BER,P012604,26.751,-16,43,59
55,BER,P012721,25.599,1,50,49
55,IST,P004887,16.9,5,36,31
55,IST,P006590,18.516,4,37,33
55,IST,P006640,15.734,9,37,28
55,IST,P007109,20.866,-2,40,42
55,IST,P009513,7.033,-5,11,16
55,IST,P009664,16.766,7,37,30
55,IST,P009846,19.934,13,46,33
55,IST,P011078,18.783,11,41,30
55,IST,P012710,17.367,15,41,26
55,IST,P012788,19.75,15,47,32
55,IST,P013363,23.234,9,49,40
55,IST,P013364,5.117,-1,8,9
56,BAR,P000925,19.968,-9,37,46
56,BAR,P002939,18.852,-13,25,38
56,BAR,P003196,14.334,-10,26,36
56,BAR,P003478,16.484,-6,33,39
56,BAR,P006568,5.7,-2,11,13
56,BAR,P009862,24.918,-6,52,58
56,BAR,P009992,13.65,-16,18,34
56,BAR,P010106,21.15,-8,49,57
56,BAR,P011666,8.334,-7,21,28
56,BAR,P012745,24.551,-8,43,51
56,BAR,P012795,10.284,-8,14,22
56,BAR,P013379,21.785,-12,41,53
56,OLY,P001255,17.334,7,34,27
56,OLY,P003469,24.167,15,52,37
56,OLY,P003941,22.085,6,54,48
56,OLY,P007853,14.5,10,32,22
56,OLY,P007947,14.034,2,34,32
56,OLY,P007982,13.15,-1,26,27
56,OLY,P008811,9.8,7,22,15
56,OLY,P008829,20.002,10,53,43
56,OLY,P008855,21.285,24,54,30
56,OLY,P009849,19.535,12,56,44
56,OLY,P012878,8.117,8,19,11
56,OLY,P013380,16.001,5,39,34
57,MIL,P000796,24.818,-1,56,57
57,MIL,P001392,26.301,18,84,66
57,MIL,P001518,22.818,-5,40,45
57,MIL,P006085,22.618,21,72,51
57,MIL,P006509,26.668,18,80,62
57,MIL,P006721,7.35,8,24,16
57,MIL,P008985,17.384,-12,27,39
57,MIL,P008987,25.351,19,77,58
57,MIL,P011199,17.835,-10,27,37
57,MIL,P013384,8.867,-11,8,19
57,VIR,P001133,33.683,1,77,76
57,VIR,P002084,20.3,-23,41,64
57,VIR,P004554,4.5,-7,7,14
57,VIR,P004888,25.516,-21,52,73
57,VIR,P005738,0.5,-3,0,3
57,VIR,P009549,35.85,2,83,81
57,VIR,P011816,0.833,-1,2,3
57,VIR,P012585,21.918,2,65,63
57,VIR,P012591,16.582,-11,23,34
57,VIR,P013374,16.117,9,33,24
57,VIR,PBCN,24.201,7,67,60
58,MAD,P003108,32.533,3,69,66
58,MAD,P003733,20.15,-6,40,46
58,MAD,P005791,33.818,8,72,64
58,MAD,P005928,29.333,1,58,57
58,MAD,P009005,30.55,4,65,61
58,MAD,P009213,13.516,-10,15,25
58,MAD,P011649,7.717,-4,9,13
58,MAD,P012168,2.333,-4,4,8
58,MAD,P013378,11.617,-2,22,24
58,MAD,PTGB,18.433,5,36,31
58,TEL,P005145,11.166,-3,21,24
58,TEL,P006835,33.517,-5,63,68
58,TEL,P007519,28.483,10,58,48
58,TEL,P007990,13.2,-9,25,34
58,TEL,P011214,24.6,-12,43,55
58,TEL,P011219,15.834,12,38,26
58,TEL,P013381,25.567,10,53,43
58,TEL,P013382,28.383,5,52,47
58,TEL,P013389,19.25,-3,42,45
59,PAR,P004761,21.583,-3,43,46
59,PAR,P006591,21.133,-6,39,45
59,PAR,P006760,16.533,-12,27,39
59,PAR,P007632,12.301,-9,20,29
59,PAR,P007870,16.183,-12,30,42
59,PAR,P008232,24.267,-12,39,51
59,PAR,P010781,16.067,-14,25,39
59,PAR,P011836,12.116,1,27,26
59,PAR,P011981,18.984,-5,32,37
59,PAR,P012720,11.6,-8,19,27
59,PAR,P013369,14.85,-3,30,33
59,PAR,P013370,14.383,-2,29,31
59,ULK,P002849,19.582,16,47,31
59,ULK,P004004,16.532,12,41,29
59,ULK,P006961,22.733,13,54,41
59,ULK,P007182,15.767,2,30,28
59,ULK,P008962,29.016,9,59,50
59,ULK,P009783,22.966,4,47,43
59,ULK,P009863,28.733,20,69,49
59,ULK,P010560,13.233,5,36,31
59,ULK,P011205,24.55,3,48,45
59,ULK,P013396,6.883,1,14,13
60,MCO,P002581,4.033,-5,2,7
60,MCO,P005844,19.6,-3,31,34
60,MCO,P005985,30.865,0,50,50
60,MCO,P008099,13.401,-5,16,21
60,MCO,P009754,26.849,8,50,42
60,MCO,P011212,16.05,-11,18,29
60,MCO,P011226,22.049,9,39,30
60,MCO,P011231,29.966,7,50,43
60,MCO,P013365,17.699,-11,21,32
60,MCO,PLCZ,19.483,6,33,27
60,ZAL,P002329,26.016,-6,39,45
60,ZAL,P002676,27.184,8,47,39
60,ZAL,P003048,12.0,-3,20,23
60,ZAL,P005504,14.268,-3,15,18
60,ZAL,P007029,7.584,-2,8,10
60,ZAL,P007513,22.051,5,43,38
60,ZAL,P007975,21.7,-4,24,28
60,ZAL,P011051,13.417,7,28,21
60,ZAL,P011983,20.567,-3,30,33
60,ZAL,P012622,17.301,1,26,25
60,ZAL,P012715,17.917,5,35,30
61,PAN,P001926,26.217,18,58,40
61,PAN,P003842,25.8,9,50,41
61,PAN,P004088,8.166,-6,13,19
61,PAN,P005161,13.733,0,21,21
61,PAN,P005353,8.15,-13,9,22
61,PAN,P007866,6.05,8,22,14
61,PAN,P009622,27.684,-3,50,53
61,PAN,P011204,25.249,7,59,52
61,PAN,P012712,33.817,-4,67,71
61,PAN,P012774,25.134,4,56,52
61,RED,P000848,22.368,-11,34,45
61,RED,P002553,9.183,-4,19,23
61,RED,P004007,8.233,-2,15,17
61,RED,P004866,27.684,-20,39,59
61,RED,P006240,18.084,3,33,30
61,RED,P006436,13.783,6,34,28
61,RED,P009048,18.902,-8,25,33
61,RED,P010612,21.084,2,48,46
61,RED,P011194,12.734,-3,25,28
61,RED,P012044,21.016,8,52,44
61,RED,P012786,11.8,4,24,20
61,RED,PJDR,15.134,5,37,32
62,ASV,P000229,11.783,-5,23,28
62,ASV,P002100,28.051,-3,55,58
62,ASV,P003526,16.5,6,37,31
62,ASV,P007027,27.883,-6,46,52
62,ASV,P008991,8.267,-14,7,21
62,ASV,P010316,14.517,-16,21,37
62,ASV,P010545,25.666,-2,47,49
62,ASV,P012731,16.9,-11,27,38
62,ASV,P013371,13.367,-12,25,37
62,ASV,P013372,20.85,6,46,40
62,ASV,PKIR,16.216,-8,21,29
62,MUN,P004508,28.05,7,60,53
62,MUN,P005460,11.317,20,27,7
62,MUN,P007056,21.466,-1,42,43
62,MUN,P007201,25.299,-7,46,53
62,MUN,P007639,1.483,-1,6,7
62,MUN,P010391,21.049,1,37,36
62,MUN,P011052,7.167,0,21,21
62,MUN,P011224,17.933,19,39,20
62,MUN,P011244,18.95,16,41,25
62,MUN,P011987,30.282,-1,62,63
62,MUN,P012123,15.516,13,33,20
62,MUN,P013368,1.483,-1,6,7
63,BAS,P004058,19.5,2,31,29
63,BAS,P008072,16.067,-2,24,26
63,BAS,P011085,15.933,-1,24,25
63,BAS,P011196,23.916,0,41,41
63,BAS,P011948,30.65,-9,48,57
63,BAS,P012058,4.751,-7,6,13
63,BAS,P012080,30.783,3,51,48
63,BAS,P012201,30.733,1,51,50
63,BAS,P012597,7.667,-6,8,14
63,BAS,P013367,20.0,9,41,32
63,PRS,P004197,12.716,3,23,20
63,PRS,P004512,12.1,6,20,14
63,PRS,P005793,14.65,2,27,25
63,PRS,P007032,17.817,1,30,29
63,PRS,P010390,14.55,-1,23,24
63,PRS,P012608,27.1,-5,40,45
63,PRS,P012609,19.467,7,37,30
63,PRS,P012610,27.1,-5,40,45
63,PRS,P012613,27.65,-1,44,45
63,PRS,P012640,15.35,1,27,26
63,PRS,P013373,11.5,2,24,22
65,BER,P006251,22.534,-3,43,46
65,BER,P006919,22.133,-16,37,53
65,BER,P007025,11.934,-8,16,24
65,BER,P007550,13.7,-11,16,27
65,BER,P008062,20.417,-2,41,43
65,BER,P008211,11.6,-11,9,20
65,BER,P008384,28.601,-25,56,81
65,BER,P008780,26.301,-10,55,65
65,BER,P011631,15.985,-1,34,35
65,BER,P012099,0.0,0,0,0
65,BER,P012100,1.25,0,3,3
65,BER,P012604,25.55,-18,45,63
65,RED,P000848,17.533,15,41,26
65,RED,P002553,9.666,5,15,10
65,RED,P004866,27.266,27,71,44
65,RED,P006240,12.117,8,33,25
65,RED,P006436,13.567,8,31,23
65,RED,P007960,5.1,-4,9,13
65,RED,P009048,30.233,28,79,51
65,RED,P010612,24.417,8,55,47
65,RED,P011194,18.217,8,44,36
65,RED,P012044,9.934,-7,13,20
65,RED,P012786,19.233,14,47,33
65,RED,PJDR,12.717,-5,22,27
66,MAD,P003108,27.582,3,57,54
66,MAD,P003583,15.366,-13,27,40
66,MAD,P003733,16.517,-11,25,36
66,MAD,P005791,21.683,12,45,33
66,MAD,P005928,28.198,-2,55,57
66,MAD,P009005,31.516,-9,62,71
66,MAD,P009213,16.783,-8,25,33
66,MAD,P011649,3.883,-8,6,14
66,MAD,P013378,15.867,-8,30,38
66,MAD,PTGB,22.6,-1,48,49
66,MIL,P000796,31.45,9,71,62
66,MIL,P001392,29.716,15,73,58
66,MIL,P001518,9.5,-8,7,15
66,MIL,P006085,26.049,-13,41,54
66,MIL,P006509,6.4,-3,14,17
66,MIL,P006721,8.832,9,22,13
66,MIL,P008985,18.233,-4,30,34
66,MIL,P008987,38.316,3,77,74
66,MIL,P011064,15.083,17,46,29
66,MIL,P013384,16.416,20,44,24
67,MUN,P004508,28.766,4,47,43
67,MUN,P005460,2.616,5,7,2
67,MUN,P007056,25.1,-5,49,54
67,MUN,P007201,23.649,10,38,28
67,MUN,P007639,3.968,-1,4,5
67,MUN,P010391,28.683,2,56,54
67,MUN,P011224,20.167,4,47,43
67,MUN,P011244,23.417,1,54,53
67,MUN,P011987,31.467,-2,57,59
67,MUN,P012123,10.95,1,24,23
67,MUN,P013368,1.217,-4,2,6
67,ZAL,P002329,28.249,0,60,60
67,ZAL,P002676,22.982,9,40,31
67,ZAL,P003048,23.1,5,47,42
67,ZAL,P003210,6.7,3,16,13
67,ZAL,P005504,7.233,-8,9,17
67,ZAL,P007029,9.084,-4,21,25
67,ZAL,P007513,30.183,1,54,53
67,ZAL,P007975,23.45,-5,47,52
67,ZAL,P012181,0.683,1,2,1
67,ZAL,P012622,23.318,-5,48,53
67,ZAL,P012715,12.118,-7,11,18
67,ZAL,P013403,12.9,-5,15,20
68,PAR,P004761,29.633,2,60,58
68,PAR,P006591,30.7,-4,58,62
68,PAR,P006760,8.3,-9,12,21
68,PAR,P007870,7.133,-9,10,19
68,PAR,P008232,6.65,0,9,9
68,PAR,P010781,33.45,3,61,58
68,PAR,P011050,6.55,-6,10,16
68,PAR,P011981,26.317,12,51,39
68,PAR,P012720,10.467,-8,10,18
68,PAR,P013369,34.283,1,63,62
68,PAR,P013370,6.517,3,11,8
68,PRS,P004197,15.534,6,24,18
68,PRS,P004512,11.033,8,22,14
68,PRS,P005793,12.733,-7,26,33
68,PRS,P007032,13.866,-8,27,35
68,PRS,P010390,21.617,5,38,33
68,PRS,P012608,28.634,13,53,40
68,PRS,P012609,17.449,-2,37,39
68,PRS,P012610,28.584,12,52,40
68,PRS,P012613,28.584,12,52,40
68,PRS,P012640,17.033,-13,31,44
68,PRS,P013373,4.933,-11,8,19
64,IST,P004887,27.466,-9,51,60
64,IST,P006590,24.116,-3,37,40
64,IST,P006640,4.933,-4,4,8
64,IST,P007109,17.082,-10,20,30
64,IST,P009513,3.933,-5,3,8
64,IST,P009664,13.016,-9,19,28
64,IST,P009846,17.983,-10,34,44
64,IST,P011078,31.583,-5,62,67
64,IST,P012710,20.067,0,42,42
64,IST,P012788,12.533,-3,18,21
64,IST,P013363,27.283,-2,55,57
64,MCO,P005763,5.75,-4,6,10
64,MCO,P005844,25.95,6,48,42
64,MCO,P005985,27.133,12,59,47
64,MCO,P008099,16.766,7,31,24
64,MCO,P009754,19.367,3,45,42
64,MCO,P011212,24.865,9,48,39
64,MCO,P011226,23.416,18,56,38
64,MCO,P011231,17.882,-8,32,40
64,MCO,P012515,0.617,-3,0,3
64,MCO,P013365,18.916,13,37,24
64,MCO,PLCZ,19.333,7,43,36
69,ASV,P002100,25.301,15,60,45
69,ASV,P003526,24.034,-20,36,56
69,ASV,P004194,26.051,-14,44,58
69,ASV,P007027,26.383,-14,44,58
69,ASV,P008991,18.234,13,43,30
69,ASV,P010316,4.767,0,6,6
69,ASV,P010545,11.234,-9,14,23
69,ASV,P012731,24.1,0,43,43
69,ASV,P013371,26.6,-7,47,54
69,ASV,PKIR,13.301,16,28,12
69,ULK,P002849,18.283,1,35,34
69,ULK,P002968,15.633,1,29,28
69,ULK,P004004,23.95,7,53,46
69,ULK,P006961,21.316,-8,36,44
69,ULK,P007182,9.333,-1,17,18
69,ULK,P008104,9.883,-10,11,21
69,ULK,P008962,30.499,18,70,52
69,ULK,P009783,25.966,12,51,39
69,ULK,P009863,2.65,-2,2,4
69,ULK,P010560,6.15,-11,3,14
69,ULK,P011205,28.982,15,65,50
69,ULK,P013396,7.35,-2,13,15
70,OLY,P001255,9.917,7,23,16
70,OLY,P003469,28.25,-2,68,70
70,OLY,P003941,20.684,7,50,43
70,OLY,P007853,19.333,3,42,39
70,OLY,P007947,20.0,2,50,48
70,OLY,P007982,16.751,3,35,32
70,OLY,P008811,15.833,1,39,38
70,OLY,P008829,11.75,7,26,19
70,OLY,P008855,23.916,2,61,59
70,OLY,P009849,1.583,-3,3,6
70,OLY,P012878,3.483,-3,5,8
70,OLY,P013380,28.5,1,68,67
70,PAN,P001926,30.501,6,75,69
70,PAN,P003842,26.967,-3,63,66
70,PAN,P004088,17.533,-8,35,43
70,PAN,P005161,8.134,0,13,13
70,PAN,P005353,3.967,-6,4,10
70,PAN,P007866,13.034,-2,26,28
70,PAN,P009622,9.267,-7,19,26
70,PAN,P011204,20.934,-6,46,52
70,PAN,P011209,0.666,2,4,2
70,PAN,P012712,36.034,1,85,84
70,PAN,P012774,32.968,-2,75,77
71,BAR,P000925,24.284,29,59,30
71,BAR,P002939,17.75,17,37,20
71,BAR,P003478,17.083,11,35,24
71,BAR,P006568,11.749,1,22,21
71,BAR,P007464,2.433,1,4,3
71,BAR,P009862,23.35,10,47,37
71,BAR,P009992,16.416,13,44,31
71,BAR,P010106,19.816,5,50,45
71,BAR,P011666,2.433,1,4,3
71,BAR,P012745,25.833,16,57,41
71,BAR,P012795,20.716,11,52,41
71,BAR,P013379,18.132,0,44,44
71,BAS,P007230,23.699,-5,52,57
71,BAS,P008072,11.366,-1,23,24
71,BAS,P008850,2.433,-1,3,4
71,BAS,P011085,9.816,-10,12,22
71,BAS,P011196,23.565,-17,37,54
71,BAS,P011948,23.849,-18,40,58
71,BAS,P012058,9.617,-2,16,18
71,BAS,P012080,18.366,-15,22,37
71,BAS,P012201,31.915,-25,55,80
71,BAS,P012597,15.699,-6,30,36
71,BAS,P013367,29.665,-15,50,65
72,TEL,P006835,33.585,-1,69,70
72,TEL,P007519,29.818,8,65,57
72,TEL,P007990,17.985,-11,31,42
72,TEL,P011214,19.934,-3,42,45
72,TEL,P011219,24.718,-6,43,49
72,TEL,P013250,9.166,1,18,17
72,TEL,P013381,12.034,2,25,23
72,TEL,P013382,28.268,-9,56,65
72,TEL,P013383,13.384,-5,18,23
72,TEL,P013389,11.118,-11,18,29
72,VIR,P001133,24.383,6,48,42
72,VIR,P002084,16.283,-2,36,38
72,VIR,P004554,28.816,11,68,57
72,VIR,P004888,27.633,2,54,52
72,VIR,P006739,23.067,-2,49,51
72,VIR,P009549,27.616,13,62,49
72,VIR,P011816,0.267,-3,0,3
72,VIR,P012585,17.382,11,36,25
72,VIR,P012591,10.033,-4,19,23
72,VIR,P013374,8.499,-1,12,13
72,VIR,PBCN,16.016,4,36,32
73,MUN,P004508,26.25,-20,37,57
73,MUN,P005460,9.633,-22,7,29
73,MUN,P007056,28.067,11,65,54
73,MUN,P007201,26.433,-2,49,51
73,MUN,P010391,32.583,-2,67,69
73,MUN,P011224,14.301,-8,30,38
73,MUN,P011244,23.35,-6,48,54
73,MUN,P011987,32.784,-2,68,70
73,MUN,P012123,5.466,-3,7,10
73,MUN,P013368,1.133,-1,2,3
73,ULK,P002849,23.233,13,60,47
73,ULK,P002968,16.601,3,29,26
73,ULK,P004004,21.384,5,51,46
73,ULK,P006961,23.067,12,53,41
73,ULK,P007182,11.117,6,22,16
73,ULK,P008104,16.617,1,29,28
73,ULK,P008962,29.051,0,63,63
73,ULK,P009783,16.934,-1,34,35
73,ULK,P011205,30.151,11,72,61
73,ULK,P013396,11.85,5,22,17
74,MCO,P004790,13.383,5,34,29
74,MCO,P005844,22.367,2,56,54
74,MCO,P005985,26.217,-5,59,64
74,MCO,P008099,14.483,2,36,34
74,MCO,P009754,22.933,-6,53,59
74,MCO,P011212,27.917,-2,64,66
74,MCO,P011226,22.1,-11,42,53
74,MCO,P011231,20.817,-11,44,55
74,MCO,P013365,12.15,-4,28,32
74,MCO,PLCZ,17.633,-10,34,44
74,RED,P000848,12.4,1,31,30
74,RED,P002553,8.966,2,18,16
74,RED,P004007,3.8,-6,7,13
74,RED,P004866,32.216,13,80,67
74,RED,P006240,8.7,-6,17,23
74,RED,P006436,20.533,13,57,44
74,RED,P009048,27.95,11,70,59
74,RED,P010612,24.499,4,59,55
74,RED,P011194,22.333,12,63,51
74,RED,P012044,16.299,2,38,36
74,RED,P012786,9.233,-11,17,28
74,RED,PJDR,13.066,5,33,28
75,BER,P006251,34.0,3,82,79
75,BER,P007025,32.534,11,81,70
75,BER,P007550,18.8,-16,33,49
75,BER,P008173,33.768,11,86,75
75,BER,P008384,36.185,5,81,76
75,BER,P011626,6.451,-5,11,16
75,BER,P011631,23.367,0,54,54
75,BER,P012099,3.533,-6,5,11
75,BER,P012100,5.916,0,13,13
75,BER,P012604,30.451,17,79,62
75,MIL,P000796,34.634,-3,79,82
75,MIL,P001392,23.484,-18,48,66
75,MIL,P001518,19.001,-8,34,42
75,MIL,P006085,31.067,-2,77,79
75,MIL,P006509,17.618,11,43,32
75,MIL,P006721,5.333,-1,13,14
75,MIL,P008985,31.65,-4,76,80
75,MIL,P008987,35.034,6,87,81
75,MIL,P011064,14.284,-2,24,26
75,MIL,P013384,10.75,3,22,19
75,MIL,P013386,2.15,-2,2,4
76,ASV,P003526,30.417,8,80,72
76,ASV,P004194,27.434,6,76,70
76,ASV,P007027,31.3,-6,74,80
76,ASV,P008991,12.466,-8,16,24
76,ASV,P012263,5.55,-5,7,12
76,ASV,P012731,22.0,3,61,58
76,ASV,P013371,32.15,1,74,73
76,ASV,P013405,19.333,-4,37,41
76,ASV,PKIR,19.35,-5,35,40
76,OLY,P001255,10.001,-5,24,29
76,OLY,P003469,30.001,5,76,71
76,OLY,P003941,23.1,-2,60,62
76,OLY,P007853,15.75,-5,27,32
76,OLY,P007947,13.733,3,39,36
76,OLY,P007982,19.117,1,41,40
76,OLY,P008811,9.267,3,22,19
76,OLY,P008829,10.1,-3,18,21
76,OLY,P008855,27.768,6,74,68
76,OLY,P009849,5.1,-1,5,6
76,OLY,P012878,7.534,1,12,11
76,OLY,P013380,28.534,7,72,65
77,PAN,P001926,12.399,-10,20,30
77,PAN,P003842,30.95,16,78,62
77,PAN,P004088,15.617,10,43,33
77,PAN,P005161,6.567,-5,12,17
77,PAN,P005353,8.95,-7,15,22
77,PAN,P007866,11.0,-12,15,27
77,PAN,P009622,13.7,1,29,28
77,PAN,P011204,28.3,15,73,58
77,PAN,P011209,6.884,2,17,15
77,PAN,P012712,29.0,18,78,60
77,PAN,P012774,36.633,2,85,83
77,TEL,P006835,34.85,-4,78,82
77,TEL,P007519,26.984,-12,56,68
77,TEL,P011193,22.117,-7,49,56
77,TEL,P011219,29.15,-7,61,68
77,TEL,P013250,11.7,2,28,26
77,TEL,P013381,15.583,5,31,26
77,TEL,P013382,30.333,-10,66,76
77,TEL,P013383,12.067,1,27,26
77,TEL,P013389,17.216,2,39,37
78,BAS,P004058,7.933,-9,10,19
78,BAS,P007230,25.599,4,53,49
78,BAS,P008072,28.682,5,58,53
78,BAS,P011085,14.282,-2,29,31
78,BAS,P011196,10.783,-9,23,32
78,BAS,P011948,20.665,-17,37,54
78,BAS,P012058,7.833,0,19,19
78,BAS,P012080,17.115,-1,39,40
78,BAS,P012201,28.099,1,62,61
78,BAS,P012597,13.117,9,30,21
78,BAS,P013367,25.882,-6,60,66
78,IST,P004887,21.866,16,59,43
78,IST,P006590,27.55,-1,64,65
78,IST,P006640,9.817,7,22,15
78,IST,P007109,13.45,2,33,31
78,IST,P009513,0.183,-3,0,3
78,IST,P009664,13.116,6,32,26
78,IST,P009846,27.483,17,70,53
78,IST,P011078,26.933,-1,60,61
78,IST,P012710,13.617,-6,24,30
78,IST,P012788,17.951,-8,30,38
78,IST,P013363,16.101,-2,29,31
78,IST,P013364,11.933,-2,22,24
79,MAD,P003108,30.251,6,71,65
79,MAD,P003583,16.517,1,33,32
79,MAD,P003733,16.334,2,36,34
79,MAD,P005791,23.051,15,65,50
79,MAD,P005928,23.934,19,70,51
79,MAD,P009005,22.417,10,57,47
79,MAD,P009213,19.117,9,49,40
79,MAD,P011649,7.267,3,19,16
79,MAD,P012168,0.433,-4,0,4
79,MAD,P012199,0.95,-4,0,4
79,MAD,P013378,22.367,0,50,50
79,MAD,PTGB,17.367,3,40,37
79,VIR,P001133,24.901,-11,55,66
79,VIR,P001844,8.584,-7,21,28
79,VIR,P002084,15.1,-1,31,32
79,VIR,P004554,23.55,-7,54,61
79,VIR,P004888,25.985,2,63,61
79,VIR,P006739,21.416,-2,43,45
79,VIR,P009549,24.749,-12,56,68
79,VIR,P012585,12.217,-3,25,28
79,VIR,P012591,16.919,-4,33,37
79,VIR,P013374,16.451,-5,32,37
79,VIR,PBCN,10.133,-10,17,27
80,BAR,P000925,25.752,0,53,53
80,BAR,P002939,22.501,14,55,41
80,BAR,P003478,14.584,-1,34,35
80,BAR,P006568,3.066,-4,7,11
80,BAR,P007464,0.733,-3,0,3
80,BAR,P009862,31.467,7,73,66
80,BAR,P009992,9.6,0,21,21
80,BAR,P010106,15.434,-3,27,30
80,BAR,P012745,29.268,14,70,56
80,BAR,P012795,26.417,7,51,44
80,BAR,P013379,21.183,9,44,35
80,PAR,P006591,17.348,-12,27,39
80,PAR,P006760,19.465,-19,33,52
80,PAR,P007870,16.832,-5,32,37
80,PAR,P008232,17.632,7,42,35
80,PAR,P010781,18.831,-20,31,51
80,PAR,P011981,26.165,1,53,52
80,PAR,P012167,19.182,8,47,39
80,PAR,P012720,16.616,-13,31,44
80,PAR,P013369,32.232,-7,60,67
80,PAR,P013370,15.682,20,39,19
81,PRS,P004197,14.351,5,26,21
81,PRS,P004512,9.334,1,18,17
81,PRS,P005793,12.733,-3,31,34
81,PRS,P007032,14.516,-5,31,36
81,PRS,P010390,16.267,6,29,23
81,PRS,P012608,28.951,12,57,45
81,PRS,P012609,19.817,-6,45,51
81,PRS,P012610,28.951,12,57,45
81,PRS,P012613,28.551,16,56,40
81,PRS,P012640,16.384,-2,41,43
81,PRS,P013373,10.15,-6,24,30
81,ZAL,P002329,19.299,-5,31,36
81,ZAL,P002676,30.765,1,63,62
81,ZAL,P003048,12.699,-11,23,34
81,ZAL,P005504,12.666,3,18,15
81,ZAL,P007029,10.199,-8,13,21
81,ZAL,P007513,24.098,-7,49,56
81,ZAL,P007975,27.6,7,59,52
81,ZAL,P011983,16.699,7,44,37
81,ZAL,P012622,26.783,-8,59,67
81,ZAL,P012715,3.85,-1,5,6
81,ZAL,P013403,15.332,-8,21,29
82,ASV,P002100,22.983,4,49,45
82,ASV,P003526,26.767,-3,51,54
82,ASV,P004194,23.384,5,47,42
82,ASV,P007027,34.267,0,70,70
82,ASV,P008991,2.417,-2,2,4
82,ASV,P010545,11.783,-4,22,26
82,ASV,P012731,23.4,1,44,43
82,ASV,P013371,20.433,3,35,32
82,ASV,P013405,18.933,4,37,33
82,ASV,PKIR,15.633,7,28,21
82,RED,P002553,9.2,-3,16,19
82,RED,P004866,29.583,-6,57,63
82,RED,P006240,4.134,-9,2,11
82,RED,P006436,12.666,-1,22,23
82,RED,P007960,5.6,-5,4,9
82,RED,P009048,26.784,-4,50,54
82,RED,P010612,27.65,0,49,49
82,RED,P011194,25.566,7,54,47
82,RED,P012044,22.85,-2,42,44
82,RED,P012786,10.167,4,20,16
82,RED,PJDR,17.85,0,37,37
82,RED,PLUO,7.95,4,17,13
83,BAS,P004058,6.532,-7,11,18
83,BAS,P007230,29.682,-14,49,63
83,BAS,P008072,7.267,-14,5,19
83,BAS,P011085,17.082,2,41,39
83,BAS,P011196,30.265,-2,61,63
83,BAS,P011948,14.949,-13,25,38
83,BAS,P012058,6.716,-8,10,18
83,BAS,P012080,24.266,1,48,47
83,BAS,P012201,28.982,0,59,59
83,BAS,P012597,23.116,-4,45,49
83,BAS,P013367,11.133,-1,21,22
83,MCO,P004790,18.251,3,41,38
83,MCO,P005844,18.483,9,42,33
83,MCO,P005985,26.134,16,56,40
83,MCO,P008099,17.734,0,32,32
83,MCO,P009754,22.684,12,55,43
83,MCO,P011212,22.001,5,55,50
83,MCO,P011226,26.067,6,59,53
83,MCO,P011231,25.101,5,50,45
83,MCO,P013365,9.95,2,19,17
83,MCO,PLCZ,13.6,2,26,24
84,BER,P006251,23.099,-31,45,76
84,BER,P007025,23.833,-20,49,69
84,BER,P007550,15.75,-1,36,37
84,BER,P008173,25.349,-22,54,76
84,BER,P008384,23.933,-13,54,67
84,BER,P011626,9.367,-3,22,25
84,BER,P011631,20.783,-13,40,53
84,BER,P011934,21.949,-12,52,64
84,BER,P012099,2.367,0,8,8
84,BER,P012100,11.366,-15,23,38
84,BER,P012604,22.199,-15,47,62
84,MUN,P004508,22.949,41,81,40
84,MUN,P005460,5.3,5,12,7
84,MUN,P007056,20.15,19,64,45
84,MUN,P007201,17.283,28,60,32
84,MUN,P007639,9.784,-6,25,31
84,MUN,P010391,20.9,28,73,45
84,MUN,P011052,17.233,5,42,37
84,MUN,P011224,20.849,-5,45,50
84,MUN,P011244,13.482,13,36,23
84,MUN,P011987,22.349,33,73,40
84,MUN,P012123,15.717,-15,31,46
84,MUN,P013368,13.999,-1,33,34
85,IST,P004887,24.866,11,45,34
85,IST,P006590,28.516,-1,45,46
85,IST,P006640,7.282,3,17,14
85,IST,P007109,17.398,2,36,34
85,IST,P009664,7.084,4,14,10
85,IST,P009846,22.5,10,45,35
85,IST,P011078,31.634,7,55,48
85,IST,P012710,15.517,4,24,20
85,IST,P012788,15.133,-1,29,30
85,IST,P013363,15.199,4,36,32
85,IST,P013364,14.866,7,24,17
85,MAD,P003108,36.484,-10,60,70
85,MAD,P003583,8.95,-3,19,22
85,MAD,P003733,24.233,3,43,40
85,MAD,P005791,31.05,-7,45,52
85,MAD,P005928,34.9,-6,58,64
85,MAD,P009005,25.367,-4,43,47
85,MAD,P009213,10.967,-12,13,25
85,MAD,P011247,0.083,0,0,0
85,MAD,P011649,5.033,-2,6,8
85,MAD,P013378,5.999,-8,4,12
85,MAD,PTGB,16.934,-1,29,30
86,OLY,P001255,9.301,-5,16,21
86,OLY,P003469,28.651,11,75,64
86,OLY,P003941,21.417,7,54,47
86,OLY,P007853,3.434,-10,4,14
86,OLY,P007947,31.851,6,80,74
86,OLY,P007982,21.501,5,50,45
86,OLY,P008811,12.534,9,31,22
86,OLY,P008829,11.535,-6,21,27
86,OLY,P008855,18.267,11,48,37
86,OLY,P009849,6.567,-6,9,15
86,OLY,P012878,6.034,-13,9,22
86,OLY,P013380,28.918,6,73,67
86,TEL,P005145,6.0,1,12,11
86,TEL,P006835,29.934,-7,70,77
86,TEL,P007519,20.551,-3,49,52
86,TEL,P007990,6.684,0,16,16
86,TEL,P011193,24.385,6,63,57
86,TEL,P011219,22.518,2,53,51
86,TEL,P013250,16.934,-8,31,39
86,TEL,P013381,15.384,-12,27,39
86,TEL,P013382,28.069,12,73,61
86,TEL,P013383,17.934,-7,38,45
86,TEL,P013389,11.617,1,23,22
87,ULK,P002849,18.45,12,36,24
87,ULK,P002968,15.684,7,32,25
87,ULK,P002969,0.333,1,1,0
87,ULK,P004004,29.767,1,55,54
87,ULK,P006961,14.734,-1,21,22
87,ULK,P007182,8.25,-7,13,20
87,ULK,P008104,23.816,8,41,33
87,ULK,P008962,34.383,1,57,56
87,ULK,P009783,26.383,-1,45,46
87,ULK,P010560,22.066,13,48,35
87,ULK,P013396,6.134,1,11,10
87,ZAL,P002329,23.766,-8,38,46
87,ZAL,P002676,28.349,-11,43,54
87,ZAL,P003048,18.616,-5,27,32
87,ZAL,P003210,11.366,-4,17,21
87,ZAL,P005504,11.25,-3,17,20
87,ZAL,P007029,7.866,-9,9,18
87,ZAL,P007513,14.366,-1,19,20
87,ZAL,P007975,22.883,-2,42,44
87,ZAL,P011983,12.066,-1,24,25
87,ZAL,P012622,22.334,11,41,30
87,ZAL,P012715,2.4,0,5,5
87,ZAL,P013403,24.733,-2,43,45
88,BAR,P000925,19.4,-2,44,46
88,BAR,P002939,15.868,-10,30,40
88,BAR,P003196,13.75,-5,30,35
88,BAR,P003478,21.3,-8,38,46
88,BAR,P007464,18.7,-8,49,57
88,BAR,P009862,25.983,-5,58,63
88,BAR,P009992,9.85,-6,22,28
88,BAR,P010106,23.999,-4,57,61
88,BAR,P011666,5.733,-5,13,18
88,BAR,P012745,32.617,-7,75,82
88,BAR,P013379,12.8,-20,19,39
88,PRS,P004197,12.95,4,29,25
88,PRS,P004512,11.15,2,30,28
88,PRS,P005793,15.683,-1,40,41
88,PRS,P007032,19.066,10,52,42
88,PRS,P010390,16.332,0,32,32
88,PRS,P012608,25.383,18,66,48
88,PRS,P012609,22.933,8,66,58
88,PRS,P012610,24.066,13,61,48
88,PRS,P012611,1.1,-2,2,4
88,PRS,P012613,24.316,17,63,46
88,PRS,P012640,19.649,-1,49,50
88,PRS,P013373,7.367,12,25,13
89,MIL,P000796,29.717,3,67,64
89,MIL,P001392,21.717,5,51,46
89,MIL,P001518,26.084,16,58,42
89,MIL,P006085,9.517,-6,17,23
89,MIL,P006721,2.35,-4,2,6
89,MIL,P008985,27.184,-1,51,52
89,MIL,P008987,28.118,14,64,50
89,MIL,P011064,25.034,9,60,51
89,MIL,P013384,19.417,5,43,38
89,MIL,P013385,6.817,-2,19,21
89,MIL,P013386,4.05,-4,8,12
89,PAR,P006591,21.383,-2,44,46
89,PAR,P006760,22.166,0,45,45
89,PAR,P007870,24.133,-17,44,61
89,PAR,P008232,23.433,-6,45,51
89,PAR,P010781,19.982,-10,38,48
89,PAR,P011981,15.733,8,35,27
89,PAR,P012167,9.966,-6,20,26
89,PAR,P012720,34.116,-4,72,76
89,PAR,P013369,22.566,5,50,45
89,PAR,P013370,6.517,-3,12,15
90,PAN,P001926,28.517,-1,58,59
90,PAN,P003842,28.633,4,52,48
90,PAN,P004088,7.917,-2,9,11
90,PAN,P005161,22.717,1,38,37
90,PAN,P005353,10.667,5,30,25
90,PAN,P007866,19.1,1,33,32
90,PAN,P011204,28.116,10,67,57
90,PAN,P011209,6.167,6,12,6
90,PAN,P012712,21.6,0,49,49
90,PAN,P012774,26.566,1,62,61
90,VIR,P001133,31.351,-3,63,66
90,VIR,P001844,9.633,8,23,15
90,VIR,P002084,19.999,-5,38,43
90,VIR,P004554,13.016,3,27,24
90,VIR,P004888,33.45,0,65,65
90,VIR,P006739,29.534,-6,59,65
90,VIR,P009549,34.866,-8,62,70
90,VIR,P012585,2.05,-1,3,4
90,VIR,P012591,2.617,-3,2,5
90,VIR,P013374,13.917,-3,26,29
90,VIR,PBCN,9.567,-7,17,24
91,ULK,P002849,8.451,-9,9,18
91,ULK,P002968,19.617,9,45,36
91,ULK,P004004,23.367,12,57,45
91,ULK,P006961,26.184,4,55,51
91,ULK,P007182,17.534,-3,36,39
91,ULK,P008104,21.383,-2,45,47
91,ULK,P008962,30.717,7,68,61
91,ULK,P009783,31.967,14,76,62
91,ULK,P010560,10.251,-9,18,27
91,ULK,P013396,10.534,-3,21,24
91,VIR,P001133,33.334,-7,66,73
91,VIR,P001844,17.933,-6,32,38
91,VIR,P002084,12.101,5,27,22
91,VIR,P004554,27.967,-3,58,61
91,VIR,P004888,29.268,-6,64,70
91,VIR,P006739,16.901,-3,31,34
91,VIR,P009549,27.616,-11,54,65
91,VIR,P012585,20.052,6,51,45
91,VIR,P013374,5.55,1,11,10
91,VIR,PBCN,9.283,4,16,12
92,ASV,P002100,23.184,-2,63,65
92,ASV,P003526,25.55,6,64,58
92,ASV,P004194,26.75,-14,58,72
92,ASV,P007027,32.917,-4,81,85
92,ASV,P008991,3.617,-1,9,10
92,ASV,P010545,17.75,-2,45,47
92,ASV,P012731,23.75,0,60,60
92,ASV,P013371,22.733,-17,38,55
92,ASV,P013405,11.999,-12,19,31
92,ASV,PKIR,11.75,-9,23,32
92,MCO,P005844,20.967,14,61,47
92,MCO,P005985,27.668,-2,67,69
92,MCO,P008099,22.167,19,68,49
92,MCO,P009754,16.468,1,38,37
92,MCO,P011212,26.252,17,69,52
92,MCO,P011226,22.918,-4,59,63
92,MCO,P011231,34.268,8,86,78
92,MCO,P013365,10.684,5,25,20
92,MCO,PLCZ,18.618,-3,42,45
93,PAR,P006591,25.533,19,58,39
93,PAR,P006760,23.083,6,47,41
93,PAR,P007870,16.816,5,32,27
93,PAR,P008232,5.85,-6,11,17
93,PAR,P010781,29.917,14,70,56
93,PAR,P011836,27.933,17,61,44
93,PAR,P011981,23.184,7,57,50
93,PAR,P012720,20.467,-6,45,51
93,PAR,P013369,27.217,4,64,60
93,RED,P000848,20.866,-11,39,50
93,RED,P002553,9.383,-11,10,21
93,RED,P004866,25.65,-7,48,55
93,RED,P006240,5.333,0,14,14
93,RED,P006436,19.6,4,46,42
93,RED,P009048,28.1,-16,51,67
93,RED,P010612,18.467,-1,38,39
93,RED,P011194,25.284,-1,53,54
93,RED,P012044,16.15,0,40,40
93,RED,P012786,18.35,-9,28,37
93,RED,PJDR,10.5,-7,17,24
93,RED,PLUO,2.317,-1,1,2
94,BAS,P004058,5.366,-6,8,14
94,BAS,P007230,34.768,-19,59,78
94,BAS,P008072,8.467,-14,11,25
94,BAS,P008850,11.65,-6,19,25
94,BAS,P011085,22.217,2,46,44
94,BAS,P011196,15.833,-2,29,31
94,BAS,P011948,23.184,-14,43,57
94,BAS,P012058,5.667,-7,11,18
94,BAS,P012080,25.451,-21,40,61
94,BAS,P012201,15.317,-8,24,32
94,BAS,P013367,32.085,-20,55,75
94,OLY,P001255,20.0,15,45,30
94,OLY,P003941,20.083,13,47,34
94,OLY,P007853,19.416,21,51,30
94,OLY,P007947,21.934,5,48,43
94,OLY,P007982,23.25,16,51,35
94,OLY,P008811,16.517,8,36,28
94,OLY,P008829,30.317,21,69,48
94,OLY,P008855,10.55,0,23,23
94,OLY,P010392,8.05,9,20,11
94,OLY,P012878,3.4,2,9,7
94,OLY,P013380,26.483,5,61,56
95,MIL,P000796,33.349,15,85,70
95,MIL,P001392,21.349,-3,45,48
95,MIL,P001518,8.449,-2,18,20
95,MIL,P006085,10.933,-7,21,28
95,MIL,P006509,1.583,-2,2,4
95,MIL,P006721,2.616,0,4,4
95,MIL,P007831,25.8,21,71,50
95,MIL,P008987,33.634,16,86,70
95,MIL,P011064,28.266,19,74,55
95,MIL,P013384,25.2,8,65,57
95,MIL,P013385,8.816,-5,19,24
95,TEL,P005145,4.049,2,10,8
95,TEL,P006835,32.016,-13,64,77
95,TEL,P007519,25.784,-10,49,59
95,TEL,P007990,20.066,-2,44,46
95,TEL,P011202,12.033,2,28,26
95,TEL,P011219,22.015,1,54,53
95,TEL,P013250,18.816,-8,43,51
95,TEL,P013381,14.583,-1,35,36
95,TEL,P013382,30.083,-14,63,77
95,TEL,P013383,20.55,-17,40,57
97,IST,P004887,25.184,-6,58,64
97,IST,P006372,5.383,-3,8,11
97,IST,P006590,27.315,-11,56,67
97,IST,P007109,13.3,-11,20,31
97,IST,P009513,4.717,-5,7,12
97,IST,P009664,19.166,1,45,44
97,IST,P009846,30.833,4,73,69
97,IST,P011078,35.282,-4,77,81
97,IST,P012710,7.533,1,19,18
97,IST,P012788,13.849,-4,25,29
97,IST,P013363,16.55,-8,31,39
97,IST,P013364,0.883,1,1,0
97,PRS,P004197,13.683,19,32,13
97,PRS,P004512,8.683,1,23,22
97,PRS,P005793,12.45,-8,25,33
97,PRS,P007032,13.933,-7,29,36
97,PRS,P010390,21.95,14,52,38
97,PRS,P012608,27.55,17,68,51
97,PRS,P012609,23.15,-6,55,61
97,PRS,P012610,27.55,17,68,51
97,PRS,P012613,27.467,17,68,51
97,PRS,P012640,14.217,-13,27,40
97,PRS,P013373,9.367,-6,18,24
96,BER,P006251,20.6,-6,51,57
96,BER,P007025,20.117,-12,38,50
96,BER,P007550,19.484,3,42,39
96,BER,P008173,23.167,-18,50,68
96,BER,P008211,19.918,-5,44,49
96,BER,P008384,28.267,-15,61,76
96,BER,P011626,8.65,3,15,12
96,BER,P011631,19.051,-5,38,43
96,BER,P011934,22.75,8,45,37
96,BER,P012100,2.317,1,3,2
96,BER,P012604,15.684,-24,33,57
96,MAD,P003108,23.8,31,70,39
96,MAD,P003583,19.4,-4,44,48
96,MAD,P003733,18.265,8,51,43
96,MAD,P005791,20.599,18,54,36
96,MAD,P005928,19.715,22,63,41
96,MAD,P006540,18.267,-3,37,40
96,MAD,P009005,20.383,2,46,44
96,MAD,P009213,11.9,-9,17,26
96,MAD,P011247,16.184,4,32,28
96,MAD,P011649,8.417,-3,16,19
96,MAD,P013378,17.066,10,48,38
96,MAD,PTGB,5.999,-6,12,18
98,PAN,P001926,22.501,-12,39,51
98,PAN,P003842,23.766,-6,40,46
98,PAN,P005161,20.217,-2,42,44
98,PAN,P005353,16.034,-3,35,38
98,PAN,P007866,7.501,-10,14,24
98,PAN,P009622,26.117,-5,46,51
98,PAN,P011204,27.132,-12,53,65
98,PAN,P011209,4.35,5,10,5
98,PAN,P012712,24.966,5,49,44
98,PAN,P012774,27.416,5,57,52
98,ZAL,P002329,14.433,-8,29,37
98,ZAL,P002676,20.316,-1,42,43
98,ZAL,P003048,16.866,-3,33,36
98,ZAL,P005504,12.199,7,29,22
98,ZAL,P007029,22.033,9,47,38
98,ZAL,P007513,22.466,4,44,40
98,ZAL,P007975,18.5,-8,31,39
98,ZAL,P011051,10.934,3,22,19
98,ZAL,P012622,24.599,12,53,41
98,ZAL,P012715,13.216,9,31,22
98,ZAL,P013403,24.433,11,59,48
99,BAR,P000925,18.183,-9,34,43
99,BAR,P002939,19.2,-9,34,43
99,BAR,P003196,13.418,-12,26,38
99,BAR,P003478,11.9,-5,22,27
99,BAR,P006568,8.4,-1,18,19
99,BAR,P007464,18.934,-6,38,44
99,BAR,P009862,19.734,-15,35,50
99,BAR,P009992,15.833,-1,37,38
99,BAR,P010106,20.418,-11,44,55
99,BAR,P011666,4.434,-6,6,12
99,BAR,P012745,27.05,-14,56,70
99,BAR,P012795,22.501,-21,40,61
99,MUN,P004508,28.484,17,75,58
99,MUN,P005460,12.817,5,27,22
99,MUN,P007056,21.2,19,57,38
99,MUN,P007201,22.084,8,55,47
99,MUN,P007639,3.85,-2,10,12
99,MUN,P007929,16.067,5,41,36
99,MUN,P010391,22.217,11,51,40
99,MUN,P011224,20.301,12,51,39
99,MUN,P011244,17.434,17,43,26
99,MUN,P011987,29.784,25,74,49
99,MUN,P012123,3.15,-4,8,12
99,MUN,P013368,2.617,-3,8,11
100,BAS,P004058,2.767,-4,0,4
100,BAS,P007230,21.718,-7,36,43
100,BAS,P008072,3.901,-4,2,6
100,BAS,P011085,27.3,25,62,37
100,BAS,P011196,33.517,16,77,61
100,BAS,P011948,21.134,-9,41,50
100,BAS,P012058,4.05,-5,6,11
100,BAS,P012201,29.517,14,66,52
100,BAS,P012597,23.601,21,51,30
100,BAS,P013367,32.5,18,74,56
100,ZAL,P002329,13.618,-12,15,27
100,ZAL,P002676,25.902,11,52,41
100,ZAL,P003048,7.749,-9,11,20
100,ZAL,P003210,2.75,-6,0,6
100,ZAL,P005504,11.934,5,21,16
100,ZAL,P007029,24.25,2,52,50
100,ZAL,P007513,27.767,-3,59,62
100,ZAL,P007975,16.818,-8,26,34
100,ZAL,P011051,20.319,-9,38,47
100,ZAL,P012622,19.769,-10,29,39
100,ZAL,P012715,3.983,-1,9,10
100,ZAL,P013403,25.151,-25,38,63
101,BER,P006251,17.665,-19,36,55
101,BER,P007025,24.45,-9,49,58
101,BER,P007550,15.499,-7,31,38
101,BER,P008173,24.417,-8,54,62
101,BER,P008211,18.133,-7,41,48
101,BER,P008384,25.266,-18,48,66
101,BER,P011631,15.599,-1,40,41
101,BER,P011934,24.75,-5,51,56
101,BER,P012604,24.166,-16,53,69
101,BER,P013386,10.05,0,22,22
101,TEL,P006835,28.882,25,78,53
101,TEL,P007519,25.801,8,64,56
101,TEL,P007990,21.366,20,59,39
101,TEL,P011202,14.7,-4,34,38
101,TEL,P011214,14.699,-4,31,35
101,TEL,P011219,15.534,-2,38,40
101,TEL,P011433,1.133,-2,2,4
101,TEL,P013250,22.765,12,63,51
101,TEL,P013381,16.249,4,35,31
101,TEL,P013382,18.666,13,55,42
101,TEL,P013383,20.2,20,56,36
102,PRS,P004197,13.516,-6,21,27
102,PRS,P004512,10.633,3,22,19
102,PRS,P005793,12.784,2,26,24
102,PRS,P007032,17.667,-6,31,37
102,PRS,P010390,20.933,-6,37,43
102,PRS,P012608,27.133,1,55,54
102,PRS,P012609,16.017,7,38,31
102,PRS,P012610,27.216,1,55,54
102,PRS,P012613,27.216,1,55,54
102,PRS,P012640,18.468,12,43,31
102,PRS,P013373,8.417,6,22,16
102,VIR,P001133,21.6,3,39,36
102,VIR,P001844,12.367,-9,17,26
102,VIR,P002084,12.533,-10,20,30
102,VIR,P004554,20.815,-7,40,47
102,VIR,P004888,31.032,6,72,66
102,VIR,P005738,10.416,-1,25,26
102,VIR,P006739,22.132,3,46,43
102,VIR,P009549,24.016,8,59,51
102,VIR,P012585,19.067,-4,34,38
102,VIR,P012591,2.5,-3,2,5
102,VIR,P013374,14.35,6,27,21
102,VIR,PBCN,9.167,-7,9,16
103,OLY,P001255,16.034,-30,18,48
103,OLY,P003941,25.934,-17,35,52
103,OLY,P007853,14.8,-9,20,29
103,OLY,P007947,28.417,3,56,53
103,OLY,P007982,15.934,-13,18,31
103,OLY,P008811,13.917,9,33,24
103,OLY,P008829,24.067,22,54,32
103,OLY,P008855,30.917,0,60,60
103,OLY,P009849,4.734,-6,6,12
103,OLY,P013380,25.251,1,50,49
103,PAR,P004761,28.884,26,67,41
103,PAR,P006591,23.717,5,47,42
103,PAR,P006760,16.018,-10,26,36
103,PAR,P007870,18.183,-1,38,39
103,PAR,P008232,5.284,-3,5,8
103,PAR,P010781,30.967,21,64,43
103,PAR,P011050,10.417,11,22,11
103,PAR,P011836,12.734,-20,16,36
103,PAR,P011981,16.234,3,31,28
103,PAR,P012720,5.933,-12,9,21
103,PAR,P013369,31.634,20,65,45
107,BAR,P000925,38.167,-9,64,73
107,BAR,P002939,26.5,-7,42,49
107,BAR,P003196,3.35,-2,7,9
107,BAR,P003478,25.834,-6,40,46
107,BAR,P006568,8.483,4,19,15
107,BAR,P007464,14.417,4,31,27
107,BAR,P009862,34.516,-3,59,62
107,BAR,P009992,19.683,-5,38,43
107,BAR,P010106,11.967,9,28,19
107,BAR,P012745,35.583,-11,59,70
107,BAR,P012795,27.683,-4,56,60
107,BAR,P013505,3.817,-5,7,12
107,MAD,P003108,35.749,9,68,59
107,MAD,P003583,13.283,-16,13,29
107,MAD,P003733,22.8,6,41,35
107,MAD,P005791,36.45,20,81,61
107,MAD,P005928,44.833,14,89,75
107,MAD,P006540,31.399,3,65,62
107,MAD,P009005,27.316,2,58,56
107,MAD,P011247,5.033,-7,8,15
107,MAD,P013378,16.582,4,27,23
107,MAD,PTGB,16.55,0,35,35
104,MIL,P000796,29.215,11,72,61
104,MIL,P001392,21.965,6,51,45
104,MIL,P001518,23.15,4,54,50
104,MIL,P006085,18.982,12,45,33
104,MIL,P006721,0.05,0,0,0
104,MIL,P007831,25.499,-2,59,61
104,MIL,P008987,29.149,1,70,69
104,MIL,P011064,20.549,-6,46,52
104,MIL,P011941,4.366,-1,5,6
104,MIL,P013384,17.099,9,38,29
104,MIL,P013385,9.966,-4,15,19
104,ULK,P002849,14.099,13,41,28
104,ULK,P002968,9.966,-4,15,19
104,ULK,P004004,17.115,-15,30,45
104,ULK,P006961,30.549,-11,57,68
104,ULK,P007182,13.933,4,45,41
104,ULK,P008104,27.316,3,63,60
104,ULK,P008962,30.632,-10,56,66
104,ULK,P009783,15.415,-3,40,43
104,ULK,P009863,29.966,-9,54,63
104,ULK,P010560,4.933,-4,4,8
104,ULK,P013396,6.066,6,20,14
105,MUN,P004508,21.45,-14,45,59
105,MUN,P005460,11.617,2,22,20
105,MUN,P007056,24.016,-28,39,67
105,MUN,P007201,15.717,-15,29,44
105,MUN,P007639,11.367,2,26,24
105,MUN,P007929,24.15,-11,46,57
105,MUN,P010391,13.417,-20,19,39
105,MUN,P011224,21.35,-8,40,48
105,MUN,P011244,24.283,-9,48,57
105,MUN,P011987,19.233,-19,35,54
105,MUN,P012123,6.7,0,18,18
105,MUN,P013368,6.7,0,18,18
105,RED,P002553,13.717,-2,34,36
105,RED,P004007,19.101,25,53,28
105,RED,P004866,27.667,24,71,47
105,RED,P006240,5.666,-1,9,10
105,RED,P006436,13.05,-14,24,38
105,RED,P009048,21.501,21,57,36
105,RED,P010612,20.267,2,48,46
105,RED,P011194,22.235,25,61,36
105,RED,P012044,18.5,3,44,41
105,RED,P012786,26.284,26,67,41
105,RED,PJDR,6.317,12,22,10
105,RED,PLUO,5.7,-1,15,16
106,MCO,P005844,17.382,4,37,33
106,MCO,P005985,33.116,2,74,72
106,MCO,P008099,15.733,-9,25,34
106,MCO,P008161,0.133,3,3,0
106,MCO,P009754,26.5,1,63,62
106,MCO,P011212,26.233,1,60,59
106,MCO,P011226,30.415,15,78,63
106,MCO,P011231,18.966,0,42,42
106,MCO,P013365,16.917,4,42,38
106,MCO,PLCZ,14.6,-6,31,37
106,PAN,P001926,26.234,-5,60,65
106,PAN,P003842,34.884,2,78,76
106,PAN,P004088,20.116,-2,43,45
106,PAN,P005161,4.883,-5,12,17
106,PAN,P005353,5.116,-5,10,15
106,PAN,P007866,10.833,-7,20,27
106,PAN,P009622,20.083,3,40,37
106,PAN,P011204,31.45,-8,68,76
106,PAN,P012712,19.784,11,48,37
106,PAN,P012774,26.617,1,61,60
108,ASV,P002100,16.433,21,41,20
108,ASV,P003526,18.0,7,39,32
108,ASV,P004194,19.283,11,53,42
108,ASV,P007027,26.0,-13,58,71
108,ASV,P008991,4.8,-3,12,15
108,ASV,P010316,7.05,-9,16,25
108,ASV,P010545,18.467,7,39,32
108,ASV,P011225,18.834,33,53,20
108,ASV,P012731,15.9,8,39,31
108,ASV,P013371,18.566,-11,42,53
108,ASV,P013405,21.717,7,51,44
108,ASV,PKIR,14.95,17,42,25
108,IST,P004887,24.933,-10,49,59
108,IST,P006590,20.934,-10,41,51
108,IST,P007109,16.033,-9,35,44
108,IST,P009513,7.1,7,21,14
108,IST,P009664,9.584,-5,15,20
108,IST,P009846,26.1,-17,45,62
108,IST,P011078,30.483,-19,60,79
108,IST,P012710,14.383,-1,32,33
108,IST,P012788,14.9,-5,33,38
108,IST,P013363,21.517,-8,46,54
108,IST,P013364,14.033,2,33,31
109,IST,P004887,21.616,4,51,47
109,IST,P006590,18.216,16,54,38
109,IST,P007109,19.133,4,52,48
109,IST,P009513,15.849,-1,38,39
109,IST,P009846,24.983,2,58,56
109,IST,P010400,8.683,-5,23,28
109,IST,P011078,31.199,13,75,62
109,IST,P012710,21.266,9,51,42
109,IST,P012788,17.933,5,48,43
109,IST,P013363,21.117,8,55,47
109,MUN,P001557,5.866,-11,12,23
109,MUN,P004508,26.783,-8,56,64
109,MUN,P005460,4.05,-1,12,13
109,MUN,P007056,32.332,-12,70,82
109,MUN,P007201,28.883,-6,64,70
109,MUN,P007639,3.617,2,8,6
109,MUN,P007929,4.566,-3,8,11
109,MUN,P010391,32.949,-5,73,78
109,MUN,P011224,19.716,-3,47,50
109,MUN,P011244,4.983,-6,12,18
109,MUN,P011987,30.117,-3,74,77
109,MUN,P013368,6.133,1,14,13
110,ASV,P002100,21.533,0,39,39
110,ASV,P003526,20.3,-6,35,41
110,ASV,P004194,12.834,-11,22,33
110,ASV,P007027,30.334,17,69,52
110,ASV,P008991,11.349,5,22,17
110,ASV,P010316,3.517,0,11,11
110,ASV,P010545,13.233,2,27,25
110,ASV,P011225,26.417,10,58,48
110,ASV,P012731,25.6,1,49,48
110,ASV,P013371,7.816,-11,11,22
110,ASV,P013405,27.067,3,57,54
110,MAD,P003108,31.068,0,59,59
110,MAD,P003733,11.251,-10,15,25
110,MAD,P005791,25.617,11,58,47
110,MAD,P005928,29.234,5,56,51
110,MAD,P006540,14.317,-13,25,38
110,MAD,P007630,12.833,-11,20,31
110,MAD,P009005,29.684,8,63,55
110,MAD,P009213,13.567,-3,28,31
110,MAD,P011247,10.767,-7,22,29
110,MAD,P011649,1.15,-2,0,2
110,MAD,P013378,6.684,-3,12,15
110,MAD,PTGB,13.833,15,32,17
114,PRS,P004512,12.367,11,31,20
114,PRS,P005793,14.65,0,38,38
114,PRS,P007032,21.567,-1,46,47
114,PRS,P010390,16.783,-2,32,34
114,PRS,P012608,25.933,9,55,46
114,PRS,P012609,22.517,14,59,45
114,PRS,P012610,21.933,11,50,39
114,PRS,P012611,11.983,5,29,24
114,PRS,P012613,25.35,12,55,43
114,PRS,P012640,16.067,-2,40,42
114,PRS,P013373,10.85,3,30,27
114,TEL,P006835,30.368,-20,56,76
114,TEL,P007519,25.05,-8,49,57
114,TEL,P007990,20.417,-3,43,46
114,TEL,P011193,16.633,-7,34,41
114,TEL,P011202,22.6,-1,46,47
114,TEL,P011214,16.15,0,34,34
114,TEL,P011219,13.182,6,32,26
114,TEL,P013250,2.983,1,6,5
114,TEL,P013381,11.066,2,29,27
114,TEL,P013382,30.384,-16,60,76
114,TEL,P013383,11.167,-14,16,30
111,BAR,P000925,28.967,9,67,58
111,BAR,P002939,17.083,-1,31,32
111,BAR,P003196,10.984,-10,22,32
111,BAR,P003478,17.967,8,42,34
111,BAR,P007464,6.267,-2,17,19
111,BAR,P009862,32.384,4,76,72
111,BAR,P010106,24.501,3,63,60
111,BAR,P011666,2.067,-3,3,6
111,BAR,P012745,35.951,0,76,76
111,BAR,P012795,23.834,-13,48,61
111,PAN,P001926,17.998,4,43,39
111,PAN,P003842,25.866,-8,53,61
111,PAN,P004088,3.933,2,10,8
111,PAN,P005353,2.183,0,6,6
111,PAN,P007866,18.815,6,49,43
111,PAN,P009622,24.882,-5,50,55
111,PAN,P011204,33.315,5,76,71
111,PAN,P011209,12.384,-3,27,30
111,PAN,P012712,30.549,5,67,62
111,PAN,P012774,30.065,-1,69,70
112,BAS,P007230,25.882,7,57,50
112,BAS,P008072,13.883,3,29,26
112,BAS,P008850,10.567,6,26,20
112,BAS,P011085,22.416,2,54,52
112,BAS,P011196,26.116,9,59,50
112,BAS,P011948,18.916,2,40,38
112,BAS,P012201,28.25,10,58,48
112,BAS,P012597,27.349,5,61,56
112,BAS,P013367,26.616,16,56,40
112,ULK,P002849,13.267,-2,31,33
112,ULK,P002968,18.0,-10,26,36
112,ULK,P004004,28.083,-11,43,54
112,ULK,P006961,21.133,2,43,41
112,ULK,P007182,17.233,2,42,40
112,ULK,P008104,22.65,2,56,54
112,ULK,P008174,4.75,3,17,14
112,ULK,P008962,33.384,-16,58,74
112,ULK,P009783,17.483,-9,33,42
112,ULK,P009863,19.767,-14,25,39
112,ULK,P013396,4.25,-7,6,13
113,PAR,P004761,17.016,-8,31,39
113,PAR,P006591,23.983,-7,51,58
113,PAR,P006760,20.583,3,47,44
113,PAR,P007870,8.2,6,14,8
113,PAR,P011050,2.95,-3,4,7
113,PAR,P011836,12.967,-5,24,29
113,PAR,P011981,33.899,4,72,68
113,PAR,P012720,30.616,17,68,51
113,PAR,P013369,31.248,14,71,57
113,PAR,P013370,18.533,9,38,29
113,ZAL,P002329,29.834,-4,63,67
113,ZAL,P002676,7.918,0,8,8
113,ZAL,P003048,17.984,-8,33,41
113,ZAL,P005504,7.283,8,22,14
113,ZAL,P007029,8.734,-6,17,23
113,ZAL,P007513,23.282,-1,53,54
113,ZAL,P007975,23.035,-11,36,47
113,ZAL,P011051,14.534,-6,23,29
113,ZAL,P012622,13.051,-10,18,28
113,ZAL,P012715,23.25,-2,47,49
113,ZAL,P013403,31.1,10,70,60
115,MCO,P005844,15.765,-3,29,32
115,MCO,P005985,28.717,-11,58,69
115,MCO,P008099,21.016,-3,45,48
115,MCO,P009754,24.382,1,50,49
115,MCO,P011212,23.032,-8,41,49
115,MCO,P011226,29.666,-12,58,70
115,MCO,P011231,19.116,-6,35,41
115,MCO,P013365,14.067,3,33,30
115,MCO,PLCZ,24.234,-6,51,57
115,OLY,P001255,7.366,-4,14,18
115,OLY,P003469,27.766,15,69,54
115,OLY,P003941,22.866,5,48,43
115,OLY,P007853,23.983,3,56,53
115,OLY,P007947,15.333,6,33,27
115,OLY,P007982,22.499,-2,45,47
115,OLY,P008811,17.133,4,41,37
115,OLY,P008829,18.067,-3,42,45
115,OLY,P008855,22.666,19,55,36
115,OLY,P013380,22.316,2,42,40
116,MIL,P000796,27.566,24,79,55
116,MIL,P001392,24.1,5,61,56
116,MIL,P001518,18.717,19,52,33
116,MIL,P006085,14.017,-16,29,45
116,MIL,P007831,26.967,26,70,44
116,MIL,P008987,31.333,18,75,57
116,MIL,P011064,28.2,25,79,54
116,MIL,P011941,14.984,-15,32,47
116,MIL,P013384,14.116,-11,28,39
116,RED,P002553,22.716,4,59,55
116,RED,P004007,11.067,-14,15,29
116,RED,P004866,27.299,-24,48,72
116,RED,P006436,13.184,-1,31,32
116,RED,P007960,13.599,-4,36,40
116,RED,P009048,14.499,-23,20,43
116,RED,P010612,21.833,-7,52,59
116,RED,P011194,13.633,-20,17,37
116,RED,P012044,25.433,11,66,55
116,RED,P012786,12.45,-4,24,28
116,RED,PJDR,18.316,6,45,39
116,RED,PLUO,5.966,1,17,16
117,BER,P006251,22.966,-1,53,54
117,BER,P007550,13.416,-3,32,35
117,BER,P008173,24.832,5,55,50
117,BER,P008211,14.349,-5,29,34
117,BER,P008384,30.732,8,62,54
117,BER,P008780,24.966,8,44,36
117,BER,P008967,26.782,-6,49,55
117,BER,P011934,22.165,5,39,34
117,BER,P012604,18.933,-10,41,51
117,BER,P013386,25.849,9,46,37
117,VIR,P001133,21.483,-10,35,45
117,VIR,P001844,11.783,0,32,32
117,VIR,P002084,15.2,4,34,30
117,VIR,P004554,16.65,-4,33,37
117,VIR,P004888,32.301,-10,54,64
117,VIR,P005738,3.15,-9,0,9
117,VIR,P006739,25.967,-5,43,48
117,VIR,P009549,30.734,-4,58,62
117,VIR,P012585,15.182,4,34,30
117,VIR,P012591,2.3,2,9,7
117,VIR,P013374,25.45,8,55,47
117,VIR,PBCN,24.8,14,53,39
118,IST,P004887,13.517,-10,22,32
118,IST,P006590,25.517,3,47,44
118,IST,P007109,12.934,-11,17,28
118,IST,P009513,17.5,-11,35,46
118,IST,P009664,22.401,2,45,43
118,IST,P009846,35.218,-8,70,78
118,IST,P010400,4.9,-5,4,9
118,IST,P011078,26.818,-10,47,57
118,IST,P012710,8.167,-5,15,20
118,IST,P012788,22.733,2,43,41
118,IST,P013363,6.217,-10,4,14
118,IST,P013364,4.083,-2,11,13
118,ZAL,P002329,26.217,13,66,53
118,ZAL,P002676,25.351,4,43,39
118,ZAL,P003048,10.1,7,19,12
118,ZAL,P005504,16.95,8,37,29
118,ZAL,P007029,13.501,10,36,26
118,ZAL,P007513,32.717,10,69,59
118,ZAL,P007975,20.05,3,40,37
118,ZAL,P011051,12.034,-4,24,28
118,ZAL,P011983,2.533,3,7,4
118,ZAL,P012622,10.3,-4,18,22
118,ZAL,P012715,5.467,7,12,5
118,ZAL,P013403,24.785,8,54,46
119,BAS,P007230,29.052,-14,58,72
119,BAS,P008072,10.984,3,25,22
119,BAS,P008850,10.685,-1,20,21
119,BAS,P011085,17.735,-5,35,40
119,BAS,P011196,29.019,-17,55,72
119,BAS,P011948,30.968,-15,62,77
119,BAS,P012201,30.585,-17,58,75
119,BAS,P012597,19.669,1,44,43
119,BAS,P013367,21.318,-5,43,48
119,MUN,P001557,12.183,8,31,23
119,MUN,P004508,27.416,16,69,53
119,MUN,P005460,3.9,-6,2,8
119,MUN,P007056,28.45,14,72,58
119,MUN,P007201,20.817,10,54,44
119,MUN,P007929,4.967,-6,7,13
119,MUN,P010391,32.133,10,74,64
119,MUN,P011224,16.101,14,44,30
119,MUN,P011244,20.216,3,42,39
119,MUN,P011987,27.2,0,57,57
119,MUN,P013368,6.617,7,18,11
120,PAN,P001926,23.316,-5,47,52
120,PAN,P003842,33.166,-10,59,69
120,PAN,P004088,8.033,-8,11,19
120,PAN,P005161,10.033,-8,20,28
120,PAN,P007866,9.65,-8,19,27
120,PAN,P009622,24.416,-11,43,54
120,PAN,P011204,27.433,-18,45,63
120,PAN,P011209,7.016,-5,13,18
120,PAN,P012712,26.316,-10,48,58
120,PAN,P012774,30.616,-7,60,67
120,PAR,P004761,27.951,7,57,50
120,PAR,P006591,13.5,-5,22,27
120,PAR,P006760,31.55,23,78,55
120,PAR,P007870,16.767,-8,34,42
120,PAR,P011050,5.717,2,11,9
120,PAR,P011836,5.717,2,11,9
120,PAR,P011981,27.101,22,68,46
120,PAR,P012720,30.001,14,68,54
120,PAR,P013369,27.567,14,67,53
120,PAR,P013370,14.134,19,39,20
121,MAD,P003108,28.601,-5,45,50
121,MAD,P003583,10.584,-18,10,28
121,MAD,P005791,28.85,9,57,48
121,MAD,P005928,28.268,2,54,52
121,MAD,P006540,19.467,6,42,36
121,MAD,P007630,12.118,-13,18,31
121,MAD,P009005,22.234,4,47,43
121,MAD,P009213,12.967,-4,28,32
121,MAD,P011247,9.433,-13,12,25
121,MAD,P011649,4.883,-8,6,14
121,MAD,P013378,5.316,-6,6,12
121,MAD,PTGB,17.284,-14,25,39
121,ULK,P002849,16.45,15,34,19
121,ULK,P002968,14.65,3,28,25
121,ULK,P004004,21.75,6,45,39
121,ULK,P006961,14.566,9,36,27
121,ULK,P007182,21.383,13,49,36
121,ULK,P008104,19.067,8,39,31
121,ULK,P008962,37.55,4,74,70
121,ULK,P009783,24.65,7,52,45
121,ULK,P009863,26.15,0,49,49
121,ULK,PLMG,3.784,-5,4,9
122,BAR,P000925,22.55,-7,49,56
122,BAR,P002939,26.033,10,65,55
122,BAR,P003196,14.533,9,34,25
122,BAR,P003478,20.949,8,50,42
122,BAR,P006568,2.917,0,5,5
122,BAR,P007464,6.099,-5,7,12
122,BAR,P009862,30.717,3,70,67
122,BAR,P010106,13.967,-8,23,31
122,BAR,P012745,35.134,4,82,78
122,BAR,P012795,27.101,-4,55,59
122,TEL,P005145,7.8,-4,12,16
122,TEL,P006835,32.199,2,74,72
122,TEL,P007519,18.916,-16,33,49
122,TEL,P007990,12.416,-2,28,30
122,TEL,P011193,26.516,7,64,57
122,TEL,P011202,12.916,-4,22,26
122,TEL,P011214,22.666,10,54,44
122,TEL,P011219,8.766,-13,15,28
122,TEL,P013250,8.95,3,18,15
122,TEL,P013381,11.333,2,25,23
122,TEL,P013382,28.917,7,70,63
122,TEL,P013383,8.6,-2,15,17
123,BER,P006251,16.468,-2,31,33
123,BER,P007025,15.951,-11,28,39
123,BER,P007550,17.151,-14,28,42
123,BER,P008173,22.85,-6,52,58
123,BER,P008211,22.783,-8,43,51
123,BER,P008384,17.067,-9,38,47
123,BER,P008967,18.4,-7,43,50
123,BER,P011631,11.551,-5,19,24
123,BER,P011934,19.5,-16,43,59
123,BER,P012604,19.917,-13,33,46
123,BER,P013386,18.367,-9,42,51
123,MCO,P004790,13.101,8,25,17
123,MCO,P005844,18.9,0,39,39
123,MCO,P005985,21.1,15,57,42
123,MCO,P008099,13.9,6,31,25
123,MCO,P008161,5.851,-1,12,13
123,MCO,P009754,21.583,20,60,40
123,MCO,P011212,20.851,2,44,42
123,MCO,P011226,12.617,14,42,28
123,MCO,P011231,21.851,11,47,36
123,MCO,P012515,17.384,-2,39,41
123,MCO,P013365,20.484,17,61,44
123,MCO,PLCZ,12.383,10,43,33
124,OLY,P001255,5.567,-3,10,13
124,OLY,P003469,31.783,-1,74,75
124,OLY,P003941,24.433,-10,50,60
124,OLY,P007853,19.5,-8,42,50
124,OLY,P007947,21.334,1,50,49
124,OLY,P007982,21.466,8,56,48
124,OLY,P008829,18.167,2,46,44
124,OLY,P008855,28.483,-19,52,71
124,OLY,P009849,5.917,-6,10,16
124,OLY,P013380,23.35,6,60,54
124,PRS,P004197,14.499,20,39,19
124,PRS,P004512,8.517,10,26,16
124,PRS,P005793,14.432,-10,29,39
124,PRS,P007032,15.999,-2,43,45
124,PRS,P010390,21.315,5,48,43
124,PRS,P012608,27.182,14,69,55
124,PRS,P012609,16.783,-6,34,40
124,PRS,P012610,27.315,11,69,58
124,PRS,P012613,25.016,14,65,51
124,PRS,P012640,21.999,-11,52,63
124,PRS,P013373,6.933,-15,6,21
125,RED,P002553,28.916,5,60,55
125,RED,P004007,9.767,-2,19,21
125,RED,P004866,22.483,-2,48,50
125,RED,P006436,15.216,11,44,33
125,RED,P007960,15.433,12,43,31
125,RED,P009048,25.25,-2,51,53
125,RED,P010612,28.282,16,75,59
125,RED,P011194,23.299,-5,51,56
125,RED,P012044,16.532,17,53,36
125,RED,P012786,10.567,-6,24,30
125,RED,PJDR,4.25,-9,2,11
125,VIR,P001133,32.865,-6,78,84
125,VIR,P001844,18.466,0,45,45
125,VIR,P002084,25.3,-10,53,63
125,VIR,P004554,13.899,1,26,25
125,VIR,P004888,30.349,0,67,67
125,VIR,P006739,25.048,-6,54,60
125,VIR,P009549,31.616,0,69,69
125,VIR,P012585,4.916,-7,6,13
125,VIR,P013374,7.749,0,15,15
125,VIR,PBCN,9.782,-7,22,29
126,ASV,P003526,13.616,-1,32,33
126,ASV,P004194,27.148,3,59,56
126,ASV,P007027,32.532,-5,70,75
126,ASV,P008991,5.283,1,11,10
126,ASV,P010316,7.399,-11,10,21
126,ASV,P010545,18.033,-14,32,46
126,ASV,P011225,26.898,-12,52,64
126,ASV,P012731,28.232,-18,55,73
126,ASV,P013371,12.85,5,31,26
126,ASV,P013405,21.049,16,53,37
126,ASV,PKIR,6.95,-4,15,19
126,MIL,P000796,32.933,11,79,68
126,MIL,P001392,24.401,21,65,44
126,MIL,P001518,8.716,-9,11,20
126,MIL,P006085,19.516,-1,43,44
126,MIL,P007831,27.549,1,66,65
126,MIL,P008987,28.617,2,66,64
126,MIL,P011064,19.868,7,45,38
126,MIL,P011941,8.033,-1,18,19
126,MIL,P013384,19.95,5,46,41
126,MIL,P013385,10.417,4,21,17
127,MCO,P002581,3.601,0,6,6
127,MCO,P005844,13.183,1,28,27
127,MCO,P005985,29.616,23,70,47
127,MCO,P008099,12.168,0,28,28
127,MCO,P008161,3.4,0,9,9
127,MCO,P009754,18.332,22,54,32
127,MCO,P011212,26.817,21,69,48
127,MCO,P011231,21.7,21,52,31
127,MCO,P012515,26.1,20,60,40
127,MCO,P013365,22.55,15,59,44
127,MCO,PLCZ,22.533,27,60,33
127,ULK,P002849,15.615,-7,33,40
127,ULK,P002968,16.733,-8,30,38
127,ULK,P002969,2.283,-4,2,6
127,ULK,P004004,17.033,-4,38,42
127,ULK,P006961,26.767,-29,44,73
127,ULK,P007182,17.55,-15,27,42
127,ULK,P008174,3.733,-6,4,10
127,ULK,P008962,37.183,-31,61,92
127,ULK,P009783,24.116,-16,39,55
127,ULK,P009863,29.967,-24,53,77
127,ULK,P013396,9.015,-6,14,20
128,BER,P006251,19.167,-7,39,46
128,BER,P006919,12.45,7,26,19
128,BER,P007025,13.117,-3,25,28
128,BER,P007550,11.4,0,22,22
128,BER,P008173,28.434,0,67,67
128,BER,P008211,23.401,-5,56,61
128,BER,P008967,27.034,1,66,65
128,BER,P011631,11.784,5,26,21
128,BER,P011934,20.184,2,47,45
128,BER,P012604,7.9,-9,19,28
128,BER,P013386,25.134,4,57,53
128,PAR,P004761,24.517,0,60,60
128,PAR,P006591,5.384,-2,8,10
128,PAR,P006760,28.85,5,65,60
128,PAR,P007870,15.284,8,41,33
128,PAR,P011836,11.15,-4,26,30
128,PAR,P011981,30.483,-8,60,68
128,PAR,P012167,2.0,-5,0,5
128,PAR,P012720,32.517,-6,74,80
128,PAR,P013369,32.799,10,83,73
128,PAR,P013370,17.016,7,38,31
129,BAS,P007230,31.133,5,61,56
129,BAS,P008072,17.783,8,42,34
129,BAS,P008850,0.2,0,0,0
129,BAS,P011085,19.833,2,50,48
129,BAS,P011196,22.2,-9,39,48
129,BAS,P011948,29.433,4,63,59
129,BAS,P012201,29.034,-9,51,60
129,BAS,P012597,23.284,0,53,53
129,BAS,P013367,27.1,-6,46,52
129,VIR,P001133,31.351,-1,63,64
129,VIR,P001844,23.301,-2,41,43
129,VIR,P002084,4.434,0,9,9
129,VIR,P004554,16.335,6,33,27
129,VIR,P004888,34.618,-1,72,73
129,VIR,P005738,22.968,4,50,46
129,VIR,P006739,23.469,-2,50,52
129,VIR,P009549,20.468,10,47,37
129,VIR,P012585,6.317,0,17,17
129,VIR,P012591,8.616,-2,14,16
129,VIR,P013374,8.133,-7,14,21
130,MUN,P001557,11.784,7,31,24
130,MUN,P004508,28.668,-5,66,71
130,MUN,P007056,29.218,2,73,71
130,MUN,P007201,19.434,1,51,50
130,MUN,P007639,7.117,4,18,14
130,MUN,P007929,4.534,1,10,9
130,MUN,P010391,28.151,-1,70,71
130,MUN,P011224,19.068,10,46,36
130,MUN,P011244,10.484,1,22,21
130,MUN,P011987,29.501,3,77,74
130,MUN,P013368,12.051,2,26,24
130,TEL,P005145,11.216,-4,20,24
130,TEL,P006835,33.382,2,80,78
130,TEL,P007519,32.05,5,82,77
130,TEL,P007990,14.383,-16,23,39
130,TEL,P011193,24.583,11,68,57
130,TEL,P011202,12.683,-15,22,37
130,TEL,P013250,8.149,-10,11,21
130,TEL,P013381,7.399,3,17,14
130,TEL,P013382,28.1,9,76,67
130,TEL,P013383,28.05,-10,66,76
131,MAD,P003108,25.266,1,55,54
131,MAD,P003583,8.666,-15,13,28
131,MAD,P003733,19.133,2,40,38
131,MAD,P005791,27.949,0,58,58
131,MAD,P005928,24.315,-8,47,55
131,MAD,P006540,15.765,-7,34,41
131,MAD,P009005,24.766,-4,49,53
131,MAD,P009213,18.665,0,48,48
131,MAD,P011247,6.483,-1,11,12
131,MAD,P013378,15.099,3,34,31
131,MAD,PTGB,13.883,-16,26,42
131,ZAL,P002329,25.002,3,55,52
131,ZAL,P002676,0.933,-3,0,3
131,ZAL,P003048,7.368,1,18,17
131,ZAL,P003210,5.35,2,14,12
131,ZAL,P005504,14.433,-2,29,31
131,ZAL,P007029,21.434,-5,40,45
131,ZAL,P007975,31.018,10,74,64
131,ZAL,P011051,18.201,10,45,35
131,ZAL,P011983,19.085,17,54,37
131,ZAL,P012622,5.75,-1,12,13
131,ZAL,P012715,23.568,15,62,47
131,ZAL,P013403,27.868,-2,57,59
132,IST,P004887,13.917,15,29,14
132,IST,P006590,18.6,14,49,35
132,IST,P007109,18.867,2,44,42
132,IST,P007200,17.468,14,45,31
132,IST,P009513,4.116,0,9,9
132,IST,P009664,3.483,-3,6,9
132,IST,P009846,26.25,26,63,37
132,IST,P011078,22.968,19,51,32
132,IST,P012710,22.901,18,49,31
132,IST,P012788,20.234,18,56,38
132,IST,P013363,27.718,10,58,48
132,IST,P013364,3.483,-3,6,9
132,PAN,P001926,25.733,-11,47,58
132,PAN,P003842,26.45,-27,37,64
132,PAN,P004088,26.183,-19,39,58
132,PAN,P005161,13.55,-13,19,32
132,PAN,P005353,8.833,2,21,19
132,PAN,P006544,4.117,1,9,8
132,PAN,P007866,20.75,-8,40,48
132,PAN,P009622,19.55,-18,32,50
132,PAN,P011204,27.083,-21,40,61
132,PAN,P011209,7.934,-6,15,21
132,PAN,P011221,7.067,0,16,16
132,PAN,P012712,12.75,-10,20,30
133,OLY,P001255,16.266,-4,31,35
133,OLY,P003469,30.767,-5,58,63
133,OLY,P003941,24.934,-10,44,54
133,OLY,P007853,15.333,-2,35,37
133,OLY,P007947,18.8,-15,30,45
133,OLY,P007982,30.0,-7,60,67
133,OLY,P008829,19.233,-9,35,44
133,OLY,P008855,14.834,-6,22,28
133,OLY,P009849,10.0,1,21,20
133,OLY,P013380,19.833,-13,29,42
133,RED,P000848,18.851,17,52,35
133,RED,P002553,14.434,10,34,24
133,RED,P004007,24.783,16,55,39
133,RED,P004866,29.817,5,63,58
133,RED,P006240,16.517,4,33,29
133,RED,P007960,17.484,7,39,32
133,RED,P009048,31.334,10,68,58
133,RED,P010612,14.45,-3,29,32
133,RED,P012044,21.201,-1,40,41
133,RED,P012786,6.034,0,11,11
133,RED,PLUO,5.1,5,11,6
134,BAR,P000925,26.867,-4,57,61
134,BAR,P002939,22.667,-6,39,45
134,BAR,P003196,10.635,-12,17,29
134,BAR,P007464,18.684,-7,38,45
134,BAR,P009862,24.034,3,60,57
134,BAR,P009992,16.868,-14,26,40
134,BAR,P010106,17.335,-7,42,49
134,BAR,P011666,1.2,-2,0,2
134,BAR,P012745,26.152,-5,52,57
134,BAR,P012795,35.568,-11,74,85
134,MIL,P000796,30.517,12,74,62
134,MIL,P001392,22.901,-5,43,48
134,MIL,P001518,6.317,2,11,9
134,MIL,P006085,11.316,19,35,16
134,MIL,P007831,31.234,8,76,68
134,MIL,P008985,18.068,16,53,37
134,MIL,P008987,31.984,4,74,70
134,MIL,P011064,23.551,-8,46,54
134,MIL,P011941,6.016,2,13,11
134,MIL,P013384,8.75,6,22,16
134,MIL,P013385,9.351,9,23,14
135,ASV,P002100,18.067,8,56,48
135,ASV,P003526,20.101,-5,45,50
135,ASV,P004194,15.901,-12,32,44
135,ASV,P007027,31.585,2,77,75
135,ASV,P010316,14.484,4,34,30
135,ASV,P010545,16.051,-13,34,47
135,ASV,P011225,17.918,-9,35,44
135,ASV,P012731,27.301,17,73,56
135,ASV,P013371,17.851,15,47,32
135,ASV,P013405,20.751,18,57,39
135,PRS,P004197,15.449,2,34,32
135,PRS,P004512,6.699,-4,15,19
135,PRS,P005793,16.717,-17,38,55
135,PRS,P007032,14.2,-15,29,44
135,PRS,P010390,12.083,12,34,22
135,PRS,P012608,27.499,9,66,57
135,PRS,P012609,16.533,-13,33,46
135,PRS,P012610,27.499,9,66,57
135,PRS,P012613,27.249,9,66,57
135,PRS,P012640,20.65,-9,53,62
135,PRS,P013373,15.417,-8,31,39
136,MCO,P002581,11.216,18,34,16
136,MCO,P004790,5.3,-7,2,9
136,MCO,P005844,12.434,7,31,24
136,MCO,P005985,25.85,12,58,46
136,MCO,P008099,21.9,25,60,35
136,MCO,P008161,5.567,-7,2,9
136,MCO,P009754,19.167,10,46,36
136,MCO,P011212,22.784,12,53,41
136,MCO,P011231,20.3,24,59,35
136,MCO,P012515,24.732,5,60,55
136,MCO,P013365,20.017,-5,34,39
136,MCO,PLCZ,10.733,1,26,25
136,MUN,P001557,12.0,-9,22,31
136,MUN,P004508,26.968,-20,50,70
136,MUN,P005460,7.434,-13,11,24
136,MUN,P007056,19.317,-5,39,44
136,MUN,P007201,20.884,-15,40,55
136,MUN,P007639,19.117,-4,34,38
136,MUN,P007929,10.0,-2,14,16
136,MUN,P010391,24.601,-11,47,58
136,MUN,P011224,18.867,-16,34,50
136,MUN,P011987,23.734,-9,48,57
136,MUN,P012123,5.3,7,9,2
136,MUN,P013368,11.783,2,22,20
137,MIL,P000796,24.464,-11,49,60
137,MIL,P001392,25.649,-20,49,69
137,MIL,P001518,7.383,-1,15,16
137,MIL,P005670,7.984,-2,14,16
137,MIL,P006085,18.333,-17,32,49
137,MIL,P007831,26.498,-15,50,65
137,MIL,P008987,25.567,-26,43,69
137,MIL,P011064,21.666,-12,42,54
137,MIL,P011941,11.783,-10,26,36
137,MIL,P013384,16.351,-16,30,46
137,MIL,P013385,14.317,-15,20,35
137,PAN,P001926,19.882,26,54,28
137,PAN,P003842,27.348,11,70,59
137,PAN,P004088,13.048,5,28,23
137,PAN,P005353,12.649,18,33,15
137,PAN,P007866,17.948,16,47,31
137,PAN,P009622,9.815,-6,17,23
137,PAN,P011204,26.949,24,75,51
137,PAN,P011209,13.4,15,42,27
137,PAN,P011442,2.266,-4,4,8
137,PAN,P012712,19.783,17,52,35
137,PAN,P012774,36.897,23,93,70
138,BAR,P000925,23.65,17,55,38
138,BAR,P002939,22.967,19,55,36
138,BAR,P003196,16.35,10,35,25
138,BAR,P003478,18.017,3,36,33
138,BAR,P007464,8.983,4,19,15
138,BAR,P009862,27.85,27,65,38
138,BAR,P009992,11.15,4,23,19
138,BAR,P010106,17.033,8,35,27
138,BAR,P011666,1.316,9,9,0
138,BAR,P012745,31.017,23,71,48
138,BAR,P012795,21.667,11,47,36
138,ULK,P002849,15.55,-13,21,34
138,ULK,P002968,11.016,-13,16,29
138,ULK,P004004,22.55,-12,32,44
138,ULK,P006961,22.583,-16,33,49
138,ULK,P007182,19.117,-9,33,42
138,ULK,P008174,1.233,-6,0,6
138,ULK,P008962,34.317,-19,56,75
138,ULK,P009783,27.483,-23,46,69
138,ULK,P009863,12.217,-2,20,22
138,ULK,P011205,20.434,-8,36,44
138,ULK,P013396,13.5,-14,22,36
139,MAD,P003108,27.15,12,75,63
139,MAD,P003733,17.716,14,46,32
139,MAD,P005791,30.833,13,74,61
139,MAD,P005928,27.533,21,74,53
139,MAD,P006540,18.367,2,39,37
139,MAD,P007630,9.167,-2,22,24
139,MAD,P009005,31.749,10,74,64
139,MAD,P009213,4.867,-5,5,10
139,MAD,P011247,12.984,-8,24,32
139,MAD,P011649,6.734,3,16,13
139,MAD,PTGB,12.9,-5,31,36
139,PRS,P004512,11.217,-6,12,18
139,PRS,P005793,20.284,-17,33,50
139,PRS,P007032,27.401,1,67,66
139,PRS,P010390,23.15,3,58,55
139,PRS,P012609,27.334,-10,55,65
139,PRS,P012610,25.584,2,65,63
139,PRS,P012611,12.6,-12,18,30
139,PRS,P012613,7.734,3,20,17
139,PRS,P012640,30.251,-21,57,78
139,PRS,P013373,14.45,2,40,38
140,BER,P006251,7.9,-17,4,21
140,BER,P006919,14.133,-21,13,34
140,BER,P007025,16.734,-18,20,38
140,BER,P008173,23.3,-8,44,52
140,BER,P008211,20.284,-3,40,43
140,BER,P008780,16.701,-12,22,34
140,BER,P008967,23.267,-2,46,48
140,BER,P011631,14.068,-1,26,27
140,BER,P011934,23.617,2,49,47
140,BER,P012604,14.267,-23,12,35
140,BER,P013386,25.734,3,54,51
140,ZAL,P002329,24.5,6,52,46
140,ZAL,P002676,16.25,15,37,22
140,ZAL,P003048,14.033,14,37,23
140,ZAL,P005504,23.949,10,44,34
140,ZAL,P007029,21.95,1,43,42
140,ZAL,P007513,16.65,5,35,30
140,ZAL,P007975,26.999,10,56,46
140,ZAL,P011051,2.017,-4,5,9
140,ZAL,P011983,15.299,12,34,22
140,ZAL,P012715,16.232,18,38,20
140,ZAL,P013403,22.116,13,49,36
141,BAS,P004058,6.0,-3,8,11
141,BAS,P007230,32.534,13,79,66
141,BAS,P008072,19.451,20,53,33
141,BAS,P008850,1.85,1,5,4
141,BAS,P011085,24.201,10,58,48
141,BAS,P011196,12.933,-10,26,36
141,BAS,P011948,34.001,13,87,74
141,BAS,P012201,29.034,-4,64,68
141,BAS,P012597,24.701,13,61,48
141,BAS,P013367,15.3,-3,34,37
141,TEL,P005145,15.317,-18,26,44
141,TEL,P006835,29.118,10,70,60
141,TEL,P007519,23.901,-5,49,54
141,TEL,P007990,13.919,-19,18,37
141,TEL,P011193,23.801,3,57,54
141,TEL,P011202,17.251,-26,25,51
141,TEL,P011219,28.202,-9,56,65
141,TEL,P013250,4.966,-3,9,12
141,TEL,P013381,16.051,2,42,40
141,TEL,P013382,23.484,10,58,48
141,TEL,P013383,4.0,5,15,10
144,ASV,P002100,20.466,-1,34,35
144,ASV,P003526,21.683,6,50,44
144,ASV,P004194,24.433,0,53,53
144,ASV,P007027,26.218,1,56,55
144,ASV,P008991,9.95,4,23,19
144,ASV,P010316,25.633,4,52,48
144,ASV,P010545,25.768,2,49,47
144,ASV,P011225,17.183,1,42,41
144,ASV,P012263,0.467,1,3,2
144,ASV,P012731,12.533,-7,19,26
144,ASV,P013371,15.666,4,29,25
144,PAR,P004761,9.884,-1,21,22
144,PAR,P006760,32.034,10,68,58
144,PAR,P008232,12.667,8,31,23
144,PAR,P011050,13.9,-5,27,32
144,PAR,P011836,20.367,-1,34,35
144,PAR,P011981,26.084,2,52,50
144,PAR,P012167,4.617,-4,9,13
144,PAR,P012720,33.484,-16,60,76
144,PAR,P013369,21.984,-6,43,49
144,PAR,P013370,24.984,-2,50,52
142,IST,P004887,21.1,10,41,31
142,IST,P006590,17.833,25,50,25
142,IST,P007109,18.249,25,52,27
142,IST,P007200,24.533,22,63,41
142,IST,P009846,27.417,11,54,43
142,IST,P011078,27.417,6,59,53
142,IST,P012710,21.751,-3,37,40
142,IST,P012788,18.9,12,48,36
142,IST,P013363,15.467,0,26,26
142,IST,P013364,7.333,2,15,13
142,RED,P000848,16.6,-19,24,43
142,RED,P002553,16.034,-14,33,47
142,RED,P004007,19.018,2,35,33
142,RED,P004866,25.535,-15,47,62
142,RED,P006436,7.067,-15,10,25
142,RED,P009035,20.351,-3,30,33
142,RED,P009048,27.686,-6,47,53
142,RED,P010612,12.651,-13,17,30
142,RED,P011194,28.968,-3,47,50
142,RED,P012044,18.733,-18,31,49
142,RED,P012786,7.367,-6,14,20
143,OLY,P001255,23.566,24,55,31
143,OLY,P003469,29.382,25,75,50
143,OLY,P003941,21.649,11,48,37
143,OLY,P007853,8.084,-13,11,24
143,OLY,P007947,11.833,-18,22,40
143,OLY,P007982,10.817,-15,13,28
143,OLY,P008811,18.35,-1,39,40
143,OLY,P008829,17.316,-13,29,42
143,OLY,P008855,23.199,30,62,32
143,OLY,P010392,8.85,-10,16,26
143,OLY,P013380,26.949,30,65,35
143,VIR,P001844,19.383,-3,36,39
143,VIR,P002084,11.166,-12,13,25
143,VIR,P004554,28.349,-17,54,71
143,VIR,P004888,24.483,-27,32,59
143,VIR,P005738,12.5,-3,29,32
143,VIR,P006739,20.683,-7,41,48
143,VIR,P009549,26.048,4,56,52
143,VIR,P011816,5.233,4,12,8
143,VIR,P012585,17.617,-9,33,42
143,VIR,P013374,11.65,7,23,16
143,VIR,PBCN,22.883,13,56,43
145,BAS,P007230,26.599,-23,47,70
145,BAS,P008072,21.149,0,47,47
145,BAS,P008850,18.783,-7,40,47
145,BAS,P010784,1.417,0,3,3
145,BAS,P011085,17.067,-10,28,38
145,BAS,P011196,15.901,-30,20,50
145,BAS,P011948,20.351,-31,28,59
145,BAS,P012058,5.183,-7,5,12
145,BAS,P012201,32.567,-29,58,87
145,BAS,P012597,25.616,-10,51,61
145,BAS,P013367,15.367,-28,18,46
145,PAN,P001926,13.518,-17,24,41
145,PAN,P003842,16.484,24,48,24
145,PAN,P004088,18.051,5,44,39
145,PAN,P005353,14.284,2,30,28
145,PAN,P007866,15.751,6,42,36
145,PAN,P009622,17.084,5,43,38
145,PAN,P011204,21.134,29,57,28
145,PAN,P011209,19.201,35,56,21
145,PAN,P011221,11.584,11,31,20
145,PAN,P011442,3.117,0,5,5
145,PAN,P012712,20.084,29,55,26
145,PAN,P012774,29.718,46,85,39
147,MAD,P003108,19.516,18,52,34
147,MAD,P003583,14.55,-7,31,38
147,MAD,P003733,20.4,6,45,39
147,MAD,P005791,10.434,8,26,18
147,MAD,P005928,15.884,10,37,27
147,MAD,P006540,23.151,22,62,40
147,MAD,P007630,15.017,21,37,16
147,MAD,P009005,17.885,9,40,31
147,MAD,P009213,20.018,18,51,33
147,MAD,P011247,22.483,8,53,45
147,MAD,P011649,14.049,-8,18,26
147,MAD,PTGB,6.618,5,18,13
147,MCO,P002581,12.116,-3,26,29
147,MCO,P004790,13.816,5,31,26
147,MCO,P005763,15.867,-6,33,39
147,MCO,P005844,8.567,-17,8,25
147,MCO,P005985,29.6,-12,55,67
147,MCO,P008099,22.917,-11,35,46
147,MCO,P008161,5.3,-5,10,15
147,MCO,P009754,25.217,-14,47,61
147,MCO,P011231,16.183,-17,22,39
147,MCO,P012515,19.399,-17,34,51
147,MCO,P013365,14.301,-6,28,34
147,MCO,PLCZ,16.717,-7,31,38
148,IST,P004887,15.034,-4,31,35
148,IST,P006590,18.816,14,41,27
148,IST,P007109,6.784,-5,4,9
148,IST,P007200,28.933,15,63,48
148,IST,P009846,18.217,-1,37,38
148,IST,P011078,28.317,-3,63,66
148,IST,P012710,34.95,12,82,70
148,IST,P012788,23.232,15,55,40
148,IST,P013363,21.984,3,50,47
148,IST,P013364,3.733,-1,4,5
148,PAR,P006760,29.117,-10,55,65
148,PAR,P007632,5.983,-4,11,15
148,PAR,P007870,16.334,-8,24,32
148,PAR,P008232,25.684,2,56,54
148,PAR,P011836,8.55,-3,12,15
148,PAR,P011981,28.399,-5,62,67
148,PAR,P012720,32.25,3,65,62
148,PAR,P013369,34.1,-11,67,78
148,PAR,P013370,19.583,-9,33,42
149,ASV,P002100,22.7,-2,43,45
149,ASV,P003526,13.3,1,24,23
149,ASV,P007027,31.267,0,60,60
149,ASV,P008991,21.266,12,45,33
149,ASV,P010316,27.184,9,55,46
149,ASV,P010545,18.317,-8,31,39
149,ASV,P011225,22.833,3,43,40
149,ASV,P013371,14.783,6,29,23
149,ASV,P013405,28.35,9,60,51
149,ZAL,P002329,22.067,3,45,42
149,ZAL,P002676,23.15,2,44,42
149,ZAL,P003048,18.084,-4,36,40
149,ZAL,P005504,13.916,8,27,19
149,ZAL,P007029,18.583,0,33,33
149,ZAL,P007513,18.515,-7,28,35
149,ZAL,P007975,34.267,-1,66,67
149,ZAL,P011051,8.0,-10,9,19
149,ZAL,P011983,7.3,-8,9,17
149,ZAL,P012622,7.417,-3,12,15
149,ZAL,P012715,14.8,-8,25,33
149,ZAL,P013403,13.901,-2,26,28
150,BAR,P000925,21.283,-9,38,47
150,BAR,P002939,29.818,6,67,61
150,BAR,P003196,14.584,8,39,31
150,BAR,P003478,14.901,-10,26,36
150,BAR,P006568,4.117,-4,4,8
150,BAR,P007464,8.667,-1,15,16
150,BAR,P009862,30.45,-2,61,63
150,BAR,P009992,11.5,-4,22,26
150,BAR,P010106,8.467,-11,12,23
150,BAR,P012745,31.334,-4,66,70
150,BAR,P012795,24.884,6,55,49
150,VIR,P001844,15.617,-3,32,35
150,VIR,P002084,19.599,-4,38,42
150,VIR,P004554,22.533,-2,44,46
150,VIR,P004888,26.65,3,55,52
150,VIR,P005738,17.167,1,36,35
150,VIR,P006739,24.518,12,56,44
150,VIR,P009549,33.3,2,69,67
150,VIR,P012585,14.649,4,35,31
150,VIR,P013374,17.45,7,42,35
150,VIR,PBCN,8.517,5,23,18
151,BER,P006251,13.733,-1,30,31
151,BER,P006919,17.416,10,43,33
151,BER,P007025,15.483,6,33,27
151,BER,P007550,12.734,11,34,23
151,BER,P008173,11.901,-13,24,37
151,BER,P008211,24.351,-13,49,62
151,BER,P008780,15.365,-3,27,30
151,BER,P008967,22.75,-13,45,58
151,BER,P011631,8.383,5,17,12
151,BER,P011934,19.684,-12,41,53
151,BER,P012604,19.55,15,47,32
151,BER,P013386,18.65,-17,35,52
151,OLY,P001255,15.384,13,43,30
151,OLY,P003469,28.317,7,68,61
151,OLY,P003941,14.6,-14,19,33
151,OLY,P007853,20.615,-12,39,51
151,OLY,P007947,14.966,-2,31,33
151,OLY,P007982,15.683,-3,31,34
151,OLY,P008811,25.049,17,69,52
151,OLY,P008829,11.682,-2,22,24
151,OLY,P008855,16.9,11,44,33
151,OLY,P009849,13.916,-3,25,28
151,OLY,P013380,22.883,13,59,46
152,RED,P000848,17.801,5,37,32
152,RED,P002553,10.801,13,27,14
152,RED,P004866,24.884,-5,48,53
152,RED,P006436,18.768,9,46,37
152,RED,P009035,29.201,-5,54,59
152,RED,P009048,20.7,-13,29,42
152,RED,P010612,24.818,14,52,38
152,RED,P011194,16.134,-1,28,29
152,RED,P012044,20.002,16,50,34
152,RED,P012786,16.901,7,34,27
152,TEL,P005145,5.95,-9,4,13
152,TEL,P006835,36.898,5,73,68
152,TEL,P007519,28.715,6,65,59
152,TEL,P007990,4.383,-9,2,11
152,TEL,P011193,27.366,4,50,46
152,TEL,P011202,12.616,-26,10,36
152,TEL,P011219,34.915,-1,65,66
152,TEL,P013250,10.049,1,17,16
152,TEL,P013381,8.95,-12,14,26
152,TEL,P013382,30.148,1,65,64
153,MIL,P000796,29.583,-6,53,59
153,MIL,P001392,29.049,7,61,54
153,MIL,P006085,23.233,3,49,46
153,MIL,P007831,31.299,-12,59,71
153,MIL,P008985,14.383,0,27,27
153,MIL,P008987,31.616,5,65,60
153,MIL,P011064,16.766,-4,29,33
153,MIL,P011199,16.549,9,38,29
153,MIL,P013384,5.267,3,9,6
153,MIL,P013385,2.25,-10,0,10
153,MUN,P001557,11.167,2,17,15
153,MUN,P004508,29.85,-1,62,63
153,MUN,P007056,32.75,3,67,64
153,MUN,P007201,32.4,15,68,53
153,MUN,P007639,4.2,-5,7,12
153,MUN,P007929,4.2,-5,7,12
153,MUN,P010391,28.983,12,63,51
153,MUN,P011224,12.817,-15,16,31
153,MUN,P011244,6.483,-11,9,20
153,MUN,P011987,32.983,10,72,62
153,MUN,P013368,4.167,0,7,7
154,IST,P004887,23.167,-10,39,49
154,IST,P006590,21.332,-13,39,52
154,IST,P007109,15.8,6,38,32
154,IST,P007200,29.416,-5,61,66
154,IST,P009513,0.366,-2,0,2
154,IST,P009664,8.216,-8,12,20
154,IST,P009846,22.7,-6,43,49
154,IST,P011078,25.633,-17,48,65
154,IST,P012710,15.95,-17,25,42
154,IST,P012788,16.799,-9,36,45
154,IST,P013363,20.616,-14,34,48
154,MCO,P002581,14.332,6,34,28
154,MCO,P005844,11.099,2,21,19
154,MCO,P005985,28.098,9,64,55
154,MCO,P008099,20.981,1,42,41
154,MCO,P008161,0.633,0,0,0
154,MCO,P009754,29.432,27,79,52
154,MCO,P011212,24.914,6,54,48
154,MCO,P011231,22.565,11,56,45
154,MCO,P012515,14.433,15,40,25
154,MCO,P013365,18.932,7,41,34
154,MCO,PLCZ,14.566,11,39,28
155,BER,P006251,20.85,5,37,32
155,BER,P006919,18.267,-11,32,43
155,BER,P007025,4.583,-11,6,17
155,BER,P007550,7.717,1,14,13
155,BER,P008173,15.634,-12,26,38
155,BER,P008211,21.733,0,37,37
155,BER,P008780,27.133,1,49,48
155,BER,P008967,24.933,-1,43,44
155,BER,P011631,7.633,-13,12,25
155,BER,P011934,19.233,-19,29,48
155,BER,P013386,32.284,5,60,55
155,MAD,P003108,24.95,10,53,43
155,MAD,P003733,19.133,5,41,36
155,MAD,P005791,29.0,1,50,49
155,MAD,P005928,26.266,10,57,47
155,MAD,P006540,23.633,4,45,41
155,MAD,P007630,10.767,8,28,20
155,MAD,P009005,24.517,4,48,44
155,MAD,P011247,13.734,1,23,22
155,MAD,P011649,8.033,1,14,13
155,MAD,PTGB,19.967,11,41,30
157,TEL,P005145,3.117,4,7,3
157,TEL,P006835,31.483,24,73,49
157,TEL,P007519,27.601,9,63,54
157,TEL,P007990,17.117,9,47,38
157,TEL,P011193,23.7,20,54,34
157,TEL,P011202,9.401,0,23,23
157,TEL,P011219,21.601,21,53,32
157,TEL,P012604,17.484,-3,45,48
157,TEL,P013250,11.184,0,26,26
157,TEL,P013381,12.134,-11,27,38
157,TEL,P013382,25.183,12,57,45
157,ZAL,P002329,13.583,-7,27,34
157,ZAL,P002676,21.183,-12,38,50
157,ZAL,P003048,18.733,-11,29,40
157,ZAL,P005504,5.8,-7,8,15
157,ZAL,P007029,22.533,5,57,52
157,ZAL,P007513,25.4,-1,57,58
157,ZAL,P007975,23.282,-13,42,55
157,ZAL,P011051,15.466,1,41,40
157,ZAL,P011983,4.467,-6,8,14
157,ZAL,P012622,15.049,-7,26,33
157,ZAL,P012715,7.55,-7,11,18
157,ZAL,P013403,26.949,-20,46,66
156,MIL,P000796,30.0,5,69,64
156,MIL,P001392,18.683,-1,37,38
156,MIL,P001518,14.933,4,30,26
156,MIL,P006085,16.583,-5,33,38
156,MIL,P006509,10.717,1,23,22
156,MIL,P007831,27.917,-3,58,61
156,MIL,P008985,24.817,-4,50,54
156,MIL,P008987,27.3,-4,56,60
156,MIL,P011064,21.283,9,48,39
156,MIL,P011941,2.317,-5,2,7
156,MIL,P013385,5.45,-2,9,11
156,OLY,P001255,26.417,2,56,54
156,OLY,P003469,32.584,2,71,69
156,OLY,P007853,6.05,-4,13,17
156,OLY,P007947,17.167,4,37,33
156,OLY,P007982,25.234,5,61,56
156,OLY,P008811,25.384,1,47,46
156,OLY,P008829,15.718,4,37,33
156,OLY,P008855,23.0,-3,39,42
156,OLY,P013380,28.451,-6,59,65
158,BAR,P000925,25.349,1,48,47
158,BAR,P002939,24.516,-5,42,47
158,BAR,P003196,14.65,-5,26,31
158,BAR,P003478,18.967,1,32,31
158,BAR,P007464,3.584,-5,5,10
158,BAR,P009862,27.648,2,52,50
158,BAR,P009992,6.667,-2,15,17
158,BAR,P010106,12.2,-3,24,27
158,BAR,P012745,17.533,-9,29,38
158,BAR,P012795,23.132,-4,44,48
158,BAR,P013379,22.466,5,45,40
158,BAR,P013505,3.283,4,8,4
158,RED,P000848,6.832,2,19,17
158,RED,P002553,10.567,-3,17,20
158,RED,P004866,28.851,2,53,51
158,RED,P006436,11.986,-4,19,23
158,RED,P007960,26.601,9,54,45
158,RED,P009035,24.069,5,47,42
158,RED,P009048,21.6,-2,38,40
158,RED,P010612,10.318,-1,17,18
158,RED,P011194,20.251,3,46,43
158,RED,P012044,17.018,10,41,31
158,RED,P012786,21.917,-1,39,40
159,PAR,P006591,23.6,13,56,43
159,PAR,P007632,11.083,-9,20,29
159,PAR,P007870,12.416,-6,24,30
159,PAR,P008232,24.434,14,59,45
159,PAR,P011050,4.117,-5,5,10
159,PAR,P011836,25.301,-4,54,58
159,PAR,P011981,13.551,17,38,21
159,PAR,P012720,25.484,7,58,51
159,PAR,P013369,31.318,-2,66,68
159,PAR,P013370,28.701,20,70,50
159,ULK,P002849,11.933,-12,19,31
159,ULK,P002968,13.267,-7,21,28
159,ULK,P002969,13.733,3,31,28
159,ULK,P004004,24.583,-10,49,59
159,ULK,P006961,24.049,-3,48,51
159,ULK,P007182,20.616,2,46,44
159,ULK,P008962,34.182,-1,76,77
159,ULK,P009783,16.366,-7,32,39
159,ULK,P011205,29.299,5,67,62
159,ULK,P013396,11.967,-15,16,31
160,BAS,P007230,29.116,24,74,50
160,BAS,P008072,11.383,-10,20,30
160,BAS,P011085,21.449,-1,50,51
160,BAS,P011196,26.166,15,66,51
160,BAS,P011948,26.667,19,66,47
160,BAS,P012080,7.333,-10,12,22
160,BAS,P012201,31.883,11,72,61
160,BAS,P012597,22.299,3,52,49
160,BAS,P013367,23.699,14,58,44
160,PRS,P004197,13.0,-2,26,28
160,PRS,P004512,7.467,0,14,14
160,PRS,P005793,15.033,6,35,29
160,PRS,P007032,19.483,-3,41,44
160,PRS,P010390,21.083,-7,44,51
160,PRS,P012608,27.049,-22,50,72
160,PRS,P012609,21.649,-5,46,51
160,PRS,P012610,27.049,-22,50,72
160,PRS,P012613,22.233,-20,37,57
160,PRS,P012640,20.466,1,45,44
160,PRS,P013373,5.483,9,17,8
161,MUN,P001557,19.233,-3,36,39
161,MUN,P004508,30.517,-17,48,65
161,MUN,P007056,19.917,8,39,31
161,MUN,P007201,36.067,-2,64,66
161,MUN,P007639,3.1,-10,2,12
161,MUN,P010391,29.316,10,55,45
161,MUN,P011224,17.717,-17,28,45
161,MUN,P011244,3.1,-10,2,12
161,MUN,P011987,34.516,-9,63,72
161,MUN,P012123,1.767,-6,0,6
161,MUN,P013368,4.75,1,8,7
161,PAN,P001926,25.134,28,59,31
161,PAN,P004088,17.85,19,45,26
161,PAN,P005161,1.5,-2,0,2
161,PAN,P005353,8.517,-12,7,19
161,PAN,P007866,29.716,22,73,51
161,PAN,P009622,3.983,-12,0,12
161,PAN,P011204,28.05,-9,48,57
161,PAN,P011209,7.05,-7,8,15
161,PAN,P012712,10.517,-17,7,24
161,PAN,P012774,37.933,14,80,66
161,PAN,P013383,29.75,31,73,42
162,ASV,P000229,8.45,-7,7,14
162,ASV,P002100,17.4,-9,28,37
162,ASV,P003526,23.117,-17,39,56
162,ASV,P007027,29.933,-15,52,67
162,ASV,P008991,11.233,-6,15,21
162,ASV,P010316,18.95,2,38,36
162,ASV,P010545,28.667,-8,54,62
162,ASV,P011225,20.8,-3,39,42
162,ASV,P013371,16.75,-4,29,33
162,ASV,P013405,24.7,-3,44,47
162,VIR,P002084,26.216,17,53,36
162,VIR,P004554,10.966,7,22,15
162,VIR,P004888,26.984,13,55,42
162,VIR,P005738,15.85,4,39,35
162,VIR,P006739,27.866,17,59,42
162,VIR,P009549,23.233,8,45,37
162,VIR,P011816,4.316,-3,7,10
162,VIR,P012585,17.65,5,36,31
162,VIR,P012591,12.049,0,24,24
162,VIR,P013374,18.733,5,38,33
162,VIR,PBCN,16.132,-3,37,40
163,OLY,P001255,29.284,15,70,55
163,OLY,P003469,32.051,11,75,64
163,OLY,P003941,19.851,12,47,35
163,OLY,P007853,20.002,3,47,44
163,OLY,P007982,21.835,4,50,46
163,OLY,P008811,16.817,-2,37,39
163,OLY,P008829,8.068,-4,17,21
163,OLY,P008855,24.967,4,57,53
163,OLY,P013380,23.918,-5,52,57
163,OLY,P013514,3.217,-3,8,11
163,ZAL,P002329,21.515,-2,44,46
163,ZAL,P002676,25.933,10,64,54
163,ZAL,P003048,19.232,-1,38,39
163,ZAL,P005504,2.884,-4,4,8
163,ZAL,P007029,19.084,-4,40,44
163,ZAL,P007513,15.432,-20,23,43
163,ZAL,P007975,29.599,8,67,59
163,ZAL,P011051,17.883,-2,43,45
163,ZAL,P011983,16.317,-3,34,37
163,ZAL,P012622,6.017,-6,14,20
163,ZAL,P012715,6.267,-2,14,16
163,ZAL,P013403,19.832,-9,40,49
165,ASV,P000229,12.033,-3,19,22
165,ASV,P002100,22.116,-10,38,48
165,ASV,P003526,14.882,-9,18,27
165,ASV,P007027,25.499,-9,37,46
165,ASV,P010316,18.217,5,30,25
165,ASV,P010545,33.999,-5,59,64
165,ASV,P011225,25.566,-7,44,51
165,ASV,P013371,12.117,-3,23,26
165,ASV,P013377,2.467,-1,3,4
165,ASV,P013405,33.099,-3,59,62
165,MIL,P000796,24.782,9,51,42
165,MIL,P001518,6.949,4,13,9
165,MIL,P005670,1.733,-4,2,6
165,MIL,P006085,10.233,-4,14,18
165,MIL,P006509,10.999,1,20,19
165,MIL,P007831,28.216,-4,54,58
165,MIL,P008985,26.233,13,47,34
165,MIL,P008987,24.765,8,47,39
165,MIL,P011064,24.466,16,53,37
165,MIL,P011941,13.934,-7,20,27
165,MIL,P013384,18.114,9,35,26
165,MIL,P013385,9.566,4,19,15
164,BER,P006251,19.432,-13,43,56
164,BER,P007025,11.099,1,26,25
164,BER,P007550,8.299,-9,10,19
164,BER,P008062,16.266,-1,43,44
164,BER,P008173,21.349,-4,47,51
164,BER,P008211,15.383,-17,30,47
164,BER,P008384,23.182,-1,57,58
164,BER,P008967,24.416,-14,57,71
164,BER,P011631,20.916,-5,47,52
164,BER,P011934,23.432,-11,51,62
164,BER,P013386,16.216,-1,39,40
164,MCO,P001932,18.585,19,51,32
164,MCO,P005844,18.235,13,49,36
164,MCO,P005985,27.535,11,70,59
164,MCO,P008099,21.0,-4,52,56
164,MCO,P009754,28.868,18,87,69
164,MCO,P011212,25.652,7,61,54
164,MCO,P011231,17.45,4,45,41
164,MCO,P013365,22.335,9,58,49
164,MCO,PLCZ,20.35,-2,52,54
166,BAS,P007230,19.15,-5,36,41
166,BAS,P007579,17.217,2,32,30
166,BAS,P008072,8.75,-11,4,15
166,BAS,P011085,20.85,3,37,34
166,BAS,P011196,19.283,1,41,40
166,BAS,P011948,24.183,-4,46,50
166,BAS,P012080,16.484,0,27,27
166,BAS,P012201,34.083,6,69,63
166,BAS,P012597,18.8,-7,33,40
166,BAS,P013367,21.2,5,40,35
166,RED,P000848,19.715,5,44,39
166,RED,P002553,11.85,1,21,20
166,RED,P004866,27.283,-8,47,55
166,RED,P006436,26.632,15,58,43
166,RED,P007960,8.333,-15,6,21
166,RED,P009035,28.149,1,54,53
166,RED,P009048,17.9,-12,30,42
166,RED,P010588,13.916,8,31,23
166,RED,P010612,21.434,-1,35,36
166,RED,P011194,4.567,6,10,4
166,RED,P012044,16.566,11,31,20
166,RED,PJDR,3.65,-1,8,9
167,IST,P004887,21.184,1,52,51
167,IST,P006372,0.05,0,0,0
167,IST,P006590,17.966,-8,35,43
167,IST,P007109,21.683,-12,31,43
167,IST,P007200,32.383,-10,65,75
167,IST,P009846,24.85,-8,48,56
167,IST,P011078,23.717,-3,42,45
167,IST,P012710,14.184,3,29,26
167,IST,P012788,15.283,-7,18,25
167,IST,P013363,17.7,7,42,35
167,IST,P013364,11.0,-3,18,21
167,ULK,P002849,17.199,3,35,32
167,ULK,P002968,7.2,-1,17,18
167,ULK,P004004,27.416,11,64,53
167,ULK,P006961,26.733,-1,55,56
167,ULK,P007182,20.199,-2,39,41
167,ULK,P008962,31.467,9,66,57
167,ULK,P009783,9.199,-6,18,24
167,ULK,P010560,13.667,12,26,14
167,ULK,P011205,30.266,8,65,57
167,ULK,P013396,16.649,7,35,28
168,PAN,P001926,16.25,3,40,37
168,PAN,P004088,16.083,10,49,39
168,PAN,P005161,15.5,11,41,30
168,PAN,P005353,27.933,24,85,61
168,PAN,P007866,9.883,-8,20,28
168,PAN,P009622,19.7,25,61,36
168,PAN,P011204,17.1,2,42,40
168,PAN,P011209,3.6,3,11,8
168,PAN,P012712,32.884,27,97,70
168,PAN,P012774,31.767,9,89,80
168,PAN,P013383,9.3,-1,20,21
168,VIR,P001844,3.434,0,10,10
168,VIR,P002084,17.917,-21,36,57
168,VIR,P004888,28.518,-10,65,75
168,VIR,P005738,15.984,4,40,36
168,VIR,P006739,25.834,-12,60,72
168,VIR,P009549,23.933,-13,52,65
168,VIR,P011816,17.317,8,44,36
168,VIR,P012585,19.05,-14,40,54
168,VIR,P012591,5.917,-10,7,17
168,VIR,P013374,24.017,-25,50,75
168,VIR,PBCN,18.084,-12,46,58
169,BAR,P002939,22.916,8,56,48
169,BAR,P003196,20.566,11,53,42
169,BAR,P003478,26.833,8,67,59
169,BAR,P006568,11.917,7,22,15
169,BAR,P009862,32.499,10,75,65
169,BAR,P009992,11.249,-4,19,23
169,BAR,P010106,16.9,3,34,31
169,BAR,P012745,32.199,9,78,69
169,BAR,P012795,9.833,6,19,13
169,BAR,P013379,15.083,-3,27,30
169,PRS,P004197,14.7,-7,26,33
169,PRS,P004512,5.867,-4,8,12
169,PRS,P005793,19.434,-8,36,44
169,PRS,P007032,21.768,-10,43,53
169,PRS,P010390,22.701,-9,45,54
169,PRS,P012608,27.017,-8,50,58
169,PRS,P012609,16.517,3,39,36
169,PRS,P012610,23.65,-4,49,53
169,PRS,P012613,24.55,-7,50,57
169,PRS,P012640,17.384,-5,34,39
169,PRS,P013373,6.417,4,15,11
170,PAR,P006591,18.232,18,46,28
170,PAR,P006760,15.9,10,33,23
170,PAR,P007632,19.567,3,46,43
170,PAR,P007870,15.633,11,34,23
170,PAR,P008232,10.433,11,30,19
170,PAR,P010781,16.899,-2,42,44
170,PAR,P011050,3.467,1,14,13
170,PAR,P011836,12.883,2,31,29
170,PAR,P011981,20.899,11,50,39
170,PAR,P012720,23.883,25,60,35
170,PAR,P013369,20.316,13,45,32
170,PAR,P013370,21.883,12,59,47
170,TEL,P006835,32.468,-13,67,80
170,TEL,P007519,18.434,-11,34,45
170,TEL,P007990,22.501,-15,48,63
170,TEL,P011193,26.934,-6,52,58
170,TEL,P011202,11.249,-7,21,28
170,TEL,P011219,25.05,-10,47,57
170,TEL,P012604,15.984,-7,32,39
170,TEL,P013250,8.433,-12,10,22
170,TEL,P013381,13.25,-15,23,38
170,TEL,P013382,25.702,-19,41,60
171,MAD,P003108,25.017,8,56,48
171,MAD,P003583,6.933,5,18,13
171,MAD,P003733,21.167,2,42,40
171,MAD,P005791,22.166,5,46,41
171,MAD,P005928,24.85,19,66,47
171,MAD,P006540,21.699,21,58,37
171,MAD,P007630,10.901,2,24,22
171,MAD,P009213,14.983,4,32,28
171,MAD,P011247,15.15,-7,22,29
171,MAD,P011649,5.55,10,14,4
171,MAD,P013378,12.05,-4,24,28
171,MAD,PTGB,19.534,-5,38,43
171,MUN,P001557,21.766,-16,39,55
171,MUN,P004508,27.767,-3,57,60
171,MUN,P005460,11.934,-4,25,29
171,MUN,P007056,28.066,-8,51,59
171,MUN,P007201,15.3,-14,24,38
171,MUN,P007929,10.767,0,26,26
171,MUN,P011224,26.966,-5,51,56
171,MUN,P011244,19.4,3,40,37
171,MUN,P011987,30.684,-9,54,63
171,MUN,P012123,7.35,-4,13,17
172,BER,P006251,23.233,-4,44,48
172,BER,P007025,5.333,0,9,9
172,BER,P008062,24.2,-21,41,62
172,BER,P008173,16.534,3,37,34
172,BER,P008211,18.333,-5,37,42
172,BER,P008384,22.267,-12,38,50
172,BER,P008780,12.8,4,28,24
172,BER,P008967,20.533,-20,29,49
172,BER,P011631,15.934,-10,29,39
172,BER,P011934,19.25,-19,35,54
172,BER,P013386,21.583,-1,38,39
172,ULK,P002849,11.167,-4,24,28
172,ULK,P002968,21.932,26,57,31
172,ULK,P002969,6.449,-3,11,14
172,ULK,P003091,1.583,2,4,2
172,ULK,P004004,20.167,19,49,30
172,ULK,P006961,19.85,21,53,32
172,ULK,P007182,7.467,-4,10,14
172,ULK,P008962,33.832,13,78,65
172,ULK,P009783,15.716,4,30,26
172,ULK,P010560,19.333,1,45,44
172,ULK,P011205,26.15,10,60,50
172,ULK,P013396,16.349,0,29,29
173,BAR,P002939,18.5,8,38,30
173,BAR,P003478,19.899,24,55,31
173,BAR,P006568,12.567,2,26,24
173,BAR,P007464,16.684,18,48,30
173,BAR,P009862,24.5,3,63,60
173,BAR,P009992,28.767,12,75,63
173,BAR,P010106,7.917,7,20,13
173,BAR,P012745,24.866,-1,55,56
173,BAR,P012795,20.417,-12,43,55
173,BAR,P013379,25.883,9,67,58
173,MCO,P001932,9.583,-17,13,30
173,MCO,P002581,7.868,-7,14,21
173,MCO,P005844,23.384,6,56,50
173,MCO,P005985,31.067,0,70,70
173,MCO,P008099,27.301,7,69,62
173,MCO,P009754,22.184,-15,42,57
173,MCO,P011212,21.634,-13,46,59
173,MCO,P011231,21.818,-23,38,61
173,MCO,P012515,8.467,-2,14,16
173,MCO,P013365,19.733,6,48,42
173,MCO,PLCZ,6.966,-12,10,22
174,PAN,P004088,27.084,6,66,60
174,PAN,P005161,7.934,11,23,12
174,PAN,P005353,29.551,14,70,56
174,PAN,P007866,7.7,-1,16,17
174,PAN,P011204,37.384,8,88,80
174,PAN,P011209,12.067,5,26,21
174,PAN,P012712,34.751,7,82,75
174,PAN,P012774,35.534,6,85,79
174,PAN,P013383,8.0,4,24,20
174,PAR,P006591,12.834,5,28,23
174,PAR,P006760,24.801,-8,52,60
174,PAR,P007632,4.05,-5,5,10
174,PAR,P007870,20.617,-9,44,53
174,PAR,P008232,15.933,1,38,37
174,PAR,P010781,33.8,-14,72,86
174,PAR,P011836,13.517,-4,30,34
174,PAR,P011981,21.501,-8,43,51
174,PAR,P012720,31.434,1,72,71
174,PAR,P013369,10.851,-7,18,25
174,PAR,P013370,10.667,-12,18,30
175,MIL,P000796,22.017,28,64,36
175,MIL,P001518,18.783,6,46,40
175,MIL,P005670,14.1,15,43,28
175,MIL,P006509,16.799,11,49,38
175,MIL,P006721,3.533,-2,8,10
175,MIL,P007831,24.034,25,63,38
175,MIL,P008985,22.2,24,58,34
175,MIL,P008987,19.133,16,57,41
175,MIL,P011064,23.267,19,59,40
175,MIL,P011941,16.534,18,39,21
175,MIL,P013384,19.6,5,49,44
175,TEL,P006835,26.915,-22,47,69
175,TEL,P007519,28.1,-17,52,69
175,TEL,P007990,21.6,-18,42,60
175,TEL,P011193,19.667,-20,33,53
175,TEL,P011202,11.817,-6,26,32
175,TEL,P011214,16.117,-16,24,40
175,TEL,P011219,17.568,-13,37,50
175,TEL,P012604,16.816,-17,32,49
175,TEL,P013250,6.9,-8,13,21
175,TEL,P013381,7.4,-6,15,21
175,TEL,P013382,27.1,-22,49,71
176,ASV,P000229,10.35,-1,20,21
176,ASV,P002100,23.549,3,51,48
176,ASV,P003526,13.117,8,23,15
176,ASV,P007027,26.817,11,54,43
176,ASV,P008991,22.483,19,51,32
176,ASV,P010316,16.798,-8,32,40
176,ASV,P010545,17.516,-13,31,44
176,ASV,P011225,17.383,-14,32,46
176,ASV,P013371,22.133,20,50,30
176,ASV,P013405,29.849,5,66,61
176,IST,P004887,26.233,6,54,48
176,IST,P006590,9.934,-2,13,15
176,IST,P007109,18.485,-8,29,37
176,IST,P007200,31.301,-2,62,64
176,IST,P009513,5.233,-2,8,10
176,IST,P009846,25.435,-9,41,50
176,IST,P011078,31.15,1,68,67
176,IST,P012710,23.333,0,49,49
176,IST,P012788,11.568,-10,20,30
176,IST,P013363,11.4,-1,25,26
176,IST,P013364,5.933,-3,11,14
177,MAD,P003108,26.618,10,54,44
177,MAD,P003583,19.151,19,38,19
177,MAD,P003733,25.883,22,53,31
177,MAD,P005791,10.467,0,23,23
177,MAD,P005928,23.118,-10,43,53
177,MAD,P006540,16.051,-2,31,33
177,MAD,P007630,10.283,0,22,22
177,MAD,P009213,13.866,10,33,23
177,MAD,P011247,21.3,27,51,24
177,MAD,P011649,5.733,-1,9,10
177,MAD,P013378,11.868,0,25,25
177,MAD,PTGB,15.667,20,33,13
177,ZAL,P002329,19.618,-22,22,44
177,ZAL,P002676,28.934,0,59,59
177,ZAL,P003048,8.15,-13,3,16
177,ZAL,P003210,11.767,-2,18,20
177,ZAL,P005504,15.517,6,35,29
177,ZAL,P007029,16.418,-3,22,25
177,ZAL,P007513,28.502,-19,46,65
177,ZAL,P007975,2.733,7,11,4
177,ZAL,P011051,16.335,-12,26,38
177,ZAL,P011983,14.217,-8,21,29
177,ZAL,P012715,16.218,-10,24,34
177,ZAL,P013403,21.601,-19,33,52
178,PRS,P004197,13.767,-1,21,22
178,PRS,P004512,6.834,-9,9,18
178,PRS,P005793,6.116,-7,7,14
178,PRS,P007032,19.083,-9,39,48
178,PRS,P010390,19.733,-4,31,35
178,PRS,P012608,26.767,-6,43,49
178,PRS,P012609,16.95,-11,31,42
178,PRS,P012610,26.0,-2,43,45
178,PRS,P012612,5.583,2,17,15
178,PRS,P012613,25.184,-3,41,44
178,PRS,P012640,20.75,-20,37,57
178,PRS,P013373,13.233,-10,26,36
178,RED,P000848,21.885,5,46,41
178,RED,P004866,17.084,-1,31,32
178,RED,P006436,17.317,16,42,26
178,RED,P007960,22.434,8,51,43
178,RED,P009035,26.485,11,54,43
178,RED,P009048,27.468,7,60,53
178,RED,P010588,10.434,-1,17,18
178,RED,P010612,23.718,12,51,39
178,RED,P011194,20.651,14,48,34
178,RED,P012044,12.534,9,25,16
179,MUN,P001557,19.5,-27,29,56
179,MUN,P004508,21.734,-12,46,58
179,MUN,P005460,1.851,-11,0,11
179,MUN,P007056,19.383,-12,38,50
179,MUN,P007201,19.383,-12,38,50
179,MUN,P007639,18.784,-22,31,53
179,MUN,P007929,14.451,-28,16,44
179,MUN,P011224,18.749,-10,35,45
179,MUN,P011987,17.85,-13,35,48
179,MUN,P012123,20.534,-29,31,60
179,MUN,P012126,7.168,-8,15,23
179,MUN,P013368,20.618,-31,31,62
179,OLY,P003469,35.233,48,103,55
179,OLY,P003941,20.366,33,66,33
179,OLY,P007853,27.8,31,80,49
179,OLY,P007947,22.367,17,62,45
179,OLY,P007982,23.183,27,65,38
179,OLY,P008811,17.267,12,43,31
179,OLY,P008829,23.583,27,65,38
179,OLY,P008855,5.4,12,16,4
179,OLY,P009849,3.95,-4,6,10
179,OLY,P010392,14.817,12,42,30
179,OLY,P011965,3.667,2,9,7
179,OLY,P013514,2.367,-2,3,5
180,BAS,P004058,20.751,16,46,30
180,BAS,P007579,20.334,20,49,29
180,BAS,P008072,4.733,8,13,5
180,BAS,P008850,14.367,-20,15,35
180,BAS,P011085,23.534,18,55,37
180,BAS,P011196,26.051,-21,38,59
180,BAS,P012058,7.483,9,19,10
180,BAS,P012080,31.367,-11,54,65
180,BAS,P012201,20.934,-22,27,49
180,BAS,P013367,30.451,-7,54,61
180,VIR,P001844,11.516,-9,14,23
180,VIR,P002084,29.349,13,61,48
180,VIR,P005738,24.732,13,53,40
180,VIR,P006273,0.117,-1,2,3
180,VIR,P006739,34.05,4,68,64
180,VIR,P009549,33.231,15,69,54
180,VIR,P011816,10.65,-11,15,26
180,VIR,P012585,31.233,14,66,52
180,VIR,P013374,15.3,-11,23,34
180,VIR,PBCN,9.817,-17,9,26
181,ASV,P000229,14.833,-15,25,40
181,ASV,P002100,15.782,-16,20,36
181,ASV,P003526,14.199,-20,19,39
181,ASV,P007027,22.149,-22,33,55
181,ASV,P008991,16.866,-23,22,45
181,ASV,P010316,24.783,-11,43,54
181,ASV,P010545,19.75,-6,36,42
181,ASV,P011225,19.799,-6,34,40
181,ASV,P012263,4.1,1,7,6
181,ASV,P013371,20.034,-19,30,49
181,ASV,P013377,3.35,-2,4,6
181,ASV,P013405,24.35,-16,37,53
181,PAR,P006760,21.716,22,47,25
181,PAR,P007632,4.1,-1,6,7
181,PAR,P007736,18.466,14,35,21
181,PAR,P007870,18.75,17,39,22
181,PAR,P008232,5.917,2,13,11
181,PAR,P010781,28.516,25,68,43
181,PAR,P011050,10.967,8,29,21
181,PAR,P011836,20.149,9,46,37
181,PAR,P011981,22.532,24,60,36
181,PAR,P012720,23.116,19,60,41
181,PAR,P013369,25.766,16,62,46
182,BAS,P004058,18.933,1,51,50
182,BAS,P007579,11.817,-8,36,44
182,BAS,P008072,12.616,2,24,22
182,BAS,P011085,15.333,-2,40,42
182,BAS,P011196,28.382,-2,58,60
182,BAS,P012080,37.066,2,82,80
182,BAS,P012201,37.183,6,84,78
182,BAS,P012597,35.933,-6,70,76
182,BAS,P013367,27.732,2,60,58
182,OLY,P001255,10.833,-5,15,20
182,OLY,P003469,39.199,2,87,85
182,OLY,P003941,13.883,4,40,36
182,OLY,P007853,34.316,6,87,81
182,OLY,P007947,15.716,-1,42,43
182,OLY,P007982,32.399,2,68,66
182,OLY,P008811,30.916,-3,62,65
182,OLY,P008829,5.85,-1,15,16
182,OLY,P010392,2.867,-3,4,7
182,OLY,P013380,39.016,4,90,86
183,BER,P006251,23.817,-20,46,66
183,BER,P007025,19.583,-15,28,43
183,BER,P007550,17.151,-6,28,34
183,BER,P008062,20.9,-26,29,55
183,BER,P008384,22.017,-13,39,52
183,BER,P008780,16.433,-11,34,45
183,BER,P008967,20.299,-20,39,59
183,BER,P011631,17.217,-17,24,41
183,BER,P011934,21.5,-16,35,51
183,BER,P013386,21.083,-16,38,54
183,MIL,P000796,22.001,18,63,45
183,MIL,P001518,16.416,17,38,21
183,MIL,P005670,11.967,1,26,25
183,MIL,P006509,17.865,18,44,26
183,MIL,P006701,4.067,8,10,2
183,MIL,P006721,3.5,6,8,2
183,MIL,P007831,23.667,18,64,46
183,MIL,P008985,25.517,21,70,49
183,MIL,P008987,19.766,12,46,34
183,MIL,P011064,16.517,8,40,32
183,MIL,P011941,22.384,19,55,36
183,MIL,P013384,16.333,14,36,22
184,IST,P004887,27.249,-4,53,57
184,IST,P006590,16.7,3,39,36
184,IST,P007109,17.083,-9,29,38
184,IST,P007200,31.033,-2,69,71
184,IST,P009664,18.284,0,45,45
184,IST,P009846,28.349,-5,59,64
184,IST,P011078,24.8,-2,49,51
184,IST,P012710,4.617,4,12,8
184,IST,P012788,12.634,0,28,28
184,IST,P013363,15.201,-4,29,33
184,IST,P013364,4.05,-1,8,9
184,PRS,P004197,13.266,4,35,31
184,PRS,P004512,9.65,-2,20,22
184,PRS,P005793,7.183,3,20,17
184,PRS,P007032,19.067,5,51,46
184,PRS,P010390,20.617,1,41,40
184,PRS,P012608,26.967,-3,54,57
184,PRS,P012609,17.517,-1,31,32
184,PRS,P012610,26.5,-2,54,56
184,PRS,P012613,25.984,2,53,51
184,PRS,P012640,16.933,8,42,34
184,PRS,P013373,16.316,5,39,34
185,MAD,P003108,28.217,-6,74,80
185,MAD,P003733,25.251,9,78,69
185,MAD,P005791,25.051,10,78,68
185,MAD,P005928,28.801,11,91,80
185,MAD,P006540,19.55,-3,54,57
185,MAD,P007630,14.9,-7,38,45
185,MAD,P009213,20.235,10,61,51
185,MAD,P011247,10.283,-1,35,36
185,MAD,P011649,6.066,-2,14,16
185,MAD,P013378,7.433,-5,20,25
185,MAD,PTGB,14.218,-1,37,38
185,TEL,P004233,12.7,-3,39,42
185,TEL,P006835,27.4,6,82,76
185,TEL,P007519,29.517,4,83,79
185,TEL,P007990,13.282,-6,35,41
185,TEL,P011193,24.015,-6,68,74
185,TEL,P011202,15.483,1,43,42
185,TEL,P011214,21.799,-10,63,73
185,TEL,P011219,19.949,1,54,53
185,TEL,P012604,10.116,-1,26,27
185,TEL,P013382,25.734,-1,72,73
186,VIR,P001133,23.266,-7,36,43
186,VIR,P001844,10.766,-2,16,18
186,VIR,P002084,11.184,-6,15,21
186,VIR,P005738,16.25,4,32,28
186,VIR,P006739,31.118,-9,52,61
186,VIR,P009549,28.967,4,55,51
186,VIR,P011816,8.634,-1,18,19
186,VIR,P012585,25.484,2,47,45
186,VIR,P012591,3.25,-8,2,10
186,VIR,P013374,20.668,-8,35,43
186,VIR,PBCN,20.418,-14,32,46
186,ZAL,P002329,25.984,5,55,50
186,ZAL,P002676,31.218,11,59,48
186,ZAL,P003048,20.968,4,38,34
186,ZAL,P005504,12.766,17,30,13
186,ZAL,P007029,7.4,0,16,16
186,ZAL,P007513,30.1,10,57,47
186,ZAL,P007975,28.818,11,60,49
186,ZAL,P011051,12.85,-9,17,26
186,ZAL,P012622,6.167,-6,9,15
186,ZAL,P012715,7.434,1,14,13
186,ZAL,P013403,16.3,1,30,29
187,RED,P002553,6.517,-2,17,19
187,RED,P004007,17.434,7,42,35
187,RED,P004866,24.0,-2,51,53
187,RED,P006436,18.9,-6,40,46
187,RED,P007960,19.034,1,45,44
187,RED,P009035,16.05,-10,28,38
187,RED,P009048,26.584,8,64,56
187,RED,P010588,3.05,-5,4,9
187,RED,P010612,21.868,-4,54,58
187,RED,P011194,20.384,5,52,47
187,RED,P012044,14.717,-11,29,40
187,RED,PJDR,11.467,-6,29,35
187,ULK,P002849,27.833,12,72,60
187,ULK,P004004,28.566,18,78,60
187,ULK,P005216,18.667,-14,40,54
187,ULK,P006961,21.683,-1,52,53
187,ULK,P007182,11.784,-7,22,29
187,ULK,P008104,11.699,16,32,16
187,ULK,P008962,34.25,-1,80,81
187,ULK,P009783,15.067,14,39,25
187,ULK,P010560,6.15,4,16,12
187,ULK,P011205,24.301,-16,49,65
188,BAR,P000925,16.067,-3,31,34
188,BAR,P002939,23.917,2,45,43
188,BAR,P003478,21.335,10,45,35
188,BAR,P006568,11.0,10,25,15
188,BAR,P007464,15.05,9,38,29
188,BAR,P009862,22.384,-4,40,44
188,BAR,P009992,20.017,16,48,32
188,BAR,P010106,15.917,5,35,30
188,BAR,P012745,32.2,7,68,61
188,BAR,P012795,4.1,-3,8,11
188,BAR,P013379,18.018,-4,27,31
188,PAN,P001926,19.632,-4,37,41
188,PAN,P004088,34.015,-12,64,76
188,PAN,P005161,1.533,1,4,3
188,PAN,P005353,22.583,6,42,36
188,PAN,P007866,12.765,-4,25,29
188,PAN,P009622,3.2,7,9,2
188,PAN,P011204,33.065,-5,60,65
188,PAN,P011209,0.15,-2,0,2
188,PAN,P012712,32.199,-9,58,67
188,PAN,P012774,30.832,-12,55,67
188,PAN,P013383,10.016,-11,11,22
189,MCO,P001932,12.301,5,28,23
189,MCO,P002581,23.417,9,59,50
189,MCO,P005844,11.117,-4,25,29
189,MCO,P005985,25.751,-7,58,65
189,MCO,P008099,21.816,-5,54,59
189,MCO,P009754,27.501,14,69,55
189,MCO,P011212,15.251,-8,35,43
189,MCO,P011226,14.884,-2,33,35
189,MCO,P011231,24.25,2,59,57
189,MCO,P012515,12.116,8,32,24
189,MCO,P013365,6.267,-11,8,19
189,MCO,PLCZ,5.334,-6,10,16
189,MUN,P001557,14.684,1,36,35
189,MUN,P004508,22.2,0,55,55
189,MUN,P005460,7.916,1,20,19
189,MUN,P007056,32.084,0,75,75
189,MUN,P007201,23.667,15,68,53
189,MUN,P007929,2.3,-1,5,6
189,MUN,P010391,27.6,8,72,64
189,MUN,P011224,23.333,-5,51,56
189,MUN,P011244,13.416,-11,19,30
189,MUN,P011987,32.8,-3,74,77
190,ASV,P000229,27.215,1,54,53
190,ASV,P002100,24.833,11,60,49
190,ASV,P003526,13.283,0,26,26
190,ASV,P007027,30.715,-4,62,66
190,ASV,P008991,12.183,10,29,19
190,ASV,P010316,16.4,0,34,34
190,ASV,P010545,23.182,-8,45,53
190,ASV,P011225,19.549,-8,33,41
190,ASV,P013371,16.049,23,45,22
190,ASV,P013377,9.583,5,22,17
190,ASV,P013405,31.998,5,70,65
190,BER,P006251,33.5,3,68,65
190,BER,P006919,8.134,0,16,16
190,BER,P007025,10.067,-9,16,25
190,BER,P008062,17.733,-2,33,35
190,BER,P008211,22.634,-10,39,49
190,BER,P008384,17.584,0,36,36
190,BER,P008780,25.801,-1,54,55
190,BER,P008967,36.334,1,78,77
190,BER,P011631,8.217,-10,16,26
190,BER,P011934,17.317,4,40,36
190,BER,P013386,27.684,-11,49,60
191,MIL,P000796,33.067,-8,65,73
191,MIL,P001518,8.617,-12,9,21
191,MIL,P006509,22.568,-7,43,50
191,MIL,P007831,32.134,-13,60,73
191,MIL,P008985,27.467,-7,51,58
191,MIL,P008987,25.301,-24,37,61
191,MIL,P011064,23.001,-25,32,57
191,MIL,P011941,15.867,-1,30,31
191,MIL,P013384,11.983,-3,23,26
191,PAR,P006760,22.916,14,52,38
191,PAR,P007736,4.5,-3,10,13
191,PAR,P007870,16.616,1,34,33
191,PAR,P008232,10.133,1,22,21
191,PAR,P010781,32.566,22,74,52
191,PAR,P011050,4.367,-5,7,12
191,PAR,P011836,9.516,5,22,17
191,PAR,P011981,29.366,24,69,45
191,PAR,P012720,35.499,23,80,57
191,PAR,P013369,34.516,18,80,62
192,PRS,P004197,16.984,-13,39,52
192,PRS,P004512,11.984,-2,26,28
192,PRS,P007032,13.567,-7,34,41
192,PRS,P010390,18.95,22,48,26
192,PRS,P012608,23.017,26,57,31
192,PRS,P012609,18.95,22,48,26
192,PRS,P012610,23.017,26,57,31
192,PRS,P012611,3.417,-6,5,11
192,PRS,P012612,9.067,-7,22,29
192,PRS,P012613,23.017,26,57,31
192,PRS,P012640,21.051,-9,48,57
192,PRS,P013373,16.984,-13,39,52
192,TEL,P006835,30.25,1,64,63
192,TEL,P007519,27.634,-17,52,69
192,TEL,P007990,24.267,-7,52,59
192,TEL,P011193,17.633,-6,38,44
192,TEL,P011202,18.984,-12,37,49
192,TEL,P011214,15.851,-11,29,40
192,TEL,P011219,14.267,-7,30,37
192,TEL,P011433,2.166,7,9,2
192,TEL,P012604,12.449,-3,28,31
192,TEL,P013381,10.333,3,26,23
192,TEL,P013382,26.166,-13,50,63
193,MAD,P003108,30.182,-5,60,65
193,MAD,P003733,9.75,-8,20,28
193,MAD,P005791,25.248,-4,49,53
193,MAD,P005928,23.082,-16,41,57
193,MAD,P006540,23.999,-16,54,70
193,MAD,P007630,13.033,-4,29,33
193,MAD,P009213,14.516,-13,28,41
193,MAD,P011247,15.483,9,41,32
193,MAD,P011649,13.899,-6,33,39
193,MAD,P013378,12.633,10,39,29
193,MAD,PTGB,18.165,3,36,33
193,OLY,P001255,23.166,16,61,45
193,OLY,P003469,33.2,19,86,67
193,OLY,P003941,24.55,3,52,49
193,OLY,P007853,17.634,-6,43,49
193,OLY,P007947,26.766,10,67,57
193,OLY,P007982,14.084,-7,29,36
193,OLY,P008811,14.65,7,36,29
193,OLY,P008829,6.8,-9,10,19
193,OLY,P010392,5.883,-1,9,10
193,OLY,P013380,33.267,18,87,69
194,ULK,P002849,20.367,-1,45,46
194,ULK,P002968,12.667,10,33,23
194,ULK,P004004,23.232,15,66,51
194,ULK,P005216,6.6,2,16,14
194,ULK,P006961,26.032,23,70,47
194,ULK,P007182,5.816,-9,6,15
194,ULK,P008104,20.833,-2,48,50
194,ULK,P008962,33.349,10,82,72
194,ULK,P009783,17.616,3,45,42
194,ULK,P010560,3.917,-1,8,9
194,ULK,P011205,29.566,10,71,61
194,ZAL,P002329,24.717,-20,47,67
194,ZAL,P002676,19.633,-1,43,44
194,ZAL,P003048,14.251,-13,33,46
194,ZAL,P003210,0.2,0,0,0
194,ZAL,P005504,4.433,4,10,6
194,ZAL,P007029,0.2,0,0,0
194,ZAL,P007513,27.867,-21,48,69
194,ZAL,P007975,32.668,-6,77,83
194,ZAL,P011051,19.084,7,42,35
194,ZAL,P011983,15.534,-3,33,36
194,ZAL,P012622,15.567,-4,38,42
194,ZAL,P013403,25.851,-3,59,62
195,MCO,P005844,6.383,-12,8,20
195,MCO,P005985,38.665,-4,64,68
195,MCO,P008099,29.1,-2,57,59
195,MCO,P009754,18.015,1,28,27
195,MCO,P011212,20.199,-4,43,47
195,MCO,P011226,25.799,-9,46,55
195,MCO,P011231,36.899,7,73,66
195,MCO,P012515,23.515,-17,40,57
195,MCO,P013365,2.799,4,8,4
195,MCO,PLCZ,23.616,6,43,37
195,RED,P004007,16.449,-9,32,41
195,RED,P004866,35.066,12,63,51
195,RED,P006436,5.233,-7,18,25
195,RED,P007960,14.132,-4,31,35
195,RED,P009035,22.583,-14,34,48
195,RED,P009048,32.6,17,67,50
195,RED,P010588,2.034,-8,2,10
195,RED,P010612,38.766,17,75,58
195,RED,P011194,22.416,20,54,34
195,RED,P012044,35.716,6,64,58
196,BAS,P004058,7.334,-2,13,15
196,BAS,P007579,9.717,-14,12,26
196,BAS,P008072,9.917,2,18,16
196,BAS,P011085,12.6,-7,21,28
196,BAS,P011196,28.167,17,73,56
196,BAS,P011948,15.884,3,36,33
196,BAS,P012080,31.084,23,79,56
196,BAS,P012201,32.201,23,79,56
196,BAS,P012597,30.451,18,73,55
196,BAS,P013367,22.65,7,51,44
196,PAN,P001926,14.833,8,37,29
196,PAN,P004088,19.817,-13,32,45
196,PAN,P005161,15.734,5,39,34
196,PAN,P005353,26.567,-16,48,64
196,PAN,P009622,25.034,-6,51,57
196,PAN,P011204,16.118,-13,28,41
196,PAN,P011209,19.967,-1,45,46
196,PAN,P012712,29.501,-25,48,73
196,PAN,P012774,24.234,-17,38,55
196,PAN,P013383,8.2,8,19,11
197,MUN,P001557,21.283,14,49,35
197,MUN,P004508,26.284,-14,37,51
197,MUN,P005460,9.551,-2,14,16
197,MUN,P007056,28.567,-5,58,63
197,MUN,P007201,28.917,-22,48,70
197,MUN,P007929,3.234,-10,2,12
197,MUN,P010391,22.966,-13,39,52
197,MUN,P011224,21.218,-3,39,42
197,MUN,P011244,7.884,1,12,11
197,MUN,P011987,30.084,6,62,56
197,MUN,P012123,0.017,-2,0,2
197,VIR,P001133,28.133,9,67,58
197,VIR,P001844,17.766,3,30,27
197,VIR,P002084,21.016,10,44,34
197,VIR,P005738,17.133,-7,32,39
197,VIR,P006739,28.051,9,59,50
197,VIR,P009549,32.149,7,72,65
197,VIR,P012585,28.132,14,56,42
197,VIR,P012591,8.933,-4,19,23
197,VIR,P013374,13.799,6,21,15
197,VIR,PBCN,4.883,3,10,7
198,BAR,P000925,17.149,12,39,27
198,BAR,P002939,20.251,1,47,46
198,BAR,P003478,22.617,6,49,43
198,BAR,P006568,15.117,3,39,36
198,BAR,P007464,6.583,1,20,19
198,BAR,P009862,23.917,-3,49,52
198,BAR,P009992,22.65,13,59,46
198,BAR,P010106,21.716,13,46,33
198,BAR,P012745,25.867,-1,53,54
198,BAR,P012795,7.466,3,15,12
198,BAR,P013379,16.667,2,34,32
198,IST,P004887,21.133,-3,39,42
198,IST,P006590,18.5,-2,40,42
198,IST,P007109,14.117,4,37,33
198,IST,P007200,26.65,-6,53,59
198,IST,P009664,12.65,-8,23,31
198,IST,P009846,26.334,-5,54,59
198,IST,P011078,28.051,-8,54,62
198,IST,P012710,13.418,1,29,28
198,IST,P012742,13.401,-8,23,31
198,IST,P012788,11.934,-4,25,29
198,IST,P013363,7.084,-1,16,17
198,IST,P013364,6.733,-10,7,17
199,IST,P004887,22.333,25,54,29
199,IST,P006590,21.068,20,66,46
199,IST,P007109,16.967,11,45,34
199,IST,P007200,15.917,19,37,18
199,IST,P009846,24.617,34,63,29
199,IST,P011078,23.4,26,58,32
199,IST,P012710,22.234,34,63,29
199,IST,P012742,16.984,17,52,35
199,IST,P012788,17.668,19,56,37
199,IST,P013363,18.817,15,56,41
199,MIL,P001518,18.884,-18,37,55
199,MIL,P005670,4.967,-3,9,12
199,MIL,P006085,16.433,-25,29,54
199,MIL,P006509,12.534,-5,27,32
199,MIL,P006721,11.217,-1,28,29
199,MIL,P007831,22.951,-29,30,59
199,MIL,P008985,23.4,-29,34,63
199,MIL,P008987,21.599,-38,29,67
199,MIL,P011064,16.184,-12,23,35
199,MIL,P011941,28.302,-31,38,69
199,MIL,P013384,23.534,-29,46,75
200,PAN,P001926,20.166,33,59,26
200,PAN,P004088,22.433,7,49,42
200,PAN,P005161,4.717,-3,9,12
200,PAN,P007866,5.95,-9,8,17
200,PAN,P009622,3.066,-2,5,7
200,PAN,P011204,30.817,-11,58,69
200,PAN,P011209,15.617,3,28,25
200,PAN,P011442,0.917,-2,0,2
200,PAN,P012712,32.217,18,75,57
200,PAN,P012774,30.384,9,73,64
200,PAN,P013383,33.716,22,81,59
200,ZAL,P002329,16.965,-8,34,42
200,ZAL,P002676,20.016,-4,38,42
200,ZAL,P003048,12.965,16,36,20
200,ZAL,P005504,25.215,-22,40,62
200,ZAL,P007029,19.398,-8,36,44
200,ZAL,P007513,25.165,3,49,46
200,ZAL,P007975,20.899,-21,35,56
200,ZAL,P011983,1.866,-1,3,4
200,ZAL,P012622,22.748,-6,46,52
200,ZAL,P012715,5.033,3,11,8
200,ZAL,P013403,29.715,-17,52,69
201,MCO,P001932,22.484,-13,41,54
201,MCO,P004790,10.283,9,25,16
201,MCO,P005844,24.899,18,58,40
201,MCO,P005985,35.466,10,82,72
201,MCO,P008099,32.383,10,73,63
201,MCO,P008161,14.55,13,34,21
201,MCO,P011226,19.1,-12,30,42
201,MCO,P011231,21.85,10,54,44
201,MCO,P012515,4.767,-3,9,12
201,MCO,PLCZ,14.218,-12,24,36
201,VIR,P001133,24.383,-7,45,52
201,VIR,P001844,17.633,12,42,30
201,VIR,P002084,14.0,-9,24,33
201,VIR,P005738,15.699,-10,24,34
201,VIR,P006739,33.366,-7,69,76
201,VIR,P009549,22.45,-11,42,53
201,VIR,P012585,21.865,1,44,43
201,VIR,P012591,18.033,7,42,35
201,VIR,P013374,16.833,9,38,29
201,VIR,PBCN,15.733,-15,30,45
203,RED,P002553,4.534,0,10,10
203,RED,P004007,9.666,-5,14,19
203,RED,P004866,25.568,-8,48,56
203,RED,P006436,8.034,-7,12,19
203,RED,P007960,7.284,-11,4,15
203,RED,P009035,20.451,-3,38,41
203,RED,P009048,21.434,-10,42,52
203,RED,P010588,23.134,-1,49,50
203,RED,P010612,21.418,-9,31,40
203,RED,P011194,22.268,-5,43,48
203,RED,P012044,16.868,-2,29,31
203,RED,PJDR,19.351,1,45,44
203,TEL,P005145,1.733,2,2,0
203,TEL,P006835,31.902,4,66,62
203,TEL,P007519,32.718,9,71,62
203,TEL,P007990,21.968,4,45,41
203,TEL,P011193,30.268,10,59,49
203,TEL,P011202,5.417,-4,9,13
203,TEL,P011214,20.467,21,46,25
203,TEL,P011219,18.268,-7,39,46
203,TEL,P012604,7.717,8,19,11
203,TEL,P013381,6.051,5,14,9
203,TEL,P013382,23.501,8,55,47
207,PAR,P006760,27.766,12,71,59
207,PAR,P007736,18.816,10,41,31
207,PAR,P007870,15.567,5,35,30
207,PAR,P008232,8.766,-2,14,16
207,PAR,P010781,36.666,-2,83,85
207,PAR,P011050,2.383,-6,4,10
207,PAR,P011981,27.466,1,63,62
207,PAR,P012720,29.616,1,65,64
207,PAR,P013369,32.949,11,84,73
207,PRS,P004197,16.334,-8,33,41
207,PRS,P004512,10.133,-2,20,22
207,PRS,P005793,6.033,-10,13,23
207,PRS,P007032,16.317,-13,32,45
207,PRS,P010390,16.034,1,34,33
207,PRS,P012608,27.201,3,61,58
207,PRS,P012609,16.45,6,39,33
207,PRS,P012610,27.201,3,61,58
207,PRS,P012612,2.667,-1,4,5
207,PRS,P012613,27.201,3,61,58
207,PRS,P012640,22.317,-5,47,52
207,PRS,P013373,12.117,-7,25,32
202,BAS,P004058,9.3,-8,14,22
202,BAS,P007579,15.917,-1,32,33
202,BAS,P008072,12.9,-5,27,32
202,BAS,P008850,13.55,-5,29,34
202,BAS,P011085,26.433,4,60,56
202,BAS,P011196,18.517,2,42,40
202,BAS,P011948,11.066,5,28,23
202,BAS,P012201,32.7,2,77,75
202,BAS,P012597,26.384,-7,58,65
202,BAS,P013367,33.233,8,78,70
202,MAD,P003108,24.483,-2,51,53
202,MAD,P003583,4.017,-7,7,14
202,MAD,P003733,21.516,10,52,42
202,MAD,P005791,23.516,8,58,50
202,MAD,P005928,31.799,0,75,75
202,MAD,P006540,29.249,5,70,65
202,MAD,P007630,17.799,4,39,35
202,MAD,P009213,10.183,-1,25,26
202,MAD,P011247,9.383,0,17,17
202,MAD,P011649,5.767,-8,9,17
202,MAD,P013378,12.716,-1,29,30
202,MAD,PTGB,9.567,-3,18,21
204,BER,P006251,24.917,-13,46,59
204,BER,P006919,15.083,-2,38,40
204,BER,P007025,9.8,2,29,27
204,BER,P008062,23.684,-8,48,56
204,BER,P008173,16.316,-7,36,43
204,BER,P008211,21.8,-17,33,50
204,BER,P008384,18.2,2,51,49
204,BER,P008967,30.2,-17,55,72
204,BER,P011934,16.584,-2,45,47
204,BER,P013386,23.416,-13,39,52
204,MUN,P001288,22.783,-4,51,55
204,MUN,P001557,20.484,26,62,36
204,MUN,P004508,23.233,0,55,55
204,MUN,P007056,29.583,26,73,47
204,MUN,P007201,16.467,-8,40,48
204,MUN,P010391,26.267,16,65,49
204,MUN,P011244,17.283,4,38,34
204,MUN,P011987,34.384,20,87,67
204,MUN,P012123,5.233,-2,11,13
204,MUN,P013368,4.283,-3,13,16
205,ASV,P000229,9.383,-8,18,26
205,ASV,P002100,18.532,-3,45,48
205,ASV,P003526,21.016,10,54,44
205,ASV,P004194,10.283,-6,24,30
205,ASV,P007027,27.984,12,73,61
205,ASV,P008991,12.399,-1,28,29
205,ASV,P009818,11.316,-5,21,26
205,ASV,P010316,8.133,-1,21,22
205,ASV,P010545,21.45,20,61,41
205,ASV,P011225,25.283,12,68,56
205,ASV,P013371,9.799,-4,21,25
205,ASV,P013405,24.417,4,66,62
205,BAR,P000925,16.499,-5,35,40
205,BAR,P002939,26.383,-15,58,73
205,BAR,P003196,4.949,-1,14,15
205,BAR,P003478,21.517,-7,45,52
205,BAR,P006568,5.833,-1,12,13
205,BAR,P007464,13.466,1,35,34
205,BAR,P009862,29.631,-6,69,75
205,BAR,P009992,25.35,18,70,52
205,BAR,P012745,26.033,-8,63,71
205,BAR,P012795,11.683,-4,26,30
205,BAR,P013379,18.651,-2,43,45
206,OLY,P001255,19.066,-3,38,41
206,OLY,P003469,28.381,0,60,60
206,OLY,P003941,16.966,-8,27,35
206,OLY,P007947,17.499,-9,32,41
206,OLY,P007982,35.598,-3,68,71
206,OLY,P008811,18.949,-1,42,43
206,OLY,P008829,20.199,-9,37,46
206,OLY,P009849,6.55,-6,13,19
206,OLY,P010392,3.35,2,8,6
206,OLY,P013380,33.432,-13,60,73
206,ULK,P002849,11.5,9,29,20
206,ULK,P002968,24.934,-4,45,49
206,ULK,P004004,26.433,9,61,52
206,ULK,P005216,18.917,-2,42,44
206,ULK,P006961,30.717,9,66,57
206,ULK,P007182,3.566,5,13,8
206,ULK,P008104,14.033,6,32,26
206,ULK,P008962,36.017,5,75,70
206,ULK,P009783,15.633,5,31,26
206,ULK,P011205,18.25,8,41,33
208,MUN,P001288,24.499,5,56,51
208,MUN,P001557,24.784,21,65,44
208,MUN,P004508,22.983,7,54,47
208,MUN,P007056,22.7,4,50,46
208,MUN,P007201,17.316,10,47,37
208,MUN,P010391,31.965,10,78,68
208,MUN,P011244,28.382,10,71,61
208,MUN,P011987,27.366,8,64,56
208,ZAL,P002329,24.334,-5,50,55
208,ZAL,P002676,23.517,-4,56,60
208,ZAL,P003048,15.6,-1,33,34
208,ZAL,P003210,7.567,-5,12,17
208,ZAL,P005504,7.85,6,24,18
208,ZAL,P007029,20.817,-13,41,54
208,ZAL,P007975,31.951,-10,70,80
208,ZAL,P011051,20.934,-18,36,54
208,ZAL,P011983,14.35,-6,29,35
208,ZAL,P012622,10.018,-12,11,23
208,ZAL,P012715,6.883,0,14,14
208,ZAL,P013403,16.184,-7,34,41
209,BAR,P002939,26.25,-2,56,58
209,BAR,P003196,19.749,-6,39,45
209,BAR,P003478,18.834,4,47,43
209,BAR,P006568,9.883,-3,16,19
209,BAR,P007464,11.933,-1,25,26
209,BAR,P009862,26.032,-4,49,53
209,BAR,P009992,22.982,4,56,52
209,BAR,P010106,17.183,-3,36,39
209,BAR,P011666,1.983,-7,0,7
209,BAR,P012745,19.916,4,41,37
209,BAR,P013379,25.25,4,65,61
209,BAS,P004058,3.383,-4,6,10
209,BAS,P007579,10.216,-4,23,27
209,BAS,P008072,14.767,4,28,24
209,BAS,P011085,19.399,-2,43,45
209,BAS,P011196,24.999,-2,58,60
209,BAS,P011948,20.132,-1,50,51
209,BAS,P012080,28.183,10,64,54
209,BAS,P012201,29.783,6,65,59
209,BAS,P012597,18.65,-1,40,41
209,BAS,P013367,30.483,4,63,59
210,MIL,P006085,11.234,-3,18,21
210,MIL,P006509,18.866,0,34,34
210,MIL,P006721,16.6,-1,32,33
210,MIL,P007831,29.967,6,62,56
210,MIL,P008985,26.116,11,60,49
210,MIL,P008987,32.717,18,75,57
210,MIL,P011064,23.9,13,59,46
210,MIL,P011941,25.8,9,59,50
210,MIL,P013384,14.8,7,36,29
210,PAN,P001926,31.132,-13,59,72
210,PAN,P004088,25.35,-5,50,55
210,PAN,P005161,3.617,-4,8,12
210,PAN,P007866,25.8,1,52,51
210,PAN,P009622,9.283,-7,13,20
210,PAN,P011204,20.133,-6,37,43
210,PAN,P011209,5.016,-7,5,12
210,PAN,P011221,4.383,-12,4,16
210,PAN,P012712,33.583,-1,65,66
210,PAN,P012774,30.999,-5,61,66
210,PAN,P013383,10.699,-1,21,22
211,ASV,P000229,16.217,3,38,35
211,ASV,P002100,20.9,-9,45,54
211,ASV,P003526,9.401,-2,11,13
211,ASV,P004194,17.767,-1,41,42
211,ASV,P007027,28.184,-2,63,65
211,ASV,P008991,1.65,3,6,3
211,ASV,P009818,13.25,1,29,28
211,ASV,P010316,10.684,-7,15,22
211,ASV,P010545,14.718,-17,22,39
211,ASV,P011225,24.284,-4,44,48
211,ASV,P013371,15.717,-5,38,43
211,ASV,P013405,27.233,-5,58,63
211,PRS,P004197,15.499,2,43,41
211,PRS,P004512,8.566,-12,13,25
211,PRS,P005793,11.266,3,30,27
211,PRS,P007032,19.332,-3,47,50
211,PRS,P010390,20.6,19,46,27
211,PRS,P012608,24.5,7,48,41
211,PRS,P012609,16.667,19,40,21
211,PRS,P012610,24.5,7,48,41
211,PRS,P012613,24.5,7,48,41
211,PRS,P012640,21.149,-7,49,56
211,PRS,P013373,13.416,3,43,40
212,BER,P006251,17.3,-4,36,40
212,BER,P006919,18.333,1,41,40
212,BER,P007025,12.049,6,27,21
212,BER,P008062,19.783,0,44,44
212,BER,P008173,25.401,4,60,56
212,BER,P008211,26.701,0,62,62
212,BER,P008780,20.217,6,49,43
212,BER,P011626,0.583,2,2,0
212,BER,P011631,17.166,4,43,39
212,BER,P011934,27.5,13,66,53
212,BER,P013386,14.967,-2,35,37
212,TEL,P004233,7.05,-8,9,17
212,TEL,P005145,8.866,-4,24,28
212,TEL,P007519,14.116,-1,28,29
212,TEL,P007990,21.084,-9,46,55
212,TEL,P011193,27.7,9,70,61
212,TEL,P011202,11.701,5,30,25
212,TEL,P011214,21.767,-2,42,44
212,TEL,P011219,25.784,-3,59,62
212,TEL,P012604,10.45,-6,19,25
212,TEL,P013250,10.35,-13,14,27
212,TEL,P013381,11.199,1,25,24
212,TEL,P013382,29.933,1,69,68
213,ULK,P002849,17.266,-2,41,43
213,ULK,P002968,20.232,8,47,39
213,ULK,P002969,2.133,-3,6,9
213,ULK,P004004,22.967,4,53,49
213,ULK,P005216,23.515,13,62,49
213,ULK,P006961,19.867,14,53,39
213,ULK,P007182,10.301,5,22,17
213,ULK,P008104,16.5,-6,33,39
213,ULK,P008962,24.933,14,56,42
213,ULK,P009783,18.833,16,47,31
213,ULK,P010560,2.133,-3,6,9
213,ULK,P011205,21.315,10,49,39
213,VIR,P001133,29.268,-5,58,63
213,VIR,P001844,21.75,-13,45,58
213,VIR,P002084,14.017,-5,23,28
213,VIR,P005738,20.8,-12,44,56
213,VIR,P006273,2.133,3,9,6
213,VIR,P006739,25.934,-7,48,55
213,VIR,P009549,23.352,-6,47,53
213,VIR,P011816,9.783,-5,23,28
213,VIR,P012585,22.701,0,55,55
213,VIR,P012591,14.033,-12,19,31
213,VIR,P013374,8.617,-4,17,21
213,VIR,PBCN,7.617,-4,17,21
214,MAD,P003108,26.216,-5,49,54
214,MAD,P003733,24.183,-5,42,47
214,MAD,P005791,25.367,8,52,44
214,MAD,P005928,23.517,-5,38,43
214,MAD,P006540,20.15,-9,29,38
214,MAD,P009213,8.45,-5,11,16
214,MAD,P011247,20.2,4,45,41
214,MAD,P011649,16.084,5,33,28
214,MAD,P013667,14.633,-12,21,33
214,MAD,PTGB,21.2,4,45,41
214,MCO,P001932,33.499,17,69,52
214,MCO,P002581,14.715,-4,35,39
214,MCO,P004790,18.25,5,36,31
214,MCO,P005844,13.867,3,20,17
214,MCO,P005985,31.116,-5,55,60
214,MCO,P008099,23.399,-6,46,52
214,MCO,P011226,26.4,-3,45,48
214,MCO,P011231,16.582,3,31,28
214,MCO,P012515,12.8,6,27,21
214,MCO,PLCZ,9.367,4,21,17
215,IST,P004887,17.466,6,46,40
215,IST,P006372,0.05,0,0,0
215,IST,P006590,13.5,4,37,33
215,IST,P007109,13.568,-13,22,35
215,IST,P007200,21.401,-10,40,50
215,IST,P009664,5.833,3,13,10
215,IST,P009846,25.767,10,66,56
215,IST,P011078,17.067,-11,30,41
215,IST,P012710,20.817,5,54,49
215,IST,P012742,22.101,7,56,49
215,IST,P012788,22.235,-7,43,50
215,IST,P013363,20.2,-9,38,47
215,OLY,P001255,26.332,4,64,60
215,OLY,P003469,31.565,14,80,66
215,OLY,P003941,24.399,-3,52,55
215,OLY,P007853,21.548,2,47,45
215,OLY,P007947,12.966,3,27,24
215,OLY,P007982,27.599,6,68,62
215,OLY,P008811,15.549,6,40,34
215,OLY,P008829,8.483,-11,12,23
215,OLY,P009849,3.816,-4,5,9
215,OLY,P010392,0.933,-1,2,3
215,OLY,P013380,26.8,-1,63,64
216,PAR,P006760,30.65,-2,52,54
216,PAR,P007736,14.949,2,30,28
216,PAR,P007870,29.233,-6,48,54
216,PAR,P010781,25.633,1,46,45
216,PAR,P011836,18.2,-6,33,39
216,PAR,P011981,13.817,7,29,22
216,PAR,P012720,23.166,-1,38,39
216,PAR,P013369,27.185,-8,47,55
216,PAR,P013370,17.167,3,32,29
216,RED,P000848,11.083,-3,15,18
216,RED,P004866,30.9,9,61,52
216,RED,P006436,13.8,-2,24,26
216,RED,P007960,13.217,4,23,19
216,RED,P009035,27.384,2,46,44
216,RED,P009048,30.433,1,56,55
216,RED,P010588,18.833,1,37,36
216,RED,P010612,16.95,3,37,34
216,RED,P011194,28.067,-4,51,55
216,RED,P012044,9.333,-1,15,16
217,IST,P004887,25.001,-1,42,43
217,IST,P006372,4.3,-3,7,10
217,IST,P006590,12.166,-2,25,27
217,IST,P006640,0.284,-3,0,3
217,IST,P007109,23.534,-9,39,48
217,IST,P009846,31.767,13,66,53
217,IST,P011078,33.786,11,70,59
217,IST,P012710,16.468,15,40,25
217,IST,P012742,19.719,0,36,36
217,IST,P012788,15.001,7,37,30
217,IST,P013363,17.984,2,33,31
217,MAD,P003108,26.267,-9,47,56
217,MAD,P003733,25.536,-9,45,54
217,MAD,P005791,22.367,1,42,41
217,MAD,P005928,25.017,1,47,46
217,MAD,P006540,9.1,-6,12,18
217,MAD,P007630,16.601,2,29,27
217,MAD,P011247,16.935,-4,32,36
217,MAD,P011649,20.268,5,48,43
217,MAD,P013666,5.917,0,7,7
217,MAD,P013667,17.635,-7,31,38
217,MAD,PTGB,14.367,-4,25,29
218,BER,P006251,14.3,0,24,24
218,BER,P006919,19.917,-16,24,40
218,BER,P007025,15.768,-12,20,32
218,BER,P008062,20.533,-10,25,35
218,BER,P008173,22.019,-12,30,42
218,BER,P008211,21.117,-5,27,32
218,BER,P008967,20.052,-6,31,37
218,BER,P011626,9.267,-4,14,18
218,BER,P011631,17.035,-15,17,32
218,BER,P011934,22.635,-17,22,39
218,BER,P013386,17.367,-3,31,34
218,ZAL,P002329,26.066,19,54,35
218,ZAL,P002676,22.767,10,42,32
218,ZAL,P003048,18.782,10,38,28
218,ZAL,P003210,14.266,-2,23,25
218,ZAL,P005504,16.317,13,30,17
218,ZAL,P007029,13.849,7,24,17
218,ZAL,P007975,25.733,22,50,28
218,ZAL,P011051,4.9,-3,5,8
218,ZAL,P011330,2.5,1,5,4
218,ZAL,P011983,23.25,12,45,33
218,ZAL,P012622,13.933,1,19,18
218,ZAL,P013403,17.632,10,30,20
219,ASV,P000229,9.583,0,16,16
219,ASV,P002100,19.882,3,40,37
219,ASV,P003526,12.551,-2,16,18
219,ASV,P004194,23.749,-8,35,43
219,ASV,P007027,31.25,6,55,49
219,ASV,P009818,16.699,-8,32,40
219,ASV,P010316,6.216,-13,5,18
219,ASV,P010545,13.4,0,23,23
219,ASV,P011225,23.533,-2,36,38
219,ASV,P013371,11.716,-15,15,30
219,ASV,P013405,31.416,4,57,53
219,RED,P000848,13.516,0,20,20
219,RED,P002553,8.85,0,13,13
219,RED,P004007,8.833,-8,11,19
219,RED,P004866,24.216,-2,43,45
219,RED,P006436,15.099,12,32,20
219,RED,P007960,11.867,12,25,13
219,RED,P009035,23.999,8,48,40
219,RED,P009048,27.283,6,50,44
219,RED,P010588,20.166,-1,35,36
219,RED,P010612,18.166,6,36,30
219,RED,P011194,7.15,-1,12,13
219,RED,P012044,20.85,3,40,37
220,PAN,P001926,26.584,5,65,60
220,PAN,P004088,29.351,0,70,70
220,PAN,P005161,11.484,8,26,18
220,PAN,P007866,15.151,2,33,31
220,PAN,P009622,8.017,0,13,13
220,PAN,P011204,23.884,2,52,50
220,PAN,P011209,1.017,-5,2,7
220,PAN,P012712,32.634,-3,73,76
220,PAN,P012774,27.833,-1,65,66
220,PAN,P013383,24.05,-3,56,59
220,ULK,P002849,8.449,-12,8,20
220,ULK,P002968,22.9,10,56,46
220,ULK,P004004,23.482,-9,46,55
220,ULK,P005216,22.883,9,61,52
220,ULK,P006961,15.667,2,42,40
220,ULK,P007182,11.9,-4,27,31
220,ULK,P008104,9.133,-6,17,23
220,ULK,P008962,33.799,-1,77,78
220,ULK,P009783,23.632,-5,45,50
220,ULK,P011205,28.15,11,71,60
221,MIL,P001518,16.785,-2,33,35
221,MIL,P005670,6.2,-2,10,12
221,MIL,P006085,11.717,-7,21,28
221,MIL,P006509,21.568,-8,39,47
221,MIL,P006721,16.15,-5,32,37
221,MIL,P007831,24.518,-21,35,56
221,MIL,P008985,22.568,-8,39,47
221,MIL,P008987,27.668,-20,41,61
221,MIL,P011064,17.951,-9,31,40
221,MIL,P011941,13.201,-5,24,29
221,MIL,P013384,15.484,4,35,31
221,MIL,P013385,6.2,-2,10,12
221,MUN,P001288,24.501,21,56,35
221,MUN,P001557,24.535,9,54,45
221,MUN,P004508,27.968,5,58,53
221,MUN,P005460,5.734,-9,11,20
221,MUN,P007201,26.651,20,65,45
221,MUN,P007639,11.367,0,20,20
221,MUN,P010391,29.667,21,69,48
221,MUN,P011244,22.101,12,46,34
221,MUN,P011987,23.985,10,52,42
221,MUN,P012123,1.517,-1,2,3
221,MUN,P013368,1.984,-3,2,5
222,BAS,P004058,3.3,-9,0,9
222,BAS,P007230,9.65,-11,17,28
222,BAS,P007579,17.233,-1,44,45
222,BAS,P011085,20.016,-11,39,50
222,BAS,P011196,23.999,-7,43,50
222,BAS,P011948,8.584,-16,12,28
222,BAS,P012080,24.516,7,58,51
222,BAS,P012201,36.466,0,80,80
222,BAS,P012597,21.115,8,49,41
222,BAS,P013367,35.116,5,83,78
222,MCO,P001932,31.101,5,74,69
222,MCO,P002581,12.501,9,33,24
222,MCO,P004790,11.133,-9,22,31
222,MCO,P005844,19.617,1,43,42
222,MCO,P005985,32.018,-1,73,74
222,MCO,P008099,21.502,7,49,42
222,MCO,P008161,0.35,0,0,0
222,MCO,P011226,29.968,-7,58,65
222,MCO,P011231,20.585,22,57,35
222,MCO,P012515,13.701,11,35,24
222,MCO,PLCZ,7.534,-3,16,19
223,BAR,P002939,18.399,9,45,36
223,BAR,P003196,20.683,19,56,37
223,BAR,P003478,16.166,12,48,36
223,BAR,P006568,16.933,11,43,32
223,BAR,P007464,5.766,8,15,7
223,BAR,P009862,24.199,15,64,49
223,BAR,P009992,15.8,12,34,22
223,BAR,P010106,18.95,20,53,33
223,BAR,P011666,3.783,0,4,4
223,BAR,P012745,25.548,14,65,51
223,BAR,P012795,18.701,13,39,26
223,BAR,P013379,15.067,12,34,22
223,TEL,P004233,6.15,-8,7,15
223,TEL,P005145,6.45,-7,15,22
223,TEL,P007519,23.517,-5,49,54
223,TEL,P007990,18.402,-14,33,47
223,TEL,P011193,24.568,-25,49,74
223,TEL,P011202,13.818,-12,15,27
223,TEL,P011214,25.401,-20,46,66
223,TEL,P011219,27.685,-14,49,63
223,TEL,P011433,8.45,-7,11,18
223,TEL,P012604,16.701,-8,30,38
223,TEL,P013381,8.218,-15,11,26
223,TEL,P013382,20.65,-10,40,50
224,OLY,P001255,26.5,16,61,45
224,OLY,P003469,30.0,15,72,57
224,OLY,P003941,20.167,-2,36,38
224,OLY,P007853,20.068,-7,35,42
224,OLY,P007982,35.884,24,88,64
224,OLY,P008811,19.834,19,54,35
224,OLY,P008829,9.951,2,18,16
224,OLY,P010392,7.284,4,16,12
224,OLY,P011965,0.05,0,0,0
224,OLY,P013380,30.267,14,70,56
224,PRS,P004197,11.25,-18,13,31
224,PRS,P004512,9.4,-4,18,22
224,PRS,P005793,13.983,-7,22,29
224,PRS,P007032,14.167,-21,18,39
224,PRS,P010390,20.45,7,46,39
224,PRS,P012608,26.949,2,57,55
224,PRS,P012609,25.049,-5,52,57
224,PRS,P012610,26.949,2,57,55
224,PRS,P012611,1.8,-1,3,4
224,PRS,P012613,20.099,2,41,39
224,PRS,P012640,22.033,-23,32,55
224,PRS,P013373,7.866,-19,6,25
225,PAR,P006760,32.75,4,64,60
225,PAR,P007736,19.751,1,29,28
225,PAR,P007870,20.568,1,38,37
225,PAR,P008232,2.284,1,4,3
225,PAR,P010781,38.234,13,79,66
225,PAR,P011981,28.683,13,65,52
225,PAR,P012720,30.868,11,64,53
225,PAR,P013369,26.867,6,62,56
225,VIR,P001133,30.434,-6,59,65
225,VIR,P001844,17.517,-1,31,32
225,VIR,P002084,15.784,-8,20,28
225,VIR,P005738,16.017,6,33,27
225,VIR,P006739,22.583,-7,45,52
225,VIR,P009549,30.485,-8,53,61
225,VIR,P012585,25.367,-3,44,47
225,VIR,P012591,11.717,-5,23,28
225,VIR,P013374,16.3,-8,28,36
225,VIR,P013695,10.084,-5,16,21
225,VIR,PBCN,3.717,-5,3,8
226,MAD,P003583,15.933,-6,27,33
226,MAD,P003733,24.183,-8,42,50
226,MAD,P005791,21.967,0,40,40
226,MAD,P005928,23.684,-8,37,45
226,MAD,P007630,19.35,-12,33,45
226,MAD,P009213,1.183,-8,0,8
226,MAD,P011247,18.733,-3,32,35
226,MAD,P011649,16.4,-6,25,31
226,MAD,P013378,11.751,0,21,21
226,MAD,P013666,14.733,-1,25,26
226,MAD,P013667,22.75,-4,34,38
226,MAD,PTGB,9.333,1,19,18
226,ULK,P002849,19.966,8,41,33
226,ULK,P002968,14.034,1,26,25
226,ULK,P004004,18.967,12,38,26
226,ULK,P005216,16.15,-1,33,34
226,ULK,P006961,25.416,9,51,42
226,ULK,P007182,10.166,0,17,17
226,ULK,P008104,8.749,-7,7,14
226,ULK,P008962,31.534,17,65,48
226,ULK,P009783,23.183,16,48,32
226,ULK,P010560,9.601,-3,18,21
226,ULK,P011205,19.434,12,44,32
226,ULK,P013696,2.8,-9,2,11
227,BER,P006251,28.233,4,48,44
227,BER,P006919,15.884,-12,25,37
227,BER,P007025,12.283,-1,18,19
227,BER,P008062,22.401,-1,42,43
227,BER,P008173,21.434,-11,38,49
227,BER,P008211,23.666,4,41,37
227,BER,P008967,30.285,-4,59,63
227,BER,P011631,26.667,0,50,50
227,BER,P013386,19.152,-9,34,43
227,RED,P000848,17.8,8,34,26
227,RED,P002553,5.217,5,18,13
227,RED,P004007,18.868,-2,37,39
227,RED,P004866,21.2,0,34,34
227,RED,P006436,10.433,6,24,18
227,RED,P007960,6.784,4,13,9
227,RED,P009035,18.818,-3,31,34
227,RED,P009048,21.584,1,40,39
227,RED,P010588,17.751,5,36,31
227,RED,P010612,16.834,-1,31,32
227,RED,P011194,25.833,0,48,48
227,RED,P012044,18.883,7,39,32
228,MIL,P001518,9.949,1,23,22
228,MIL,P006085,14.833,0,30,30
228,MIL,P006509,24.016,-4,55,59
228,MIL,P006721,1.2,1,5,4
228,MIL,P007831,30.783,-7,64,71
228,MIL,P008985,19.499,16,55,39
228,MIL,P008987,32.833,4,71,67
228,MIL,P011064,25.166,2,59,57
228,MIL,P011941,28.317,2,59,57
228,MIL,P013384,7.933,-3,14,17
228,MIL,P013385,5.466,-2,10,12
228,ZAL,P002329,19.868,-1,45,46
228,ZAL,P002676,30.817,7,70,63
228,ZAL,P003048,7.651,1,18,17
228,ZAL,P003210,3.35,-7,4,11
228,ZAL,P005504,9.984,-1,22,23
228,ZAL,P007029,24.434,2,56,54
228,ZAL,P007975,30.451,-2,70,72
228,ZAL,P011051,22.033,-4,42,46
228,ZAL,P011983,21.433,3,45,42
228,ZAL,P012622,2.817,-7,4,11
228,ZAL,P013403,27.167,-1,59,60
229,IST,P004887,12.999,-5,26,31
229,IST,P006590,19.65,-14,46,60
229,IST,P007109,15.884,-14,34,48
229,IST,P009664,7.416,2,12,10
229,IST,P009846,29.967,-18,61,79
229,IST,P011078,27.317,-14,54,68
229,IST,P012710,20.567,-10,49,59
229,IST,P012742,11.8,2,34,32
229,IST,P012788,23.567,1,57,56
229,IST,P013363,30.833,-5,72,77
229,PAN,P001926,26.334,15,75,60
229,PAN,P004088,25.149,12,71,59
229,PAN,P005161,4.383,2,12,10
229,PAN,P007866,19.533,4,53,49
229,PAN,P009622,4.116,-1,9,10
229,PAN,P011204,29.699,1,73,72
229,PAN,P011209,1.45,1,1,0
229,PAN,P012712,33.149,10,83,73
229,PAN,P012774,33.249,17,83,66
229,PAN,P013383,22.933,14,60,46
230,ASV,P000229,17.817,-9,27,36
230,ASV,P002100,16.934,-11,27,38
230,ASV,P003526,24.884,4,44,40
230,ASV,P004194,19.184,-1,34,35
230,ASV,P007027,20.333,-11,28,39
230,ASV,P008991,3.45,-4,0,4
230,ASV,P009818,10.133,-15,9,24
230,ASV,P010316,0.117,3,3,0
230,ASV,P010545,21.468,9,47,38
230,ASV,P011225,26.751,-6,44,50
230,ASV,P013371,12.067,1,23,22
230,ASV,P013405,26.867,-5,49,54
230,MUN,P001288,25.25,11,49,38
230,MUN,P001557,17.4,12,37,25
230,MUN,P004508,24.067,-8,40,48
230,MUN,P005460,8.868,7,19,12
230,MUN,P007201,31.001,10,58,48
230,MUN,P007639,13.033,0,24,24
230,MUN,P010391,26.583,23,55,32
230,MUN,P011224,11.201,-9,21,30
230,MUN,P011244,14.8,-3,24,27
230,MUN,P011987,27.802,2,53,51
231,MCO,P001932,29.317,-7,56,63
231,MCO,P002581,12.967,-3,24,27
231,MCO,P004790,11.6,-4,21,25
231,MCO,P005844,15.217,-8,24,32
231,MCO,P005985,33.05,-13,54,67
231,MCO,P008099,29.0,-15,47,62
231,MCO,P008161,4.316,-1,8,9
231,MCO,P011226,32.2,-14,55,69
231,MCO,P011231,17.266,-9,29,38
231,MCO,P012515,7.417,-9,11,20
231,MCO,PLCZ,7.65,-2,16,18
231,PAR,P006760,26.45,14,61,47
231,PAR,P007736,13.366,13,34,21
231,PAR,P007870,16.267,3,30,27
231,PAR,P008232,13.55,3,25,22
231,PAR,P010781,27.517,16,63,47
231,PAR,P011981,23.733,14,56,42
231,PAR,P012720,29.467,10,61,51
231,PAR,P013369,28.717,5,56,51
231,PAR,P013370,20.933,7,44,37
232,BAS,P007230,10.833,5,22,17
232,BAS,P007579,14.817,-2,37,39
232,BAS,P008850,0.033,2,2,0
232,BAS,P011085,16.483,7,39,32
232,BAS,P011196,25.183,9,52,43
232,BAS,P011948,26.6,9,58,49
232,BAS,P012080,29.317,-2,59,61
232,BAS,P012201,29.167,2,67,65
232,BAS,P012597,14.9,-5,30,35
232,BAS,P013367,32.667,10,79,69
232,TEL,P004233,18.1,-2,28,30
232,TEL,P005145,14.133,-1,22,23
232,TEL,P007990,15.549,-4,24,28
232,TEL,P011193,22.768,-9,52,61
232,TEL,P011202,20.151,7,51,44
232,TEL,P011214,14.95,-1,24,25
232,TEL,P011219,24.551,-9,55,64
232,TEL,P012604,21.918,-8,50,58
232,TEL,P013250,17.233,2,30,28
232,TEL,P013381,8.117,-6,18,24
232,TEL,P013382,22.535,-4,56,60
233,BAR,P002939,28.251,7,66,59
233,BAR,P003196,9.033,2,21,19
233,BAR,P006568,17.917,-6,36,42
233,BAR,P007464,11.517,-3,22,25
233,BAR,P009862,28.234,6,68,62
233,BAR,P009992,20.001,-3,41,44
233,BAR,P010106,11.75,-9,22,31
233,BAR,P012745,29.051,-4,60,64
233,BAR,P012795,20.35,-4,45,49
233,BAR,P013379,23.901,4,59,55
233,OLY,P001255,23.2,12,53,41
233,OLY,P003469,32.333,9,73,64
233,OLY,P003941,15.683,4,40,36
233,OLY,P007853,19.567,-8,43,51
233,OLY,P007982,31.533,6,70,64
233,OLY,P008811,24.317,-2,50,52
233,OLY,P008829,10.0,-6,23,29
233,OLY,P010392,8.333,1,18,17
233,OLY,P011965,8.467,-4,20,24
233,OLY,P013380,26.567,-2,60,62
234,PRS,P004197,16.05,4,34,30
234,PRS,P004512,5.483,10,18,8
234,PRS,P005793,12.783,25,41,16
234,PRS,P007032,16.817,15,46,31
234,PRS,P010390,24.185,-1,45,46
234,PRS,P011949,4.75,-14,3,17
234,PRS,P012608,26.701,1,51,50
234,PRS,P012609,18.434,-10,33,43
234,PRS,P012610,20.434,-8,35,43
234,PRS,P012613,27.651,5,54,49
234,PRS,P012640,21.967,17,52,35
234,PRS,P013373,4.75,-14,3,17
234,VIR,P001133,29.27,2,60,58
234,VIR,P001844,17.302,-12,29,41
234,VIR,P002084,20.517,0,40,40
234,VIR,P005738,22.902,-8,36,44
234,VIR,P006739,25.569,-1,50,51
234,VIR,P009549,27.686,-9,52,61
234,VIR,P012585,12.867,-3,24,27
234,VIR,P012591,14.067,-6,26,32
234,VIR,P013374,5.683,-3,11,14
234,VIR,P013695,14.051,2,34,32
234,VIR,PBCN,10.101,8,23,15
235,RED,P000848,27.118,-1,57,58
235,RED,P004007,3.134,-4,4,8
235,RED,P004866,30.968,-1,62,63
235,RED,P006436,6.568,-6,12,18
235,RED,P007960,10.734,2,26,24
235,RED,P009035,26.102,-5,45,50
235,RED,P009048,21.834,-2,48,50
235,RED,P010588,13.185,-4,27,31
235,RED,P010612,13.719,-4,25,29
235,RED,P011194,29.234,-6,60,66
235,RED,P012044,17.419,1,34,33
235,ZAL,P002329,17.351,1,37,36
235,ZAL,P002676,30.283,3,66,63
235,ZAL,P003048,19.833,4,39,35
235,ZAL,P005504,10.3,4,23,19
235,ZAL,P007029,23.534,-3,46,49
235,ZAL,P007513,16.9,1,34,33
235,ZAL,P007975,32.684,12,75,63
235,ZAL,P011051,18.068,-2,41,43
235,ZAL,P011330,0.117,-2,0,2
235,ZAL,P011983,27.467,10,60,50
235,ZAL,P012181,0.634,-2,0,2
235,ZAL,P012715,2.834,4,9,5
236,MCO,P002581,5.501,-8,8,16
236,MCO,P004132,23.735,-3,47,50
236,MCO,P004790,12.134,-1,25,26
236,MCO,P005844,17.167,1,36,35
236,MCO,P005985,28.068,-4,62,66
236,MCO,P008099,22.168,-7,45,52
236,MCO,P009754,22.851,-5,43,48
236,MCO,P011212,23.518,-2,50,52
236,MCO,P011226,27.251,-5,49,54
236,MCO,P011231,17.617,4,35,31
236,MIL,P000796,28.366,14,63,49
236,MIL,P001392,15.966,6,36,30
236,MIL,P001518,13.782,-6,23,29
236,MIL,P005670,2.599,-2,2,4
236,MIL,P006085,11.966,5,33,28
236,MIL,P006509,21.449,8,49,41
236,MIL,P006721,0.067,0,0,0
236,MIL,P007831,31.05,7,69,62
236,MIL,P008987,29.834,5,68,63
236,MIL,P011064,24.634,-3,45,48
236,MIL,P011941,8.366,-1,18,19
236,MIL,P013384,11.916,-3,24,27
237,MUN,P001288,29.715,-10,64,74
237,MUN,P001557,16.683,1,40,39
237,MUN,P004508,26.782,5,64,59
237,MUN,P005460,9.265,-9,16,25
237,MUN,P007201,27.831,10,61,51
237,MUN,P007639,7.634,-4,18,22
237,MUN,P010391,26.532,-7,54,61
237,MUN,P011224,24.732,0,57,57
237,MUN,P011244,2.317,-1,2,3
237,MUN,P011987,28.232,-10,62,72
237,MUN,P012123,0.267,0,2,2
237,PRS,P004197,14.733,7,39,32
237,PRS,P005793,14.366,7,34,27
237,PRS,P007032,23.032,1,53,52
237,PRS,P010390,23.45,-2,49,51
237,PRS,P011949,13.45,7,34,27
237,PRS,P012608,27.416,-4,60,64
237,PRS,P012610,25.732,-2,57,59
237,PRS,P012613,22.133,3,48,45
237,PRS,P012640,18.684,6,49,43
237,PRS,P013373,16.999,2,42,40
238,BAR,P002939,27.383,-2,60,62
238,BAR,P003196,5.35,-3,6,9
238,BAR,P003478,11.033,-9,18,27
238,BAR,P006568,17.983,12,37,25
238,BAR,P007464,24.649,1,61,60
238,BAR,P009992,24.265,-5,60,65
238,BAR,P011666,0.233,0,0,0
238,BAR,P012317,3.817,-5,7,12
238,BAR,P012745,30.567,-6,73,79
238,BAR,P012795,29.533,7,75,68
238,BAR,P013379,25.182,-15,58,73
238,MAD,P003108,25.534,2,64,62
238,MAD,P003583,4.75,0,10,10
238,MAD,P003733,24.284,13,69,56
238,MAD,P005791,22.301,7,54,47
238,MAD,P005928,28.185,0,73,73
238,MAD,P006540,26.384,2,68,66
238,MAD,P007630,14.884,0,32,32
238,MAD,P011247,13.166,5,27,22
238,MAD,P011649,4.934,-3,10,13
238,MAD,P013378,7.217,-7,11,18
238,MAD,P013667,12.483,-1,30,31
238,MAD,PTGB,15.883,7,32,25
239,TEL,P007990,23.632,6,54,48
239,TEL,P011202,18.416,15,47,32
239,TEL,P011214,28.683,14,67,53
239,TEL,P011219,28.283,8,66,58
239,TEL,P011433,15.167,14,46,32
239,TEL,P012604,18.299,10,44,34
239,TEL,P013381,17.517,14,45,31
239,TEL,P013382,26.266,8,58,50
239,TEL,P013699,23.732,1,43,42
239,ULK,P002849,10.967,-9,15,24
239,ULK,P002968,14.082,-5,24,29
239,ULK,P005216,12.749,-6,25,31
239,ULK,P006961,22.317,-18,43,61
239,ULK,P007182,14.3,-5,29,34
239,ULK,P008104,13.55,-8,26,34
239,ULK,P008962,32.682,-10,65,75
239,ULK,P009783,25.366,-1,48,49
239,ULK,P009863,24.633,-9,51,60
239,ULK,P011205,25.382,-18,44,62
239,ULK,P013696,3.967,-1,10,11
240,BER,P006251,20.368,-20,31,51
240,BER,P006919,20.5,-24,33,57
240,BER,P007025,8.785,-5,20,25
240,BER,P008062,21.252,-11,40,51
240,BER,P008384,17.535,-11,30,41
240,BER,P008780,18.75,-14,33,47
240,BER,P008967,27.5,-18,45,63
240,BER,P011631,17.267,-6,35,41
240,BER,P011934,21.019,-6,44,50
240,BER,P012721,12.217,-5,24,29
240,BER,P013386,14.817,-5,30,35
240,IST,P004887,21.151,8,45,37
240,IST,P006372,2.533,4,6,2
240,IST,P006590,9.483,0,17,17
240,IST,P007109,24.866,10,62,52
240,IST,P007200,23.167,19,63,44
240,IST,P009664,17.199,28,49,21
240,IST,P009846,19.916,-1,37,38
240,IST,P011078,24.633,13,56,43
240,IST,P012710,10.299,-1,18,19
240,IST,P012742,16.299,12,42,30
240,IST,P012788,6.7,7,24,17
240,IST,P013363,23.749,26,71,45
241,OLY,P001255,19.1,20,51,31
241,OLY,P003469,26.335,18,66,48
241,OLY,P003941,19.984,14,56,42
241,OLY,P007853,16.267,0,26,26
241,OLY,P007947,19.417,2,44,42
241,OLY,P007982,14.334,11,30,19
241,OLY,P008811,20.017,8,36,28
241,OLY,P008829,22.433,13,52,39
241,OLY,P009849,10.783,2,24,22
241,OLY,P010392,13.767,13,35,22
241,OLY,P013380,17.568,9,40,31
241,VIR,P001844,24.782,-3,49,52
241,VIR,P004554,14.933,-22,14,36
241,VIR,P005738,6.816,-6,15,21
241,VIR,P006739,5.749,-2,10,12
241,VIR,P009549,26.499,-1,53,54
241,VIR,P011816,21.966,-8,39,47
241,VIR,P012585,21.932,-25,33,58
241,VIR,P012591,25.065,-12,46,58
241,VIR,P013374,25.065,0,56,56
241,VIR,P013695,17.05,-17,19,36
241,VIR,PBCN,10.133,-14,16,30
242,BAS,P004058,8.749,-2,15,17
242,BAS,P007230,16.998,-3,28,31
242,BAS,P007579,14.533,-14,25,39
242,BAS,P008072,13.05,1,22,21
242,BAS,P011085,31.165,-6,57,63
242,BAS,P011196,17.632,-8,32,40
242,BAS,P011948,7.632,4,19,15
242,BAS,P012080,33.716,-10,64,74
242,BAS,P012201,25.266,-16,45,61
242,BAS,P013367,31.249,-11,58,69
242,PAR,P004761,13.167,9,30,21
242,PAR,P007736,4.767,5,10,5
242,PAR,P007870,19.484,2,38,36
242,PAR,P008232,15.317,-3,28,31
242,PAR,P010781,31.434,4,64,60
242,PAR,P011836,24.684,16,58,42
242,PAR,P011981,20.517,11,48,37
242,PAR,P012720,33.834,16,74,58
242,PAR,P013369,29.834,14,69,55
242,PAR,P013370,6.967,-9,11,20
243,ASV,P002100,26.051,1,61,60
243,ASV,P007027,30.699,-3,76,79
243,ASV,P008991,15.017,3,34,31
243,ASV,P009818,6.684,-18,7,25
243,ASV,P010316,34.366,6,89,83
243,ASV,P010545,21.917,1,57,56
243,ASV,P011225,15.666,-4,34,38
243,ASV,P013371,15.134,-2,36,38
243,ASV,P013377,3.066,-7,2,9
243,ASV,P013405,28.866,16,69,53
243,ASV,PKIR,2.534,-8,0,8
243,PAN,P001926,20.85,-2,49,51
243,PAN,P004088,12.35,-4,26,30
243,PAN,P005161,16.284,6,42,36
243,PAN,P007866,13.0,2,33,31
243,PAN,P009622,22.9,1,54,53
243,PAN,P011204,18.983,-6,42,48
243,PAN,P012712,31.9,0,74,74
243,PAN,P012774,31.95,7,80,73
243,PAN,P013383,18.133,2,45,43
243,PAN,PLHK,13.65,9,35,26
