GAMECODE,CODETEAM,joueur_1,joueur_2,TIME,DELTA_SCORE,OFF,DEF
1,PMT,P002020,P002644,0 days 00:21:02,3,42,39
1,PMT,P011066,P012599,0 days 00:17:56,13,47,34
1,PMT,P011066,P011944,0 days 00:16:22,12,44,32
1,PMT,P002644,P011966,0 days 00:15:25,7,31,24
1,PMT,P001686,P012599,0 days 00:14:55,9,41,32
1,PMT,P011066,P011823,0 days 00:13:59,13,41,28
1,PMT,P011823,P012599,0 days 00:13:47,7,39,32
1,PMT,P002644,P011943,0 days 00:13:13,4,32,28
1,PMT,P002644,P011944,0 days 00:13:12,7,28,21
1,PMT,P002020,P011943,0 days 00:13:07,5,33,28
1,PMT,P002020,P011966,0 days 00:12:56,6,28,22
1,PMT,P001686,P011066,0 days 00:12:18,11,37,26
1,PMT,P001686,P011823,0 days 00:11:20,5,33,28
1,PMT,P002020,P011944,0 days 00:11:17,4,21,17
1,PMT,P011944,P012599,0 days 00:11:10,7,27,20
1,PMT,P002020,P011066,0 days 00:10:37,1,22,21
1,PMT,P002644,P012600,0 days 00:10:31,7,23,16
1,PMT,P002644,P011066,0 days 00:10:10,2,23,21
1,PMT,P002644,P012599,0 days 00:09:51,6,17,11
1,PMT,P012599,P012600,0 days 00:09:19,6,23,17
1,PMT,P011966,P012600,0 days 00:09:19,5,20,15
1,PMT,P011943,P011966,0 days 00:09:00,8,24,16
1,PMT,P002020,P012599,0 days 00:08:43,4,15,11
1,PMT,P001686,P011944,0 days 00:08:07,3,23,20
1,PMT,P011943,P011944,0 days 00:07:32,-1,15,16
1,PMT,P011823,P011944,0 days 00:07:26,3,21,18
1,PMT,P002020,P012600,0 days 00:07:22,5,17,12
1,PMT,P001686,P012600,0 days 00:06:58,7,19,12
1,PMT,P002020,P011947,0 days 00:06:37,-4,14,18
1,PMT,P011066,P012600,0 days 00:06:23,10,21,11
1,PMT,P011966,P012599,0 days 00:05:42,0,9,9
1,PMT,P011823,P012600,0 days 00:05:11,8,18,10
1,PMT,P002644,P011947,0 days 00:04:23,-6,8,14
1,PMT,P011066,P011943,0 days 00:04:17,-2,10,12
1,PMT,P011944,P011966,0 days 00:04:16,-2,5,7
1,PMT,P001686,P002644,0 days 00:03:45,5,9,4
1,PMT,P011947,P011966,0 days 00:03:25,-1,8,9
1,PMT,P011066,P011947,0 days 00:03:20,-3,6,9
1,PMT,P011943,P012600,0 days 00:03:18,8,11,3
1,PMT,P011947,P012599,0 days 00:03:09,0,6,6
1,PMT,P001686,P011966,0 days 00:02:47,-1,5,6
1,PMT,P002020,P011823,0 days 00:02:31,4,8,4
1,PMT,P011943,P011947,0 days 00:02:27,-1,8,9
1,PMT,P011823,P011947,0 days 00:02:22,2,6,4
1,PMT,P011944,P012600,0 days 00:01:56,4,7,3
1,PMT,P012600,P012601,0 days 00:01:22,3,5,2
1,PMT,P011066,P012601,0 days 00:01:14,3,5,2
1,PMT,P011944,P012601,0 days 00:01:14,3,5,2
1,PMT,P011947,P012600,0 days 00:01:09,-3,0,3
1,PMT,P002644,P012601,0 days 00:00:48,1,3,2
1,PMT,P011823,P012601,0 days 00:00:34,2,2,0
1,PMT,P011823,P011966,0 days 00:00:26,-2,2,4
1,PMT,P001686,P011943,0 days 00:00:10,1,1,0
1,PMT,P011947,P012601,0 days 00:00:08,0,0,0
1,PMT,P011966,P012601,0 days 00:00:08,0,0,0
1,PMT,P011823,P011943,0 days 00:00:04,2,2,0
1,HAM,P011168,P012582,0 days 00:20:30,-16,49,65
1,HAM,P011187,P012581,0 days 00:15:48,-7,32,39
1,HAM,P012580,P012581,0 days 00:15:30,-4,29,33
1,HAM,P011187,P012582,0 days 00:14:50,-12,32,44
1,HAM,P011187,P012580,0 days 00:14:00,-7,27,34
1,HAM,P011168,P012579,0 days 00:13:48,-10,22,32
1,HAM,P012578,P012580,0 days 00:13:32,-3,24,27
1,HAM,P011168,P012581,0 days 00:13:29,-19,21,40
1,HAM,P011168,P011187,0 days 00:13:14,-14,28,42
1,HAM,P001990,P012580,0 days 00:13:11,3,22,19
1,HAM,P009663,P011168,0 days 00:12:50,-10,24,34
1,HAM,P011168,P012580,0 days 00:12:49,-14,27,41
1,HAM,P009663,P012580,0 days 00:12:00,-4,22,26
1,HAM,P012581,P012582,0 days 00:11:31,-18,21,39
1,HAM,P009663,P012578,0 days 00:11:27,-5,22,27
1,HAM,P012580,P012582,0 days 00:10:49,-5,28,33
1,HAM,P011168,P012578,0 days 00:10:47,-4,22,26
1,HAM,P012579,P012582,0 days 00:10:38,-7,22,29
1,HAM,P001990,P012581,0 days 00:10:36,6,20,14
1,HAM,P011187,P012579,0 days 00:10:34,-8,20,28
1,HAM,P012579,P012581,0 days 00:09:53,-8,15,23
1,HAM,P001990,P011187,0 days 00:09:36,3,18,15
1,HAM,P012578,P012581,0 days 00:08:39,3,13,10
1,HAM,P001990,P012578,0 days 00:08:25,0,14,14
1,HAM,P009663,P012581,0 days 00:08:17,-6,9,15
1,HAM,P012578,P012579,0 days 00:07:53,-5,10,15
1,HAM,P012580,P012648,0 days 00:07:51,-5,13,18
1,HAM,P011187,P012578,0 days 00:07:45,1,14,13
1,HAM,P009663,P012582,0 days 00:07:16,-2,21,23
1,HAM,P009663,P012579,0 days 00:07:01,-4,9,13
1,HAM,P009663,P012648,0 days 00:05:29,-6,10,16
1,HAM,P012578,P012582,0 days 00:05:13,4,19,15
1,HAM,P011168,P012648,0 days 00:04:21,-10,8,18
1,HAM,P001990,P009663,0 days 00:04:20,1,7,6
1,HAM,P012579,P012580,0 days 00:04:18,-5,4,9
1,HAM,P001990,P012648,0 days 00:04:13,3,8,5
1,HAM,P001990,P012579,0 days 00:03:47,-2,7,9
1,HAM,P012582,P012648,0 days 00:03:33,-3,9,12
1,HAM,P012578,P012648,0 days 00:03:07,-7,6,13
1,HAM,P011187,P012648,0 days 00:03:05,-1,6,7
1,HAM,P012581,P012648,0 days 00:02:37,1,4,3
1,HAM,P012582,P012694,0 days 00:02:28,1,7,6
1,HAM,P011187,P012694,0 days 00:02:28,1,7,6
1,HAM,P011168,P012694,0 days 00:02:28,1,7,6
1,HAM,P012579,P012694,0 days 00:02:28,1,7,6
1,HAM,P001990,P012582,0 days 00:01:36,2,4,2
2,LLI,P009649,P012586,0 days 00:20:26,2,35,33
2,LLI,P006600,P012586,0 days 00:18:37,-4,31,35
2,LLI,P004479,P009649,0 days 00:16:37,0,29,29
2,LLI,P006600,P009649,0 days 00:16:36,-4,23,27
2,LLI,P005247,P012586,0 days 00:16:24,9,38,29
2,LLI,P004479,P012586,0 days 00:15:17,7,29,22
2,LLI,P005247,P012020,0 days 00:15:16,12,36,24
2,LLI,P009649,P012585,0 days 00:14:35,-1,27,28
2,LLI,P004773,P012586,0 days 00:14:30,-3,23,26
2,LLI,P005247,P009680,0 days 00:14:22,2,31,29
2,LLI,P004479,P006600,0 days 00:14:01,-6,19,25
2,LLI,P012585,P012586,0 days 00:13:21,-1,27,28
2,LLI,P006600,P012585,0 days 00:13:03,0,24,24
2,LLI,P009680,P012020,0 days 00:12:58,7,28,21
2,LLI,P004479,P005247,0 days 00:12:17,18,28,10
2,LLI,P004479,P012585,0 days 00:12:00,9,26,17
2,LLI,P012020,P012586,0 days 00:11:34,7,26,19
2,LLI,P009680,P012585,0 days 00:11:08,5,22,17
2,LLI,P004479,P012020,0 days 00:11:05,17,29,12
2,LLI,P009680,P012586,0 days 00:10:35,-5,19,24
2,LLI,P004773,P005247,0 days 00:10:29,-1,21,22
2,LLI,P004479,P009680,0 days 00:09:49,4,19,15
2,LLI,P004479,P004773,0 days 00:09:18,-5,13,18
2,LLI,P004773,P009680,0 days 00:09:16,-6,16,22
2,LLI,P004773,P012020,0 days 00:09:12,2,18,16
2,LLI,P005247,P012585,0 days 00:08:40,9,22,13
2,LLI,P004773,P006600,0 days 00:08:04,-9,9,18
2,LLI,P005247,P006600,0 days 00:07:41,3,16,13
2,LLI,P006600,P009680,0 days 00:07:26,-8,10,18
2,LLI,P012020,P012585,0 days 00:07:21,7,18,11
2,LLI,P009649,P012020,0 days 00:07:06,4,17,13
2,LLI,P004773,P009649,0 days 00:06:47,-6,6,12
2,LLI,P005247,P009649,0 days 00:06:39,8,16,8
2,LLI,P009649,P009680,0 days 00:06:02,-3,7,10
2,LLI,P004773,P012585,0 days 00:01:28,0,2,2
2,VNC,P011909,P011928,0 days 00:29:26,11,58,47
2,VNC,P004381,P011928,0 days 00:26:18,4,49,45
2,VNC,P004381,P011909,0 days 00:25:16,6,49,43
2,VNC,P011928,P012591,0 days 00:24:16,6,46,40
2,VNC,P004381,P012591,0 days 00:23:18,6,44,38
2,VNC,P011909,P012591,0 days 00:22:16,8,44,36
2,VNC,P003759,P011909,0 days 00:21:14,12,48,36
2,VNC,P003759,P011928,0 days 00:20:55,10,44,34
2,VNC,P003759,P004381,0 days 00:19:19,4,38,34
2,VNC,P003759,P012591,0 days 00:18:27,6,38,32
2,VNC,P004117,P011928,0 days 00:15:56,-13,21,34
2,VNC,P011928,P012590,0 days 00:13:36,-8,19,27
2,VNC,P004117,P012590,0 days 00:13:21,-14,17,31
2,VNC,P009400,P011928,0 days 00:11:52,-20,12,32
2,VNC,P004117,P009400,0 days 00:10:46,-18,12,30
2,VNC,P012587,P012590,0 days 00:10:10,-10,15,25
2,VNC,P004117,P011909,0 days 00:09:58,1,18,17
2,VNC,P009400,P012590,0 days 00:09:53,-15,10,25
2,VNC,P011928,P012587,0 days 00:08:49,-10,11,21
2,VNC,P004117,P004381,0 days 00:07:47,-2,11,13
2,VNC,P004117,P012587,0 days 00:07:42,-14,9,23
2,VNC,P011909,P012590,0 days 00:07:38,6,16,10
2,VNC,P009400,P012587,0 days 00:06:21,-14,5,19
2,VNC,P004117,P012591,0 days 00:04:53,2,8,6
2,VNC,P003759,P012590,0 days 00:04:41,2,10,8
2,VNC,P003759,P012587,0 days 00:03:49,4,10,6
2,VNC,P011909,P012587,0 days 00:03:49,4,10,6
2,VNC,P004381,P009400,0 days 00:03:43,-9,2,11
2,VNC,P009400,P011909,0 days 00:03:31,-4,5,9
2,VNC,P004381,P012590,0 days 00:02:59,-1,3,4
2,VNC,P009400,P012591,0 days 00:02:56,-4,2,6
2,VNC,P003759,P004117,0 days 00:02:13,-2,4,6
2,VNC,P003759,P009400,0 days 00:01:54,-4,0,4
2,VNC,P012590,P012591,0 days 00:00:58,0,2,2
3,PRS,P012608,P012610,0 days 00:18:39,24,53,29
3,PRS,P012609,P012640,0 days 00:17:38,11,49,38
3,PRS,P004512,P012608,0 days 00:16:59,20,49,29
3,PRS,P004512,P012610,0 days 00:16:59,20,49,29
3,PRS,P005793,P012608,0 days 00:16:33,7,42,35
3,PRS,P012609,P012611,0 days 00:16:30,8,42,34
3,PRS,P003481,P012611,0 days 00:16:22,7,41,34
3,PRS,P003481,P012609,0 days 00:16:22,7,41,34
3,PRS,P012611,P012640,0 days 00:14:19,13,39,26
3,PRS,P003481,P012640,0 days 00:14:11,12,38,26
3,PRS,P005793,P012611,0 days 00:12:55,5,34,29
3,PRS,P012613,P012640,0 days 00:12:53,8,32,24
3,PRS,P005793,P012610,0 days 00:12:28,12,34,22
3,PRS,P011887,P012610,0 days 00:12:14,12,33,21
3,PRS,P012609,P012613,0 days 00:12:07,8,32,24
3,PRS,P004512,P005793,0 days 00:10:48,8,30,22
3,PRS,P011887,P012608,0 days 00:10:42,15,33,18
3,PRS,P004512,P011887,0 days 00:10:30,15,33,18
3,PRS,P005793,P012609,0 days 00:10:18,-2,27,29
3,PRS,P012608,P012613,0 days 00:09:33,16,28,12
3,PRS,P005793,P012640,0 days 00:08:51,10,28,18
3,PRS,P012611,P012613,0 days 00:08:06,6,18,12
3,PRS,P003481,P012613,0 days 00:07:58,5,17,12
3,PRS,P003481,P005793,0 days 00:07:40,1,22,21
3,PRS,P012610,P012613,0 days 00:07:39,16,23,7
3,PRS,P012608,P012611,0 days 00:07:26,-1,15,16
3,PRS,P011887,P012613,0 days 00:06:54,6,20,14
3,PRS,P004512,P012613,0 days 00:06:11,12,19,7
3,PRS,P012610,P012611,0 days 00:05:59,5,14,9
3,PRS,P012608,P012609,0 days 00:05:31,-4,12,16
3,PRS,P004512,P012611,0 days 00:05:15,4,12,8
3,PRS,P005793,P011887,0 days 00:05:13,7,18,11
3,PRS,P012610,P012640,0 days 00:03:44,2,6,4
3,PRS,P005793,P012613,0 days 00:03:22,4,9,5
3,PRS,P012608,P012640,0 days 00:03:22,4,9,5
3,PRS,P010801,P012640,0 days 00:03:05,-4,6,10
3,PRS,P010801,P011887,0 days 00:02:57,-5,5,10
3,PRS,P011887,P012640,0 days 00:02:57,-5,5,10
3,PRS,P003481,P012608,0 days 00:02:11,-5,3,8
3,PRS,P012609,P012610,0 days 00:02:10,2,6,4
3,PRS,P011887,P012609,0 days 00:01:37,-2,5,7
3,PRS,P010801,P012613,0 days 00:01:33,-1,6,7
3,PRS,P010801,P012609,0 days 00:01:33,-1,6,7
3,PRS,P011551,P012640,0 days 00:01:32,-3,0,3
3,PRS,P011551,P012610,0 days 00:01:32,-3,0,3
3,PRS,P011551,P011887,0 days 00:01:32,-3,0,3
3,PRS,P010801,P012610,0 days 00:01:32,-3,0,3
3,PRS,P010801,P011551,0 days 00:01:32,-3,0,3
3,PRS,P004512,P012609,0 days 00:01:14,1,4,3
3,PRS,P003481,P012610,0 days 00:00:44,1,2,1
3,PRS,P010801,P012611,0 days 00:00:08,1,1,0
3,WOL,P002387,P011150,0 days 00:27:01,-24,51,75
3,WOL,P006154,P011150,0 days 00:17:32,-5,42,47
3,WOL,P002387,P008104,0 days 00:17:08,-25,30,55
3,WOL,P008104,P011150,0 days 00:16:39,-17,33,50
3,WOL,P011150,P012577,0 days 00:16:26,-17,21,38
3,WOL,P002387,P012577,0 days 00:16:16,-24,23,47
3,WOL,P005516,P011150,0 days 00:16:05,-9,28,37
3,WOL,P005516,P006154,0 days 00:15:36,6,35,29
3,WOL,P002387,P005516,0 days 00:15:29,-17,29,46
3,WOL,P011150,P012576,0 days 00:14:42,-15,28,43
3,WOL,P002387,P012576,0 days 00:14:25,-20,27,47
3,WOL,P005516,P012576,0 days 00:13:54,-9,27,36
3,WOL,P002387,P006154,0 days 00:13:51,-9,32,41
3,WOL,P005516,P012577,0 days 00:13:25,-10,20,30
3,WOL,P008104,P012577,0 days 00:13:15,-14,22,36
3,WOL,P006154,P008104,0 days 00:12:22,-6,30,36
3,WOL,P012576,P012577,0 days 00:12:21,-10,21,31
3,WOL,P008104,P012576,0 days 00:12:12,-14,25,39
3,WOL,P002333,P006154,0 days 00:11:28,4,29,25
3,WOL,P002333,P011150,0 days 00:11:00,-3,26,29
3,WOL,P006154,P012576,0 days 00:10:44,-3,26,29
3,WOL,P002333,P005516,0 days 00:09:27,-1,18,19
3,WOL,P002333,P002387,0 days 00:09:08,-7,21,28
3,WOL,P005516,P008104,0 days 00:07:34,-8,14,22
3,WOL,P002387,P004229,0 days 00:05:42,-4,7,11
3,WOL,P004229,P011150,0 days 00:05:42,-4,7,11
3,WOL,P004229,P008104,0 days 00:05:42,-4,7,11
3,WOL,P002333,P008104,0 days 00:05:39,-5,15,20
3,WOL,P004229,P012577,0 days 00:05:18,-4,7,11
3,WOL,P006154,P012577,0 days 00:05:00,8,10,2
3,WOL,P002333,P012577,0 days 00:04:05,-4,5,9
3,WOL,P002333,P006907,0 days 00:03:05,4,10,6
3,WOL,P006154,P006907,0 days 00:03:05,4,10,6
3,WOL,P004645,P006154,0 days 00:03:02,-3,6,9
3,WOL,P004645,P005516,0 days 00:03:02,-3,6,9
3,WOL,P004645,P012576,0 days 00:02:22,-1,6,7
3,WOL,P006907,P008104,0 days 00:02:15,1,7,6
3,WOL,P004645,P011150,0 days 00:01:36,-3,1,4
3,WOL,P006907,P011150,0 days 00:01:33,1,7,6
3,WOL,P005516,P006907,0 days 00:01:32,3,3,0
3,WOL,P004645,P008104,0 days 00:01:26,0,5,5
3,WOL,P006907,P012577,0 days 00:00:50,3,3,0
3,WOL,P002387,P004645,0 days 00:00:40,-2,0,2
3,WOL,P004229,P006154,0 days 00:00:24,0,0,0
4,HTA,P007759,P011991,0 days 00:25:34,20,66,46
4,HTA,P010550,P011991,0 days 00:25:28,13,64,51
4,HTA,P007759,P010550,0 days 00:22:30,13,59,46
4,HTA,P003533,P011991,0 days 00:20:39,21,53,32
4,HTA,P010465,P011991,0 days 00:18:26,14,47,33
4,HTA,P003533,P007759,0 days 00:18:23,18,48,30
4,HTA,P010465,P010550,0 days 00:18:01,12,45,33
4,HTA,P006835,P011991,0 days 00:16:07,14,43,29
4,HTA,P003533,P010465,0 days 00:16:06,14,40,26
4,HTA,P006835,P007759,0 days 00:15:25,15,41,26
4,HTA,P004846,P006835,0 days 00:15:06,9,43,34
4,HTA,P003533,P010550,0 days 00:15:00,10,37,27
4,HTA,P007759,P010465,0 days 00:12:54,10,33,23
4,HTA,P006835,P010550,0 days 00:12:38,5,34,29
4,HTA,P006835,P010465,0 days 00:12:31,7,30,23
4,HTA,P006835,P011990,0 days 00:12:21,12,32,20
4,HTA,P003533,P011990,0 days 00:12:17,13,30,17
4,HTA,P004846,P010550,0 days 00:11:30,3,30,27
4,HTA,P004846,P011991,0 days 00:10:40,5,27,22
4,HTA,P003533,P006835,0 days 00:10:23,15,26,11
4,HTA,P007759,P011990,0 days 00:10:07,12,28,16
4,HTA,P004846,P010465,0 days 00:10:02,6,26,20
4,HTA,P003533,P004846,0 days 00:08:43,9,18,9
4,HTA,P004846,P007759,0 days 00:07:43,4,21,17
4,HTA,P011990,P011991,0 days 00:07:33,9,20,11
4,HTA,P004846,P011990,0 days 00:07:05,5,20,15
4,HTA,P010465,P011990,0 days 00:06:18,0,12,12
4,HTA,P010550,P011990,0 days 00:05:24,4,15,11
4,HTA,P010465,P012592,0 days 00:01:59,-3,3,6
4,HTA,P011990,P012592,0 days 00:01:59,-3,3,6
4,HTA,P010465,P012706,0 days 00:01:48,-2,0,2
4,HTA,P011990,P012706,0 days 00:01:48,-2,0,2
4,HTA,P012592,P012706,0 days 00:01:48,-2,0,2
4,HTA,P006835,P012592,0 days 00:01:08,-1,3,4
4,HTA,P006835,P012706,0 days 00:00:57,0,0,0
4,HTA,P011990,P012028,0 days 00:00:52,-2,0,2
4,HTA,P010465,P012028,0 days 00:00:51,-2,0,2
4,HTA,P012028,P012592,0 days 00:00:51,-2,0,2
4,HTA,P012028,P012706,0 days 00:00:51,-2,0,2
4,HTA,P004846,P012592,0 days 00:00:11,-1,3,4
4,HTA,P003533,P012028,0 days 00:00:01,0,0,0
4,HTA,P010550,P012028,0 days 00:00:01,0,0,0
4,HTA,P011991,P012028,0 days 00:00:01,0,0,0
4,LJU,P005969,P009395,0 days 00:24:43,-11,49,60
4,LJU,P003452,P009395,0 days 00:22:48,-21,44,65
4,LJU,P003452,P005969,0 days 00:22:31,-14,46,60
4,LJU,P009395,P012700,0 days 00:21:31,-16,38,54
4,LJU,P009395,P012598,0 days 00:21:13,-17,40,57
4,LJU,P005969,P012598,0 days 00:21:12,-11,43,54
4,LJU,P003452,P012598,0 days 00:18:39,-17,34,51
4,LJU,P005969,P008883,0 days 00:17:49,-6,34,40
4,LJU,P012598,P012700,0 days 00:17:39,-16,34,50
4,LJU,P005969,P012700,0 days 00:17:00,-6,33,39
4,LJU,P003452,P012700,0 days 00:15:05,-16,28,44
4,LJU,P007066,P011261,0 days 00:11:54,-10,19,29
4,LJU,P008883,P009395,0 days 00:11:03,-5,20,25
4,LJU,P008883,P010594,0 days 00:10:53,-3,18,21
4,LJU,P005969,P007066,0 days 00:10:10,-4,21,25
4,LJU,P005969,P010594,0 days 00:09:58,0,22,22
4,LJU,P005969,P011261,0 days 00:09:54,-4,23,27
4,LJU,P003452,P008883,0 days 00:08:50,-3,18,21
4,LJU,P008883,P012598,0 days 00:08:48,-5,16,21
4,LJU,P007066,P008883,0 days 00:08:38,-3,14,17
4,LJU,P011261,P012598,0 days 00:07:54,-8,17,25
4,LJU,P008883,P011261,0 days 00:07:31,-5,12,17
4,LJU,P011261,P012700,0 days 00:06:38,-8,11,19
4,LJU,P009395,P011261,0 days 00:06:38,-8,11,19
4,LJU,P003452,P010594,0 days 00:06:13,-1,16,17
4,LJU,P007066,P010594,0 days 00:06:04,0,10,10
4,LJU,P009395,P010594,0 days 00:05:46,-2,12,14
4,LJU,P003452,P011261,0 days 00:05:40,-11,10,21
4,LJU,P010594,P011261,0 days 00:04:57,-2,8,10
4,LJU,P007066,P012598,0 days 00:03:31,-2,8,10
4,LJU,P008883,P012700,0 days 00:03:20,0,4,4
4,LJU,P003452,P007066,0 days 00:03:15,-1,7,8
4,LJU,P002561,P011261,0 days 00:02:51,-4,0,4
4,LJU,P002561,P007066,0 days 00:02:51,-4,0,4
4,LJU,P007066,P009395,0 days 00:02:15,-2,2,4
4,LJU,P007066,P012700,0 days 00:02:15,-2,2,4
4,LJU,P002561,P010594,0 days 00:01:52,-2,0,2
4,LJU,P002561,P008883,0 days 00:01:52,-2,0,2
4,LJU,P010594,P012700,0 days 00:01:37,2,2,0
4,LJU,P003452,P010771,0 days 00:01:11,-4,1,5
4,LJU,P005969,P010771,0 days 00:01:11,-4,1,5
4,LJU,P007066,P010771,0 days 00:01:11,-4,1,5
4,LJU,P010771,P011261,0 days 00:01:11,-4,1,5
4,LJU,P002561,P009395,0 days 00:00:59,-2,0,2
4,LJU,P002561,P012700,0 days 00:00:59,-2,0,2
5,JOV,P002361,P002507,0 days 00:20:13,0,29,29
5,JOV,P002361,P005094,0 days 00:15:41,4,26,22
5,JOV,P005094,P011248,0 days 00:14:50,10,28,18
5,JOV,P002507,P005094,0 days 00:13:43,4,20,16
5,JOV,P011247,P012076,0 days 00:12:59,0,20,20
5,JOV,P011247,PJUG,0 days 00:12:19,-7,19,26
5,JOV,P002361,P011248,0 days 00:10:52,3,22,19
5,JOV,P002507,P011248,0 days 00:10:50,3,18,15
5,JOV,P002507,P011247,0 days 00:10:45,0,16,16
5,JOV,P010458,PJUG,0 days 00:10:32,-10,17,27
5,JOV,P005094,P011247,0 days 00:10:23,-4,10,14
5,JOV,P010161,P011247,0 days 00:10:11,-4,19,23
5,JOV,P006771,P011248,0 days 00:09:42,-2,11,13
5,JOV,P010458,P011247,0 days 00:09:41,-8,15,23
5,JOV,P002507,P010166,0 days 00:09:26,10,20,10
5,JOV,P002507,P006771,0 days 00:09:14,-2,9,11
5,JOV,P005094,P006771,0 days 00:08:49,3,11,8
5,JOV,P012076,PJUG,0 days 00:08:46,-4,16,20
5,JOV,P002361,P006771,0 days 00:08:33,-5,10,15
5,JOV,P002361,P010166,0 days 00:08:32,8,18,10
5,JOV,P010166,P011247,0 days 00:08:30,5,14,9
5,JOV,P011247,P011248,0 days 00:08:26,2,10,8
5,JOV,P006771,P011247,0 days 00:08:16,3,10,7
5,JOV,P002361,PJUG,0 days 00:08:11,-4,8,12
5,JOV,P002361,P011247,0 days 00:08:06,-3,11,14
5,JOV,P002507,PJUG,0 days 00:07:53,-1,9,10
5,JOV,P006771,P012076,0 days 00:07:35,0,11,11
5,JOV,P010458,P012076,0 days 00:07:34,-7,12,19
5,JOV,P005094,PJUG,0 days 00:07:17,-6,4,10
5,JOV,P005094,P012076,0 days 00:07:14,4,12,8
5,JOV,P011248,P012076,0 days 00:07:12,4,12,8
5,JOV,P006771,PJUG,0 days 00:07:07,0,9,9
5,JOV,P010161,PJUG,0 days 00:07:03,-5,14,19
5,JOV,P010166,P011248,0 days 00:06:49,12,16,4
5,JOV,P010161,P010458,0 days 00:06:41,-7,12,19
5,JOV,P002361,P010161,0 days 00:06:30,1,12,11
5,JOV,P010161,P012076,0 days 00:05:53,-1,14,15
5,JOV,P005094,P010166,0 days 00:05:44,11,14,3
5,JOV,P002507,P010161,0 days 00:05:29,1,10,9
5,JOV,P006771,P010458,0 days 00:05:00,-5,5,10
5,JOV,P010161,P010166,0 days 00:04:09,1,7,6
5,JOV,P002507,P010458,0 days 00:03:55,-3,5,8
5,JOV,P010166,P012076,0 days 00:03:27,2,5,3
5,JOV,P006771,P010166,0 days 00:03:00,0,4,4
5,JOV,P002361,P012076,0 days 00:02:59,0,8,8
5,JOV,P002361,P010458,0 days 00:02:58,-6,2,8
5,JOV,P005094,P010161,0 days 00:02:39,-4,3,7
5,JOV,P005094,P010458,0 days 00:02:08,-6,0,6
5,JOV,P010458,P011248,0 days 00:02:07,-4,0,4
5,JOV,P010166,PJUG,0 days 00:01:55,-1,2,3
5,JOV,P010161,P011248,0 days 00:01:20,0,3,3
5,JOV,P002361,P010709,0 days 00:00:13,2,2,0
5,JOV,P010161,P010709,0 days 00:00:13,2,2,0
5,JOV,P010709,P012076,0 days 00:00:13,2,2,0
5,JOV,P010709,PJUG,0 days 00:00:13,2,2,0
5,BES,P003783,P007914,0 days 00:27:56,8,46,38
5,BES,P003783,P007917,0 days 00:23:52,5,38,33
5,BES,P003783,P011936,0 days 00:21:41,10,33,23
5,BES,P003783,P009582,0 days 00:21:02,7,38,31
5,BES,P009582,P011936,0 days 00:20:57,-3,31,34
5,BES,P007914,P007917,0 days 00:20:28,4,36,32
5,BES,P007917,P012647,0 days 00:19:30,-6,23,29
5,BES,P007917,P011936,0 days 00:18:25,-2,26,28
5,BES,P007914,P011936,0 days 00:18:17,9,31,22
5,BES,P003783,P012647,0 days 00:17:36,3,24,21
5,BES,P007917,P009582,0 days 00:16:51,-7,27,34
5,BES,P007914,P009582,0 days 00:16:43,4,32,28
5,BES,P009582,P012647,0 days 00:15:31,-6,21,27
5,BES,P011936,P012647,0 days 00:14:43,-6,17,23
5,BES,P007914,P012647,0 days 00:11:58,2,16,14
5,BES,P007914,P011357,0 days 00:10:59,-1,21,22
5,BES,P007914,P011379,0 days 00:10:23,4,17,13
5,BES,P007917,P011357,0 days 00:09:44,0,20,20
5,BES,P003783,P011379,0 days 00:09:28,2,13,11
5,BES,P003783,P011357,0 days 00:08:45,-1,15,16
5,BES,P007917,P008945,0 days 00:08:08,-6,12,18
5,BES,P011357,P011936,0 days 00:07:09,2,12,10
5,BES,P011379,P011936,0 days 00:07:04,6,15,9
5,BES,P008945,P012647,0 days 00:06:26,-5,7,12
5,BES,P009582,P011379,0 days 00:06:09,4,11,7
5,BES,P009582,P011357,0 days 00:04:47,-3,9,12
5,BES,P007917,P011379,0 days 00:04:14,0,6,6
5,BES,P008945,P011936,0 days 00:04:12,-8,3,11
5,BES,P008945,P009582,0 days 00:04:12,-8,3,11
5,BES,P003783,P008945,0 days 00:03:56,2,9,7
5,BES,P007914,P008945,0 days 00:03:56,2,9,7
5,BES,P011357,P011379,0 days 00:01:48,1,4,3
5,BES,P011379,P012647,0 days 00:01:28,-2,0,2
5,BES,P008945,P011379,0 days 00:00:58,1,2,1
5,BES,P008945,P011357,0 days 00:00:44,-2,3,5
6,BOU,P010431,P010449,0 days 00:18:41,8,48,40
6,BOU,P010449,P012628,0 days 00:17:41,5,41,36
6,BOU,P010449,P011837,0 days 00:17:39,4,42,38
6,BOU,P004525,P012619,0 days 00:17:23,12,37,25
6,BOU,P011836,P012628,0 days 00:17:16,-3,35,38
6,BOU,P010449,P011836,0 days 00:17:03,2,40,38
6,BOU,P010431,P012628,0 days 00:16:59,1,39,38
6,BOU,P010431,P011836,0 days 00:16:51,-5,38,43
6,BOU,P010450,P012619,0 days 00:16:30,5,33,28
6,BOU,P010431,P011837,0 days 00:15:57,3,39,36
6,BOU,P010718,P012619,0 days 00:15:56,8,31,23
6,BOU,P011837,P012628,0 days 00:15:49,5,37,32
6,BOU,P011836,P011837,0 days 00:15:46,1,37,36
6,BOU,P004525,P010718,0 days 00:15:33,11,32,21
6,BOU,P004525,P010450,0 days 00:14:23,10,29,19
6,BOU,P010718,P011161,0 days 00:12:34,8,23,15
6,BOU,P004525,P011161,0 days 00:12:34,8,23,15
6,BOU,P010450,P010718,0 days 00:12:28,8,25,17
6,BOU,P011161,P012619,0 days 00:12:10,1,19,18
6,BOU,P010450,P011161,0 days 00:09:59,2,16,14
6,BOU,P010449,P010718,0 days 00:08:02,8,24,16
6,BOU,P004525,P010449,0 days 00:07:36,11,23,12
6,BOU,P012619,P012628,0 days 00:07:14,1,15,14
6,BOU,P010449,P012619,0 days 00:07:00,9,21,12
6,BOU,P010718,P012628,0 days 00:06:04,5,13,8
6,BOU,P004525,P012628,0 days 00:05:47,9,17,8
6,BOU,P010431,P012619,0 days 00:05:31,0,13,13
6,BOU,P010718,P011836,0 days 00:05:03,5,15,10
6,BOU,P010449,P010450,0 days 00:04:54,5,13,8
6,BOU,P010431,P010450,0 days 00:04:42,-3,8,11
6,BOU,P010718,P011837,0 days 00:04:40,8,16,8
6,BOU,P004525,P010431,0 days 00:04:37,8,14,6
6,BOU,P011836,P012619,0 days 00:04:04,-4,7,11
6,BOU,P011161,P012628,0 days 00:03:05,3,7,4
6,BOU,P010450,P011836,0 days 00:02:47,-5,4,9
6,BOU,P004525,P011837,0 days 00:02:47,7,9,2
6,BOU,P010450,P012628,0 days 00:02:17,-2,4,6
6,BOU,P010431,P010718,0 days 00:02:04,3,9,6
6,BOU,P011161,P011837,0 days 00:00:54,4,4,0
6,BOU,P010450,P011837,0 days 00:00:40,0,0,0
6,BOU,P010431,P011161,0 days 00:00:30,-3,0,3
6,BOU,P011161,P011836,0 days 00:00:30,-3,0,3
6,WRO,P005531,P009896,0 days 00:25:07,-7,51,58
6,WRO,P001694,P009896,0 days 00:23:52,4,50,46
6,WRO,P009896,P012735,0 days 00:23:51,-9,43,52
6,WRO,P001694,P005531,0 days 00:20:34,5,46,41
6,WRO,P005531,P012699,0 days 00:20:09,-4,41,45
6,WRO,P001694,P012699,0 days 00:18:40,2,39,37
6,WRO,P009896,P012699,0 days 00:18:40,-3,37,40
6,WRO,P001694,P012735,0 days 00:18:13,1,34,33
6,WRO,P005531,P012735,0 days 00:17:15,-3,36,39
6,WRO,P011900,P012735,0 days 00:16:55,-13,28,41
6,WRO,P001694,P012736,0 days 00:16:49,-5,30,35
6,WRO,P009896,P011900,0 days 00:15:41,-9,30,39
6,WRO,P009896,P012736,0 days 00:15:03,-3,29,32
6,WRO,P001694,P011900,0 days 00:13:14,-5,23,28
6,WRO,P012735,P012736,0 days 00:13:14,-10,23,33
6,WRO,P003034,P012735,0 days 00:12:50,-17,17,34
6,WRO,P011900,P012736,0 days 00:12:00,-11,18,29
6,WRO,P003034,P011900,0 days 00:11:21,-11,15,26
6,WRO,P005531,P012736,0 days 00:10:58,-1,26,27
6,WRO,P012699,P012735,0 days 00:09:56,-4,17,21
6,WRO,P005531,P011900,0 days 00:09:05,-3,23,26
6,WRO,P003034,P012736,0 days 00:08:46,-11,11,22
6,WRO,P012699,P012736,0 days 00:08:34,-3,15,18
6,WRO,P003034,P005531,0 days 00:08:32,-7,17,24
6,WRO,P003034,P009896,0 days 00:08:12,-12,10,22
6,WRO,P001694,P003034,0 days 00:05:52,-5,8,13
6,WRO,P003034,P012699,0 days 00:05:07,-9,6,15
6,WRO,P011900,P012699,0 days 00:04:42,-3,9,12
6,WRO,P001694,P012308,0 days 00:01:42,-1,2,3
6,WRO,P009896,P012308,0 days 00:01:42,-1,2,3
6,WRO,P011900,P012308,0 days 00:01:42,-1,2,3
6,WRO,P012308,P012735,0 days 00:01:42,-1,2,3
7,CLU,P010569,P012621,0 days 00:26:23,9,56,47
7,CLU,P004862,P010569,0 days 00:24:06,6,48,42
7,CLU,P004862,P012621,0 days 00:22:20,12,50,38
7,CLU,P005714,P011801,0 days 00:19:00,11,39,28
7,CLU,P010569,P011797,0 days 00:18:27,-3,32,35
7,CLU,P011797,P012621,0 days 00:17:53,7,36,29
7,CLU,P005113,P012621,0 days 00:16:30,10,40,30
7,CLU,P004862,P011797,0 days 00:14:59,-6,23,29
7,CLU,P004862,P005113,0 days 00:14:52,5,35,30
7,CLU,P005113,P010569,0 days 00:14:26,4,32,28
7,CLU,P005373,P011801,0 days 00:13:50,-3,24,27
7,CLU,P004862,P011801,0 days 00:12:38,2,27,25
7,CLU,P004862,P005714,0 days 00:12:38,2,27,25
7,CLU,P005113,P011797,0 days 00:12:20,8,27,19
7,CLU,P010569,P011801,0 days 00:12:04,4,25,21
7,CLU,P011801,P012621,0 days 00:11:56,15,32,17
7,CLU,P011797,P011801,0 days 00:10:31,10,22,12
7,CLU,P011801,P012698,0 days 00:10:22,-6,15,21
7,CLU,P005373,P012698,0 days 00:10:22,-6,15,21
7,CLU,P005714,P012698,0 days 00:09:21,-1,15,16
7,CLU,P005373,P005714,0 days 00:09:21,-1,15,16
7,CLU,P005373,P011797,0 days 00:08:46,6,16,10
7,CLU,P004862,P012698,0 days 00:08:21,-4,18,22
7,CLU,P005714,P010569,0 days 00:07:35,6,16,10
7,CLU,P005714,P012621,0 days 00:07:27,17,23,6
7,CLU,P005714,P011797,0 days 00:07:03,7,13,6
7,CLU,P004862,P005373,0 days 00:06:42,-9,8,17
7,CLU,P005373,P010569,0 days 00:06:34,-6,9,15
7,CLU,P005373,P012621,0 days 00:06:34,-6,9,15
7,CLU,P010569,P012698,0 days 00:04:45,-4,10,14
7,CLU,P012621,P012698,0 days 00:04:45,-4,10,14
7,CLU,P005113,P012698,0 days 00:03:44,1,10,9
7,CLU,P011797,P012698,0 days 00:03:13,7,7,0
7,CLU,P005113,P005714,0 days 00:02:04,6,8,2
7,CLU,P005113,P011801,0 days 00:02:04,6,8,2
7,CLU,P005373,P012620,0 days 00:01:31,-3,0,3
7,CLU,P005714,P012620,0 days 00:01:31,-3,0,3
7,CLU,P011801,P012620,0 days 00:01:31,-3,0,3
7,CLU,P012620,P012698,0 days 00:01:31,-3,0,3
7,TTK,P005000,P011925,0 days 00:22:42,-7,38,45
7,TTK,P005000,P011834,0 days 00:21:14,-3,38,41
7,TTK,P011834,P011925,0 days 00:18:22,9,33,24
7,TTK,P005000,P012697,0 days 00:17:41,-6,36,42
7,TTK,P011925,P012056,0 days 00:17:19,-2,34,36
7,TTK,P011925,P012697,0 days 00:15:41,7,36,29
7,TTK,P011834,P012697,0 days 00:15:24,13,40,27
7,TTK,P005000,P012056,0 days 00:14:31,-12,24,36
7,TTK,P011239,P011834,0 days 00:12:52,-6,16,22
7,TTK,P011834,P012056,0 days 00:12:37,9,27,18
7,TTK,P004801,P011834,0 days 00:12:19,-7,23,30
7,TTK,P005685,P011834,0 days 00:12:09,9,26,17
7,TTK,P006693,P011834,0 days 00:11:42,-7,15,22
7,TTK,P009845,P012056,0 days 00:10:42,-4,18,22
7,TTK,P009845,P011925,0 days 00:10:16,-4,18,22
7,TTK,P005000,P009845,0 days 00:10:16,-4,18,22
7,TTK,P006693,P012056,0 days 00:09:53,0,19,19
7,TTK,P005000,P011239,0 days 00:09:50,-12,13,25
7,TTK,P005000,P006693,0 days 00:09:11,-4,16,20
7,TTK,P005685,P011925,0 days 00:09:10,14,20,6
7,TTK,P006693,P011239,0 days 00:09:04,-7,9,16
7,TTK,P005685,P012697,0 days 00:08:55,10,22,12
7,TTK,P005000,P005685,0 days 00:08:47,-1,14,15
7,TTK,P012056,P012697,0 days 00:08:22,2,22,20
7,TTK,P006693,P011925,0 days 00:08:19,-5,11,16
7,TTK,P004801,P006693,0 days 00:08:05,-3,14,17
7,TTK,P004801,P011239,0 days 00:07:50,-1,14,15
7,TTK,P004801,P005000,0 days 00:07:48,-7,15,22
7,TTK,P011239,P011925,0 days 00:06:35,-15,2,17
7,TTK,P006693,P009845,0 days 00:06:15,-2,13,15
7,TTK,P005685,P012056,0 days 00:05:28,8,13,5
7,TTK,P011239,P012697,0 days 00:05:24,-9,7,16
7,TTK,P004801,P012056,0 days 00:04:34,0,8,8
7,TTK,P004801,P012697,0 days 00:04:14,-4,9,13
7,TTK,P011239,P012056,0 days 00:04:06,-9,3,12
7,TTK,P009845,P011834,0 days 00:04:06,-4,6,10
7,TTK,P009845,P012697,0 days 00:03:59,-1,8,9
7,TTK,P004801,P005685,0 days 00:02:59,-5,6,11
7,TTK,P000497,P011925,0 days 00:02:11,-5,0,5
7,TTK,P000497,P011834,0 days 00:02:11,-5,0,5
7,TTK,P000497,P011239,0 days 00:02:11,-5,0,5
7,TTK,P000497,P006693,0 days 00:02:11,-5,0,5
7,TTK,P004801,P009845,0 days 00:01:30,-1,3,4
7,TTK,P005685,P006693,0 days 00:01:08,1,3,2
7,TTK,P004801,P011925,-1 days +23:59:57,0,0,0
8,BUD,P002740,P012606,0 days 00:20:28,6,40,34
8,BUD,P002740,P010248,0 days 00:18:07,4,32,28
8,BUD,P004945,P011935,0 days 00:17:35,7,32,25
8,BUD,P011935,P012606,0 days 00:17:29,1,31,30
8,BUD,P010248,P012606,0 days 00:17:15,5,32,27
8,BUD,P007398,P010432,0 days 00:16:51,2,32,30
8,BUD,P004945,P012606,0 days 00:15:10,4,29,25
8,BUD,P010432,P012605,0 days 00:14:34,2,28,26
8,BUD,P004945,P010432,0 days 00:14:23,15,34,19
8,BUD,P002740,P004945,0 days 00:13:48,7,28,21
8,BUD,P002740,P011935,0 days 00:13:23,-3,23,26
8,BUD,P007398,P012605,0 days 00:13:06,-2,24,26
8,BUD,P010432,P011935,0 days 00:11:56,3,24,21
8,BUD,P004945,P007398,0 days 00:10:43,7,22,15
8,BUD,P010248,P011935,0 days 00:10:10,-4,15,19
8,BUD,P007398,P011935,0 days 00:09:44,-1,16,17
8,BUD,P012606,P012630,0 days 00:09:24,6,19,13
8,BUD,P004945,P012605,0 days 00:09:21,10,21,11
8,BUD,P004945,P010248,0 days 00:09:07,2,16,14
8,BUD,P010248,P012630,0 days 00:09:00,2,16,14
8,BUD,P002740,P012630,0 days 00:09:00,2,16,14
8,BUD,P007398,P012630,0 days 00:06:29,-5,10,15
8,BUD,P010432,P012630,0 days 00:06:29,-5,10,15
8,BUD,P010432,P012606,0 days 00:06:18,8,16,8
8,BUD,P002740,P006566,0 days 00:06:10,13,16,3
8,BUD,P012605,P012630,0 days 00:06:05,-9,7,16
8,BUD,P011935,P012605,0 days 00:05:38,-5,8,13
8,BUD,P011935,P012630,0 days 00:05:32,-11,7,18
8,BUD,P006566,P012605,0 days 00:05:15,7,13,6
8,BUD,P004945,P006566,0 days 00:04:48,8,13,5
8,BUD,P006566,P010248,0 days 00:04:42,9,12,3
8,BUD,P004397,P012630,0 days 00:04:33,-1,7,8
8,BUD,P004397,P012605,0 days 00:04:33,-1,7,8
8,BUD,P004397,P010432,0 days 00:04:33,-1,7,8
8,BUD,P004397,P007398,0 days 00:04:33,-1,7,8
8,BUD,P006566,P010432,0 days 00:04:23,8,13,5
8,BUD,P006566,P012630,0 days 00:04:17,9,12,3
8,BUD,P006561,P012606,0 days 00:04:16,-4,5,9
8,BUD,P007398,P012606,0 days 00:04:06,4,8,4
8,BUD,P002740,P010432,0 days 00:04:01,8,12,4
8,BUD,P002740,P006561,0 days 00:03:55,-4,5,9
8,BUD,P006566,P012606,0 days 00:03:50,10,12,2
8,BUD,P006561,P010248,0 days 00:03:15,-1,5,6
8,BUD,P004945,P006561,0 days 00:03:09,-4,5,9
8,BUD,P006566,P007398,0 days 00:02:55,4,9,5
8,BUD,P002740,P012605,0 days 00:02:20,3,4,1
8,BUD,P006561,P012630,0 days 00:01:07,0,0,0
8,BUD,P006561,P011935,0 days 00:01:01,-3,0,3
8,BUD,P010248,P012605,0 days 00:00:52,-1,0,1
8,BUD,P006561,P007398,0 days 00:00:21,0,0,0
8,LKB,P002012,P007029,0 days 00:26:18,-10,43,53
8,LKB,P002012,P004664,0 days 00:25:29,-7,41,48
8,LKB,P004664,P007029,0 days 00:25:04,-13,34,47
8,LKB,P002012,PLXI,0 days 00:18:57,7,39,32
8,LKB,P002012,P005521,0 days 00:17:25,-24,21,45
8,LKB,P007029,P010461,0 days 00:17:02,-10,22,32
8,LKB,P002012,P006230,0 days 00:16:51,-6,31,37
8,LKB,P004664,P006230,0 days 00:16:25,-4,29,33
8,LKB,P005521,P007029,0 days 00:16:00,-21,17,38
8,LKB,P004664,P005521,0 days 00:15:23,-12,23,35
8,LKB,P006230,P007029,0 days 00:15:04,-5,25,30
8,LKB,P002012,P010461,0 days 00:14:39,-7,21,28
8,LKB,P007029,PLXI,0 days 00:14:02,10,30,20
8,LKB,P004664,PLXI,0 days 00:13:47,6,28,22
8,LKB,P008856,P010461,0 days 00:12:57,-3,17,20
8,LKB,P005521,P010461,0 days 00:12:47,-11,15,26
8,LKB,P004664,P010461,0 days 00:12:02,-7,14,21
8,LKB,P006230,PLXI,0 days 00:11:07,4,26,22
8,LKB,P010461,PLXI,0 days 00:10:33,10,22,12
8,LKB,P007029,P008856,0 days 00:09:54,-6,13,19
8,LKB,P005521,P006230,0 days 00:09:43,-7,19,26
8,LKB,P008856,PLXI,0 days 00:08:45,9,21,12
8,LKB,P005521,P008856,0 days 00:07:39,-6,11,17
8,LKB,P002012,P008856,0 days 00:07:25,-5,12,17
8,LKB,P008856,P012583,0 days 00:07:20,2,11,9
8,LKB,P010461,P012583,0 days 00:07:08,0,9,9
8,LKB,P005521,PLXI,0 days 00:06:46,3,17,14
8,LKB,P007029,P012583,0 days 00:06:04,-5,4,9
8,LKB,P005521,P012583,0 days 00:05:21,6,13,7
8,LKB,P004664,P008856,0 days 00:03:28,-3,1,4
8,LKB,P004664,P012583,0 days 00:03:14,-4,2,6
8,LKB,P012583,PLXI,0 days 00:02:43,7,9,2
8,LKB,P006230,P008856,0 days 00:01:32,0,6,6
8,LKB,P006230,P012583,0 days 00:01:06,2,4,2
9,ARI,P003240,P012708,0 days 00:23:57,-8,36,44
9,ARI,P003240,P012615,0 days 00:21:21,-5,33,38
9,ARI,P012615,P012708,0 days 00:20:13,-3,35,38
9,ARI,P004292,P012708,0 days 00:16:15,7,34,27
9,ARI,P012708,P012716,0 days 00:16:03,-4,27,31
9,ARI,P004292,P012615,0 days 00:15:41,-7,24,31
9,ARI,P004292,P012722,0 days 00:15:39,-5,28,33
9,ARI,P003240,P004292,0 days 00:15:11,-5,23,28
9,ARI,P004292,P012716,0 days 00:13:54,-2,28,30
9,ARI,P003240,P012716,0 days 00:13:42,-12,19,31
9,ARI,P012708,P012722,0 days 00:13:05,-1,24,25
9,ARI,P003240,P012702,0 days 00:13:04,-8,23,31
9,ARI,P012702,P012708,0 days 00:12:57,-8,17,25
9,ARI,P012615,P012722,0 days 00:11:44,-7,17,24
9,ARI,P002867,P012716,0 days 00:11:37,-10,19,29
9,ARI,P012702,P012716,0 days 00:11:27,-11,15,26
9,ARI,P003240,P012722,0 days 00:10:48,-6,13,19
9,ARI,P002867,P012708,0 days 00:09:23,-5,14,19
9,ARI,P012615,P012716,0 days 00:09:15,-7,12,19
9,ARI,P012702,P012707,0 days 00:09:09,1,19,18
9,ARI,P012716,P012717,0 days 00:08:56,-5,14,19
9,ARI,P012716,P012722,0 days 00:08:38,-6,15,21
9,ARI,P003240,P012707,0 days 00:08:36,-3,18,21
9,ARI,P012615,P012707,0 days 00:08:23,-5,15,20
9,ARI,P012702,P012717,0 days 00:08:00,-2,12,14
9,ARI,P012707,P012708,0 days 00:07:08,1,16,15
9,ARI,P012615,P012702,0 days 00:07:07,-2,12,14
9,ARI,P002867,P012702,0 days 00:06:08,-12,5,17
9,ARI,P002867,P012722,0 days 00:06:06,-1,11,12
9,ARI,P002867,P004292,0 days 00:05:49,3,17,14
9,ARI,P012707,P012716,0 days 00:05:34,-1,13,14
9,ARI,P012708,P012717,0 days 00:04:59,-3,5,8
9,ARI,P002867,P012717,0 days 00:04:54,-8,4,12
9,ARI,P002867,P003240,0 days 00:04:44,-10,3,13
9,ARI,P003240,P012717,0 days 00:03:13,1,8,7
9,ARI,P012707,P012717,0 days 00:02:50,1,7,6
9,ARI,P004292,P012717,0 days 00:02:32,-3,2,5
9,ARI,P004292,P012702,0 days 00:02:26,-4,3,7
9,ARI,P012717,P012722,0 days 00:01:30,-3,2,5
9,ARI,P004292,P012707,0 days 00:01:25,0,5,5
9,ARI,P012707,P012722,0 days 00:01:14,-3,2,5
9,ARI,P012616,P012702,0 days 00:01:06,2,2,0
9,ARI,P012616,P012707,0 days 00:01:06,2,2,0
9,ARI,P012616,P012716,0 days 00:01:06,2,2,0
9,ARI,P012616,P012717,0 days 00:01:06,2,2,0
9,ARI,P002867,P012615,0 days 00:00:48,0,0,0
9,ARI,P002867,P012707,0 days 00:00:11,3,3,0
9,CAN,P003425,P010385,0 days 00:18:50,24,40,16
9,CAN,P003637,P010452,0 days 00:16:01,18,40,22
9,CAN,P003637,P005005,0 days 00:15:54,18,42,24
9,CAN,P005005,P010452,0 days 00:15:06,23,41,18
9,CAN,P010385,P010452,0 days 00:14:33,13,29,16
9,CAN,P003425,P010452,0 days 00:14:14,21,35,14
9,CAN,P003425,P006588,0 days 00:12:13,13,31,18
9,CAN,P006588,P008121,0 days 00:12:09,2,22,20
9,CAN,P003637,P010385,0 days 00:11:49,13,27,14
9,CAN,P003425,P007560,0 days 00:11:47,12,26,14
9,CAN,P003425,P008121,0 days 00:11:38,5,22,17
9,CAN,P003425,P005005,0 days 00:10:44,21,30,9
9,CAN,P003425,P003637,0 days 00:10:40,20,29,9
9,CAN,P005005,P010385,0 days 00:10:01,15,24,9
9,CAN,P006588,P007560,0 days 00:10:00,12,23,11
9,CAN,P006588,P007644,0 days 00:09:51,-6,17,23
9,CAN,P008121,P010385,0 days 00:09:39,3,15,12
9,CAN,P007560,P010385,0 days 00:09:38,10,19,9
9,CAN,P004160,P006588,0 days 00:09:04,0,17,17
9,CAN,P001607,P007644,0 days 00:09:00,-8,12,20
9,CAN,P001607,P005005,0 days 00:08:51,-7,18,25
9,CAN,P001607,P003637,0 days 00:08:37,-7,18,25
9,CAN,P005005,P007644,0 days 00:08:07,-2,18,20
9,CAN,P007560,P008121,0 days 00:07:58,7,12,5
9,CAN,P003425,P004160,0 days 00:07:45,2,17,15
9,CAN,P006588,P010385,0 days 00:07:43,8,17,9
9,CAN,P003637,P007644,0 days 00:07:28,0,20,20
9,CAN,P003425,P007644,0 days 00:07:17,2,18,16
9,CAN,P007644,P008121,0 days 00:06:51,-5,9,14
9,CAN,P001607,P006588,0 days 00:06:48,-10,9,19
9,CAN,P001607,P010452,0 days 00:05:49,-2,11,13
9,CAN,P004160,P008121,0 days 00:05:45,-4,10,14
9,CAN,P004160,P007644,0 days 00:05:39,-1,10,11
9,CAN,P007644,P010452,0 days 00:05:20,2,13,11
9,CAN,P001607,P008121,0 days 00:04:52,-7,2,9
9,CAN,P007560,P010452,0 days 00:04:38,1,9,8
9,CAN,P007560,P007644,0 days 00:04:29,-4,3,7
9,CAN,P008121,P010452,0 days 00:04:21,-4,2,6
9,CAN,P001607,P007560,0 days 00:03:47,-5,2,7
9,CAN,P005005,P007560,0 days 00:03:41,-4,6,10
9,CAN,P005005,P006588,0 days 00:03:33,-3,11,14
9,CAN,P001607,P010385,0 days 00:03:26,-3,6,9
9,CAN,P004160,P010385,0 days 00:03:25,1,7,6
9,CAN,P004160,P007560,0 days 00:03:19,4,7,3
9,CAN,P003637,P006588,0 days 00:03:16,-5,7,12
9,CAN,P003637,P008121,0 days 00:02:47,-5,2,7
9,CAN,P001607,P010484,0 days 00:02:23,-5,2,7
9,CAN,P005005,P010484,0 days 00:02:23,-5,2,7
9,CAN,P007560,P010484,0 days 00:02:23,-5,2,7
9,CAN,P001607,P004160,0 days 00:01:19,-2,0,2
9,CAN,P006588,P010484,0 days 00:01:17,-3,2,5
9,CAN,P007644,P010484,0 days 00:01:06,-2,0,2
9,CAN,P003637,P007560,0 days 00:00:36,0,3,3
9,CAN,P006588,P010452,0 days 00:00:10,4,4,0
10,ULM,P005422,P012603,0 days 00:21:26,9,44,35
10,ULM,P010582,P012604,0 days 00:21:25,8,40,32
10,ULM,P010106,P012603,0 days 00:21:09,-3,38,41
10,ULM,P005422,P010106,0 days 00:19:26,-2,32,34
10,ULM,P010582,P012603,0 days 00:19:18,1,35,34
10,ULM,P012603,P012604,0 days 00:18:56,10,35,25
10,ULM,P010106,P012604,0 days 00:17:44,1,30,29
10,ULM,P005422,P012604,0 days 00:17:03,1,28,27
10,ULM,P010106,P010582,0 days 00:16:31,-2,30,32
10,ULM,P012629,P012703,0 days 00:15:45,14,37,23
10,ULM,P005422,P010582,0 days 00:13:51,1,24,23
10,ULM,P011457,P012629,0 days 00:12:59,1,25,24
10,ULM,P012604,P012629,0 days 00:12:59,-1,24,25
10,ULM,P010582,P012703,0 days 00:12:27,7,26,19
10,ULM,P011457,P012703,0 days 00:11:51,5,25,20
10,ULM,P010582,P012629,0 days 00:11:46,5,24,19
10,ULM,P012603,P012629,0 days 00:10:31,12,26,14
10,ULM,P010582,P011457,0 days 00:09:40,4,21,17
10,ULM,P011391,P012629,0 days 00:09:06,10,23,13
10,ULM,P011391,P012703,0 days 00:08:56,12,24,12
10,ULM,P005422,P012629,0 days 00:08:54,0,19,19
10,ULM,P012604,P012703,0 days 00:08:39,5,18,13
10,ULM,P011457,P012604,0 days 00:07:27,-4,13,17
10,ULM,P012603,P012703,0 days 00:07:09,16,21,5
10,ULM,P010106,P012629,0 days 00:06:20,-5,10,15
10,ULM,P011391,P012603,0 days 00:05:45,8,16,8
10,ULM,P011391,P011457,0 days 00:05:40,5,12,7
10,ULM,P005422,P011391,0 days 00:04:58,1,12,11
10,ULM,P005422,P012703,0 days 00:04:02,4,12,8
10,ULM,P010726,P012603,0 days 00:03:56,0,9,9
10,ULM,P010582,P011391,0 days 00:03:56,2,8,6
10,ULM,P007952,P010106,0 days 00:03:37,-5,8,13
10,ULM,P007952,P010582,0 days 00:03:37,-5,8,13
10,ULM,P007952,P012603,0 days 00:03:37,-5,8,13
10,ULM,P010582,P010726,0 days 00:03:21,-1,8,9
10,ULM,P010106,P010726,0 days 00:02:33,-5,4,9
10,ULM,P007952,P010726,0 days 00:02:10,-5,4,9
10,ULM,P005422,P011457,0 days 00:02:02,-7,0,7
10,ULM,P010726,P012703,0 days 00:01:31,5,5,0
10,ULM,P005422,P007952,0 days 00:01:27,0,4,4
10,ULM,P011457,P012603,0 days 00:01:25,4,4,0
10,ULM,P010726,P012604,0 days 00:01:19,4,4,0
10,ULM,P010106,P011457,0 days 00:01:16,-4,0,4
10,ULM,P010106,P011391,0 days 00:01:04,-3,0,3
10,ULM,P005422,P010726,0 days 00:00:43,1,1,0
10,ULM,P010726,P011391,0 days 00:00:35,1,1,0
10,ULM,P010726,P011457,0 days 00:00:08,0,0,0
10,TRN,P005059,P005738,0 days 00:25:17,-3,47,50
10,TRN,P005059,P009903,0 days 00:21:00,2,41,39
10,TRN,P005059,P012597,0 days 00:20:41,-6,36,42
10,TRN,P005738,P009903,0 days 00:20:26,-4,38,42
10,TRN,P005738,P012597,0 days 00:18:53,-9,30,39
10,TRN,P005059,P012595,0 days 00:18:06,6,40,34
10,TRN,P009903,P012597,0 days 00:16:30,-12,26,38
10,TRN,P009903,P012593,0 days 00:15:12,-2,24,26
10,TRN,P005738,P012595,0 days 00:14:58,3,34,31
10,TRN,P005738,P012593,0 days 00:14:13,-2,22,24
10,TRN,P005059,P012593,0 days 00:13:00,2,22,20
10,TRN,P009903,P012595,0 days 00:12:52,8,30,22
10,TRN,P006382,P012596,0 days 00:12:32,-12,20,32
10,TRN,P012595,P012596,0 days 00:11:34,-6,19,25
10,TRN,P001479,P012594,0 days 00:10:29,-2,17,19
10,TRN,P012593,P012597,0 days 00:10:17,-9,13,22
10,TRN,P001479,P012596,0 days 00:10:12,-5,18,23
10,TRN,P005059,P012596,0 days 00:09:31,-4,15,19
10,TRN,P001479,P012595,0 days 00:09:20,-1,15,16
10,TRN,P012595,P012597,0 days 00:08:51,1,20,19
10,TRN,P001479,P006382,0 days 00:08:51,-6,15,21
10,TRN,P006382,P012595,0 days 00:08:38,-9,15,24
10,TRN,P012594,P012595,0 days 00:07:58,-1,12,13
10,TRN,P012596,P012597,0 days 00:07:20,2,15,13
10,TRN,P006382,P012594,0 days 00:07:20,-5,12,17
10,TRN,P012594,P012596,0 days 00:07:19,-4,12,16
10,TRN,P005059,P006382,0 days 00:07:10,-8,11,19
10,TRN,P005738,P012596,0 days 00:06:04,-3,9,12
10,TRN,P012593,P012595,0 days 00:05:27,7,11,4
10,TRN,P001479,P005059,0 days 00:05:06,1,9,8
10,TRN,P005738,P006382,0 days 00:04:56,-6,8,14
10,TRN,P006382,P012597,0 days 00:04:50,-2,8,10
10,TRN,P001479,P012597,0 days 00:04:49,-1,11,12
10,TRN,P009903,P012594,0 days 00:04:23,-2,5,7
10,TRN,P001479,P009903,0 days 00:03:10,2,5,3
10,TRN,P012594,P012597,0 days 00:03:09,-4,5,9
10,TRN,P012593,P012594,0 days 00:02:44,-4,2,6
10,TRN,P005059,P012594,0 days 00:02:13,2,3,1
10,TRN,P001479,P012593,0 days 00:01:31,0,2,2
10,TRN,P006382,P009903,0 days 00:01:23,0,3,3
10,TRN,P005738,P012594,0 days 00:01:13,-4,0,4
10,TRN,P012593,P012596,0 days 00:00:32,0,0,0
11,BES,P009582,P011936,0 days 00:22:47,2,40,38
11,BES,P007914,P011936,0 days 00:20:15,9,43,34
11,BES,P003783,P012647,0 days 00:20:07,10,46,36
11,BES,P007914,P009582,0 days 00:19:56,4,41,37
11,BES,P011936,P012622,0 days 00:19:53,4,34,30
11,BES,P003783,P011936,0 days 00:19:13,-1,35,36
11,BES,P011357,P011936,0 days 00:17:58,13,41,28
11,BES,P003783,P009582,0 days 00:17:28,-5,33,38
11,BES,P003783,P007914,0 days 00:17:15,9,46,37
11,BES,P009582,P012622,0 days 00:16:59,1,30,29
11,BES,P007914,P011357,0 days 00:14:59,9,32,23
11,BES,P003783,P012622,0 days 00:14:06,5,32,27
11,BES,P009582,P011357,0 days 00:13:39,8,27,19
11,BES,P007914,P012622,0 days 00:12:57,8,31,23
11,BES,P011936,P012647,0 days 00:12:28,-3,20,23
11,BES,P011357,P012622,0 days 00:12:15,8,25,17
11,BES,P003783,P007917,0 days 00:12:07,14,35,21
11,BES,P012622,P012647,0 days 00:12:05,3,27,24
11,BES,P009582,P012647,0 days 00:11:54,-3,23,26
11,BES,P007914,P012647,0 days 00:11:43,11,34,23
11,BES,P007917,P011936,0 days 00:10:54,12,31,19
11,BES,P007914,P007917,0 days 00:10:39,14,35,21
11,BES,P007917,P012622,0 days 00:08:19,12,26,14
11,BES,P007917,P012647,0 days 00:08:13,13,23,10
11,BES,P007917,P011357,0 days 00:06:42,11,24,13
11,BES,P003783,P011357,0 days 00:06:19,3,15,12
11,BES,P003783,P011379,0 days 00:04:41,6,13,7
11,BES,P007917,P011379,0 days 00:04:41,6,13,7
11,BES,P007914,P011379,0 days 00:04:00,4,10,6
11,BES,P007917,P009582,0 days 00:03:37,3,12,9
11,BES,P011379,P012647,0 days 00:03:12,6,8,2
11,BES,P007917,P012233,0 days 00:01:27,5,6,1
11,BES,P003783,P012233,0 days 00:01:27,5,6,1
11,BES,P009582,P011379,0 days 00:00:48,-2,2,4
11,BES,P012233,P012622,0 days 00:00:46,3,3,0
11,BES,P012233,P012647,0 days 00:00:46,3,3,0
11,BES,P003783,P012624,0 days 00:00:41,2,3,1
11,BES,P007917,P012624,0 days 00:00:41,2,3,1
11,BES,P011379,P012233,0 days 00:00:41,2,3,1
11,BES,P011379,P012624,0 days 00:00:41,2,3,1
11,BES,P012233,P012624,0 days 00:00:41,2,3,1
11,PMT,P011066,P011823,0 days 00:18:35,2,32,30
11,PMT,P002644,P011966,0 days 00:16:07,-12,33,45
11,PMT,P011823,P011944,0 days 00:15:54,3,27,24
11,PMT,P011823,P012599,0 days 00:15:27,-4,23,27
11,PMT,P001686,P011823,0 days 00:14:52,4,26,22
11,PMT,P001686,P011944,0 days 00:14:46,10,28,18
11,PMT,P001686,P011066,0 days 00:14:38,4,26,22
11,PMT,P009559,P011947,0 days 00:13:41,-8,24,32
11,PMT,P011066,P011944,0 days 00:13:11,7,24,17
11,PMT,P011966,P012600,0 days 00:12:59,-16,25,41
11,PMT,P011944,P012599,0 days 00:12:59,2,21,19
11,PMT,P002644,P012600,0 days 00:12:40,-18,23,41
11,PMT,P009559,P011823,0 days 00:12:28,-11,19,30
11,PMT,P011066,P012599,0 days 00:11:18,3,18,15
11,PMT,P001686,P012599,0 days 00:10:16,6,18,12
11,PMT,P009559,P011943,0 days 00:09:19,-8,13,21
11,PMT,P011823,P011947,0 days 00:09:19,-6,14,20
11,PMT,P009559,P011066,0 days 00:09:14,-9,14,23
11,PMT,P011066,P011947,0 days 00:09:14,-9,14,23
11,PMT,P001686,P012600,0 days 00:09:03,-9,18,27
11,PMT,P001686,P011966,0 days 00:09:03,-9,18,27
11,PMT,P001686,P002644,0 days 00:08:49,-9,18,27
11,PMT,P002644,P011943,0 days 00:08:26,-13,14,27
11,PMT,P011943,P011966,0 days 00:08:26,-13,14,27
11,PMT,P009559,P011966,0 days 00:08:18,-6,17,23
11,PMT,P002644,P009559,0 days 00:08:13,-8,15,23
11,PMT,P009559,P011944,0 days 00:07:07,-2,14,16
11,PMT,P002644,P011947,0 days 00:06:59,-8,14,22
11,PMT,P001686,P011947,0 days 00:06:59,-8,12,20
11,PMT,P011947,P011966,0 days 00:06:18,-3,14,17
11,PMT,P002644,P011944,0 days 00:05:59,5,15,10
11,PMT,P011944,P011966,0 days 00:05:59,5,15,10
11,PMT,P009559,P012599,0 days 00:05:11,-10,5,15
11,PMT,P011943,P012600,0 days 00:04:52,-11,9,20
11,PMT,P009559,P012600,0 days 00:04:51,-12,7,19
11,PMT,P011944,P012600,0 days 00:04:30,4,10,6
11,PMT,P001686,P009559,0 days 00:04:22,-2,8,10
11,PMT,P011944,P011947,0 days 00:04:03,2,11,9
11,PMT,P011947,P012600,0 days 00:03:32,-11,4,15
11,PMT,P011943,P011947,0 days 00:03:19,0,5,5
11,PMT,P011943,P011944,0 days 00:03:04,-4,3,7
11,PMT,P011823,P011943,0 days 00:02:49,-2,3,5
11,PMT,P011943,P012599,0 days 00:02:49,-2,3,5
11,PMT,P001686,P011943,0 days 00:01:56,-7,4,11
11,PMT,P011947,P012599,0 days 00:01:48,-5,0,5
11,PMT,P011823,P011966,0 days 00:01:14,-3,2,5
11,PMT,P011823,P012600,0 days 00:01:14,-3,2,5
11,PMT,P011966,P012599,0 days 00:01:00,-3,2,5
11,PMT,P012599,P012600,0 days 00:01:00,-3,2,5
11,PMT,P002644,P011066,0 days 00:00:55,-5,0,5
11,PMT,P011066,P012600,0 days 00:00:55,-5,0,5
12,LJU,P005969,P009395,0 days 00:34:09,0,71,71
12,LJU,P005969,P012598,0 days 00:32:20,-2,71,73
12,LJU,P003452,P012598,0 days 00:31:09,-6,62,68
12,LJU,P003452,P005969,0 days 00:30:25,-3,66,69
12,LJU,P009395,P012598,0 days 00:29:57,1,65,64
12,LJU,P003452,P009395,0 days 00:28:11,-3,58,61
12,LJU,P005969,P008883,0 days 00:27:28,6,58,52
12,LJU,P008883,P012598,0 days 00:24:44,-2,52,54
12,LJU,P008883,P009395,0 days 00:22:04,4,47,43
12,LJU,P003452,P008883,0 days 00:19:11,-3,40,43
12,LJU,P009395,P012700,0 days 00:18:15,-3,35,38
12,LJU,P005969,P012700,0 days 00:17:11,-3,35,38
12,LJU,P012598,P012700,0 days 00:14:25,-2,29,31
12,LJU,P007066,P008883,0 days 00:12:49,-1,18,19
12,LJU,P003452,P012700,0 days 00:12:39,-6,22,28
12,LJU,P005969,P007066,0 days 00:11:43,1,19,18
12,LJU,P007066,P012598,0 days 00:06:45,-6,9,15
12,LJU,P003452,P007066,0 days 00:06:23,-5,10,15
12,LJU,P008883,P012700,0 days 00:05:36,3,13,10
12,LJU,P007066,P009395,0 days 00:05:16,-1,6,7
12,LJU,P002561,P007066,0 days 00:04:51,6,10,4
12,LJU,P002561,P010594,0 days 00:04:26,6,10,4
12,LJU,P007066,P010594,0 days 00:04:26,6,10,4
12,LJU,P007066,P011261,0 days 00:04:08,-7,0,7
12,LJU,P008883,P011261,0 days 00:04:08,-7,0,7
12,LJU,P007066,P012700,0 days 00:03:50,-1,6,7
12,LJU,P002561,P008883,0 days 00:03:48,6,8,2
12,LJU,P002561,P005969,0 days 00:03:32,7,9,2
12,LJU,P008883,P010594,0 days 00:03:23,6,8,2
12,LJU,P002561,P012598,0 days 00:03:22,3,5,2
12,LJU,P005969,P010594,0 days 00:03:02,5,7,2
12,LJU,P002561,P003452,0 days 00:03:01,2,4,2
12,LJU,P011261,P012598,0 days 00:02:42,-7,0,7
12,LJU,P005969,P011261,0 days 00:02:38,-3,0,3
12,LJU,P002561,P009395,0 days 00:01:33,2,2,0
12,LJU,P003452,P011261,0 days 00:01:30,-4,0,4
12,LJU,P009395,P011261,0 days 00:01:26,0,0,0
12,LJU,P010594,P012598,0 days 00:01:24,1,3,2
12,LJU,P003452,P010594,0 days 00:01:03,0,2,2
12,LJU,P002561,P012700,0 days 00:01:03,0,0,0
12,LJU,P001235,P007066,0 days 00:00:01,0,0,0
12,LJU,P001235,P008883,0 days 00:00:01,0,0,0
12,LJU,P001235,P009395,0 days 00:00:01,0,0,0
12,LJU,P001235,P012700,0 days 00:00:01,0,0,0
12,JOV,P002361,P010458,0 days 00:31:17,5,68,63
12,JOV,P005094,P011247,0 days 00:27:35,7,52,45
12,JOV,P005094,P010458,0 days 00:25:54,11,56,45
12,JOV,P010458,P011247,0 days 00:24:39,13,54,41
12,JOV,P002361,P005094,0 days 00:24:11,11,52,41
12,JOV,P010458,P012076,0 days 00:23:12,3,48,45
12,JOV,P002361,P011247,0 days 00:21:35,11,46,35
12,JOV,P002361,P012076,0 days 00:20:20,5,43,38
12,JOV,P002507,P005094,0 days 00:19:57,1,36,35
12,JOV,P010458,PJUG,0 days 00:17:25,-10,29,39
12,JOV,P002507,P011247,0 days 00:16:52,-2,28,30
12,JOV,P011247,P012076,0 days 00:16:03,11,38,27
12,JOV,P005094,PJUG,0 days 00:14:26,0,31,31
12,JOV,P005094,P012076,0 days 00:14:11,6,32,26
12,JOV,P002507,P010458,0 days 00:13:33,2,28,26
12,JOV,P002361,P002507,0 days 00:13:22,-2,25,27
12,JOV,P002361,PJUG,0 days 00:12:10,-9,22,31
12,JOV,P002507,PJUG,0 days 00:11:16,4,26,22
12,JOV,P012076,PJUG,0 days 00:10:09,-11,15,26
12,JOV,P011247,PJUG,0 days 00:09:19,1,19,18
12,JOV,P006771,P010458,0 days 00:08:26,-4,14,18
12,JOV,P002507,P010166,0 days 00:08:14,-4,12,16
12,JOV,P010166,P011247,0 days 00:08:14,-4,12,16
12,JOV,P005094,P010166,0 days 00:08:13,-4,12,16
12,JOV,P006771,P012076,0 days 00:08:07,-2,14,16
12,JOV,P002361,P006771,0 days 00:07:28,-4,12,16
12,JOV,P006771,P011247,0 days 00:04:50,1,12,11
12,JOV,P006771,PJUG,0 days 00:04:34,-5,4,9
12,JOV,P010166,PJUG,0 days 00:03:59,3,12,9
12,JOV,P002361,P010166,0 days 00:02:24,-2,0,2
12,JOV,P010161,PJUG,0 days 00:02:22,-1,6,7
12,JOV,P010161,P010458,0 days 00:02:21,-1,6,7
12,JOV,P002507,P010709,0 days 00:02:04,-4,1,5
12,JOV,P005094,P010709,0 days 00:02:04,-4,1,5
12,JOV,P010709,P011247,0 days 00:02:04,-4,1,5
12,JOV,P002361,P010161,0 days 00:01:57,-3,4,7
12,JOV,P010166,P010709,0 days 00:01:51,-5,0,5
12,JOV,P002507,P010161,0 days 00:01:30,-1,4,5
12,JOV,P010161,P012076,0 days 00:00:52,0,2,2
12,JOV,P010161,P011247,0 days 00:00:25,2,2,0
12,JOV,P002507,P006771,0 days 00:00:19,-2,0,2
12,JOV,P010458,P010709,0 days 00:00:13,1,1,0
12,JOV,P002507,P012076,0 days 00:00:01,0,0,0
12,JOV,P010166,P012076,0 days 00:00:01,0,0,0
12,JOV,P005094,P010161,0 days 00:00:01,0,0,0
13,HTA,P004267,P007759,0 days 00:31:25,15,73,58
13,HTA,P004846,P007759,0 days 00:31:15,10,70,60
13,HTA,P004267,P004846,0 days 00:31:04,15,73,58
13,HTA,P004267,P011973,0 days 00:28:56,12,64,52
13,HTA,P007759,P010550,0 days 00:27:43,9,63,54
13,HTA,P004267,P010550,0 days 00:27:30,17,69,52
13,HTA,P004846,P010550,0 days 00:26:43,10,64,54
13,HTA,P007759,P011973,0 days 00:26:32,10,57,47
13,HTA,P004846,P011973,0 days 00:26:11,10,57,47
13,HTA,P010550,P011973,0 days 00:21:37,11,50,39
13,HTA,P003533,P007759,0 days 00:12:36,1,28,27
13,HTA,P003533,P004267,0 days 00:12:03,11,31,20
13,HTA,P003533,P004846,0 days 00:11:35,8,27,19
13,HTA,P010550,P011990,0 days 00:10:29,-6,22,28
13,HTA,P003533,P010550,0 days 00:08:50,-2,19,21
13,HTA,P004267,P011990,0 days 00:07:38,4,20,16
13,HTA,P004846,P011990,0 days 00:06:51,-3,15,18
13,HTA,P007759,P011990,0 days 00:06:49,-6,12,18
13,HTA,P003533,P011990,0 days 00:06:17,-4,11,15
13,HTA,P003533,P011973,0 days 00:05:48,6,14,8
13,HTA,P011973,P011990,0 days 00:05:20,2,11,9
13,HTA,P003533,P012706,0 days 00:04:43,-4,10,14
13,HTA,P004267,P012706,0 days 00:03:53,0,10,10
13,HTA,P007759,P012706,0 days 00:02:53,-5,5,10
13,HTA,P010550,P012706,0 days 00:02:40,-3,5,8
13,HTA,P011990,P012706,0 days 00:02:40,-3,5,8
13,HTA,P004267,P012592,0 days 00:01:59,-6,0,6
13,HTA,P004846,P012592,0 days 00:01:59,-6,0,6
13,HTA,P007759,P012592,0 days 00:01:59,-6,0,6
13,HTA,P011973,P012592,0 days 00:01:59,-6,0,6
13,HTA,P011973,P012706,0 days 00:01:13,-1,3,4
13,HTA,P004846,P012706,0 days 00:00:50,0,2,2
13,WOL,P006546,P011150,0 days 00:26:08,1,56,55
13,WOL,P006546,P012576,0 days 00:24:42,1,49,48
13,WOL,P011150,P012576,0 days 00:23:47,5,51,46
13,WOL,P005516,P006546,0 days 00:21:30,-3,43,46
13,WOL,P002387,P011150,0 days 00:20:35,3,47,44
13,WOL,P002387,P006546,0 days 00:20:08,2,41,39
13,WOL,P005516,P012576,0 days 00:18:45,1,36,35
13,WOL,P005516,P011150,0 days 00:18:21,2,39,37
13,WOL,P002387,P012576,0 days 00:16:42,6,36,30
13,WOL,P002387,P005516,0 days 00:16:32,3,35,32
13,WOL,P003212,P012577,0 days 00:14:43,-5,26,31
13,WOL,P003212,P011150,0 days 00:12:27,-5,27,32
13,WOL,P011150,P012577,0 days 00:11:56,-4,25,29
13,WOL,P003212,P004229,0 days 00:10:53,-6,20,26
13,WOL,P004229,P012577,0 days 00:10:33,-6,18,24
13,WOL,P006546,P012577,0 days 00:10:30,-3,19,22
13,WOL,P003212,P006546,0 days 00:09:52,-3,17,20
13,WOL,P012576,P012577,0 days 00:09:08,-5,16,21
13,WOL,P003212,P012576,0 days 00:08:09,-2,17,19
13,WOL,P002387,P003212,0 days 00:07:54,-6,12,18
13,WOL,P003212,P006907,0 days 00:06:53,-6,13,19
13,WOL,P004229,P011150,0 days 00:05:48,-9,10,19
13,WOL,P002387,P004229,0 days 00:05:31,-8,6,14
13,WOL,P005516,P012577,0 days 00:05:25,-3,13,16
13,WOL,P004229,P006907,0 days 00:05:09,-6,8,14
13,WOL,P006907,P012577,0 days 00:05:09,-6,8,14
13,WOL,P003212,P006154,0 days 00:04:58,-1,10,11
13,WOL,P004229,P006154,0 days 00:04:58,-1,10,11
13,WOL,P006154,P012577,0 days 00:04:58,-1,10,11
13,WOL,P002387,P012577,0 days 00:04:50,0,11,11
13,WOL,P004229,P006546,0 days 00:04:27,-6,6,12
13,WOL,P006907,P011150,0 days 00:04:10,-5,9,14
13,WOL,P012577,PLCT,0 days 00:03:20,1,10,9
13,WOL,P006154,P006907,0 days 00:03:01,-3,4,7
13,WOL,P004229,PLCT,0 days 00:02:13,3,8,5
13,WOL,P005516,PLCT,0 days 00:02:09,-3,4,7
13,WOL,P006546,PLCT,0 days 00:02:09,-3,4,7
13,WOL,P006546,P006907,0 days 00:02:02,-2,5,7
13,WOL,P004229,P005516,0 days 00:02:00,-5,2,7
13,WOL,P006907,P012576,0 days 00:01:16,0,5,5
13,WOL,P003212,PLCT,0 days 00:01:11,4,6,2
13,WOL,P006154,PLCT,0 days 00:01:11,4,6,2
13,WOL,P012576,PLCT,0 days 00:01:07,-2,2,4
13,WOL,P003212,P005516,0 days 00:01:00,-2,0,2
13,WOL,P002387,P006154,0 days 00:00:46,-2,0,2
13,WOL,P002387,P006907,0 days 00:00:46,-2,0,2
13,WOL,P005516,P006907,0 days 00:00:18,-2,0,2
14,VNC,P011928,P012591,0 days 00:29:47,1,64,63
14,VNC,P003759,P012591,0 days 00:28:23,8,58,50
14,VNC,P000968,P011928,0 days 00:26:42,5,62,57
14,VNC,P003759,P011928,0 days 00:26:39,11,63,52
14,VNC,P000968,P003759,0 days 00:25:07,1,55,54
14,VNC,P000968,P012591,0 days 00:24:29,3,55,52
14,VNC,P011909,P011928,0 days 00:24:18,8,53,45
14,VNC,P003759,P011909,0 days 00:23:51,5,51,46
14,VNC,P000968,P011909,0 days 00:20:59,3,45,42
14,VNC,P011909,P012591,0 days 00:20:54,8,46,38
14,VNC,P009400,P012591,0 days 00:14:01,-10,20,30
14,VNC,P003759,P009400,0 days 00:13:43,-7,21,28
14,VNC,P000968,P009400,0 days 00:12:41,-10,24,34
14,VNC,P009400,P011928,0 days 00:12:12,-3,27,30
14,VNC,P004117,P012591,0 days 00:11:40,-13,10,23
14,VNC,P004117,P009400,0 days 00:11:31,-14,10,24
14,VNC,P012590,P012591,0 days 00:10:26,-5,11,16
14,VNC,P003759,P012590,0 days 00:08:26,-1,10,11
14,VNC,P011928,P012590,0 days 00:07:10,-4,11,15
14,VNC,P004117,P011928,0 days 00:06:50,-8,10,18
14,VNC,P000968,P004117,0 days 00:06:43,-12,7,19
14,VNC,P004117,P012590,0 days 00:06:38,-5,5,10
14,VNC,P003759,P004117,0 days 00:06:31,-9,2,11
14,VNC,P009400,P012590,0 days 00:06:02,-2,5,7
14,VNC,P011909,P012590,0 days 00:05:05,-3,8,11
14,VNC,P009400,P011909,0 days 00:04:24,-4,7,11
14,VNC,P004117,P011909,0 days 00:03:13,-9,2,11
14,VNC,P000968,P012590,0 days 00:00:23,-2,0,2
14,VNC,P004117,P012587,0 days 00:00:18,2,2,0
14,VNC,P009400,P012587,0 days 00:00:18,2,2,0
14,VNC,P011928,P012587,0 days 00:00:18,2,2,0
14,VNC,P012587,P012590,0 days 00:00:18,2,2,0
14,PRS,P012608,P012610,0 days 00:20:52,-2,43,45
14,PRS,P012608,P012613,0 days 00:19:46,6,37,31
14,PRS,P012609,P012640,0 days 00:17:46,10,41,31
14,PRS,P012609,P012613,0 days 00:17:04,12,40,28
14,PRS,P012610,P012613,0 days 00:16:20,6,33,27
14,PRS,P005793,P012608,0 days 00:16:07,-5,32,37
14,PRS,P005793,P012611,0 days 00:14:56,2,34,32
14,PRS,P012613,P012640,0 days 00:14:30,-1,25,26
14,PRS,P003481,P012609,0 days 00:13:33,6,29,23
14,PRS,P003481,P012640,0 days 00:13:33,6,29,23
14,PRS,P012610,P012611,0 days 00:13:07,5,33,28
14,PRS,P005793,P012610,0 days 00:13:05,-3,28,31
14,PRS,P004512,P012608,0 days 00:12:51,-2,24,26
14,PRS,P012608,P012609,0 days 00:12:34,9,31,22
14,PRS,P012609,P012611,0 days 00:12:17,0,25,25
14,PRS,P012610,P012640,0 days 00:11:08,-3,20,23
14,PRS,P012608,P012611,0 days 00:10:52,1,26,25
14,PRS,P004512,P012610,0 days 00:10:46,-5,19,24
14,PRS,P012609,P012610,0 days 00:10:38,11,32,21
14,PRS,P012611,P012640,0 days 00:10:21,2,22,20
14,PRS,P003481,P012611,0 days 00:09:32,1,20,19
14,PRS,P005793,P012640,0 days 00:09:23,-6,13,19
14,PRS,P012608,P012640,0 days 00:09:19,-4,14,18
14,PRS,P005793,P012613,0 days 00:09:13,1,17,16
14,PRS,P005793,P012609,0 days 00:08:39,2,20,18
14,PRS,P012611,P012613,0 days 00:07:51,6,17,11
14,PRS,P004512,P005793,0 days 00:07:43,-5,17,22
14,PRS,P004512,P012611,0 days 00:07:16,-5,15,20
14,PRS,P003481,P012613,0 days 00:06:33,4,13,9
14,PRS,P004512,P012613,0 days 00:05:28,3,7,4
14,PRS,P011887,P012608,0 days 00:05:24,-1,5,6
14,PRS,P003481,P005793,0 days 00:04:29,0,9,9
14,PRS,P011887,P012613,0 days 00:04:23,-1,3,4
14,PRS,P003481,P012610,0 days 00:04:21,5,12,7
14,PRS,P004512,P011887,0 days 00:04:20,1,5,4
14,PRS,P004512,P012609,0 days 00:04:20,5,9,4
14,PRS,P011887,P012609,0 days 00:03:29,1,5,4
14,PRS,P003481,P012608,0 days 00:02:11,2,4,2
14,PRS,P005793,P011887,0 days 00:02:05,-2,2,4
14,PRS,P011887,P012610,0 days 00:01:55,-2,0,2
15,HAM,P009663,P012580,0 days 00:20:39,-6,48,54
15,HAM,P011187,P012582,0 days 00:19:32,2,49,47
15,HAM,P011168,P012580,0 days 00:18:38,-8,46,54
15,HAM,P011168,P012582,0 days 00:18:14,-9,46,55
15,HAM,P011168,P011187,0 days 00:17:17,-5,41,46
15,HAM,P011187,P012581,0 days 00:15:21,-6,35,41
15,HAM,P012579,P012580,0 days 00:15:18,-4,38,42
15,HAM,P012581,P012582,0 days 00:14:57,-4,35,39
15,HAM,P009663,P011168,0 days 00:14:41,-8,38,46
15,HAM,P011168,P012648,0 days 00:13:55,-7,29,36
15,HAM,P011168,P012579,0 days 00:13:48,-8,36,44
15,HAM,P009663,P012579,0 days 00:13:19,-1,33,34
15,HAM,P011168,P012581,0 days 00:12:25,-10,28,38
15,HAM,P011187,P012580,0 days 00:11:41,5,25,20
15,HAM,P011187,P012579,0 days 00:11:05,3,29,26
15,HAM,P012580,P012694,0 days 00:10:28,-8,22,30
15,HAM,P009663,P011187,0 days 00:10:26,9,25,16
15,HAM,P009663,P012694,0 days 00:09:53,-11,19,30
15,HAM,P012582,P012648,0 days 00:09:36,-4,23,27
15,HAM,P011187,P012648,0 days 00:09:32,0,21,21
15,HAM,P009663,P012582,0 days 00:08:50,2,22,20
15,HAM,P012579,P012694,0 days 00:08:06,-3,20,23
15,HAM,P012580,P012582,0 days 00:08:04,1,22,21
15,HAM,P012581,P012648,0 days 00:07:34,-3,18,21
15,HAM,P012579,P012582,0 days 00:07:33,-2,18,20
15,HAM,P011187,P012578,0 days 00:07:20,6,16,10
15,HAM,P011168,P012694,0 days 00:07:14,-7,18,25
15,HAM,P009663,P012578,0 days 00:06:28,6,18,12
15,HAM,P012580,P012648,0 days 00:06:21,-4,11,15
15,HAM,P009663,P012648,0 days 00:05:21,-1,14,15
15,HAM,P012578,P012580,0 days 00:05:15,2,10,8
15,HAM,P011168,P012578,0 days 00:04:36,-2,6,8
15,HAM,P012579,P012581,0 days 00:04:08,-3,10,13
15,HAM,P012578,P012581,0 days 00:04:02,2,9,7
15,HAM,P012578,P012582,0 days 00:04:02,2,9,7
15,HAM,P011187,P012694,0 days 00:03:49,2,7,5
15,HAM,P012578,P012648,0 days 00:03:35,5,7,2
15,HAM,P012578,P012579,0 days 00:02:38,3,9,6
15,HAM,P009663,P012581,0 days 00:02:38,2,7,5
15,HAM,P012648,P012694,0 days 00:01:13,-5,2,7
15,HAM,P009663,P010070,0 days 00:01:09,0,0,0
15,HAM,P010070,P011187,0 days 00:01:09,0,0,0
15,HAM,P010070,P012580,0 days 00:01:09,0,0,0
15,HAM,P010070,P012694,0 days 00:01:09,0,0,0
15,HAM,P011187,P012695,0 days 00:01:08,4,4,0
15,HAM,P012578,P012695,0 days 00:01:08,4,4,0
15,HAM,P012581,P012695,0 days 00:01:08,4,4,0
15,HAM,P012582,P012695,0 days 00:01:08,4,4,0
15,HAM,P012580,P012581,0 days 00:00:51,-2,2,4
15,HAM,P012579,P012648,0 days 00:00:29,3,3,0
15,LLI,P006600,P012585,0 days 00:27:39,5,73,68
15,LLI,P012585,P012586,0 days 00:23:33,9,67,58
15,LLI,P006600,P012586,0 days 00:23:32,7,64,57
15,LLI,P006600,P009649,0 days 00:23:23,6,62,56
15,LLI,P009649,P012585,0 days 00:22:11,11,64,53
15,LLI,P009649,P012586,0 days 00:21:13,7,57,50
15,LLI,P009680,P012585,0 days 00:19:30,15,58,43
15,LLI,P006600,P009680,0 days 00:17:24,7,47,40
15,LLI,P005247,P012585,0 days 00:16:48,5,43,38
15,LLI,P005247,P009680,0 days 00:15:39,1,39,38
15,LLI,P009649,P009680,0 days 00:13:32,9,38,29
15,LLI,P004479,P009649,0 days 00:12:46,-5,26,31
15,LLI,P005247,P006600,0 days 00:11:38,-3,25,28
15,LLI,P004479,P012586,0 days 00:11:38,-3,26,29
15,LLI,P004479,P006600,0 days 00:11:32,-2,26,28
15,LLI,P004773,P005247,0 days 00:10:23,1,24,23
15,LLI,P009680,P012586,0 days 00:10:10,10,34,24
15,LLI,P004479,P012585,0 days 00:10:03,-2,26,28
15,LLI,P004773,P009680,0 days 00:09:04,0,20,20
15,LLI,P004773,P012585,0 days 00:08:55,1,21,20
15,LLI,P005247,P009649,0 days 00:08:38,-3,19,22
15,LLI,P005247,P012020,0 days 00:08:29,2,23,21
15,LLI,P005247,P012586,0 days 00:08:24,-4,19,23
15,LLI,P004773,P006600,0 days 00:07:56,-4,11,15
15,LLI,P004773,P009649,0 days 00:07:13,-7,9,16
15,LLI,P004773,P012020,0 days 00:06:50,1,17,16
15,LLI,P004773,P012586,0 days 00:06:29,-4,10,14
15,LLI,P012020,P012585,0 days 00:06:01,8,20,12
15,LLI,P009680,P012020,0 days 00:05:37,4,16,12
15,LLI,P009649,P012020,0 days 00:05:08,-2,9,11
15,LLI,P012020,P012586,0 days 00:03:37,-2,7,9
15,LLI,P004479,P004773,0 days 00:02:14,0,0,0
15,LLI,P004479,P012020,0 days 00:01:14,-3,0,3
15,LLI,P004479,P009680,0 days 00:01:08,-2,0,2
15,LLI,P004479,P005247,0 days 00:00:29,-3,0,3
16,TRN,P005059,P012595,0 days 00:25:31,-2,49,51
16,TRN,P005059,P009903,0 days 00:24:15,-3,49,52
16,TRN,P009903,P012595,0 days 00:23:11,2,49,47
16,TRN,P005738,P009903,0 days 00:22:51,-8,44,52
16,TRN,P005738,P012595,0 days 00:22:16,-4,44,48
16,TRN,P005059,P005738,0 days 00:20:32,-8,40,48
16,TRN,P005738,P012593,0 days 00:16:48,-5,36,41
16,TRN,P009903,P012593,0 days 00:14:27,-3,29,32
16,TRN,P005738,P012594,0 days 00:12:12,-10,19,29
16,TRN,P005059,P012593,0 days 00:11:33,-3,25,28
16,TRN,P006382,P012594,0 days 00:10:54,0,15,15
16,TRN,P012594,P012596,0 days 00:10:31,0,19,19
16,TRN,P012593,P012595,0 days 00:10:29,2,25,23
16,TRN,P006382,P012596,0 days 00:10:20,-4,11,15
16,TRN,P012593,P012594,0 days 00:09:48,-8,13,21
16,TRN,P012595,P012597,0 days 00:08:49,4,18,14
16,TRN,P001479,P006382,0 days 00:08:22,-2,9,11
16,TRN,P001479,P012595,0 days 00:07:56,5,15,10
16,TRN,P006382,P012595,0 days 00:07:49,-3,12,15
16,TRN,P005059,P012597,0 days 00:07:46,1,15,14
16,TRN,P009903,P012597,0 days 00:07:46,1,15,14
16,TRN,P012594,P012595,0 days 00:07:46,1,14,13
16,TRN,P006382,P012593,0 days 00:07:16,0,8,8
16,TRN,P005738,P012597,0 days 00:07:14,-5,15,20
16,TRN,P001479,P012596,0 days 00:07:07,-1,8,9
16,TRN,P009903,P012594,0 days 00:07:03,-7,8,15
16,TRN,P012595,P012596,0 days 00:07:01,-1,10,11
16,TRN,P005738,P006382,0 days 00:06:43,-1,11,12
16,TRN,P001479,P005059,0 days 00:06:03,1,9,8
16,TRN,P012593,P012596,0 days 00:05:50,-3,9,12
16,TRN,P005738,P012596,0 days 00:05:44,-3,11,14
16,TRN,P001479,P012594,0 days 00:05:22,3,8,5
16,TRN,P006382,P009903,0 days 00:04:45,1,9,8
16,TRN,P001479,P009903,0 days 00:04:18,5,9,4
16,TRN,P005059,P006382,0 days 00:04:11,-3,5,8
16,TRN,P005059,P012594,0 days 00:04:09,-7,4,11
16,TRN,P001479,P012593,0 days 00:03:29,-1,2,3
16,TRN,P001479,P012597,0 days 00:03:03,6,8,2
16,TRN,P012594,P012597,0 days 00:02:31,0,8,8
16,TRN,P012596,P012597,0 days 00:02:31,0,8,8
16,TRN,P005059,P012596,0 days 00:02:20,-4,0,4
16,TRN,P012593,P012597,0 days 00:01:28,-3,5,8
16,BOU,P010449,P011836,0 days 00:23:44,18,48,30
16,BOU,P011836,P012628,0 days 00:22:44,22,60,38
16,BOU,P004525,P010450,0 days 00:19:02,4,30,26
16,BOU,P010449,P012628,0 days 00:18:54,20,46,26
16,BOU,P011837,P012628,0 days 00:18:44,9,48,39
16,BOU,P011836,P011837,0 days 00:17:39,12,46,34
16,BOU,P010431,P012628,0 days 00:17:29,9,40,31
16,BOU,P010431,P011836,0 days 00:17:15,7,38,31
16,BOU,P010431,P011837,0 days 00:16:28,6,38,32
16,BOU,P010431,P010449,0 days 00:15:10,5,32,27
16,BOU,P004525,P010718,0 days 00:14:37,-10,17,27
16,BOU,P010450,P010718,0 days 00:12:56,-9,14,23
16,BOU,P010449,P011837,0 days 00:12:48,7,30,23
16,BOU,P010450,P011836,0 days 00:12:00,10,20,10
16,BOU,P004525,P011836,0 days 00:12:00,10,20,10
16,BOU,P010449,P010450,0 days 00:11:44,7,20,13
16,BOU,P004525,P010449,0 days 00:11:27,10,20,10
16,BOU,P010718,P011161,0 days 00:11:01,-7,21,28
16,BOU,P004525,P011161,0 days 00:09:33,-10,13,23
16,BOU,P010718,P011836,0 days 00:09:27,1,14,13
16,BOU,P004525,P012628,0 days 00:08:21,6,19,13
16,BOU,P010718,P012619,0 days 00:07:41,-9,9,18
16,BOU,P010450,P011161,0 days 00:07:35,-6,10,16
16,BOU,P011161,P012628,0 days 00:07:06,-2,19,21
16,BOU,P011161,P011836,0 days 00:06:59,2,18,16
16,BOU,P004525,P012619,0 days 00:06:37,-7,9,16
16,BOU,P011161,P012619,0 days 00:06:37,-7,9,16
16,BOU,P010449,P010718,0 days 00:06:25,-5,4,9
16,BOU,P010450,P012628,0 days 00:06:23,10,16,6
16,BOU,P011161,P011837,0 days 00:06:13,-1,18,19
16,BOU,P010450,P012619,0 days 00:05:44,-6,8,14
16,BOU,P010431,P011161,0 days 00:03:40,-1,8,9
16,BOU,P010718,P012628,0 days 00:03:26,-1,11,12
16,BOU,P010718,P011837,0 days 00:02:50,-3,10,13
16,BOU,P010431,P010450,0 days 00:01:35,-3,2,5
16,BOU,P010431,P010718,0 days 00:01:21,-5,0,5
16,BOU,P004525,P010431,0 days 00:01:18,0,2,2
16,BOU,P004525,P011837,0 days 00:01:05,-3,2,5
16,BOU,P010431,P012619,0 days 00:01:04,-2,0,2
16,BOU,P010449,P012619,0 days 00:01:04,-2,0,2
16,BOU,P011836,P012619,0 days 00:01:04,-2,0,2
16,BOU,P012619,P012628,0 days 00:00:53,-1,1,2
16,BOU,P010450,P011837,0 days 00:00:17,-3,0,3
17,CAN,P005005,P006588,0 days 00:15:47,14,50,36
17,CAN,P006588,P007560,0 days 00:14:10,10,42,32
17,CAN,P006588,P009864,0 days 00:14:08,11,40,29
17,CAN,P001607,P007560,0 days 00:13:24,-7,32,39
17,CAN,P001607,P005005,0 days 00:13:14,-1,41,42
17,CAN,P007560,P009864,0 days 00:13:11,5,37,32
17,CAN,P005005,P007560,0 days 00:11:47,4,35,31
17,CAN,P003425,P006588,0 days 00:11:13,20,33,13
17,CAN,P006588,P008121,0 days 00:11:02,11,37,26
17,CAN,P003425,P005005,0 days 00:10:50,13,28,15
17,CAN,P005005,P010385,0 days 00:10:07,8,26,18
17,CAN,P010385,P010452,0 days 00:10:05,5,23,18
17,CAN,P005005,P009864,0 days 00:10:01,5,28,23
17,CAN,P003425,P007560,0 days 00:09:53,16,27,11
17,CAN,P003637,P005005,0 days 00:09:37,11,26,15
17,CAN,P001607,P006588,0 days 00:09:26,-4,28,32
17,CAN,P001607,P010452,0 days 00:09:13,3,24,21
17,CAN,P003425,P003637,0 days 00:09:11,9,24,15
17,CAN,P001607,P007644,0 days 00:09:08,2,27,25
17,CAN,P003425,P009864,0 days 00:08:53,18,31,13
17,CAN,P007560,P008121,0 days 00:08:48,12,25,13
17,CAN,P003425,P010385,0 days 00:08:39,4,17,13
17,CAN,P003637,P010385,0 days 00:08:37,6,21,15
17,CAN,P005005,P010452,0 days 00:08:25,-2,22,24
17,CAN,P003637,P010452,0 days 00:07:54,6,21,15
17,CAN,P001607,P009864,0 days 00:07:24,-4,17,21
17,CAN,P007560,P010452,0 days 00:07:24,-4,15,19
17,CAN,P001607,P008121,0 days 00:07:06,7,22,15
17,CAN,P003425,P008121,0 days 00:06:28,6,17,11
17,CAN,P007560,P010484,0 days 00:06:11,4,16,12
17,CAN,P003425,P010452,0 days 00:06:05,-1,12,13
17,CAN,P008121,P009864,0 days 00:06:02,6,17,11
17,CAN,P007644,P010484,0 days 00:05:57,1,13,12
17,CAN,P007560,P007644,0 days 00:05:57,1,13,12
17,CAN,P001607,P010484,0 days 00:05:18,1,13,12
17,CAN,P007560,P010385,0 days 00:05:12,8,13,5
17,CAN,P005005,P008121,0 days 00:05:00,5,20,15
17,CAN,P005005,P007644,0 days 00:04:59,4,19,15
17,CAN,P008121,P010385,0 days 00:04:52,10,14,4
17,CAN,P001607,P003637,0 days 00:04:23,9,13,4
17,CAN,P001607,P010385,0 days 00:04:00,6,11,5
17,CAN,P006588,P007644,0 days 00:03:50,1,14,13
17,CAN,P007644,P008121,0 days 00:03:50,1,14,13
17,CAN,P003637,P006588,0 days 00:03:49,9,11,2
17,CAN,P006588,P010385,0 days 00:03:44,9,11,2
17,CAN,P008121,P010452,0 days 00:03:42,6,8,2
17,CAN,P003637,P009864,0 days 00:03:20,12,14,2
17,CAN,P007644,P010452,0 days 00:03:11,-2,6,8
17,CAN,P010452,P010484,0 days 00:03:11,-2,6,8
17,CAN,P003637,P008121,0 days 00:02:06,4,6,2
17,CAN,P009864,P010452,0 days 00:01:55,0,5,5
17,CAN,P003637,P007560,0 days 00:01:51,3,5,2
17,CAN,P003637,P010484,0 days 00:01:51,3,5,2
17,CAN,P003637,P007644,0 days 00:01:37,0,2,2
17,CAN,P005005,P010484,0 days 00:01:09,3,5,2
17,CAN,P003425,P010484,0 days 00:00:53,3,3,0
17,CAN,P003425,P007644,0 days 00:00:39,0,0,0
17,CAN,P009864,P010484,0 days 00:00:14,3,3,0
17,CAN,P006588,P010452,0 days 00:00:07,-1,2,3
17,ULM,P005422,P012603,0 days 00:21:47,0,59,59
17,ULM,P010582,P012603,0 days 00:17:41,-11,36,47
17,ULM,P010106,P012603,0 days 00:17:25,-20,30,50
17,ULM,P012603,P012629,0 days 00:16:42,-14,35,49
17,ULM,P007952,P012603,0 days 00:16:01,-11,32,43
17,ULM,P012603,P012703,0 days 00:15:54,-5,36,41
17,ULM,P007952,P010582,0 days 00:15:33,-13,31,44
17,ULM,P012629,P012703,0 days 00:15:25,-14,29,43
17,ULM,P005422,P012703,0 days 00:14:37,-3,36,39
17,ULM,P011391,P012629,0 days 00:14:29,-9,33,42
17,ULM,P010582,P012703,0 days 00:14:07,-5,31,36
17,ULM,P005422,P011391,0 days 00:13:18,-12,30,42
17,ULM,P005422,P010106,0 days 00:13:12,-4,31,35
17,ULM,P005422,P012629,0 days 00:12:36,-5,31,36
17,ULM,P005422,P010582,0 days 00:12:22,1,31,30
17,ULM,P005422,P007952,0 days 00:11:38,4,32,28
17,ULM,P010106,P012629,0 days 00:11:13,-12,20,32
17,ULM,P011391,P012703,0 days 00:11:13,-9,24,33
17,ULM,P011391,P012603,0 days 00:10:55,-7,27,34
17,ULM,P007952,P010106,0 days 00:10:24,-13,16,29
17,ULM,P007952,P012703,0 days 00:09:16,-9,18,27
17,ULM,P010106,P011391,0 days 00:08:28,-5,17,22
17,ULM,P010106,P010582,0 days 00:08:17,-13,13,26
17,ULM,P011457,P012703,0 days 00:07:29,-9,13,22
17,ULM,P010582,P012629,0 days 00:06:02,-10,10,20
17,ULM,P004744,P010582,0 days 00:04:49,0,10,10
17,ULM,P010582,P011457,0 days 00:04:43,-7,8,15
17,ULM,P011391,P011457,0 days 00:04:41,-5,8,13
17,ULM,P004744,P012703,0 days 00:04:35,3,10,7
17,ULM,P007952,P012629,0 days 00:04:22,-8,5,13
17,ULM,P010106,P012703,0 days 00:04:10,-7,3,10
17,ULM,P011457,P012629,0 days 00:04:05,-4,8,12
17,ULM,P010726,P011391,0 days 00:04:02,0,10,10
17,ULM,P010582,P010726,0 days 00:04:00,-9,3,12
17,ULM,P004744,P012603,0 days 00:03:54,-1,7,8
17,ULM,P004744,P012629,0 days 00:03:37,-2,8,10
17,ULM,P010726,P011457,0 days 00:03:30,-2,8,10
17,ULM,P010726,P012703,0 days 00:03:30,-2,8,10
17,ULM,P010726,P012603,0 days 00:03:01,-7,2,9
17,ULM,P010106,P010726,0 days 00:03:01,-7,2,9
17,ULM,P005422,P011457,0 days 00:02:40,-5,2,7
17,ULM,P007952,P010726,0 days 00:02:29,-9,0,9
17,ULM,P010582,P011391,0 days 00:02:02,-5,3,8
17,ULM,P007952,P011457,0 days 00:01:53,-5,2,7
17,ULM,P010726,P012629,0 days 00:01:21,2,5,3
17,ULM,P004744,P005422,0 days 00:01:12,2,2,0
17,ULM,P005422,P010726,0 days 00:01:10,-2,2,4
17,ULM,P004744,P011457,0 days 00:00:55,1,3,2
17,ULM,P004744,P010106,0 days 00:00:14,-3,0,3
18,LKB,P002012,P007029,0 days 00:29:20,15,70,55
18,LKB,P002012,PLXI,0 days 00:21:51,5,46,41
18,LKB,P007029,PLXI,0 days 00:20:58,9,47,38
18,LKB,P002012,P004664,0 days 00:20:28,7,47,40
18,LKB,P004664,P007029,0 days 00:19:41,14,50,36
18,LKB,P007029,P008856,0 days 00:15:36,7,35,28
18,LKB,P007029,P010461,0 days 00:15:27,14,38,24
18,LKB,P002012,P006230,0 days 00:15:01,9,34,25
18,LKB,P006230,PLXI,0 days 00:14:34,7,32,25
18,LKB,P004664,PLXI,0 days 00:14:16,9,32,23
18,LKB,P006230,P007029,0 days 00:14:09,14,35,21
18,LKB,P004664,P006230,0 days 00:13:56,16,35,19
18,LKB,P002012,P010461,0 days 00:13:25,8,32,24
18,LKB,P008856,PLXI,0 days 00:13:23,-8,21,29
18,LKB,P002012,P005521,0 days 00:13:05,1,27,26
18,LKB,P002012,P008856,0 days 00:13:01,1,28,27
18,LKB,P008856,P010461,0 days 00:12:43,12,31,19
18,LKB,P005521,P007029,0 days 00:12:25,13,32,19
18,LKB,P004664,P005521,0 days 00:09:32,-5,16,21
18,LKB,P005521,P008856,0 days 00:09:04,7,19,12
18,LKB,P010461,PLXI,0 days 00:08:49,0,16,16
18,LKB,P005521,P012583,0 days 00:08:33,-10,11,21
18,LKB,P005521,P010461,0 days 00:07:54,10,20,10
18,LKB,P005521,PLXI,0 days 00:06:30,-12,3,15
18,LKB,P012583,PLXI,0 days 00:05:59,-13,2,15
18,LKB,P005521,P006230,0 days 00:05:36,1,7,6
18,LKB,P007029,P012583,0 days 00:05:14,-5,10,15
18,LKB,P004664,P012583,0 days 00:04:59,-10,6,16
18,LKB,P008856,P012583,0 days 00:04:50,-3,6,9
18,LKB,P006230,P008856,0 days 00:04:26,-5,5,10
18,LKB,P002012,P012583,0 days 00:04:10,-7,7,14
18,LKB,P004664,P010461,0 days 00:04:04,0,9,9
18,LKB,P010461,P012583,0 days 00:01:57,1,3,2
18,LKB,P005521,P006901,0 days 00:01:33,2,4,2
18,LKB,P006901,P008856,0 days 00:01:33,2,4,2
18,LKB,P004664,P008856,0 days 00:01:32,1,5,4
18,LKB,P006230,P012583,0 days 00:01:31,-2,0,2
18,LKB,P010190,P012583,0 days 00:01:29,-2,2,4
18,LKB,P008856,P010190,0 days 00:01:28,-2,2,4
18,LKB,P010190,PLXI,0 days 00:01:16,-3,1,4
18,LKB,P007029,P010190,0 days 00:01:13,-4,0,4
18,LKB,P006901,P007029,0 days 00:00:57,3,3,0
18,LKB,P006901,P010461,0 days 00:00:57,3,3,0
18,LKB,P006901,P012583,0 days 00:00:37,-1,1,2
18,LKB,P006901,PLXI,0 days 00:00:24,-2,0,2
18,LKB,P006901,P010190,0 days 00:00:13,1,1,0
18,LKB,P005521,P010190,0 days 00:00:12,1,1,0
18,LKB,P002012,P010190,0 days 00:00:03,1,1,0
18,LKB,P006230,P006901,0 days 00:00:01,0,0,0
18,LKB,P006230,P010190,0 days 00:00:01,0,0,0
18,LKB,P006230,P011329,0 days 00:00:01,0,0,0
18,LKB,P006901,P011329,0 days 00:00:01,0,0,0
18,LKB,P010190,P011329,0 days 00:00:01,0,0,0
18,LKB,P011329,P012583,0 days 00:00:01,0,0,0
18,ARI,P003240,P012708,0 days 00:22:53,-12,45,57
18,ARI,P004292,P012708,0 days 00:20:28,3,46,43
18,ARI,P004292,P012716,0 days 00:19:26,2,38,36
18,ARI,P012702,P012708,0 days 00:19:25,-5,42,47
18,ARI,P003240,P012702,0 days 00:16:59,-6,36,42
18,ARI,P012708,P012716,0 days 00:14:03,-6,29,35
18,ARI,P003240,P004292,0 days 00:13:52,4,31,27
18,ARI,P004292,P012702,0 days 00:13:42,14,34,20
18,ARI,P003240,P012716,0 days 00:11:48,-11,18,29
18,ARI,P012702,P012716,0 days 00:11:20,7,26,19
18,ARI,P012702,P012707,0 days 00:11:01,-8,21,29
18,ARI,P012707,P012716,0 days 00:10:56,-1,16,17
18,ARI,P012716,P012722,0 days 00:10:33,-4,17,21
18,ARI,P004292,P012615,0 days 00:10:13,1,18,17
18,ARI,P002867,P012615,0 days 00:10:11,0,16,16
18,ARI,P012615,P012708,0 days 00:09:47,-5,19,24
18,ARI,P004292,P012722,0 days 00:09:21,-1,18,19
18,ARI,P012707,P012708,0 days 00:09:16,-9,19,28
18,ARI,P003240,P012615,0 days 00:09:06,-6,15,21
18,ARI,P012708,P012717,0 days 00:09:03,-6,18,24
18,ARI,P004292,P012707,0 days 00:08:54,2,16,14
18,ARI,P003240,P012717,0 days 00:08:53,-11,13,24
18,ARI,P012615,P012716,0 days 00:08:21,-3,9,12
18,ARI,P002867,P004292,0 days 00:08:13,7,14,7
18,ARI,P012702,P012717,0 days 00:08:10,-9,13,22
18,ARI,P012615,P012722,0 days 00:08:07,4,13,9
18,ARI,P002867,P012716,0 days 00:07:50,10,14,4
18,ARI,P012708,P012722,0 days 00:07:35,-6,14,20
18,ARI,P002867,P012707,0 days 00:07:24,6,14,8
18,ARI,P003240,P012722,0 days 00:07:07,-7,9,16
18,ARI,P003240,P012707,0 days 00:06:52,-14,9,23
18,ARI,P012707,P012717,0 days 00:06:10,-14,9,23
18,ARI,P012615,P012707,0 days 00:05:35,0,8,8
18,ARI,P002867,P012708,0 days 00:05:26,-6,8,14
18,ARI,P002867,P012722,0 days 00:05:11,2,8,6
18,ARI,P002867,P012702,0 days 00:05:07,2,10,8
18,ARI,P012615,P012702,0 days 00:04:28,-3,10,13
18,ARI,P012716,P012717,0 days 00:03:59,-6,5,11
18,ARI,P004292,P012717,0 days 00:03:55,4,9,5
18,ARI,P012707,P012722,0 days 00:03:32,-2,4,6
18,ARI,P002867,P003240,0 days 00:03:18,-5,4,9
18,ARI,P012717,P012722,0 days 00:02:30,-2,5,7
19,TTK,P011239,P011925,0 days 00:27:43,0,51,51
19,TTK,P005000,P011925,0 days 00:22:30,3,46,43
19,TTK,P011239,P011834,0 days 00:21:32,2,39,37
19,TTK,P011834,P011925,0 days 00:20:56,3,38,35
19,TTK,P005000,P011239,0 days 00:20:15,1,41,40
19,TTK,P012056,P012697,0 days 00:18:45,-1,38,39
19,TTK,P011925,P012697,0 days 00:16:08,-7,24,31
19,TTK,P011834,P012697,0 days 00:15:31,0,29,29
19,TTK,P006693,P011925,0 days 00:14:44,6,32,26
19,TTK,P006693,P011239,0 days 00:14:44,6,32,26
19,TTK,P006693,P011834,0 days 00:14:33,6,32,26
19,TTK,P011239,P012697,0 days 00:14:29,-10,20,30
19,TTK,P011239,P012056,0 days 00:14:16,-9,22,31
19,TTK,P011834,P012056,0 days 00:14:13,4,31,27
19,TTK,P004801,P012697,0 days 00:13:50,-2,28,30
19,TTK,P011925,P012056,0 days 00:13:36,-3,23,26
19,TTK,P005000,P011834,0 days 00:12:34,7,28,21
19,TTK,P004801,P011834,0 days 00:12:25,-2,25,27
19,TTK,P005000,P012697,0 days 00:11:34,-2,22,24
19,TTK,P005000,P006693,0 days 00:10:56,5,24,19
19,TTK,P005685,P012697,0 days 00:10:47,6,27,21
19,TTK,P004801,P005685,0 days 00:09:57,4,25,21
19,TTK,P004801,P012056,0 days 00:09:08,3,23,20
19,TTK,P005685,P011834,0 days 00:08:32,4,22,18
19,TTK,P005000,P012056,0 days 00:08:31,-4,15,19
19,TTK,P005685,P012056,0 days 00:08:28,9,24,15
19,TTK,P004801,P011925,0 days 00:04:42,-5,5,10
19,TTK,P006693,P012056,0 days 00:03:59,1,8,7
19,TTK,P004801,P011239,0 days 00:03:53,-6,3,9
19,TTK,P005685,P011925,0 days 00:03:09,-1,5,6
19,TTK,P005000,P005685,0 days 00:02:15,2,5,3
19,TTK,P004801,P005000,0 days 00:01:25,0,3,3
19,BUD,P004945,P012606,0 days 00:24:09,-3,46,49
19,BUD,P002740,P004945,0 days 00:16:52,-5,29,34
19,BUD,P002740,P012606,0 days 00:16:52,-5,29,34
19,BUD,P004945,P011935,0 days 00:15:33,-9,27,36
19,BUD,P004945,P010432,0 days 00:14:56,1,29,28
19,BUD,P010432,P012606,0 days 00:14:48,3,30,27
19,BUD,P010432,P012630,0 days 00:14:11,3,30,27
19,BUD,P011935,P012606,0 days 00:14:02,-9,25,34
19,BUD,P006561,P007398,0 days 00:13:25,-2,24,26
19,BUD,P010432,P011935,0 days 00:13:15,1,29,28
19,BUD,P007398,P012605,0 days 00:12:57,-1,26,27
19,BUD,P012605,P012630,0 days 00:12:39,1,26,25
19,BUD,P007398,P012630,0 days 00:12:31,3,27,24
19,BUD,P006561,P012630,0 days 00:11:58,4,27,23
19,BUD,P007398,P010432,0 days 00:11:05,-4,22,26
19,BUD,P004945,P010248,0 days 00:10:53,-5,18,23
19,BUD,P002740,P011935,0 days 00:10:45,-3,19,22
19,BUD,P006561,P012605,0 days 00:10:13,-6,18,24
19,BUD,P006561,P010432,0 days 00:09:57,-1,18,19
19,BUD,P010248,P012606,0 days 00:09:04,-3,16,19
19,BUD,P002740,P010248,0 days 00:09:04,-3,16,19
19,BUD,P010432,P012605,0 days 00:08:24,-3,17,20
19,BUD,P004945,P006561,0 days 00:07:57,4,15,11
19,BUD,P006561,P012606,0 days 00:07:31,8,16,8
19,BUD,P006561,P010248,0 days 00:06:38,4,13,9
19,BUD,P011935,P012630,0 days 00:06:32,4,15,11
19,BUD,P004945,P012630,0 days 00:06:30,5,15,10
19,BUD,P012606,P012630,0 days 00:06:22,7,16,9
19,BUD,P002740,P010432,0 days 00:06:12,0,13,13
19,BUD,P010248,P012605,0 days 00:06:04,2,11,9
19,BUD,P007398,P010248,0 days 00:06:04,2,11,9
19,BUD,P009214,P012606,0 days 00:05:08,-1,11,12
19,BUD,P004945,P009214,0 days 00:05:08,-1,11,12
19,BUD,P002740,P009214,0 days 00:05:04,-2,8,10
19,BUD,P010248,P011935,0 days 00:05:02,-5,6,11
19,BUD,P004945,P007398,0 days 00:04:38,-5,6,11
19,BUD,P011935,P012605,0 days 00:04:15,5,10,5
19,BUD,P010248,P012630,0 days 00:04:15,4,9,5
19,BUD,P007398,P012606,0 days 00:04:12,-1,7,8
19,BUD,P007398,P011935,0 days 00:03:44,0,9,9
19,BUD,P009214,P010248,0 days 00:03:28,0,8,8
19,BUD,P004945,P012605,0 days 00:03:20,-2,4,6
19,BUD,P002740,P006561,0 days 00:02:08,-2,2,4
19,BUD,P006561,P009214,0 days 00:01:09,-1,3,4
19,BUD,P009214,P012630,0 days 00:00:35,1,3,2
19,BUD,P002740,P012630,0 days 00:00:31,0,0,0
20,WRO,P001694,P005531,0 days 00:30:10,-7,53,60
20,WRO,P005531,P009896,0 days 00:26:44,0,48,48
20,WRO,P001694,P009896,0 days 00:26:12,-2,46,48
20,WRO,P001694,P012699,0 days 00:24:01,-3,39,42
20,WRO,P005531,P012699,0 days 00:20:33,-1,37,38
20,WRO,P009896,P012699,0 days 00:20:14,5,37,32
20,WRO,P001694,P012735,0 days 00:19:53,10,43,33
20,WRO,P009896,P012735,0 days 00:19:05,14,38,24
20,WRO,P005531,P012735,0 days 00:18:36,12,41,29
20,WRO,P001694,P011900,0 days 00:17:35,-11,27,38
20,WRO,P012699,P012735,0 days 00:16:27,14,36,22
20,WRO,P009896,P011900,0 days 00:12:40,-6,20,26
20,WRO,P005531,P011900,0 days 00:12:18,-9,21,30
20,WRO,P003034,P012699,0 days 00:10:17,-2,12,14
20,WRO,P003034,P012736,0 days 00:09:37,0,12,12
20,WRO,P001694,P003034,0 days 00:09:15,-7,13,20
20,WRO,P001694,P012736,0 days 00:09:09,-8,10,18
20,WRO,P011900,P012736,0 days 00:09:01,-3,12,15
20,WRO,P009896,P012736,0 days 00:08:06,2,12,10
20,WRO,P012699,P012736,0 days 00:07:31,4,10,6
20,WRO,P011900,P012699,0 days 00:07:19,-8,7,15
20,WRO,P003034,P011900,0 days 00:06:59,-1,11,12
20,WRO,P003034,P012735,0 days 00:06:10,0,13,13
20,WRO,P005531,P012749,0 days 00:06:05,-6,7,13
20,WRO,P009896,P012749,0 days 00:05:58,-1,9,10
20,WRO,P001694,P012749,0 days 00:05:33,-8,5,13
20,WRO,P012735,P012736,0 days 00:05:08,-3,6,9
20,WRO,P011900,P012735,0 days 00:04:57,1,11,10
20,WRO,P005531,P012736,0 days 00:04:24,-4,6,10
20,WRO,P003034,P009896,0 days 00:04:01,4,6,2
20,WRO,P003034,P005531,0 days 00:03:58,-5,7,12
20,WRO,P012699,P012749,0 days 00:03:46,-5,2,7
20,WRO,P011900,P012749,0 days 00:03:39,1,7,6
20,WRO,P003034,P012749,0 days 00:02:47,-1,2,3
20,WRO,P012736,P012749,0 days 00:01:52,4,4,0
20,CLU,P004862,P012621,0 days 00:25:44,6,51,45
20,CLU,P004862,P011797,0 days 00:21:37,5,44,39
20,CLU,P011797,P012621,0 days 00:21:37,5,44,39
20,CLU,P005113,P012621,0 days 00:20:10,12,47,35
20,CLU,P004862,P005113,0 days 00:18:32,11,41,30
20,CLU,P005113,P011797,0 days 00:18:14,10,38,28
20,CLU,P004862,P010569,0 days 00:16:44,4,34,30
20,CLU,P005714,P012698,0 days 00:16:14,-3,21,24
20,CLU,P010569,P011797,0 days 00:15:37,-1,29,30
20,CLU,P010569,P012621,0 days 00:15:30,4,34,30
20,CLU,P004862,P012698,0 days 00:13:23,3,22,19
20,CLU,P005113,P010569,0 days 00:13:13,4,29,25
20,CLU,P011801,P012698,0 days 00:12:41,-3,17,20
20,CLU,P004862,P005714,0 days 00:12:41,4,22,18
20,CLU,P005113,P012698,0 days 00:11:29,6,23,17
20,CLU,P004862,P005373,0 days 00:11:18,-3,17,20
20,CLU,P005714,P011801,0 days 00:11:12,-1,15,16
20,CLU,P012621,P012698,0 days 00:09:52,2,19,17
20,CLU,P005373,P005714,0 days 00:09:28,1,12,11
20,CLU,P005714,P012621,0 days 00:08:49,3,17,14
20,CLU,P005373,P012621,0 days 00:07:44,-5,10,15
20,CLU,P011797,P012698,0 days 00:07:34,0,10,10
20,CLU,P005373,P011797,0 days 00:07:22,-5,10,15
20,CLU,P005373,P012698,0 days 00:07:16,-4,7,11
20,CLU,P005113,P005714,0 days 00:07:06,4,16,12
20,CLU,P005714,P011797,0 days 00:06:24,6,13,7
20,CLU,P005373,P011801,0 days 00:06:11,0,7,7
20,CLU,P010569,P012698,0 days 00:05:22,-3,7,10
20,CLU,P005113,P011801,0 days 00:04:52,1,10,9
20,CLU,P004862,P011801,0 days 00:04:06,2,7,5
20,CLU,P012620,P012698,0 days 00:04:01,-6,2,8
20,CLU,P005714,P012620,0 days 00:04:01,-6,2,8
20,CLU,P011797,P011801,0 days 00:03:59,0,4,4
20,CLU,P005373,P010569,0 days 00:03:25,-2,5,7
20,CLU,P010569,P012620,0 days 00:03:13,-4,2,6
20,CLU,P005714,P010569,0 days 00:03:13,-4,2,6
20,CLU,P010569,P011801,0 days 00:03:07,-6,2,8
20,CLU,P011801,P012620,0 days 00:02:26,-6,0,6
20,CLU,P011801,P012621,0 days 00:02:10,1,6,5
20,CLU,P004862,P012620,0 days 00:01:35,0,2,2
20,CLU,P005373,P012620,0 days 00:00:48,-2,0,2
21,PMT,P011066,P011823,0 days 00:19:35,0,48,48
21,PMT,P011066,P011944,0 days 00:18:17,0,45,45
21,PMT,P009559,P011066,0 days 00:17:33,-11,40,51
21,PMT,P011823,P011944,0 days 00:16:43,5,40,35
21,PMT,P002644,P011966,0 days 00:15:43,-9,31,40
21,PMT,P011823,P011943,0 days 00:15:17,4,33,29
21,PMT,P011066,P011943,0 days 00:14:45,-7,32,39
21,PMT,P002644,P012600,0 days 00:13:56,7,37,30
21,PMT,P009559,P011823,0 days 00:13:46,3,34,31
21,PMT,P002644,P011944,0 days 00:13:26,0,30,30
21,PMT,P001686,P012600,0 days 00:13:22,7,32,25
21,PMT,P011943,P011944,0 days 00:13:19,4,29,25
21,PMT,P002644,P011066,0 days 00:13:18,-11,29,40
21,PMT,P011066,P012600,0 days 00:12:49,2,32,30
21,PMT,P009559,P011943,0 days 00:12:01,-3,29,32
21,PMT,P002644,P011943,0 days 00:11:30,-17,16,33
21,PMT,P001686,P002644,0 days 00:11:24,1,23,22
21,PMT,P001686,P011066,0 days 00:10:19,-6,21,27
21,PMT,P011943,P011966,0 days 00:09:38,-12,14,26
21,PMT,P009559,P011944,0 days 00:09:35,-1,23,24
21,PMT,P002644,P011823,0 days 00:09:02,3,20,17
21,PMT,P011944,P012600,0 days 00:08:41,5,23,18
21,PMT,P011823,P012600,0 days 00:08:38,-2,22,24
21,PMT,P001686,P011966,0 days 00:06:54,4,15,11
21,PMT,P011966,P012600,0 days 00:06:31,4,18,14
21,PMT,P001686,P009559,0 days 00:06:16,-6,13,19
21,PMT,P001686,P011823,0 days 00:05:49,-3,13,16
21,PMT,P009559,P012600,0 days 00:05:45,-5,11,16
21,PMT,P011823,P011966,0 days 00:05:43,2,9,7
21,PMT,P002020,P002644,0 days 00:05:41,0,14,14
21,PMT,P002020,P011966,0 days 00:05:02,2,14,12
21,PMT,P002020,P012600,0 days 00:05:02,2,14,12
21,PMT,P001686,P002020,0 days 00:04:57,4,13,9
21,PMT,P011944,P011966,0 days 00:04:55,-3,9,12
21,PMT,P002644,P009559,0 days 00:04:12,-16,6,22
21,PMT,P011066,P011966,0 days 00:03:54,-9,8,17
21,PMT,P001686,P011943,0 days 00:03:51,-9,4,13
21,PMT,P001686,P011944,0 days 00:03:44,2,8,6
21,PMT,P009559,P011966,0 days 00:02:44,-13,4,17
21,PMT,P002020,P011943,0 days 00:02:17,-10,2,12
21,PMT,P001686,P011946,0 days 00:02:16,-2,2,4
21,PMT,P002644,P011946,0 days 00:02:16,-2,2,4
21,PMT,P011946,P011966,0 days 00:02:16,-2,2,4
21,PMT,P002020,P011066,0 days 00:01:46,-6,1,7
21,PMT,P002020,P011944,0 days 00:01:20,-4,1,5
21,PMT,P011943,P011946,0 days 00:01:17,-4,0,4
21,PMT,P002020,P011823,0 days 00:01:07,-4,1,5
21,PMT,P011946,P012600,0 days 00:00:59,2,2,0
21,PMT,P011943,P012600,0 days 00:00:49,-6,1,7
21,LLI,P009649,P012586,0 days 00:29:26,26,85,59
21,LLI,P012585,P012586,0 days 00:29:16,23,81,58
21,LLI,P006600,P012586,0 days 00:29:01,13,74,61
21,LLI,P009649,P012585,0 days 00:27:57,22,78,56
21,LLI,P006600,P012585,0 days 00:26:37,17,71,54
21,LLI,P006600,P009649,0 days 00:25:38,19,71,52
21,LLI,P009672,P012586,0 days 00:19:19,2,48,46
21,LLI,P009649,P009672,0 days 00:16:55,6,45,39
21,LLI,P006600,P009672,0 days 00:16:51,-5,36,41
21,LLI,P006600,P009680,0 days 00:15:53,16,42,26
21,LLI,P009672,P012585,0 days 00:15:26,2,38,36
21,LLI,P009680,P012585,0 days 00:13:50,21,43,22
21,LLI,P009680,P012586,0 days 00:13:50,21,43,22
21,LLI,P009649,P009680,0 days 00:12:31,20,40,20
21,LLI,P004773,P005247,0 days 00:09:15,-15,11,26
21,LLI,P005247,P009680,0 days 00:08:10,-10,11,21
21,LLI,P004773,P009680,0 days 00:06:51,-11,8,19
21,LLI,P004773,P009672,0 days 00:06:37,-2,14,16
21,LLI,P005247,P006600,0 days 00:05:46,-8,5,13
21,LLI,P004479,P005247,0 days 00:05:31,-11,6,17
21,LLI,P004479,P004773,0 days 00:05:31,-11,6,17
21,LLI,P004479,P009680,0 days 00:05:31,-11,6,17
21,LLI,P005247,P009672,0 days 00:05:08,-6,7,13
21,LLI,P004773,P006600,0 days 00:04:47,-6,5,11
21,LLI,P004773,P012020,0 days 00:04:33,-3,11,14
21,LLI,P012020,P012586,0 days 00:04:08,10,17,7
21,LLI,P004773,P012586,0 days 00:03:53,0,10,10
21,LLI,P009649,P012020,0 days 00:03:48,7,14,7
21,LLI,P009672,P012020,0 days 00:03:48,7,14,7
21,LLI,P005247,P012586,0 days 00:03:43,-3,6,9
21,LLI,P005247,P012020,0 days 00:03:24,-4,7,11
21,LLI,P009680,P012020,0 days 00:03:24,-4,7,11
21,LLI,P004479,P012020,0 days 00:03:04,-7,4,11
21,LLI,P009672,P009680,0 days 00:02:44,-2,4,6
21,LLI,P012020,P012585,0 days 00:02:39,6,10,4
21,LLI,P004773,P009649,0 days 00:01:29,4,7,3
21,LLI,P004479,P009672,0 days 00:01:24,-2,2,4
21,LLI,P005247,P012585,0 days 00:01:19,1,3,2
21,LLI,P004479,P006600,0 days 00:01:03,-2,0,2
22,HAM,P011187,P012580,0 days 00:21:59,-22,32,54
22,HAM,P011187,P012582,0 days 00:20:00,-2,41,43
22,HAM,P012580,P012582,0 days 00:17:16,-7,27,34
22,HAM,P011168,P012580,0 days 00:16:57,-9,29,38
22,HAM,P011168,P011187,0 days 00:15:49,-3,34,37
22,HAM,P011168,P012582,0 days 00:13:23,5,34,29
22,HAM,P011187,P012648,0 days 00:12:51,-2,28,30
22,HAM,P012580,P012648,0 days 00:12:15,-9,20,29
22,HAM,P011187,P012579,0 days 00:12:14,-2,28,30
22,HAM,P011168,P012579,0 days 00:11:52,-16,23,39
22,HAM,P009663,P012580,0 days 00:11:22,-25,9,34
22,HAM,P009663,P012648,0 days 00:10:38,-5,22,27
22,HAM,P012578,P012579,0 days 00:10:18,-9,20,29
22,HAM,P009663,P011187,0 days 00:09:49,-13,15,28
22,HAM,P011187,P012581,0 days 00:09:42,-5,13,18
22,HAM,P009663,P012579,0 days 00:09:39,-10,21,31
22,HAM,P012580,P012581,0 days 00:09:27,-9,12,21
22,HAM,P011168,P012648,0 days 00:09:15,-1,22,23
22,HAM,P009663,P010070,0 days 00:09:11,-20,11,31
22,HAM,P012581,P012582,0 days 00:09:00,-4,12,16
22,HAM,P012582,P012648,0 days 00:08:47,1,21,20
22,HAM,P011168,P012578,0 days 00:08:15,-17,11,28
22,HAM,P009663,P011168,0 days 00:08:11,-18,14,32
22,HAM,P009663,P012578,0 days 00:07:50,-7,16,23
22,HAM,P010070,P011168,0 days 00:07:43,-8,17,25
22,HAM,P011187,P012578,0 days 00:07:28,-6,11,17
22,HAM,P010070,P012579,0 days 00:07:09,-13,14,27
22,HAM,P009663,P012582,0 days 00:06:53,-15,7,22
22,HAM,P010070,P011187,0 days 00:06:22,-8,12,20
22,HAM,P012579,P012582,0 days 00:05:55,-2,17,19
22,HAM,P001990,P012581,0 days 00:05:53,-8,4,12
22,HAM,P012578,P012580,0 days 00:05:49,-14,5,19
22,HAM,P001990,P012580,0 days 00:05:46,-10,6,16
22,HAM,P010070,P012580,0 days 00:05:40,-9,6,15
22,HAM,P012579,P012580,0 days 00:05:25,-10,6,16
22,HAM,P001990,P012582,0 days 00:05:16,-8,4,12
22,HAM,P001990,P011187,0 days 00:04:42,-5,6,11
22,HAM,P010070,P012582,0 days 00:04:34,-8,9,17
22,HAM,P011168,P012581,0 days 00:04:11,-1,8,9
22,HAM,P012579,P012648,0 days 00:04:09,5,16,11
22,HAM,P012578,P012648,0 days 00:03:58,-3,9,12
22,HAM,P010070,P012648,0 days 00:03:35,-2,6,8
22,HAM,P009663,P012581,0 days 00:03:06,-10,1,11
22,HAM,P010070,P012578,0 days 00:02:18,-4,5,9
22,HAM,P012578,P012581,0 days 00:02:17,-2,1,3
22,HAM,P012579,P012581,0 days 00:01:56,-1,1,2
22,HAM,P001990,P009663,0 days 00:01:41,-5,0,5
22,HAM,P001990,P012578,0 days 00:01:07,-2,2,4
22,HAM,P001990,P012579,0 days 00:01:07,-2,2,4
22,PRS,P012610,P012613,0 days 00:22:37,34,65,31
22,PRS,P012608,P012610,0 days 00:21:41,34,62,28
22,PRS,P012608,P012613,0 days 00:21:41,34,62,28
22,PRS,P009556,P012640,0 days 00:17:08,0,41,41
22,PRS,P012608,P012611,0 days 00:16:42,28,44,16
22,PRS,P012610,P012611,0 days 00:16:42,28,44,16
22,PRS,P012611,P012613,0 days 00:16:42,28,44,16
22,PRS,P004512,P012608,0 days 00:16:27,29,46,17
22,PRS,P004512,P012613,0 days 00:16:27,29,46,17
22,PRS,P004512,P012610,0 days 00:16:27,29,46,17
22,PRS,P012609,P012640,0 days 00:15:45,-5,36,41
22,PRS,P005793,P009556,0 days 00:15:41,-3,35,38
22,PRS,P004512,P012611,0 days 00:15:01,22,36,14
22,PRS,P005793,P012640,0 days 00:14:53,-3,35,38
22,PRS,P009556,P012609,0 days 00:13:48,0,32,32
22,PRS,P005793,P012609,0 days 00:13:48,0,32,32
22,PRS,P003481,P012609,0 days 00:13:21,0,32,32
22,PRS,P003481,P009556,0 days 00:13:19,0,32,32
22,PRS,P003481,P005793,0 days 00:13:19,0,32,32
22,PRS,P003481,P012640,0 days 00:12:37,-2,30,32
22,PRS,P009556,P010801,0 days 00:04:46,4,10,6
22,PRS,P012608,P012609,0 days 00:04:36,4,16,12
22,PRS,P012609,P012610,0 days 00:04:36,4,16,12
22,PRS,P012609,P012613,0 days 00:04:36,4,16,12
22,PRS,P012613,P012640,0 days 00:04:27,-1,11,12
22,PRS,P012610,P012640,0 days 00:04:27,-1,11,12
22,PRS,P009556,P012612,0 days 00:04:04,2,8,6
22,PRS,P010801,P012612,0 days 00:04:04,2,8,6
22,PRS,P010801,P012640,0 days 00:03:35,2,8,6
22,PRS,P012612,P012640,0 days 00:03:35,2,8,6
22,PRS,P012608,P012640,0 days 00:03:31,-1,8,9
22,PRS,P009556,P012611,0 days 00:02:38,5,8,3
22,PRS,P010801,P012611,0 days 00:02:38,5,8,3
22,PRS,P012611,P012612,0 days 00:02:38,5,8,3
22,PRS,P012611,P012640,0 days 00:02:38,5,8,3
22,PRS,P005793,P010801,0 days 00:02:08,-1,2,3
22,PRS,P003481,P012608,0 days 00:01:43,6,8,2
22,PRS,P003481,P012610,0 days 00:01:43,6,8,2
22,PRS,P003481,P012613,0 days 00:01:43,6,8,2
22,PRS,P003481,P012611,0 days 00:01:41,6,8,2
22,PRS,P004512,P012609,0 days 00:01:26,7,10,3
22,PRS,P005793,P012612,0 days 00:01:26,-3,0,3
22,PRS,P005793,P012610,0 days 00:01:19,2,5,3
22,PRS,P005793,P012613,0 days 00:01:19,2,5,3
22,PRS,P010801,P012609,0 days 00:01:11,2,2,0
22,PRS,P009556,P012610,0 days 00:00:56,0,3,3
22,PRS,P009556,P012613,0 days 00:00:56,0,3,3
22,PRS,P003481,P010801,0 days 00:00:42,2,2,0
22,PRS,P012609,P012612,0 days 00:00:29,0,0,0
22,PRS,P005793,P012608,0 days 00:00:23,2,2,0
23,VNC,P004381,P011928,0 days 00:21:21,-19,37,56
23,VNC,P004381,P012591,0 days 00:20:32,-14,41,55
23,VNC,P011928,P012591,0 days 00:20:24,-14,37,51
23,VNC,P003759,P012590,0 days 00:20:18,-2,45,47
23,VNC,P008052,P012591,0 days 00:18:02,-14,36,50
23,VNC,P004381,P011909,0 days 00:17:38,-11,29,40
23,VNC,P003759,P012591,0 days 00:17:02,-2,39,41
23,VNC,P011909,P012591,0 days 00:17:01,-8,29,37
23,VNC,P003759,P004381,0 days 00:16:49,-2,37,39
23,VNC,P011909,P011928,0 days 00:15:59,-14,23,37
23,VNC,P004381,P012590,0 days 00:15:38,-9,34,43
23,VNC,P003759,P011909,0 days 00:15:15,-2,29,31
23,VNC,P008052,P011928,0 days 00:12:58,-15,20,35
23,VNC,P012590,P012591,0 days 00:12:50,-10,27,37
23,VNC,P003759,P011928,0 days 00:12:06,-4,24,28
23,VNC,P004381,P008052,0 days 00:11:22,-15,20,35
23,VNC,P011928,P012590,0 days 00:10:59,-11,21,32
23,VNC,P008052,P011909,0 days 00:10:41,-8,18,26
23,VNC,P000968,P008052,0 days 00:09:00,4,24,20
23,VNC,P011909,P012590,0 days 00:08:31,-3,13,16
23,VNC,P000968,P003759,0 days 00:07:29,5,22,17
23,VNC,P003759,P008052,0 days 00:07:24,4,24,20
23,VNC,P008052,P012590,0 days 00:06:59,-4,19,23
23,VNC,P009400,P012590,0 days 00:06:54,0,15,15
23,VNC,P000968,P009400,0 days 00:06:52,5,20,15
23,VNC,P003759,P009400,0 days 00:06:50,0,15,15
23,VNC,P000968,P012591,0 days 00:06:40,1,16,15
23,VNC,P009400,P012591,0 days 00:05:26,-3,9,12
23,VNC,P008052,P009400,0 days 00:05:02,4,15,11
23,VNC,P004117,P012590,0 days 00:04:55,-1,9,10
23,VNC,P003759,P004117,0 days 00:04:55,-1,9,10
23,VNC,P000968,P012590,0 days 00:04:32,4,13,9
23,VNC,P000968,P011909,0 days 00:04:20,0,9,9
23,VNC,P000968,P011928,0 days 00:03:43,0,7,7
23,VNC,P004117,P009400,0 days 00:03:37,-3,7,10
23,VNC,P009400,P011928,0 days 00:02:46,1,7,6
23,VNC,P000968,P004117,0 days 00:02:12,1,5,4
23,VNC,P004117,P012591,0 days 00:01:47,-4,2,6
23,VNC,P004117,P011909,0 days 00:01:18,2,2,0
23,VNC,P009400,P011909,0 days 00:00:57,0,0,0
23,VNC,P004117,P004381,0 days 00:00:56,2,2,0
23,HTA,P007759,P010465,0 days 00:25:46,9,60,51
23,HTA,P010465,P010550,0 days 00:20:45,8,48,40
23,HTA,P010465,P011973,0 days 00:20:24,11,46,35
23,HTA,P007759,P011973,0 days 00:19:00,9,44,35
23,HTA,P004846,P007759,0 days 00:18:24,14,51,37
23,HTA,P007759,P010550,0 days 00:18:09,2,43,41
23,HTA,P006835,P007759,0 days 00:17:40,18,51,33
23,HTA,P006835,P010465,0 days 00:16:30,15,41,26
23,HTA,P010465,P011991,0 days 00:15:53,4,28,24
23,HTA,P004846,P010465,0 days 00:15:26,5,38,33
23,HTA,P010550,P011991,0 days 00:15:07,-6,29,35
23,HTA,P004846,P006835,0 days 00:14:48,15,42,27
23,HTA,P010550,P011973,0 days 00:13:08,-1,28,29
23,HTA,P007759,P011991,0 days 00:12:10,-2,23,25
23,HTA,P011973,P011991,0 days 00:12:05,3,21,18
23,HTA,P004846,P010550,0 days 00:11:33,3,31,28
23,HTA,P003533,P004846,0 days 00:10:30,-1,27,28
23,HTA,P004267,P011991,0 days 00:10:18,-6,20,26
23,HTA,P004267,P006835,0 days 00:10:14,16,36,20
23,HTA,P006835,P011991,0 days 00:09:14,-1,19,20
23,HTA,P003533,P004267,0 days 00:09:03,5,24,19
23,HTA,P003533,P006835,0 days 00:08:11,3,23,20
23,HTA,P004846,P011973,0 days 00:08:09,3,20,17
23,HTA,P004267,P010550,0 days 00:07:49,-4,17,21
23,HTA,P004267,P004846,0 days 00:07:37,7,24,17
23,HTA,P006835,P010550,0 days 00:07:23,6,22,16
23,HTA,P006835,P011973,0 days 00:07:20,12,18,6
23,HTA,P003533,P007759,0 days 00:06:43,5,20,15
23,HTA,P004267,P010465,0 days 00:05:45,10,16,6
23,HTA,P003533,P011991,0 days 00:05:28,-6,9,15
23,HTA,P003533,P010465,0 days 00:05:11,-6,7,13
23,HTA,P004267,P007759,0 days 00:05:04,13,24,11
23,HTA,P003533,P010550,0 days 00:04:02,-4,6,10
23,HTA,P004846,P011991,0 days 00:03:41,-6,7,13
23,HTA,P004267,P011973,0 days 00:01:30,7,7,0
24,JOV,P002361,P010458,0 days 00:26:02,17,62,45
24,JOV,P010161,P010458,0 days 00:22:19,8,55,47
24,JOV,P002361,P010161,0 days 00:22:06,8,48,40
24,JOV,P002361,P002507,0 days 00:21:58,-7,40,47
24,JOV,P002507,P010458,0 days 00:20:31,1,45,44
24,JOV,P002507,P010161,0 days 00:20:02,-4,42,46
24,JOV,P006771,P010458,0 days 00:18:23,-3,40,43
24,JOV,P002507,P005094,0 days 00:18:08,5,42,37
24,JOV,P002361,P005094,0 days 00:17:38,15,42,27
24,JOV,P005094,P010458,0 days 00:17:28,27,50,23
24,JOV,P006771,PJUG,0 days 00:17:03,1,43,42
24,JOV,P005094,P010161,0 days 00:16:40,22,46,24
24,JOV,P010458,PJUG,0 days 00:15:17,7,38,31
24,JOV,P010458,P012076,0 days 00:14:03,16,39,23
24,JOV,P002361,P006771,0 days 00:12:25,-6,21,27
24,JOV,P006771,P012076,0 days 00:12:14,2,27,25
24,JOV,P002507,P006771,0 days 00:11:32,-12,25,37
24,JOV,P002361,P012076,0 days 00:11:18,19,32,13
24,JOV,P012076,PJUG,0 days 00:10:57,5,27,22
24,JOV,P002361,PJUG,0 days 00:10:10,12,26,14
24,JOV,P006771,P010161,0 days 00:09:23,-9,24,33
24,JOV,P005094,P006771,0 days 00:09:16,-3,22,25
24,JOV,P010161,P012076,0 days 00:08:25,9,24,15
24,JOV,P002507,PJUG,0 days 00:08:22,1,23,22
24,JOV,P010161,P010709,0 days 00:08:21,-6,16,22
24,JOV,P002507,P010709,0 days 00:07:58,-7,12,19
24,JOV,P002361,P010709,0 days 00:07:58,-7,12,19
24,JOV,P005094,P012076,0 days 00:06:51,13,22,9
24,JOV,P005094,PJUG,0 days 00:06:33,4,20,16
24,JOV,P006771,P010166,0 days 00:05:34,-8,14,22
24,JOV,P010161,PJUG,0 days 00:05:07,-3,13,16
24,JOV,P010458,P010709,0 days 00:04:13,-5,7,12
24,JOV,P010166,PJUG,0 days 00:03:53,-3,10,13
24,JOV,P005094,P010709,0 days 00:03:45,-2,5,7
24,JOV,P002507,P010166,0 days 00:03:37,-9,7,16
24,JOV,P005094,P010166,0 days 00:03:37,-9,7,16
24,JOV,P002361,P010166,0 days 00:03:29,-3,5,8
24,JOV,P010161,P010166,0 days 00:02:34,-2,8,10
24,JOV,P010166,P012076,0 days 00:02:32,0,5,5
24,JOV,P006771,P010708,0 days 00:00:23,1,4,3
24,JOV,P006771,P010709,0 days 00:00:23,1,4,3
24,JOV,P010161,P010708,0 days 00:00:23,1,4,3
24,JOV,P010708,P010709,0 days 00:00:23,1,4,3
24,JOV,P010166,P010708,0 days 00:00:20,1,4,3
24,JOV,P010166,P010709,0 days 00:00:20,1,4,3
24,JOV,P010708,PJUG,0 days 00:00:03,0,0,0
24,JOV,P010709,PJUG,0 days 00:00:03,0,0,0
24,WOL,P002387,P005516,0 days 00:23:58,13,56,43
24,WOL,P002387,P012576,0 days 00:23:57,16,60,44
24,WOL,P012576,P012577,0 days 00:23:56,0,52,52
24,WOL,P011150,P012577,0 days 00:23:32,-17,48,65
24,WOL,P005516,P011150,0 days 00:21:32,6,55,49
24,WOL,P005516,P012576,0 days 00:21:30,18,54,36
24,WOL,P011150,P012576,0 days 00:20:56,8,53,45
24,WOL,P002387,P011150,0 days 00:20:44,10,51,41
24,WOL,P002387,P012577,0 days 00:20:01,4,45,41
24,WOL,P005516,P012577,0 days 00:18:54,0,43,43
24,WOL,P003212,P011150,0 days 00:17:32,-11,41,52
24,WOL,P002387,P003212,0 days 00:16:55,-2,37,39
24,WOL,P003212,P012577,0 days 00:16:20,-14,34,48
24,WOL,P003212,P012576,0 days 00:15:43,1,36,35
24,WOL,P004645,P011150,0 days 00:15:27,-10,37,47
24,WOL,P003212,P004645,0 days 00:13:36,-15,25,40
24,WOL,P002333,P011150,0 days 00:13:11,-10,25,35
24,WOL,P003212,P005516,0 days 00:12:20,-2,28,30
24,WOL,P002333,P003212,0 days 00:10:51,-11,19,30
24,WOL,P004645,P012576,0 days 00:10:14,-1,21,22
24,WOL,P004645,P005516,0 days 00:10:01,-10,19,29
24,WOL,P004645,P012577,0 days 00:09:43,-19,16,35
24,WOL,P002333,P004645,0 days 00:09:33,-12,17,29
24,WOL,P002333,P005516,0 days 00:08:30,-13,11,24
24,WOL,P004645,P006154,0 days 00:06:51,2,18,16
24,WOL,P002333,P002387,0 days 00:06:08,-8,8,16
24,WOL,P002333,P006154,0 days 00:05:50,2,14,12
24,WOL,P002333,P012577,0 days 00:05:25,-12,6,18
24,WOL,P002387,P004645,0 days 00:05:15,1,11,10
24,WOL,P006154,P011150,0 days 00:05:06,4,14,10
24,WOL,P005516,P006154,0 days 00:04:47,-4,6,10
24,WOL,P003212,P006154,0 days 00:04:31,2,12,10
24,WOL,P002387,P006154,0 days 00:03:22,-2,4,6
24,WOL,P006154,P012576,0 days 00:02:44,-2,4,6
24,WOL,P006154,P012577,0 days 00:01:05,-2,0,2
25,BES,P008945,P012622,0 days 00:21:16,7,34,27
25,BES,P008945,P011936,0 days 00:20:55,10,36,26
25,BES,P011936,P012622,0 days 00:20:09,13,36,23
25,BES,P008945,P012647,0 days 00:18:18,-1,25,26
25,BES,P011936,P012647,0 days 00:17:48,-3,24,27
25,BES,P003783,P011936,0 days 00:17:08,1,36,35
25,BES,P007917,P011936,0 days 00:15:58,6,28,22
25,BES,P012622,P012647,0 days 00:15:27,1,19,18
25,BES,P007917,P012622,0 days 00:13:54,12,28,16
25,BES,P007914,P011936,0 days 00:13:32,0,24,24
25,BES,P007914,P012647,0 days 00:12:55,-4,17,21
25,BES,P007914,P009582,0 days 00:12:53,-4,27,31
25,BES,P009582,P011936,0 days 00:11:45,-3,26,29
25,BES,P007917,P008945,0 days 00:10:46,11,22,11
25,BES,P003783,P009582,0 days 00:10:45,3,29,26
25,BES,P003783,P007914,0 days 00:10:26,-3,23,26
25,BES,P011379,P011936,0 days 00:10:26,11,25,14
25,BES,P007914,P012622,0 days 00:10:11,2,15,13
25,BES,P007917,P012647,0 days 00:10:08,2,13,11
25,BES,P007914,P008945,0 days 00:09:57,1,12,11
25,BES,P008945,P009582,0 days 00:09:36,-10,12,22
25,BES,P009582,P012647,0 days 00:09:26,-12,13,25
25,BES,P003783,P011379,0 days 00:08:09,10,21,11
25,BES,P003783,P012622,0 days 00:07:50,6,17,11
25,BES,P009582,P012622,0 days 00:07:40,-7,11,18
25,BES,P011379,P012622,0 days 00:06:57,6,16,10
25,BES,P003783,P012647,0 days 00:06:42,-7,9,16
25,BES,P003783,P007917,0 days 00:06:15,-3,8,11
25,BES,P011357,P011936,0 days 00:04:55,1,13,12
25,BES,P003783,P008945,0 days 00:04:54,2,10,8
25,BES,P008945,P011379,0 days 00:04:52,5,10,5
25,BES,P011357,P012622,0 days 00:04:36,4,12,8
25,BES,P009582,P011379,0 days 00:04:25,6,11,5
25,BES,P003783,P011357,0 days 00:04:15,-1,11,12
25,BES,P007914,P011357,0 days 00:04:15,-1,11,12
25,BES,P007914,P007917,0 days 00:04:10,-2,4,6
25,BES,P007917,P011379,0 days 00:03:42,3,10,7
25,BES,P009582,P011357,0 days 00:03:42,-1,11,12
25,BES,P007914,P011379,0 days 00:03:13,3,7,4
25,BES,P007917,P011357,0 days 00:03:11,3,7,4
25,BES,P008945,P011357,0 days 00:02:38,3,7,4
25,LJU,P012598,P012700,0 days 00:26:11,-4,51,55
25,LJU,P005969,P012598,0 days 00:25:46,-8,41,49
25,LJU,P008883,P012700,0 days 00:22:51,-5,44,49
25,LJU,P005969,P012700,0 days 00:21:17,-7,34,41
25,LJU,P008883,P012598,0 days 00:20:39,0,46,46
25,LJU,P007066,P012598,0 days 00:20:28,-8,30,38
25,LJU,P005969,P007066,0 days 00:18:46,-7,23,30
25,LJU,P010594,P012700,0 days 00:18:32,-2,30,32
25,LJU,P009395,P012700,0 days 00:17:48,3,36,33
25,LJU,P009395,P012598,0 days 00:17:09,-5,33,38
25,LJU,P007066,P012700,0 days 00:16:31,-5,23,28
25,LJU,P005969,P009395,0 days 00:15:27,-7,25,32
25,LJU,P010594,P012598,0 days 00:15:12,6,32,26
25,LJU,P008883,P010594,0 days 00:14:32,5,29,24
25,LJU,P005969,P008883,0 days 00:14:15,-5,27,32
25,LJU,P008883,P009395,0 days 00:13:13,-2,27,29
25,LJU,P007066,P008883,0 days 00:12:34,0,23,23
25,LJU,P007066,P010594,0 days 00:10:41,3,17,14
25,LJU,P003452,P007066,0 days 00:10:03,-11,7,18
25,LJU,P009395,P010594,0 days 00:09:39,1,19,18
25,LJU,P003452,P005969,0 days 00:09:33,-7,9,16
25,LJU,P003452,P009395,0 days 00:09:11,2,11,9
25,LJU,P005969,P010594,0 days 00:08:48,1,13,12
25,LJU,P003452,P012700,0 days 00:08:06,4,10,6
25,LJU,P003452,P012598,0 days 00:08:03,-9,7,16
25,LJU,P007066,P009395,0 days 00:05:45,-4,5,9
25,LJU,P003452,P008883,0 days 00:05:04,-1,4,5
25,LJU,P003452,P010594,0 days 00:03:56,2,4,2
26,BOU,P010431,P010449,0 days 00:19:59,1,48,47
26,BOU,P010449,P011836,0 days 00:19:11,12,52,40
26,BOU,P011161,P012628,0 days 00:18:51,7,43,36
26,BOU,P010449,P012628,0 days 00:16:45,3,43,40
26,BOU,P010431,P011836,0 days 00:15:10,4,39,35
26,BOU,P010449,P011837,0 days 00:15:05,12,40,28
26,BOU,P010449,P010718,0 days 00:14:59,1,38,37
26,BOU,P010450,P012628,0 days 00:14:43,-8,26,34
26,BOU,P004525,P012628,0 days 00:13:36,-2,27,29
26,BOU,P010450,P011161,0 days 00:13:14,-5,25,30
26,BOU,P010431,P010718,0 days 00:13:08,2,32,30
26,BOU,P000498,P012628,0 days 00:11:56,-8,20,28
26,BOU,P011836,P011837,0 days 00:11:41,7,29,22
26,BOU,P000498,P011161,0 days 00:11:01,-6,20,26
26,BOU,P010718,P011836,0 days 00:11:00,0,27,27
26,BOU,P000498,P010450,0 days 00:10:44,-9,17,26
26,BOU,P011836,P012628,0 days 00:10:32,3,28,25
26,BOU,P004525,P010450,0 days 00:10:05,-10,13,23
26,BOU,P004525,P011161,0 days 00:09:56,4,22,18
26,BOU,P010718,P011837,0 days 00:09:45,6,25,19
26,BOU,P010431,P011837,0 days 00:09:35,4,23,19
26,BOU,P010449,P011161,0 days 00:09:30,16,28,12
26,BOU,P011837,P012628,0 days 00:09:11,0,18,18
26,BOU,P010431,P012628,0 days 00:08:57,-8,22,30
26,BOU,P004525,P010449,0 days 00:08:00,2,18,16
26,BOU,P000498,P004525,0 days 00:07:40,-3,13,16
26,BOU,P011161,P011837,0 days 00:07:30,3,14,11
26,BOU,P010718,P012628,0 days 00:06:08,-7,14,21
26,BOU,P011161,P011836,0 days 00:05:43,16,20,4
26,BOU,P010449,P010450,0 days 00:05:27,0,11,11
26,BOU,P004525,P010431,0 days 00:05:25,-1,11,12
26,BOU,P004525,P010718,0 days 00:04:15,-2,8,10
26,BOU,P010450,P011837,0 days 00:04:07,1,8,7
26,BOU,P012628,P012755,0 days 00:04:05,0,11,11
26,BOU,P004525,P011836,0 days 00:03:43,8,12,4
26,BOU,P010431,P012755,0 days 00:03:03,1,7,6
26,BOU,P010449,P012755,0 days 00:03:03,1,7,6
26,BOU,P011836,P012755,0 days 00:03:03,1,7,6
26,BOU,P010431,P010450,0 days 00:02:57,-4,3,7
26,BOU,P011161,P012755,0 days 00:02:56,1,10,9
26,BOU,P000498,P011837,0 days 00:02:34,-5,3,8
26,BOU,P010450,P012755,0 days 00:01:59,0,7,7
26,BOU,P000498,P012755,0 days 00:01:59,0,7,7
26,BOU,P010431,P011161,0 days 00:01:42,5,7,2
26,BOU,P010718,P011161,0 days 00:01:41,-1,3,4
26,BOU,P000498,P011836,0 days 00:01:29,1,6,5
26,BOU,P010450,P010718,0 days 00:01:28,-1,2,3
26,BOU,P000498,P010718,0 days 00:01:12,-2,3,5
26,BOU,P000498,P010449,0 days 00:00:17,0,3,3
26,CLU,P010569,P011797,0 days 00:23:22,-4,55,59
26,CLU,P005113,P011797,0 days 00:19:51,-8,37,45
26,CLU,P011797,P011801,0 days 00:19:35,3,49,46
26,CLU,P004862,P011797,0 days 00:18:27,2,43,41
26,CLU,P010569,P011801,0 days 00:18:14,-2,45,47
26,CLU,P011797,P012621,0 days 00:17:42,-4,34,38
26,CLU,P011801,P012698,0 days 00:17:32,0,42,42
26,CLU,P004862,P010569,0 days 00:15:56,-5,38,43
26,CLU,P010569,P012621,0 days 00:15:17,-12,29,41
26,CLU,P004862,P005373,0 days 00:14:39,2,29,27
26,CLU,P004862,P011801,0 days 00:14:37,6,41,35
26,CLU,P005113,P010569,0 days 00:14:16,-11,28,39
26,CLU,P005373,P011801,0 days 00:13:50,-2,31,33
26,CLU,P011801,P012621,0 days 00:13:31,-2,32,34
26,CLU,P011797,P012698,0 days 00:13:31,1,29,28
26,CLU,P005113,P012621,0 days 00:13:10,-10,20,30
26,CLU,P004862,P012621,0 days 00:13:02,-3,23,26
26,CLU,P005373,P012621,0 days 00:12:35,6,28,22
26,CLU,P004862,P012698,0 days 00:11:51,0,27,27
26,CLU,P010569,P012698,0 days 00:10:23,-3,21,24
26,CLU,P005373,P011797,0 days 00:10:06,7,22,15
26,CLU,P004862,P005113,0 days 00:10:02,-4,19,23
26,CLU,P005113,P011801,0 days 00:09:46,-2,22,24
26,CLU,P005373,P012698,0 days 00:08:43,-1,20,21
26,CLU,P005113,P012698,0 days 00:07:49,-3,12,15
26,CLU,P005373,P010569,0 days 00:07:49,-2,17,19
26,CLU,P012620,P012698,0 days 00:06:26,2,17,15
26,CLU,P011801,P012620,0 days 00:05:35,-1,14,15
26,CLU,P005373,P012620,0 days 00:05:35,-1,14,15
26,CLU,P012621,P012698,0 days 00:05:01,0,12,12
26,CLU,P004862,P012620,0 days 00:03:50,-2,8,10
26,CLU,P005113,P005373,0 days 00:03:39,3,7,4
26,CLU,P012620,P012621,0 days 00:01:42,1,6,5
26,CLU,P011797,P012620,0 days 00:00:54,3,3,0
26,CLU,P005113,P012620,0 days 00:00:51,3,3,0
26,CLU,P010569,P012620,0 days 00:00:51,3,3,0
27,BUD,P010432,P011935,0 days 00:21:25,10,51,41
27,BUD,P004945,P012606,0 days 00:20:11,1,44,43
27,BUD,P002740,P004945,0 days 00:18:02,0,37,37
27,BUD,P002740,P012606,0 days 00:18:02,0,37,37
27,BUD,P004945,P010432,0 days 00:17:51,8,42,34
27,BUD,P004945,P011935,0 days 00:17:51,8,42,34
27,BUD,P010432,P012606,0 days 00:17:51,8,42,34
27,BUD,P011935,P012606,0 days 00:17:51,8,42,34
27,BUD,P002740,P011935,0 days 00:17:40,10,43,33
27,BUD,P007398,P012605,0 days 00:17:09,14,55,41
27,BUD,P002740,P010432,0 days 00:16:59,10,40,30
27,BUD,P009214,P012605,0 days 00:14:21,10,45,35
27,BUD,P006561,P009214,0 days 00:13:02,-3,37,40
27,BUD,P007398,P009214,0 days 00:12:54,12,43,31
27,BUD,P012605,P012630,0 days 00:11:44,6,35,29
27,BUD,P007398,P012630,0 days 00:11:30,9,35,26
27,BUD,P006561,P012605,0 days 00:11:23,4,38,34
27,BUD,P006561,P007398,0 days 00:11:09,7,38,31
27,BUD,P009214,P012630,0 days 00:09:27,7,31,24
27,BUD,P007398,P010432,0 days 00:09:22,9,26,17
27,BUD,P010432,P012605,0 days 00:07:13,8,19,11
27,BUD,P006561,P012630,0 days 00:07:01,2,23,21
27,BUD,P007398,P011935,0 days 00:06:24,3,19,16
27,BUD,P010432,P012630,0 days 00:05:56,5,14,9
27,BUD,P002740,P006561,0 days 00:05:53,-3,15,18
27,BUD,P002740,P009214,0 days 00:05:12,-3,12,15
27,BUD,P002740,P007398,0 days 00:04:50,7,18,11
27,BUD,P002740,P012605,0 days 00:04:50,7,18,11
27,BUD,P006561,P006566,0 days 00:04:42,-2,8,10
27,BUD,P011935,P012605,0 days 00:04:15,2,12,10
27,BUD,P009214,P010432,0 days 00:03:39,6,10,4
27,BUD,P006561,P012606,0 days 00:03:33,-6,4,10
27,BUD,P006566,P009214,0 days 00:03:29,-3,6,9
27,BUD,P006566,P012605,0 days 00:03:29,-3,6,9
27,BUD,P007398,P012606,0 days 00:03:22,2,9,7
27,BUD,P006566,P007398,0 days 00:03:15,0,6,6
27,BUD,P006566,P012630,0 days 00:02:40,-1,4,5
27,BUD,P009214,P012606,0 days 00:02:20,-7,2,9
27,BUD,P004945,P009214,0 days 00:02:20,-7,2,9
27,BUD,P004945,P006561,0 days 00:02:20,-7,2,9
27,BUD,P011935,P012630,0 days 00:02:17,-1,4,5
27,BUD,P004945,P007398,0 days 00:02:09,1,7,6
27,BUD,P006566,P012606,0 days 00:01:13,1,2,1
27,BUD,P012606,P012630,0 days 00:01:13,1,2,1
27,BUD,P006561,P011935,0 days 00:00:41,0,3,3
27,WRO,P001694,P005531,0 days 00:27:52,-13,59,72
27,WRO,P001694,P011165,0 days 00:17:36,-4,40,44
27,WRO,P005531,P011165,0 days 00:17:13,-4,40,44
27,WRO,P011165,P012699,0 days 00:17:11,5,50,45
27,WRO,P009896,P012699,0 days 00:16:28,-3,40,43
27,WRO,P001694,P009896,0 days 00:15:59,-10,35,45
27,WRO,P005531,P009896,0 days 00:15:46,-12,33,45
27,WRO,P001694,P012699,0 days 00:15:29,-2,39,41
27,WRO,P005531,P012699,0 days 00:14:53,-4,37,41
27,WRO,P001694,P003034,0 days 00:12:29,-1,26,27
27,WRO,P003034,P011165,0 days 00:12:28,-1,26,27
27,WRO,P003034,P005531,0 days 00:12:14,-1,26,27
27,WRO,P011900,P011902,0 days 00:11:32,-3,28,31
27,WRO,P009896,P011165,0 days 00:11:14,-5,30,35
27,WRO,P011165,P011900,0 days 00:10:51,-6,22,28
27,WRO,P009896,P011900,0 days 00:10:36,-7,20,27
27,WRO,P011900,P012699,0 days 00:10:28,6,26,20
27,WRO,P003034,P011900,0 days 00:10:06,-3,20,23
27,WRO,P001694,P011900,0 days 00:09:10,-7,12,19
27,WRO,P005531,P012749,0 days 00:08:44,-6,18,24
27,WRO,P005531,P011900,0 days 00:08:42,-9,10,19
27,WRO,P001694,P012749,0 days 00:08:36,-6,18,24
27,WRO,P003034,P012736,0 days 00:07:54,-12,12,24
27,WRO,P012736,P012749,0 days 00:07:54,-6,18,24
27,WRO,P011902,P012699,0 days 00:07:49,7,23,16
27,WRO,P003034,P012699,0 days 00:06:50,8,22,14
27,WRO,P009896,P012749,0 days 00:06:44,-4,14,18
27,WRO,P001694,P012736,0 days 00:06:41,-1,15,16
27,WRO,P005531,P012736,0 days 00:06:28,-3,13,16
27,WRO,P011900,P012749,0 days 00:06:21,-3,13,16
27,WRO,P011165,P011902,0 days 00:06:06,-2,16,18
27,WRO,P003034,P012749,0 days 00:06:04,-3,14,17
27,WRO,P003034,P011902,0 days 00:06:03,-3,14,17
27,WRO,P009896,P011902,0 days 00:05:29,0,14,14
27,WRO,P011900,P012736,0 days 00:05:02,-8,9,17
27,WRO,P011902,P012736,0 days 00:04:49,-10,7,17
27,WRO,P011902,P012749,0 days 00:04:12,-1,10,11
27,WRO,P009896,P012736,0 days 00:03:36,1,10,9
27,WRO,P012699,P012749,0 days 00:02:37,1,7,6
27,WRO,P011165,P012736,0 days 00:02:09,-7,0,7
27,WRO,P012699,P012736,0 days 00:01:27,2,4,2
27,WRO,P005531,P011902,0 days 00:00:08,0,0,0
28,ARI,P012615,P012716,0 days 00:24:34,6,45,39
28,ARI,P004292,P012615,0 days 00:23:40,3,46,43
28,ARI,P012615,P012708,0 days 00:20:19,6,41,35
28,ARI,P004292,P012716,0 days 00:18:21,-4,33,37
28,ARI,P012615,P012707,0 days 00:17:44,15,29,14
28,ARI,P012615,P012702,0 days 00:17:07,8,36,28
28,ARI,P012702,P012708,0 days 00:17:00,5,36,31
28,ARI,P004292,P012708,0 days 00:16:58,-4,34,38
28,ARI,P012707,P012716,0 days 00:14:26,8,22,14
28,ARI,P012708,P012716,0 days 00:14:24,0,27,27
28,ARI,P004292,P012702,0 days 00:14:00,-3,29,32
28,ARI,P012615,P012722,0 days 00:13:43,10,26,16
28,ARI,P012707,P012722,0 days 00:13:07,7,19,12
28,ARI,P004292,P012722,0 days 00:13:04,1,23,22
28,ARI,P012702,P012716,0 days 00:12:39,3,27,24
28,ARI,P002867,P004292,0 days 00:12:28,-6,21,27
28,ARI,P002867,P012615,0 days 00:11:53,12,25,13
28,ARI,P002867,P012708,0 days 00:11:23,-3,17,20
28,ARI,P012716,P012722,0 days 00:11:20,4,18,14
28,ARI,P002867,P012707,0 days 00:11:05,3,16,13
28,ARI,P004292,P012707,0 days 00:10:36,1,16,15
28,ARI,P002867,P012722,0 days 00:10:25,2,19,17
28,ARI,P012707,P012708,0 days 00:09:32,1,10,9
28,ARI,P002867,P012702,0 days 00:08:31,0,12,12
28,ARI,P012708,P012722,0 days 00:08:04,-8,8,16
28,ARI,P002867,P010387,0 days 00:07:45,-13,6,19
28,ARI,P012702,P012707,0 days 00:07:35,4,13,9
28,ARI,P010387,P012708,0 days 00:05:28,-9,3,12
28,ARI,P002867,P012716,0 days 00:05:02,1,8,7
28,ARI,P010387,P012722,0 days 00:04:57,-8,3,11
28,ARI,P004292,P010387,0 days 00:04:49,-8,6,14
28,ARI,P010387,P012707,0 days 00:04:23,-7,3,10
28,ARI,P010387,P012702,0 days 00:02:48,-5,3,8
28,ARI,P010387,P012716,0 days 00:00:50,-2,0,2
28,TTK,P011925,P012056,0 days 00:26:08,-6,45,51
28,TTK,P011239,P012056,0 days 00:23:38,1,47,46
28,TTK,P005000,P011925,0 days 00:23:30,-9,33,42
28,TTK,P005000,P006693,0 days 00:22:49,-2,38,40
28,TTK,P006693,P011925,0 days 00:22:30,-11,33,44
28,TTK,P006693,P012056,0 days 00:20:23,-5,35,40
28,TTK,P011239,P011925,0 days 00:19:30,1,40,39
28,TTK,P005000,P012056,0 days 00:18:59,-1,33,34
28,TTK,P011834,P012697,0 days 00:18:25,7,31,24
28,TTK,P011834,P011925,0 days 00:17:07,-3,26,29
28,TTK,P011834,P012056,0 days 00:16:35,4,30,26
28,TTK,P012056,P012697,0 days 00:15:48,3,26,23
28,TTK,P011925,P012697,0 days 00:15:39,-2,22,24
28,TTK,P006693,P011239,0 days 00:15:06,2,33,31
28,TTK,P005000,P011239,0 days 00:13:05,6,31,25
28,TTK,P011239,P011834,0 days 00:11:21,-5,18,23
28,TTK,P005000,P011834,0 days 00:09:16,-1,11,12
28,TTK,P005000,P012697,0 days 00:09:01,-4,7,11
28,TTK,P006693,P011834,0 days 00:08:49,-3,11,14
28,TTK,P011239,P012697,0 days 00:08:32,-1,14,15
28,TTK,P005685,P012697,0 days 00:06:34,5,12,7
28,TTK,P005685,P011834,0 days 00:06:26,3,12,9
28,TTK,P006693,P012697,0 days 00:06:00,-2,5,7
28,TTK,P000497,P012056,0 days 00:05:23,5,10,5
28,TTK,P005685,P011925,0 days 00:04:56,-2,7,9
28,TTK,P000497,P011834,0 days 00:04:41,2,7,5
28,TTK,P000497,P012697,0 days 00:04:41,2,7,5
28,TTK,P005685,P012056,0 days 00:04:10,7,10,3
28,TTK,P005000,P005685,0 days 00:03:22,-4,2,6
28,TTK,P000497,P011239,0 days 00:03:20,0,5,5
28,TTK,P009845,P011925,0 days 00:02:36,-4,2,6
28,TTK,P005000,P009845,0 days 00:02:36,-4,2,6
28,TTK,P006693,P009845,0 days 00:02:36,-4,2,6
28,TTK,P000497,P005685,0 days 00:02:03,5,5,0
28,TTK,P009845,P012056,0 days 00:01:32,-4,0,4
28,TTK,P009845,P011834,0 days 00:01:04,0,2,2
28,TTK,P000497,P005000,0 days 00:00:42,3,3,0
28,TTK,P000497,P006693,0 days 00:00:42,3,3,0
28,TTK,P005685,P006693,0 days 00:00:25,-2,0,2
29,ULM,P012604,P012703,0 days 00:20:59,23,57,34
29,ULM,P012629,P012703,0 days 00:20:54,17,50,33
29,ULM,P012604,P012629,0 days 00:19:30,24,52,28
29,ULM,P012603,P012604,0 days 00:19:21,17,49,32
29,ULM,P012603,P012629,0 days 00:16:54,18,42,24
29,ULM,P012603,P012703,0 days 00:16:49,18,43,25
29,ULM,P005422,P012603,0 days 00:13:09,10,30,20
29,ULM,P005422,P012629,0 days 00:12:51,11,30,19
29,ULM,P005422,P012604,0 days 00:12:38,12,29,17
29,ULM,P011457,P012703,0 days 00:12:33,5,30,25
29,ULM,P010582,P011457,0 days 00:12:20,1,25,24
29,ULM,P007952,P011457,0 days 00:11:53,-5,18,23
29,ULM,P010582,P012703,0 days 00:11:33,10,32,22
29,ULM,P012066,P012703,0 days 00:11:26,9,31,22
29,ULM,P005422,P012703,0 days 00:10:59,8,25,17
29,ULM,P010726,P011457,0 days 00:10:47,4,24,20
29,ULM,P012066,P012604,0 days 00:10:36,7,32,25
29,ULM,P007952,P010582,0 days 00:09:52,-4,15,19
29,ULM,P010582,P010726,0 days 00:09:41,-3,18,21
29,ULM,P011457,P012629,0 days 00:08:49,6,24,18
29,ULM,P007952,P012703,0 days 00:08:23,0,16,16
29,ULM,P007952,P010726,0 days 00:08:21,-2,14,16
29,ULM,P012066,P012629,0 days 00:07:55,6,20,14
29,ULM,P010582,P012604,0 days 00:07:36,9,27,18
29,ULM,P005422,P010726,0 days 00:07:13,1,14,13
29,ULM,P011457,P012066,0 days 00:07:12,3,19,16
29,ULM,P011457,P012604,0 days 00:05:49,9,21,12
29,ULM,P012066,P012603,0 days 00:05:41,4,17,13
29,ULM,P005422,P007952,0 days 00:05:40,-3,10,13
29,ULM,P005422,P010582,0 days 00:05:33,-2,9,11
29,ULM,P005422,P011457,0 days 00:05:09,-1,9,10
29,ULM,P010582,P012603,0 days 00:05:08,4,17,13
29,ULM,P010582,P012066,0 days 00:04:58,1,16,15
29,ULM,P010726,P012629,0 days 00:04:43,7,16,9
29,ULM,P007952,P012629,0 days 00:04:21,-3,7,10
29,ULM,P010726,P012604,0 days 00:04:11,3,13,10
29,ULM,P010726,P012703,0 days 00:03:52,2,8,6
29,ULM,P010726,P012603,0 days 00:03:37,0,10,10
29,ULM,P010582,P012629,0 days 00:03:11,4,9,5
29,ULM,P007952,P012066,0 days 00:02:17,0,4,4
29,ULM,P012602,P012629,0 days 00:01:52,3,7,4
29,ULM,P011391,P012602,0 days 00:01:52,3,7,4
29,ULM,P011457,P012602,0 days 00:01:52,3,7,4
29,ULM,P011391,P012629,0 days 00:01:52,3,7,4
29,ULM,P011391,P011457,0 days 00:01:52,3,7,4
29,ULM,P010726,P012602,0 days 00:01:52,3,7,4
29,ULM,P010726,P011391,0 days 00:01:52,3,7,4
29,ULM,P010726,P012066,0 days 00:01:27,-2,5,7
29,ULM,P007952,P012603,0 days 00:01:05,1,4,3
29,LKB,P002012,P004664,0 days 00:19:51,-14,35,49
29,LKB,P005521,P008856,0 days 00:18:30,-7,39,46
29,LKB,P002012,PLXI,0 days 00:18:23,-6,40,46
29,LKB,P002012,P010190,0 days 00:17:32,-15,24,39
29,LKB,P004664,P010190,0 days 00:16:13,-11,24,35
29,LKB,P004664,PLXI,0 days 00:15:26,-6,31,37
29,LKB,P010190,P010461,0 days 00:14:20,-9,21,30
29,LKB,P002012,P010461,0 days 00:13:43,-7,20,27
29,LKB,P002012,P005521,0 days 00:13:09,-5,29,34
29,LKB,P006230,PLXI,0 days 00:12:57,-12,28,40
29,LKB,P005521,P006230,0 days 00:12:43,-8,29,37
29,LKB,P005521,PLXI,0 days 00:12:39,-5,29,34
29,LKB,P010190,PLXI,0 days 00:12:32,-8,20,28
29,LKB,P005521,P012583,0 days 00:12:24,-9,24,33
29,LKB,P004664,P010461,0 days 00:11:32,-8,15,23
29,LKB,P010461,PLXI,0 days 00:11:04,0,18,18
29,LKB,P005521,P010461,0 days 00:10:42,-3,20,23
29,LKB,P005521,P006901,0 days 00:10:35,-8,17,25
29,LKB,P006901,P008856,0 days 00:10:31,-6,17,23
29,LKB,P008856,PLXI,0 days 00:10:04,-8,18,26
29,LKB,P008856,P012583,0 days 00:09:59,-6,23,29
29,LKB,P006230,P008856,0 days 00:09:52,-9,18,27
29,LKB,P004664,P005521,0 days 00:09:17,-11,15,26
29,LKB,P002012,P006230,0 days 00:08:43,-2,25,27
29,LKB,P005521,P010190,0 days 00:08:01,-9,10,19
29,LKB,P008856,P010461,0 days 00:07:59,1,17,16
29,LKB,P010190,P012583,0 days 00:06:16,-6,10,16
29,LKB,P002012,P008856,0 days 00:05:50,1,14,13
29,LKB,P004664,P006230,0 days 00:05:43,-3,16,19
29,LKB,P006230,P006901,0 days 00:05:11,-7,6,13
29,LKB,P006901,P012583,0 days 00:04:36,-3,10,13
29,LKB,P008856,P010190,0 days 00:04:20,-6,6,12
29,LKB,P006230,P012583,0 days 00:04:19,-3,9,12
29,LKB,P010461,P012583,0 days 00:04:02,0,10,10
29,LKB,P012583,PLXI,0 days 00:03:58,-2,10,12
29,LKB,P006901,PLXI,0 days 00:03:41,-5,2,7
29,LKB,P004664,P012583,0 days 00:03:35,-4,4,8
29,LKB,P006901,P010461,0 days 00:03:26,2,7,5
29,LKB,P002012,P012583,0 days 00:03:15,-4,4,8
29,LKB,P006230,P010190,0 days 00:02:52,-4,5,9
29,LKB,P002012,P006901,0 days 00:02:18,0,5,5
29,LKB,P005521,P011329,0 days 00:01:52,-3,4,7
29,LKB,P006901,P011329,0 days 00:01:52,-3,4,7
29,LKB,P008856,P011329,0 days 00:01:52,-3,4,7
29,LKB,P011329,P012583,0 days 00:01:52,-3,4,7
29,LKB,P004664,P008856,0 days 00:00:19,-1,0,1
29,LKB,P006901,P010190,0 days 00:00:06,0,0,0
29,LKB,P004664,P006901,0 days 00:00:04,-2,0,2
30,TRN,P009903,P012593,0 days 00:17:56,-5,37,42
30,TRN,P005738,P012593,0 days 00:17:43,-15,28,43
30,TRN,P005738,P009903,0 days 00:16:49,-16,27,43
30,TRN,P005059,P012593,0 days 00:15:05,-4,30,34
30,TRN,P005738,P006382,0 days 00:14:50,-10,23,33
30,TRN,P001479,P005059,0 days 00:14:23,6,34,28
30,TRN,P005059,P009903,0 days 00:14:09,-4,23,27
30,TRN,P006382,P012593,0 days 00:12:13,-3,26,29
30,TRN,P005059,P012595,0 days 00:12:03,-12,15,27
30,TRN,P005738,P012594,0 days 00:11:16,-9,19,28
30,TRN,P005059,P005738,0 days 00:11:04,-16,10,26
30,TRN,P009903,P012594,0 days 00:10:48,-8,17,25
30,TRN,P006382,P012596,0 days 00:10:47,8,26,18
30,TRN,P001479,P012596,0 days 00:10:35,-1,23,24
30,TRN,P012594,P012595,0 days 00:10:34,-5,15,20
30,TRN,P005738,P012595,0 days 00:10:16,-16,13,29
30,TRN,P005059,P006382,0 days 00:10:09,-6,17,23
30,TRN,P009903,P012595,0 days 00:10:03,-7,15,22
30,TRN,P005059,P012596,0 days 00:09:08,1,21,20
30,TRN,P006382,P012594,0 days 00:09:05,-2,16,18
30,TRN,P012593,P012595,0 days 00:09:00,-13,12,25
30,TRN,P006382,P007828,0 days 00:08:55,0,18,18
30,TRN,P006382,P009903,0 days 00:08:20,-6,15,21
30,TRN,P001479,P012595,0 days 00:08:14,-2,12,14
30,TRN,P005059,P012594,0 days 00:08:05,-6,9,15
30,TRN,P012594,P012596,0 days 00:07:55,-1,12,13
30,TRN,P005059,P007828,0 days 00:07:42,1,17,16
30,TRN,P007828,P012593,0 days 00:07:31,3,18,15
30,TRN,P001479,P007828,0 days 00:07:31,1,19,18
30,TRN,P007828,P009903,0 days 00:07:29,3,19,16
30,TRN,P001479,P012594,0 days 00:07:27,0,10,10
30,TRN,P012595,P012596,0 days 00:07:24,-6,10,16
30,TRN,P005738,P007828,0 days 00:06:58,-1,12,13
30,TRN,P001479,P006382,0 days 00:06:27,5,18,13
30,TRN,P001479,P009903,0 days 00:06:06,7,15,8
30,TRN,P001479,P012593,0 days 00:06:01,8,21,13
30,TRN,P007828,P012596,0 days 00:05:53,-1,12,13
30,TRN,P012593,P012594,0 days 00:05:49,-4,12,16
30,TRN,P006382,P012595,0 days 00:04:22,-6,5,11
30,TRN,P005738,P012596,0 days 00:04:20,3,8,5
30,TRN,P007828,P012594,0 days 00:03:53,-1,6,7
30,TRN,P012593,P012596,0 days 00:03:38,5,12,7
30,TRN,P007828,P012595,0 days 00:02:04,-5,3,8
30,CAN,P006588,P008121,0 days 00:20:23,15,47,32
30,CAN,P003425,P006588,0 days 00:16:52,9,38,29
30,CAN,P004160,P005005,0 days 00:15:59,-1,31,32
30,CAN,P003425,P008121,0 days 00:12:32,10,32,22
30,CAN,P003425,P004160,0 days 00:12:24,13,27,14
30,CAN,P004160,P010452,0 days 00:12:20,1,27,26
30,CAN,P005005,P010452,0 days 00:11:56,-2,25,27
30,CAN,P008121,P009864,0 days 00:11:56,3,26,23
30,CAN,P006588,P007560,0 days 00:11:53,13,32,19
30,CAN,P007560,P008121,0 days 00:11:26,11,30,19
30,CAN,P008121,P010385,0 days 00:11:01,12,28,16
30,CAN,P006588,P010385,0 days 00:10:48,11,26,15
30,CAN,P004160,P007644,0 days 00:10:31,11,25,14
30,CAN,P001607,P008121,0 days 00:10:25,5,22,17
30,CAN,P006588,P009864,0 days 00:10:23,4,21,17
30,CAN,P005005,P007644,0 days 00:10:04,9,23,14
30,CAN,P003425,P009864,0 days 00:09:50,-1,18,19
30,CAN,P001607,P010452,0 days 00:09:41,-7,22,29
30,CAN,P004160,P006588,0 days 00:08:53,5,17,12
30,CAN,P001607,P004160,0 days 00:08:49,-7,17,24
30,CAN,P003425,P005005,0 days 00:08:42,2,14,12
30,CAN,P001607,P006588,0 days 00:08:38,7,17,10
30,CAN,P001607,P010385,0 days 00:08:32,4,18,14
30,CAN,P007560,P010385,0 days 00:08:09,2,17,15
30,CAN,P001607,P005005,0 days 00:07:54,-5,17,22
30,CAN,P003637,P008121,0 days 00:06:44,-1,13,14
30,CAN,P003637,P009864,0 days 00:06:44,-1,13,14
30,CAN,P001607,P007560,0 days 00:06:40,5,14,9
30,CAN,P003425,P007644,0 days 00:06:19,9,16,7
30,CAN,P007644,P010452,0 days 00:06:12,10,17,7
30,CAN,P004160,P010385,0 days 00:05:55,8,15,7
30,CAN,P003425,P007560,0 days 00:05:50,6,18,12
30,CAN,P001607,P009864,0 days 00:05:35,-6,12,18
30,CAN,P003425,P010385,0 days 00:05:32,6,14,8
30,CAN,P003637,P006588,0 days 00:05:11,0,8,8
30,CAN,P009864,P010452,0 days 00:05:02,-11,9,20
30,CAN,P003425,P010452,0 days 00:04:49,5,10,5
30,CAN,P004160,P008121,0 days 00:04:47,5,11,6
30,CAN,P004160,P009864,0 days 00:04:47,-13,4,17
30,CAN,P005005,P006588,0 days 00:04:40,-1,6,7
30,CAN,P006588,P007644,0 days 00:04:19,1,8,7
30,CAN,P001607,P007644,0 days 00:04:12,2,9,7
30,CAN,P003425,P003637,0 days 00:03:54,-3,5,8
30,CAN,P007560,P009864,0 days 00:03:54,7,13,6
30,CAN,P005005,P009864,0 days 00:03:29,-10,4,14
30,CAN,P010385,P010452,0 days 00:03:16,-1,6,7
30,CAN,P005005,P010385,0 days 00:03:03,-2,4,6
30,CAN,P001607,P003637,0 days 00:02:50,2,8,6
30,CAN,P008121,P010452,0 days 00:02:34,0,7,7
30,CAN,P003637,P010452,0 days 00:01:33,-1,5,6
30,CAN,P005005,P007560,0 days 00:00:37,-2,0,2
30,CAN,P007560,P010452,0 days 00:00:37,-2,0,2
30,CAN,P004160,P007560,0 days 00:00:27,2,2,0
30,CAN,P007560,P007644,0 days 00:00:27,2,2,0
31,LJU,P003452,P012700,0 days 00:30:12,-10,57,67
31,LJU,P009395,P012700,0 days 00:26:55,1,57,56
31,LJU,P002661,P003452,0 days 00:26:21,-13,56,69
31,LJU,P003452,P009395,0 days 00:26:03,-12,46,58
31,LJU,P002661,P012700,0 days 00:25:49,0,60,60
31,LJU,P002661,P009395,0 days 00:25:24,-4,53,57
31,LJU,P003452,P012598,0 days 00:20:28,-9,37,46
31,LJU,P012598,P012700,0 days 00:17:49,-2,35,37
31,LJU,P003452,P007066,0 days 00:15:26,-6,34,40
31,LJU,P007066,P012700,0 days 00:15:13,0,35,35
31,LJU,P009395,P012598,0 days 00:15:06,-5,28,33
31,LJU,P002661,P012598,0 days 00:13:40,-10,27,37
31,LJU,P010594,P012700,0 days 00:13:20,3,27,24
31,LJU,P002661,P007066,0 days 00:12:51,2,40,38
31,LJU,P002661,P010594,0 days 00:10:01,5,26,21
31,LJU,P009395,P010594,0 days 00:10:00,3,23,20
31,LJU,P003452,P010594,0 days 00:09:50,-4,17,21
31,LJU,P007066,P009395,0 days 00:08:50,2,24,22
31,LJU,P007066,P010594,0 days 00:08:45,5,23,18
31,LJU,P003452,P011261,0 days 00:07:32,-5,11,16
31,LJU,P002661,P011261,0 days 00:07:31,0,14,14
31,LJU,P007066,P011261,0 days 00:05:37,-1,11,12
31,LJU,P009395,P011261,0 days 00:05:22,-2,7,9
31,LJU,P007066,P012598,0 days 00:05:22,-4,9,13
31,LJU,P011261,P012700,0 days 00:04:26,1,3,2
31,LJU,P011261,P012598,0 days 00:03:48,-7,2,9
31,LJU,P010594,P011261,0 days 00:03:32,6,8,2
31,LJU,P005969,P009395,0 days 00:03:16,1,6,5
31,LJU,P005969,P012700,0 days 00:03:16,1,6,5
31,LJU,P005969,P012598,0 days 00:03:16,1,6,5
31,LJU,P003452,P005969,0 days 00:03:16,1,6,5
31,LJU,P010594,P012598,0 days 00:02:23,0,4,4
31,LJU,P007066,P010771,0 days 00:02:20,-2,8,10
31,LJU,P010771,P012700,0 days 00:02:20,-2,8,10
31,LJU,P003452,P010771,0 days 00:02:20,-2,8,10
31,LJU,P002661,P010771,0 days 00:02:19,0,8,8
31,LJU,P010594,P010771,0 days 00:00:01,-2,0,2
31,PMT,P002644,P011066,0 days 00:24:28,11,59,48
31,PMT,P002644,P012600,0 days 00:24:18,11,64,53
31,PMT,P009559,P011066,0 days 00:23:29,2,51,49
31,PMT,P011066,P012600,0 days 00:22:15,17,61,44
31,PMT,P002644,P009559,0 days 00:19:52,0,41,41
31,PMT,P009559,P012600,0 days 00:18:11,4,41,37
31,PMT,P011066,P011944,0 days 00:17:57,3,34,31
31,PMT,P001686,P011066,0 days 00:17:54,2,42,40
31,PMT,P009559,P011944,0 days 00:14:34,-4,23,27
31,PMT,P011943,P012600,0 days 00:14:21,3,40,37
31,PMT,P001686,P009559,0 days 00:14:01,0,31,31
31,PMT,P002644,P011944,0 days 00:13:59,1,24,23
31,PMT,P002644,P011943,0 days 00:13:14,6,40,34
31,PMT,P011066,P011823,0 days 00:13:02,8,28,20
31,PMT,P011066,P011943,0 days 00:12:04,9,37,28
31,PMT,P001686,P002644,0 days 00:12:03,2,30,28
31,PMT,P001686,P011944,0 days 00:11:43,-2,21,23
31,PMT,P011823,P011944,0 days 00:11:28,3,21,18
31,PMT,P001686,P011823,0 days 00:10:05,1,19,18
31,PMT,P009559,P011943,0 days 00:09:53,3,23,20
31,PMT,P001686,P012600,0 days 00:09:50,8,32,24
31,PMT,P009559,P011823,0 days 00:08:29,5,19,14
31,PMT,P011944,P012600,0 days 00:08:20,7,17,10
31,PMT,P002644,P011966,0 days 00:06:58,-6,12,18
31,PMT,P011823,P012600,0 days 00:05:14,12,16,4
31,PMT,P002644,P011823,0 days 00:05:08,3,9,6
31,PMT,P009559,P011966,0 days 00:04:49,0,9,9
31,PMT,P011966,P012600,0 days 00:04:17,-4,10,14
31,PMT,P002020,P002644,0 days 00:03:56,-8,5,13
31,PMT,P002020,P011966,0 days 00:03:56,-8,5,13
31,PMT,P001686,P011943,0 days 00:03:18,3,14,11
31,PMT,P001686,P011966,0 days 00:03:02,2,7,5
31,PMT,P002020,P009559,0 days 00:02:14,-2,2,4
31,PMT,P002020,P011944,0 days 00:02:14,-2,2,4
31,PMT,P011944,P011966,0 days 00:02:14,-2,2,4
31,PMT,P002020,P011943,0 days 00:01:42,-6,3,9
31,PMT,P002020,P012600,0 days 00:01:42,-6,3,9
31,PMT,P011943,P011966,0 days 00:01:42,-6,3,9
31,PMT,P011823,P011943,0 days 00:00:35,0,0,0
31,PMT,P011943,P011944,0 days 00:00:35,0,0,0
31,PMT,P011066,P011966,0 days 00:00:27,0,0,0
31,PMT,P011823,P011966,0 days 00:00:27,0,0,0
32,WOL,P002387,P012577,0 days 00:24:13,3,59,56
32,WOL,P005516,P012577,0 days 00:22:11,17,65,48
32,WOL,P002387,P011150,0 days 00:22:10,-11,45,56
32,WOL,P011150,P012577,0 days 00:21:53,4,56,52
32,WOL,P002387,P005516,0 days 00:21:09,1,50,49
32,WOL,P005516,P011150,0 days 00:20:10,3,52,49
32,WOL,P004645,P012577,0 days 00:19:10,2,44,42
32,WOL,P002387,P004645,0 days 00:18:08,-14,29,43
32,WOL,P004645,P011150,0 days 00:17:42,-13,31,44
32,WOL,P005516,P012576,0 days 00:16:57,11,43,32
32,WOL,P004645,P005516,0 days 00:16:29,-1,37,38
32,WOL,P011150,P012576,0 days 00:15:02,9,38,29
32,WOL,P012576,P012577,0 days 00:13:11,11,37,26
32,WOL,P002387,P003212,0 days 00:12:52,-3,24,27
32,WOL,P003212,P012577,0 days 00:12:20,-1,27,28
32,WOL,P003212,P004645,0 days 00:11:06,-1,22,23
32,WOL,P002387,P012576,0 days 00:11:05,2,21,19
32,WOL,P004645,P012576,0 days 00:10:55,8,28,20
32,WOL,P002387,PLCT,0 days 00:10:14,11,28,17
32,WOL,P003212,P011150,0 days 00:07:10,-7,10,17
32,WOL,P012577,PLCT,0 days 00:06:59,13,25,12
32,WOL,P002333,P002387,0 days 00:06:55,-11,10,21
32,WOL,P002333,P005516,0 days 00:05:18,-10,6,16
32,WOL,P003212,PLCT,0 days 00:05:08,-1,8,9
32,WOL,P005516,PLCT,0 days 00:05:06,12,20,8
32,WOL,P004645,PLCT,0 days 00:04:45,3,12,9
32,WOL,P002387,P006154,0 days 00:04:38,-2,6,8
32,WOL,P002333,P012577,0 days 00:04:04,-4,8,12
32,WOL,P003212,P012576,0 days 00:03:16,0,5,5
32,WOL,P003212,P005516,0 days 00:03:09,5,11,6
32,WOL,P002333,PLCT,0 days 00:02:55,0,5,5
32,WOL,P005516,P006154,0 days 00:02:43,-2,4,6
32,WOL,P006154,PLCT,0 days 00:02:39,-1,3,4
32,WOL,P002333,P011150,0 days 00:02:31,-10,2,12
32,WOL,P002333,P003212,0 days 00:02:28,0,7,7
32,WOL,P003212,P006154,0 days 00:01:55,0,2,2
32,WOL,P011150,PLCT,0 days 00:01:53,8,11,3
32,WOL,P002333,P006154,0 days 00:01:52,-2,2,4
32,WOL,P002333,P004645,0 days 00:01:37,-7,0,7
32,WOL,P006154,P012577,0 days 00:01:27,-1,3,4
32,WOL,P012576,PLCT,0 days 00:01:17,-1,0,1
32,WOL,P004645,P006154,0 days 00:01:16,-1,1,2
32,WOL,P006154,P012576,0 days 00:01:13,0,0,0
32,WOL,P006154,P011150,0 days 00:00:49,1,3,2
32,BES,P011936,P012647,0 days 00:27:35,-1,57,58
32,BES,P011936,P012622,0 days 00:26:58,0,62,62
32,BES,P012622,P012647,0 days 00:23:50,0,52,52
32,BES,P009582,P011936,0 days 00:23:21,3,51,48
32,BES,P009582,P012622,0 days 00:22:23,6,53,47
32,BES,P009582,P012647,0 days 00:19:43,7,42,35
32,BES,P008945,P012622,0 days 00:19:25,10,51,41
32,BES,P008945,P011936,0 days 00:18:56,5,45,40
32,BES,P008945,P012647,0 days 00:18:07,2,42,40
32,BES,P008945,P009582,0 days 00:14:06,13,36,23
32,BES,P007917,P012622,0 days 00:13:24,-12,30,42
32,BES,P007914,P012622,0 days 00:11:17,-7,21,28
32,BES,P007917,P011936,0 days 00:11:12,-11,24,35
32,BES,P007914,P012647,0 days 00:11:08,-7,17,24
32,BES,P003783,P007914,0 days 00:10:38,-7,16,23
32,BES,P007914,P011936,0 days 00:10:03,-9,13,22
32,BES,P003783,P012622,0 days 00:09:49,-5,22,27
32,BES,P007917,P012647,0 days 00:09:34,-9,19,28
32,BES,P007914,P009582,0 days 00:09:29,-8,12,20
32,BES,P003783,P011936,0 days 00:09:04,-2,20,22
32,BES,P003783,P007917,0 days 00:08:07,-7,17,24
32,BES,P007914,P007917,0 days 00:07:49,-2,18,20
32,BES,P003783,P009582,0 days 00:07:25,-4,14,18
32,BES,P003783,P012647,0 days 00:07:11,0,15,15
32,BES,P011357,P012622,0 days 00:06:20,8,17,9
32,BES,P007917,P008945,0 days 00:06:18,-4,17,21
32,BES,P003783,P011357,0 days 00:05:12,5,12,7
32,BES,P009582,P011357,0 days 00:05:08,5,12,7
32,BES,P011357,P011936,0 days 00:04:19,7,12,5
32,BES,P007914,P011379,0 days 00:02:58,0,8,8
32,BES,P007917,P011379,0 days 00:02:58,0,8,8
32,BES,P011379,P012622,0 days 00:02:58,0,8,8
32,BES,P007914,P011357,0 days 00:02:55,1,5,4
32,BES,P007914,P008945,0 days 00:02:27,3,10,7
32,BES,P007917,P011357,0 days 00:02:25,3,7,4
32,BES,P007917,P009582,0 days 00:01:41,-6,4,10
32,BES,P003783,P011379,0 days 00:01:30,-4,0,4
32,BES,P008945,P011379,0 days 00:01:28,4,8,4
32,BES,P008945,P011357,0 days 00:00:49,3,3,0
33,VNC,P003759,P004381,0 days 00:23:14,16,52,36
33,VNC,P004381,P011909,0 days 00:21:35,9,47,38
33,VNC,P004381,P012591,0 days 00:21:23,12,38,26
33,VNC,P004381,P011928,0 days 00:20:37,3,34,31
33,VNC,P011928,P012591,0 days 00:20:14,11,38,27
33,VNC,P003759,P012591,0 days 00:18:23,6,31,25
33,VNC,P000968,P003759,0 days 00:18:06,11,41,30
33,VNC,P003759,P011909,0 days 00:17:52,8,41,33
33,VNC,P011909,P011928,0 days 00:13:35,-4,20,24
33,VNC,P003759,P011928,0 days 00:13:20,4,23,19
33,VNC,P011909,P012591,0 days 00:13:06,-1,20,21
33,VNC,P004381,P008052,0 days 00:11:05,14,32,18
33,VNC,P000968,P004381,0 days 00:10:38,13,31,18
33,VNC,P003759,P004117,0 days 00:09:43,-1,14,15
33,VNC,P012590,P012591,0 days 00:08:32,8,19,11
33,VNC,P000968,P011909,0 days 00:08:29,10,27,17
33,VNC,P003759,P012590,0 days 00:08:27,7,17,10
33,VNC,P000968,P004117,0 days 00:08:17,-5,12,17
33,VNC,P008052,P011909,0 days 00:08:12,11,27,16
33,VNC,P004117,P012590,0 days 00:08:09,-7,12,19
33,VNC,P011928,P012590,0 days 00:08:08,3,15,12
33,VNC,P003759,P008052,0 days 00:08:00,13,27,14
33,VNC,P000968,P008052,0 days 00:08:00,13,27,14
33,VNC,P000968,P012590,0 days 00:07:49,0,14,14
33,VNC,P000968,P012591,0 days 00:06:32,1,12,11
33,VNC,P004381,P012590,0 days 00:06:28,3,11,8
33,VNC,P004117,P012591,0 days 00:06:17,-3,10,13
33,VNC,P003759,P012587,0 days 00:06:13,-1,9,10
33,VNC,P004117,P012587,0 days 00:06:13,-1,9,10
33,VNC,P004381,P009400,0 days 00:04:08,-2,5,7
33,VNC,P009400,P011928,0 days 00:04:08,-2,5,7
33,VNC,P004117,P004381,0 days 00:04:04,-4,4,8
33,VNC,P000968,P012587,0 days 00:04:02,-3,5,8
33,VNC,P000968,P011928,0 days 00:03:40,1,8,7
33,VNC,P011909,P012590,0 days 00:03:31,3,6,3
33,VNC,P012587,P012590,0 days 00:03:17,-1,5,6
33,VNC,P008052,P011928,0 days 00:03:05,1,5,4
33,VNC,P012587,P012591,0 days 00:02:56,0,4,4
33,VNC,P008052,P009400,0 days 00:02:53,3,5,2
33,VNC,P008052,P012591,0 days 00:02:46,1,5,4
33,VNC,P009400,P012591,0 days 00:02:34,3,5,2
33,VNC,P009400,P012590,0 days 00:02:28,-4,1,5
33,VNC,P004381,P012587,0 days 00:02:11,2,4,2
33,VNC,P004117,P009400,0 days 00:02:09,-4,1,5
33,VNC,P004117,P011928,0 days 00:02:00,-7,2,9
33,VNC,P000968,P009400,0 days 00:00:54,1,1,0
33,VNC,P003759,P009400,0 days 00:00:54,1,1,0
33,VNC,P000968,P012588,0 days 00:00:21,2,2,0
33,VNC,P004381,P012588,0 days 00:00:21,2,2,0
33,VNC,P011928,P012588,0 days 00:00:21,2,2,0
33,VNC,P012588,P012591,0 days 00:00:21,2,2,0
33,VNC,P008052,P012590,0 days 00:00:19,0,0,0
33,JOV,P005094,P011248,0 days 00:22:53,-10,32,42
33,JOV,P005094,P010161,0 days 00:17:55,-3,30,33
33,JOV,P002361,P005094,0 days 00:17:31,4,31,27
33,JOV,P002507,P011248,0 days 00:17:21,-6,26,32
33,JOV,P002361,P011248,0 days 00:16:20,1,24,23
33,JOV,P010161,P011248,0 days 00:15:52,-10,25,35
33,JOV,P005094,PJUG,0 days 00:15:03,-14,25,39
33,JOV,P005094,P006771,0 days 00:14:22,4,32,28
33,JOV,P002507,P005094,0 days 00:13:57,-6,20,26
33,JOV,P005094,P012076,0 days 00:13:57,2,29,27
33,JOV,P006771,PJUG,0 days 00:13:46,-10,23,33
33,JOV,P006771,P012076,0 days 00:13:34,3,31,28
33,JOV,P002361,P002507,0 days 00:12:13,2,18,16
33,JOV,P012076,PJUG,0 days 00:11:53,-5,22,27
33,JOV,P002361,P010161,0 days 00:11:32,0,20,20
33,JOV,P010161,P012076,0 days 00:10:35,3,20,17
33,JOV,P002507,P010161,0 days 00:10:24,-9,16,25
33,JOV,P010161,PJUG,0 days 00:10:03,-12,13,25
33,JOV,P006771,P010161,0 days 00:09:59,4,18,14
33,JOV,P011248,PJUG,0 days 00:09:48,-14,13,27
33,JOV,P002361,P006771,0 days 00:09:11,-2,19,21
33,JOV,P006771,P011248,0 days 00:08:12,2,16,14
33,JOV,P010458,P011248,0 days 00:07:51,0,12,12
33,JOV,P002361,P010458,0 days 00:07:51,0,12,12
33,JOV,P002361,P012076,0 days 00:07:26,0,18,18
33,JOV,P011248,P012076,0 days 00:07:20,-1,14,15
33,JOV,P005094,P010458,0 days 00:06:30,0,8,8
33,JOV,P002361,P010166,0 days 00:05:57,-6,5,11
33,JOV,P006771,P010166,0 days 00:05:25,-6,5,11
33,JOV,P002361,PJUG,0 days 00:05:09,-6,9,15
33,JOV,P002507,P010458,0 days 00:05:04,1,6,5
33,JOV,P002507,PJUG,0 days 00:04:35,-8,6,14
33,JOV,P010161,P010458,0 days 00:04:12,-1,8,9
33,JOV,P010166,P011248,0 days 00:03:57,0,6,6
33,JOV,P002507,P010166,0 days 00:03:49,0,6,6
33,JOV,P002507,P006771,0 days 00:03:41,2,6,4
33,JOV,P010161,P010166,0 days 00:03:35,-6,2,8
33,JOV,P010166,PJUG,0 days 00:03:33,-6,3,9
33,JOV,P006771,P010708,0 days 00:02:41,-9,0,9
33,JOV,P010708,PJUG,0 days 00:02:17,-9,0,9
33,JOV,P010458,P012076,0 days 00:02:13,0,6,6
33,JOV,P010166,P010708,0 days 00:01:43,-7,0,7
33,JOV,P010458,PJUG,0 days 00:01:25,0,2,2
33,JOV,P006771,P010458,0 days 00:01:25,0,2,2
33,JOV,P002361,P010708,0 days 00:01:22,-5,0,5
33,JOV,P005094,P010708,0 days 00:00:58,-2,0,2
33,JOV,P010708,P011248,0 days 00:00:58,-2,0,2
33,JOV,P010166,P012076,0 days 00:00:46,-2,0,2
33,JOV,P010161,P010708,0 days 00:00:45,-2,0,2
33,JOV,P005094,P010166,0 days 00:00:38,1,1,0
33,JOV,P010166,P010458,0 days 00:00:33,0,0,0
34,HAM,P009663,P012580,0 days 00:23:44,-30,41,71
34,HAM,P009663,P012581,0 days 00:20:05,-21,42,63
34,HAM,P009663,P012578,0 days 00:19:48,-26,38,64
34,HAM,P012580,P012581,0 days 00:18:47,-30,32,62
34,HAM,P012578,P012581,0 days 00:18:40,-17,39,56
34,HAM,P012578,P012580,0 days 00:16:24,-25,29,54
34,HAM,P009663,P011168,0 days 00:16:03,-25,24,49
34,HAM,P001990,P012581,0 days 00:13:49,-8,31,39
34,HAM,P011168,P012578,0 days 00:13:14,-21,17,38
34,HAM,P011168,P012581,0 days 00:13:07,-20,24,44
34,HAM,P011168,P012580,0 days 00:12:55,-26,17,43
34,HAM,P001990,P009663,0 days 00:11:43,-1,33,34
34,HAM,P001990,P012580,0 days 00:11:34,-8,26,34
34,HAM,P012581,P012694,0 days 00:10:56,-14,16,30
34,HAM,P001990,P012578,0 days 00:10:17,-4,30,34
34,HAM,P009663,P012579,0 days 00:09:58,-5,18,23
34,HAM,P009663,P012694,0 days 00:09:17,-4,19,23
34,HAM,P012580,P012694,0 days 00:09:13,-11,14,25
34,HAM,P011168,P012579,0 days 00:08:56,-6,13,19
34,HAM,P010070,P012648,0 days 00:08:52,-7,15,22
34,HAM,P012581,P012648,0 days 00:08:37,-2,16,18
34,HAM,P012578,P012648,0 days 00:08:35,-3,18,21
34,HAM,P001990,P012694,0 days 00:08:25,-2,14,16
34,HAM,P010070,P012581,0 days 00:07:38,-4,11,15
34,HAM,P001990,P012648,0 days 00:07:08,2,18,16
34,HAM,P012579,P012580,0 days 00:06:50,-6,11,17
34,HAM,P010070,P012578,0 days 00:06:40,-5,13,18
34,HAM,P011168,P012694,0 days 00:06:37,-6,13,19
34,HAM,P012579,P012694,0 days 00:05:47,4,16,12
34,HAM,P012578,P012579,0 days 00:05:35,-8,4,12
34,HAM,P001990,P010070,0 days 00:04:45,-1,11,12
34,HAM,P011168,P012648,0 days 00:04:44,-2,6,8
34,HAM,P001990,P012579,0 days 00:03:50,3,9,6
34,HAM,P012648,P012694,0 days 00:03:36,-1,4,5
34,HAM,P009663,P012648,0 days 00:03:09,-1,9,10
34,HAM,P012581,P012695,0 days 00:02:40,-3,0,3
34,HAM,P010070,P011168,0 days 00:02:24,-3,4,7
34,HAM,P012579,P012648,0 days 00:02:20,1,2,1
34,HAM,P012579,P012581,0 days 00:02:12,1,7,6
34,HAM,P010070,P012694,0 days 00:02:12,-2,2,4
34,HAM,P011187,P012581,0 days 00:01:53,-6,2,8
34,HAM,P011187,P012694,0 days 00:01:53,-6,2,8
34,HAM,P011187,P012580,0 days 00:01:53,-6,2,8
34,HAM,P001990,P011187,0 days 00:01:53,-6,2,8
34,HAM,P010070,P012695,0 days 00:01:43,-3,0,3
34,HAM,P012578,P012695,0 days 00:01:43,-3,0,3
34,HAM,P012648,P012695,0 days 00:01:43,-3,0,3
34,HAM,P001990,P011168,0 days 00:01:24,1,2,1
34,HAM,P009663,P012695,0 days 00:01:19,-4,0,4
34,HAM,P009663,P010070,0 days 00:01:14,-3,4,7
34,HAM,P012580,P012695,0 days 00:01:08,-2,0,2
34,HAM,P012694,P012695,0 days 00:01:08,-2,0,2
34,HTA,P004846,P006835,0 days 00:16:53,14,48,34
34,HTA,P007759,P010465,0 days 00:15:10,33,52,19
34,HTA,P007759,P011973,0 days 00:15:04,25,47,22
34,HTA,P010465,P011973,0 days 00:14:07,21,49,28
34,HTA,P010465,P010550,0 days 00:13:27,18,40,22
34,HTA,P010550,P011991,0 days 00:13:18,18,41,23
34,HTA,P007759,P010550,0 days 00:12:33,26,44,18
34,HTA,P010465,P011991,0 days 00:12:25,26,50,24
34,HTA,P006835,P007759,0 days 00:12:15,17,36,19
34,HTA,P004846,P007759,0 days 00:11:14,14,34,20
34,HTA,P003533,P004846,0 days 00:10:33,6,30,24
34,HTA,P004846,P010550,0 days 00:10:11,-10,12,22
34,HTA,P006835,P011990,0 days 00:09:55,16,33,17
34,HTA,P011973,P011991,0 days 00:09:52,16,38,22
34,HTA,P006835,P011973,0 days 00:09:37,10,27,17
34,HTA,P006835,P010465,0 days 00:09:30,16,31,15
34,HTA,P010550,P011973,0 days 00:09:28,16,32,16
34,HTA,P003533,P007759,0 days 00:09:20,20,37,17
34,HTA,P007759,P011991,0 days 00:09:07,24,37,13
34,HTA,P003533,P006835,0 days 00:08:56,16,33,17
34,HTA,P004267,P004846,0 days 00:08:47,-10,10,20
34,HTA,P004267,P010550,0 days 00:08:47,-10,10,20
34,HTA,P004846,P010465,0 days 00:08:18,4,22,18
34,HTA,P004846,P011973,0 days 00:08:07,12,26,14
34,HTA,P003533,P011990,0 days 00:07:36,14,29,15
34,HTA,P006835,P011991,0 days 00:07:13,-4,17,21
34,HTA,P003533,P010465,0 days 00:06:58,13,22,9
34,HTA,P004267,P011973,0 days 00:06:44,1,11,10
34,HTA,P004846,P011990,0 days 00:06:44,11,24,13
34,HTA,P007759,P011990,0 days 00:06:22,10,23,13
34,HTA,P004846,P011991,0 days 00:06:16,-5,14,19
34,HTA,P004267,P006835,0 days 00:06:03,-7,7,14
34,HTA,P011973,P011990,0 days 00:05:50,3,10,7
34,HTA,P011973,P012592,0 days 00:05:38,3,10,7
34,HTA,P011990,P012592,0 days 00:05:14,1,8,7
34,HTA,P003533,P010550,0 days 00:05:02,4,13,9
34,HTA,P006835,P010550,0 days 00:04:59,-6,4,10
34,HTA,P004267,P010465,0 days 00:04:45,-7,4,11
34,HTA,P011973,P012706,0 days 00:04:09,-1,6,7
34,HTA,P011990,P012706,0 days 00:04:09,-1,6,7
34,HTA,P012592,P012706,0 days 00:04:09,-1,6,7
34,HTA,P004267,P011991,0 days 00:04:03,-6,4,10
34,HTA,P004267,P007759,0 days 00:03:59,1,8,7
34,HTA,P004267,P011990,0 days 00:03:26,1,6,5
34,HTA,P003533,P004267,0 days 00:03:26,-5,4,9
34,HTA,P004267,P012706,0 days 00:03:26,1,6,5
34,HTA,P004267,P012592,0 days 00:03:26,1,6,5
34,HTA,P010465,P011990,0 days 00:03:24,12,14,2
34,HTA,P003533,P011991,0 days 00:02:33,10,12,2
34,HTA,P006835,P012592,0 days 00:02:12,2,4,2
34,HTA,P004846,P012592,0 days 00:01:29,4,4,0
34,HTA,P003533,P011973,0 days 00:01:28,2,4,2
34,HTA,P011990,P011991,0 days 00:01:05,1,3,2
34,HTA,P006835,P012706,0 days 00:00:43,-2,0,2
34,HTA,P007759,P012592,0 days 00:00:24,2,2,0
34,HTA,P010550,P011990,0 days 00:00:11,0,0,0
35,LLI,P006600,P012585,0 days 00:34:22,5,78,73
35,LLI,P006600,P009672,0 days 00:34:15,9,81,72
35,LLI,P009672,P012585,0 days 00:32:13,7,74,67
35,LLI,P009649,P012585,0 days 00:30:11,15,71,56
35,LLI,P009649,P009672,0 days 00:29:21,11,70,59
35,LLI,P012585,P012586,0 days 00:28:03,2,55,53
35,LLI,P006600,P009649,0 days 00:27:30,16,74,58
35,LLI,P009672,P012586,0 days 00:27:28,3,56,53
35,LLI,P006600,P012586,0 days 00:25:23,6,58,52
35,LLI,P009649,P012586,0 days 00:23:59,10,56,46
35,LLI,P009680,P012585,0 days 00:13:43,-7,35,42
35,LLI,P004479,P009680,0 days 00:11:22,-10,19,29
35,LLI,P005247,P012586,0 days 00:10:22,-8,17,25
35,LLI,P005247,P009680,0 days 00:10:06,-8,18,26
35,LLI,P006600,P009680,0 days 00:10:01,-2,29,31
35,LLI,P009680,P012586,0 days 00:09:36,-8,15,23
35,LLI,P009649,P009680,0 days 00:09:31,-2,26,28
35,LLI,P004479,P005247,0 days 00:08:52,-11,13,24
35,LLI,P009672,P009680,0 days 00:08:15,0,25,25
35,LLI,P004773,P012586,0 days 00:07:34,-8,18,26
35,LLI,P004479,P012586,0 days 00:07:31,-5,17,22
35,LLI,P005247,P006600,0 days 00:07:16,-8,13,21
35,LLI,P005247,P012585,0 days 00:07:15,-11,13,24
35,LLI,P004773,P005247,0 days 00:06:37,-1,11,12
35,LLI,P004773,P009680,0 days 00:05:54,-3,9,12
35,LLI,P004479,P012585,0 days 00:05:51,-7,10,17
35,LLI,P005247,P009672,0 days 00:05:00,-1,11,12
35,LLI,P004479,P004773,0 days 00:04:10,-3,11,14
35,LLI,P004773,P009672,0 days 00:03:24,-5,7,12
35,LLI,P004773,P006600,0 days 00:01:40,-5,9,14
35,LLI,P004479,P006600,0 days 00:01:09,-5,6,11
35,LLI,P004479,P009649,0 days 00:01:09,1,8,7
35,LLI,P004773,P012585,0 days 00:00:38,-4,0,4
35,LLI,P004773,P009649,0 days 00:00:19,-3,7,10
35,PRS,P012609,P012640,0 days 00:26:51,2,63,61
35,PRS,P012608,P012613,0 days 00:26:38,1,65,64
35,PRS,P012608,P012610,0 days 00:25:44,9,64,55
35,PRS,P012610,P012613,0 days 00:24:06,5,58,53
35,PRS,P004512,P012608,0 days 00:20:31,-3,48,51
35,PRS,P005793,P012609,0 days 00:18:50,4,43,39
35,PRS,P004512,P012611,0 days 00:18:33,-2,31,33
35,PRS,P004512,P012613,0 days 00:18:32,-7,42,49
35,PRS,P004512,P012610,0 days 00:18:06,2,43,41
35,PRS,P005793,P012640,0 days 00:17:12,0,37,37
35,PRS,P012609,P012613,0 days 00:15:02,0,37,37
35,PRS,P012610,P012611,0 days 00:13:57,-6,22,28
35,PRS,P012611,P012613,0 days 00:13:57,-6,22,28
35,PRS,P012613,P012640,0 days 00:13:27,-1,31,32
35,PRS,P012608,P012609,0 days 00:12:41,8,44,36
35,PRS,P003481,P005793,0 days 00:12:16,-2,23,25
35,PRS,P003481,P012609,0 days 00:12:16,-2,23,25
35,PRS,P003481,P012640,0 days 00:12:16,-2,23,25
35,PRS,P005793,P009556,0 days 00:11:51,-4,22,26
35,PRS,P009556,P012609,0 days 00:11:51,-4,22,26
35,PRS,P009556,P012640,0 days 00:11:51,-4,22,26
35,PRS,P012608,P012611,0 days 00:11:04,-6,22,28
35,PRS,P012609,P012610,0 days 00:10:51,12,33,21
35,PRS,P004512,P012609,0 days 00:10:20,4,26,22
35,PRS,P003481,P009556,0 days 00:09:30,-1,19,20
35,PRS,P012608,P012640,0 days 00:09:28,3,32,29
35,PRS,P012610,P012640,0 days 00:07:38,7,21,14
35,PRS,P004512,P005793,0 days 00:07:34,11,24,13
35,PRS,P004512,P012640,0 days 00:07:04,-1,14,15
35,PRS,P005793,P012613,0 days 00:04:41,0,14,14
35,PRS,P005793,P012610,0 days 00:02:34,7,15,8
35,PRS,P009556,P012613,0 days 00:02:21,-3,3,6
35,PRS,P005793,P012608,0 days 00:02:20,8,21,13
35,PRS,P003481,P012608,0 days 00:01:50,0,4,4
35,PRS,P012611,P012640,0 days 00:01:49,4,9,5
35,PRS,P005793,P012611,0 days 00:01:46,4,9,5
35,PRS,P012609,P012611,0 days 00:01:46,4,9,5
35,PRS,P003481,P012613,0 days 00:00:56,-1,0,1
36,CAN,P003425,P006588,0 days 00:20:52,3,45,42
36,CAN,P006588,P008121,0 days 00:20:00,-2,41,43
36,CAN,P003425,P008121,0 days 00:19:39,5,43,38
36,CAN,P005005,P010452,0 days 00:14:07,10,33,23
36,CAN,P001607,P010452,0 days 00:13:13,10,33,23
36,CAN,P001607,P005005,0 days 00:12:35,10,31,21
36,CAN,P003425,P003637,0 days 00:11:27,3,28,25
36,CAN,P005005,P009864,0 days 00:11:10,3,20,17
36,CAN,P003425,P010385,0 days 00:10:56,-1,18,19
36,CAN,P008121,P010385,0 days 00:10:30,0,18,18
36,CAN,P003637,P006588,0 days 00:10:06,1,26,25
36,CAN,P003637,P009864,0 days 00:09:59,-5,18,23
36,CAN,P006588,P010385,0 days 00:09:44,-1,16,17
36,CAN,P003425,P005005,0 days 00:09:18,6,15,9
36,CAN,P001607,P009864,0 days 00:09:10,-9,15,24
36,CAN,P009864,P010452,0 days 00:08:58,0,17,17
36,CAN,P005005,P010385,0 days 00:08:55,12,22,10
36,CAN,P003637,P008121,0 days 00:08:32,1,24,23
36,CAN,P006588,P009864,0 days 00:08:14,-4,16,20
36,CAN,P008121,P009864,0 days 00:08:14,-4,16,20
36,CAN,P003425,P009864,0 days 00:08:02,5,18,13
36,CAN,P005005,P006588,0 days 00:07:57,4,13,9
36,CAN,P007560,P010452,0 days 00:07:43,7,21,14
36,CAN,P007560,P010385,0 days 00:07:40,2,15,13
36,CAN,P001607,P007560,0 days 00:07:33,2,19,17
36,CAN,P010385,P010452,0 days 00:07:29,11,20,9
36,CAN,P007560,P008121,0 days 00:07:27,-6,10,16
36,CAN,P005005,P007560,0 days 00:07:22,5,21,16
36,CAN,P006588,P007560,0 days 00:07:06,-8,10,18
36,CAN,P003425,P007560,0 days 00:07:05,-1,12,13
36,CAN,P003637,P005005,0 days 00:07:04,-5,7,12
36,CAN,P001607,P010385,0 days 00:06:33,12,20,8
36,CAN,P003637,P010452,0 days 00:05:30,-5,5,10
36,CAN,P007560,P009864,0 days 00:05:01,-2,12,14
36,CAN,P006588,P007644,0 days 00:04:57,2,13,11
36,CAN,P003425,P007644,0 days 00:04:57,2,13,11
36,CAN,P005005,P008121,0 days 00:04:24,5,7,2
36,CAN,P003425,P010452,0 days 00:04:19,3,8,5
36,CAN,P004160,P010385,0 days 00:04:17,7,11,4
36,CAN,P001607,P003637,0 days 00:04:09,-7,3,10
36,CAN,P001607,P008121,0 days 00:03:46,-7,6,13
36,CAN,P001607,P006588,0 days 00:03:46,-7,6,13
36,CAN,P001607,P004160,0 days 00:03:34,9,11,2
36,CAN,P004160,P010452,0 days 00:03:25,7,11,4
36,CAN,P004160,P005005,0 days 00:03:25,7,11,4
36,CAN,P007644,P008121,0 days 00:02:58,3,9,6
36,CAN,P008121,P010452,0 days 00:02:58,1,6,5
36,CAN,P003637,P007644,0 days 00:02:49,3,9,6
36,CAN,P003637,P010385,0 days 00:02:48,-2,4,6
36,CAN,P007560,P007644,0 days 00:02:08,-1,4,5
36,CAN,P005005,P007644,0 days 00:01:59,-1,4,5
36,CAN,P001607,P003425,0 days 00:01:05,-1,4,5
36,CAN,P004160,P006588,0 days 00:00:52,0,0,0
36,CAN,P004160,P008121,0 days 00:00:52,0,0,0
36,CAN,P006588,P010452,0 days 00:00:38,0,2,2
36,CAN,P003425,P004160,0 days 00:00:32,0,0,0
36,CAN,P004160,P007560,0 days 00:00:11,-2,0,2
36,BOU,P004525,P012628,0 days 00:15:12,-18,22,40
36,BOU,P010449,P011836,0 days 00:15:01,-3,33,36
36,BOU,P000498,P004525,0 days 00:14:44,-15,19,34
36,BOU,P010431,P011836,0 days 00:14:33,10,44,34
36,BOU,P010431,P010718,0 days 00:14:15,20,47,27
36,BOU,P004525,P011161,0 days 00:14:12,-13,21,34
36,BOU,P011836,P011837,0 days 00:14:03,12,41,29
36,BOU,P010718,P011836,0 days 00:13:43,10,39,29
36,BOU,P010431,P011837,0 days 00:13:13,11,39,28
36,BOU,P004525,P012619,0 days 00:12:55,-2,18,20
36,BOU,P010718,P011837,0 days 00:12:53,12,39,27
36,BOU,P000498,P011837,0 days 00:11:38,-1,25,26
36,BOU,P011161,P012628,0 days 00:10:58,-13,17,30
36,BOU,P010431,P010449,0 days 00:10:31,0,28,28
36,BOU,P004525,P010431,0 days 00:10:28,0,15,15
36,BOU,P000498,P010431,0 days 00:09:49,10,22,12
36,BOU,P000498,P011161,0 days 00:09:29,-15,13,28
36,BOU,P010449,P011837,0 days 00:09:29,2,25,23
36,BOU,P011837,P012628,0 days 00:09:14,-13,11,24
36,BOU,P000498,P012628,0 days 00:09:10,-16,13,29
36,BOU,P010449,P010718,0 days 00:09:09,0,23,23
36,BOU,P011161,P012619,0 days 00:09:00,-5,12,17
36,BOU,P004525,P010718,0 days 00:08:45,0,12,12
36,BOU,P012619,P012628,0 days 00:08:32,-8,11,19
36,BOU,P000498,P012619,0 days 00:08:06,-6,10,16
36,BOU,P010718,P012619,0 days 00:07:55,2,12,10
36,BOU,P000498,P010718,0 days 00:07:34,10,20,10
36,BOU,P010718,P011161,0 days 00:07:32,-2,8,10
36,BOU,P011836,P012628,0 days 00:07:18,-7,10,17
36,BOU,P004525,P011837,0 days 00:07:04,-11,9,20
36,BOU,P010449,P012628,0 days 00:06:52,-5,10,15
36,BOU,P010450,P012619,0 days 00:05:46,-4,5,9
36,BOU,P011161,P011837,0 days 00:05:44,-8,9,17
36,BOU,P010431,P012619,0 days 00:05:24,7,10,3
36,BOU,P000498,P011836,0 days 00:05:00,8,16,8
36,BOU,P010718,P012628,0 days 00:04:46,-4,4,8
36,BOU,P010431,P012628,0 days 00:04:34,-5,5,10
36,BOU,P010450,P011836,0 days 00:03:56,-3,5,8
36,BOU,P010450,P012628,0 days 00:03:56,-3,5,8
36,BOU,P010449,P010450,0 days 00:03:30,-1,5,6
36,BOU,P000498,P010450,0 days 00:03:26,-3,2,5
36,BOU,P004525,P010449,0 days 00:03:12,-4,5,9
36,BOU,P004525,P011836,0 days 00:03:12,-4,5,9
36,BOU,P010431,P010450,0 days 00:03:00,-1,2,3
36,BOU,P004525,P010450,0 days 00:03:00,-1,2,3
36,BOU,P011836,P012619,0 days 00:02:46,-3,3,6
36,BOU,P010449,P012619,0 days 00:02:20,-1,3,4
36,BOU,P010431,P011161,0 days 00:01:29,4,4,0
36,BOU,P010450,P011837,0 days 00:01:10,0,2,2
36,BOU,P011161,P011836,0 days 00:00:32,0,0,0
37,LKB,P002012,P008856,0 days 00:27:42,4,69,65
37,LKB,P002012,PLXI,0 days 00:25:42,14,63,49
37,LKB,P002012,P007029,0 days 00:25:16,10,67,57
37,LKB,P007029,P008856,0 days 00:24:35,6,65,59
37,LKB,P008856,PLXI,0 days 00:24:26,12,63,51
37,LKB,P007029,PLXI,0 days 00:21:16,16,59,43
37,LKB,P007029,P012583,0 days 00:12:53,1,33,32
37,LKB,P007029,P010461,0 days 00:12:33,2,26,24
37,LKB,P005521,P010190,0 days 00:12:15,-3,23,26
37,LKB,P008856,P010461,0 days 00:11:44,-2,26,28
37,LKB,P002012,P010461,0 days 00:11:44,-2,26,28
37,LKB,P005521,P007029,0 days 00:11:33,-6,28,34
37,LKB,P010461,PLXI,0 days 00:10:13,1,24,23
37,LKB,P006230,P007029,0 days 00:09:49,5,30,25
37,LKB,P006230,PLXI,0 days 00:09:26,-4,17,21
37,LKB,P002012,P006230,0 days 00:09:23,1,19,18
37,LKB,P005521,P006230,0 days 00:09:09,4,17,13
37,LKB,P006230,P008856,0 days 00:08:48,-4,17,21
37,LKB,P008856,P012583,0 days 00:08:41,5,26,21
37,LKB,P002012,P012583,0 days 00:08:38,7,26,19
37,LKB,P002012,P005521,0 days 00:08:32,-12,12,24
37,LKB,P007029,P010190,0 days 00:08:14,4,22,18
37,LKB,P012583,PLXI,0 days 00:08:07,8,23,15
37,LKB,P005521,P008856,0 days 00:07:57,-17,10,27
37,LKB,P006230,P010190,0 days 00:07:36,2,15,13
37,LKB,P005521,P012583,0 days 00:07:14,-15,12,27
37,LKB,P006901,P010190,0 days 00:06:59,0,19,19
37,LKB,P005521,P006901,0 days 00:06:59,0,19,19
37,LKB,P005521,PLXI,0 days 00:05:43,-8,5,13
37,LKB,P005521,P010461,0 days 00:05:34,-11,6,17
37,LKB,P010190,P012583,0 days 00:05:26,-8,8,16
37,LKB,P006901,P007029,0 days 00:05:07,2,18,16
37,LKB,P006230,P006901,0 days 00:04:46,3,13,10
37,LKB,P010190,PLXI,0 days 00:02:33,-4,1,5
37,LKB,P010190,P010461,0 days 00:02:26,-2,2,4
37,LKB,P010461,P012583,0 days 00:02:26,-2,2,4
37,LKB,P006901,P012583,0 days 00:02:16,-5,6,11
37,LKB,P002012,P010190,0 days 00:02:03,2,2,0
37,LKB,P006901,P008856,0 days 00:01:31,-5,0,5
37,LKB,P008856,P010190,0 days 00:01:28,-3,0,3
37,LKB,P006230,P012583,0 days 00:00:47,-3,0,3
37,LKB,P006901,PLXI,0 days 00:00:30,-3,1,4
37,TRN,P005738,P012595,0 days 00:21:16,-7,41,48
37,TRN,P009903,P012595,0 days 00:19:28,-5,39,44
37,TRN,P005059,P012593,0 days 00:19:05,1,50,49
37,TRN,P005738,P009903,0 days 00:18:39,-3,36,39
37,TRN,P009903,P012594,0 days 00:18:23,-4,37,41
37,TRN,P012594,P012595,0 days 00:18:22,-4,37,41
37,TRN,P012593,P012596,0 days 00:17:08,4,50,46
37,TRN,P005738,P012594,0 days 00:16:34,-2,34,36
37,TRN,P005059,P012596,0 days 00:16:19,0,44,44
37,TRN,P001479,P012593,0 days 00:14:47,11,44,33
37,TRN,P001479,P005059,0 days 00:13:23,7,38,31
37,TRN,P001479,P012596,0 days 00:13:15,9,40,31
37,TRN,P005059,P012595,0 days 00:13:15,-3,28,31
37,TRN,P005059,P005738,0 days 00:12:12,-1,25,26
37,TRN,P012593,P012595,0 days 00:10:29,-14,19,33
37,TRN,P007828,P012593,0 days 00:10:20,7,32,25
37,TRN,P001479,P007828,0 days 00:09:45,6,30,24
37,TRN,P005738,P012593,0 days 00:09:43,-12,16,28
37,TRN,P005059,P007828,0 days 00:09:31,3,26,23
37,TRN,P005059,P009903,0 days 00:09:16,6,19,13
37,TRN,P007828,P012596,0 days 00:08:41,5,28,23
37,TRN,P009903,P012593,0 days 00:07:22,-5,10,15
37,TRN,P007828,P009903,0 days 00:06:46,-4,11,15
37,TRN,P012595,P012596,0 days 00:06:31,-7,13,20
37,TRN,P007828,P012594,0 days 00:05:56,-2,13,15
37,TRN,P005738,P007828,0 days 00:05:42,-5,9,14
37,TRN,P005059,P012594,0 days 00:05:39,5,13,8
37,TRN,P012593,P012594,0 days 00:05:26,-2,10,12
37,TRN,P007828,P012595,0 days 00:05:07,-6,7,13
37,TRN,P005738,P012596,0 days 00:04:45,-5,10,15
37,TRN,P006382,P009903,0 days 00:04:45,3,13,10
37,TRN,P006382,P012595,0 days 00:04:45,3,13,10
37,TRN,P006382,P012594,0 days 00:04:45,3,13,10
37,TRN,P005738,P006382,0 days 00:04:45,3,13,10
37,TRN,P001479,P012595,0 days 00:04:43,-5,11,16
37,TRN,P006382,P012596,0 days 00:03:40,6,9,3
37,TRN,P006382,P012593,0 days 00:03:40,6,9,3
37,TRN,P005059,P006382,0 days 00:03:40,6,9,3
37,TRN,P001479,P006382,0 days 00:03:40,6,9,3
37,TRN,P001479,P012594,0 days 00:03:30,2,9,7
37,TRN,P001479,P009903,0 days 00:03:21,0,7,7
37,TRN,P012594,P012596,0 days 00:01:41,4,6,2
38,TTK,P011925,P012056,0 days 00:23:20,-5,45,50
38,TTK,P005000,P011925,0 days 00:22:40,6,54,48
38,TTK,P011239,P011925,0 days 00:22:36,6,52,46
38,TTK,P011239,P012056,0 days 00:21:58,-10,41,51
38,TTK,P005000,P011239,0 days 00:20:18,13,52,39
38,TTK,P011834,P012697,0 days 00:18:10,-5,36,41
38,TTK,P005000,P012056,0 days 00:17:56,-5,39,44
38,TTK,P006693,P011925,0 days 00:16:36,-3,34,37
38,TTK,P006693,P012056,0 days 00:16:36,-12,35,47
38,TTK,P011925,P012697,0 days 00:16:31,2,32,30
38,TTK,P006693,P011239,0 days 00:15:00,-3,32,35
38,TTK,P005000,P006693,0 days 00:14:38,-4,34,38
38,TTK,P011834,P011925,0 days 00:14:13,-1,25,26
38,TTK,P012056,P012697,0 days 00:12:58,-16,18,34
38,TTK,P005685,P011834,0 days 00:12:12,-1,22,23
38,TTK,P011834,P012056,0 days 00:11:46,-24,14,38
38,TTK,P004801,P011834,0 days 00:11:02,-5,18,23
38,TTK,P005000,P012697,0 days 00:10:42,-7,22,29
38,TTK,P011239,P012697,0 days 00:10:32,2,22,20
38,TTK,P005685,P012697,0 days 00:10:21,1,19,18
38,TTK,P004801,P012697,0 days 00:08:28,0,15,15
38,TTK,P011239,P011834,0 days 00:08:13,-4,15,19
38,TTK,P004801,P005685,0 days 00:07:41,3,16,13
38,TTK,P005685,P011925,0 days 00:07:37,0,10,10
38,TTK,P005685,P012056,0 days 00:06:30,-3,12,15
38,TTK,P006693,P011834,0 days 00:06:07,-21,5,26
38,TTK,P005000,P011834,0 days 00:05:57,-4,15,19
38,TTK,P004801,P012056,0 days 00:05:16,-9,8,17
38,TTK,P004801,P011239,0 days 00:03:31,-8,2,10
38,TTK,P004801,P011925,0 days 00:03:31,3,4,1
38,TTK,P004801,P006693,0 days 00:02:48,-5,3,8
38,TTK,P000497,P004801,0 days 00:02:08,1,6,5
38,TTK,P000497,P012697,0 days 00:02:08,1,6,5
38,TTK,P000497,P011834,0 days 00:02:08,1,6,5
38,TTK,P000497,P005685,0 days 00:02:08,1,6,5
38,TTK,P005685,P006693,0 days 00:02:05,-2,3,5
38,TTK,P006693,P012697,0 days 00:01:50,-10,2,12
38,TTK,P005000,P005685,0 days 00:01:10,-3,0,3
38,TTK,P004801,P005000,0 days 00:00:39,0,0,0
38,ULM,P012603,P012703,0 days 00:22:23,17,60,43
38,ULM,P012629,P012703,0 days 00:21:56,7,54,47
38,ULM,P005422,P012703,0 days 00:21:53,7,50,43
38,ULM,P012604,P012703,0 days 00:18:44,22,54,32
38,ULM,P005422,P012629,0 days 00:18:26,-3,38,41
38,ULM,P005422,P012604,0 days 00:17:11,13,44,31
38,ULM,P005422,P012603,0 days 00:16:50,8,42,34
38,ULM,P012604,P012629,0 days 00:16:30,15,44,29
38,ULM,P012603,P012629,0 days 00:16:00,11,43,32
38,ULM,P012603,P012604,0 days 00:15:34,19,48,29
38,ULM,P010582,P012703,0 days 00:14:29,18,41,23
38,ULM,P005422,P010582,0 days 00:12:56,16,36,20
38,ULM,P010582,P012604,0 days 00:11:26,18,35,17
38,ULM,P006997,P010582,0 days 00:11:24,-3,17,20
38,ULM,P010582,P012603,0 days 00:10:52,11,31,20
38,ULM,P010582,P010726,0 days 00:09:49,-2,16,18
38,ULM,P007952,P012703,0 days 00:09:31,-7,17,24
38,ULM,P010582,P011457,0 days 00:09:31,-4,14,18
38,ULM,P007952,P010582,0 days 00:09:27,0,18,18
38,ULM,P005422,P007952,0 days 00:09:25,-4,19,23
38,ULM,P011457,P012703,0 days 00:08:44,-3,18,21
38,ULM,P006997,P010726,0 days 00:08:20,-2,11,13
38,ULM,P007952,P011457,0 days 00:07:46,-7,11,18
38,ULM,P010582,P012629,0 days 00:07:18,10,20,10
38,ULM,P011457,P012603,0 days 00:07:00,0,14,14
38,ULM,P006997,P007952,0 days 00:06:56,0,13,13
38,ULM,P006997,P011457,0 days 00:06:39,-4,9,13
38,ULM,P007952,P012603,0 days 00:06:22,-2,13,15
38,ULM,P007952,P012629,0 days 00:06:16,-8,10,18
38,ULM,P007952,P010726,0 days 00:05:53,0,11,11
38,ULM,P005422,P010726,0 days 00:04:55,2,13,11
38,ULM,P010726,P011457,0 days 00:03:54,-4,3,7
38,ULM,P005422,P006997,0 days 00:03:26,2,8,6
38,ULM,P006997,P012603,0 days 00:03:13,-2,4,6
38,ULM,P011457,P012629,0 days 00:03:07,-3,7,10
38,ULM,P006997,P012703,0 days 00:03:04,-1,6,7
38,ULM,P010726,P012603,0 days 00:02:54,-2,5,7
38,ULM,P010726,P012604,0 days 00:02:27,0,5,5
38,ULM,P005422,P011457,0 days 00:02:10,-5,2,7
38,ULM,P011457,P012604,0 days 00:01:41,2,6,4
38,ULM,P006997,P012629,0 days 00:01:23,-1,0,1
38,ULM,P006997,P012604,0 days 00:01:11,-1,0,1
38,ULM,P010726,P012629,0 days 00:01:04,0,0,0
39,WRO,P005531,P012699,0 days 00:20:10,-1,39,40
39,WRO,P001694,P005531,0 days 00:18:57,-8,32,40
39,WRO,P001694,P011165,0 days 00:18:44,-5,32,37
39,WRO,P001694,P003034,0 days 00:18:19,0,28,28
39,WRO,P001694,P012699,0 days 00:18:05,-2,32,34
39,WRO,P009896,P011165,0 days 00:14:13,-16,20,36
39,WRO,P001694,P012736,0 days 00:14:12,-6,16,22
39,WRO,P005531,P011165,0 days 00:13:57,-5,26,31
39,WRO,P011165,P012699,0 days 00:13:55,-7,26,33
39,WRO,P001694,P009896,0 days 00:12:18,-9,18,27
39,WRO,P003034,P005531,0 days 00:12:14,-3,21,24
39,WRO,P009896,P012699,0 days 00:11:56,-11,18,29
39,WRO,P005531,P009896,0 days 00:11:31,-5,20,25
39,WRO,P003034,P012699,0 days 00:10:44,3,21,18
39,WRO,P003034,P012736,0 days 00:09:31,-3,11,14
39,WRO,P001694,P011901,0 days 00:09:04,1,12,11
39,WRO,P003034,P011901,0 days 00:08:46,-3,11,14
39,WRO,P009896,P012736,0 days 00:08:43,-2,13,15
39,WRO,P005531,P011901,0 days 00:08:33,-3,13,16
39,WRO,P009896,P011902,0 days 00:08:29,-7,15,22
39,WRO,P003034,P011165,0 days 00:08:27,7,19,12
39,WRO,P011165,P012736,0 days 00:08:24,0,13,13
39,WRO,P011901,P012736,0 days 00:07:09,0,11,11
39,WRO,P011900,P012736,0 days 00:06:57,-1,9,10
39,WRO,P011901,P012699,0 days 00:06:56,0,11,11
39,WRO,P001694,P012749,0 days 00:05:24,-8,5,13
39,WRO,P012736,P012749,0 days 00:05:18,-7,5,12
39,WRO,P009896,P011901,0 days 00:05:07,3,11,8
39,WRO,P001694,P011900,0 days 00:05:01,-1,5,6
39,WRO,P011901,P011902,0 days 00:04:49,-1,10,11
39,WRO,P005531,P011902,0 days 00:04:48,0,9,9
39,WRO,P009896,P011900,0 days 00:04:45,-5,8,13
39,WRO,P011902,P012699,0 days 00:04:35,-6,7,13
39,WRO,P011165,P012749,0 days 00:04:16,-6,3,9
39,WRO,P011902,P012736,0 days 00:04:02,1,8,7
39,WRO,P011165,P011900,0 days 00:03:59,-2,6,8
39,WRO,P011165,P011902,0 days 00:03:56,-4,7,11
39,WRO,P009896,P012749,0 days 00:03:48,-9,5,14
39,WRO,P003034,P012749,0 days 00:03:29,-3,2,5
39,WRO,P003034,P011900,0 days 00:03:17,-3,3,6
39,WRO,P005531,P012736,0 days 00:03:04,-3,4,7
39,WRO,P011900,P011902,0 days 00:03:01,-7,6,13
39,WRO,P012699,P012736,0 days 00:02:53,-1,2,3
39,WRO,P011900,P011901,0 days 00:02:44,-1,3,4
39,WRO,P012308,P012736,0 days 00:02:43,2,4,2
39,WRO,P001694,P012308,0 days 00:02:24,2,4,2
39,WRO,P009896,P012308,0 days 00:02:18,-3,4,7
39,WRO,P012308,P012749,0 days 00:01:54,-3,4,7
39,WRO,P011902,P012749,0 days 00:01:53,-4,2,6
39,WRO,P011901,P012308,0 days 00:01:35,2,2,0
39,WRO,P005531,P012749,0 days 00:01:13,-2,0,2
39,WRO,P003034,P012308,0 days 00:01:11,2,2,0
39,WRO,P012699,P012749,0 days 00:01:07,-3,0,3
39,WRO,P011902,P012308,0 days 00:01:05,-3,2,5
39,WRO,P003034,P011902,0 days 00:00:54,-1,2,3
39,WRO,P011165,P011901,0 days 00:00:49,2,4,2
39,WRO,P011900,P012308,0 days 00:00:46,-3,2,5
39,WRO,P011900,P012749,0 days 00:00:46,-3,2,5
39,WRO,P005531,P011900,0 days 00:00:33,-2,0,2
39,WRO,P011900,P012699,0 days 00:00:19,-4,0,4
39,ARI,P012708,P012716,0 days 00:20:41,23,47,24
39,ARI,P004292,P012716,0 days 00:18:00,9,41,32
39,ARI,P004292,P012708,0 days 00:17:57,13,39,26
39,ARI,P004292,P012615,0 days 00:17:48,7,36,29
39,ARI,P012707,P012716,0 days 00:16:44,0,28,28
39,ARI,P003240,P012708,0 days 00:16:25,7,25,18
39,ARI,P012615,P012716,0 days 00:16:05,11,37,26
39,ARI,P003240,P012716,0 days 00:15:11,5,28,23
39,ARI,P012615,P012708,0 days 00:14:19,12,31,19
39,ARI,P003240,P012707,0 days 00:12:31,-1,19,20
39,ARI,P012716,P012760,0 days 00:12:04,8,25,17
39,ARI,P012702,P012716,0 days 00:11:16,5,25,20
39,ARI,P003240,P004292,0 days 00:10:28,1,17,16
39,ARI,P012708,P012760,0 days 00:10:27,11,22,11
39,ARI,P012615,P012707,0 days 00:09:59,-3,15,18
39,ARI,P003240,P012760,0 days 00:09:54,6,18,12
39,ARI,P003240,P012615,0 days 00:09:12,0,13,13
39,ARI,P012615,P012702,0 days 00:09:09,8,22,14
39,ARI,P004292,P012760,0 days 00:08:56,3,20,17
39,ARI,P012707,P012708,0 days 00:08:27,13,17,4
39,ARI,P004292,P012722,0 days 00:08:17,3,15,12
39,ARI,P012615,P012722,0 days 00:07:56,3,16,13
39,ARI,P002867,P012716,0 days 00:07:49,0,17,17
39,ARI,P012702,P012708,0 days 00:07:45,12,21,9
39,ARI,P002867,P012707,0 days 00:07:45,-11,8,19
39,ARI,P003240,P012722,0 days 00:07:31,3,13,10
39,ARI,P012707,P012760,0 days 00:07:29,4,12,8
39,ARI,P012702,P012707,0 days 00:07:09,-3,11,14
39,ARI,P012716,P012722,0 days 00:06:31,3,14,11
39,ARI,P012708,P012722,0 days 00:06:29,1,9,8
39,ARI,P002867,P003240,0 days 00:05:48,-6,10,16
39,ARI,P002867,P012615,0 days 00:05:38,0,8,8
39,ARI,P012615,P012760,0 days 00:05:19,-2,6,8
39,ARI,P012707,P012722,0 days 00:05:14,-2,9,11
39,ARI,P004292,P012702,0 days 00:05:14,7,16,9
39,ARI,P002867,P012702,0 days 00:04:38,-8,6,14
39,ARI,P003240,P012702,0 days 00:04:21,-5,7,12
39,ARI,P004292,P012707,0 days 00:04:10,-1,9,10
39,ARI,P002867,P012760,0 days 00:03:16,1,6,5
39,ARI,P002867,P012722,0 days 00:02:33,4,7,3
39,ARI,P002867,P004292,0 days 00:02:23,4,7,3
39,ARI,P004292,P012616,0 days 00:01:57,3,7,4
39,ARI,P012616,P012760,0 days 00:01:25,2,6,4
39,ARI,P012616,P012716,0 days 00:01:11,0,2,2
39,ARI,P002867,P012708,0 days 00:01:06,4,5,1
39,ARI,P003240,P012616,0 days 00:01:05,3,5,2
39,ARI,P002867,P012616,0 days 00:00:52,0,2,2
39,ARI,P003240,P010387,0 days 00:00:46,3,5,2
39,ARI,P004292,P010387,0 days 00:00:46,3,5,2
39,ARI,P010387,P012616,0 days 00:00:46,3,5,2
39,ARI,P010387,P012760,0 days 00:00:46,3,5,2
39,ARI,P012615,P012616,0 days 00:00:19,0,0,0
39,ARI,P012616,P012722,0 days 00:00:13,1,1,0
40,CLU,P010569,P011801,0 days 00:23:53,14,56,42
40,CLU,P011801,P012621,0 days 00:21:14,17,55,38
40,CLU,P010569,P012621,0 days 00:19:21,13,48,35
40,CLU,P011801,P012698,0 days 00:18:57,1,39,38
40,CLU,P005714,P012621,0 days 00:18:17,6,41,35
40,CLU,P010569,P012698,0 days 00:17:51,6,39,33
40,CLU,P005714,P011797,0 days 00:14:50,3,32,29
40,CLU,P004862,P012621,0 days 00:14:46,-1,29,30
40,CLU,P005113,P011797,0 days 00:14:44,7,32,25
40,CLU,P005113,P012621,0 days 00:14:26,8,32,24
40,CLU,P011797,P012621,0 days 00:14:05,3,30,27
40,CLU,P004862,P005113,0 days 00:13:38,-1,24,25
40,CLU,P012621,P012698,0 days 00:12:40,5,30,25
40,CLU,P004862,P011797,0 days 00:12:29,2,25,23
40,CLU,P005373,P011801,0 days 00:10:55,1,25,24
40,CLU,P004862,P005714,0 days 00:10:49,4,24,20
40,CLU,P005113,P005714,0 days 00:10:27,5,24,19
40,CLU,P005714,P011801,0 days 00:10:24,5,25,20
40,CLU,P005113,P011801,0 days 00:10:21,8,22,14
40,CLU,P005373,P012621,0 days 00:10:11,1,23,22
40,CLU,P005373,P010569,0 days 00:10:04,4,25,21
40,CLU,P005373,P012698,0 days 00:10:03,4,23,19
40,CLU,P005714,P012698,0 days 00:09:34,7,25,18
40,CLU,P004862,P010569,0 days 00:09:03,1,18,17
40,CLU,P005113,P010569,0 days 00:08:43,2,15,13
40,CLU,P011797,P011801,0 days 00:08:06,3,17,14
40,CLU,P004862,P011801,0 days 00:07:46,3,17,14
40,CLU,P005714,P010569,0 days 00:06:23,6,17,11
40,CLU,P004862,P005373,0 days 00:06:14,6,18,12
40,CLU,P011797,P012698,0 days 00:05:59,0,12,12
40,CLU,P010569,P011797,0 days 00:05:22,2,10,8
40,CLU,P005373,P011797,0 days 00:05:13,0,10,10
40,CLU,P004862,P012698,0 days 00:04:43,6,13,7
40,CLU,P005113,P012698,0 days 00:04:21,-1,7,8
40,CLU,P005373,P005714,0 days 00:04:08,0,8,8
40,BUD,P011935,P012606,0 days 00:29:18,-5,57,62
40,BUD,P010432,P011935,0 days 00:28:56,-2,58,60
40,BUD,P010432,P012606,0 days 00:27:15,-4,54,58
40,BUD,P004945,P012606,0 days 00:21:08,-2,40,42
40,BUD,P004945,P010432,0 days 00:21:01,-6,37,43
40,BUD,P004945,P011935,0 days 00:20:19,-1,38,39
40,BUD,P007398,P010432,0 days 00:17:04,-8,29,37
40,BUD,P007398,P011935,0 days 00:16:26,-6,31,37
40,BUD,P002740,P010432,0 days 00:15:30,-5,28,33
40,BUD,P011935,P012630,0 days 00:14:31,-2,32,34
40,BUD,P007398,P012606,0 days 00:13:22,-7,23,30
40,BUD,P002740,P012606,0 days 00:12:51,-1,26,27
40,BUD,P010432,P012630,0 days 00:12:49,-2,25,27
40,BUD,P002740,P011935,0 days 00:12:02,0,24,24
40,BUD,P012606,P012630,0 days 00:11:27,-3,24,27
40,BUD,P007398,P012630,0 days 00:11:01,-5,23,28
40,BUD,P002740,P004945,0 days 00:09:52,-3,19,22
40,BUD,P004945,P007398,0 days 00:09:43,-4,13,17
40,BUD,P010432,P012605,0 days 00:08:54,-5,13,18
40,BUD,P006566,P012605,0 days 00:07:23,-10,9,19
40,BUD,P007398,P012605,0 days 00:07:11,-4,13,17
40,BUD,P012605,P012630,0 days 00:07:11,-4,13,17
40,BUD,P006566,P012630,0 days 00:07:01,-7,12,19
40,BUD,P004945,P006566,0 days 00:05:48,-7,9,16
40,BUD,P002740,P012630,0 days 00:05:20,-1,9,10
40,BUD,P006566,P010432,0 days 00:05:15,-8,4,12
40,BUD,P011935,P012605,0 days 00:05:02,2,13,11
40,BUD,P006566,P007398,0 days 00:04:41,-5,7,12
40,BUD,P004945,P012605,0 days 00:04:40,-4,7,11
40,BUD,P002740,P006566,0 days 00:03:34,-7,4,11
40,BUD,P006566,P012606,0 days 00:03:09,-3,7,10
40,BUD,P006566,P011935,0 days 00:02:54,-2,7,9
40,BUD,P004945,P012630,0 days 00:02:49,-1,5,6
40,BUD,P002740,P012605,0 days 00:02:42,-5,2,7
40,BUD,P006561,P012630,0 days 00:02:23,-3,5,8
40,BUD,P006561,P012605,0 days 00:02:23,-3,5,8
40,BUD,P006561,P007398,0 days 00:02:23,-3,5,8
40,BUD,P006561,P006566,0 days 00:02:23,-3,5,8
40,BUD,P012605,P012606,0 days 00:01:58,1,5,4
40,BUD,P002740,P007398,0 days 00:00:21,-2,0,2
41,PMT,P011823,P011944,0 days 00:25:54,-10,45,55
41,PMT,P011944,P012600,0 days 00:18:15,-12,32,44
41,PMT,P009559,P011944,0 days 00:17:59,-3,31,34
41,PMT,P011066,P011944,0 days 00:16:03,-12,25,37
41,PMT,P011823,P012600,0 days 00:15:06,-7,29,36
41,PMT,P011947,P012600,0 days 00:14:50,5,37,32
41,PMT,P011943,P011944,0 days 00:14:41,-4,25,29
41,PMT,P011823,P011943,0 days 00:14:41,-4,25,29
41,PMT,P009559,P011066,0 days 00:14:14,-1,26,27
41,PMT,P009559,P011823,0 days 00:13:42,-1,23,24
41,PMT,P002644,P012600,0 days 00:13:11,-9,30,39
41,PMT,P011066,P011823,0 days 00:13:00,-2,21,23
41,PMT,P009559,P012600,0 days 00:12:29,1,27,26
41,PMT,P009559,P011947,0 days 00:11:36,1,29,28
41,PMT,P011066,P012600,0 days 00:11:01,-7,23,30
41,PMT,P011944,P011947,0 days 00:10:48,0,23,23
41,PMT,P009559,P011943,0 days 00:10:24,0,18,18
41,PMT,P011966,P012600,0 days 00:09:36,-4,23,27
41,PMT,P002644,P011947,0 days 00:09:35,1,25,24
41,PMT,P002644,P009559,0 days 00:09:26,-2,22,24
41,PMT,P011823,P011947,0 days 00:09:21,-1,22,23
41,PMT,P011823,P011966,0 days 00:08:46,-2,18,20
41,PMT,P011066,P011943,0 days 00:08:41,2,14,12
41,PMT,P002644,P011944,0 days 00:08:20,-14,13,27
41,PMT,P002644,P011066,0 days 00:08:07,-9,19,28
41,PMT,P011944,P011966,0 days 00:07:17,-3,13,16
41,PMT,P011946,P011966,0 days 00:06:52,-2,14,16
41,PMT,P011947,P011966,0 days 00:05:52,-1,16,17
41,PMT,P011066,P011947,0 days 00:05:42,3,16,13
41,PMT,P011823,P011946,0 days 00:05:23,-2,9,11
41,PMT,P011946,P012600,0 days 00:05:01,-1,12,13
41,PMT,P011944,P011946,0 days 00:04:57,-2,9,11
41,PMT,P011943,P011947,0 days 00:03:56,-4,10,14
41,PMT,P002644,P011823,0 days 00:03:24,-5,8,13
41,PMT,P002020,P011944,0 days 00:03:18,-12,4,16
41,PMT,P002020,P002644,0 days 00:03:12,-10,4,14
41,PMT,P002020,P011066,0 days 00:03:12,-10,4,14
41,PMT,P002644,P011966,0 days 00:02:53,-4,7,11
41,PMT,P011943,P012600,0 days 00:02:24,-2,4,6
41,PMT,P002020,P012600,0 days 00:02:06,-8,2,10
41,PMT,P011946,P011947,0 days 00:01:55,0,5,5
41,PMT,P011943,P011966,0 days 00:01:51,-1,2,3
41,PMT,P011943,P011946,0 days 00:01:51,-1,2,3
41,PMT,P002020,P009559,0 days 00:01:30,-4,2,6
41,PMT,P011947,P012601,0 days 00:01:29,0,5,5
41,PMT,P011966,P012601,0 days 00:01:29,0,5,5
41,PMT,P012600,P012601,0 days 00:01:29,0,5,5
41,PMT,P011946,P012601,0 days 00:01:29,0,5,5
41,PMT,P009559,P011966,0 days 00:01:12,-3,2,5
41,PMT,P002020,P011823,0 days 00:00:15,-2,0,2
41,PMT,P002020,P011943,0 days 00:00:15,-2,0,2
41,PRS,P012610,P012613,0 days 00:25:09,15,58,43
41,PRS,P012608,P012610,0 days 00:25:08,15,58,43
41,PRS,P012608,P012613,0 days 00:25:08,15,58,43
41,PRS,P012609,P012640,0 days 00:20:09,1,49,48
41,PRS,P012611,P012613,0 days 00:18:21,16,42,26
41,PRS,P012608,P012611,0 days 00:18:21,16,42,26
41,PRS,P012610,P012611,0 days 00:18:21,16,42,26
41,PRS,P004512,P012610,0 days 00:18:07,14,40,26
41,PRS,P004512,P012613,0 days 00:18:07,14,40,26
41,PRS,P004512,P012608,0 days 00:18:06,14,40,26
41,PRS,P004512,P012611,0 days 00:18:06,14,40,26
41,PRS,P005793,P009556,0 days 00:14:51,2,38,36
41,PRS,P003481,P005793,0 days 00:14:11,0,36,36
41,PRS,P003481,P009556,0 days 00:14:11,0,36,36
41,PRS,P005793,P012609,0 days 00:13:23,2,33,31
41,PRS,P009556,P012640,0 days 00:13:22,2,33,31
41,PRS,P005793,P012640,0 days 00:13:22,2,33,31
41,PRS,P009556,P012609,0 days 00:13:22,2,33,31
41,PRS,P003481,P012609,0 days 00:12:42,0,31,31
41,PRS,P003481,P012640,0 days 00:12:42,0,31,31
41,PRS,P012613,P012640,0 days 00:07:02,1,18,17
41,PRS,P012608,P012640,0 days 00:07:02,1,18,17
41,PRS,P012610,P012640,0 days 00:07:02,1,18,17
41,PRS,P012609,P012610,0 days 00:06:48,-1,16,17
41,PRS,P012609,P012613,0 days 00:06:48,-1,16,17
41,PRS,P012608,P012609,0 days 00:06:47,-1,16,17
41,PRS,P003481,P010801,0 days 00:01:29,0,5,5
41,PRS,P003481,P011887,0 days 00:01:29,0,5,5
41,PRS,P005793,P010801,0 days 00:01:29,0,5,5
41,PRS,P005793,P011887,0 days 00:01:29,0,5,5
41,PRS,P009556,P010801,0 days 00:01:29,0,5,5
41,PRS,P009556,P011887,0 days 00:01:29,0,5,5
41,PRS,P010801,P011887,0 days 00:01:29,0,5,5
41,PRS,P004512,P005793,0 days 00:00:41,2,2,0
41,PRS,P004512,P012609,0 days 00:00:41,2,2,0
41,PRS,P004512,P009556,0 days 00:00:40,2,2,0
41,PRS,P004512,P012640,0 days 00:00:40,2,2,0
41,PRS,P012611,P012640,0 days 00:00:15,2,2,0
41,PRS,P005793,P012610,0 days 00:00:01,0,0,0
41,PRS,P005793,P012613,0 days 00:00:01,0,0,0
42,LLI,P006600,P012585,0 days 00:26:56,0,68,68
42,LLI,P006600,P012586,0 days 00:25:29,-6,57,63
42,LLI,P005247,P009680,0 days 00:23:54,9,65,56
42,LLI,P005247,P006600,0 days 00:22:25,13,65,52
42,LLI,P012585,P012586,0 days 00:20:28,-7,46,53
42,LLI,P006600,P009680,0 days 00:19:42,13,58,45
42,LLI,P005247,P012585,0 days 00:19:27,12,56,44
42,LLI,P006600,P009649,0 days 00:18:51,0,47,47
42,LLI,P009649,P012586,0 days 00:18:40,-8,36,44
42,LLI,P009680,P012585,0 days 00:17:16,10,49,39
42,LLI,P005247,P012586,0 days 00:15:57,6,43,37
42,LLI,P009649,P012585,0 days 00:15:28,-5,36,41
42,LLI,P009680,P012586,0 days 00:14:34,2,36,34
42,LLI,P004479,P012586,0 days 00:12:50,-18,18,36
42,LLI,P004479,P009649,0 days 00:12:18,-16,18,34
42,LLI,P004479,P012585,0 days 00:09:59,-11,16,27
42,LLI,P004479,P006600,0 days 00:09:58,-13,16,29
42,LLI,P005247,P009649,0 days 00:09:19,12,33,21
42,LLI,P009649,P009680,0 days 00:08:45,4,26,22
42,LLI,P004773,P005247,0 days 00:07:01,-6,12,18
42,LLI,P003850,P004479,0 days 00:06:33,-9,9,18
42,LLI,P004773,P009680,0 days 00:06:12,-2,12,14
42,LLI,P003850,P009680,0 days 00:05:32,-8,7,15
42,LLI,P004479,P009680,0 days 00:05:01,-8,7,15
42,LLI,P004773,P006600,0 days 00:04:27,-3,5,8
42,LLI,P004773,P012585,0 days 00:04:19,1,7,6
42,LLI,P004479,P005247,0 days 00:04:13,-6,7,13
42,LLI,P003850,P005247,0 days 00:04:12,-4,7,11
42,LLI,P003850,P012586,0 days 00:03:51,-5,4,9
42,LLI,P003850,P009649,0 days 00:03:51,-5,4,9
42,LLI,P003850,P004773,0 days 00:03:39,-4,7,11
42,LLI,P004773,P012586,0 days 00:03:00,-7,0,7
42,LLI,P004479,P004773,0 days 00:02:41,-6,5,11
42,LLI,P003850,P008274,0 days 00:02:31,-1,4,5
42,LLI,P008274,P012586,0 days 00:02:31,-1,4,5
42,LLI,P008274,P009649,0 days 00:02:31,-1,4,5
42,LLI,P004479,P008274,0 days 00:02:31,-1,4,5
42,LLI,P003850,P012585,0 days 00:02:03,0,2,2
42,LLI,P004773,P009649,0 days 00:01:05,-1,0,1
42,HTA,P007759,P010465,0 days 00:26:20,6,66,60
42,HTA,P010465,P011973,0 days 00:25:53,11,66,55
42,HTA,P010465,P010550,0 days 00:24:50,10,62,52
42,HTA,P010465,P011991,0 days 00:24:02,1,53,52
42,HTA,P010550,P011991,0 days 00:23:59,-2,55,57
42,HTA,P007759,P010550,0 days 00:23:24,14,61,47
42,HTA,P007759,P011973,0 days 00:22:30,2,56,54
42,HTA,P007759,P011991,0 days 00:20:35,3,52,49
42,HTA,P011973,P011991,0 days 00:20:26,5,45,40
42,HTA,P010550,P011973,0 days 00:18:38,15,50,35
42,HTA,P004846,P010465,0 days 00:16:11,7,40,33
42,HTA,P004846,P010550,0 days 00:15:20,8,39,31
42,HTA,P004846,P007759,0 days 00:13:58,7,37,30
42,HTA,P004846,P006835,0 days 00:13:48,-3,36,39
42,HTA,P006835,P010465,0 days 00:12:35,-6,31,37
42,HTA,P006835,P007759,0 days 00:11:52,-5,28,33
42,HTA,P004846,P011991,0 days 00:11:52,0,24,24
42,HTA,P004846,P011973,0 days 00:11:40,13,32,19
42,HTA,P006835,P011991,0 days 00:09:30,0,23,23
42,HTA,P006835,P011973,0 days 00:08:36,-2,23,25
42,HTA,P006835,P010550,0 days 00:06:22,-2,19,21
42,HTA,P003533,P010550,0 days 00:05:36,-1,12,13
42,HTA,P003533,P004846,0 days 00:05:01,-2,10,12
42,HTA,P003533,P007759,0 days 00:04:38,5,13,8
42,HTA,P003533,P011991,0 days 00:04:17,-1,9,10
42,HTA,P003533,P010465,0 days 00:03:49,3,10,7
42,HTA,P004267,P004846,0 days 00:03:14,-2,6,8
42,HTA,P003533,P004267,0 days 00:03:09,-2,6,8
42,HTA,P004267,P010550,0 days 00:03:07,-2,6,8
42,HTA,P004267,P011991,0 days 00:01:43,-2,3,5
42,HTA,P004267,P007759,0 days 00:01:31,0,3,3
42,HTA,P003533,P006835,0 days 00:01:22,2,4,2
42,HTA,P004267,P006835,0 days 00:00:07,0,0,0
42,HTA,P004267,P011973,0 days 00:00:05,0,0,0
43,JOV,P010161,P010166,0 days 00:17:21,12,58,46
43,JOV,P002361,P011248,0 days 00:16:14,7,44,37
43,JOV,P010161,P011248,0 days 00:15:10,6,44,38
43,JOV,P002361,P010161,0 days 00:13:57,2,37,35
43,JOV,P009572,PJUG,0 days 00:13:44,19,44,25
43,JOV,P005094,PJUG,0 days 00:13:41,13,37,24
43,JOV,P006771,P010161,0 days 00:13:24,7,34,27
43,JOV,P005094,P010708,0 days 00:13:23,15,31,16
43,JOV,P005094,P009572,0 days 00:13:06,13,37,24
43,JOV,P002361,P006771,0 days 00:12:42,1,27,26
43,JOV,P010166,P011248,0 days 00:12:23,12,44,32
43,JOV,P006771,P010708,0 days 00:12:10,10,23,13
43,JOV,P010708,P011248,0 days 00:11:18,5,22,17
43,JOV,P010708,PJUG,0 days 00:10:50,11,24,13
43,JOV,P009572,P010708,0 days 00:10:20,14,24,10
43,JOV,P006771,P011248,0 days 00:09:59,1,24,23
43,JOV,P002361,P010708,0 days 00:09:32,2,17,15
43,JOV,P002361,P010166,0 days 00:09:24,5,30,25
43,JOV,P009572,P010166,0 days 00:08:56,7,30,23
43,JOV,P010166,P010709,0 days 00:08:55,6,27,21
43,JOV,P009572,P010161,0 days 00:08:52,4,26,22
43,JOV,P005094,P011248,0 days 00:08:18,6,19,13
43,JOV,P006771,P010166,0 days 00:08:06,8,27,19
43,JOV,P010161,P010708,0 days 00:07:57,0,15,15
43,JOV,P006771,PJUG,0 days 00:07:48,11,16,5
43,JOV,P010709,P011248,0 days 00:07:10,7,20,13
43,JOV,P010161,PJUG,0 days 00:06:57,6,24,18
43,JOV,P005094,P006771,0 days 00:06:54,11,16,5
43,JOV,P002361,P005094,0 days 00:06:54,6,15,9
43,JOV,P009572,P011248,0 days 00:06:44,8,19,11
43,JOV,P005094,P010161,0 days 00:06:42,3,22,19
43,JOV,P005094,P010166,0 days 00:06:41,4,21,17
43,JOV,P010161,P010709,0 days 00:06:30,4,20,16
43,JOV,P010166,PJUG,0 days 00:06:14,10,26,16
43,JOV,P010709,P012349,0 days 00:05:11,6,14,8
43,JOV,P006771,P009572,0 days 00:05:05,11,13,2
43,JOV,P009572,P010709,0 days 00:04:44,0,7,7
43,JOV,P010166,P012349,0 days 00:04:37,6,14,8
43,JOV,P010161,P012349,0 days 00:04:26,4,12,8
43,JOV,P002361,P010709,0 days 00:04:22,5,15,10
43,JOV,P005094,P010709,0 days 00:04:21,5,10,5
43,JOV,P011248,PJUG,0 days 00:03:51,6,14,8
43,JOV,P002361,PJUG,0 days 00:02:43,0,3,3
43,JOV,P009572,P012349,0 days 00:02:41,0,4,4
43,JOV,P010708,P010709,0 days 00:02:41,5,5,0
43,JOV,P006771,P012349,0 days 00:02:30,6,10,4
43,JOV,P006771,P010709,0 days 00:02:30,6,10,4
43,JOV,P011248,P012349,0 days 00:00:45,2,2,0
43,JOV,P010166,P010708,0 days 00:00:43,2,3,1
43,JOV,P010708,P012349,0 days 00:00:34,0,0,0
43,HAM,P011168,P012580,0 days 00:17:57,-21,32,53
43,HAM,P009663,P012579,0 days 00:17:39,-2,33,35
43,HAM,P012579,P012580,0 days 00:17:17,-8,36,44
43,HAM,P009663,P012580,0 days 00:16:21,-5,32,37
43,HAM,P009663,P011168,0 days 00:15:53,-13,26,39
43,HAM,P012580,P012582,0 days 00:15:22,1,36,35
43,HAM,P011168,P012579,0 days 00:15:10,-13,26,39
43,HAM,P009663,P012694,0 days 00:12:47,-8,22,30
43,HAM,P010070,P012581,0 days 00:12:37,-11,26,37
43,HAM,P012580,P012581,0 days 00:12:20,-18,24,42
43,HAM,P011168,P012694,0 days 00:11:31,-14,20,34
43,HAM,P012579,P012694,0 days 00:11:19,-9,19,28
43,HAM,P012582,P012695,0 days 00:10:48,-4,25,29
43,HAM,P012579,P012582,0 days 00:10:39,-3,23,26
43,HAM,P012580,P012694,0 days 00:10:35,-14,18,32
43,HAM,P012581,P012582,0 days 00:10:21,-8,23,31
43,HAM,P010070,P012582,0 days 00:10:21,-8,23,31
43,HAM,P009663,P012582,0 days 00:09:49,-1,20,21
43,HAM,P012580,P012695,0 days 00:09:26,3,22,19
43,HAM,P011168,P012582,0 days 00:09:22,-5,18,23
43,HAM,P012581,P012695,0 days 00:09:11,-12,17,29
43,HAM,P011168,P012581,0 days 00:09:05,-14,20,34
43,HAM,P010070,P012695,0 days 00:08:33,-10,16,26
43,HAM,P012581,P012694,0 days 00:08:22,-14,18,32
43,HAM,P010070,P012580,0 days 00:07:46,0,16,16
43,HAM,P012581,P012648,0 days 00:07:33,-14,13,27
43,HAM,P012579,P012695,0 days 00:07:12,1,16,15
43,HAM,P009663,P012648,0 days 00:06:41,-6,9,15
43,HAM,P009663,P012581,0 days 00:06:19,-4,17,21
43,HAM,P012579,P012581,0 days 00:05:03,-7,12,19
43,HAM,P009663,P012695,0 days 00:04:50,5,12,7
43,HAM,P010070,P011168,0 days 00:04:49,-1,10,11
43,HAM,P011168,P012648,0 days 00:04:03,-10,0,10
43,HAM,P012582,P012648,0 days 00:03:58,-8,4,12
43,HAM,P012648,P012694,0 days 00:03:47,-6,4,10
43,HAM,P001990,P009663,0 days 00:03:40,-1,9,10
43,HAM,P001990,P012581,0 days 00:03:40,-1,9,10
43,HAM,P001990,P012648,0 days 00:03:40,-1,9,10
43,HAM,P012694,P012695,0 days 00:03:13,-3,4,7
43,HAM,P012578,P012581,0 days 00:03:13,-5,5,10
43,HAM,P010070,P012694,0 days 00:03:01,-3,3,6
43,HAM,P012579,P012648,0 days 00:03:01,-5,0,5
43,HAM,P010070,P012648,0 days 00:02:51,-8,4,12
43,HAM,P012648,P012695,0 days 00:02:51,-8,4,12
43,HAM,P012578,P012648,0 days 00:02:49,-5,5,10
43,HAM,P001990,P012694,0 days 00:01:53,-1,4,5
43,HAM,P009663,P012578,0 days 00:01:47,0,5,5
43,HAM,P001990,P012578,0 days 00:01:47,0,5,5
43,HAM,P009663,P010070,0 days 00:01:46,-1,3,4
43,HAM,P010070,P012579,0 days 00:01:44,-2,3,5
43,HAM,P011168,P012578,0 days 00:01:26,-5,0,5
43,HAM,P012578,P012580,0 days 00:01:26,-5,0,5
43,HAM,P012580,P012648,0 days 00:01:02,-5,0,5
43,HAM,P012578,P012579,0 days 00:00:24,0,0,0
44,BES,P008945,P012622,0 days 00:29:04,0,49,49
44,BES,P012622,P012647,0 days 00:26:04,-4,40,44
44,BES,P008945,P012647,0 days 00:24:32,-2,38,40
44,BES,P011936,P012647,0 days 00:23:02,-5,35,40
44,BES,P008945,P011936,0 days 00:22:05,-4,34,38
44,BES,P011936,P012622,0 days 00:22:01,-7,33,40
44,BES,P008945,P009582,0 days 00:15:54,2,29,27
44,BES,P009582,P012622,0 days 00:15:44,-2,28,30
44,BES,P009582,P011936,0 days 00:15:17,2,29,27
44,BES,P007914,P009582,0 days 00:14:46,12,34,22
44,BES,P003783,P011936,0 days 00:14:00,5,27,22
44,BES,P009582,P012647,0 days 00:12:28,-2,20,22
44,BES,P003783,P009582,0 days 00:11:10,7,27,20
44,BES,P007914,P012622,0 days 00:10:13,-3,18,21
44,BES,P007917,P012647,0 days 00:09:24,8,19,11
44,BES,P007917,P012622,0 days 00:09:24,8,19,11
44,BES,P007914,P008945,0 days 00:09:22,-2,16,18
44,BES,P007914,P011936,0 days 00:09:21,1,20,19
44,BES,P003783,P012647,0 days 00:09:11,-3,15,18
44,BES,P007917,P011936,0 days 00:08:58,9,19,10
44,BES,P007917,P008945,0 days 00:08:27,8,17,9
44,BES,P007914,P012647,0 days 00:08:03,-4,13,17
44,BES,P003783,P012622,0 days 00:07:55,-5,12,17
44,BES,P003783,P007914,0 days 00:07:48,7,20,13
44,BES,P003783,P008945,0 days 00:07:08,-1,11,12
44,BES,P009582,P011379,0 days 00:06:53,3,13,10
44,BES,P011379,P011936,0 days 00:05:18,3,11,8
44,BES,P007914,P011357,0 days 00:04:56,6,16,10
44,BES,P009582,P011357,0 days 00:04:56,6,16,10
44,BES,P008945,P011379,0 days 00:04:17,0,8,8
44,BES,P003783,P011379,0 days 00:04:12,4,8,4
44,BES,P007914,P011379,0 days 00:04:11,3,7,4
44,BES,P003783,P011357,0 days 00:03:05,3,10,7
44,BES,P011357,P012622,0 days 00:02:42,2,8,6
44,BES,P011379,P012622,0 days 00:02:41,-1,5,6
44,BES,P011357,P011936,0 days 00:02:14,4,8,4
44,BES,P008945,P011357,0 days 00:01:51,3,6,3
44,BES,P003783,P007917,0 days 00:01:23,-1,2,3
44,VNC,P004381,P012591,0 days 00:23:39,10,43,33
44,VNC,P003759,P004381,0 days 00:23:00,-4,36,40
44,VNC,P003759,P012591,0 days 00:18:02,-3,29,32
44,VNC,P008052,P012591,0 days 00:16:58,4,31,27
44,VNC,P000968,P008052,0 days 00:15:51,-5,27,32
44,VNC,P004381,P008052,0 days 00:15:04,7,28,21
44,VNC,P003759,P009400,0 days 00:14:38,-6,23,29
44,VNC,P004381,P011928,0 days 00:14:37,7,30,23
44,VNC,P011928,P012591,0 days 00:14:24,-2,22,24
44,VNC,P004381,P009400,0 days 00:13:47,-7,20,27
44,VNC,P000968,P012591,0 days 00:13:44,2,28,26
44,VNC,P000968,P011928,0 days 00:13:30,-5,20,25
44,VNC,P008052,P011928,0 days 00:12:54,-4,21,25
44,VNC,P011928,P012590,0 days 00:12:10,-11,16,27
44,VNC,P003759,P008052,0 days 00:10:49,-2,18,20
44,VNC,P008052,P012590,0 days 00:10:43,-12,16,28
44,VNC,P012590,P012591,0 days 00:10:19,-3,16,19
44,VNC,P003759,P012590,0 days 00:09:52,4,22,18
44,VNC,P004381,P012590,0 days 00:09:24,7,20,13
44,VNC,P000968,P012590,0 days 00:09:18,-15,11,26
44,VNC,P004117,P004381,0 days 00:08:43,8,20,12
44,VNC,P000968,P004381,0 days 00:08:32,10,22,12
44,VNC,P004117,P012591,0 days 00:08:18,5,16,11
44,VNC,P009400,P012591,0 days 00:07:41,-5,9,14
44,VNC,P003759,P004117,0 days 00:07:15,4,16,12
44,VNC,P009400,P011928,0 days 00:06:55,-6,9,15
44,VNC,P003759,P011928,0 days 00:06:55,-6,9,15
44,VNC,P008052,P009400,0 days 00:06:39,-1,10,11
44,VNC,P004381,P012587,0 days 00:06:02,-2,9,11
44,VNC,P008052,P012587,0 days 00:05:54,-11,5,16
44,VNC,P003759,P012587,0 days 00:05:05,-3,6,9
44,VNC,P004117,P012590,0 days 00:04:39,3,8,5
44,VNC,P000968,P003759,0 days 00:04:20,0,13,13
44,VNC,P011928,P012587,0 days 00:04:12,-7,5,12
44,VNC,P012587,P012590,0 days 00:04:12,-7,5,12
44,VNC,P009400,P012590,0 days 00:04:11,2,10,8
44,VNC,P004117,P012587,0 days 00:03:23,1,6,5
44,VNC,P000968,P012587,0 days 00:03:15,-8,2,10
44,VNC,P009400,P012587,0 days 00:02:46,-3,4,7
44,VNC,P012587,P012591,0 days 00:02:19,0,2,2
44,VNC,P004117,P011928,0 days 00:02:07,2,4,2
44,VNC,P000968,P004117,0 days 00:01:59,0,6,6
44,VNC,P004117,P009400,0 days 00:01:04,1,4,3
44,VNC,P000968,P009400,0 days 00:00:51,1,3,2
45,LJU,P002661,P012700,0 days 00:26:39,-5,57,62
45,LJU,P012598,P012700,0 days 00:26:05,7,56,49
45,LJU,P003452,P012598,0 days 00:23:38,1,46,45
45,LJU,P003452,P012700,0 days 00:23:18,-9,46,55
45,LJU,P009395,P012700,0 days 00:22:09,-2,45,47
45,LJU,P002661,P012598,0 days 00:21:03,-2,43,45
45,LJU,P002661,P009395,0 days 00:19:58,-6,36,42
45,LJU,P001235,P012700,0 days 00:18:59,6,42,36
45,LJU,P002661,P003452,0 days 00:18:37,-16,33,49
45,LJU,P003452,P009395,0 days 00:18:32,-7,33,40
45,LJU,P009395,P012598,0 days 00:16:18,0,33,33
45,LJU,P007066,P012700,0 days 00:15:21,-2,32,34
45,LJU,P002661,P007066,0 days 00:13:48,-7,28,35
45,LJU,P007066,P012598,0 days 00:13:10,4,27,23
45,LJU,P001235,P009395,0 days 00:12:13,2,25,23
45,LJU,P002661,P011261,0 days 00:11:32,-2,20,22
45,LJU,P003452,P007066,0 days 00:10:45,-11,17,28
45,LJU,P001235,P012598,0 days 00:10:32,10,24,14
45,LJU,P001235,P003452,0 days 00:10:20,-1,21,22
45,LJU,P001235,P002661,0 days 00:09:58,4,25,21
45,LJU,P011261,P012700,0 days 00:09:07,1,18,17
45,LJU,P001235,P007066,0 days 00:07:54,5,20,15
45,LJU,P009395,P011261,0 days 00:07:22,2,13,11
45,LJU,P011261,P012598,0 days 00:06:08,-4,9,13
45,LJU,P001235,P011261,0 days 00:05:24,2,11,9
45,LJU,P007066,P011261,0 days 00:04:10,-4,7,11
45,LJU,P003452,P010594,0 days 00:02:57,-10,2,12
45,LJU,P007066,P010594,0 days 00:02:57,-10,2,12
45,LJU,P007066,P009395,0 days 00:02:47,-3,3,6
45,LJU,P003452,P011261,0 days 00:02:25,-3,2,5
45,LJU,P002661,P010594,0 days 00:02:21,-6,2,8
45,LJU,P010594,P012700,0 days 00:01:02,-8,0,8
45,LJU,P010594,P012598,0 days 00:00:58,0,2,2
45,LJU,P009395,P010594,0 days 00:00:57,-2,0,2
45,LJU,P001235,P010594,0 days 00:00:36,-4,0,4
45,WOL,P005516,P012577,0 days 00:26:15,-5,51,56
45,WOL,P011150,P012577,0 days 00:25:57,0,59,59
45,WOL,P005516,P011150,0 days 00:23:38,12,58,46
45,WOL,P004645,P005516,0 days 00:22:43,16,57,41
45,WOL,P004645,P012577,0 days 00:17:25,4,40,36
45,WOL,P012576,P012577,0 days 00:15:45,-7,27,34
45,WOL,P011150,P012576,0 days 00:15:42,2,33,31
45,WOL,P005516,P012576,0 days 00:15:39,0,29,29
45,WOL,P004645,P011150,0 days 00:15:37,21,47,26
45,WOL,P003212,P011150,0 days 00:14:22,18,40,22
45,WOL,P003212,P012577,0 days 00:13:41,10,37,27
45,WOL,P005516,P006154,0 days 00:12:49,2,26,24
45,WOL,P006154,P012576,0 days 00:11:56,5,27,22
45,WOL,P006154,P012577,0 days 00:11:22,3,24,21
45,WOL,P003212,P004645,0 days 00:10:55,11,25,14
45,WOL,P004645,P006154,0 days 00:09:51,6,24,18
45,WOL,P004645,P012576,0 days 00:09:48,4,20,16
45,WOL,P006154,P011150,0 days 00:09:42,12,28,16
45,WOL,P003212,P005516,0 days 00:09:25,13,25,12
45,WOL,P005516,PLCT,0 days 00:08:09,-7,11,18
45,WOL,P004229,P011150,0 days 00:08:05,0,15,15
45,WOL,P006907,P011150,0 days 00:08:00,-3,15,18
45,WOL,P006907,P012577,0 days 00:08:00,-3,15,18
45,WOL,P004229,P012577,0 days 00:07:35,-8,12,20
45,WOL,P003212,P004229,0 days 00:06:49,4,12,8
45,WOL,P012577,PLCT,0 days 00:06:48,-2,11,13
45,WOL,P004229,P005516,0 days 00:06:43,-8,9,17
45,WOL,P003212,P012576,0 days 00:06:27,3,15,12
45,WOL,P004645,PLCT,0 days 00:06:00,-3,8,11
45,WOL,P004229,P006907,0 days 00:05:11,-1,9,10
45,WOL,P011150,PLCT,0 days 00:04:33,-2,9,11
45,WOL,P004229,P004645,0 days 00:04:33,-3,7,10
45,WOL,P003212,P006907,0 days 00:04:25,0,9,9
45,WOL,P006154,PLCT,0 days 00:03:36,-5,2,7
45,WOL,P005516,P006907,0 days 00:03:35,-3,6,9
45,WOL,P012576,PLCT,0 days 00:03:30,-9,3,12
45,WOL,P006907,P012576,0 days 00:02:49,-2,6,8
45,WOL,P003212,P006154,0 days 00:02:40,5,9,4
46,BOU,P010718,P011837,0 days 00:18:33,10,42,32
46,BOU,P004525,P010718,0 days 00:17:24,-4,33,37
46,BOU,P011161,P011837,0 days 00:16:43,9,36,27
46,BOU,P010718,P011161,0 days 00:16:07,6,30,24
46,BOU,P010431,P011161,0 days 00:15:37,1,28,27
46,BOU,P004525,P010450,0 days 00:15:30,-9,26,35
46,BOU,P011836,P011837,0 days 00:14:49,4,31,27
46,BOU,P011836,P012628,0 days 00:14:20,15,34,19
46,BOU,P000498,P010718,0 days 00:14:11,-4,27,31
46,BOU,P011161,P011836,0 days 00:13:25,8,29,21
46,BOU,P004525,P012619,0 days 00:12:56,-13,17,30
46,BOU,P010718,P011836,0 days 00:12:54,6,24,18
46,BOU,P011837,P012628,0 days 00:12:34,10,31,21
46,BOU,P010431,P011837,0 days 00:12:28,3,27,24
46,BOU,P010450,P010718,0 days 00:11:53,-9,19,28
46,BOU,P010718,P012619,0 days 00:11:45,-8,15,23
46,BOU,P000498,P004525,0 days 00:11:37,-6,24,30
46,BOU,P010450,P012619,0 days 00:11:25,-12,14,26
46,BOU,P011161,P012628,0 days 00:11:10,14,29,15
46,BOU,P000498,P010450,0 days 00:10:54,-8,19,27
46,BOU,P004525,P011161,0 days 00:10:36,2,18,16
46,BOU,P010718,P012628,0 days 00:09:27,12,22,10
46,BOU,P004525,P011837,0 days 00:09:17,9,25,16
46,BOU,P004525,P010431,0 days 00:09:04,6,19,13
46,BOU,P010431,P010718,0 days 00:08:58,-1,16,17
46,BOU,P000498,P012619,0 days 00:08:36,-9,11,20
46,BOU,P010431,P011836,0 days 00:07:48,-3,14,17
46,BOU,P000498,P011837,0 days 00:07:23,4,20,16
46,BOU,P011161,P012619,0 days 00:07:18,1,11,10
46,BOU,P000498,P012628,0 days 00:05:38,0,11,11
46,BOU,P010431,P012628,0 days 00:05:33,3,14,11
46,BOU,P010450,P011161,0 days 00:05:08,-1,7,8
46,BOU,P010450,P011837,0 days 00:04:37,3,12,9
46,BOU,P010431,P012619,0 days 00:04:24,0,6,6
46,BOU,P000498,P011836,0 days 00:04:22,1,7,6
46,BOU,P012619,P012628,0 days 00:04:14,4,9,5
46,BOU,P011836,P012619,0 days 00:02:58,5,5,0
46,BOU,P004525,P012628,0 days 00:02:28,-1,6,7
46,BOU,P010431,P010450,0 days 00:02:21,1,3,2
46,BOU,P010450,P012628,0 days 00:01:48,-1,4,5
46,BOU,P000498,P010431,0 days 00:01:15,2,5,3
46,BOU,P010450,P011836,0 days 00:00:32,0,0,0
46,BUD,P004945,P011935,0 days 00:24:49,-8,38,46
46,BUD,P004945,P012606,0 days 00:20:40,-1,40,41
46,BUD,P007398,P010248,0 days 00:20:13,2,39,37
46,BUD,P007398,P011935,0 days 00:18:47,0,37,37
46,BUD,P011935,P012606,0 days 00:18:05,-4,31,35
46,BUD,P010248,P011935,0 days 00:18:00,2,37,35
46,BUD,P002740,P004945,0 days 00:17:24,-5,30,35
46,BUD,P004945,P010432,0 days 00:16:50,-9,26,35
46,BUD,P002740,P012606,0 days 00:16:49,-5,30,35
46,BUD,P002740,P010432,0 days 00:16:03,-7,26,33
46,BUD,P010432,P012606,0 days 00:15:28,-7,26,33
46,BUD,P007398,P012605,0 days 00:14:53,-3,27,30
46,BUD,P010432,P011935,0 days 00:14:52,-9,21,30
46,BUD,P011935,P012605,0 days 00:14:47,-3,27,30
46,BUD,P010248,P012605,0 days 00:14:06,-1,27,28
46,BUD,P002740,P011935,0 days 00:14:05,-7,21,28
46,BUD,P004945,P010248,0 days 00:13:15,5,27,22
46,BUD,P010248,P012630,0 days 00:11:52,1,26,25
46,BUD,P004945,P007398,0 days 00:11:05,1,19,18
46,BUD,P007398,P012630,0 days 00:10:16,1,22,21
46,BUD,P004945,P012605,0 days 00:09:25,-3,13,16
46,BUD,P010248,P012606,0 days 00:09:04,5,20,15
46,BUD,P011935,P012630,0 days 00:08:03,1,20,19
46,BUD,P012606,P012630,0 days 00:06:24,1,15,14
46,BUD,P007398,P012606,0 days 00:06:07,3,12,9
46,BUD,P012605,P012630,0 days 00:06:03,0,14,14
46,BUD,P009214,P012606,0 days 00:05:31,0,10,10
46,BUD,P009214,P010248,0 days 00:04:49,0,8,8
46,BUD,P004945,P009214,0 days 00:04:20,2,10,8
46,BUD,P009214,P012630,0 days 00:03:28,-2,4,6
46,BUD,P002740,P009214,0 days 00:02:44,2,6,4
46,BUD,P004945,P012630,0 days 00:02:32,2,9,7
46,BUD,P007398,P009214,0 days 00:01:52,-2,0,2
46,BUD,P009214,P010432,0 days 00:01:23,0,2,2
46,BUD,P010432,P012605,0 days 00:01:22,-2,0,2
46,BUD,P002740,P010248,0 days 00:01:21,2,4,2
46,BUD,P007398,P010432,0 days 00:00:47,-2,0,2
46,BUD,P009214,P012605,0 days 00:00:41,0,0,0
46,BUD,P002740,P012605,0 days 00:00:35,0,0,0
46,BUD,P002740,P012630,0 days 00:00:35,0,3,3
46,BUD,P010432,P012630,0 days 00:00:35,0,3,3
47,ARI,P012707,P012716,0 days 00:23:33,1,35,34
47,ARI,P003240,P012708,0 days 00:20:39,-5,26,31
47,ARI,P002867,P012716,0 days 00:20:13,5,32,27
47,ARI,P012708,P012716,0 days 00:20:13,-6,27,33
47,ARI,P003240,P012716,0 days 00:20:05,-8,26,34
47,ARI,P003240,P012707,0 days 00:18:49,-9,23,32
47,ARI,P012615,P012708,0 days 00:18:17,4,29,25
47,ARI,P002867,P012708,0 days 00:17:23,5,30,25
47,ARI,P012707,P012708,0 days 00:16:35,-4,20,24
47,ARI,P002867,P003240,0 days 00:15:31,10,31,21
47,ARI,P003240,P012702,0 days 00:13:42,9,25,16
47,ARI,P003240,P012615,0 days 00:13:19,5,21,16
47,ARI,P002867,P012615,0 days 00:13:07,14,29,15
47,ARI,P002867,P012707,0 days 00:12:41,11,23,12
47,ARI,P012702,P012708,0 days 00:12:41,7,24,17
47,ARI,P012615,P012707,0 days 00:12:40,2,16,14
47,ARI,P012702,P012716,0 days 00:12:00,-4,18,22
47,ARI,P002867,P012702,0 days 00:11:34,8,25,17
47,ARI,P012707,P012760,0 days 00:11:14,-8,10,18
47,ARI,P003240,P012760,0 days 00:10:54,-16,10,26
47,ARI,P012615,P012716,0 days 00:10:42,5,18,13
47,ARI,P012716,P012760,0 days 00:09:51,-7,12,19
47,ARI,P012708,P012760,0 days 00:08:33,-12,8,20
47,ARI,P012702,P012707,0 days 00:07:27,-1,13,14
47,ARI,P002867,P012760,0 days 00:07:02,-4,8,12
47,ARI,P012615,P012760,0 days 00:05:40,-6,4,10
47,ARI,P012615,P012702,0 days 00:04:43,8,15,7
47,ARI,P010387,P012707,0 days 00:04:18,-5,6,11
47,ARI,P010387,P012716,0 days 00:04:18,-5,6,11
47,ARI,P012616,P012716,0 days 00:03:25,-1,2,3
47,ARI,P012616,P012760,0 days 00:03:25,-1,2,3
47,ARI,P002867,P012616,0 days 00:03:25,-1,2,3
47,ARI,P003240,P010387,0 days 00:03:01,-6,2,8
47,ARI,P010387,P012760,0 days 00:03:01,-6,2,8
47,ARI,P012616,P012707,0 days 00:02:31,1,2,1
47,ARI,P010387,P012702,0 days 00:01:17,1,4,3
47,ARI,P010387,P012708,0 days 00:01:17,1,4,3
47,ARI,P012616,P012708,0 days 00:00:54,-2,0,2
47,CLU,P011801,P012698,0 days 00:22:34,12,39,27
47,CLU,P005714,P011801,0 days 00:21:39,9,40,31
47,CLU,P005714,P012698,0 days 00:19:15,12,37,25
47,CLU,P005714,P011797,0 days 00:18:21,15,39,24
47,CLU,P011797,P011801,0 days 00:18:03,13,35,22
47,CLU,P011797,P012698,0 days 00:18:03,13,35,22
47,CLU,P005113,P011797,0 days 00:17:45,1,28,27
47,CLU,P004862,P012621,0 days 00:17:20,-9,22,31
47,CLU,P004862,P010569,0 days 00:15:13,-4,21,25
47,CLU,P005113,P011801,0 days 00:15:09,5,25,20
47,CLU,P010569,P011797,0 days 00:13:49,-6,16,22
47,CLU,P010569,P012621,0 days 00:13:36,-3,19,22
47,CLU,P005113,P012698,0 days 00:13:15,8,24,16
47,CLU,P005113,P005714,0 days 00:12:42,7,25,18
47,CLU,P004862,P011801,0 days 00:11:46,0,18,18
47,CLU,P004862,P011797,0 days 00:11:35,-4,18,22
47,CLU,P010569,P011801,0 days 00:10:48,0,11,11
47,CLU,P011797,P012621,0 days 00:10:21,-7,13,20
47,CLU,P005373,P011801,0 days 00:10:16,3,15,12
47,CLU,P004862,P005113,0 days 00:10:16,-10,9,19
47,CLU,P004862,P005373,0 days 00:09:45,-4,13,17
47,CLU,P005373,P012621,0 days 00:09:12,-4,11,15
47,CLU,P005113,P010569,0 days 00:08:53,-9,6,15
47,CLU,P005113,P012621,0 days 00:08:20,-10,7,17
47,CLU,P011801,P012621,0 days 00:07:57,-2,9,11
47,CLU,P004862,P005714,0 days 00:07:46,1,14,13
47,CLU,P005373,P010569,0 days 00:07:16,1,11,10
47,CLU,P010569,P012698,0 days 00:06:19,-2,5,7
47,CLU,P005373,P005714,0 days 00:06:09,-3,7,10
47,CLU,P005714,P012621,0 days 00:05:40,-3,7,10
47,CLU,P005373,P011797,0 days 00:05:39,-1,8,9
47,CLU,P005373,P012698,0 days 00:05:17,1,7,6
47,CLU,P004862,P012698,0 days 00:04:47,2,9,7
47,CLU,P005714,P010569,0 days 00:03:46,3,7,4
47,CLU,P012621,P012698,0 days 00:01:04,-1,0,1
47,CLU,P005373,P012620,0 days 00:00:06,-1,0,1
47,CLU,P005714,P012620,0 days 00:00:06,-1,0,1
47,CLU,P012620,P012621,0 days 00:00:06,-1,0,1
47,CLU,P012620,P012698,0 days 00:00:06,-1,0,1
48,ULM,P005422,P012604,0 days 00:30:34,1,70,69
48,ULM,P012604,P012703,0 days 00:27:37,3,69,66
48,ULM,P012604,P012629,0 days 00:25:42,7,67,60
48,ULM,P012629,P012703,0 days 00:24:34,-3,61,64
48,ULM,P005422,P012629,0 days 00:23:36,2,58,56
48,ULM,P005422,P012703,0 days 00:23:10,-3,54,57
48,ULM,P010106,P010582,0 days 00:18:56,8,46,38
48,ULM,P010106,P012604,0 days 00:17:12,4,41,37
48,ULM,P010582,P012604,0 days 00:16:45,14,42,28
48,ULM,P005422,P010106,0 days 00:16:32,4,37,33
48,ULM,P012603,P012629,0 days 00:14:35,-17,29,46
48,ULM,P012603,P012703,0 days 00:14:35,-17,29,46
48,ULM,P005422,P010582,0 days 00:13:44,13,32,19
48,ULM,P012603,P012604,0 days 00:13:38,-18,27,45
48,ULM,P010582,P011457,0 days 00:13:06,7,32,25
48,ULM,P005422,P012603,0 days 00:12:23,-22,23,45
48,ULM,P010106,P011457,0 days 00:10:45,6,26,20
48,ULM,P010106,P012629,0 days 00:09:35,9,29,20
48,ULM,P010106,P012703,0 days 00:09:09,4,25,21
48,ULM,P010582,P012703,0 days 00:08:42,14,26,12
48,ULM,P006997,P010726,0 days 00:08:30,5,22,17
48,ULM,P006997,P010106,0 days 00:07:42,6,21,15
48,ULM,P006997,P010582,0 days 00:07:42,6,21,15
48,ULM,P010582,P010726,0 days 00:07:09,7,20,13
48,ULM,P010106,P010726,0 days 00:07:09,7,20,13
48,ULM,P011457,P012604,0 days 00:06:57,0,14,14
48,ULM,P010582,P012629,0 days 00:06:47,18,24,6
48,ULM,P006997,P011457,0 days 00:06:09,7,18,11
48,ULM,P010726,P011457,0 days 00:05:36,8,17,9
48,ULM,P005422,P011457,0 days 00:04:47,0,9,9
48,ULM,P012066,P012604,0 days 00:04:15,1,10,9
48,ULM,P012066,P012703,0 days 00:03:53,3,10,7
48,ULM,P006997,P012603,0 days 00:03:11,-5,5,10
48,ULM,P010726,P012603,0 days 00:02:54,-3,5,8
48,ULM,P011457,P012066,0 days 00:02:43,-1,6,7
48,ULM,P010582,P012066,0 days 00:02:43,-1,6,7
48,ULM,P011457,P012703,0 days 00:02:21,1,6,5
48,ULM,P010106,P012603,0 days 00:02:14,-6,3,9
48,ULM,P010582,P012603,0 days 00:02:14,-6,3,9
48,ULM,P006997,P012629,0 days 00:01:38,-4,2,6
48,ULM,P006997,P012703,0 days 00:01:38,-4,2,6
48,ULM,P012066,P012603,0 days 00:01:32,2,4,2
48,ULM,P012066,P012629,0 days 00:01:32,2,4,2
48,ULM,P010726,P012629,0 days 00:01:21,-2,2,4
48,ULM,P010726,P012703,0 days 00:01:21,-2,2,4
48,ULM,P005422,P006997,0 days 00:00:50,-3,1,4
48,ULM,P010106,P012066,0 days 00:00:22,-2,0,2
48,WRO,P001694,P011165,0 days 00:27:02,-14,55,69
48,WRO,P012699,P012736,0 days 00:24:04,-7,54,61
48,WRO,P011165,P012699,0 days 00:22:28,-21,43,64
48,WRO,P011165,P012736,0 days 00:21:12,-12,47,59
48,WRO,P009896,P011165,0 days 00:20:54,-2,48,50
48,WRO,P001694,P012699,0 days 00:19:20,-20,37,57
48,WRO,P001694,P012736,0 days 00:18:33,-15,37,52
48,WRO,P009896,P011278,0 days 00:18:24,10,47,37
48,WRO,P009896,P011901,0 days 00:17:46,21,54,33
48,WRO,P011278,P011901,0 days 00:17:09,10,46,36
48,WRO,P009896,P011902,0 days 00:15:13,5,36,31
48,WRO,P003034,P012736,0 days 00:14:59,-10,33,43
48,WRO,P003034,P011165,0 days 00:14:55,-12,32,44
48,WRO,P001694,P003034,0 days 00:14:54,-15,29,44
48,WRO,P011165,P011278,0 days 00:14:51,1,35,34
48,WRO,P003034,P012699,0 days 00:14:50,-12,31,43
48,WRO,P011901,P011902,0 days 00:12:59,6,34,28
48,WRO,P009896,P012736,0 days 00:12:33,10,34,24
48,WRO,P009896,P012699,0 days 00:12:30,-1,27,28
48,WRO,P001694,P009896,0 days 00:12:08,1,26,25
48,WRO,P011165,P011901,0 days 00:11:51,4,32,28
48,WRO,P011278,P011902,0 days 00:11:23,-3,23,26
48,WRO,P011902,P012699,0 days 00:07:59,7,21,14
48,WRO,P011902,P012736,0 days 00:07:57,14,25,11
48,WRO,P011165,P011902,0 days 00:07:42,-7,14,21
48,WRO,P001694,P011278,0 days 00:07:42,6,18,12
48,WRO,P011901,P012736,0 days 00:07:22,13,25,12
48,WRO,P001694,P011901,0 days 00:07:00,6,16,10
48,WRO,P011901,P012699,0 days 00:04:53,8,15,7
48,WRO,P009896,P012749,0 days 00:04:11,-7,5,12
48,WRO,P011278,P012736,0 days 00:03:28,7,13,6
48,WRO,P011278,P012749,0 days 00:03:24,-2,5,7
48,WRO,P003034,P011901,0 days 00:03:18,-2,7,9
48,WRO,P011902,P012749,0 days 00:02:42,-2,3,5
48,WRO,P011278,P012699,0 days 00:02:29,-1,4,5
48,WRO,P011165,P012749,0 days 00:02:17,-5,2,7
48,WRO,P011901,P012749,0 days 00:01:54,-2,3,5
48,WRO,P003034,P011278,0 days 00:01:46,0,5,5
48,WRO,P003034,P011902,0 days 00:01:41,0,4,4
48,WRO,P001694,P012749,0 days 00:01:29,-5,2,7
48,WRO,P012699,P012749,0 days 00:00:47,-5,0,5
48,WRO,P003034,P009896,0 days 00:00:01,3,3,0
49,TRN,P009903,P012594,0 days 00:27:40,9,66,57
49,TRN,P005738,P009903,0 days 00:25:40,8,62,54
49,TRN,P005738,P012594,0 days 00:24:27,9,58,49
49,TRN,P009903,P012595,0 days 00:23:24,2,54,52
49,TRN,P012594,P012595,0 days 00:22:11,3,50,47
49,TRN,P009903,P012593,0 days 00:21:27,13,55,42
49,TRN,P005738,P012593,0 days 00:21:27,13,55,42
49,TRN,P005738,P012595,0 days 00:20:47,-1,46,47
49,TRN,P012593,P012594,0 days 00:20:14,14,51,37
49,TRN,P005738,P012597,0 days 00:16:43,10,43,33
49,TRN,P012593,P012595,0 days 00:16:39,6,41,35
49,TRN,P005059,P012597,0 days 00:16:07,-3,31,34
49,TRN,P006382,P012597,0 days 00:15:52,-1,33,34
49,TRN,P005059,P006382,0 days 00:15:11,0,31,31
49,TRN,P001479,P012597,0 days 00:15:05,-8,30,38
49,TRN,P009903,P012597,0 days 00:14:03,3,34,31
49,TRN,P012594,P012597,0 days 00:12:14,2,29,27
49,TRN,P001479,P005059,0 days 00:11:52,-8,22,30
49,TRN,P001479,P006382,0 days 00:10:56,-5,22,27
49,TRN,P012596,P012597,0 days 00:10:51,-7,13,20
49,TRN,P005059,P012596,0 days 00:10:51,-7,13,20
49,TRN,P006382,P012596,0 days 00:10:31,-7,13,20
49,TRN,P005059,P005738,0 days 00:08:55,7,26,19
49,TRN,P005738,P006382,0 days 00:07:47,10,24,14
49,TRN,P012595,P012597,0 days 00:07:41,-7,13,20
49,TRN,P001479,P012596,0 days 00:06:36,-12,4,16
49,TRN,P001479,P009903,0 days 00:05:02,1,13,12
49,TRN,P012593,P012597,0 days 00:04:48,7,14,7
49,TRN,P005738,P012596,0 days 00:04:15,5,9,4
49,TRN,P001479,P012595,0 days 00:04:09,-3,8,11
49,TRN,P001479,P005738,0 days 00:03:27,3,13,10
49,TRN,P001479,P012594,0 days 00:03:13,0,8,8
49,TRN,P005059,P009903,0 days 00:03:02,0,9,9
49,TRN,P006382,P009903,0 days 00:02:30,0,7,7
49,TRN,P005059,P012595,0 days 00:02:09,-4,4,8
49,TRN,P005059,P012593,0 days 00:01:13,-1,4,5
49,TRN,P006382,P012594,0 days 00:00:41,-1,2,3
49,TRN,P012595,P012596,0 days 00:00:20,0,0,0
49,TTK,P005000,P011239,0 days 00:27:32,-3,59,62
49,TTK,P005000,P012697,0 days 00:27:20,-2,62,64
49,TTK,P005000,P011925,0 days 00:26:20,-2,59,61
49,TTK,P011239,P012056,0 days 00:25:27,-2,54,56
49,TTK,P011239,P011925,0 days 00:25:07,-13,48,61
49,TTK,P011239,P011834,0 days 00:24:41,-2,53,55
49,TTK,P005000,P012056,0 days 00:23:20,5,55,50
49,TTK,P005000,P011834,0 days 00:21:27,-2,48,50
49,TTK,P011925,P012056,0 days 00:20:55,-5,44,49
49,TTK,P011925,P012697,0 days 00:20:08,0,48,48
49,TTK,P012056,P012697,0 days 00:19:43,-1,47,48
49,TTK,P011239,P012697,0 days 00:17:48,-5,39,44
49,TTK,P011834,P011925,0 days 00:17:25,-5,37,42
49,TTK,P006693,P011834,0 days 00:17:08,-1,35,36
49,TTK,P006693,P011239,0 days 00:17:03,-1,33,34
49,TTK,P011834,P012056,0 days 00:17:03,4,37,33
49,TTK,P006693,P011925,0 days 00:14:18,-5,26,31
49,TTK,P011834,P012697,0 days 00:12:25,-4,28,32
49,TTK,P005000,P006693,0 days 00:11:08,0,23,23
49,TTK,P006693,P012056,0 days 00:10:56,3,21,18
49,TTK,P005000,P005685,0 days 00:06:26,0,14,14
49,TTK,P005685,P012697,0 days 00:06:26,0,14,14
49,TTK,P005685,P011925,0 days 00:04:49,7,14,7
49,TTK,P000497,P005000,0 days 00:04:15,-5,4,9
49,TTK,P000497,P012697,0 days 00:04:15,-5,4,9
49,TTK,P005685,P012056,0 days 00:03:57,7,12,5
49,TTK,P005000,P009845,0 days 00:02:56,1,8,7
49,TTK,P009845,P011925,0 days 00:02:56,1,8,7
49,TTK,P009845,P012697,0 days 00:02:56,1,8,7
49,TTK,P000497,P011925,0 days 00:02:38,2,4,2
49,TTK,P000497,P005685,0 days 00:02:29,-7,2,9
49,TTK,P000497,P011239,0 days 00:01:46,2,2,0
49,TTK,P009845,P011834,0 days 00:01:41,4,6,2
49,TTK,P000497,P011834,0 days 00:01:37,-7,0,7
49,TTK,P005685,P011834,0 days 00:01:37,-7,0,7
49,TTK,P009845,P012056,0 days 00:01:15,-3,2,5
49,TTK,P006693,P012697,0 days 00:00:47,0,2,2
50,CAN,P003425,P008121,0 days 00:20:43,14,45,31
50,CAN,P006588,P008121,0 days 00:19:43,15,45,30
50,CAN,P003425,P006588,0 days 00:19:25,17,46,29
50,CAN,P003637,P005005,0 days 00:14:55,1,36,35
50,CAN,P003425,P009864,0 days 00:14:37,21,38,17
50,CAN,P001607,P003637,0 days 00:13:58,-2,32,34
50,CAN,P008121,P009864,0 days 00:13:39,13,33,20
50,CAN,P001607,P005005,0 days 00:13:32,-4,30,34
50,CAN,P001607,P010452,0 days 00:13:10,-9,28,37
50,CAN,P006588,P009864,0 days 00:13:09,13,31,18
50,CAN,P003637,P010385,0 days 00:12:37,-1,28,29
50,CAN,P005005,P010452,0 days 00:11:29,0,30,30
50,CAN,P003637,P010452,0 days 00:11:08,-2,28,30
50,CAN,P005005,P010385,0 days 00:10:55,2,26,24
50,CAN,P001607,P010385,0 days 00:10:55,2,25,23
50,CAN,P007560,P008121,0 days 00:10:13,8,27,19
50,CAN,P003425,P007560,0 days 00:10:11,9,27,18
50,CAN,P007560,P009864,0 days 00:09:38,4,21,17
50,CAN,P006588,P007560,0 days 00:08:55,12,25,13
50,CAN,P010385,P010452,0 days 00:08:11,-3,18,21
50,CAN,P005005,P009864,0 days 00:07:52,7,23,16
50,CAN,P005005,P006588,0 days 00:07:18,9,19,10
50,CAN,P003425,P004160,0 days 00:06:42,2,9,7
50,CAN,P009864,P010452,0 days 00:06:28,0,15,15
50,CAN,P004160,P008121,0 days 00:06:21,0,7,7
50,CAN,P006588,P010385,0 days 00:06:07,7,17,10
50,CAN,P004160,P006588,0 days 00:05:35,0,7,7
50,CAN,P004160,P007644,0 days 00:05:34,-4,7,11
50,CAN,P003637,P006588,0 days 00:05:29,0,10,10
50,CAN,P003425,P005005,0 days 00:05:15,13,19,6
50,CAN,P001607,P009864,0 days 00:05:00,-8,8,16
50,CAN,P007644,P008121,0 days 00:04:45,-4,5,9
50,CAN,P003425,P007644,0 days 00:04:45,-4,5,9
50,CAN,P007560,P010452,0 days 00:04:15,-7,5,12
50,CAN,P006588,P007644,0 days 00:04:14,-2,5,7
50,CAN,P001607,P006588,0 days 00:04:05,1,7,6
50,CAN,P004160,P009864,0 days 00:04:05,3,5,2
50,CAN,P004160,P010452,0 days 00:04:04,-1,5,6
50,CAN,P003637,P009864,0 days 00:04:00,-1,10,11
50,CAN,P005005,P008121,0 days 00:03:31,6,11,5
50,CAN,P003425,P010385,0 days 00:03:23,2,10,8
50,CAN,P008121,P010385,0 days 00:03:23,2,9,7
50,CAN,P003425,P010452,0 days 00:03:20,2,7,5
50,CAN,P001607,P007560,0 days 00:02:59,-4,3,7
50,CAN,P004160,P007560,0 days 00:02:57,-3,3,6
50,CAN,P001607,P004160,0 days 00:02:57,-3,3,6
50,CAN,P003425,P003637,0 days 00:02:39,0,6,6
50,CAN,P008121,P010452,0 days 00:02:04,-4,2,6
50,CAN,P007560,P007644,0 days 00:01:51,-4,2,6
50,CAN,P007644,P010452,0 days 00:01:51,-4,2,6
50,CAN,P003637,P008121,0 days 00:01:42,-3,2,5
50,CAN,P007560,P010385,0 days 00:01:41,5,7,2
50,CAN,P001607,P007644,0 days 00:01:20,-2,2,4
50,CAN,P001607,P008121,0 days 00:01:04,-3,2,5
50,CAN,P004160,P005005,0 days 00:00:21,2,2,0
50,LKB,P002012,PLXI,0 days 00:21:45,-8,37,45
50,LKB,P002012,P007029,0 days 00:20:43,-13,37,50
50,LKB,P002012,P004664,0 days 00:17:24,1,40,39
50,LKB,P007029,PLXI,0 days 00:17:19,-15,28,43
50,LKB,P004664,P005521,0 days 00:16:40,7,39,32
50,LKB,P004664,PLXI,0 days 00:15:48,-4,33,37
50,LKB,P005521,P010461,0 days 00:15:03,-1,31,32
50,LKB,P005521,P012583,0 days 00:14:06,-5,28,33
50,LKB,P010461,PLXI,0 days 00:13:13,-2,20,22
50,LKB,P004664,P007029,0 days 00:13:08,-6,31,37
50,LKB,P004664,P010461,0 days 00:13:06,-3,25,28
50,LKB,P002012,P010461,0 days 00:11:29,6,23,17
50,LKB,P006230,P007029,0 days 00:11:21,-15,18,33
50,LKB,P008856,PLXI,0 days 00:10:57,-10,10,20
50,LKB,P007029,P010461,0 days 00:10:33,5,23,18
50,LKB,P007029,P008856,0 days 00:10:18,-7,12,19
50,LKB,P002012,P006230,0 days 00:10:14,-12,18,30
50,LKB,P006230,PLXI,0 days 00:10:06,-12,18,30
50,LKB,P004664,P006230,0 days 00:09:50,2,31,29
50,LKB,P004664,P012583,0 days 00:09:45,-5,20,25
50,LKB,P005521,PLXI,0 days 00:09:26,1,15,14
50,LKB,P010461,P012583,0 days 00:09:15,-7,16,23
50,LKB,P012583,PLXI,0 days 00:08:26,-6,11,17
50,LKB,P002012,P005521,0 days 00:07:50,9,18,9
50,LKB,P002012,P008856,0 days 00:07:45,-7,6,13
50,LKB,P008856,P010461,0 days 00:07:38,2,14,12
50,LKB,P004664,P010190,0 days 00:07:08,1,19,18
50,LKB,P005521,P010190,0 days 00:07:08,1,19,18
50,LKB,P005521,P007029,0 days 00:06:07,2,15,13
50,LKB,P005521,P008856,0 days 00:06:01,-3,10,13
50,LKB,P006230,P008856,0 days 00:06:00,-12,2,14
50,LKB,P008856,P012583,0 days 00:05:53,-3,10,13
50,LKB,P005521,P006230,0 days 00:05:44,2,15,13
50,LKB,P010190,P012583,0 days 00:04:39,-2,13,15
50,LKB,P006230,P010190,0 days 00:04:29,5,15,10
50,LKB,P007029,P012583,0 days 00:04:05,-3,8,11
50,LKB,P002012,P012583,0 days 00:03:26,0,5,5
50,LKB,P006230,P012583,0 days 00:02:57,-1,9,10
50,LKB,P004664,P006901,0 days 00:02:39,3,6,3
50,LKB,P010190,P010461,0 days 00:02:39,-4,4,8
50,LKB,P005521,P006901,0 days 00:02:39,3,6,3
50,LKB,P006230,P006901,0 days 00:02:39,3,6,3
50,LKB,P006901,P010190,0 days 00:02:29,3,6,3
50,LKB,P006901,P007029,0 days 00:00:10,0,0,0
51,WOL,P005516,P012577,0 days 00:22:59,8,46,38
51,WOL,P011150,P012577,0 days 00:20:13,12,46,34
51,WOL,P005516,P011150,0 days 00:20:10,6,40,34
51,WOL,P011150,P012576,0 days 00:20:04,27,57,30
51,WOL,P005516,P012576,0 days 00:18:31,14,39,25
51,WOL,P002387,P003212,0 days 00:18:11,10,41,31
51,WOL,P002387,P011150,0 days 00:16:58,11,43,32
51,WOL,P002387,P005516,0 days 00:16:00,-3,20,23
51,WOL,P002387,P012576,0 days 00:15:47,16,38,22
51,WOL,P012576,P012577,0 days 00:15:20,11,34,23
51,WOL,P002387,P012577,0 days 00:12:15,2,21,19
51,WOL,P003212,P012576,0 days 00:11:54,11,30,19
51,WOL,P004229,P005516,0 days 00:11:29,-11,14,25
51,WOL,P004229,P012577,0 days 00:10:55,-3,20,23
51,WOL,P002387,P006154,0 days 00:10:53,4,24,20
51,WOL,P004645,P012577,0 days 00:10:28,7,27,20
51,WOL,P004645,P005516,0 days 00:10:28,7,27,20
51,WOL,P003212,P005516,0 days 00:10:22,-3,13,16
51,WOL,P002387,P004229,0 days 00:10:01,-8,14,22
51,WOL,P006154,P012576,0 days 00:09:49,14,28,14
51,WOL,P003212,P006154,0 days 00:09:40,7,23,16
51,WOL,P003212,P011150,0 days 00:09:15,13,32,19
51,WOL,P005516,P006154,0 days 00:09:02,-3,13,16
51,WOL,P004645,P011150,0 days 00:08:58,8,24,16
51,WOL,P004229,P011150,0 days 00:08:49,-8,15,23
51,WOL,P003212,P012577,0 days 00:08:25,-2,16,18
51,WOL,P003212,P004229,0 days 00:08:22,-3,15,18
51,WOL,P006154,P011150,0 days 00:07:46,8,24,16
51,WOL,P004645,P012576,0 days 00:06:35,10,19,9
51,WOL,P004229,P004645,0 days 00:03:53,-3,8,11
51,WOL,P002387,PLCT,0 days 00:03:25,0,7,7
51,WOL,P003212,PLCT,0 days 00:03:25,0,7,7
51,WOL,P012576,PLCT,0 days 00:03:25,0,7,7
51,WOL,P004229,P006154,0 days 00:03:25,-8,2,10
51,WOL,P006154,P012577,0 days 00:02:21,2,6,4
51,WOL,P011150,PLCT,0 days 00:02:20,2,7,5
51,WOL,P003212,P004645,0 days 00:01:30,-1,3,4
51,WOL,P005516,P006907,0 days 00:01:23,-3,0,3
51,WOL,P006907,P011150,0 days 00:01:23,-3,0,3
51,WOL,P006907,P012577,0 days 00:01:23,-3,0,3
51,WOL,P012577,PLCT,0 days 00:01:05,-2,0,2
51,WOL,P006907,P012576,0 days 00:00:51,-3,0,3
51,WOL,P004229,P006907,0 days 00:00:26,0,0,0
51,WOL,P002387,P006907,0 days 00:00:06,0,0,0
51,PMT,P011066,P012599,0 days 00:26:16,-10,49,59
51,PMT,P011066,P011944,0 days 00:23:11,-10,36,46
51,PMT,P011944,P012599,0 days 00:20:28,-3,36,39
51,PMT,P002644,P011944,0 days 00:16:10,-1,28,29
51,PMT,P002644,P011066,0 days 00:16:00,-1,29,30
51,PMT,P011823,P012599,0 days 00:15:57,-5,29,34
51,PMT,P009559,P011066,0 days 00:15:27,-13,29,42
51,PMT,P009559,P012599,0 days 00:15:03,-11,27,38
51,PMT,P011066,P011823,0 days 00:15:03,-14,27,41
51,PMT,P002644,P012599,0 days 00:14:05,-3,27,30
51,PMT,P011823,P011944,0 days 00:13:00,-13,20,33
51,PMT,P011823,P011947,0 days 00:12:14,-6,18,24
51,PMT,P011947,P012599,0 days 00:11:46,0,16,16
51,PMT,P011066,P011947,0 days 00:11:39,-2,16,18
51,PMT,P009559,P011944,0 days 00:11:38,-6,20,26
51,PMT,P011944,P011947,0 days 00:11:22,-4,14,18
51,PMT,P002644,P009559,0 days 00:10:19,-7,18,25
51,PMT,P002644,P011947,0 days 00:08:25,6,15,9
51,PMT,P011823,P012600,0 days 00:08:03,-8,19,27
51,PMT,P001686,P002644,0 days 00:07:37,3,16,13
51,PMT,P001686,P011944,0 days 00:07:00,0,16,16
51,PMT,P009559,P011823,0 days 00:06:50,-6,11,17
51,PMT,P011946,P012599,0 days 00:05:36,-1,9,10
51,PMT,P011823,P011946,0 days 00:05:36,-1,9,10
51,PMT,P011066,P012600,0 days 00:05:14,-10,11,21
51,PMT,P001686,P011947,0 days 00:04:57,2,12,10
51,PMT,P012599,P012600,0 days 00:04:47,-5,11,16
51,PMT,P002644,P011943,0 days 00:04:32,2,8,6
51,PMT,P011943,P011947,0 days 00:04:32,2,8,6
51,PMT,P009559,P012600,0 days 00:04:30,-7,9,16
51,PMT,P001686,P012600,0 days 00:04:21,-4,10,14
51,PMT,P001686,P011823,0 days 00:04:21,-4,10,14
51,PMT,P011944,P012600,0 days 00:04:21,-4,10,14
51,PMT,P011946,P011947,0 days 00:04:21,2,7,5
51,PMT,P011943,P011966,0 days 00:04:00,2,8,6
51,PMT,P011947,P011966,0 days 00:04:00,2,8,6
51,PMT,P002644,P011966,0 days 00:04:00,2,8,6
51,PMT,P001686,P011066,0 days 00:03:58,1,8,7
51,PMT,P009559,P011947,0 days 00:03:48,-2,2,4
51,PMT,P011066,P011946,0 days 00:03:32,-1,7,8
51,PMT,P001686,P011966,0 days 00:03:32,2,8,6
51,PMT,P001686,P011943,0 days 00:03:32,2,8,6
51,PMT,P001686,P012599,0 days 00:02:50,6,8,2
51,PMT,P002644,P012600,0 days 00:02:20,-6,2,8
51,PMT,P011944,P011946,0 days 00:02:18,-3,4,7
51,PMT,P002644,P011823,0 days 00:02:16,-3,5,8
51,PMT,P011947,P012600,0 days 00:02:12,0,4,4
51,PMT,P009559,P011946,0 days 00:01:01,0,0,0
51,PMT,P011943,P011944,0 days 00:01:00,0,0,0
51,PMT,P011066,P011943,0 days 00:00:32,0,0,0
51,PMT,P011944,P011966,0 days 00:00:28,0,0,0
52,VNC,P011928,P012591,0 days 00:26:18,5,58,53
52,VNC,P004381,P012591,0 days 00:25:01,21,66,45
52,VNC,P004381,P009400,0 days 00:21:01,12,52,40
52,VNC,P008052,P012590,0 days 00:20:42,1,52,51
52,VNC,P004381,P011928,0 days 00:20:40,8,49,41
52,VNC,P012590,P012591,0 days 00:19:17,15,52,37
52,VNC,P009400,P012591,0 days 00:18:33,12,46,34
52,VNC,P008052,P012591,0 days 00:18:13,11,48,37
52,VNC,P003759,P004381,0 days 00:17:48,2,37,35
52,VNC,P011928,P012590,0 days 00:16:43,2,39,37
52,VNC,P004381,P008052,0 days 00:16:25,8,46,38
52,VNC,P004381,P012590,0 days 00:15:01,12,44,32
52,VNC,P008052,P011928,0 days 00:14:26,-6,31,37
52,VNC,P003759,P012591,0 days 00:13:58,8,30,22
52,VNC,P009400,P011928,0 days 00:13:48,-1,29,30
52,VNC,P003759,P009400,0 days 00:13:32,5,29,24
52,VNC,P003759,P011928,0 days 00:11:45,5,23,18
52,VNC,P008052,P012587,0 days 00:11:08,-11,23,34
52,VNC,P008052,P009400,0 days 00:08:55,10,26,16
52,VNC,P012587,P012590,0 days 00:08:35,-11,17,28
52,VNC,P003759,P008052,0 days 00:08:02,-1,21,22
52,VNC,P000968,P008052,0 days 00:06:29,-4,13,17
52,VNC,P000968,P012590,0 days 00:06:29,-4,13,17
52,VNC,P003759,P012590,0 days 00:06:15,-1,15,16
52,VNC,P003759,P012587,0 days 00:05:49,-4,14,18
52,VNC,P009400,P012590,0 days 00:05:42,10,20,10
52,VNC,P004381,P012587,0 days 00:05:24,-7,10,17
52,VNC,P011928,P012587,0 days 00:05:14,-7,9,16
52,VNC,P000968,P011928,0 days 00:04:30,-6,6,12
52,VNC,P000968,P012591,0 days 00:03:56,-2,6,8
52,VNC,P012587,P012591,0 days 00:03:16,-2,6,8
52,VNC,P000968,P012587,0 days 00:02:33,-2,7,9
52,VNC,P009400,P012587,0 days 00:02:33,0,6,6
52,VNC,P000968,P003759,0 days 00:01:59,2,7,5
52,LJU,P012598,P012700,0 days 00:29:07,-10,57,67
52,LJU,P003452,P012700,0 days 00:27:14,-19,53,72
52,LJU,P002661,P012700,0 days 00:26:38,-9,59,68
52,LJU,P003452,P012598,0 days 00:25:54,-11,56,67
52,LJU,P009395,P012700,0 days 00:24:21,1,51,50
52,LJU,P002661,P003452,0 days 00:24:14,-5,59,64
52,LJU,P002661,P012598,0 days 00:23:11,-5,53,58
52,LJU,P009395,P012598,0 days 00:22:55,2,48,46
52,LJU,P003452,P009395,0 days 00:18:21,-1,39,40
52,LJU,P002661,P009395,0 days 00:16:13,1,38,37
52,LJU,P002661,P007066,0 days 00:14:14,-3,34,37
52,LJU,P003452,P007066,0 days 00:13:08,-13,29,42
52,LJU,P007066,P012700,0 days 00:11:12,-14,21,35
52,LJU,P001235,P012700,0 days 00:10:31,1,18,17
52,LJU,P002661,P009392,0 days 00:09:36,4,26,22
52,LJU,P007066,P012598,0 days 00:08:59,-11,20,31
52,LJU,P001235,P012598,0 days 00:08:55,-4,15,19
52,LJU,P007066,P009392,0 days 00:08:53,3,23,20
52,LJU,P001235,P003452,0 days 00:08:31,-5,13,18
52,LJU,P001235,P009395,0 days 00:08:08,0,13,13
52,LJU,P003452,P009392,0 days 00:07:55,-2,19,21
52,LJU,P009392,P012700,0 days 00:06:37,-5,13,18
52,LJU,P011261,P012598,0 days 00:04:22,0,10,10
52,LJU,P011261,P012700,0 days 00:04:09,4,10,6
52,LJU,P009395,P011261,0 days 00:04:01,2,8,6
52,LJU,P001235,P007066,0 days 00:03:53,3,11,8
52,LJU,P001235,P009392,0 days 00:03:30,7,9,2
52,LJU,P010594,P012700,0 days 00:03:11,-1,6,7
52,LJU,P002661,P010594,0 days 00:02:59,-1,6,7
52,LJU,P009392,P012598,0 days 00:02:45,3,9,6
52,LJU,P001235,P002661,0 days 00:02:40,9,9,0
52,LJU,P001235,P011261,0 days 00:02:32,1,8,7
52,LJU,P010594,P012598,0 days 00:02:16,0,4,4
52,LJU,P009395,P010594,0 days 00:02:04,0,4,4
52,LJU,P002661,P011261,0 days 00:02:03,1,4,3
52,LJU,P009392,P009395,0 days 00:01:21,-1,3,4
52,LJU,P009392,P010594,0 days 00:01:07,-1,2,3
52,LJU,P007066,P010594,0 days 00:00:55,-1,2,3
52,LJU,P003452,P011261,0 days 00:00:39,0,4,4
52,LJU,P007066,P011261,0 days 00:00:34,0,4,4
52,LJU,P001235,P010594,0 days 00:00:12,0,0,0
53,BES,P008945,P012647,0 days 00:21:53,18,54,36
53,BES,P008945,P011936,0 days 00:17:00,7,42,35
53,BES,P012622,P012647,0 days 00:16:58,6,39,33
53,BES,P009582,P012647,0 days 00:16:44,18,45,27
53,BES,P008945,P012622,0 days 00:16:36,9,35,26
53,BES,P008945,P009582,0 days 00:16:15,13,38,25
53,BES,P011936,P012622,0 days 00:15:55,4,34,30
53,BES,P011936,P012647,0 days 00:15:48,3,39,36
53,BES,P007914,P009582,0 days 00:15:19,7,36,29
53,BES,P003783,P009582,0 days 00:14:23,6,37,31
53,BES,P007914,P008945,0 days 00:14:00,10,33,23
53,BES,P009582,P011936,0 days 00:13:59,4,33,29
53,BES,P009582,P012622,0 days 00:13:54,7,28,21
53,BES,P007914,P012647,0 days 00:13:16,8,31,23
53,BES,P003783,P007914,0 days 00:12:11,0,26,26
53,BES,P003783,P011936,0 days 00:11:47,-1,23,24
53,BES,P007914,P011936,0 days 00:11:08,-2,22,24
53,BES,P007917,P011936,0 days 00:09:36,-3,20,23
53,BES,P003783,P011379,0 days 00:09:15,4,19,15
53,BES,P011379,P011936,0 days 00:09:05,0,15,15
53,BES,P007914,P011379,0 days 00:09:00,-4,16,20
53,BES,P007917,P012647,0 days 00:08:37,-5,18,23
53,BES,P007917,P008945,0 days 00:07:25,0,18,18
53,BES,P003783,P012647,0 days 00:07:23,1,21,20
53,BES,P003783,P012622,0 days 00:07:19,2,16,14
53,BES,P007914,P012622,0 days 00:07:03,0,9,9
53,BES,P009582,P011379,0 days 00:06:45,-5,12,17
53,BES,P003783,P005348,0 days 00:06:19,2,17,15
53,BES,P005348,P009582,0 days 00:06:19,2,17,15
53,BES,P003783,P008945,0 days 00:05:26,9,17,8
53,BES,P007917,P012622,0 days 00:04:49,-1,11,12
53,BES,P007914,P007917,0 days 00:04:47,-2,9,11
53,BES,P011379,P012622,0 days 00:04:35,2,7,5
53,BES,P008945,P011379,0 days 00:03:41,-2,7,9
53,BES,P003783,P011357,0 days 00:03:14,0,6,6
53,BES,P005348,P011357,0 days 00:03:14,0,6,6
53,BES,P009582,P011357,0 days 00:03:14,0,6,6
53,BES,P011357,P011936,0 days 00:02:23,0,6,6
53,BES,P005348,P011936,0 days 00:02:23,0,6,6
53,BES,P005348,P011379,0 days 00:02:20,-1,6,7
53,BES,P005348,P007914,0 days 00:02:20,-1,6,7
53,BES,P003783,P007917,0 days 00:02:11,-3,2,5
53,BES,P005348,P012622,0 days 00:01:36,3,5,2
53,BES,P007917,P011379,0 days 00:00:59,2,2,0
53,BES,P011357,P012622,0 days 00:00:51,0,0,0
53,BES,P005348,P012647,0 days 00:00:45,3,5,2
53,HAM,P009663,P012581,0 days 00:22:47,-15,44,59
53,HAM,P009663,P011168,0 days 00:21:30,-11,42,53
53,HAM,P011168,P012582,0 days 00:19:40,-13,37,50
53,HAM,P011168,P012579,0 days 00:18:24,-1,38,39
53,HAM,P011168,P012581,0 days 00:18:18,-11,36,47
53,HAM,P009663,P012579,0 days 00:17:23,-15,31,46
53,HAM,P009663,P012582,0 days 00:17:18,-13,30,43
53,HAM,P012579,P012582,0 days 00:17:10,-7,31,38
53,HAM,P012581,P012582,0 days 00:15:59,-14,27,41
53,HAM,P012579,P012581,0 days 00:14:09,-11,26,37
53,HAM,P012580,P012694,0 days 00:14:01,2,28,26
53,HAM,P011168,P012580,0 days 00:12:55,2,27,25
53,HAM,P009663,P012580,0 days 00:12:52,-14,20,34
53,HAM,P012579,P012580,0 days 00:12:34,-3,22,25
53,HAM,P011187,P012580,0 days 00:11:11,11,26,15
53,HAM,P009663,P012694,0 days 00:10:29,-5,22,27
53,HAM,P012580,P012582,0 days 00:10:02,-5,18,23
53,HAM,P011168,P012694,0 days 00:08:55,6,22,16
53,HAM,P012580,P012695,0 days 00:08:45,1,16,15
53,HAM,P012580,P012581,0 days 00:07:52,-11,12,23
53,HAM,P012581,P012694,0 days 00:07:50,-6,17,23
53,HAM,P011168,P012648,0 days 00:07:33,-4,17,21
53,HAM,P012579,P012694,0 days 00:07:10,-1,14,15
53,HAM,P011168,P011187,0 days 00:07:05,4,17,13
53,HAM,P011187,P012579,0 days 00:06:57,7,14,7
53,HAM,P011187,P012582,0 days 00:06:35,-3,13,16
53,HAM,P012580,P012648,0 days 00:06:00,5,15,10
53,HAM,P011187,P012694,0 days 00:05:38,9,13,4
53,HAM,P012694,P012695,0 days 00:05:33,4,10,6
53,HAM,P012582,P012648,0 days 00:05:19,-6,10,16
53,HAM,P011187,P012648,0 days 00:05:16,-1,12,13
53,HAM,P011187,P012695,0 days 00:05:08,2,9,7
53,HAM,P009663,P012648,0 days 00:04:55,2,12,10
53,HAM,P012648,P012694,0 days 00:04:52,7,14,7
53,HAM,P012581,P012648,0 days 00:04:11,-4,9,13
53,HAM,P009663,P012695,0 days 00:03:54,-1,7,8
53,HAM,P012579,P012695,0 days 00:03:33,-1,4,5
53,HAM,P012582,P012695,0 days 00:03:29,-3,6,9
53,HAM,P012581,P012695,0 days 00:03:08,-3,5,8
53,HAM,P012648,P012695,0 days 00:02:38,5,7,2
53,HAM,P011187,P012581,0 days 00:01:02,-5,0,5
54,JOV,P005094,P011248,0 days 00:26:35,3,55,52
54,JOV,P005094,P010161,0 days 00:22:43,-1,44,45
54,JOV,P005094,P010708,0 days 00:19:41,6,41,35
54,JOV,P010161,P011248,0 days 00:18:39,0,41,41
54,JOV,P010708,P011248,0 days 00:17:44,8,40,32
54,JOV,P002361,P005094,0 days 00:17:35,-9,29,38
54,JOV,P006771,P011248,0 days 00:17:26,0,35,35
54,JOV,P010161,P010708,0 days 00:17:00,1,37,36
54,JOV,P005094,P006771,0 days 00:16:52,0,29,29
54,JOV,P006771,P010161,0 days 00:12:39,-4,25,29
54,JOV,P002361,P011248,0 days 00:12:17,0,26,26
54,JOV,P009572,P010161,0 days 00:12:01,-2,28,30
54,JOV,P006771,P010708,0 days 00:11:30,2,21,19
54,JOV,P002361,P010161,0 days 00:10:27,-10,15,25
54,JOV,P009572,P011248,0 days 00:10:12,-1,22,23
54,JOV,P002361,P006771,0 days 00:09:38,-9,18,27
54,JOV,P010161,PJUG,0 days 00:09:35,-10,15,25
54,JOV,P002361,P010708,0 days 00:09:35,0,17,17
54,JOV,P005094,P009572,0 days 00:09:30,-2,18,20
54,JOV,P010166,P011248,0 days 00:08:19,-2,19,21
54,JOV,P009572,P010166,0 days 00:08:05,4,19,15
54,JOV,P006771,P009572,0 days 00:07:53,2,14,12
54,JOV,P005094,P010166,0 days 00:07:34,-3,15,18
54,JOV,P006771,P012349,0 days 00:06:53,-10,8,18
54,JOV,P002361,P012349,0 days 00:06:42,-14,6,20
54,JOV,P006771,P010166,0 days 00:06:42,4,20,16
54,JOV,P010161,P010166,0 days 00:06:19,-3,15,18
54,JOV,P006771,PJUG,0 days 00:05:51,-5,10,15
54,JOV,P010161,P012349,0 days 00:05:49,-11,4,15
54,JOV,P005094,PJUG,0 days 00:05:48,-9,5,14
54,JOV,P005094,P012349,0 days 00:05:46,-9,4,13
54,JOV,P002361,PJUG,0 days 00:05:36,-14,5,19
54,JOV,P009572,P010708,0 days 00:05:22,2,15,13
54,JOV,P012349,PJUG,0 days 00:05:14,-11,2,13
54,JOV,P009572,PJUG,0 days 00:05:01,2,10,8
54,JOV,P011248,P012349,0 days 00:04:00,-4,6,10
54,JOV,P010708,PJUG,0 days 00:02:54,-4,5,9
54,JOV,P009572,P012349,0 days 00:02:32,-1,2,3
54,JOV,P010166,PJUG,0 days 00:02:25,3,8,5
54,JOV,P002361,P010166,0 days 00:02:14,0,8,8
54,JOV,P010166,P010708,0 days 00:01:18,1,4,3
54,JOV,P011248,PJUG,0 days 00:00:04,0,0,0
54,LLI,P006600,P009680,0 days 00:29:23,15,71,56
54,LLI,P006600,P012585,0 days 00:23:49,7,56,49
54,LLI,P009680,P012585,0 days 00:23:32,5,53,48
54,LLI,P009649,P009680,0 days 00:21:06,5,47,42
54,LLI,P006600,P009649,0 days 00:21:04,9,50,41
54,LLI,P006600,P012586,0 days 00:18:10,9,46,37
54,LLI,P004479,P006600,0 days 00:17:35,18,38,20
54,LLI,P009649,P012585,0 days 00:16:40,5,40,35
54,LLI,P005247,P006600,0 days 00:16:40,23,46,23
54,LLI,P004479,P009649,0 days 00:15:47,-4,23,27
54,LLI,P005247,P012586,0 days 00:15:07,5,32,27
54,LLI,P009680,P012586,0 days 00:14:53,-2,36,38
54,LLI,P012585,P012586,0 days 00:14:51,2,39,37
54,LLI,P004479,P009680,0 days 00:14:35,9,31,22
54,LLI,P005247,P009680,0 days 00:13:23,12,36,24
54,LLI,P004479,P005247,0 days 00:13:03,9,29,20
54,LLI,P004479,P004773,0 days 00:11:57,4,23,19
54,LLI,P009649,P012586,0 days 00:10:40,-9,23,32
54,LLI,P004479,P012586,0 days 00:10:20,-6,13,19
54,LLI,P004773,P012586,0 days 00:10:01,-4,13,17
54,LLI,P004773,P005247,0 days 00:08:49,9,21,12
54,LLI,P004479,P012585,0 days 00:08:25,1,13,12
54,LLI,P005247,P012585,0 days 00:07:59,8,23,15
54,LLI,P003850,P012586,0 days 00:06:42,-11,6,17
54,LLI,P003850,P004773,0 days 00:06:42,-11,6,17
54,LLI,P003850,P004479,0 days 00:06:42,-11,6,17
54,LLI,P004773,P006600,0 days 00:05:15,15,17,2
54,LLI,P005247,P009649,0 days 00:05:04,6,15,9
54,LLI,P003850,P005247,0 days 00:04:03,-4,6,10
54,LLI,P004773,P009649,0 days 00:03:08,-5,2,7
54,LLI,P003850,P009649,0 days 00:02:39,-7,0,7
54,LLI,P004773,P009680,0 days 00:01:56,8,10,2
55,PRS,P012608,P012613,0 days 00:24:10,23,73,50
55,PRS,P012608,P012610,0 days 00:24:10,23,73,50
55,PRS,P012610,P012613,0 days 00:24:10,23,73,50
55,PRS,P005793,P012640,0 days 00:18:17,4,43,39
55,PRS,P009556,P012640,0 days 00:15:50,4,41,37
55,PRS,P004512,P012608,0 days 00:15:00,18,46,28
55,PRS,P004512,P012610,0 days 00:15:00,18,46,28
55,PRS,P004512,P012613,0 days 00:15:00,18,46,28
55,PRS,P009556,P012609,0 days 00:13:24,2,32,30
55,PRS,P012609,P012640,0 days 00:13:24,2,32,30
55,PRS,P003481,P012609,0 days 00:12:43,1,30,29
55,PRS,P003481,P012640,0 days 00:12:17,7,32,25
55,PRS,P003481,P009556,0 days 00:12:17,7,32,25
55,PRS,P012610,P012611,0 days 00:11:53,14,38,24
55,PRS,P012608,P012611,0 days 00:11:53,14,38,24
55,PRS,P012611,P012613,0 days 00:11:53,14,38,24
55,PRS,P005793,P009556,0 days 00:11:21,-1,23,24
55,PRS,P005793,P012609,0 days 00:11:21,-1,23,24
55,PRS,P004512,P012611,0 days 00:10:58,12,34,22
55,PRS,P003481,P005793,0 days 00:09:21,0,18,18
55,PRS,P012608,P012640,0 days 00:06:56,5,20,15
55,PRS,P012613,P012640,0 days 00:06:56,5,20,15
55,PRS,P012610,P012640,0 days 00:06:56,5,20,15
55,PRS,P005793,P012613,0 days 00:06:56,5,20,15
55,PRS,P005793,P012608,0 days 00:06:56,5,20,15
55,PRS,P005793,P012610,0 days 00:06:56,5,20,15
55,PRS,P012608,P012609,0 days 00:06:16,6,19,13
55,PRS,P012609,P012610,0 days 00:06:16,6,19,13
55,PRS,P012609,P012613,0 days 00:06:16,6,19,13
55,PRS,P004512,P012609,0 days 00:06:02,5,17,12
55,PRS,P009556,P012611,0 days 00:04:29,5,18,13
55,PRS,P012611,P012640,0 days 00:04:29,5,18,13
55,PRS,P012609,P012611,0 days 00:02:58,5,13,8
55,PRS,P003481,P012611,0 days 00:02:56,7,14,7
55,PRS,P009556,P010801,0 days 00:02:26,2,9,7
55,PRS,P010801,P012640,0 days 00:02:26,2,9,7
55,PRS,P010801,P012611,0 days 00:02:26,2,9,7
55,PRS,P004512,P009556,0 days 00:02:00,-1,5,6
55,PRS,P004512,P012640,0 days 00:02:00,-1,5,6
55,PRS,P004512,P005793,0 days 00:02:00,-1,5,6
55,PRS,P009556,P011551,0 days 00:01:33,-2,4,6
55,PRS,P010801,P011551,0 days 00:01:33,-2,4,6
55,PRS,P011551,P012611,0 days 00:01:33,-2,4,6
55,PRS,P011551,P012640,0 days 00:01:33,-2,4,6
55,PRS,P003481,P012608,0 days 00:01:19,-2,3,5
55,PRS,P003481,P012610,0 days 00:01:19,-2,3,5
55,PRS,P003481,P012613,0 days 00:01:19,-2,3,5
55,PRS,P003481,P010801,0 days 00:00:53,4,5,1
55,HTA,P010465,P010550,0 days 00:22:13,-10,60,70
55,HTA,P007759,P010550,0 days 00:22:11,-18,51,69
55,HTA,P010550,P011973,0 days 00:22:01,-11,53,64
55,HTA,P007759,P011973,0 days 00:21:40,-15,48,63
55,HTA,P004846,P010550,0 days 00:18:32,-15,43,58
55,HTA,P004846,P007759,0 days 00:18:21,-12,40,52
55,HTA,P007759,P010465,0 days 00:18:06,-9,45,54
55,HTA,P010465,P011973,0 days 00:18:02,-4,45,49
55,HTA,P004846,P010465,0 days 00:17:59,-13,41,54
55,HTA,P006835,P010465,0 days 00:17:43,-10,38,48
55,HTA,P004846,P011973,0 days 00:17:35,-14,36,50
55,HTA,P006835,P007759,0 days 00:13:53,-10,28,38
55,HTA,P006835,P010550,0 days 00:13:11,-8,32,40
55,HTA,P004267,P006835,0 days 00:12:36,-12,23,35
55,HTA,P003533,P006835,0 days 00:12:18,-12,23,35
55,HTA,P004846,P006835,0 days 00:12:09,-9,19,28
55,HTA,P004267,P007759,0 days 00:11:50,-5,25,30
55,HTA,P006835,P011973,0 days 00:10:48,-4,22,26
55,HTA,P003533,P010465,0 days 00:09:51,-11,19,30
55,HTA,P004267,P010465,0 days 00:09:18,-9,14,23
55,HTA,P004267,P004846,0 days 00:09:08,-5,16,21
55,HTA,P003533,P004267,0 days 00:07:50,-8,12,20
55,HTA,P003533,P004846,0 days 00:07:48,-4,17,21
55,HTA,P006835,P011990,0 days 00:07:30,-7,17,24
55,HTA,P004267,P011973,0 days 00:07:26,-4,13,17
55,HTA,P004267,P010550,0 days 00:06:16,-4,12,16
55,HTA,P003533,P007759,0 days 00:04:57,-2,10,12
55,HTA,P011973,P011990,0 days 00:04:56,0,15,15
55,HTA,P003533,P010550,0 days 00:04:30,-4,11,15
55,HTA,P004267,P011990,0 days 00:04:24,-9,7,16
55,HTA,P010465,P011990,0 days 00:04:16,-2,10,12
55,HTA,P007759,P011990,0 days 00:03:14,-5,7,12
55,HTA,P010550,P011990,0 days 00:03:06,2,10,8
55,HTA,P003533,P011990,0 days 00:01:58,-7,0,7
55,HTA,P004267,P012592,0 days 00:00:36,0,2,2
55,HTA,P006835,P012592,0 days 00:00:36,0,2,2
55,HTA,P007759,P012592,0 days 00:00:36,0,2,2
55,HTA,P011990,P012592,0 days 00:00:36,0,2,2
56,LKB,P007029,PLXI,0 days 00:27:36,6,65,59
56,LKB,P002012,PLXI,0 days 00:25:04,-1,54,55
56,LKB,P004664,P007029,0 days 00:22:43,0,62,62
56,LKB,P002012,P007029,0 days 00:21:49,1,50,49
56,LKB,P004664,PLXI,0 days 00:19:56,-7,43,50
56,LKB,P002012,P006230,0 days 00:19:55,3,51,48
56,LKB,P006230,PLXI,0 days 00:18:25,9,48,39
56,LKB,P006230,P007029,0 days 00:17:03,14,51,37
56,LKB,P004664,P006230,0 days 00:16:50,6,45,39
56,LKB,P002012,P004664,0 days 00:16:39,-5,37,42
56,LKB,P010461,PLXI,0 days 00:13:51,-6,25,31
56,LKB,P007029,P010461,0 days 00:12:43,-4,30,34
56,LKB,P008856,PLXI,0 days 00:11:55,10,28,18
56,LKB,P005521,PLXI,0 days 00:11:52,11,32,21
56,LKB,P005521,P008856,0 days 00:10:37,2,25,23
56,LKB,P005521,P006230,0 days 00:10:02,0,26,26
56,LKB,P002012,P008856,0 days 00:09:45,-1,19,20
56,LKB,P005521,P007029,0 days 00:09:22,18,40,22
56,LKB,P005521,P010461,0 days 00:08:20,6,27,21
56,LKB,P006230,P008856,0 days 00:07:45,0,19,19
56,LKB,P002012,P010461,0 days 00:07:31,-6,10,16
56,LKB,P004664,P010461,0 days 00:07:23,-10,17,27
56,LKB,P005521,P006901,0 days 00:07:21,4,25,21
56,LKB,P004664,P005521,0 days 00:07:20,4,26,22
56,LKB,P002012,P005521,0 days 00:06:42,0,18,18
56,LKB,P007029,P008856,0 days 00:06:38,10,17,7
56,LKB,P008856,P010461,0 days 00:06:23,2,11,9
56,LKB,P004664,P006901,0 days 00:04:31,0,18,18
56,LKB,P005521,P010190,0 days 00:04:20,-9,5,14
56,LKB,P006230,P010190,0 days 00:04:20,-9,5,14
56,LKB,P006230,P006901,0 days 00:04:00,1,11,10
56,LKB,P006901,P007029,0 days 00:03:38,7,21,14
56,LKB,P006901,P008856,0 days 00:03:07,2,8,6
56,LKB,P006901,P010461,0 days 00:03:01,-2,12,14
56,LKB,P006901,PLXI,0 days 00:02:53,2,9,7
56,LKB,P008856,P010190,0 days 00:02:50,-5,5,10
56,LKB,P002012,P010190,0 days 00:02:19,-3,5,8
56,LKB,P006901,P010190,0 days 00:02:01,-6,0,6
56,LKB,P004664,P010190,0 days 00:01:30,-4,0,4
56,BOU,P010718,P011836,0 days 00:21:45,-6,48,54
56,BOU,P010431,P011161,0 days 00:17:38,-17,34,51
56,BOU,P000498,P012628,0 days 00:17:32,14,55,41
56,BOU,P011836,P011837,0 days 00:16:34,12,41,29
56,BOU,P010718,P011837,0 days 00:15:40,10,39,29
56,BOU,P011836,P012628,0 days 00:14:47,3,39,36
56,BOU,P000498,P010718,0 days 00:14:36,8,45,37
56,BOU,P011837,P012628,0 days 00:14:34,18,42,24
56,BOU,P000498,P011837,0 days 00:14:19,22,44,22
56,BOU,P010718,P012628,0 days 00:13:54,2,41,39
56,BOU,P000498,P011836,0 days 00:13:53,9,38,29
56,BOU,P010431,P012619,0 days 00:13:34,-13,30,43
56,BOU,P010431,P010718,0 days 00:13:34,-6,32,38
56,BOU,P010718,P011161,0 days 00:12:31,-11,22,33
56,BOU,P011161,P012619,0 days 00:11:25,-14,23,37
56,BOU,P010431,P011836,0 days 00:11:22,-7,20,27
56,BOU,P011161,P011836,0 days 00:11:02,-13,17,30
56,BOU,P010431,P010450,0 days 00:10:50,-15,20,35
56,BOU,P010431,P011837,0 days 00:10:49,14,27,13
56,BOU,P010450,P011161,0 days 00:10:44,-14,21,35
56,BOU,P004525,P010431,0 days 00:10:35,-5,24,29
56,BOU,P010450,P012619,0 days 00:10:22,-14,18,32
56,BOU,P010718,P012619,0 days 00:09:23,-5,24,29
56,BOU,P000498,P010431,0 days 00:08:49,10,27,17
56,BOU,P010431,P012628,0 days 00:08:37,11,30,19
56,BOU,P011161,P011837,0 days 00:06:35,0,11,11
56,BOU,P011836,P012619,0 days 00:06:32,-8,12,20
56,BOU,P010450,P010718,0 days 00:06:13,-2,15,17
56,BOU,P012619,P012628,0 days 00:05:52,-1,19,20
56,BOU,P000498,P012619,0 days 00:05:37,-4,14,18
56,BOU,P004525,P012619,0 days 00:05:23,-13,8,21
56,BOU,P004525,P011161,0 days 00:05:22,-12,8,20
56,BOU,P000498,P004525,0 days 00:05:13,7,16,9
56,BOU,P004525,P010450,0 days 00:05:09,-15,6,21
56,BOU,P004525,P012628,0 days 00:04:49,12,18,6
56,BOU,P004525,P011837,0 days 00:04:20,10,14,4
56,BOU,P011161,P012628,0 days 00:03:19,1,8,7
56,BOU,P010450,P011836,0 days 00:03:08,-4,5,9
56,BOU,P000498,P010450,0 days 00:01:25,-2,1,3
56,BOU,P004525,P010718,0 days 00:00:52,-2,2,4
56,BOU,P010450,P011837,0 days 00:00:45,2,2,0
56,BOU,P004525,P011836,0 days 00:00:37,-2,0,2
57,TTK,P005000,P011925,0 days 00:31:07,-7,53,60
57,TTK,P011925,P012056,0 days 00:30:11,-13,53,66
57,TTK,P011239,P011925,0 days 00:29:23,-8,53,61
57,TTK,P006693,P011925,0 days 00:24:03,-7,45,52
57,TTK,P005000,P012056,0 days 00:23:06,-7,39,46
57,TTK,P005000,P011239,0 days 00:21:38,-4,37,41
57,TTK,P011239,P012056,0 days 00:21:16,-8,37,45
57,TTK,P005000,P012697,0 days 00:21:15,-4,38,42
57,TTK,P011925,P012697,0 days 00:21:15,-4,38,42
57,TTK,P006693,P012056,0 days 00:19:04,-9,31,40
57,TTK,P006693,P011239,0 days 00:16:34,-2,30,32
57,TTK,P011239,P012697,0 days 00:16:05,-3,31,34
57,TTK,P005000,P006693,0 days 00:16:01,-1,29,30
57,TTK,P012056,P012697,0 days 00:15:42,-5,28,33
57,TTK,P009845,P011239,0 days 00:08:12,-6,12,18
57,TTK,P006693,P011975,0 days 00:07:48,-1,12,13
57,TTK,P011239,P011975,0 days 00:07:48,-1,12,13
57,TTK,P009845,P011925,0 days 00:07:38,-8,12,20
57,TTK,P011925,P011975,0 days 00:06:57,-1,12,13
57,TTK,P006693,P012697,0 days 00:06:09,2,14,12
57,TTK,P005685,P011925,0 days 00:06:02,-4,10,14
57,TTK,P005685,P012056,0 days 00:06:02,-4,10,14
57,TTK,P005000,P005685,0 days 00:05:45,-2,10,12
57,TTK,P006693,P009845,0 days 00:05:21,-6,10,16
57,TTK,P005685,P006693,0 days 00:04:36,-4,9,13
57,TTK,P009845,P012056,0 days 00:04:24,-6,8,14
57,TTK,P011975,P012056,0 days 00:04:23,0,6,6
57,TTK,P005000,P009845,0 days 00:03:08,-2,2,4
57,TTK,P009845,P012697,0 days 00:03:08,-2,2,4
57,TTK,P005000,P011975,0 days 00:02:28,-1,4,5
57,TTK,P009845,P011975,0 days 00:01:48,0,2,2
57,TTK,P005685,P012697,0 days 00:01:26,0,1,1
57,TTK,P005685,P009845,0 days 00:00:17,-2,0,2
57,CAN,P001607,P005005,0 days 00:18:18,0,32,32
57,CAN,P008121,P010452,0 days 00:18:04,13,46,33
57,CAN,P003425,P010452,0 days 00:16:12,6,34,28
57,CAN,P004160,P010452,0 days 00:14:18,14,35,21
57,CAN,P001607,P007644,0 days 00:13:57,-4,20,24
57,CAN,P005005,P010385,0 days 00:13:18,-2,22,24
57,CAN,P001607,P004160,0 days 00:13:03,12,32,20
57,CAN,P003425,P008121,0 days 00:12:59,5,30,25
57,CAN,P005005,P007644,0 days 00:12:14,-5,16,21
57,CAN,P004160,P005005,0 days 00:11:52,7,22,15
57,CAN,P010385,P010452,0 days 00:11:38,8,28,20
57,CAN,P008121,P009864,0 days 00:11:24,8,27,19
57,CAN,P009864,P010452,0 days 00:11:24,8,27,19
57,CAN,P007560,P010452,0 days 00:11:20,4,25,21
57,CAN,P001607,P010385,0 days 00:11:11,-2,20,22
57,CAN,P001607,P010452,0 days 00:11:09,13,32,19
57,CAN,P007560,P009864,0 days 00:10:18,7,20,13
57,CAN,P001607,P009864,0 days 00:09:22,10,23,13
57,CAN,P005005,P010452,0 days 00:09:17,6,20,14
57,CAN,P004160,P007644,0 days 00:08:46,4,21,17
57,CAN,P003425,P007560,0 days 00:08:18,4,17,13
57,CAN,P003425,P009864,0 days 00:08:18,4,17,13
57,CAN,P007560,P008121,0 days 00:08:18,4,17,13
57,CAN,P001607,P007560,0 days 00:07:47,-1,14,15
57,CAN,P005005,P007560,0 days 00:07:47,-1,14,15
57,CAN,P004160,P010385,0 days 00:07:40,5,14,9
57,CAN,P004160,P008121,0 days 00:07:28,8,23,15
57,CAN,P004160,P009864,0 days 00:07:07,9,20,11
57,CAN,P003425,P004160,0 days 00:06:17,3,13,10
57,CAN,P007644,P009864,0 days 00:06:16,6,13,7
57,CAN,P005005,P009864,0 days 00:06:16,6,13,7
57,CAN,P001607,P008121,0 days 00:05:30,7,16,9
57,CAN,P003425,P010385,0 days 00:05:28,1,10,9
57,CAN,P003637,P010385,0 days 00:05:09,-5,6,11
57,CAN,P007644,P010385,0 days 00:05:01,-9,2,11
57,CAN,P007560,P007644,0 days 00:04:45,-1,6,7
57,CAN,P007644,P008121,0 days 00:04:09,2,11,9
57,CAN,P007560,P010385,0 days 00:03:50,-1,10,11
57,CAN,P001607,P003637,0 days 00:03:47,-6,2,8
57,CAN,P007644,P010452,0 days 00:03:44,3,11,8
57,CAN,P008121,P010385,0 days 00:03:21,1,8,7
57,CAN,P003425,P005005,0 days 00:03:13,1,4,3
57,CAN,P003637,P007644,0 days 00:03:06,-8,0,8
57,CAN,P003637,P008121,0 days 00:02:43,0,6,6
57,CAN,P003637,P005005,0 days 00:02:41,-7,0,7
57,CAN,P003425,P007644,0 days 00:02:26,1,7,6
57,CAN,P003637,P010452,0 days 00:02:18,1,6,5
57,CAN,P003425,P003637,0 days 00:01:37,-1,4,5
57,CAN,P001607,P010484,0 days 00:01:08,-1,1,2
57,CAN,P005005,P010484,0 days 00:01:08,-1,1,2
57,CAN,P007560,P010484,0 days 00:01:08,-1,1,2
57,CAN,P007644,P010484,0 days 00:01:08,-1,1,2
57,CAN,P004160,P007560,0 days 00:00:49,-2,0,2
57,CAN,P003637,P009864,0 days 00:00:15,-2,0,2
58,WRO,P005531,P009896,0 days 00:25:44,4,51,47
58,WRO,P009896,P012010,0 days 00:21:27,3,42,39
58,WRO,P005531,P012010,0 days 00:21:22,2,44,42
58,WRO,P012010,P012699,0 days 00:19:04,-9,37,46
58,WRO,P009896,P012736,0 days 00:18:01,6,34,28
58,WRO,P005531,P012736,0 days 00:17:37,5,36,31
58,WRO,P012010,P012736,0 days 00:17:16,2,33,31
58,WRO,P011900,P012010,0 days 00:15:39,-7,29,36
58,WRO,P011165,P012699,0 days 00:14:34,-2,34,36
58,WRO,P005531,P011900,0 days 00:14:00,-7,23,30
58,WRO,P011165,P012010,0 days 00:13:57,2,33,31
58,WRO,P005531,P011165,0 days 00:13:46,-1,28,29
58,WRO,P005531,P012699,0 days 00:13:11,-3,30,33
58,WRO,P003034,P011165,0 days 00:12:46,-10,22,32
58,WRO,P009896,P011900,0 days 00:12:29,-2,21,23
58,WRO,P009896,P012699,0 days 00:12:01,0,26,26
58,WRO,P003034,P012699,0 days 00:10:51,-6,22,28
58,WRO,P009896,P011165,0 days 00:09:27,7,22,15
58,WRO,P003034,P012010,0 days 00:09:11,-3,18,21
58,WRO,P011900,P012699,0 days 00:08:56,-7,14,21
58,WRO,P011165,P011900,0 days 00:08:27,-9,12,21
58,WRO,P011900,P012736,0 days 00:07:48,-2,15,17
58,WRO,P011902,P012010,0 days 00:07:20,-2,12,14
58,WRO,P005531,P011901,0 days 00:07:15,-7,10,17
58,WRO,P011165,P011901,0 days 00:07:15,-7,10,17
58,WRO,P012699,P012736,0 days 00:06:27,-3,11,14
58,WRO,P003034,P011900,0 days 00:06:13,-7,8,15
58,WRO,P011165,P011902,0 days 00:05:27,-2,10,12
58,WRO,P011165,P012736,0 days 00:04:53,6,13,7
58,WRO,P011902,P012699,0 days 00:04:50,-2,10,12
58,WRO,P003034,P011902,0 days 00:04:34,0,10,10
58,WRO,P003034,P005531,0 days 00:03:54,-7,4,11
58,WRO,P011900,P011901,0 days 00:03:44,-5,2,7
58,WRO,P009896,P011901,0 days 00:03:40,0,6,6
58,WRO,P003034,P011901,0 days 00:03:35,-7,4,11
58,WRO,P005531,P011902,0 days 00:03:23,-2,2,4
58,WRO,P009896,P011902,0 days 00:03:23,-2,2,4
58,WRO,P011902,P012736,0 days 00:02:46,-2,2,4
58,WRO,P011901,P012699,0 days 00:02:38,0,8,8
58,WRO,P011901,P011902,0 days 00:00:53,-2,0,2
58,WRO,P011900,P011902,0 days 00:00:16,-2,0,2
58,TRN,P005738,P009903,0 days 00:23:25,5,42,37
58,TRN,P005738,P012595,0 days 00:22:51,8,45,37
58,TRN,P005059,P012597,0 days 00:22:25,15,60,45
58,TRN,P009903,P012595,0 days 00:21:47,5,40,35
58,TRN,P005738,P012597,0 days 00:17:45,8,35,27
58,TRN,P012595,P012597,0 days 00:15:43,9,31,22
58,TRN,P005059,P012596,0 days 00:15:11,6,42,36
58,TRN,P012596,P012597,0 days 00:14:51,4,42,38
58,TRN,P009903,P012597,0 days 00:14:36,9,26,17
58,TRN,P005059,P012595,0 days 00:14:12,7,28,21
58,TRN,P005738,P012594,0 days 00:14:04,-5,22,27
58,TRN,P005059,P005738,0 days 00:13:20,10,32,22
58,TRN,P001479,P005059,0 days 00:13:01,5,33,28
58,TRN,P009903,P012594,0 days 00:12:57,-4,19,23
58,TRN,P001479,P012596,0 days 00:12:19,5,33,28
58,TRN,P001479,P012597,0 days 00:11:59,5,33,28
58,TRN,P012594,P012595,0 days 00:11:47,-2,19,21
58,TRN,P005059,P009903,0 days 00:10:53,9,23,14
58,TRN,P012593,P012595,0 days 00:08:23,1,14,13
58,TRN,P005738,P012593,0 days 00:08:16,-1,14,15
58,TRN,P005059,P012593,0 days 00:08:02,7,20,13
58,TRN,P012594,P012597,0 days 00:07:44,-1,11,12
58,TRN,P009903,P012593,0 days 00:07:34,1,14,13
58,TRN,P005059,P006382,0 days 00:07:25,3,19,16
58,TRN,P006382,P012597,0 days 00:07:12,3,19,16
58,TRN,P012593,P012596,0 days 00:06:20,2,15,13
58,TRN,P006382,P012596,0 days 00:06:15,1,17,16
58,TRN,P012593,P012594,0 days 00:05:52,-4,9,13
58,TRN,P001479,P012593,0 days 00:05:38,4,15,11
58,TRN,P001479,P006382,0 days 00:05:34,4,16,12
58,TRN,P012593,P012597,0 days 00:05:31,2,15,13
58,TRN,P012595,P012596,0 days 00:03:55,0,7,7
58,TRN,P005738,P012596,0 days 00:03:34,-1,9,10
58,TRN,P001479,P012595,0 days 00:03:08,-3,2,5
58,TRN,P005738,P007828,0 days 00:02:50,-7,2,9
58,TRN,P007828,P009903,0 days 00:02:50,-7,2,9
58,TRN,P007828,P012594,0 days 00:02:20,-4,2,6
58,TRN,P005738,P006382,0 days 00:01:51,-1,3,4
58,TRN,P007828,P012595,0 days 00:01:40,-5,2,7
58,TRN,P007828,P012597,0 days 00:01:10,-2,0,2
58,TRN,P012594,P012596,0 days 00:01:07,-1,3,4
58,TRN,P006382,P009903,0 days 00:00:53,2,2,0
58,TRN,P005059,P007828,0 days 00:00:30,-3,0,3
58,TRN,P006382,P012595,0 days 00:00:30,0,0,0
58,TRN,P005059,P012594,0 days 00:00:25,1,3,2
58,TRN,P001479,P009903,0 days 00:00:25,0,0,0
59,CLU,P004862,P010569,0 days 00:22:23,12,51,39
59,CLU,P004862,P011797,0 days 00:21:57,11,51,40
59,CLU,P004862,P005113,0 days 00:20:50,12,47,35
59,CLU,P010569,P011797,0 days 00:20:29,13,47,34
59,CLU,P005113,P011797,0 days 00:18:23,16,43,27
59,CLU,P004862,P012698,0 days 00:18:14,0,37,37
59,CLU,P005113,P010569,0 days 00:18:09,20,45,25
59,CLU,P005714,P011801,0 days 00:16:09,1,31,30
59,CLU,P005714,P012698,0 days 00:15:32,-1,33,34
59,CLU,P005373,P005714,0 days 00:14:32,7,33,26
59,CLU,P005373,P012698,0 days 00:14:16,5,33,28
59,CLU,P011801,P012698,0 days 00:14:04,1,29,28
59,CLU,P005373,P011801,0 days 00:13:37,6,29,23
59,CLU,P011797,P012698,0 days 00:13:11,10,35,25
59,CLU,P011797,P012621,0 days 00:12:13,-2,20,22
59,CLU,P004862,P012621,0 days 00:12:02,-3,22,25
59,CLU,P010569,P012621,0 days 00:12:02,-3,22,25
59,CLU,P004862,P005373,0 days 00:10:53,-9,17,26
59,CLU,P004862,P011801,0 days 00:10:43,-3,18,21
59,CLU,P005113,P012698,0 days 00:09:57,3,22,19
59,CLU,P004862,P005714,0 days 00:09:46,-9,17,26
59,CLU,P005373,P011797,0 days 00:09:39,-4,19,23
59,CLU,P011797,P011801,0 days 00:08:43,5,18,13
59,CLU,P010569,P012698,0 days 00:08:41,9,22,13
59,CLU,P005113,P012621,0 days 00:08:39,5,18,13
59,CLU,P005714,P011797,0 days 00:07:33,-1,15,16
59,CLU,P005373,P012621,0 days 00:05:15,-8,4,12
59,CLU,P005113,P011801,0 days 00:05:10,-1,9,10
59,CLU,P005373,P010569,0 days 00:04:01,-8,4,12
59,CLU,P005113,P005714,0 days 00:03:05,-8,2,10
59,CLU,P010569,P011801,0 days 00:02:38,4,7,3
59,CLU,P005714,P012621,0 days 00:02:18,0,4,4
59,CLU,P005714,P012620,0 days 00:02:12,7,11,4
59,CLU,P011801,P012621,0 days 00:02:05,0,2,2
59,CLU,P005373,P012620,0 days 00:01:59,7,9,2
59,CLU,P011801,P012620,0 days 00:01:59,7,9,2
59,CLU,P012620,P012698,0 days 00:01:59,7,9,2
59,CLU,P012621,P012698,0 days 00:00:58,-2,0,2
59,CLU,P004862,P012620,0 days 00:00:56,1,4,3
59,CLU,P010569,P012620,0 days 00:00:56,1,4,3
59,CLU,P012620,P012621,0 days 00:00:56,1,4,3
59,CLU,P005113,P012620,0 days 00:00:43,1,2,1
59,CLU,P005714,P010569,0 days 00:00:13,0,2,2
59,ULM,P010106,P012604,0 days 00:24:18,13,53,40
59,ULM,P012603,P012604,0 days 00:23:46,10,52,42
59,ULM,P010582,P012604,0 days 00:23:18,4,48,44
59,ULM,P010582,P012603,0 days 00:23:11,1,47,46
59,ULM,P010106,P012603,0 days 00:23:02,14,52,38
59,ULM,P010106,P010582,0 days 00:22:56,10,50,40
59,ULM,P011457,P012604,0 days 00:16:04,17,44,27
59,ULM,P005422,P012604,0 days 00:15:09,-8,22,30
59,ULM,P012629,P012703,0 days 00:12:58,-17,18,35
59,ULM,P010106,P011457,0 days 00:12:40,19,37,18
59,ULM,P010582,P011457,0 days 00:12:13,17,35,18
59,ULM,P005422,P012603,0 days 00:12:03,-5,20,25
59,ULM,P011457,P012603,0 days 00:11:02,18,34,16
59,ULM,P005422,P012629,0 days 00:10:59,-11,15,26
59,ULM,P005422,P012703,0 days 00:10:54,-19,14,33
59,ULM,P005422,P010106,0 days 00:09:55,1,17,16
59,ULM,P005422,P010582,0 days 00:09:22,-6,14,20
59,ULM,P012604,P012629,0 days 00:08:30,0,16,16
59,ULM,P007952,P012703,0 days 00:08:19,-17,11,28
59,ULM,P006997,P012703,0 days 00:07:20,-16,6,22
59,ULM,P006997,P012629,0 days 00:06:55,-14,6,20
59,ULM,P007952,P012629,0 days 00:06:54,-14,9,23
59,ULM,P012604,P012703,0 days 00:06:47,-7,9,16
59,ULM,P011457,P012629,0 days 00:06:21,2,16,14
59,ULM,P011457,P012703,0 days 00:06:07,-2,14,16
59,ULM,P005422,P007952,0 days 00:05:29,-8,9,17
59,ULM,P012603,P012629,0 days 00:05:24,1,11,10
59,ULM,P005422,P011457,0 days 00:04:56,-2,11,13
59,ULM,P012603,P012703,0 days 00:04:54,-9,6,15
59,ULM,P010726,P012603,0 days 00:04:14,-5,4,9
59,ULM,P007952,P012603,0 days 00:04:12,-5,6,11
59,ULM,P010582,P010726,0 days 00:04:10,-6,2,8
59,ULM,P005422,P006997,0 days 00:04:04,-13,0,13
59,ULM,P006997,P007952,0 days 00:03:37,-11,4,15
59,ULM,P006997,P012604,0 days 00:03:30,-3,2,5
59,ULM,P006997,P011457,0 days 00:03:02,-1,6,7
59,ULM,P010726,P012604,0 days 00:03:01,-2,2,4
59,ULM,P010106,P010726,0 days 00:03:01,-2,2,4
59,ULM,P007952,P011457,0 days 00:02:30,2,7,5
59,ULM,P010106,P012629,0 days 00:02:26,3,7,4
59,ULM,P010726,P012703,0 days 00:02:05,-9,2,11
59,ULM,P007952,P010726,0 days 00:01:52,-7,2,9
59,ULM,P010582,P012703,0 days 00:01:52,-8,0,8
59,ULM,P007952,P010582,0 days 00:01:32,-2,2,4
59,ULM,P006997,P010726,0 days 00:00:52,-6,0,6
59,ULM,P010582,P012629,0 days 00:00:42,-2,2,4
59,ULM,P005422,P010726,0 days 00:00:29,-1,2,3
59,ULM,P010726,P012629,0 days 00:00:27,-4,0,4
59,ULM,P007952,P010106,0 days 00:00:22,2,2,0
59,ULM,P010726,P011457,0 days 00:00:13,-2,0,2
59,ULM,P007952,P012604,0 days 00:00:01,0,0,0
60,BUD,P004945,P011935,0 days 00:30:13,15,54,39
60,BUD,P011935,P012606,0 days 00:27:55,-2,44,46
60,BUD,P010432,P011935,0 days 00:26:01,-5,42,47
60,BUD,P010432,P012606,0 days 00:24:32,-1,42,43
60,BUD,P007398,P011935,0 days 00:22:54,1,38,37
60,BUD,P004945,P010432,0 days 00:22:44,5,40,35
60,BUD,P007398,P010432,0 days 00:22:23,1,38,37
60,BUD,P004945,P012606,0 days 00:21:52,11,42,31
60,BUD,P007398,P012606,0 days 00:21:25,5,38,33
60,BUD,P004945,P007398,0 days 00:20:41,8,38,30
60,BUD,P011935,P012630,0 days 00:16:06,-6,18,24
60,BUD,P010248,P012630,0 days 00:13:28,3,21,18
60,BUD,P010248,P012605,0 days 00:12:45,4,19,15
60,BUD,P012605,P012630,0 days 00:12:45,4,19,15
60,BUD,P004945,P012630,0 days 00:11:11,7,19,12
60,BUD,P011935,P012605,0 days 00:11:07,1,12,11
60,BUD,P012606,P012630,0 days 00:09:51,-17,6,23
60,BUD,P010248,P011935,0 days 00:09:44,7,14,7
60,BUD,P004945,P012605,0 days 00:09:29,4,15,11
60,BUD,P004945,P010248,0 days 00:08:06,10,17,7
60,BUD,P010432,P012630,0 days 00:05:51,-13,4,17
60,BUD,P009214,P012630,0 days 00:03:44,-4,7,11
60,BUD,P009214,P010248,0 days 00:03:44,-4,7,11
60,BUD,P006566,P012630,0 days 00:03:40,-7,6,13
60,BUD,P010248,P012606,0 days 00:03:29,-4,2,6
60,BUD,P009214,P012605,0 days 00:03:07,-1,7,8
60,BUD,P012605,P012606,0 days 00:02:46,-3,0,3
60,BUD,P007398,P012630,0 days 00:02:44,-7,0,7
60,BUD,P006566,P010248,0 days 00:02:36,-4,4,8
60,BUD,P006566,P009214,0 days 00:02:36,-4,4,8
60,BUD,P006566,P012605,0 days 00:01:59,-1,4,5
60,BUD,P006566,P012606,0 days 00:01:41,-6,2,8
60,BUD,P007398,P012605,0 days 00:01:29,-4,0,4
60,BUD,P010432,P012605,0 days 00:01:29,-4,0,4
60,BUD,P004945,P009214,0 days 00:01:08,0,3,3
60,BUD,P006566,P010432,0 days 00:01:04,-3,2,5
60,BUD,P006566,P011935,0 days 00:01:04,-3,2,5
60,BUD,P009214,P012606,0 days 00:00:37,-3,0,3
60,ARI,P003240,P012708,0 days 00:23:00,7,49,42
60,ARI,P012615,P012708,0 days 00:19:46,16,43,27
60,ARI,P002867,P012702,0 days 00:19:10,4,24,20
60,ARI,P003240,P012615,0 days 00:18:16,10,39,29
60,ARI,P002867,P003240,0 days 00:15:57,-5,22,27
60,ARI,P003240,P012702,0 days 00:15:23,0,20,20
60,ARI,P002867,P012716,0 days 00:15:05,-9,12,21
60,ARI,P002867,P012708,0 days 00:14:56,2,20,18
60,ARI,P012708,P012760,0 days 00:14:18,7,38,31
60,ARI,P003240,P012760,0 days 00:14:12,3,36,33
60,ARI,P002867,P012615,0 days 00:12:53,6,19,13
60,ARI,P012702,P012708,0 days 00:12:49,5,16,11
60,ARI,P012615,P012702,0 days 00:11:49,3,14,11
60,ARI,P012708,P012716,0 days 00:10:50,1,16,15
60,ARI,P012716,P012760,0 days 00:10:48,-15,10,25
60,ARI,P003240,P012707,0 days 00:10:18,-6,15,21
60,ARI,P012707,P012716,0 days 00:09:59,-13,9,22
60,ARI,P003240,P012716,0 days 00:09:57,-9,12,21
60,ARI,P012615,P012760,0 days 00:09:56,12,30,18
60,ARI,P012702,P012716,0 days 00:09:34,5,11,6
60,ARI,P012616,P012760,0 days 00:09:26,5,25,20
60,ARI,P012615,P012616,0 days 00:08:17,9,25,16
60,ARI,P003240,P012616,0 days 00:08:17,9,25,16
60,ARI,P002867,P012707,0 days 00:07:38,-9,6,15
60,ARI,P002867,P012760,0 days 00:07:12,-10,7,17
60,ARI,P012707,P012760,0 days 00:07:12,-12,6,18
60,ARI,P012616,P012708,0 days 00:06:50,11,25,14
60,ARI,P004292,P012716,0 days 00:06:18,-6,4,10
60,ARI,P002867,P004292,0 days 00:06:18,-6,4,10
60,ARI,P012702,P012707,0 days 00:06:08,0,9,9
60,ARI,P012707,P012708,0 days 00:05:24,-1,9,10
60,ARI,P012615,P012716,0 days 00:04:32,6,6,0
60,ARI,P012616,P012716,0 days 00:04:25,0,4,4
60,ARI,P004292,P012760,0 days 00:04:08,-10,0,10
60,ARI,P004292,P012616,0 days 00:03:54,0,4,4
60,ARI,P002867,P012616,0 days 00:03:54,0,4,4
60,ARI,P004292,P012702,0 days 00:02:45,4,4,0
60,ARI,P012616,P012702,0 days 00:02:45,4,4,0
60,ARI,P010387,P012707,0 days 00:02:25,3,6,3
60,ARI,P010387,P012702,0 days 00:02:25,3,6,3
60,ARI,P003240,P010387,0 days 00:02:25,3,6,3
60,ARI,P002867,P010387,0 days 00:02:25,3,6,3
60,ARI,P004292,P012707,0 days 00:02:24,-6,0,6
60,ARI,P012615,P012707,0 days 00:00:56,-2,0,2
60,ARI,P012616,P012707,0 days 00:00:56,-2,0,2
60,ARI,P003240,P004292,0 days 00:00:35,0,0,0
60,ARI,P004292,P012615,0 days 00:00:35,0,0,0
60,ARI,P004292,P012708,0 days 00:00:35,0,0,0
61,PMT,P011823,P012600,0 days 00:21:17,3,59,56
61,PMT,P012599,P012600,0 days 00:19:49,-6,41,47
61,PMT,P011966,P012599,0 days 00:18:53,8,42,34
61,PMT,P001686,P012599,0 days 00:17:03,11,44,33
61,PMT,P011966,P012600,0 days 00:16:37,-3,39,42
61,PMT,P011947,P012600,0 days 00:16:20,3,39,36
61,PMT,P001686,P012600,0 days 00:16:15,6,42,36
61,PMT,P011944,P012600,0 days 00:14:44,4,41,37
61,PMT,P011823,P012599,0 days 00:14:35,-2,36,38
61,PMT,P011944,P012599,0 days 00:14:15,5,33,28
61,PMT,P002644,P012599,0 days 00:14:08,1,25,24
61,PMT,P001686,P011823,0 days 00:13:42,6,37,31
61,PMT,P001686,P011966,0 days 00:13:19,14,39,25
61,PMT,P011944,P011947,0 days 00:13:05,2,35,33
61,PMT,P002644,P011966,0 days 00:12:40,10,30,20
61,PMT,P011823,P011944,0 days 00:12:29,2,36,34
61,PMT,P011947,P012599,0 days 00:11:41,-13,19,32
61,PMT,P011823,P011966,0 days 00:11:02,-2,28,30
61,PMT,P002644,P011944,0 days 00:10:29,10,25,15
61,PMT,P011823,P011947,0 days 00:10:27,5,31,26
61,PMT,P002644,P012600,0 days 00:09:49,1,19,18
61,PMT,P011944,P011966,0 days 00:09:49,10,26,16
61,PMT,P001686,P011944,0 days 00:09:28,15,30,15
61,PMT,P001686,P011947,0 days 00:07:58,2,19,17
61,PMT,P002644,P011947,0 days 00:07:42,-8,9,17
61,PMT,P001686,P002644,0 days 00:07:39,10,21,11
61,PMT,P002020,P002644,0 days 00:07:12,1,17,16
61,PMT,P002020,P011966,0 days 00:05:31,3,14,11
61,PMT,P002020,P012600,0 days 00:05:11,9,18,9
61,PMT,P011943,P011966,0 days 00:05:02,-4,14,18
61,PMT,P002020,P011944,0 days 00:04:50,5,12,7
61,PMT,P011943,P012600,0 days 00:04:22,-1,14,15
61,PMT,P002644,P011943,0 days 00:04:09,-1,10,11
61,PMT,P002020,P011943,0 days 00:03:14,0,9,9
61,PMT,P002020,P012599,0 days 00:02:53,-4,3,7
61,PMT,P011943,P011944,0 days 00:02:43,-5,6,11
61,PMT,P002020,P011947,0 days 00:02:33,2,7,5
61,PMT,P011947,P011966,0 days 00:01:55,-4,0,4
61,PMT,P011823,P011943,0 days 00:01:48,-4,5,9
61,PMT,P011943,P012599,0 days 00:01:35,-4,1,5
61,PMT,P011943,P011947,0 days 00:00:55,-1,1,2
61,PMT,P002020,P011823,0 days 00:00:52,4,4,0
61,HTA,P006835,P011991,0 days 00:23:58,-11,47,58
61,HTA,P006835,P007759,0 days 00:22:49,-1,56,57
61,HTA,P006835,P010465,0 days 00:20:40,-4,50,54
61,HTA,P004846,P006835,0 days 00:20:34,-7,46,53
61,HTA,P006835,P011973,0 days 00:20:32,4,52,48
61,HTA,P007759,P011991,0 days 00:18:19,-2,41,43
61,HTA,P004846,P011991,0 days 00:17:59,-10,34,44
61,HTA,P004846,P007759,0 days 00:17:39,-4,43,47
61,HTA,P007759,P011973,0 days 00:17:09,1,47,46
61,HTA,P007759,P010465,0 days 00:16:34,1,44,43
61,HTA,P010465,P011973,0 days 00:16:31,-1,41,42
61,HTA,P010465,P011991,0 days 00:15:38,-1,35,36
61,HTA,P011973,P011991,0 days 00:15:10,-2,34,36
61,HTA,P004846,P010465,0 days 00:14:35,-7,34,41
61,HTA,P003533,P011991,0 days 00:13:48,-5,25,30
61,HTA,P003533,P004846,0 days 00:13:15,-1,24,25
61,HTA,P004846,P011973,0 days 00:13:14,-3,36,39
61,HTA,P004267,P011991,0 days 00:11:21,-9,22,31
61,HTA,P003533,P006835,0 days 00:11:01,-8,19,27
61,HTA,P004267,P004846,0 days 00:10:50,-1,26,27
61,HTA,P003533,P004267,0 days 00:09:31,-2,17,19
61,HTA,P003533,P007759,0 days 00:08:43,-1,16,17
61,HTA,P004267,P007759,0 days 00:07:19,-10,13,23
61,HTA,P003533,P010465,0 days 00:07:17,0,18,18
61,HTA,P004267,P006835,0 days 00:06:02,-5,12,17
61,HTA,P006835,P011990,0 days 00:05:40,0,10,10
61,HTA,P011990,P011991,0 days 00:04:43,-4,6,10
61,HTA,P004267,P010465,0 days 00:03:47,1,9,8
61,HTA,P011973,P011990,0 days 00:03:43,3,9,6
61,HTA,P004267,P011973,0 days 00:03:05,-2,9,11
61,HTA,P004846,P011990,0 days 00:02:54,1,5,4
61,HTA,P010465,P011990,0 days 00:02:46,-1,5,6
61,HTA,P003533,P011990,0 days 00:01:57,-3,1,4
61,HTA,P004267,P011990,0 days 00:00:57,4,4,0
62,JOV,P002361,P005094,0 days 00:21:59,-15,38,53
62,JOV,P010161,P012349,0 days 00:21:26,1,48,47
62,JOV,P005094,P011248,0 days 00:19:52,-21,35,56
62,JOV,P002361,P011248,0 days 00:19:26,-9,37,46
62,JOV,P002361,P012349,0 days 00:18:11,0,35,35
62,JOV,P002361,P010161,0 days 00:17:59,2,39,37
62,JOV,P002361,P006771,0 days 00:17:33,0,36,36
62,JOV,P009572,P012349,0 days 00:17:20,4,40,36
62,JOV,P005094,P010708,0 days 00:17:04,-1,36,37
62,JOV,P005094,P006771,0 days 00:16:45,-12,27,39
62,JOV,P002361,P010708,0 days 00:16:25,3,36,33
62,JOV,P009572,P010161,0 days 00:16:20,13,42,29
62,JOV,P010708,P011248,0 days 00:16:20,6,38,32
62,JOV,P006771,P011248,0 days 00:16:09,-4,34,38
62,JOV,P002361,P009572,0 days 00:15:59,10,36,26
62,JOV,P002361,P010709,0 days 00:15:04,13,35,22
62,JOV,P006771,P010708,0 days 00:14:59,7,35,28
62,JOV,P009572,P011248,0 days 00:12:46,-15,24,39
62,JOV,P010161,P011248,0 days 00:11:21,-24,14,38
62,JOV,P005094,P012349,0 days 00:10:40,-17,16,33
62,JOV,P005094,P009572,0 days 00:10:39,-5,25,30
62,JOV,P006771,P009572,0 days 00:10:35,-9,22,31
62,JOV,P010709,P012349,0 days 00:10:15,20,29,9
62,JOV,P011248,P012349,0 days 00:09:49,-27,10,37
62,JOV,P005094,P010161,0 days 00:09:47,-10,20,30
62,JOV,P006771,P012349,0 days 00:09:19,-13,14,27
62,JOV,P010161,P010709,0 days 00:09:07,22,29,7
62,JOV,P005094,P010709,0 days 00:08:22,1,19,18
62,JOV,P009572,P010709,0 days 00:07:24,20,24,4
62,JOV,P006771,P010161,0 days 00:07:05,-8,14,22
62,JOV,P006771,P010709,0 days 00:06:55,-1,14,15
62,JOV,P009572,P010708,0 days 00:06:33,-2,15,17
62,JOV,P010708,P010709,0 days 00:06:24,-1,14,15
62,JOV,P010709,P011248,0 days 00:03:05,2,8,6
62,JOV,P010161,P010708,0 days 00:01:03,0,2,2
62,PRS,P012608,P012610,0 days 00:30:47,8,64,56
62,PRS,P004512,P012610,0 days 00:23:02,4,44,40
62,PRS,P004512,P012608,0 days 00:23:02,4,44,40
62,PRS,P012609,P012640,0 days 00:22:15,6,57,51
62,PRS,P012610,P012611,0 days 00:19:52,-4,36,40
62,PRS,P012608,P012611,0 days 00:19:52,-4,36,40
62,PRS,P004512,P012611,0 days 00:18:04,-5,30,35
62,PRS,P005793,P012640,0 days 00:18:02,5,49,44
62,PRS,P012609,P012610,0 days 00:16:59,10,39,29
62,PRS,P012608,P012609,0 days 00:16:52,10,39,29
62,PRS,P009556,P012609,0 days 00:14:13,-1,37,38
62,PRS,P009556,P012640,0 days 00:14:13,-1,37,38
62,PRS,P005793,P009556,0 days 00:14:06,-1,37,38
62,PRS,P005793,P012609,0 days 00:14:06,-1,37,38
62,PRS,P004512,P012609,0 days 00:13:03,12,31,19
62,PRS,P012610,P012640,0 days 00:12:05,13,32,19
62,PRS,P003481,P012609,0 days 00:12:02,-11,27,38
62,PRS,P012608,P012640,0 days 00:11:58,13,32,19
62,PRS,P003481,P012640,0 days 00:11:17,-11,25,36
62,PRS,P003481,P009556,0 days 00:10:24,-10,23,33
62,PRS,P003481,P005793,0 days 00:10:17,-10,23,33
62,PRS,P012609,P012611,0 days 00:09:53,4,23,19
62,PRS,P012612,P012640,0 days 00:08:53,13,26,13
62,PRS,P005793,P012612,0 days 00:07:45,15,26,11
62,PRS,P012608,P012613,0 days 00:07:36,-2,13,15
62,PRS,P012610,P012613,0 days 00:07:36,-2,13,15
62,PRS,P004512,P012613,0 days 00:07:36,-2,13,15
62,PRS,P012611,P012613,0 days 00:07:36,-2,13,15
62,PRS,P005793,P012608,0 days 00:06:19,0,12,12
62,PRS,P005793,P012610,0 days 00:06:19,0,12,12
62,PRS,P012608,P012612,0 days 00:05:04,4,12,8
62,PRS,P012610,P012612,0 days 00:05:04,4,12,8
62,PRS,P004512,P012640,0 days 00:04:58,9,14,5
62,PRS,P012609,P012612,0 days 00:04:57,7,14,7
62,PRS,P009556,P012612,0 days 00:03:49,9,14,5
62,PRS,P004512,P005793,0 days 00:02:23,-6,0,6
62,PRS,P005793,P012611,0 days 00:02:23,-6,0,6
62,PRS,P003481,P012610,0 days 00:01:45,-1,4,5
62,PRS,P003481,P012608,0 days 00:01:38,-1,4,5
62,PRS,P012611,P012640,0 days 00:01:03,1,4,3
62,PRS,P003481,P012611,0 days 00:00:45,0,2,2
62,PRS,P009556,P012610,0 days 00:00:07,0,0,0
63,BES,P008945,P009582,0 days 00:26:03,15,67,52
63,BES,P008945,P012647,0 days 00:25:03,6,58,52
63,BES,P009582,P012647,0 days 00:21:49,7,52,45
63,BES,P008945,P011936,0 days 00:20:49,11,51,40
63,BES,P009582,P011936,0 days 00:19:33,16,50,34
63,BES,P011936,P012647,0 days 00:17:38,0,36,36
63,BES,P007914,P009582,0 days 00:15:38,-2,35,37
63,BES,P008945,P012622,0 days 00:15:12,15,43,28
63,BES,P007914,P011936,0 days 00:15:06,-7,26,33
63,BES,P012622,P012647,0 days 00:13:43,-4,28,32
63,BES,P007914,P008945,0 days 00:13:40,-6,30,36
63,BES,P005348,P008945,0 days 00:13:38,14,34,20
63,BES,P005348,P012647,0 days 00:13:32,1,26,25
63,BES,P009582,P012622,0 days 00:13:10,14,37,23
63,BES,P005348,P012622,0 days 00:13:06,-1,23,24
63,BES,P007914,P012647,0 days 00:12:56,-1,30,31
63,BES,P011936,P012622,0 days 00:12:23,1,23,22
63,BES,P005348,P009582,0 days 00:12:12,13,30,17
63,BES,P005348,P011936,0 days 00:11:21,5,23,18
63,BES,P003783,P012622,0 days 00:09:21,-21,4,25
63,BES,P007914,P012622,0 days 00:08:46,-11,13,24
63,BES,P003783,P011936,0 days 00:08:13,-7,9,16
63,BES,P011379,P012622,0 days 00:07:04,-6,9,15
63,BES,P003783,P011379,0 days 00:06:17,-9,5,14
63,BES,P011379,P011936,0 days 00:06:16,-1,12,13
63,BES,P003783,P007914,0 days 00:06:05,-4,7,11
63,BES,P003783,P005348,0 days 00:04:38,-13,0,13
63,BES,P007914,P011379,0 days 00:04:18,-7,5,12
63,BES,P009582,P011379,0 days 00:04:01,2,10,8
63,BES,P003783,P009582,0 days 00:03:10,2,5,3
63,BES,P005348,P011379,0 days 00:02:37,-7,0,7
63,BES,P003783,P012647,0 days 00:02:37,-6,2,8
63,BES,P003783,P011357,0 days 00:02:25,-2,2,4
63,BES,P007914,P011357,0 days 00:02:25,-2,2,4
63,BES,P011357,P011936,0 days 00:02:25,-2,2,4
63,BES,P008945,P011379,0 days 00:02:07,1,7,6
63,BES,P005348,P007917,0 days 00:01:54,-8,0,8
63,BES,P007917,P012622,0 days 00:01:54,-8,0,8
63,BES,P003783,P007917,0 days 00:01:54,-8,0,8
63,BES,P009582,P011357,0 days 00:01:16,1,2,1
63,BES,P011357,P012622,0 days 00:01:09,-3,0,3
63,BES,P007917,P012647,0 days 00:00:58,-3,0,3
63,BES,P007917,P011379,0 days 00:00:56,-5,0,5
63,BES,P003783,P008945,0 days 00:00:36,0,2,2
63,BES,P005348,P007914,0 days 00:00:06,0,0,0
63,LLI,P005247,P009680,0 days 00:28:09,2,57,55
63,LLI,P006600,P012586,0 days 00:27:48,-3,55,58
63,LLI,P005247,P012585,0 days 00:23:52,-6,49,55
63,LLI,P009680,P012585,0 days 00:21:42,-3,48,51
63,LLI,P012585,P012586,0 days 00:21:37,-8,43,51
63,LLI,P005247,P012586,0 days 00:21:20,-7,39,46
63,LLI,P006600,P012585,0 days 00:21:14,-4,43,47
63,LLI,P005247,P006600,0 days 00:20:23,-5,37,42
63,LLI,P009680,P012586,0 days 00:19:50,-9,38,47
63,LLI,P006600,P009680,0 days 00:19:27,-5,38,43
63,LLI,P004479,P012585,0 days 00:16:47,9,39,30
63,LLI,P004479,P005247,0 days 00:15:41,7,34,27
63,LLI,P004773,P012586,0 days 00:13:20,8,30,22
63,LLI,P004773,P006600,0 days 00:12:45,6,28,22
63,LLI,P004479,P009680,0 days 00:12:29,5,28,23
63,LLI,P005247,P012020,0 days 00:12:11,6,28,22
63,LLI,P004479,P012020,0 days 00:11:49,10,28,18
63,LLI,P009680,P012020,0 days 00:11:37,4,26,22
63,LLI,P004773,P009680,0 days 00:11:06,2,21,19
63,LLI,P004479,P012586,0 days 00:10:09,1,21,20
63,LLI,P004479,P006600,0 days 00:09:35,-1,19,20
63,LLI,P004479,P004773,0 days 00:09:06,5,19,14
63,LLI,P012020,P012585,0 days 00:08:48,3,22,19
63,LLI,P004773,P005247,0 days 00:08:44,7,16,9
63,LLI,P004773,P012585,0 days 00:06:12,5,16,11
63,LLI,P004773,P012020,0 days 00:03:23,3,6,3
63,LLI,P012020,P012586,0 days 00:00:56,-2,2,4
64,LJU,P003452,P012700,0 days 00:28:28,-10,60,70
64,LJU,P002661,P003452,0 days 00:22:58,-15,48,63
64,LJU,P002661,P012700,0 days 00:19:32,-12,47,59
64,LJU,P001235,P003452,0 days 00:17:02,11,31,20
64,LJU,P003452,P011261,0 days 00:16:05,26,42,16
64,LJU,P010771,P011261,0 days 00:15:16,24,43,19
64,LJU,P003452,P009395,0 days 00:14:44,-9,22,31
64,LJU,P001235,P012700,0 days 00:13:55,12,26,14
64,LJU,P011261,P012700,0 days 00:13:39,27,41,14
64,LJU,P002661,P011261,0 days 00:13:29,15,35,20
64,LJU,P003452,P010771,0 days 00:12:58,20,40,20
64,LJU,P002661,P009392,0 days 00:12:21,-12,24,36
64,LJU,P010771,P012700,0 days 00:11:58,23,38,15
64,LJU,P009395,P012700,0 days 00:11:42,-11,18,29
64,LJU,P003452,P012598,0 days 00:11:28,-6,21,27
64,LJU,P012598,P012700,0 days 00:11:28,-6,21,27
64,LJU,P009395,P012598,0 days 00:10:58,-6,18,24
64,LJU,P001235,P011261,0 days 00:10:44,19,27,8
64,LJU,P002661,P007066,0 days 00:09:48,-18,14,32
64,LJU,P001235,P010771,0 days 00:09:44,19,27,8
64,LJU,P003452,P009392,0 days 00:09:20,-20,15,35
64,LJU,P009392,P012700,0 days 00:09:01,-18,19,37
64,LJU,P007066,P012700,0 days 00:08:48,-18,14,32
64,LJU,P002661,P010771,0 days 00:08:46,7,28,21
64,LJU,P002661,P009395,0 days 00:08:24,0,16,16
64,LJU,P003452,P007066,0 days 00:08:12,-20,9,29
64,LJU,P009392,P011261,0 days 00:06:27,6,14,8
64,LJU,P007066,P009392,0 days 00:06:21,-13,12,25
64,LJU,P001235,P002661,0 days 00:06:05,-1,9,10
64,LJU,P002661,P012598,0 days 00:05:41,-2,15,17
64,LJU,P001235,P012598,0 days 00:04:47,-2,6,8
64,LJU,P001235,P009395,0 days 00:04:47,-2,6,8
64,LJU,P009392,P009395,0 days 00:03:35,-3,4,7
64,LJU,P001235,P007066,0 days 00:03:00,-4,0,4
64,LJU,P009392,P010771,0 days 00:02:58,-1,8,9
64,LJU,P007066,P011261,0 days 00:02:36,2,5,3
64,LJU,P003452,P010594,0 days 00:02:33,-9,0,9
64,LJU,P009395,P010594,0 days 00:02:33,-9,0,9
64,LJU,P009395,P011261,0 days 00:02:13,4,4,0
64,LJU,P010594,P012700,0 days 00:01:33,-7,0,7
64,LJU,P009392,P010594,0 days 00:01:33,-7,0,7
64,LJU,P010594,P012598,0 days 00:01:00,-2,0,2
64,LJU,P002661,P010594,0 days 00:01:00,-2,0,2
64,LJU,P007066,P012598,0 days 00:00:27,-1,2,3
64,LJU,P011261,P012598,0 days 00:00:03,1,1,0
64,HAM,P009663,P012582,0 days 00:19:52,8,48,40
64,HAM,P011168,P012582,0 days 00:19:30,3,43,40
64,HAM,P009663,P011168,0 days 00:16:45,4,39,35
64,HAM,P012581,P012582,0 days 00:16:25,8,36,28
64,HAM,P009663,P012581,0 days 00:16:13,8,35,27
64,HAM,P011187,P012579,0 days 00:15:59,-7,32,39
64,HAM,P012580,P012582,0 days 00:14:48,8,36,28
64,HAM,P011168,P012581,0 days 00:14:39,8,37,29
64,HAM,P012582,P012648,0 days 00:12:34,-6,26,32
64,HAM,P011168,P012648,0 days 00:12:18,-8,23,31
64,HAM,P009663,P012580,0 days 00:11:47,7,31,24
64,HAM,P010070,P011187,0 days 00:10:50,-5,21,26
64,HAM,P012579,P012582,0 days 00:10:48,-5,22,27
64,HAM,P009663,P012648,0 days 00:10:42,1,26,25
64,HAM,P010070,P012579,0 days 00:10:25,-5,21,26
64,HAM,P011187,P012582,0 days 00:10:18,2,25,23
64,HAM,P012579,P012580,0 days 00:09:54,-2,18,20
64,HAM,P012580,P012581,0 days 00:09:46,13,24,11
64,HAM,P012581,P012648,0 days 00:09:38,-3,18,21
64,HAM,P011187,P012580,0 days 00:09:28,0,17,17
64,HAM,P012580,P012695,0 days 00:09:27,9,17,8
64,HAM,P011168,P012580,0 days 00:08:22,2,20,18
64,HAM,P011168,P012579,0 days 00:07:55,1,17,16
64,HAM,P011168,P011187,0 days 00:07:22,5,17,12
64,HAM,P011187,P012695,0 days 00:07:13,0,13,13
64,HAM,P009663,P012579,0 days 00:06:49,-1,15,16
64,HAM,P012579,P012695,0 days 00:06:45,-3,10,13
64,HAM,P012581,P012695,0 days 00:06:27,4,11,7
64,HAM,P010070,P012695,0 days 00:06:22,-3,8,11
64,HAM,P012579,P012581,0 days 00:06:02,-3,14,17
64,HAM,P001990,P012579,0 days 00:05:30,-6,11,17
64,HAM,P011187,P012581,0 days 00:05:25,9,17,8
64,HAM,P012582,P012695,0 days 00:05:16,7,11,4
64,HAM,P009663,P012695,0 days 00:05:02,2,6,4
64,HAM,P010070,P012581,0 days 00:04:52,4,12,8
64,HAM,P010070,P012580,0 days 00:04:48,0,6,6
64,HAM,P001990,P012582,0 days 00:04:05,-4,10,14
64,HAM,P001990,P011187,0 days 00:04:00,-6,7,13
64,HAM,P009663,P011187,0 days 00:03:38,-4,7,11
64,HAM,P001990,P012580,0 days 00:03:08,-2,7,9
64,HAM,P010070,P011168,0 days 00:02:57,1,8,7
64,HAM,P012580,P012648,0 days 00:02:56,-3,8,11
64,HAM,P001990,P010070,0 days 00:02:35,-1,7,8
64,HAM,P010070,P012582,0 days 00:02:24,-1,7,8
64,HAM,P009663,P010070,0 days 00:02:23,-2,2,4
64,HAM,P001990,P009663,0 days 00:01:49,1,7,6
64,HAM,P001990,P012581,0 days 00:01:41,0,4,4
64,HAM,P012579,P012648,0 days 00:01:09,-5,0,5
64,HAM,P011187,P012648,0 days 00:00:43,-2,0,2
64,HAM,P001990,P012648,0 days 00:00:16,2,3,1
65,WOL,P002387,P005516,0 days 00:24:51,-11,44,55
65,WOL,P002387,P012577,0 days 00:22:35,-9,43,52
65,WOL,P012577,PLCT,0 days 00:22:09,1,50,49
65,WOL,P006154,P012577,0 days 00:21:07,-9,42,51
65,WOL,P002387,PLCT,0 days 00:19:30,-4,34,38
65,WOL,P012576,P012577,0 days 00:19:04,-8,38,46
65,WOL,P005516,P012577,0 days 00:17:14,-11,31,42
65,WOL,P006154,P012576,0 days 00:16:40,-6,33,39
65,WOL,P002387,P012576,0 days 00:16:37,-13,29,42
65,WOL,P002387,P006154,0 days 00:16:03,-10,29,39
65,WOL,P005516,PLCT,0 days 00:15:10,-7,26,33
65,WOL,P012576,PLCT,0 days 00:13:07,2,29,27
65,WOL,P005516,P012576,0 days 00:12:39,-13,19,32
65,WOL,P006154,PLCT,0 days 00:12:18,4,29,25
65,WOL,P004229,P005516,0 days 00:11:58,-5,19,24
65,WOL,P002387,P004229,0 days 00:11:40,-3,19,22
65,WOL,P004645,P006154,0 days 00:10:49,-6,23,29
65,WOL,P004645,PLCT,0 days 00:10:34,-1,24,25
65,WOL,P005516,P006154,0 days 00:10:24,-10,17,27
65,WOL,P002387,P004645,0 days 00:10:12,-2,23,25
65,WOL,P004645,P012577,0 days 00:08:45,-3,21,24
65,WOL,P004645,P005516,0 days 00:08:39,-4,19,23
65,WOL,P004229,PLCT,0 days 00:08:36,-4,11,15
65,WOL,P006907,PLCT,0 days 00:08:28,-3,17,20
65,WOL,P006907,P012577,0 days 00:07:52,-3,20,23
65,WOL,P006154,P006907,0 days 00:07:13,-2,19,21
65,WOL,P004229,P012577,0 days 00:06:30,-2,11,13
65,WOL,P004645,P012576,0 days 00:06:13,-4,11,15
65,WOL,P006907,P012576,0 days 00:04:48,2,13,11
65,WOL,P002387,P006907,0 days 00:03:36,-4,3,7
65,WOL,P004229,P006154,0 days 00:03:22,-1,8,9
65,WOL,P004229,P004645,0 days 00:03:22,-1,8,9
65,WOL,P004645,P006907,0 days 00:02:46,-3,7,10
65,WOL,P005516,P006907,0 days 00:02:45,-3,1,4
65,WOL,P004229,P006907,0 days 00:02:24,-4,0,4
65,VNC,P011928,P012591,0 days 00:30:42,10,74,64
65,VNC,P004381,P011928,0 days 00:23:58,4,58,54
65,VNC,P004381,P012591,0 days 00:23:17,6,58,52
65,VNC,P009400,P011928,0 days 00:22:43,10,55,45
65,VNC,P009400,P012591,0 days 00:22:39,12,56,44
65,VNC,P004381,P009400,0 days 00:20:57,10,47,37
65,VNC,P008052,P012590,0 days 00:18:31,8,39,31
65,VNC,P008052,P009400,0 days 00:15:31,13,33,20
65,VNC,P012590,P012591,0 days 00:15:27,6,37,31
65,VNC,P008052,P012591,0 days 00:14:55,6,36,30
65,VNC,P011928,P012590,0 days 00:14:53,3,33,30
65,VNC,P004381,P012590,0 days 00:14:50,6,32,26
65,VNC,P003759,P004381,0 days 00:14:22,3,35,32
65,VNC,P008052,P011928,0 days 00:14:21,3,32,29
65,VNC,P004381,P008052,0 days 00:14:21,6,31,25
65,VNC,P003759,P012591,0 days 00:11:38,3,29,26
65,VNC,P009400,P012590,0 days 00:11:04,10,21,11
65,VNC,P003759,P011928,0 days 00:11:00,2,26,24
65,VNC,P004117,P009400,0 days 00:10:22,10,23,13
65,VNC,P004117,P004381,0 days 00:09:59,9,22,13
65,VNC,P003759,P012590,0 days 00:08:56,5,25,20
65,VNC,P004117,P012591,0 days 00:06:39,3,17,14
65,VNC,P003759,P009400,0 days 00:06:04,-1,13,14
65,VNC,P004117,P011928,0 days 00:06:02,3,16,13
65,VNC,P012587,P012590,0 days 00:05:39,0,14,14
65,VNC,P008052,P012587,0 days 00:05:36,0,14,14
65,VNC,P004117,P012590,0 days 00:04:40,6,7,1
65,VNC,P004117,P008052,0 days 00:04:37,6,7,1
65,VNC,P003759,P008052,0 days 00:04:00,2,12,10
65,VNC,P003759,P012587,0 days 00:04:00,2,12,10
65,VNC,P004381,P012587,0 days 00:03:36,0,9,9
65,VNC,P012587,P012591,0 days 00:02:31,-2,5,7
65,VNC,P011928,P012587,0 days 00:01:53,-3,2,5
65,VNC,P004117,P012587,0 days 00:00:17,-1,0,1
66,BOU,P010431,P011836,0 days 00:21:12,6,40,34
66,BOU,P010431,P012617,0 days 00:20:24,6,36,30
66,BOU,P010431,P010718,0 days 00:20:17,7,36,29
66,BOU,P010718,P011836,0 days 00:19:30,6,36,30
66,BOU,P004525,P011836,0 days 00:18:22,1,38,37
66,BOU,P011836,P012617,0 days 00:17:51,22,46,24
66,BOU,P010718,P012617,0 days 00:17:08,14,34,20
66,BOU,P011161,P011836,0 days 00:16:27,-1,31,32
66,BOU,P004525,P011161,0 days 00:14:58,-5,27,32
66,BOU,P010431,P011837,0 days 00:14:41,9,25,16
66,BOU,P010718,P011837,0 days 00:13:58,4,21,17
66,BOU,P011837,P012617,0 days 00:13:15,5,21,16
66,BOU,P004525,P010431,0 days 00:13:00,-5,23,28
66,BOU,P004525,P012628,0 days 00:12:47,7,27,20
66,BOU,P011836,P012628,0 days 00:12:36,14,31,17
66,BOU,P004525,P010718,0 days 00:11:52,2,23,21
66,BOU,P011161,P012628,0 days 00:11:46,4,22,18
66,BOU,P011836,P011837,0 days 00:11:28,13,24,11
66,BOU,P004525,P012617,0 days 00:11:26,15,33,18
66,BOU,P010431,P011161,0 days 00:09:24,-5,15,20
66,BOU,P010718,P011161,0 days 00:07:56,-7,10,17
66,BOU,P012617,P012628,0 days 00:07:22,13,23,10
66,BOU,P010450,P012617,0 days 00:06:50,-2,8,10
66,BOU,P010450,P011837,0 days 00:06:33,-9,3,12
66,BOU,P010431,P010450,0 days 00:06:32,-5,8,13
66,BOU,P010450,P010718,0 days 00:06:20,0,8,8
66,BOU,P010718,P012628,0 days 00:05:33,-1,8,9
66,BOU,P010431,P012628,0 days 00:05:14,3,9,6
66,BOU,P000498,P012628,0 days 00:05:11,-7,4,11
66,BOU,P010450,P012628,0 days 00:04:57,-8,2,10
66,BOU,P011837,P012628,0 days 00:04:46,-1,6,7
66,BOU,P011161,P012617,0 days 00:04:28,7,15,8
66,BOU,P000498,P011161,0 days 00:04:25,-6,4,10
66,BOU,P011161,P011837,0 days 00:04:03,0,6,6
66,BOU,P004525,P010450,0 days 00:03:40,-1,7,8
66,BOU,P000498,P011837,0 days 00:03:20,-5,2,7
66,BOU,P000498,P010450,0 days 00:03:20,-5,2,7
66,BOU,P010450,P011161,0 days 00:02:37,-7,2,9
66,BOU,P000498,P004525,0 days 00:01:51,-2,2,4
66,BOU,P000498,P011836,0 days 00:01:51,-2,2,4
66,BOU,P000498,P010718,0 days 00:00:46,-1,0,1
66,BOU,P010450,P011836,0 days 00:00:03,-3,0,3
66,ARI,P012707,P012716,0 days 00:25:05,-7,43,50
66,ARI,P012707,P012760,0 days 00:23:00,1,44,43
66,ARI,P004292,P012707,0 days 00:21:00,-4,37,41
66,ARI,P004292,P012716,0 days 00:18:49,-3,35,38
66,ARI,P004292,P012760,0 days 00:18:47,-3,34,37
66,ARI,P012716,P012760,0 days 00:18:29,0,36,36
66,ARI,P012615,P012707,0 days 00:14:14,-14,20,34
66,ARI,P012615,P012708,0 days 00:13:42,-1,20,21
66,ARI,P004292,P012615,0 days 00:12:38,-10,20,30
66,ARI,P012702,P012708,0 days 00:12:32,-2,17,19
66,ARI,P012615,P012702,0 days 00:12:09,-7,14,21
66,ARI,P004292,P012708,0 days 00:10:31,3,20,17
66,ARI,P012615,P012760,0 days 00:10:28,-4,20,24
66,ARI,P002867,P012615,0 days 00:10:26,-4,13,17
66,ARI,P012707,P012708,0 days 00:10:24,-3,16,19
66,ARI,P012708,P012716,0 days 00:10:02,-6,16,22
66,ARI,P012616,P012760,0 days 00:10:01,12,23,11
66,ARI,P012616,P012707,0 days 00:10:01,12,23,11
66,ARI,P012615,P012716,0 days 00:09:45,-18,12,30
66,ARI,P002867,P012707,0 days 00:09:27,-1,12,13
66,ARI,P003240,P012615,0 days 00:08:52,-3,9,12
66,ARI,P004292,P012616,0 days 00:08:33,9,19,10
66,ARI,P004292,P012702,0 days 00:08:13,5,17,12
66,ARI,P012616,P012716,0 days 00:07:26,10,17,7
66,ARI,P003240,P012708,0 days 00:07:20,-2,7,9
66,ARI,P003240,P012702,0 days 00:07:20,-2,7,9
66,ARI,P002867,P012716,0 days 00:07:09,-6,6,12
66,ARI,P002867,P012702,0 days 00:07:07,-8,5,13
66,ARI,P003240,P004292,0 days 00:06:38,-5,9,14
66,ARI,P002867,P012708,0 days 00:06:29,-4,5,9
66,ARI,P002867,P012760,0 days 00:06:27,8,14,6
66,ARI,P012702,P012716,0 days 00:05:55,-6,7,13
66,ARI,P012702,P012707,0 days 00:05:53,-3,7,10
66,ARI,P012708,P012760,0 days 00:05:08,3,11,8
66,ARI,P002867,P004292,0 days 00:04:35,8,13,5
66,ARI,P012615,P012616,0 days 00:03:42,1,8,7
66,ARI,P002867,P012616,0 days 00:03:42,1,8,7
66,ARI,P002867,P003240,0 days 00:02:38,-2,0,2
66,ARI,P003240,P012707,0 days 00:01:56,-5,2,7
66,ARI,P003240,P012760,0 days 00:01:56,-5,2,7
66,ARI,P012616,P012702,0 days 00:01:07,-1,2,3
66,ARI,P003240,P012716,0 days 00:00:24,-4,0,4
67,ULM,P005422,P010106,0 days 00:21:50,13,47,34
67,ULM,P005422,P012603,0 days 00:21:35,12,50,38
67,ULM,P010106,P012603,0 days 00:19:36,12,44,32
67,ULM,P010106,P010582,0 days 00:17:21,11,35,24
67,ULM,P005422,P012604,0 days 00:15:18,4,26,22
67,ULM,P006997,P010582,0 days 00:15:18,8,34,26
67,ULM,P010106,P012604,0 days 00:15:15,5,23,18
67,ULM,P012603,P012604,0 days 00:14:17,3,25,22
67,ULM,P006997,P011457,0 days 00:14:00,3,28,25
67,ULM,P006997,P012629,0 days 00:13:46,9,37,28
67,ULM,P006997,P012703,0 days 00:13:38,5,28,23
67,ULM,P011457,P012703,0 days 00:13:24,1,26,25
67,ULM,P010582,P012603,0 days 00:12:59,10,29,19
67,ULM,P005422,P010582,0 days 00:12:59,10,29,19
67,ULM,P006997,P010106,0 days 00:12:53,10,33,23
67,ULM,P005422,P012629,0 days 00:12:45,8,32,24
67,ULM,P010582,P012604,0 days 00:12:45,5,21,16
67,ULM,P011457,P012629,0 days 00:11:44,5,26,21
67,ULM,P012629,P012703,0 days 00:11:29,4,29,25
67,ULM,P012603,P012629,0 days 00:10:35,1,23,22
67,ULM,P005422,P006997,0 days 00:10:26,14,35,21
67,ULM,P010582,P012703,0 days 00:10:21,-1,18,19
67,ULM,P010582,P011457,0 days 00:09:30,-3,16,19
67,ULM,P006997,P012603,0 days 00:09:17,8,27,19
67,ULM,P010106,P012629,0 days 00:08:51,3,18,15
67,ULM,P012604,P012629,0 days 00:06:34,-2,10,12
67,ULM,P010582,P012629,0 days 00:05:36,0,13,13
67,ULM,P010106,P011457,0 days 00:04:40,1,6,5
67,ULM,P006997,P010726,0 days 00:04:15,0,5,5
67,ULM,P010582,P010726,0 days 00:04:15,0,5,5
67,ULM,P005422,P011457,0 days 00:04:09,6,11,5
67,ULM,P012603,P012703,0 days 00:03:58,-1,8,9
67,ULM,P005422,P012703,0 days 00:03:54,5,14,9
67,ULM,P012604,P012703,0 days 00:03:27,0,8,8
67,ULM,P006997,P012604,0 days 00:02:47,3,5,2
67,ULM,P010726,P012604,0 days 00:02:47,3,5,2
67,ULM,P010106,P012703,0 days 00:02:26,0,3,3
67,ULM,P010726,P012703,0 days 00:02:19,-1,2,3
67,ULM,P011457,P012603,0 days 00:01:59,-1,2,3
67,ULM,P010106,P010726,0 days 00:01:56,1,3,2
67,ULM,P011457,P012604,0 days 00:01:38,-1,1,2
67,ULM,P010726,P011457,0 days 00:01:28,-3,0,3
67,BUD,P004945,P011935,0 days 00:28:24,-10,43,53
67,BUD,P004945,P012606,0 days 00:28:19,-4,51,55
67,BUD,P011935,P012606,0 days 00:25:51,-3,43,46
67,BUD,P004945,P010248,0 days 00:21:34,-9,39,48
67,BUD,P010248,P012606,0 days 00:20:21,-9,37,46
67,BUD,P010248,P011935,0 days 00:18:45,-7,29,36
67,BUD,P002740,P010432,0 days 00:16:30,-4,25,29
67,BUD,P002740,P011935,0 days 00:16:19,-4,26,30
67,BUD,P002740,P004945,0 days 00:14:00,-6,19,25
67,BUD,P010432,P011935,0 days 00:13:41,-5,23,28
67,BUD,P002740,P012606,0 days 00:12:36,-1,21,22
67,BUD,P007398,P011935,0 days 00:12:04,0,21,21
67,BUD,P007398,P012606,0 days 00:11:32,0,21,21
67,BUD,P004945,P007398,0 days 00:11:32,0,21,21
67,BUD,P010432,P012605,0 days 00:10:28,-13,14,27
67,BUD,P004945,P010432,0 days 00:10:17,-6,14,20
67,BUD,P007398,P010248,0 days 00:10:10,-1,18,19
67,BUD,P002740,P012605,0 days 00:09:54,-8,14,22
67,BUD,P010432,P012606,0 days 00:08:19,4,16,12
67,BUD,P011935,P012630,0 days 00:07:44,-9,12,21
67,BUD,P011935,P012605,0 days 00:06:56,-10,11,21
67,BUD,P004945,P012630,0 days 00:06:19,-9,13,22
67,BUD,P007398,P010432,0 days 00:06:01,1,8,7
67,BUD,P002740,P009214,0 days 00:05:50,-4,7,11
67,BUD,P010248,P012630,0 days 00:05:45,-4,13,17
67,BUD,P002740,P010248,0 days 00:05:39,-4,8,12
67,BUD,P012605,P012630,0 days 00:04:56,-6,9,15
67,BUD,P009214,P010432,0 days 00:04:45,-3,5,8
67,BUD,P009214,P012605,0 days 00:04:45,-3,5,8
67,BUD,P002740,P007398,0 days 00:04:39,0,5,5
67,BUD,P007398,P012605,0 days 00:04:39,0,5,5
67,BUD,P012606,P012630,0 days 00:04:32,-4,11,15
67,BUD,P007398,P009214,0 days 00:04:07,0,5,5
67,BUD,P010432,P012630,0 days 00:03:43,-6,7,13
67,BUD,P004945,P012605,0 days 00:03:32,-11,2,13
67,BUD,P004945,P009214,0 days 00:03:27,-5,10,15
67,BUD,P002740,P012630,0 days 00:03:09,-1,7,8
67,BUD,P009214,P010248,0 days 00:02:49,-2,10,12
67,BUD,P009214,P012606,0 days 00:02:49,-2,10,12
67,BUD,P009214,P012630,0 days 00:01:44,-1,8,9
67,BUD,P010248,P012605,0 days 00:01:13,0,2,2
67,BUD,P012605,P012606,0 days 00:00:21,-1,2,3
68,TRN,P005738,P012593,0 days 00:20:30,-25,34,59
68,TRN,P009903,P012593,0 days 00:17:07,-25,22,47
68,TRN,P001479,P006382,0 days 00:16:50,1,27,26
68,TRN,P005738,P012597,0 days 00:15:32,-30,23,53
68,TRN,P005738,P009903,0 days 00:14:42,-31,17,48
68,TRN,P009903,P012597,0 days 00:14:30,-19,21,40
68,TRN,P007828,P012593,0 days 00:14:12,0,30,30
68,TRN,P012593,P012597,0 days 00:12:33,-23,18,41
68,TRN,P001479,P007828,0 days 00:11:22,-1,24,25
68,TRN,P005059,P012597,0 days 00:10:25,-12,15,27
68,TRN,P001479,P012593,0 days 00:09:58,0,21,21
68,TRN,P005738,P012594,0 days 00:09:35,-19,12,31
68,TRN,P012593,P012594,0 days 00:09:35,-19,12,31
68,TRN,P009903,P012594,0 days 00:09:35,-19,12,31
68,TRN,P012595,P012596,0 days 00:09:32,-8,11,19
68,TRN,P005738,P012595,0 days 00:09:28,-9,15,24
68,TRN,P001479,P012597,0 days 00:09:14,-8,16,24
68,TRN,P005059,P006382,0 days 00:09:03,-8,8,16
68,TRN,P001479,P005059,0 days 00:08:54,-7,8,15
68,TRN,P006382,P007828,0 days 00:08:50,5,19,14
68,TRN,P001479,P012596,0 days 00:08:49,-10,8,18
68,TRN,P005738,P007828,0 days 00:08:47,-2,20,22
68,TRN,P006382,P012596,0 days 00:08:43,-7,8,15
68,TRN,P005059,P012596,0 days 00:08:24,-13,8,21
68,TRN,P006382,P009903,0 days 00:07:57,0,13,13
68,TRN,P001479,P009903,0 days 00:07:18,4,13,9
68,TRN,P006382,P012593,0 days 00:07:02,6,16,10
68,TRN,P005059,P012595,0 days 00:06:50,-12,5,17
68,TRN,P012593,P012595,0 days 00:06:44,-6,10,16
68,TRN,P006382,P012597,0 days 00:06:27,-3,11,14
68,TRN,P007828,P009903,0 days 00:06:24,-3,11,14
68,TRN,P007828,P012597,0 days 00:06:16,-11,11,22
68,TRN,P005059,P009903,0 days 00:06:01,-5,7,12
68,TRN,P005059,P005738,0 days 00:05:31,-11,7,18
68,TRN,P007828,P012596,0 days 00:05:27,4,11,7
68,TRN,P012594,P012597,0 days 00:05:09,-9,8,17
68,TRN,P012593,P012596,0 days 00:05:03,4,11,7
68,TRN,P005738,P012596,0 days 00:05:02,1,11,10
68,TRN,P001479,P012595,0 days 00:04:30,-9,0,9
68,TRN,P012594,P012595,0 days 00:04:26,-10,4,14
68,TRN,P009903,P012595,0 days 00:04:26,-10,4,14
68,TRN,P006382,P012595,0 days 00:04:24,-6,0,6
68,TRN,P012596,P012597,0 days 00:04:24,-7,8,15
68,TRN,P001479,P005738,0 days 00:04:09,-2,11,13
68,TRN,P012595,P012597,0 days 00:02:50,-6,5,11
68,TRN,P007828,P012595,0 days 00:02:42,4,6,2
68,TRN,P005059,P012593,0 days 00:02:32,-4,2,6
68,TRN,P005738,P006382,0 days 00:02:16,0,6,6
68,CLU,P004862,P011797,0 days 00:20:54,26,52,26
68,CLU,P004862,P012621,0 days 00:18:53,12,41,29
68,CLU,P005113,P012621,0 days 00:18:16,14,35,21
68,CLU,P010569,P012621,0 days 00:16:48,12,41,29
68,CLU,P011797,P012621,0 days 00:16:39,12,33,21
68,CLU,P004862,P005113,0 days 00:16:32,14,35,21
68,CLU,P011801,P012698,0 days 00:15:04,16,36,20
68,CLU,P005373,P011801,0 days 00:14:31,16,39,23
68,CLU,P005113,P011797,0 days 00:14:20,10,26,16
68,CLU,P004862,P010569,0 days 00:14:09,4,30,26
68,CLU,P005373,P012698,0 days 00:13:20,16,36,20
68,CLU,P010569,P011797,0 days 00:12:39,10,28,18
68,CLU,P005373,P011797,0 days 00:12:34,23,41,18
68,CLU,P005113,P010569,0 days 00:11:31,8,24,16
68,CLU,P005714,P012620,0 days 00:11:25,6,27,21
68,CLU,P011797,P011801,0 days 00:11:14,17,30,13
68,CLU,P005714,P012621,0 days 00:10:21,8,27,19
68,CLU,P011797,P012698,0 days 00:10:03,17,27,10
68,CLU,P005714,P011801,0 days 00:10:00,10,28,18
68,CLU,P004862,P005373,0 days 00:09:59,15,30,15
68,CLU,P004862,P012698,0 days 00:08:51,13,26,13
68,CLU,P004862,P011801,0 days 00:08:51,13,26,13
68,CLU,P012620,P012621,0 days 00:08:05,6,22,16
68,CLU,P004862,P005714,0 days 00:07:38,3,17,14
68,CLU,P005373,P005714,0 days 00:07:04,4,17,13
68,CLU,P011801,P012620,0 days 00:06:16,6,16,10
68,CLU,P005714,P012698,0 days 00:05:53,4,14,10
68,CLU,P011801,P012621,0 days 00:05:51,6,14,8
68,CLU,P005373,P012620,0 days 00:05:16,4,12,8
68,CLU,P004862,P012620,0 days 00:05:09,0,11,11
68,CLU,P005113,P005714,0 days 00:05:01,6,11,5
68,CLU,P005714,P010569,0 days 00:04:09,2,13,11
68,CLU,P010569,P012620,0 days 00:04:09,2,13,11
68,CLU,P005113,P012620,0 days 00:03:56,4,9,5
68,CLU,P005714,P011797,0 days 00:03:25,5,10,5
68,CLU,P012620,P012698,0 days 00:03:20,0,5,5
68,CLU,P010569,P011801,0 days 00:03:13,4,11,7
68,CLU,P005373,P012621,0 days 00:02:19,2,7,5
68,CLU,P011797,P011907,0 days 00:01:56,4,7,3
68,CLU,P011907,P012620,0 days 00:01:56,4,7,3
68,CLU,P011797,P012620,0 days 00:01:56,4,7,3
68,CLU,P005373,P011907,0 days 00:01:56,4,7,3
68,CLU,P010997,P012620,0 days 00:01:56,4,7,3
68,CLU,P010997,P011907,0 days 00:01:56,4,7,3
68,CLU,P010997,P011797,0 days 00:01:56,4,7,3
68,CLU,P005373,P010997,0 days 00:01:56,4,7,3
68,CLU,P005113,P011801,0 days 00:01:44,0,0,0
68,CLU,P005113,P012698,0 days 00:01:44,0,0,0
68,CLU,P012621,P012698,0 days 00:01:44,0,0,0
68,CLU,P005373,P010569,0 days 00:01:25,0,4,4
68,CLU,P010569,P012698,0 days 00:00:17,-2,0,2
69,CAN,P001607,P005005,0 days 00:20:51,8,51,43
69,CAN,P003637,P005005,0 days 00:18:35,-3,42,45
69,CAN,P005005,P010484,0 days 00:17:08,-9,34,43
69,CAN,P001607,P003637,0 days 00:15:55,12,42,30
69,CAN,P001607,P007644,0 days 00:15:47,14,43,29
69,CAN,P001607,P010484,0 days 00:14:38,4,34,30
69,CAN,P005005,P007644,0 days 00:13:51,7,38,31
69,CAN,P003637,P010484,0 days 00:13:34,-2,30,32
69,CAN,P003425,P008121,0 days 00:12:41,11,25,14
69,CAN,P003425,P010452,0 days 00:11:17,0,17,17
69,CAN,P007644,P010484,0 days 00:10:04,0,23,23
69,CAN,P008121,P010452,0 days 00:09:57,5,17,12
69,CAN,P003425,P007560,0 days 00:09:46,7,19,12
69,CAN,P007560,P008121,0 days 00:09:22,7,19,12
69,CAN,P009864,P010452,0 days 00:09:16,-8,8,16
69,CAN,P003637,P007644,0 days 00:08:55,11,29,18
69,CAN,P007560,P010452,0 days 00:08:52,3,17,14
69,CAN,P003425,P009864,0 days 00:08:17,-5,9,14
69,CAN,P007560,P010385,0 days 00:07:45,10,18,8
69,CAN,P005005,P010452,0 days 00:07:43,-3,17,20
69,CAN,P003425,P010385,0 days 00:06:54,6,16,10
69,CAN,P001607,P010385,0 days 00:06:46,7,16,9
69,CAN,P008121,P010385,0 days 00:06:30,6,16,10
69,CAN,P007560,P007644,0 days 00:06:24,0,11,11
69,CAN,P005005,P009864,0 days 00:06:18,-21,2,23
69,CAN,P001607,P010452,0 days 00:06:13,4,17,13
69,CAN,P007560,P010484,0 days 00:06:12,-9,8,17
69,CAN,P008121,P009864,0 days 00:06:11,5,9,4
69,CAN,P001607,P007560,0 days 00:06:00,0,11,11
69,CAN,P007560,P009864,0 days 00:05:51,-6,6,12
69,CAN,P005005,P007560,0 days 00:05:42,-13,6,19
69,CAN,P003637,P010452,0 days 00:05:23,1,14,13
69,CAN,P010385,P010484,0 days 00:05:22,4,13,9
69,CAN,P003637,P009864,0 days 00:05:20,-14,4,18
69,CAN,P004160,P007644,0 days 00:05:10,8,12,4
69,CAN,P005005,P010385,0 days 00:04:42,2,11,9
69,CAN,P003637,P010385,0 days 00:04:42,2,11,9
69,CAN,P003425,P004160,0 days 00:04:41,-3,4,7
69,CAN,P010385,P010452,0 days 00:04:37,3,11,8
69,CAN,P007644,P010452,0 days 00:03:47,7,15,8
69,CAN,P004160,P010385,0 days 00:03:41,6,8,2
69,CAN,P007644,P010385,0 days 00:03:41,6,8,2
69,CAN,P004160,P010452,0 days 00:03:35,-4,3,7
69,CAN,P001607,P004160,0 days 00:03:04,6,8,2
69,CAN,P004160,P009864,0 days 00:03:04,-4,1,5
69,CAN,P004160,P008121,0 days 00:02:57,2,4,2
69,CAN,P009864,P010484,0 days 00:02:44,-9,2,11
69,CAN,P004160,P007560,0 days 00:02:28,5,5,0
69,CAN,P001607,P009864,0 days 00:02:26,-3,2,5
69,CAN,P004160,P005005,0 days 00:02:20,-4,3,7
69,CAN,P003425,P005005,0 days 00:02:14,-12,0,12
69,CAN,P003425,P007644,0 days 00:02:14,0,4,4
69,CAN,P003425,P010484,0 days 00:01:56,-3,4,7
69,CAN,P003637,P007560,0 days 00:01:46,-8,0,8
69,CAN,P007644,P008121,0 days 00:01:42,2,4,2
69,CAN,P003425,P003637,0 days 00:01:16,-5,2,7
69,CAN,P008121,P010484,0 days 00:01:02,4,4,0
69,CAN,P007644,P009864,0 days 00:00:29,1,1,0
69,CAN,P003637,P008121,0 days 00:00:22,2,2,0
69,WRO,P009896,P011165,0 days 00:20:48,13,46,33
69,WRO,P011165,P012010,0 days 00:19:35,-6,38,44
69,WRO,P005531,P012010,0 days 00:18:24,-12,25,37
69,WRO,P011165,P011900,0 days 00:16:45,2,37,35
69,WRO,P005531,P011165,0 days 00:16:29,-11,26,37
69,WRO,P011165,P011902,0 days 00:16:11,13,41,28
69,WRO,P012010,P012699,0 days 00:16:03,2,36,34
69,WRO,P003034,P012010,0 days 00:14:39,-8,24,32
69,WRO,P009896,P012010,0 days 00:14:08,-1,21,22
69,WRO,P011165,P012699,0 days 00:13:41,2,32,30
69,WRO,P009896,P011900,0 days 00:12:56,13,33,20
69,WRO,P003034,P011165,0 days 00:12:45,-10,25,35
69,WRO,P003034,P005531,0 days 00:12:05,-13,14,27
69,WRO,P005531,P009896,0 days 00:12:01,-9,13,22
69,WRO,P009896,P011902,0 days 00:11:49,14,30,16
69,WRO,P011900,P011902,0 days 00:10:29,14,30,16
69,WRO,P011900,P012010,0 days 00:10:22,-16,15,31
69,WRO,P005531,P012736,0 days 00:09:56,-12,9,21
69,WRO,P011902,P012010,0 days 00:09:54,-5,19,24
69,WRO,P003034,P012736,0 days 00:09:28,-12,9,21
69,WRO,P003034,P009896,0 days 00:09:21,2,19,17
69,WRO,P011901,P011902,0 days 00:08:23,16,26,10
69,WRO,P011900,P011901,0 days 00:08:23,16,26,10
69,WRO,P011165,P011901,0 days 00:08:23,16,26,10
69,WRO,P009896,P011901,0 days 00:08:23,16,26,10
69,WRO,P005531,P011902,0 days 00:08:17,-6,15,21
69,WRO,P005531,P012699,0 days 00:07:47,2,17,15
69,WRO,P003034,P012699,0 days 00:07:19,-1,17,18
69,WRO,P003034,P011900,0 days 00:07:13,-14,8,22
69,WRO,P011902,P012699,0 days 00:06:29,3,17,14
69,WRO,P009896,P012736,0 days 00:06:28,-6,9,15
69,WRO,P011900,P012699,0 days 00:06:25,-7,12,19
69,WRO,P012010,P012736,0 days 00:06:23,-6,6,12
69,WRO,P005531,P011900,0 days 00:05:37,-15,1,16
69,WRO,P009896,P012699,0 days 00:05:30,6,11,5
69,WRO,P011900,P012736,0 days 00:04:22,-9,2,11
69,WRO,P011165,P012736,0 days 00:04:15,-7,5,12
69,WRO,P012699,P012736,0 days 00:00:58,1,2,1
69,WRO,P003034,P011902,0 days 00:00:54,-4,0,4
69,WRO,P011902,P012736,0 days 00:00:42,-1,2,3
70,LKB,P008856,PLXI,0 days 00:36:04,15,73,58
70,LKB,P002012,PLXI,0 days 00:32:44,19,79,60
70,LKB,P005521,PLXI,0 days 00:31:40,17,71,54
70,LKB,P005521,P008856,0 days 00:31:26,29,75,46
70,LKB,P002012,P008856,0 days 00:30:35,18,71,53
70,LKB,P006230,PLXI,0 days 00:30:20,9,63,54
70,LKB,P002012,P006230,0 days 00:27:38,14,63,49
70,LKB,P006230,P008856,0 days 00:26:38,13,55,42
70,LKB,P002012,P005521,0 days 00:23:45,31,69,38
70,LKB,P005521,P006230,0 days 00:21:21,21,53,32
70,LKB,P005521,P010461,0 days 00:14:04,3,30,27
70,LKB,P010190,PLXI,0 days 00:13:34,-22,18,40
70,LKB,P008856,P010461,0 days 00:13:11,9,30,21
70,LKB,P004868,P005521,0 days 00:12:52,-17,14,31
70,LKB,P006230,P010190,0 days 00:12:41,-16,18,34
70,LKB,P002012,P010190,0 days 00:11:08,-11,18,29
70,LKB,P004868,P008856,0 days 00:10:26,-6,14,20
70,LKB,P010461,PLXI,0 days 00:09:43,1,18,17
70,LKB,P004868,P010461,0 days 00:09:34,-7,14,21
70,LKB,P008856,P010190,0 days 00:08:59,-12,10,22
70,LKB,P004868,PLXI,0 days 00:08:31,-19,2,21
70,LKB,P005521,P010190,0 days 00:04:35,-10,8,18
70,LKB,P002012,P010461,0 days 00:04:30,10,16,6
70,LKB,P004868,P006901,0 days 00:04:21,2,12,10
70,LKB,P005521,P006901,0 days 00:04:21,2,12,10
70,LKB,P006901,P008856,0 days 00:04:21,2,12,10
70,LKB,P006901,P010461,0 days 00:04:21,2,12,10
70,LKB,P004868,P006230,0 days 00:02:42,-5,0,5
70,LKB,P004868,P010190,0 days 00:02:26,-11,0,11
70,LKB,P010190,P010461,0 days 00:00:53,-6,0,6
70,LKB,P002012,P004868,0 days 00:00:36,-5,0,5
70,TTK,P005000,P011925,0 days 00:34:33,-10,67,77
70,TTK,P011239,P011925,0 days 00:34:14,-2,64,66
70,TTK,P005000,P012056,0 days 00:33:00,-6,63,69
70,TTK,P011925,P012056,0 days 00:31:50,1,64,63
70,TTK,P011239,P012056,0 days 00:31:07,4,60,56
70,TTK,P005000,P011239,0 days 00:31:05,-7,57,64
70,TTK,P006693,P011239,0 days 00:20:59,1,43,42
70,TTK,P005000,P006693,0 days 00:18:37,-1,41,42
70,TTK,P006693,P012056,0 days 00:18:37,-1,41,42
70,TTK,P006693,P011925,0 days 00:17:20,2,37,35
70,TTK,P011239,P011834,0 days 00:15:59,-5,19,24
70,TTK,P011834,P011925,0 days 00:15:06,-6,19,25
70,TTK,P011925,P012697,0 days 00:14:24,-5,25,30
70,TTK,P005000,P011834,0 days 00:11:57,-11,12,23
70,TTK,P011834,P012056,0 days 00:11:08,-2,13,15
70,TTK,P005000,P012697,0 days 00:10:24,-7,19,26
70,TTK,P011239,P012697,0 days 00:08:42,-3,12,15
70,TTK,P012056,P012697,0 days 00:08:02,-3,15,18
70,TTK,P011834,P012697,0 days 00:07:18,-1,12,13
70,TTK,P005685,P011925,0 days 00:07:07,-4,16,20
70,TTK,P005000,P005685,0 days 00:07:07,-4,16,20
70,TTK,P009845,P011925,0 days 00:06:59,6,20,14
70,TTK,P006693,P011834,0 days 00:06:01,1,8,7
70,TTK,P005685,P012697,0 days 00:05:42,-2,13,15
70,TTK,P009845,P011239,0 days 00:05:35,6,17,11
70,TTK,P005685,P012056,0 days 00:04:22,-4,10,14
70,TTK,P005000,P009845,0 days 00:04:11,4,13,9
70,TTK,P011239,P011975,0 days 00:03:51,-6,8,14
70,TTK,P011925,P011975,0 days 00:03:51,-6,8,14
70,TTK,P009845,P012056,0 days 00:03:50,11,14,3
70,TTK,P009845,P011975,0 days 00:03:09,-5,6,11
70,TTK,P009845,P011834,0 days 00:02:48,2,7,5
70,TTK,P005685,P011834,0 days 00:02:46,-2,6,8
70,TTK,P006693,P012697,0 days 00:02:22,2,2,0
70,TTK,P011834,P011975,0 days 00:01:57,-4,4,8
70,TTK,P005000,P011975,0 days 00:01:54,-2,4,6
70,TTK,P005685,P009845,0 days 00:01:24,0,3,3
70,TTK,P011975,P012697,0 days 00:00:42,-1,2,3
71,PMT,P001686,P002644,0 days 00:23:12,4,50,46
71,PMT,P002644,P011947,0 days 00:22:29,7,53,46
71,PMT,P001686,P011947,0 days 00:21:49,4,47,43
71,PMT,P002644,P011966,0 days 00:20:50,3,47,44
71,PMT,P011947,P011966,0 days 00:19:54,-3,43,46
71,PMT,P001686,P011966,0 days 00:19:11,-1,39,40
71,PMT,P002644,P011944,0 days 00:18:15,7,39,32
71,PMT,P011943,P011944,0 days 00:15:25,7,36,29
71,PMT,P001686,P011944,0 days 00:15:13,0,28,28
71,PMT,P002644,P011943,0 days 00:13:42,11,34,23
71,PMT,P011823,P011943,0 days 00:13:22,5,33,28
71,PMT,P011944,P011947,0 days 00:13:03,6,29,23
71,PMT,P010549,P011966,0 days 00:11:11,0,26,26
71,PMT,P001686,P010549,0 days 00:10:46,0,25,25
71,PMT,P002644,P010549,0 days 00:10:42,0,24,24
71,PMT,P011943,P012600,0 days 00:10:11,3,25,22
71,PMT,P011823,P012600,0 days 00:10:04,3,25,22
71,PMT,P010549,P011947,0 days 00:09:28,0,24,24
71,PMT,P011823,P011944,0 days 00:09:05,2,23,21
71,PMT,P011944,P011966,0 days 00:08:47,-3,15,18
71,PMT,P011943,P011947,0 days 00:08:01,7,18,11
71,PMT,P001686,P011943,0 days 00:07:55,1,13,12
71,PMT,P002644,P011823,0 days 00:07:27,7,21,14
71,PMT,P011823,P011966,0 days 00:07:23,-2,15,17
71,PMT,P011944,P012600,0 days 00:07:13,0,17,17
71,PMT,P002020,P011823,0 days 00:06:56,-2,16,18
71,PMT,P002020,P012600,0 days 00:06:02,0,13,13
71,PMT,P002644,P012600,0 days 00:05:59,5,16,11
71,PMT,P011823,P011947,0 days 00:05:42,1,13,12
71,PMT,P002020,P011944,0 days 00:05:21,-1,12,13
71,PMT,P002020,P011943,0 days 00:05:21,-1,12,13
71,PMT,P011943,P011966,0 days 00:05:00,1,10,9
71,PMT,P011966,P012600,0 days 00:04:48,5,12,7
71,PMT,P010549,P011944,0 days 00:03:26,-2,5,7
71,PMT,P010549,P011823,0 days 00:02:45,-3,5,8
71,PMT,P002020,P011947,0 days 00:02:16,0,5,5
71,PMT,P002020,P011966,0 days 00:02:16,0,5,5
71,PMT,P001686,P012600,0 days 00:01:57,2,4,2
71,PMT,P011947,P012600,0 days 00:01:50,2,4,2
71,PMT,P001686,P011823,0 days 00:01:44,-3,1,4
71,PMT,P010549,P011943,0 days 00:01:43,-2,3,5
71,PMT,P002020,P010549,0 days 00:01:35,-1,4,5
71,PMT,P001686,P002020,0 days 00:00:41,1,1,0
71,VNC,P003759,P012591,0 days 00:24:59,-4,51,55
71,VNC,P009400,P012591,0 days 00:24:16,-7,47,54
71,VNC,P008052,P012591,0 days 00:21:31,-11,40,51
71,VNC,P012587,P012591,0 days 00:21:29,-10,41,51
71,VNC,P008052,P012587,0 days 00:20:24,3,46,43
71,VNC,P000968,P012591,0 days 00:19:56,-6,39,45
71,VNC,P003759,P009400,0 days 00:18:22,-3,37,40
71,VNC,P000968,P003759,0 days 00:17:37,-5,34,39
71,VNC,P003759,P008052,0 days 00:17:10,-6,33,39
71,VNC,P011928,P012591,0 days 00:17:06,-7,33,40
71,VNC,P000968,P008052,0 days 00:17:03,-8,33,41
71,VNC,P009400,P012587,0 days 00:16:29,-2,34,36
71,VNC,P009400,P011928,0 days 00:16:24,1,35,34
71,VNC,P003759,P012587,0 days 00:15:35,-6,31,37
71,VNC,P011928,P012587,0 days 00:13:31,-1,29,30
71,VNC,P000968,P011928,0 days 00:13:26,-1,29,30
71,VNC,P008052,P009400,0 days 00:13:08,2,28,26
71,VNC,P004117,P011928,0 days 00:12:59,1,29,28
71,VNC,P000968,P012587,0 days 00:11:16,-4,23,27
71,VNC,P000968,P009400,0 days 00:10:28,-2,20,22
71,VNC,P004117,P012587,0 days 00:10:08,4,24,20
71,VNC,P008052,P011928,0 days 00:09:33,3,23,20
71,VNC,P003759,P011928,0 days 00:08:21,0,18,18
71,VNC,P004117,P008052,0 days 00:08:03,5,21,16
71,VNC,P004117,P012591,0 days 00:07:47,-7,13,20
71,VNC,P004117,P009400,0 days 00:06:33,3,15,12
71,VNC,P000968,P004117,0 days 00:06:26,-2,14,16
72,HAM,P012579,P012580,0 days 00:19:21,0,35,35
72,HAM,P011187,P012580,0 days 00:19:09,0,38,38
72,HAM,P009663,P010070,0 days 00:18:25,-6,30,36
72,HAM,P011187,P012579,0 days 00:17:51,6,37,31
72,HAM,P009663,P012581,0 days 00:15:30,-6,32,38
72,HAM,P010070,P012579,0 days 00:15:16,-2,28,30
72,HAM,P009663,P012579,0 days 00:15:05,-6,23,29
72,HAM,P010070,P012580,0 days 00:14:17,-4,23,27
72,HAM,P009663,P012580,0 days 00:13:57,-6,20,26
72,HAM,P010070,P011187,0 days 00:12:29,2,25,23
72,HAM,P009663,P011187,0 days 00:12:05,4,23,19
72,HAM,P001990,P012581,0 days 00:11:58,-8,18,26
72,HAM,P012581,P012648,0 days 00:11:54,-5,21,26
72,HAM,P001990,P009663,0 days 00:11:01,-9,18,27
72,HAM,P010070,P012581,0 days 00:10:44,1,24,23
72,HAM,P001990,P012582,0 days 00:10:09,-13,15,28
72,HAM,P009663,P012648,0 days 00:10:00,-2,19,21
72,HAM,P011187,P012582,0 days 00:09:07,-1,15,16
72,HAM,P010070,P012695,0 days 00:08:52,-2,18,20
72,HAM,P012581,P012582,0 days 00:08:41,-10,12,22
72,HAM,P012580,P012695,0 days 00:08:25,-3,14,17
72,HAM,P012582,P012648,0 days 00:07:46,-8,12,20
72,HAM,P012579,P012695,0 days 00:07:33,2,14,12
72,HAM,P011187,P012695,0 days 00:07:29,0,16,16
72,HAM,P001990,P012648,0 days 00:06:58,-5,10,15
72,HAM,P001990,P012579,0 days 00:06:55,-4,16,20
72,HAM,P011187,P012581,0 days 00:06:46,0,12,12
72,HAM,P012580,P012582,0 days 00:06:36,-4,10,14
72,HAM,P009663,P012582,0 days 00:06:27,-8,10,18
72,HAM,P001990,P012580,0 days 00:05:59,-5,8,13
72,HAM,P001990,P010070,0 days 00:05:46,2,11,9
72,HAM,P012579,P012582,0 days 00:05:41,-2,10,12
72,HAM,P001990,P011187,0 days 00:04:54,-2,8,10
72,HAM,P012581,P012695,0 days 00:04:36,-4,10,14
72,HAM,P010070,P012648,0 days 00:04:33,3,9,6
72,HAM,P009663,P012695,0 days 00:04:31,-6,6,12
72,HAM,P011187,P012648,0 days 00:04:28,0,7,7
72,HAM,P012580,P012581,0 days 00:04:17,-5,5,10
72,HAM,P011187,P012694,0 days 00:03:34,-1,7,8
72,HAM,P012579,P012694,0 days 00:03:27,1,7,6
72,HAM,P009663,P012694,0 days 00:03:27,1,7,6
72,HAM,P012648,P012695,0 days 00:03:26,-7,6,13
72,HAM,P012579,P012581,0 days 00:03:14,1,10,9
72,HAM,P012582,P012695,0 days 00:03:01,-2,4,6
72,HAM,P012580,P012694,0 days 00:02:52,1,7,6
72,HAM,P010070,P012694,0 days 00:00:42,-2,0,2
72,HAM,P012579,P012648,0 days 00:00:25,0,0,0
72,HAM,P012580,P012648,0 days 00:00:07,-2,0,2
72,HAM,P012648,P012694,0 days 00:00:07,-2,0,2
72,HAM,P012694,P012695,0 days 00:00:07,-2,0,2
72,WOL,P005516,P012577,0 days 00:22:55,5,45,40
72,WOL,P004645,P005516,0 days 00:20:21,11,42,31
72,WOL,P004645,P012577,0 days 00:19:39,16,44,28
72,WOL,P005516,P006154,0 days 00:17:59,15,46,31
72,WOL,P004645,P006154,0 days 00:17:38,13,42,29
72,WOL,P006154,P012577,0 days 00:17:18,18,47,29
72,WOL,P002387,P003212,0 days 00:16:10,8,31,23
72,WOL,P012576,P012577,0 days 00:15:53,7,33,26
72,WOL,P002387,P012577,0 days 00:12:58,1,23,22
72,WOL,P003212,P012577,0 days 00:12:14,5,21,16
72,WOL,P005516,P012576,0 days 00:12:08,6,25,19
72,WOL,P004645,P012576,0 days 00:11:58,14,31,17
72,WOL,P006154,P012576,0 days 00:11:24,13,30,17
72,WOL,P002387,P004645,0 days 00:10:35,5,21,16
72,WOL,P002387,PLCT,0 days 00:10:29,-1,21,22
72,WOL,P003212,PLCT,0 days 00:10:22,9,26,17
72,WOL,P002387,P005516,0 days 00:10:02,-8,14,22
72,WOL,P003212,P004645,0 days 00:08:56,9,19,10
72,WOL,P004229,PLCT,0 days 00:08:44,-4,17,21
72,WOL,P003212,P012576,0 days 00:08:19,0,15,15
72,WOL,P012577,PLCT,0 days 00:08:18,0,17,17
72,WOL,P002387,P004229,0 days 00:08:12,-2,19,21
72,WOL,P006154,P006907,0 days 00:08:10,0,16,16
72,WOL,P004229,P012577,0 days 00:07:53,1,18,17
72,WOL,P005516,P006907,0 days 00:07:33,-4,12,16
72,WOL,P002387,P006154,0 days 00:07:17,3,20,17
72,WOL,P004645,P006907,0 days 00:06:52,-1,11,12
72,WOL,P002387,P006907,0 days 00:06:52,-3,11,14
72,WOL,P003212,P004229,0 days 00:06:47,4,18,14
72,WOL,P002387,P012576,0 days 00:06:41,1,12,11
72,WOL,P004645,PLCT,0 days 00:06:20,5,17,12
72,WOL,P006907,P012577,0 days 00:05:28,-1,8,9
72,WOL,P012576,PLCT,0 days 00:04:49,3,10,7
72,WOL,P003212,P006907,0 days 00:04:44,-2,7,9
72,WOL,P003212,P005516,0 days 00:04:30,-3,2,5
72,WOL,P004229,P004645,0 days 00:03:57,0,9,9
72,WOL,P004229,P005516,0 days 00:03:54,-6,7,13
72,WOL,P006907,P012576,0 days 00:03:28,0,4,4
72,WOL,P005516,PLCT,0 days 00:03:18,-8,3,11
72,WOL,P003212,P006154,0 days 00:03:18,2,9,7
72,WOL,P006907,PLCT,0 days 00:02:13,-2,3,5
72,WOL,P004229,P006154,0 days 00:01:57,2,8,6
72,WOL,P004229,P006907,0 days 00:01:20,-3,4,7
72,WOL,P006154,PLCT,0 days 00:00:07,2,2,0
73,LLI,P009680,P012586,0 days 00:28:50,12,79,67
73,LLI,P006600,P009680,0 days 00:25:52,11,73,62
73,LLI,P006600,P012586,0 days 00:25:03,13,71,58
73,LLI,P005247,P009680,0 days 00:24:57,-2,55,57
73,LLI,P006600,P012585,0 days 00:24:20,10,71,61
73,LLI,P005247,P012586,0 days 00:24:04,-4,53,57
73,LLI,P009680,P012585,0 days 00:23:18,14,71,57
73,LLI,P012585,P012586,0 days 00:22:29,16,69,53
73,LLI,P004773,P009680,0 days 00:20:14,4,52,48
73,LLI,P005247,P006600,0 days 00:17:45,-1,41,42
73,LLI,P004773,P012586,0 days 00:17:30,8,48,40
73,LLI,P005247,P012585,0 days 00:15:04,0,37,37
73,LLI,P004773,P005247,0 days 00:14:55,-11,22,33
73,LLI,P004773,P006600,0 days 00:14:21,9,42,33
73,LLI,P004773,P012585,0 days 00:12:08,9,42,33
73,LLI,P004773,P008274,0 days 00:10:02,-2,22,24
73,LLI,P004773,P012020,0 days 00:09:32,-2,19,21
73,LLI,P005247,P012020,0 days 00:09:04,-1,15,16
73,LLI,P008274,P012020,0 days 00:06:41,-4,12,16
73,LLI,P009680,P012020,0 days 00:06:19,2,13,11
73,LLI,P005247,P008274,0 days 00:05:39,-3,8,11
73,LLI,P008274,P009680,0 days 00:05:26,-4,10,14
73,LLI,P003850,P004773,0 days 00:05:10,-7,9,16
73,LLI,P008274,P012585,0 days 00:04:26,1,14,13
73,LLI,P012020,P012586,0 days 00:04:21,4,11,7
73,LLI,P003850,P005247,0 days 00:04:08,-6,5,11
73,LLI,P006600,P008274,0 days 00:03:24,2,10,8
73,LLI,P003850,P008274,0 days 00:03:05,-2,6,8
73,LLI,P003850,P012020,0 days 00:03:05,-2,6,8
73,LLI,P003850,P009680,0 days 00:02:05,-5,3,8
73,LLI,P003850,P012586,0 days 00:02:05,-5,3,8
73,LLI,P012020,P012585,0 days 00:01:50,3,8,5
73,LLI,P008274,P012586,0 days 00:01:34,4,6,2
73,LLI,P003850,P012585,0 days 00:01:02,-1,4,5
73,LLI,P006600,P012584,0 days 00:00:03,0,0,0
73,LLI,P008274,P012584,0 days 00:00:03,0,0,0
73,LLI,P009680,P012584,0 days 00:00:03,0,0,0
73,LLI,P012584,P012585,0 days 00:00:03,0,0,0
73,LJU,P003452,P005969,0 days 00:28:09,0,68,68
73,LJU,P002661,P003452,0 days 00:25:44,5,70,65
73,LJU,P005969,P012700,0 days 00:23:57,-5,58,63
73,LJU,P005969,P007066,0 days 00:23:28,-2,59,61
73,LJU,P003452,P012700,0 days 00:23:08,-1,55,56
73,LJU,P003452,P007066,0 days 00:22:35,5,57,52
73,LJU,P002661,P005969,0 days 00:21:58,-1,62,63
73,LJU,P007066,P012700,0 days 00:20:13,-4,47,51
73,LJU,P002661,P012700,0 days 00:19:26,-6,54,60
73,LJU,P002661,P012598,0 days 00:18:32,-10,41,51
73,LJU,P002661,P007066,0 days 00:16:32,2,49,47
73,LJU,P003452,P012598,0 days 00:14:45,-3,31,34
73,LJU,P012598,P012700,0 days 00:12:38,-12,27,39
73,LJU,P005969,P010594,0 days 00:11:54,1,28,27
73,LJU,P003452,P010594,0 days 00:11:54,1,28,27
73,LJU,P005969,P012598,0 days 00:10:59,-9,23,32
73,LJU,P007066,P010594,0 days 00:09:05,2,23,21
73,LJU,P003452,P009392,0 days 00:08:02,-1,12,13
73,LJU,P002661,P009392,0 days 00:07:48,-1,19,20
73,LJU,P009392,P012598,0 days 00:07:48,-1,19,20
73,LJU,P002661,P010594,0 days 00:07:00,1,17,16
73,LJU,P009392,P012700,0 days 00:06:55,-4,11,15
73,LJU,P007066,P012598,0 days 00:05:33,-6,10,16
73,LJU,P011261,P012598,0 days 00:05:01,-3,13,16
73,LJU,P002661,P011261,0 days 00:05:01,-3,13,16
73,LJU,P009392,P011261,0 days 00:05:01,-3,13,16
73,LJU,P010594,P012700,0 days 00:04:54,0,11,11
73,LJU,P003452,P011261,0 days 00:03:28,1,8,7
73,LJU,P005969,P009392,0 days 00:03:23,0,2,2
73,LJU,P010594,P012598,0 days 00:02:49,-1,5,6
73,LJU,P007066,P009392,0 days 00:02:35,-2,0,2
73,LJU,P001235,P002661,0 days 00:02:03,1,3,2
73,LJU,P001235,P007066,0 days 00:02:03,1,3,2
73,LJU,P001235,P012598,0 days 00:02:03,1,3,2
73,LJU,P011261,P012700,0 days 00:01:33,-4,5,9
73,LJU,P001235,P003452,0 days 00:01:07,1,3,2
73,LJU,P001235,P012700,0 days 00:00:56,0,0,0
74,PRS,P012608,P012610,0 days 00:24:11,-12,30,42
74,PRS,P012610,P012613,0 days 00:20:38,-3,30,33
74,PRS,P012608,P012613,0 days 00:20:37,-3,30,33
74,PRS,P005793,P012640,0 days 00:19:47,-1,34,35
74,PRS,P012608,P012609,0 days 00:17:46,-10,20,30
74,PRS,P004512,P012610,0 days 00:16:50,-5,25,30
74,PRS,P004512,P012608,0 days 00:16:49,-5,25,30
74,PRS,P012609,P012640,0 days 00:16:01,2,30,28
74,PRS,P005793,P012609,0 days 00:15:31,4,30,26
74,PRS,P012609,P012610,0 days 00:14:40,-11,15,26
74,PRS,P004512,P012613,0 days 00:14:22,2,25,23
74,PRS,P004512,P012609,0 days 00:13:29,-9,15,24
74,PRS,P012609,P012611,0 days 00:13:16,0,25,25
74,PRS,P003481,P012611,0 days 00:12:50,4,28,24
74,PRS,P005793,P012611,0 days 00:12:41,6,28,22
74,PRS,P012611,P012640,0 days 00:12:41,6,28,22
74,PRS,P003481,P012640,0 days 00:11:58,6,28,22
74,PRS,P003481,P005793,0 days 00:11:58,6,28,22
74,PRS,P012609,P012613,0 days 00:11:06,-2,15,17
74,PRS,P003481,P012609,0 days 00:10:33,5,25,20
74,PRS,P012608,P012640,0 days 00:10:04,-6,10,16
74,PRS,P012610,P012640,0 days 00:08:22,-6,8,14
74,PRS,P012610,P012611,0 days 00:07:38,-2,13,15
74,PRS,P005793,P012608,0 days 00:07:07,-7,6,13
74,PRS,P012612,P012640,0 days 00:06:16,4,9,5
74,PRS,P012608,P012611,0 days 00:06:13,-3,10,13
74,PRS,P012608,P012612,0 days 00:05:33,4,9,5
74,PRS,P005793,P012610,0 days 00:05:26,-7,4,11
74,PRS,P012613,P012640,0 days 00:05:19,-3,5,8
74,PRS,P004512,P012611,0 days 00:05:16,-1,10,11
74,PRS,P012611,P012613,0 days 00:04:18,2,10,8
74,PRS,P005793,P012612,0 days 00:03:50,1,5,4
74,PRS,P012609,P012612,0 days 00:03:50,1,5,4
74,PRS,P005793,P012613,0 days 00:02:54,-6,1,7
74,PRS,P012610,P012612,0 days 00:02:26,3,4,1
74,PRS,P012612,P012613,0 days 00:02:26,3,4,1
74,PRS,P003481,P012610,0 days 00:02:17,-1,3,4
74,PRS,P003481,P012608,0 days 00:00:52,-2,0,2
74,PRS,P003481,P012613,0 days 00:00:52,-2,0,2
74,PRS,P012611,P012612,0 days 00:00:43,0,0,0
74,PRS,P004512,P012640,0 days 00:00:32,-2,0,2
74,PRS,P004512,P005793,0 days 00:00:02,0,0,0
74,BES,P007914,P011936,0 days 00:18:58,-8,35,43
74,BES,P011936,P012647,0 days 00:18:39,3,32,29
74,BES,P007914,P012622,0 days 00:18:10,8,40,32
74,BES,P003783,P007914,0 days 00:16:15,-3,30,33
74,BES,P009582,P011936,0 days 00:16:10,6,25,19
74,BES,P003783,P011936,0 days 00:16:07,-5,29,34
74,BES,P008945,P012622,0 days 00:15:27,8,27,19
74,BES,P011936,P012622,0 days 00:14:16,-5,24,29
74,BES,P008945,P009582,0 days 00:13:50,1,14,13
74,BES,P007914,P012647,0 days 00:12:46,0,24,24
74,BES,P009582,P012622,0 days 00:12:30,5,15,10
74,BES,P003783,P012622,0 days 00:11:29,-1,20,21
74,BES,P009582,P012647,0 days 00:11:24,9,19,10
74,BES,P008945,P011936,0 days 00:11:13,-2,16,18
74,BES,P003783,P012647,0 days 00:11:10,4,21,17
74,BES,P005348,P008945,0 days 00:10:48,2,13,11
74,BES,P005348,P012622,0 days 00:10:32,8,17,9
74,BES,P007914,P009582,0 days 00:10:29,9,21,12
74,BES,P007914,P008945,0 days 00:10:19,11,25,14
74,BES,P005348,P009582,0 days 00:10:18,-6,9,15
74,BES,P003783,P009582,0 days 00:10:05,5,20,15
74,BES,P012622,P012647,0 days 00:09:44,-3,17,20
74,BES,P011379,P012622,0 days 00:09:15,-3,11,14
74,BES,P007914,P011357,0 days 00:09:13,5,21,16
74,BES,P009582,P011379,0 days 00:09:06,-2,11,13
74,BES,P008945,P011379,0 days 00:08:13,-3,10,13
74,BES,P008945,P012647,0 days 00:07:29,-1,11,12
74,BES,P011357,P012622,0 days 00:06:21,11,17,6
74,BES,P005348,P011379,0 days 00:06:20,-6,5,11
74,BES,P003783,P011357,0 days 00:05:48,-3,13,16
74,BES,P005348,P007914,0 days 00:05:24,12,14,2
74,BES,P005348,P011357,0 days 00:04:55,12,14,2
74,BES,P005348,P011936,0 days 00:04:46,-2,6,8
74,BES,P003783,P005348,0 days 00:04:25,4,10,6
74,BES,P011379,P011936,0 days 00:03:49,-5,4,9
74,BES,P011357,P011936,0 days 00:03:43,-7,7,14
74,BES,P008945,P011357,0 days 00:03:25,8,8,0
74,BES,P005348,P012647,0 days 00:03:24,0,4,4
74,BES,P007914,P011379,0 days 00:03:03,1,8,7
74,BES,P003783,P011379,0 days 00:02:18,-2,3,5
74,BES,P009582,P011357,0 days 00:01:48,-3,2,5
74,BES,P007914,P007917,0 days 00:01:39,-3,2,5
74,BES,P007917,P011357,0 days 00:01:39,-3,2,5
74,BES,P007917,P011936,0 days 00:01:39,-3,2,5
74,BES,P003783,P007917,0 days 00:01:39,-3,2,5
75,HTA,P007759,P011973,0 days 00:30:09,7,80,73
75,HTA,P007759,P011991,0 days 00:29:27,5,78,73
75,HTA,P006835,P007759,0 days 00:26:37,6,70,64
75,HTA,P011973,P011991,0 days 00:26:18,9,71,62
75,HTA,P010465,P011991,0 days 00:24:36,-5,62,67
75,HTA,P006835,P011991,0 days 00:24:00,4,64,60
75,HTA,P006835,P011973,0 days 00:23:24,11,64,53
75,HTA,P007759,P010465,0 days 00:21:05,-3,53,56
75,HTA,P010465,P011973,0 days 00:20:05,7,54,47
75,HTA,P006835,P010465,0 days 00:19:13,-4,47,51
75,HTA,P004846,P011991,0 days 00:18:30,4,50,46
75,HTA,P004846,P007759,0 days 00:18:00,8,50,42
75,HTA,P004846,P011973,0 days 00:16:28,6,46,40
75,HTA,P004846,P006835,0 days 00:13:14,10,39,29
75,HTA,P004846,P010465,0 days 00:12:08,-1,30,31
75,HTA,P003533,P011991,0 days 00:08:19,-8,18,26
75,HTA,P004267,P004846,0 days 00:07:33,0,16,16
75,HTA,P003533,P004846,0 days 00:07:25,1,18,17
75,HTA,P003533,P010465,0 days 00:06:53,-11,13,24
75,HTA,P004267,P011991,0 days 00:06:01,-5,11,16
75,HTA,P003533,P006835,0 days 00:05:57,-4,14,18
75,HTA,P003533,P004267,0 days 00:03:58,0,8,8
75,HTA,P003533,P007759,0 days 00:03:58,-2,9,11
75,HTA,P004267,P010465,0 days 00:03:52,1,9,8
75,HTA,P004267,P007759,0 days 00:03:41,-1,7,8
75,HTA,P004267,P011973,0 days 00:03:35,0,8,8
75,HTA,P007759,P011990,0 days 00:03:31,0,9,9
75,HTA,P006835,P011990,0 days 00:03:29,0,9,9
75,HTA,P011973,P011990,0 days 00:03:29,0,9,9
75,HTA,P004846,P011990,0 days 00:02:14,0,7,7
75,HTA,P004267,P006835,0 days 00:01:30,5,5,0
75,HTA,P011990,P011991,0 days 00:01:17,0,2,2
75,HTA,P003533,P011990,0 days 00:00:02,0,0,0
75,HTA,P004267,P011990,0 days 00:00:02,0,0,0
75,JOV,P005094,P011247,0 days 00:28:28,-3,63,66
75,JOV,P011247,P011248,0 days 00:26:48,-4,61,65
75,JOV,P005094,P011248,0 days 00:26:01,-8,57,65
75,JOV,P005094,P012780,0 days 00:24:14,8,62,54
75,JOV,P011248,P012780,0 days 00:23:05,12,62,50
75,JOV,P011247,P012780,0 days 00:22:35,12,58,46
75,JOV,P006771,P011247,0 days 00:17:42,11,48,37
75,JOV,P006771,P012780,0 days 00:17:15,17,49,32
75,JOV,P005094,P006771,0 days 00:15:20,9,40,31
75,JOV,P006771,P011248,0 days 00:15:13,7,40,33
75,JOV,P005094,PJUG,0 days 00:14:47,-4,40,44
75,JOV,P005094,P010161,0 days 00:12:26,-13,23,36
75,JOV,P012780,PJUG,0 days 00:11:42,0,34,34
75,JOV,P010161,P011247,0 days 00:11:27,-8,21,29
75,JOV,P011247,P012349,0 days 00:09:48,-11,22,33
75,JOV,P011248,P012349,0 days 00:09:25,-7,23,30
75,JOV,P010161,P011248,0 days 00:08:58,-7,17,24
75,JOV,P011247,PJUG,0 days 00:08:27,1,22,21
75,JOV,P009572,P012780,0 days 00:07:51,0,24,24
75,JOV,P005094,P009572,0 days 00:07:35,-5,20,25
75,JOV,P011248,PJUG,0 days 00:07:00,-4,18,22
75,JOV,P006771,P012349,0 days 00:06:35,-2,19,21
75,JOV,P009572,PJUG,0 days 00:06:33,-5,18,23
75,JOV,P010161,P012780,0 days 00:05:50,-5,13,18
75,JOV,P005094,P012349,0 days 00:05:33,-14,8,22
75,JOV,P012349,P012780,0 days 00:05:12,4,18,14
75,JOV,P005094,P010708,0 days 00:04:48,-2,11,13
75,JOV,P009572,P011248,0 days 00:04:40,0,14,14
75,JOV,P006771,PJUG,0 days 00:04:22,5,14,9
75,JOV,P010161,P010708,0 days 00:04:22,2,11,9
75,JOV,P010708,P011247,0 days 00:04:22,2,11,9
75,JOV,P010161,P012349,0 days 00:04:08,-8,7,15
75,JOV,P010708,P011248,0 days 00:03:42,-5,8,13
75,JOV,P010161,PJUG,0 days 00:03:25,-5,8,13
75,JOV,P009572,P010161,0 days 00:02:56,-4,8,12
75,JOV,P006771,P009572,0 days 00:01:53,1,6,5
75,JOV,P010708,PJUG,0 days 00:01:32,-1,3,4
75,JOV,P012349,PJUG,0 days 00:01:20,-3,3,6
75,JOV,P009572,P011247,0 days 00:01:15,0,2,2
75,JOV,P009572,P012349,0 days 00:00:59,1,4,3
75,JOV,P009572,P010708,0 days 00:00:26,-4,0,4
76,BOU,P010718,P011837,0 days 00:26:17,21,56,35
76,BOU,P010718,P011836,0 days 00:23:07,22,51,29
76,BOU,P010431,P011837,0 days 00:21:22,19,42,23
76,BOU,P011836,P012617,0 days 00:20:48,15,42,27
76,BOU,P010718,P012617,0 days 00:20:33,12,41,29
76,BOU,P011836,P011837,0 days 00:20:33,19,43,24
76,BOU,P011837,P012617,0 days 00:19:55,14,41,27
76,BOU,P010431,P010718,0 days 00:18:20,18,36,18
76,BOU,P000498,P004525,0 days 00:15:32,0,34,34
76,BOU,P010431,P012617,0 days 00:13:04,13,23,10
76,BOU,P010431,P011836,0 days 00:12:46,13,23,10
76,BOU,P011161,P011836,0 days 00:10:55,9,29,20
76,BOU,P000498,P011161,0 days 00:10:48,-4,25,29
76,BOU,P010718,P011161,0 days 00:10:31,6,28,22
76,BOU,P004525,P010431,0 days 00:10:20,3,22,19
76,BOU,P000498,P011837,0 days 00:10:14,10,23,13
76,BOU,P000498,P010431,0 days 00:10:02,3,22,19
76,BOU,P011161,P011837,0 days 00:09:56,0,22,22
76,BOU,P011161,P012619,0 days 00:09:51,-5,22,27
76,BOU,P004525,P011837,0 days 00:09:36,5,21,16
76,BOU,P011161,P012617,0 days 00:08:59,-1,19,20
76,BOU,P004525,P011161,0 days 00:08:52,-14,15,29
76,BOU,P000498,P010718,0 days 00:08:18,12,23,11
76,BOU,P000498,P012619,0 days 00:08:11,-3,21,24
76,BOU,P004525,P012619,0 days 00:06:43,-8,13,21
76,BOU,P011161,P012628,0 days 00:06:23,-3,13,16
76,BOU,P000498,P012628,0 days 00:05:49,-3,12,15
76,BOU,P004525,P012628,0 days 00:05:49,-3,12,15
76,BOU,P004525,P010718,0 days 00:05:44,2,13,11
76,BOU,P012619,P012628,0 days 00:05:33,-5,11,16
76,BOU,P011836,P012619,0 days 00:03:08,3,9,6
76,BOU,P000498,P011836,0 days 00:02:53,7,10,3
76,BOU,P010431,P011161,0 days 00:02:53,-8,3,11
76,BOU,P010718,P012619,0 days 00:02:34,3,8,5
76,BOU,P010450,P011837,0 days 00:01:53,6,6,0
76,BOU,P010431,P010450,0 days 00:01:53,6,6,0
76,BOU,P004525,P010450,0 days 00:01:53,6,6,0
76,BOU,P000498,P010450,0 days 00:01:53,6,6,0
76,BOU,P010431,P012619,0 days 00:01:44,-3,3,6
76,BOU,P012617,P012619,0 days 00:01:40,-2,1,3
76,BOU,P011837,P012628,0 days 00:00:50,2,2,0
76,BOU,P004525,P012617,0 days 00:00:47,-3,0,3
76,BOU,P011836,P012628,0 days 00:00:34,0,1,1
76,BOU,P012617,P012628,0 days 00:00:34,0,1,1
76,TTK,P005000,P011239,0 days 00:34:56,-3,61,64
76,TTK,P005000,P006693,0 days 00:29:49,-2,59,61
76,TTK,P006693,P011239,0 days 00:27:23,5,53,48
76,TTK,P005000,P011925,0 days 00:26:49,-1,41,42
76,TTK,P011239,P011925,0 days 00:26:49,-1,41,42
76,TTK,P005000,P011834,0 days 00:21:20,1,46,45
76,TTK,P011239,P011834,0 days 00:21:11,3,45,42
76,TTK,P006693,P011925,0 days 00:20:20,6,35,29
76,TTK,P004801,P005000,0 days 00:20:10,-5,35,40
76,TTK,P006693,P011834,0 days 00:20:04,3,44,41
76,TTK,P004801,P011239,0 days 00:19:12,-3,32,35
76,TTK,P004801,P011925,0 days 00:16:35,-16,16,32
76,TTK,P011834,P011925,0 days 00:15:42,-4,25,29
76,TTK,P004801,P006693,0 days 00:13:41,2,29,27
76,TTK,P004801,P011834,0 days 00:08:14,-8,17,25
76,TTK,P011925,P012697,0 days 00:07:45,-17,2,19
76,TTK,P004801,P012697,0 days 00:07:45,-17,2,19
76,TTK,P005000,P012697,0 days 00:05:07,-8,2,10
76,TTK,P011239,P012697,0 days 00:05:07,-8,2,10
76,TTK,P004801,P009845,0 days 00:04:46,-9,7,16
76,TTK,P005000,P009845,0 days 00:04:40,-6,12,18
76,TTK,P000497,P005000,0 days 00:04:20,-11,7,18
76,TTK,P009845,P011834,0 days 00:03:51,-12,3,15
76,TTK,P009845,P011925,0 days 00:03:48,-7,4,11
76,TTK,P000497,P006693,0 days 00:03:16,-10,5,15
76,TTK,P000497,P011834,0 days 00:02:52,-6,4,10
76,TTK,P000497,P011239,0 days 00:02:52,-6,4,10
76,TTK,P011834,P012697,0 days 00:02:38,-9,0,9
76,TTK,P009845,P012697,0 days 00:02:38,-9,0,9
76,TTK,P000497,P009845,0 days 00:02:32,-6,5,11
76,TTK,P006693,P009845,0 days 00:02:26,-7,6,13
76,TTK,P005000,P011975,0 days 00:02:17,-5,5,10
76,TTK,P006693,P011975,0 days 00:02:17,-5,5,10
76,TTK,P009845,P011975,0 days 00:02:17,-5,5,10
76,TTK,P009845,P011239,0 days 00:02:14,1,6,5
76,TTK,P000497,P011975,0 days 00:01:28,-5,3,8
76,TTK,P004801,P011975,0 days 00:00:49,0,2,2
77,WRO,P005531,P012010,0 days 00:32:05,-6,61,67
77,WRO,P012010,P012699,0 days 00:27:16,-2,53,55
77,WRO,P005531,P012699,0 days 00:26:55,-2,53,55
77,WRO,P005531,P011900,0 days 00:22:56,6,52,46
77,WRO,P009896,P012010,0 days 00:22:55,0,47,47
77,WRO,P005531,P009896,0 days 00:22:55,0,47,47
77,WRO,P011900,P012010,0 days 00:22:52,4,50,46
77,WRO,P011900,P012699,0 days 00:19:23,7,44,37
77,WRO,P009896,P011900,0 days 00:19:03,3,40,37
77,WRO,P009896,P012699,0 days 00:18:19,5,42,37
77,WRO,P005531,P012736,0 days 00:12:42,-3,22,25
77,WRO,P003034,P012736,0 days 00:11:58,0,15,15
77,WRO,P003034,P005531,0 days 00:11:14,-3,20,23
77,WRO,P011900,P012736,0 days 00:11:13,-3,14,17
77,WRO,P012010,P012736,0 days 00:10:51,-6,16,22
77,WRO,P003034,P012699,0 days 00:10:25,-8,13,21
77,WRO,P003034,P011900,0 days 00:09:28,2,16,14
77,WRO,P003034,P012010,0 days 00:09:23,-6,14,20
77,WRO,P003034,P011902,0 days 00:07:46,-3,8,11
77,WRO,P011901,P012736,0 days 00:07:34,2,10,8
77,WRO,P003034,P011901,0 days 00:07:34,2,10,8
77,WRO,P012699,P012736,0 days 00:07:17,-3,10,13
77,WRO,P009896,P012736,0 days 00:06:27,-4,11,15
77,WRO,P005531,P011902,0 days 00:06:09,-7,7,14
77,WRO,P011900,P011901,0 days 00:05:47,1,6,5
77,WRO,P011902,P012736,0 days 00:05:38,1,6,5
77,WRO,P011901,P011902,0 days 00:05:33,1,6,5
77,WRO,P011902,P012010,0 days 00:04:22,-8,3,11
77,WRO,P011902,P012699,0 days 00:04:17,-8,3,11
77,WRO,P011900,P011902,0 days 00:03:54,0,2,2
77,WRO,P005531,P011901,0 days 00:02:12,3,6,3
77,WRO,P009896,P011902,0 days 00:02:01,-4,1,5
77,WRO,P011901,P012699,0 days 00:01:36,-1,2,3
77,LKB,P002012,P008856,0 days 00:22:29,17,53,36
77,LKB,P002012,PLXI,0 days 00:21:56,18,53,35
77,LKB,P008856,PLXI,0 days 00:21:15,10,47,37
77,LKB,P002012,P005521,0 days 00:20:58,19,52,33
77,LKB,P005521,P008856,0 days 00:19:58,19,49,30
77,LKB,P010461,PLXI,0 days 00:18:05,-3,34,37
77,LKB,P005521,PLXI,0 days 00:17:53,19,46,27
77,LKB,P008856,P010461,0 days 00:17:49,-4,34,38
77,LKB,P004868,P007029,0 days 00:15:48,1,24,23
77,LKB,P002012,P010461,0 days 00:15:10,2,31,29
77,LKB,P006901,P007029,0 days 00:14:47,-14,16,30
77,LKB,P007029,P010190,0 days 00:14:28,-6,19,25
77,LKB,P007029,PLXI,0 days 00:14:26,-13,17,30
77,LKB,P005521,P010461,0 days 00:14:02,6,29,23
77,LKB,P004868,PLXI,0 days 00:12:58,9,26,17
77,LKB,P006901,P010190,0 days 00:12:56,-7,16,23
77,LKB,P007029,P008856,0 days 00:11:33,-10,16,26
77,LKB,P004868,P010190,0 days 00:10:37,-5,13,18
77,LKB,P004868,P008856,0 days 00:10:21,13,25,12
77,LKB,P002012,P004868,0 days 00:09:52,16,28,12
77,LKB,P004868,P006901,0 days 00:09:39,-6,10,16
77,LKB,P006901,PLXI,0 days 00:09:12,-12,7,19
77,LKB,P004868,P005521,0 days 00:08:49,12,26,14
77,LKB,P010190,PLXI,0 days 00:08:47,-4,10,14
77,LKB,P002012,P007029,0 days 00:08:31,-1,16,17
77,LKB,P007029,P010461,0 days 00:07:25,-16,8,24
77,LKB,P005521,P007029,0 days 00:06:14,-1,12,13
77,LKB,P006901,P008856,0 days 00:05:46,-8,6,14
77,LKB,P006901,P010461,0 days 00:05:14,-8,6,14
77,LKB,P010190,P010461,0 days 00:03:51,-1,6,7
77,LKB,P008856,P010190,0 days 00:03:49,-1,6,7
77,LKB,P005521,P006901,0 days 00:01:58,-1,3,4
77,LKB,P005521,P010190,0 days 00:01:52,-1,3,4
77,LKB,P002012,P010190,0 days 00:01:32,1,3,2
78,CLU,P005714,P011801,0 days 00:21:43,-15,38,53
78,CLU,P011801,P012621,0 days 00:19:25,3,40,37
78,CLU,P005113,P012698,0 days 00:19:14,0,37,37
78,CLU,P004862,P010569,0 days 00:18:33,-15,32,47
78,CLU,P011801,P012698,0 days 00:18:13,-8,36,44
78,CLU,P005714,P012621,0 days 00:18:05,1,35,34
78,CLU,P005113,P010569,0 days 00:16:19,-8,27,35
78,CLU,P005714,P012698,0 days 00:16:05,-8,31,39
78,CLU,P005113,P012621,0 days 00:15:44,3,34,31
78,CLU,P004862,P012698,0 days 00:14:52,-14,24,38
78,CLU,P010569,P012698,0 days 00:14:43,-8,23,31
78,CLU,P005113,P011797,0 days 00:14:26,-5,25,30
78,CLU,P012621,P012698,0 days 00:14:16,8,33,25
78,CLU,P010569,P011797,0 days 00:14:12,-9,23,32
78,CLU,P004862,P011797,0 days 00:13:32,-9,23,32
78,CLU,P004862,P005113,0 days 00:13:03,-7,23,30
78,CLU,P004862,P005714,0 days 00:12:38,-21,14,35
78,CLU,P004862,P012621,0 days 00:12:35,-8,21,29
78,CLU,P005113,P011801,0 days 00:11:41,5,25,20
78,CLU,P004862,P011801,0 days 00:11:30,-20,15,35
78,CLU,P010569,P012621,0 days 00:11:03,-4,22,26
78,CLU,P005373,P011801,0 days 00:09:54,-14,13,27
78,CLU,P005373,P005714,0 days 00:09:46,-12,13,25
78,CLU,P011797,P012698,0 days 00:08:56,-3,14,17
78,CLU,P005113,P005714,0 days 00:08:25,6,21,15
78,CLU,P004862,P005373,0 days 00:07:41,-14,8,22
78,CLU,P010569,P011801,0 days 00:07:13,-9,11,20
78,CLU,P005373,P012621,0 days 00:06:21,-5,8,13
78,CLU,P005373,P012698,0 days 00:05:45,-9,10,19
78,CLU,P011797,P012621,0 days 00:05:31,-2,11,13
78,CLU,P005714,P010569,0 days 00:05:05,-9,6,15
78,CLU,P011797,P011801,0 days 00:01:53,0,2,2
78,CLU,P005714,P011797,0 days 00:01:13,0,2,2
78,CLU,P005373,P010569,0 days 00:00:08,-2,0,2
78,CLU,P005113,P012620,0 days 00:00:04,-2,0,2
78,CLU,P005714,P012620,0 days 00:00:04,-2,0,2
78,CLU,P011801,P012620,0 days 00:00:04,-2,0,2
78,CLU,P012620,P012698,0 days 00:00:04,-2,0,2
78,CLU,P005373,P011797,0 days 00:00:01,0,0,0
78,CAN,P004160,P007644,0 days 00:17:41,15,42,27
78,CAN,P007560,P007644,0 days 00:17:20,25,50,25
78,CAN,P003425,P004160,0 days 00:17:08,19,39,20
78,CAN,P003425,P010452,0 days 00:16:07,3,31,28
78,CAN,P003425,P003637,0 days 00:15:16,-1,26,27
78,CAN,P003637,P010452,0 days 00:15:03,-4,24,28
78,CAN,P003425,P007644,0 days 00:13:45,15,36,21
78,CAN,P003637,P004160,0 days 00:13:12,-1,20,21
78,CAN,P004160,P010385,0 days 00:13:11,17,29,12
78,CAN,P004160,P007560,0 days 00:12:00,20,34,14
78,CAN,P001607,P007644,0 days 00:11:59,7,30,23
78,CAN,P003425,P007560,0 days 00:11:22,18,34,16
78,CAN,P003425,P010385,0 days 00:11:09,17,28,11
78,CAN,P003425,P005005,0 days 00:10:58,-3,21,24
78,CAN,P003637,P009864,0 days 00:10:55,1,24,23
78,CAN,P007644,P010385,0 days 00:10:39,18,29,11
78,CAN,P003637,P005005,0 days 00:10:25,-1,22,23
78,CAN,P004160,P010452,0 days 00:10:20,1,16,15
78,CAN,P005005,P007644,0 days 00:10:08,6,26,20
78,CAN,P005005,P009864,0 days 00:09:30,0,24,24
78,CAN,P007560,P010385,0 days 00:09:13,15,24,9
78,CAN,P003637,P007644,0 days 00:09:01,-3,18,21
78,CAN,P009864,P010452,0 days 00:08:34,0,17,17
78,CAN,P003425,P009864,0 days 00:08:19,0,17,17
78,CAN,P001607,P009864,0 days 00:08:18,6,26,20
78,CAN,P005005,P010452,0 days 00:08:16,-2,17,19
78,CAN,P001607,P004160,0 days 00:08:04,0,15,15
78,CAN,P001607,P007560,0 days 00:07:43,5,20,15
78,CAN,P004160,P009864,0 days 00:07:07,6,19,13
78,CAN,P005005,P007560,0 days 00:07:05,3,20,17
78,CAN,P007644,P009864,0 days 00:06:18,8,22,14
78,CAN,P001607,P003637,0 days 00:06:16,0,14,14
78,CAN,P007644,P010452,0 days 00:06:05,-3,11,14
78,CAN,P001607,P005005,0 days 00:05:55,5,19,14
78,CAN,P007560,P009864,0 days 00:05:42,5,19,14
78,CAN,P003637,P010385,0 days 00:05:23,5,10,5
78,CAN,P010385,P010452,0 days 00:03:57,2,5,3
78,CAN,P007560,P010452,0 days 00:03:33,3,9,6
78,CAN,P001607,P010385,0 days 00:03:27,3,6,3
78,CAN,P001607,P010452,0 days 00:02:29,-4,2,6
78,CAN,P004160,P005005,0 days 00:02:05,-1,2,3
78,CAN,P001607,P010484,0 days 00:01:45,-2,4,6
78,CAN,P005005,P010484,0 days 00:01:45,-2,4,6
78,CAN,P007560,P010484,0 days 00:01:45,-2,4,6
78,CAN,P009864,P010484,0 days 00:01:45,-2,4,6
78,CAN,P005005,P010385,0 days 00:01:25,3,5,2
78,CAN,P003637,P007560,0 days 00:00:37,0,2,2
79,BUD,P010248,P012606,0 days 00:27:02,-2,62,64
79,BUD,P002740,P010248,0 days 00:21:54,1,48,47
79,BUD,P007398,P011935,0 days 00:18:56,4,41,37
79,BUD,P010248,P011935,0 days 00:18:36,3,43,40
79,BUD,P010248,P012630,0 days 00:17:37,9,36,27
79,BUD,P011935,P012630,0 days 00:16:50,18,40,22
79,BUD,P002740,P012606,0 days 00:16:37,-1,38,39
79,BUD,P011935,P012606,0 days 00:15:12,2,36,34
79,BUD,P011935,P012605,0 days 00:14:57,8,32,24
79,BUD,P004945,P007398,0 days 00:13:39,2,35,33
79,BUD,P002740,P012630,0 days 00:13:13,18,33,15
79,BUD,P007398,P012606,0 days 00:12:59,-10,28,38
79,BUD,P007398,P010248,0 days 00:12:15,-6,27,33
79,BUD,P002740,P011935,0 days 00:12:14,3,29,26
79,BUD,P007398,P010432,0 days 00:11:52,4,25,21
79,BUD,P010432,P011935,0 days 00:11:33,7,25,18
79,BUD,P012606,P012630,0 days 00:11:31,9,25,16
79,BUD,P004945,P011935,0 days 00:11:30,1,26,25
79,BUD,P012605,P012630,0 days 00:11:09,8,23,15
79,BUD,P007398,P012605,0 days 00:11:08,8,24,16
79,BUD,P004945,P012606,0 days 00:11:04,-3,31,34
79,BUD,P009214,P010248,0 days 00:10:21,0,24,24
79,BUD,P010432,P012605,0 days 00:10:19,10,23,13
79,BUD,P004945,P010248,0 days 00:09:31,3,29,26
79,BUD,P007398,P012630,0 days 00:09:27,-1,15,16
79,BUD,P009214,P012606,0 days 00:09:12,-5,22,27
79,BUD,P004945,P010432,0 days 00:06:49,-4,13,17
79,BUD,P010248,P012605,0 days 00:06:06,0,11,11
79,BUD,P009214,P012630,0 days 00:05:50,-1,8,9
79,BUD,P002740,P009214,0 days 00:05:29,3,13,10
79,BUD,P002740,P012605,0 days 00:05:17,2,10,8
79,BUD,P004945,P012605,0 days 00:05:16,2,11,9
79,BUD,P007398,P009214,0 days 00:05:11,-6,11,17
79,BUD,P010432,P012630,0 days 00:05:03,8,12,4
79,BUD,P006566,P012606,0 days 00:04:59,-11,6,17
79,BUD,P006566,P010248,0 days 00:04:59,-11,6,17
79,BUD,P002740,P006566,0 days 00:04:59,-11,6,17
79,BUD,P004945,P009214,0 days 00:04:50,-2,16,18
79,BUD,P004397,P012606,0 days 00:04:11,-5,6,11
79,BUD,P004397,P010248,0 days 00:04:11,-5,6,11
79,BUD,P004397,P006566,0 days 00:04:11,-5,6,11
79,BUD,P002740,P004397,0 days 00:04:11,-5,6,11
79,BUD,P002740,P004945,0 days 00:02:41,-3,7,10
79,BUD,P010432,P012606,0 days 00:01:33,-6,2,8
79,BUD,P009214,P012605,0 days 00:01:28,2,2,0
79,BUD,P002740,P007398,0 days 00:01:01,-3,2,5
79,BUD,P006566,P011935,0 days 00:00:48,-6,0,6
79,BUD,P009214,P010432,0 days 00:00:19,-3,0,3
79,TRN,P009903,P012597,0 days 00:26:27,7,65,58
79,TRN,P005738,P012597,0 days 00:25:32,13,70,57
79,TRN,P009903,P012594,0 days 00:24:13,15,60,45
79,TRN,P012595,P012597,0 days 00:23:29,-9,48,57
79,TRN,P012594,P012597,0 days 00:22:26,13,53,40
79,TRN,P005738,P009903,0 days 00:21:45,5,60,55
79,TRN,P005738,P012595,0 days 00:20:23,1,52,51
79,TRN,P005738,P012594,0 days 00:16:30,11,46,35
79,TRN,P006382,P012595,0 days 00:16:18,-14,27,41
79,TRN,P009903,P012595,0 days 00:16:16,-4,39,43
79,TRN,P012595,P012596,0 days 00:15:10,-11,22,33
79,TRN,P009903,P012593,0 days 00:14:49,14,38,24
79,TRN,P012593,P012594,0 days 00:14:49,14,38,24
79,TRN,P012593,P012597,0 days 00:13:34,13,35,22
79,TRN,P012594,P012595,0 days 00:12:37,2,27,25
79,TRN,P001479,P012597,0 days 00:11:31,-9,13,22
79,TRN,P001479,P012595,0 days 00:11:03,-16,9,25
79,TRN,P006382,P012596,0 days 00:10:42,-10,15,25
79,TRN,P012596,P012597,0 days 00:10:36,-3,18,21
79,TRN,P001479,P012594,0 days 00:09:41,4,16,12
79,TRN,P006382,P012597,0 days 00:09:36,-7,17,24
79,TRN,P005738,P006382,0 days 00:09:10,-3,20,23
79,TRN,P001479,P012596,0 days 00:09:00,-18,6,24
79,TRN,P005738,P012593,0 days 00:08:47,12,27,15
79,TRN,P001479,P009903,0 days 00:08:05,4,14,10
79,TRN,P007828,P012595,0 days 00:08:04,-9,15,24
79,TRN,P001479,P012593,0 days 00:07:11,1,13,12
79,TRN,P001479,P006382,0 days 00:07:08,-11,7,18
79,TRN,P005738,P012596,0 days 00:06:10,7,16,9
79,TRN,P007828,P012596,0 days 00:05:55,-8,7,15
79,TRN,P006382,P009903,0 days 00:05:36,-4,12,16
79,TRN,P007828,P012597,0 days 00:05:01,-2,13,15
79,TRN,P001479,P007828,0 days 00:04:41,-11,2,13
79,TRN,P005738,P007828,0 days 00:03:23,2,13,11
79,TRN,P006382,P007828,0 days 00:03:03,-7,2,9
79,TRN,P006382,P012594,0 days 00:02:30,1,6,5
79,TRN,P012593,P012595,0 days 00:02:24,0,5,5
79,TRN,P007828,P009903,0 days 00:02:09,-1,8,9
79,TRN,P012594,P012596,0 days 00:01:58,0,2,2
79,TRN,P006382,P012593,0 days 00:01:09,-1,2,3
79,TRN,P012593,P012596,0 days 00:01:09,-1,2,3
80,ARI,P003240,P012707,0 days 00:24:53,-3,53,56
80,ARI,P003240,P012708,0 days 00:23:41,-15,44,59
80,ARI,P003240,P012716,0 days 00:22:14,1,48,47
80,ARI,P012707,P012716,0 days 00:21:39,4,46,42
80,ARI,P012708,P012716,0 days 00:19:49,-13,37,50
80,ARI,P012702,P012707,0 days 00:19:30,-8,39,47
80,ARI,P012707,P012708,0 days 00:18:42,-9,37,46
80,ARI,P012702,P012708,0 days 00:18:39,-8,31,39
80,ARI,P003240,P012702,0 days 00:18:17,-11,31,42
80,ARI,P002867,P004292,0 days 00:16:17,-4,27,31
80,ARI,P002867,P012707,0 days 00:16:11,2,36,34
80,ARI,P004292,P012707,0 days 00:16:01,7,37,30
80,ARI,P002867,P012702,0 days 00:14:10,-9,25,34
80,ARI,P003240,P004292,0 days 00:12:51,-7,27,34
80,ARI,P004292,P012702,0 days 00:12:51,-11,21,32
80,ARI,P004292,P012708,0 days 00:12:49,-16,19,35
80,ARI,P012702,P012716,0 days 00:11:41,0,22,22
80,ARI,P002867,P010387,0 days 00:10:52,2,23,21
80,ARI,P004292,P012716,0 days 00:10:50,-1,19,20
80,ARI,P004292,P010387,0 days 00:09:07,6,20,14
80,ARI,P002867,P012708,0 days 00:08:40,-9,10,19
80,ARI,P010387,P012707,0 days 00:08:32,2,21,19
80,ARI,P002867,P003240,0 days 00:08:19,-6,16,22
80,ARI,P012707,P012722,0 days 00:08:08,7,20,13
80,ARI,P012716,P012760,0 days 00:07:52,-4,15,19
80,ARI,P004292,P012722,0 days 00:07:43,2,14,12
80,ARI,P003240,P012760,0 days 00:07:41,-2,18,20
80,ARI,P002867,P012722,0 days 00:07:25,3,16,13
80,ARI,P010387,P012702,0 days 00:07:16,-1,15,16
80,ARI,P012707,P012760,0 days 00:06:56,2,15,13
80,ARI,P012716,P012722,0 days 00:06:47,0,14,14
80,ARI,P002867,P012716,0 days 00:06:44,-3,11,14
80,ARI,P012708,P012760,0 days 00:05:54,-8,12,20
80,ARI,P004292,P012760,0 days 00:04:39,4,12,8
80,ARI,P003240,P012722,0 days 00:04:26,2,12,10
80,ARI,P010387,P012722,0 days 00:03:36,3,8,5
80,ARI,P012708,P012722,0 days 00:03:27,-5,4,9
80,ARI,P010387,P012708,0 days 00:02:35,-1,2,3
80,ARI,P003240,P010387,0 days 00:01:30,-3,3,6
80,ARI,P002867,P012760,0 days 00:00:46,0,0,0
80,ULM,P010106,P010582,0 days 00:26:55,11,65,54
80,ULM,P005422,P010582,0 days 00:23:43,14,60,46
80,ULM,P005422,P012603,0 days 00:23:21,15,60,45
80,ULM,P005422,P010106,0 days 00:22:55,10,53,43
80,ULM,P010106,P012603,0 days 00:22:47,12,54,42
80,ULM,P010106,P012604,0 days 00:22:44,10,56,46
80,ULM,P010582,P012603,0 days 00:22:39,22,63,41
80,ULM,P012603,P012604,0 days 00:21:39,7,48,41
80,ULM,P005422,P012604,0 days 00:19:39,7,45,38
80,ULM,P010582,P012604,0 days 00:19:27,4,45,41
80,ULM,P010106,P011457,0 days 00:14:01,-4,26,30
80,ULM,P007952,P011457,0 days 00:13:33,-9,17,26
80,ULM,P007952,P010582,0 days 00:13:25,13,34,21
80,ULM,P010582,P011457,0 days 00:11:22,-9,15,24
80,ULM,P006997,P010106,0 days 00:11:20,-4,25,29
80,ULM,P006997,P011457,0 days 00:11:07,-7,23,30
80,ULM,P007952,P010106,0 days 00:10:58,6,25,19
80,ULM,P010106,P010726,0 days 00:10:44,3,24,21
80,ULM,P006997,P007952,0 days 00:08:09,-3,17,20
80,ULM,P005422,P007952,0 days 00:08:02,7,18,11
80,ULM,P005422,P011457,0 days 00:07:48,-9,3,12
80,ULM,P006997,P010726,0 days 00:07:17,7,22,15
80,ULM,P006997,P010582,0 days 00:07:04,-7,12,19
80,ULM,P010726,P011457,0 days 00:07:00,1,16,15
80,ULM,P010582,P012703,0 days 00:06:53,2,14,12
80,ULM,P007952,P012703,0 days 00:06:43,2,14,12
80,ULM,P005422,P012703,0 days 00:06:40,-1,11,12
80,ULM,P010726,P012604,0 days 00:06:39,2,14,12
80,ULM,P007952,P010726,0 days 00:06:25,-1,13,14
80,ULM,P011457,P012703,0 days 00:06:02,-5,6,11
80,ULM,P011457,P012604,0 days 00:05:05,3,14,11
80,ULM,P005422,P010726,0 days 00:04:45,-4,5,9
80,ULM,P011457,P012603,0 days 00:04:14,3,8,5
80,ULM,P012603,P012703,0 days 00:04:04,7,13,6
80,ULM,P010726,P012603,0 days 00:03:55,-4,3,7
80,ULM,P006997,P012604,0 days 00:03:46,1,11,10
80,ULM,P010582,P010726,0 days 00:03:44,2,8,6
80,ULM,P007952,P012603,0 days 00:03:29,17,18,1
80,ULM,P012604,P012703,0 days 00:02:41,-2,3,5
80,ULM,P010726,P012703,0 days 00:02:31,-2,3,5
80,ULM,P006997,P012703,0 days 00:02:02,-1,4,5
80,ULM,P005422,P006997,0 days 00:01:27,-3,1,4
80,ULM,P006997,P012603,0 days 00:01:16,-3,1,4
81,JOV,P011247,P011248,0 days 00:19:33,-13,28,41
81,JOV,P011248,P012349,0 days 00:18:51,2,35,33
81,JOV,P011248,P012780,0 days 00:15:50,-18,21,39
81,JOV,P002361,P011248,0 days 00:15:40,6,29,23
81,JOV,P010708,P012349,0 days 00:15:35,23,43,20
81,JOV,P002361,P012349,0 days 00:15:24,16,37,21
81,JOV,P011247,P012780,0 days 00:15:11,-18,19,37
81,JOV,P002361,P010708,0 days 00:12:47,18,37,19
81,JOV,P005094,P012780,0 days 00:12:28,-7,18,25
81,JOV,P010161,P012349,0 days 00:11:35,-10,15,25
81,JOV,P010708,P011248,0 days 00:11:22,14,28,14
81,JOV,P010161,P011248,0 days 00:11:13,-8,16,24
81,JOV,P002361,P005094,0 days 00:10:46,-1,22,23
81,JOV,P005094,P011248,0 days 00:10:39,-8,14,22
81,JOV,P005094,P011247,0 days 00:10:19,-8,12,20
81,JOV,P011247,P012349,0 days 00:09:46,-5,16,21
81,JOV,P002361,P006771,0 days 00:09:14,12,28,16
81,JOV,P002361,P010161,0 days 00:08:57,-1,13,14
81,JOV,P006771,P010708,0 days 00:07:07,16,22,6
81,JOV,P006771,P012349,0 days 00:07:07,16,22,6
81,JOV,P005094,P006771,0 days 00:06:56,-4,12,16
81,JOV,P002361,P002507,0 days 00:06:46,-3,11,14
81,JOV,P002361,P012780,0 days 00:06:37,0,11,11
81,JOV,P010708,PJUG,0 days 00:06:29,14,25,11
81,JOV,P012349,PJUG,0 days 00:06:29,14,25,11
81,JOV,P002361,PJUG,0 days 00:06:29,14,25,11
81,JOV,P011248,PJUG,0 days 00:06:25,3,17,14
81,JOV,P002361,P011247,0 days 00:06:15,-1,8,9
81,JOV,P006771,P011248,0 days 00:06:09,0,8,8
81,JOV,P010161,P012780,0 days 00:06:03,-10,9,19
81,JOV,P005094,P009572,0 days 00:05:45,0,15,15
81,JOV,P002361,P009572,0 days 00:05:45,0,15,15
81,JOV,P006771,P011247,0 days 00:05:21,0,6,6
81,JOV,P012349,P012780,0 days 00:05:11,-10,7,17
81,JOV,P010708,P011247,0 days 00:04:54,5,9,4
81,JOV,P010161,P011247,0 days 00:04:52,-10,7,17
81,JOV,P002507,P009572,0 days 00:04:28,-1,11,12
81,JOV,P002507,P005094,0 days 00:04:28,-1,11,12
81,JOV,P006771,P009572,0 days 00:04:23,1,12,11
81,JOV,P012780,PJUG,0 days 00:04:09,-2,7,9
81,JOV,P011247,PJUG,0 days 00:04:09,-2,7,9
81,JOV,P005094,PJUG,0 days 00:04:09,-2,7,9
81,JOV,P010161,P010708,0 days 00:04:06,2,8,6
81,JOV,P006771,P012780,0 days 00:03:50,-4,4,8
81,JOV,P002507,P010161,0 days 00:03:40,-3,3,6
81,JOV,P002507,P006771,0 days 00:03:06,0,8,8
81,JOV,P006771,PJUG,0 days 00:02:59,11,14,3
81,JOV,P002507,P011248,0 days 00:02:18,-2,0,2
81,JOV,P002507,P012349,0 days 00:02:18,-2,0,2
81,JOV,P005094,P010161,0 days 00:02:14,-1,5,6
81,JOV,P009572,P010161,0 days 00:01:22,-1,3,4
81,JOV,P009572,P012780,0 days 00:01:17,1,4,3
81,JOV,P010161,PJUG,0 days 00:01:14,-2,1,3
81,PMT,P002644,P012600,0 days 00:20:56,-2,37,39
81,PMT,P002644,P011944,0 days 00:17:53,8,36,28
81,PMT,P001686,P011947,0 days 00:17:37,-5,32,37
81,PMT,P002644,P010549,0 days 00:17:06,5,30,25
81,PMT,P001686,P002644,0 days 00:16:43,-4,27,31
81,PMT,P011944,P012600,0 days 00:16:19,1,32,31
81,PMT,P002644,P011947,0 days 00:16:02,-1,30,31
81,PMT,P010549,P012600,0 days 00:15:52,-1,27,28
81,PMT,P001686,P011966,0 days 00:14:25,-6,25,31
81,PMT,P011947,P011966,0 days 00:14:05,-4,27,31
81,PMT,P002644,P011966,0 days 00:13:42,-4,24,28
81,PMT,P011944,P011947,0 days 00:12:39,6,27,21
81,PMT,P011947,P012600,0 days 00:12:37,1,25,24
81,PMT,P011823,P012600,0 days 00:11:49,-8,23,31
81,PMT,P011823,P011944,0 days 00:11:03,-7,18,25
81,PMT,P010549,P011944,0 days 00:10:51,-2,18,20
81,PMT,P002020,P012600,0 days 00:10:50,8,25,17
81,PMT,P002020,P011944,0 days 00:10:37,6,23,17
81,PMT,P011823,P011947,0 days 00:10:22,0,23,23
81,PMT,P001686,P012600,0 days 00:08:53,-6,11,17
81,PMT,P011943,P011966,0 days 00:07:48,-3,20,23
81,PMT,P002644,P011823,0 days 00:07:45,-4,15,19
81,PMT,P001686,P011944,0 days 00:07:27,1,13,12
81,PMT,P011823,P011943,0 days 00:07:01,-4,15,19
81,PMT,P001686,P010549,0 days 00:06:53,-3,9,12
81,PMT,P011823,P011966,0 days 00:06:42,-2,17,19
81,PMT,P002020,P011823,0 days 00:06:26,-2,13,15
81,PMT,P010549,P011823,0 days 00:06:18,-6,9,15
81,PMT,P002020,P011947,0 days 00:06:17,6,15,9
81,PMT,P011944,P011966,0 days 00:05:56,3,13,10
81,PMT,P011943,P011947,0 days 00:05:43,-2,12,14
81,PMT,P002020,P010549,0 days 00:05:41,2,12,10
81,PMT,P001686,P011943,0 days 00:05:36,-2,12,14
81,PMT,P011966,P012600,0 days 00:05:34,-6,7,13
81,PMT,P002020,P002644,0 days 00:05:32,10,14,4
81,PMT,P010549,P011947,0 days 00:05:14,-1,9,10
81,PMT,P002644,P011943,0 days 00:04:21,0,11,11
81,PMT,P001686,P011823,0 days 00:03:34,-3,7,10
81,PMT,P010549,P011966,0 days 00:02:47,0,3,3
81,PMT,P011943,P012600,0 days 00:02:06,-3,5,8
81,PMT,P002020,P011966,0 days 00:01:21,2,4,2
81,PMT,P011943,P011944,0 days 00:01:15,0,0,0
81,PMT,P010549,P011943,0 days 00:01:14,2,3,1
81,PMT,P002020,P011943,0 days 00:01:08,0,2,2
82,HTA,P007759,P011973,0 days 00:24:21,0,47,47
82,HTA,P010465,P011973,0 days 00:23:29,-3,41,44
82,HTA,P007759,P011991,0 days 00:22:35,6,55,49
82,HTA,P011973,P011991,0 days 00:21:09,-1,42,43
82,HTA,P007759,P010465,0 days 00:19:42,-2,36,38
82,HTA,P006835,P011973,0 days 00:16:46,-6,33,39
82,HTA,P010465,P011991,0 days 00:16:30,-3,31,34
82,HTA,P006835,P007759,0 days 00:16:24,0,40,40
82,HTA,P006835,P011991,0 days 00:16:23,-1,37,38
82,HTA,P004846,P011991,0 days 00:16:05,5,34,29
82,HTA,P010550,P011991,0 days 00:14:29,7,29,22
82,HTA,P006835,P010465,0 days 00:13:57,-8,27,35
82,HTA,P007759,P010550,0 days 00:12:44,7,25,18
82,HTA,P010465,P010550,0 days 00:12:33,7,21,14
82,HTA,P003533,P004846,0 days 00:11:52,7,29,22
82,HTA,P004846,P006835,0 days 00:11:48,-7,21,28
82,HTA,P004846,P010550,0 days 00:11:37,4,26,22
82,HTA,P010550,P011973,0 days 00:11:36,7,21,14
82,HTA,P004846,P007759,0 days 00:11:09,0,29,29
82,HTA,P004846,P011973,0 days 00:10:23,-6,18,24
82,HTA,P004267,P010550,0 days 00:09:22,7,17,10
82,HTA,P003533,P010550,0 days 00:09:07,3,19,16
82,HTA,P004846,P010465,0 days 00:09:01,-4,16,20
82,HTA,P003533,P011991,0 days 00:08:35,7,22,15
82,HTA,P004267,P010465,0 days 00:07:47,7,13,6
82,HTA,P004267,P004846,0 days 00:07:05,5,15,10
82,HTA,P003533,P004267,0 days 00:06:25,4,13,9
82,HTA,P004267,P011973,0 days 00:04:48,5,6,1
82,HTA,P003533,P007759,0 days 00:04:33,5,16,11
82,HTA,P004267,P007759,0 days 00:04:08,4,4,0
82,HTA,P003533,P006835,0 days 00:03:55,0,10,10
82,HTA,P004267,P011991,0 days 00:03:10,4,6,2
82,HTA,P003533,P010465,0 days 00:03:01,2,7,5
82,HTA,P004267,P006835,0 days 00:02:07,0,2,2
82,HTA,P006835,P010550,0 days 00:01:24,-2,2,4
82,BES,P008945,P012622,0 days 00:24:19,-6,45,51
82,BES,P012622,P012647,0 days 00:23:24,0,41,41
82,BES,P008945,P012647,0 days 00:20:13,-1,38,39
82,BES,P009582,P012647,0 days 00:19:10,-5,33,38
82,BES,P011936,P012622,0 days 00:17:01,0,28,28
82,BES,P003783,P012647,0 days 00:16:14,1,30,29
82,BES,P008945,P011936,0 days 00:15:40,-3,24,27
82,BES,P003783,P012622,0 days 00:14:26,2,25,23
82,BES,P009582,P012622,0 days 00:14:25,-8,20,28
82,BES,P011936,P012647,0 days 00:14:02,1,23,22
82,BES,P007914,P009582,0 days 00:13:51,-9,27,36
82,BES,P007914,P012647,0 days 00:13:22,1,30,29
82,BES,P003783,P009582,0 days 00:13:12,-4,23,27
82,BES,P003783,P007914,0 days 00:11:43,-2,24,26
82,BES,P008945,P009582,0 days 00:11:29,-9,17,26
82,BES,P007914,P012622,0 days 00:11:18,-4,22,26
82,BES,P009582,P011936,0 days 00:11:16,-5,19,24
82,BES,P007917,P008945,0 days 00:11:06,1,23,22
82,BES,P007917,P012622,0 days 00:11:06,1,23,22
82,BES,P007914,P008945,0 days 00:10:10,0,25,25
82,BES,P003783,P011936,0 days 00:09:50,-1,20,21
82,BES,P007917,P011936,0 days 00:08:02,5,17,12
82,BES,P003783,P008945,0 days 00:07:25,0,14,14
82,BES,P011379,P011936,0 days 00:06:26,2,17,15
82,BES,P008945,P011379,0 days 00:06:15,1,15,14
82,BES,P007917,P011379,0 days 00:06:15,1,15,14
82,BES,P011379,P012622,0 days 00:06:15,1,15,14
82,BES,P005348,P012647,0 days 00:05:40,1,13,12
82,BES,P005348,P008945,0 days 00:05:28,-1,11,12
82,BES,P005348,P009582,0 days 00:05:27,2,11,9
82,BES,P007914,P011379,0 days 00:05:23,-5,10,15
82,BES,P007914,P011936,0 days 00:05:00,-6,11,17
82,BES,P007917,P012647,0 days 00:04:03,2,8,6
82,BES,P005348,P007914,0 days 00:03:17,0,7,7
82,BES,P003783,P011379,0 days 00:02:47,-2,6,8
82,BES,P009582,P011379,0 days 00:02:47,-2,6,8
82,BES,P007914,P007917,0 days 00:02:36,-3,4,7
82,BES,P005348,P012622,0 days 00:01:50,0,5,5
82,BES,P008945,P011357,0 days 00:01:31,-2,0,2
82,BES,P011357,P011936,0 days 00:01:31,-2,0,2
82,BES,P011357,P012622,0 days 00:01:16,-2,0,2
82,BES,P007917,P011357,0 days 00:00:48,-2,0,2
82,BES,P005348,P011936,0 days 00:00:48,1,1,0
82,BES,P009582,P011357,0 days 00:00:43,0,0,0
82,BES,P005348,P007917,0 days 00:00:28,-1,2,3
82,BES,P003783,P005348,0 days 00:00:27,2,2,0
82,BES,P005348,P011357,0 days 00:00:15,0,0,0
83,LJU,P005969,P012700,0 days 00:28:11,-7,60,67
83,LJU,P003452,P012700,0 days 00:26:02,-10,54,64
83,LJU,P003452,P005969,0 days 00:24:55,-4,52,56
83,LJU,P003452,P007066,0 days 00:24:42,-3,47,50
83,LJU,P002661,P003452,0 days 00:24:05,-7,49,56
83,LJU,P002661,P012700,0 days 00:19:19,-11,44,55
83,LJU,P002661,P005969,0 days 00:18:12,-5,42,47
83,LJU,P002661,P012598,0 days 00:17:41,-4,35,39
83,LJU,P005969,P007066,0 days 00:16:40,-4,34,38
83,LJU,P007066,P012700,0 days 00:15:20,-2,33,35
83,LJU,P003452,P012598,0 days 00:14:35,0,27,27
83,LJU,P002661,P007066,0 days 00:13:54,1,29,28
83,LJU,P002661,P011261,0 days 00:11:59,-8,17,25
83,LJU,P005969,P009392,0 days 00:11:23,-5,19,24
83,LJU,P007066,P009392,0 days 00:11:23,-5,19,24
83,LJU,P003452,P009392,0 days 00:11:23,-5,19,24
83,LJU,P003452,P011261,0 days 00:11:00,-7,17,24
83,LJU,P009392,P012700,0 days 00:10:48,-4,18,22
83,LJU,P011261,P012598,0 days 00:09:59,-5,16,21
83,LJU,P012598,P012700,0 days 00:08:54,-4,22,26
83,LJU,P007066,P012598,0 days 00:08:47,0,13,13
83,LJU,P007066,P011261,0 days 00:08:02,1,13,12
83,LJU,P005969,P012598,0 days 00:07:42,1,19,18
83,LJU,P003042,P012700,0 days 00:06:24,-9,8,17
83,LJU,P003042,P005969,0 days 00:05:54,-7,8,15
83,LJU,P002661,P003042,0 days 00:05:53,-9,7,16
83,LJU,P003042,P003452,0 days 00:04:54,-8,7,15
83,LJU,P011261,P012700,0 days 00:04:28,-9,5,14
83,LJU,P002661,P010594,0 days 00:03:06,-4,8,12
83,LJU,P005969,P010594,0 days 00:03:06,-4,8,12
83,LJU,P010594,P012598,0 days 00:03:06,-4,8,12
83,LJU,P010594,P012700,0 days 00:03:06,-4,8,12
83,LJU,P003042,P011261,0 days 00:02:31,-3,2,5
83,LJU,P005969,P011261,0 days 00:02:01,-1,2,3
83,LJU,P002661,P009392,0 days 00:00:35,-1,1,2
83,PRS,P012608,P012610,0 days 00:25:34,16,59,43
83,PRS,P005793,P012640,0 days 00:17:25,15,45,30
83,PRS,P012609,P012613,0 days 00:16:58,-1,29,30
83,PRS,P005793,P012609,0 days 00:16:17,-5,33,38
83,PRS,P012608,P012609,0 days 00:16:13,7,31,24
83,PRS,P012609,P012610,0 days 00:16:13,7,31,24
83,PRS,P012608,P012613,0 days 00:15:20,7,31,24
83,PRS,P012610,P012613,0 days 00:15:20,7,31,24
83,PRS,P004512,P012608,0 days 00:13:38,5,24,19
83,PRS,P004512,P012610,0 days 00:13:38,5,24,19
83,PRS,P005793,P009556,0 days 00:13:34,0,31,31
83,PRS,P009556,P012609,0 days 00:13:34,0,31,31
83,PRS,P004512,P012609,0 days 00:12:50,5,22,17
83,PRS,P011887,P012609,0 days 00:12:42,4,34,30
83,PRS,P012609,P012640,0 days 00:12:17,9,30,21
83,PRS,P005793,P011887,0 days 00:11:39,4,31,27
83,PRS,P009556,P012640,0 days 00:11:18,6,29,23
83,PRS,P009556,P011887,0 days 00:11:15,3,30,27
83,PRS,P004512,P012613,0 days 00:10:18,9,20,11
83,PRS,P005793,P012608,0 days 00:09:57,4,23,19
83,PRS,P005793,P012610,0 days 00:09:57,4,23,19
83,PRS,P005793,P012613,0 days 00:08:35,-10,13,23
83,PRS,P011887,P012640,0 days 00:08:07,9,25,16
83,PRS,P012608,P012612,0 days 00:08:03,12,29,17
83,PRS,P012610,P012612,0 days 00:08:03,12,29,17
83,PRS,P012608,P012640,0 days 00:07:49,11,21,10
83,PRS,P012610,P012640,0 days 00:07:49,11,21,10
83,PRS,P009556,P012613,0 days 00:07:02,-9,12,21
83,PRS,P011887,P012613,0 days 00:06:34,-7,15,22
83,PRS,P012613,P012640,0 days 00:06:19,-4,11,15
83,PRS,P011887,P012610,0 days 00:05:42,2,18,16
83,PRS,P011887,P012608,0 days 00:05:42,2,18,16
83,PRS,P011887,P012612,0 days 00:04:27,3,16,13
83,PRS,P005793,P012612,0 days 00:04:10,10,15,5
83,PRS,P012612,P012640,0 days 00:03:42,9,13,4
83,PRS,P004512,P005793,0 days 00:02:30,-6,2,8
83,PRS,P012612,P012613,0 days 00:02:10,0,7,7
83,PRS,P012609,P012612,0 days 00:02:04,2,7,5
83,PRS,P009556,P010801,0 days 00:00:52,0,3,3
83,PRS,P010801,P011887,0 days 00:00:52,0,3,3
83,PRS,P010801,P012613,0 days 00:00:52,0,3,3
83,PRS,P010801,P012640,0 days 00:00:52,0,3,3
83,PRS,P004512,P012640,0 days 00:00:50,2,2,0
83,PRS,P004512,P011887,0 days 00:00:48,0,2,2
83,PRS,P009556,P012612,0 days 00:00:09,0,0,0
84,WOL,P012576,P012577,0 days 00:24:57,-3,58,61
84,WOL,P005516,P012577,0 days 00:22:02,-9,44,53
84,WOL,P012576,PLCT,0 days 00:21:25,8,49,41
84,WOL,P005516,P012576,0 days 00:18:51,10,45,35
84,WOL,P006154,P012577,0 days 00:18:38,-12,41,53
84,WOL,P012577,PLCT,0 days 00:17:33,5,43,38
84,WOL,P003212,P012576,0 days 00:16:59,-17,37,54
84,WOL,P005516,P006907,0 days 00:16:12,-7,29,36
84,WOL,P005516,PLCT,0 days 00:16:03,5,35,30
84,WOL,P006907,P012577,0 days 00:15:59,-22,28,50
84,WOL,P006154,P012576,0 days 00:15:39,-10,38,48
84,WOL,P003212,P012577,0 days 00:15:26,-9,39,48
84,WOL,P004645,PLCT,0 days 00:13:55,10,34,24
84,WOL,P004645,P012576,0 days 00:13:52,7,32,25
84,WOL,P005516,P006154,0 days 00:13:49,-3,30,33
84,WOL,P006907,P012576,0 days 00:13:33,-7,29,36
84,WOL,P006154,P006907,0 days 00:13:10,-23,20,43
84,WOL,P003212,PLCT,0 days 00:10:33,-3,24,27
84,WOL,P003212,P004645,0 days 00:09:22,4,26,22
84,WOL,P004645,P012577,0 days 00:09:13,5,24,19
84,WOL,P006907,PLCT,0 days 00:08:55,-3,18,21
84,WOL,P003212,P006154,0 days 00:08:47,-16,21,37
84,WOL,P004229,P012577,0 days 00:08:00,-11,15,26
84,WOL,P004229,P005516,0 days 00:07:45,-14,9,23
84,WOL,P004229,P006907,0 days 00:07:45,-14,9,23
84,WOL,P004645,P005516,0 days 00:07:11,6,14,8
84,WOL,P006154,PLCT,0 days 00:06:49,1,17,16
84,WOL,P004229,P006154,0 days 00:05:30,-8,7,15
84,WOL,P003212,P006907,0 days 00:05:06,-14,9,23
84,WOL,P004645,P006907,0 days 00:04:32,6,10,4
84,WOL,P003212,P005516,0 days 00:04:31,-4,10,14
84,WOL,P004229,PLCT,0 days 00:03:11,-3,8,11
84,WOL,P004645,P006154,0 days 00:02:14,-1,6,7
84,WOL,P004229,P004645,0 days 00:01:37,3,6,3
84,WOL,P003212,P004229,0 days 00:00:56,3,6,3
84,LLI,P005247,P009680,0 days 00:20:44,24,59,35
84,LLI,P006600,P009680,0 days 00:20:06,18,55,37
84,LLI,P005247,P006600,0 days 00:20:03,23,58,35
84,LLI,P005247,P012586,0 days 00:19:08,11,49,38
84,LLI,P006600,P012586,0 days 00:18:35,17,53,36
84,LLI,P006600,P012585,0 days 00:18:14,11,53,42
84,LLI,P009680,P012586,0 days 00:17:16,16,45,29
84,LLI,P005247,P012585,0 days 00:16:24,2,40,38
84,LLI,P012585,P012586,0 days 00:15:29,-4,37,41
84,LLI,P009680,P012585,0 days 00:13:46,9,36,27
84,LLI,P009649,P012586,0 days 00:12:42,0,32,32
84,LLI,P009672,P012586,0 days 00:11:48,-11,25,36
84,LLI,P004773,P012020,0 days 00:11:06,3,24,21
84,LLI,P009649,P009672,0 days 00:10:51,-4,27,31
84,LLI,P004773,P012586,0 days 00:10:49,3,22,19
84,LLI,P012020,P012586,0 days 00:10:29,-12,17,29
84,LLI,P004773,P009649,0 days 00:10:15,-5,19,24
84,LLI,P009649,P012020,0 days 00:09:16,0,17,17
84,LLI,P004773,P009680,0 days 00:09:11,5,20,15
84,LLI,P006600,P009649,0 days 00:08:33,2,28,26
84,LLI,P009672,P012020,0 days 00:08:30,-7,14,21
84,LLI,P009672,P012585,0 days 00:07:59,-6,21,27
84,LLI,P009649,P009680,0 days 00:07:45,2,19,17
84,LLI,P004773,P009672,0 days 00:07:32,-4,16,20
84,LLI,P006600,P009672,0 days 00:06:58,-3,23,26
84,LLI,P004773,P005247,0 days 00:05:44,10,16,6
84,LLI,P009680,P012020,0 days 00:05:37,2,12,10
84,LLI,P004479,P012585,0 days 00:05:16,7,16,9
84,LLI,P004479,P009680,0 days 00:05:16,7,16,9
84,LLI,P004479,P006600,0 days 00:05:16,7,16,9
84,LLI,P004479,P005247,0 days 00:05:16,7,16,9
84,LLI,P005247,P012020,0 days 00:04:51,-5,9,14
84,LLI,P009649,P012585,0 days 00:04:51,1,15,14
84,LLI,P004773,P006600,0 days 00:04:50,2,11,9
84,LLI,P005247,P009672,0 days 00:04:40,-6,10,16
84,LLI,P004773,P008274,0 days 00:04:26,6,12,6
84,LLI,P008274,P009649,0 days 00:04:26,6,12,6
84,LLI,P008274,P012020,0 days 00:03:38,7,9,2
84,LLI,P012020,P012585,0 days 00:03:01,-8,2,10
84,LLI,P005247,P009649,0 days 00:02:46,6,11,5
84,LLI,P008274,P009672,0 days 00:02:29,5,9,4
84,LLI,P008274,P009680,0 days 00:01:57,1,3,2
84,LLI,P009672,P009680,0 days 00:01:14,-4,3,7
84,LLI,P006600,P008274,0 days 00:00:45,-1,3,4
84,LLI,P004773,P012584,0 days 00:00:03,0,0,0
84,LLI,P008274,P012584,0 days 00:00:03,0,0,0
84,LLI,P009649,P012584,0 days 00:00:03,0,0,0
84,LLI,P009672,P012584,0 days 00:00:03,0,0,0
85,VNC,P004381,P012591,0 days 00:24:11,18,59,41
85,VNC,P011909,P011928,0 days 00:18:40,11,41,30
85,VNC,P011928,P012591,0 days 00:17:32,8,37,29
85,VNC,P008052,P011909,0 days 00:17:11,12,38,26
85,VNC,P004381,P011928,0 days 00:17:00,9,39,30
85,VNC,P008052,P012587,0 days 00:16:04,4,40,36
85,VNC,P008052,P012591,0 days 00:14:34,14,38,24
85,VNC,P004381,P008052,0 days 00:14:34,14,38,24
85,VNC,P011909,P012591,0 days 00:14:27,17,37,20
85,VNC,P009400,P011928,0 days 00:14:26,-3,29,32
85,VNC,P009400,P012591,0 days 00:14:15,10,32,22
85,VNC,P004381,P009400,0 days 00:13:20,11,34,23
85,VNC,P000968,P011909,0 days 00:13:03,-5,21,26
85,VNC,P000968,P012587,0 days 00:12:56,2,29,27
85,VNC,P008052,P011928,0 days 00:12:46,8,27,19
85,VNC,P003759,P012591,0 days 00:12:01,1,28,27
85,VNC,P004381,P011909,0 days 00:11:42,19,33,14
85,VNC,P011909,P012587,0 days 00:11:39,-7,19,26
85,VNC,P003759,P004381,0 days 00:10:47,1,26,25
85,VNC,P000968,P008052,0 days 00:10:12,5,25,20
85,VNC,P003759,P012587,0 days 00:10:03,6,29,23
85,VNC,P000968,P011928,0 days 00:09:46,-3,17,20
85,VNC,P003759,P008052,0 days 00:09:12,6,27,21
85,VNC,P009400,P011909,0 days 00:09:01,11,23,12
85,VNC,P011928,P012587,0 days 00:08:15,-1,15,16
85,VNC,P003759,P009400,0 days 00:07:35,3,21,18
85,VNC,P012587,P012591,0 days 00:06:43,-1,17,18
85,VNC,P004381,P012587,0 days 00:05:52,-1,15,16
85,VNC,P000968,P009400,0 days 00:05:34,0,14,14
85,VNC,P003759,P011928,0 days 00:05:25,-2,11,13
85,VNC,P000968,P003759,0 days 00:05:04,3,14,11
85,VNC,P008052,P009400,0 days 00:04:31,13,19,6
85,VNC,P009400,P012587,0 days 00:03:40,2,12,10
85,VNC,P003759,P011909,0 days 00:03:17,-2,4,6
85,VNC,P000968,P012591,0 days 00:02:45,-2,4,6
85,VNC,P004381,P012588,0 days 00:02:15,-2,4,6
85,VNC,P009400,P012588,0 days 00:02:15,-2,4,6
85,VNC,P011928,P012588,0 days 00:02:15,-2,4,6
85,VNC,P012588,P012591,0 days 00:01:16,-1,0,1
85,VNC,P004381,P012493,0 days 00:00:59,-1,4,5
85,VNC,P009400,P012493,0 days 00:00:59,-1,4,5
85,VNC,P011928,P012493,0 days 00:00:59,-1,4,5
85,VNC,P012493,P012588,0 days 00:00:59,-1,4,5
85,HAM,P009663,P012582,0 days 00:21:26,-8,43,51
85,HAM,P011168,P012582,0 days 00:19:19,-13,37,50
85,HAM,P012580,P012582,0 days 00:17:16,-12,32,44
85,HAM,P009663,P010070,0 days 00:16:42,2,41,39
85,HAM,P010070,P012582,0 days 00:15:49,5,40,35
85,HAM,P012580,P012581,0 days 00:14:46,-19,23,42
85,HAM,P011168,P012580,0 days 00:14:42,-20,26,46
85,HAM,P012579,P012582,0 days 00:14:32,-2,33,35
85,HAM,P009663,P012579,0 days 00:13:45,-4,29,33
85,HAM,P011187,P012581,0 days 00:13:34,-1,27,28
85,HAM,P011168,P012581,0 days 00:12:48,-17,20,37
85,HAM,P009663,P011168,0 days 00:12:26,-16,19,35
85,HAM,P012581,P012582,0 days 00:11:20,-8,21,29
85,HAM,P009663,P012580,0 days 00:11:10,-17,14,31
85,HAM,P001990,P012582,0 days 00:11:06,4,25,21
85,HAM,P011168,P011187,0 days 00:10:17,-8,19,27
85,HAM,P011168,P012579,0 days 00:10:15,-8,17,25
85,HAM,P001990,P009663,0 days 00:10:15,-1,21,22
85,HAM,P011187,P012580,0 days 00:10:07,-3,22,25
85,HAM,P010070,P011168,0 days 00:10:05,-6,20,26
85,HAM,P010070,P012579,0 days 00:09:55,-2,23,25
85,HAM,P011187,P012582,0 days 00:09:15,0,22,22
85,HAM,P001990,P012580,0 days 00:06:24,-4,8,12
85,HAM,P001990,P010070,0 days 00:06:02,5,17,12
85,HAM,P012581,P012694,0 days 00:05:27,-5,6,11
85,HAM,P012582,P012648,0 days 00:05:26,1,10,9
85,HAM,P009663,P012648,0 days 00:05:09,1,10,9
85,HAM,P009663,P012581,0 days 00:05:04,-13,4,17
85,HAM,P012579,P012580,0 days 00:04:55,-3,8,11
85,HAM,P001990,P012579,0 days 00:04:53,5,16,11
85,HAM,P011187,P012694,0 days 00:04:49,-3,6,9
85,HAM,P010070,P012648,0 days 00:04:18,4,10,6
85,HAM,P011187,P012648,0 days 00:03:53,1,6,5
85,HAM,P012581,P012648,0 days 00:03:53,1,6,5
85,HAM,P012648,P012694,0 days 00:03:53,1,6,5
85,HAM,P001990,P012648,0 days 00:03:47,0,5,5
85,HAM,P010070,P012580,0 days 00:03:46,0,11,11
85,HAM,P001990,P012581,0 days 00:03:46,-4,4,8
85,HAM,P012648,P012695,0 days 00:03:32,4,10,6
85,HAM,P011168,P012694,0 days 00:02:50,-6,1,7
85,HAM,P011168,P012648,0 days 00:02:17,-2,1,3
85,HAM,P010070,P012581,0 days 00:02:10,-3,4,7
85,HAM,P012580,P012694,0 days 00:02:10,-7,0,7
85,HAM,P001990,P011187,0 days 00:01:54,2,4,2
85,HAM,P012694,P012695,0 days 00:01:53,3,5,2
85,HAM,P011187,P012695,0 days 00:01:53,3,5,2
85,HAM,P012581,P012695,0 days 00:01:53,3,5,2
85,HAM,P009663,P012695,0 days 00:01:39,1,5,4
85,HAM,P010070,P012695,0 days 00:01:39,1,5,4
85,HAM,P012582,P012695,0 days 00:01:39,1,5,4
85,HAM,P010070,P011187,0 days 00:01:30,2,5,3
85,HAM,P001990,P012694,0 days 00:01:20,-3,0,3
85,HAM,P009663,P012694,0 days 00:01:14,-3,0,3
85,HAM,P012580,P012648,0 days 00:01:08,-3,0,3
85,HAM,P012579,P012581,0 days 00:01:07,2,4,2
85,HAM,P012579,P012694,0 days 00:00:36,-1,0,1
85,HAM,P011187,P012579,0 days 00:00:34,1,2,1
85,HAM,P009663,P011187,0 days 00:00:30,2,2,0
85,HAM,P001990,P011168,0 days 00:00:17,0,0,0
86,ULM,P010582,P012604,0 days 00:27:17,-11,50,61
86,ULM,P010106,P010582,0 days 00:24:30,-4,51,55
86,ULM,P005422,P012604,0 days 00:23:58,-4,45,49
86,ULM,P010106,P012604,0 days 00:23:58,-4,49,53
86,ULM,P012603,P012604,0 days 00:23:04,-4,54,58
86,ULM,P005422,P010582,0 days 00:23:03,-1,45,46
86,ULM,P005422,P010106,0 days 00:19:53,1,43,42
86,ULM,P010582,P012603,0 days 00:18:35,-9,41,50
86,ULM,P010106,P012603,0 days 00:17:58,-13,39,52
86,ULM,P011457,P012604,0 days 00:16:29,13,40,27
86,ULM,P005422,P012603,0 days 00:14:53,0,35,35
86,ULM,P012604,P012703,0 days 00:12:27,-3,22,25
86,ULM,P005422,P011457,0 days 00:11:48,1,19,18
86,ULM,P010582,P011457,0 days 00:11:27,5,23,18
86,ULM,P005422,P012703,0 days 00:10:10,-8,13,21
86,ULM,P012603,P012703,0 days 00:10:08,9,26,17
86,ULM,P012603,P012629,0 days 00:10:07,0,27,27
86,ULM,P012629,P012703,0 days 00:09:36,10,27,17
86,ULM,P010106,P011457,0 days 00:09:33,8,23,15
86,ULM,P011457,P012703,0 days 00:09:00,3,19,16
86,ULM,P012604,P012629,0 days 00:08:35,1,24,23
86,ULM,P011457,P012603,0 days 00:07:17,10,25,15
86,ULM,P011457,P012629,0 days 00:07:06,6,19,13
86,ULM,P010582,P012703,0 days 00:06:26,-8,4,12
86,ULM,P005422,P012629,0 days 00:04:34,0,9,9
86,ULM,P011391,P012629,0 days 00:04:23,-3,8,11
86,ULM,P011391,P012703,0 days 00:04:04,3,9,6
86,ULM,P010106,P012629,0 days 00:03:41,-12,7,19
86,ULM,P005422,P011391,0 days 00:03:36,1,7,6
86,ULM,P010106,P012703,0 days 00:03:16,-6,2,8
86,ULM,P011391,P012603,0 days 00:03:11,2,9,7
86,ULM,P010726,P011391,0 days 00:02:24,-5,4,9
86,ULM,P010106,P011391,0 days 00:02:15,-7,4,11
86,ULM,P010106,P010726,0 days 00:01:56,-7,2,9
86,ULM,P010582,P012629,0 days 00:01:55,-7,3,10
86,ULM,P010726,P012603,0 days 00:01:55,-3,4,7
86,ULM,P010726,P012629,0 days 00:01:55,-3,4,7
86,ULM,P011391,P011457,0 days 00:01:32,-2,0,2
86,ULM,P010726,P012703,0 days 00:00:57,0,2,2
86,ULM,P010582,P011391,0 days 00:00:39,3,3,0
86,ULM,P005422,P010726,0 days 00:00:29,-2,0,2
86,BOU,P010718,P011836,0 days 00:21:49,-6,47,53
86,BOU,P010431,P012617,0 days 00:20:47,17,55,38
86,BOU,P010718,P012617,0 days 00:20:19,1,46,45
86,BOU,P011836,P012617,0 days 00:18:28,6,42,36
86,BOU,P011837,P012617,0 days 00:18:15,-1,39,40
86,BOU,P010431,P011836,0 days 00:17:42,7,39,32
86,BOU,P010431,P010718,0 days 00:16:36,11,43,32
86,BOU,P010718,P011837,0 days 00:16:27,-6,30,36
86,BOU,P010431,P011837,0 days 00:15:50,14,46,32
86,BOU,P004525,P010431,0 days 00:12:34,13,39,26
86,BOU,P000498,P011161,0 days 00:12:23,4,31,27
86,BOU,P011836,P011837,0 days 00:12:04,-4,23,27
86,BOU,P004525,P011161,0 days 00:11:19,1,28,27
86,BOU,P004525,P012617,0 days 00:10:56,3,29,26
86,BOU,P000498,P004525,0 days 00:10:42,6,28,22
86,BOU,P004525,P010718,0 days 00:10:38,-1,28,29
86,BOU,P004525,P011837,0 days 00:10:20,9,29,20
86,BOU,P004525,P012628,0 days 00:08:45,5,19,14
86,BOU,P011161,P011836,0 days 00:08:39,-8,14,22
86,BOU,P012619,P012628,0 days 00:08:09,-2,13,15
86,BOU,P010718,P011161,0 days 00:07:45,-11,11,22
86,BOU,P011161,P011837,0 days 00:07:34,-2,16,18
86,BOU,P004525,P011836,0 days 00:07:30,-1,21,22
86,BOU,P000498,P012628,0 days 00:07:03,-2,13,15
86,BOU,P000498,P011836,0 days 00:06:37,-11,11,22
86,BOU,P000498,P012619,0 days 00:06:24,-5,10,15
86,BOU,P011836,P012619,0 days 00:06:18,0,9,9
86,BOU,P012617,P012628,0 days 00:06:03,4,12,8
86,BOU,P011161,P012619,0 days 00:05:38,1,10,9
86,BOU,P011161,P012628,0 days 00:05:30,4,13,9
86,BOU,P000498,P010718,0 days 00:05:06,-9,8,17
86,BOU,P010431,P012628,0 days 00:04:58,6,12,6
86,BOU,P011837,P012628,0 days 00:04:57,4,12,8
86,BOU,P011836,P012628,0 days 00:04:21,-3,6,9
86,BOU,P000498,P011837,0 days 00:04:09,6,13,7
86,BOU,P010431,P011161,0 days 00:04:07,3,10,7
86,BOU,P004525,P012619,0 days 00:03:48,1,7,6
86,BOU,P010431,P012619,0 days 00:03:42,6,6,0
86,BOU,P010718,P012619,0 days 00:03:30,-3,3,6
86,BOU,P011161,P012617,0 days 00:03:25,-8,3,11
86,BOU,P000498,P010431,0 days 00:03:20,3,10,7
86,BOU,P012617,P012619,0 days 00:02:55,6,6,0
86,BOU,P010718,P012628,0 days 00:02:38,-8,0,8
87,TRN,P009903,P012595,0 days 00:22:24,3,37,34
87,TRN,P005738,P012597,0 days 00:22:00,8,41,33
87,TRN,P005738,P012595,0 days 00:17:32,2,32,30
87,TRN,P012595,P012597,0 days 00:17:19,6,33,27
87,TRN,P009903,P012597,0 days 00:16:54,6,31,25
87,TRN,P005738,P009903,0 days 00:16:14,4,30,26
87,TRN,P006382,P012597,0 days 00:15:53,4,31,27
87,TRN,P012593,P012596,0 days 00:15:25,3,30,27
87,TRN,P005738,P006382,0 days 00:15:22,-3,26,29
87,TRN,P001479,P012593,0 days 00:15:07,4,27,23
87,TRN,P001479,P007828,0 days 00:14:23,1,23,22
87,TRN,P012596,P012597,0 days 00:14:19,-1,28,29
87,TRN,P012593,P012597,0 days 00:13:58,1,28,27
87,TRN,P007828,P012595,0 days 00:13:36,7,24,17
87,TRN,P007828,P012593,0 days 00:13:03,4,22,18
87,TRN,P007828,P012597,0 days 00:12:11,3,26,23
87,TRN,P006382,P009903,0 days 00:10:14,-4,17,21
87,TRN,P007828,P009903,0 days 00:09:54,7,18,11
87,TRN,P006382,P012593,0 days 00:09:38,-8,14,22
87,TRN,P007828,P012596,0 days 00:09:31,0,18,18
87,TRN,P001479,P012596,0 days 00:09:24,4,21,17
87,TRN,P006382,P012595,0 days 00:09:21,-2,17,19
87,TRN,P001479,P012597,0 days 00:09:13,-3,18,21
87,TRN,P012593,P012595,0 days 00:08:51,-1,12,13
87,TRN,P001479,P012595,0 days 00:08:34,1,11,10
87,TRN,P005738,P012593,0 days 00:07:38,-6,11,17
87,TRN,P009903,P012593,0 days 00:07:20,-5,8,13
87,TRN,P005738,P012596,0 days 00:07:19,-3,11,14
87,TRN,P006382,P012596,0 days 00:07:12,1,14,13
87,TRN,P001479,P009903,0 days 00:07:03,-3,7,10
87,TRN,P005738,P007828,0 days 00:05:02,6,13,7
87,TRN,P012595,P012596,0 days 00:03:42,0,6,6
87,TRN,P005738,P012687,0 days 00:03:05,-4,0,4
87,TRN,P009903,P012687,0 days 00:03:05,-4,0,4
87,TRN,P012595,P012687,0 days 00:03:05,-4,0,4
87,TRN,P012597,P012687,0 days 00:03:05,-4,0,4
87,TRN,P001479,P006382,0 days 00:02:04,0,5,5
87,ARI,P003240,P012716,0 days 00:30:41,-4,54,58
87,ARI,P003240,P012707,0 days 00:23:22,-2,38,40
87,ARI,P012707,P012716,0 days 00:23:20,3,41,38
87,ARI,P002867,P003240,0 days 00:17:58,-4,36,40
87,ARI,P002867,P012716,0 days 00:17:56,1,39,38
87,ARI,P003240,P012702,0 days 00:16:52,8,37,29
87,ARI,P012702,P012716,0 days 00:16:12,6,35,29
87,ARI,P002867,P012717,0 days 00:15:36,-5,21,26
87,ARI,P002867,P012707,0 days 00:13:50,0,25,25
87,ARI,P002867,P012722,0 days 00:12:50,0,21,21
87,ARI,P012717,P012722,0 days 00:12:35,0,19,19
87,ARI,P003240,P012616,0 days 00:12:07,-8,12,20
87,ARI,P012616,P012716,0 days 00:12:07,-8,12,20
87,ARI,P012616,P012707,0 days 00:12:07,-8,12,20
87,ARI,P012702,P012707,0 days 00:11:41,6,25,19
87,ARI,P012707,P012760,0 days 00:09:40,-8,9,17
87,ARI,P003240,P012760,0 days 00:09:40,-8,9,17
87,ARI,P012716,P012760,0 days 00:09:40,-8,9,17
87,ARI,P003240,P012717,0 days 00:09:21,-7,12,19
87,ARI,P002867,P012702,0 days 00:09:20,0,21,21
87,ARI,P012716,P012717,0 days 00:09:19,-2,15,17
87,ARI,P012707,P012717,0 days 00:09:19,2,13,11
87,ARI,P012707,P012722,0 days 00:08:16,2,13,11
87,ARI,P012716,P012722,0 days 00:07:51,3,17,14
87,ARI,P012616,P012760,0 days 00:07:37,-6,6,12
87,ARI,P002867,P010387,0 days 00:07:19,2,14,12
87,ARI,P003240,P012722,0 days 00:07:13,-4,12,16
87,ARI,P010387,P012702,0 days 00:04:44,3,12,9
87,ARI,P012616,P012702,0 days 00:04:30,-2,6,8
87,ARI,P010387,P012716,0 days 00:04:06,5,12,7
87,ARI,P003240,P010387,0 days 00:04:06,5,12,7
87,ARI,P010177,P012702,0 days 00:03:40,8,10,2
87,ARI,P010177,P012707,0 days 00:03:40,8,10,2
87,ARI,P010177,P012716,0 days 00:03:40,8,10,2
87,ARI,P003240,P010177,0 days 00:03:40,8,10,2
87,ARI,P010387,P012707,0 days 00:03:13,-3,2,5
87,ARI,P010387,P012717,0 days 00:03:13,-3,2,5
87,ARI,P012702,P012717,0 days 00:03:01,-5,2,7
87,ARI,P010387,P012722,0 days 00:02:35,-1,2,3
87,ARI,P002867,P012760,0 days 00:02:03,-2,3,5
88,CAN,P001607,P004160,0 days 00:22:10,23,58,35
88,CAN,P004160,P007644,0 days 00:19:06,19,51,32
88,CAN,P001607,P007644,0 days 00:17:09,20,49,29
88,CAN,P003425,P008121,0 days 00:15:35,4,34,30
88,CAN,P003425,P003637,0 days 00:15:23,5,37,32
88,CAN,P007644,P010385,0 days 00:15:13,18,42,24
88,CAN,P003637,P008121,0 days 00:15:10,4,34,30
88,CAN,P009864,P010452,0 days 00:14:36,8,33,25
88,CAN,P003637,P010452,0 days 00:13:36,8,34,26
88,CAN,P008121,P010452,0 days 00:13:36,8,34,26
88,CAN,P004160,P010385,0 days 00:13:23,19,39,20
88,CAN,P004160,P005005,0 days 00:13:22,15,33,18
88,CAN,P003425,P010452,0 days 00:13:06,8,34,26
88,CAN,P008121,P009864,0 days 00:12:28,4,29,25
88,CAN,P003637,P009864,0 days 00:12:28,4,29,25
88,CAN,P001607,P005005,0 days 00:12:20,16,31,15
88,CAN,P003425,P009864,0 days 00:11:58,4,29,25
88,CAN,P005005,P007644,0 days 00:11:30,14,32,18
88,CAN,P001607,P010385,0 days 00:11:26,20,37,17
88,CAN,P005005,P010385,0 days 00:09:36,17,30,13
88,CAN,P001607,P009864,0 days 00:09:00,6,17,11
88,CAN,P004160,P009864,0 days 00:08:30,6,17,11
88,CAN,P004160,P007560,0 days 00:07:36,0,17,17
88,CAN,P001607,P007560,0 days 00:07:19,3,17,14
88,CAN,P008121,P010385,0 days 00:06:08,4,15,11
88,CAN,P007560,P007644,0 days 00:05:10,-1,12,13
88,CAN,P003425,P010385,0 days 00:05:05,3,10,7
88,CAN,P007644,P008121,0 days 00:05:00,0,10,10
88,CAN,P001607,P010484,0 days 00:04:40,-2,9,11
88,CAN,P004160,P010484,0 days 00:04:40,-2,9,11
88,CAN,P007560,P010484,0 days 00:04:40,-2,9,11
88,CAN,P005005,P009864,0 days 00:04:29,-1,6,7
88,CAN,P007560,P009864,0 days 00:04:01,7,11,4
88,CAN,P003425,P007644,0 days 00:03:57,-1,5,6
88,CAN,P007644,P009864,0 days 00:03:56,1,8,7
88,CAN,P004160,P008121,0 days 00:03:26,4,10,6
88,CAN,P003637,P010385,0 days 00:03:25,1,8,7
88,CAN,P001607,P010452,0 days 00:03:05,2,4,2
88,CAN,P001607,P008121,0 days 00:03:01,4,10,6
88,CAN,P005005,P010452,0 days 00:02:35,2,4,2
88,CAN,P004160,P010452,0 days 00:02:35,2,4,2
88,CAN,P009864,P010484,0 days 00:02:26,1,5,4
88,CAN,P003637,P007644,0 days 00:02:17,-3,3,6
88,CAN,P007644,P010484,0 days 00:02:14,-3,4,7
88,CAN,P003425,P004160,0 days 00:01:40,2,2,0
88,CAN,P010385,P010452,0 days 00:01:35,2,5,3
88,CAN,P003425,P005005,0 days 00:01:28,3,5,2
88,CAN,P007560,P010385,0 days 00:01:21,-4,2,6
88,CAN,P003637,P005005,0 days 00:00:43,1,3,2
88,CAN,P001607,P003637,0 days 00:00:30,0,0,0
88,CAN,P005005,P007560,0 days 00:00:17,-3,0,3
88,BUD,P004397,P010248,0 days 00:21:30,4,43,39
88,BUD,P010248,P012606,0 days 00:19:03,-4,39,43
88,BUD,P004397,P012606,0 days 00:16:47,3,36,33
88,BUD,P002740,P010248,0 days 00:15:38,1,37,36
88,BUD,P002740,P012606,0 days 00:14:26,-3,31,34
88,BUD,P004945,P007398,0 days 00:14:14,-9,23,32
88,BUD,P004945,P010248,0 days 00:14:07,-11,22,33
88,BUD,P007398,P010248,0 days 00:13:35,-4,24,28
88,BUD,P002740,P006566,0 days 00:13:16,-14,22,36
88,BUD,P007398,P012605,0 days 00:12:38,-9,19,28
88,BUD,P006566,P010248,0 days 00:12:27,-7,22,29
88,BUD,P002740,P004397,0 days 00:12:00,6,28,22
88,BUD,P004945,P012605,0 days 00:11:27,-7,17,24
88,BUD,P006566,P012606,0 days 00:11:15,-11,16,27
88,BUD,P010248,P012605,0 days 00:11:01,-5,18,23
88,BUD,P004397,P004945,0 days 00:10:38,-2,20,22
88,BUD,P011935,P012605,0 days 00:10:29,-13,18,31
88,BUD,P004397,P007398,0 days 00:10:08,0,19,19
88,BUD,P010432,P011935,0 days 00:10:04,-12,14,26
88,BUD,P010432,P012605,0 days 00:09:09,-11,14,25
88,BUD,P004397,P006566,0 days 00:08:47,3,16,13
88,BUD,P002740,P012605,0 days 00:08:43,-9,15,24
88,BUD,P006566,P011935,0 days 00:08:25,-19,10,29
88,BUD,P004945,P012606,0 days 00:07:59,-7,15,22
88,BUD,P007398,P012606,0 days 00:07:35,-3,17,20
88,BUD,P002740,P011935,0 days 00:07:16,-13,10,23
88,BUD,P007398,P010432,0 days 00:06:38,-8,12,20
88,BUD,P004945,P011935,0 days 00:06:28,-9,10,19
88,BUD,P004397,P012605,0 days 00:06:10,2,10,8
88,BUD,P006566,P012605,0 days 00:06:05,-8,10,18
88,BUD,P002740,P010432,0 days 00:06:04,-14,6,20
88,BUD,P002740,P007398,0 days 00:05:59,-3,13,16
88,BUD,P004945,P010432,0 days 00:05:19,-3,10,13
88,BUD,P007398,P011935,0 days 00:05:19,-3,10,13
88,BUD,P006566,P010432,0 days 00:04:53,-12,4,16
88,BUD,P007398,P009214,0 days 00:04:38,-6,7,13
88,BUD,P004945,P006566,0 days 00:04:04,-5,4,9
88,BUD,P010248,P011935,0 days 00:03:40,-10,6,16
88,BUD,P009214,P012605,0 days 00:03:31,-5,4,9
88,BUD,P009214,P010248,0 days 00:03:27,-4,5,9
88,BUD,P011935,P012606,0 days 00:03:15,-9,2,11
88,BUD,P004945,P009214,0 days 00:02:20,-3,2,5
88,BUD,P002740,P009214,0 days 00:02:18,-3,5,8
88,BUD,P010432,P012606,0 days 00:02:14,-6,2,8
88,BUD,P012605,P012606,0 days 00:01:27,1,3,2
88,BUD,P009214,P010432,0 days 00:01:11,-2,2,4
88,BUD,P002740,P004945,0 days 00:01:08,0,5,5
88,BUD,P009214,P012606,0 days 00:01:07,-1,3,4
88,BUD,P006566,P007398,0 days 00:00:08,-3,0,3
89,CLU,P004862,P010569,0 days 00:25:58,14,79,65
89,CLU,P010569,P011797,0 days 00:25:04,16,72,56
89,CLU,P011801,P012698,0 days 00:22:43,-4,55,59
89,CLU,P005373,P010569,0 days 00:20:33,10,56,46
89,CLU,P004862,P011797,0 days 00:19:55,9,59,50
89,CLU,P005113,P011801,0 days 00:19:43,-2,47,49
89,CLU,P004862,P005373,0 days 00:18:34,10,52,42
89,CLU,P005373,P011797,0 days 00:18:18,9,50,41
89,CLU,P010569,P011801,0 days 00:17:44,12,56,44
89,CLU,P005113,P012698,0 days 00:17:31,0,43,43
89,CLU,P010569,P012698,0 days 00:16:29,7,51,44
89,CLU,P004862,P011801,0 days 00:14:55,-3,47,50
89,CLU,P004862,P012698,0 days 00:14:14,-3,44,47
89,CLU,P005714,P011801,0 days 00:13:54,-11,30,41
89,CLU,P010569,P012621,0 days 00:12:30,7,28,21
89,CLU,P005714,P012698,0 days 00:12:23,-8,26,34
89,CLU,P004862,P012621,0 days 00:11:44,5,26,21
89,CLU,P005113,P005714,0 days 00:11:44,-13,20,33
89,CLU,P011797,P012698,0 days 00:11:22,6,34,28
89,CLU,P011797,P011801,0 days 00:11:18,7,38,31
89,CLU,P011797,P012621,0 days 00:10:41,7,26,19
89,CLU,P005113,P010569,0 days 00:10:13,15,37,22
89,CLU,P005373,P012621,0 days 00:09:59,5,21,16
89,CLU,P011801,P012620,0 days 00:09:12,-2,16,18
89,CLU,P005113,P012620,0 days 00:09:12,-2,16,18
89,CLU,P004862,P005113,0 days 00:08:57,-1,29,30
89,CLU,P005714,P012620,0 days 00:08:07,-4,14,18
89,CLU,P005373,P011801,0 days 00:07:41,5,25,20
89,CLU,P012620,P012698,0 days 00:07:07,-4,10,14
89,CLU,P005113,P011797,0 days 00:06:56,8,26,18
89,CLU,P005373,P012698,0 days 00:06:43,-2,17,19
89,CLU,P004862,P005714,0 days 00:05:47,-7,16,23
89,CLU,P005113,P012621,0 days 00:03:08,0,7,7
89,CLU,P011801,P012621,0 days 00:02:26,-2,2,4
89,CLU,P005714,P010569,0 days 00:01:44,1,7,6
89,CLU,P012620,P012621,0 days 00:01:23,0,2,2
89,CLU,P005714,P011797,0 days 00:01:20,0,7,7
89,CLU,P010569,P012620,0 days 00:01:05,2,2,0
89,CLU,P011797,P012620,0 days 00:00:42,2,4,2
89,CLU,P005714,P012621,0 days 00:00:37,-2,0,2
89,CLU,P005113,P005373,0 days 00:00:24,3,3,0
89,LKB,P002012,PLXI,0 days 00:31:15,-4,77,81
89,LKB,P002012,P007029,0 days 00:28:17,9,83,74
89,LKB,P007029,PLXI,0 days 00:26:48,2,77,75
89,LKB,P007029,P010461,0 days 00:26:07,5,69,64
89,LKB,P002012,P010461,0 days 00:22:45,10,67,57
89,LKB,P005521,P007029,0 days 00:22:12,6,68,62
89,LKB,P005521,PLXI,0 days 00:20:42,-13,54,67
89,LKB,P010461,PLXI,0 days 00:20:34,4,57,53
89,LKB,P008856,PLXI,0 days 00:19:30,-13,40,53
89,LKB,P002012,P005521,0 days 00:19:23,-1,54,55
89,LKB,P002012,P008856,0 days 00:18:24,-9,36,45
89,LKB,P007029,P008856,0 days 00:15:51,-6,38,44
89,LKB,P005521,P010190,0 days 00:14:52,-1,35,36
89,LKB,P005521,P010461,0 days 00:14:32,2,43,41
89,LKB,P004868,P005521,0 days 00:13:55,-11,25,36
89,LKB,P004868,PLXI,0 days 00:12:29,-17,20,37
89,LKB,P008856,P010461,0 days 00:11:12,0,24,24
89,LKB,P007029,P010190,0 days 00:10:57,7,29,22
89,LKB,P005521,P006901,0 days 00:10:46,-5,24,29
89,LKB,P002012,P004868,0 days 00:09:41,-12,14,26
89,LKB,P006901,P010190,0 days 00:09:40,-1,20,21
89,LKB,P004868,P010190,0 days 00:08:36,-2,20,22
89,LKB,P006901,P007029,0 days 00:08:22,-3,18,21
89,LKB,P004868,P007029,0 days 00:08:02,4,22,18
89,LKB,P010190,P010461,0 days 00:07:08,-5,14,19
89,LKB,P004868,P006901,0 days 00:06:18,4,18,14
89,LKB,P004868,P008856,0 days 00:06:07,-7,9,16
89,LKB,P005521,P008856,0 days 00:05:50,-13,9,22
89,LKB,P010190,PLXI,0 days 00:05:48,-5,13,18
89,LKB,P002012,P010190,0 days 00:05:35,3,17,14
89,LKB,P006901,PLXI,0 days 00:03:30,-6,10,16
89,LKB,P006901,P010461,0 days 00:03:22,-5,2,7
89,LKB,P006901,P008856,0 days 00:01:06,-4,4,8
89,LKB,P004868,P010461,0 days 00:00:24,-3,0,3
90,TTK,P011239,P011925,0 days 00:23:39,0,45,45
90,TTK,P005000,P011925,0 days 00:22:18,-14,32,46
90,TTK,P006693,P011239,0 days 00:21:16,10,41,31
90,TTK,P006693,P011925,0 days 00:21:15,6,42,36
90,TTK,P004801,P011239,0 days 00:20:15,-11,27,38
90,TTK,P011925,P012697,0 days 00:20:08,2,45,43
90,TTK,P004801,P011925,0 days 00:18:51,-9,26,35
90,TTK,P011239,P012697,0 days 00:18:36,-1,40,41
90,TTK,P004801,P006693,0 days 00:17:53,-4,24,28
90,TTK,P005000,P006693,0 days 00:15:34,-2,23,25
90,TTK,P005000,P011239,0 days 00:14:33,-5,21,26
90,TTK,P011834,P012697,0 days 00:14:31,-20,21,41
90,TTK,P011239,P011834,0 days 00:14:02,-9,22,31
90,TTK,P004801,P011834,0 days 00:12:01,-3,20,23
90,TTK,P004801,P005000,0 days 00:11:52,-12,11,23
90,TTK,P011834,P011925,0 days 00:11:20,-11,19,30
90,TTK,P005000,P012697,0 days 00:11:02,-3,21,24
90,TTK,P006693,P012697,0 days 00:09:24,12,26,14
90,TTK,P004801,P012697,0 days 00:08:59,-10,12,22
90,TTK,P000497,P004801,0 days 00:07:24,2,15,13
90,TTK,P005000,P011834,0 days 00:06:08,-11,9,20
90,TTK,P000497,P011834,0 days 00:05:37,-1,10,11
90,TTK,P000497,P011239,0 days 00:05:37,-1,10,11
90,TTK,P000497,P006693,0 days 00:05:25,9,13,4
90,TTK,P006693,P011834,0 days 00:04:50,4,8,4
90,TTK,P009845,P011925,0 days 00:04:49,0,9,9
90,TTK,P006693,P009845,0 days 00:04:49,0,9,9
90,TTK,P004801,P009845,0 days 00:04:49,0,9,9
90,TTK,P005685,P011925,0 days 00:04:43,-6,7,13
90,TTK,P005685,P012697,0 days 00:04:43,-6,7,13
90,TTK,P005000,P005685,0 days 00:04:43,-6,7,13
90,TTK,P005685,P011834,0 days 00:04:07,-5,7,12
90,TTK,P011975,P012697,0 days 00:03:54,5,14,9
90,TTK,P011925,P011975,0 days 00:03:54,5,14,9
90,TTK,P011239,P011975,0 days 00:03:54,5,14,9
90,TTK,P006693,P011975,0 days 00:03:54,5,14,9
90,TTK,P005000,P009845,0 days 00:03:02,-3,4,7
90,TTK,P000497,P012697,0 days 00:01:59,-7,2,9
90,TTK,P000497,P009845,0 days 00:01:47,3,5,2
90,TTK,P000497,P011925,0 days 00:01:47,3,5,2
90,TTK,P004801,P005685,0 days 00:00:36,-1,0,1
90,WRO,P005531,P012699,0 days 00:30:19,5,54,49
90,WRO,P005531,P011900,0 days 00:28:51,10,60,50
90,WRO,P011900,P012699,0 days 00:26:35,-5,48,53
90,WRO,P003034,P011900,0 days 00:20:35,14,51,37
90,WRO,P003034,P005531,0 days 00:19:34,21,50,29
90,WRO,P011901,P012699,0 days 00:18:40,10,43,33
90,WRO,P009896,P012699,0 days 00:17:10,-8,24,32
90,WRO,P005531,P011901,0 days 00:16:56,19,41,22
90,WRO,P003034,P012699,0 days 00:15:56,7,35,28
90,WRO,P005531,P009896,0 days 00:15:48,-7,21,28
90,WRO,P011900,P011901,0 days 00:15:39,9,39,30
90,WRO,P003034,P011901,0 days 00:14:49,20,40,20
90,WRO,P009896,P011900,0 days 00:12:34,-9,18,27
90,WRO,P007472,P012699,0 days 00:11:01,-8,16,24
90,WRO,P005531,P012736,0 days 00:10:52,-1,15,16
90,WRO,P005531,P007472,0 days 00:10:40,-2,17,19
90,WRO,P011900,P012736,0 days 00:09:56,0,15,15
90,WRO,P012699,P012736,0 days 00:09:51,-3,11,14
90,WRO,P003034,P007472,0 days 00:09:15,-3,14,17
90,WRO,P007472,P011900,0 days 00:09:03,-7,14,21
90,WRO,P009896,P012736,0 days 00:08:44,-5,9,14
90,WRO,P007472,P011901,0 days 00:08:41,4,18,14
90,WRO,P009896,P011901,0 days 00:06:35,-6,10,16
90,WRO,P005531,P012749,0 days 00:06:09,7,16,9
90,WRO,P011900,P012749,0 days 00:05:33,3,17,14
90,WRO,P003034,P011902,0 days 00:04:30,5,14,9
90,WRO,P011900,P011902,0 days 00:04:30,5,14,9
90,WRO,P007472,P009896,0 days 00:04:30,-1,9,10
90,WRO,P003034,P012749,0 days 00:03:59,8,14,6
90,WRO,P012699,P012749,0 days 00:03:32,-2,5,7
90,WRO,P009896,P012749,0 days 00:03:23,-4,5,9
90,WRO,P005531,P011902,0 days 00:02:59,4,10,6
90,WRO,P011902,P012749,0 days 00:02:59,4,10,6
90,WRO,P011901,P012749,0 days 00:02:45,-1,5,6
90,WRO,P003034,P012736,0 days 00:01:58,4,6,2
90,WRO,P012736,P012749,0 days 00:01:48,1,4,3
90,WRO,P011901,P011902,0 days 00:01:31,1,4,3
90,WRO,P007472,P011902,0 days 00:01:31,1,4,3
90,WRO,P007472,P012736,0 days 00:00:19,0,0,0
91,HAM,P009663,P012580,0 days 00:19:08,-4,34,38
91,HAM,P011168,P012580,0 days 00:16:47,-15,24,39
91,HAM,P009663,P011168,0 days 00:15:16,-11,23,34
91,HAM,P011187,P012579,0 days 00:15:07,-1,40,41
91,HAM,P011168,P012582,0 days 00:14:45,-12,22,34
91,HAM,P012580,P012581,0 days 00:14:42,-3,27,30
91,HAM,P001990,P012581,0 days 00:13:54,5,36,31
91,HAM,P012580,P012582,0 days 00:13:52,-13,18,31
91,HAM,P001990,P010070,0 days 00:13:03,-5,30,35
91,HAM,P012581,P012582,0 days 00:12:53,1,27,26
91,HAM,P011187,P012581,0 days 00:12:40,-4,30,34
91,HAM,P009663,P010070,0 days 00:12:06,4,29,25
91,HAM,P001990,P011187,0 days 00:11:36,-6,28,34
91,HAM,P010070,P012579,0 days 00:11:23,-3,28,31
91,HAM,P009663,P012582,0 days 00:11:22,-11,15,26
91,HAM,P009663,P012581,0 days 00:10:57,3,22,19
91,HAM,P010070,P012580,0 days 00:10:42,5,25,20
91,HAM,P011168,P012579,0 days 00:10:00,2,23,21
91,HAM,P001990,P012579,0 days 00:09:49,-6,25,31
91,HAM,P011168,P012581,0 days 00:09:43,-6,16,22
91,HAM,P010070,P012581,0 days 00:09:29,2,23,21
91,HAM,P012579,P012581,0 days 00:08:55,2,25,23
91,HAM,P010070,P011187,0 days 00:08:16,-4,20,24
91,HAM,P001990,P012580,0 days 00:08:15,2,18,16
91,HAM,P011187,P012582,0 days 00:07:48,2,20,18
91,HAM,P010070,P011168,0 days 00:07:19,5,19,14
91,HAM,P011168,P011187,0 days 00:07:16,-1,17,18
91,HAM,P012579,P012582,0 days 00:06:06,1,17,16
91,HAM,P011187,P012580,0 days 00:05:54,-9,8,17
91,HAM,P001990,P009663,0 days 00:05:52,4,15,11
91,HAM,P012579,P012648,0 days 00:04:58,-8,11,19
91,HAM,P010070,P012648,0 days 00:04:58,-8,11,19
91,HAM,P012579,P012580,0 days 00:04:51,-3,7,10
91,HAM,P009663,P012579,0 days 00:04:42,-3,8,11
91,HAM,P011168,P012694,0 days 00:04:40,-1,10,11
91,HAM,P001990,P012582,0 days 00:04:25,3,13,10
91,HAM,P009663,P012648,0 days 00:04:22,-9,6,15
91,HAM,P011168,P012648,0 days 00:04:22,-9,6,15
91,HAM,P011187,P012694,0 days 00:03:53,0,10,10
91,HAM,P012580,P012694,0 days 00:03:35,-6,5,11
91,HAM,P012579,P012694,0 days 00:03:25,3,8,5
91,HAM,P010070,P012582,0 days 00:03:07,-1,6,7
91,HAM,P011187,P012648,0 days 00:02:58,-5,7,12
91,HAM,P001990,P012648,0 days 00:02:58,-5,7,12
91,HAM,P012580,P012648,0 days 00:02:22,-6,2,8
91,HAM,P012582,P012648,0 days 00:02:22,-6,2,8
91,HAM,P012581,P012694,0 days 00:01:15,-4,2,6
91,HAM,P010070,P012694,0 days 00:01:05,5,5,0
91,HAM,P009663,P012694,0 days 00:00:47,-1,0,1
91,PMT,P010549,P012600,0 days 00:19:32,20,51,31
91,PMT,P001686,P011944,0 days 00:17:05,4,42,38
91,PMT,P002644,P012600,0 days 00:16:36,9,47,38
91,PMT,P011966,P012600,0 days 00:16:15,9,39,30
91,PMT,P001686,P002644,0 days 00:15:48,5,46,41
91,PMT,P011823,P011966,0 days 00:15:37,2,31,29
91,PMT,P011944,P012600,0 days 00:15:27,12,39,27
91,PMT,P001686,P012600,0 days 00:15:09,12,43,31
91,PMT,P002644,P011944,0 days 00:14:35,5,40,35
91,PMT,P001686,P011966,0 days 00:14:01,-8,29,37
91,PMT,P001686,P011942,0 days 00:13:51,-8,33,41
91,PMT,P002020,P012600,0 days 00:12:54,11,31,20
91,PMT,P002644,P010549,0 days 00:12:45,9,35,26
91,PMT,P002020,P010549,0 days 00:12:20,9,29,20
91,PMT,P011823,P012600,0 days 00:11:27,14,27,13
91,PMT,P002020,P011966,0 days 00:10:31,9,25,16
91,PMT,P011944,P011966,0 days 00:10:24,-5,22,27
91,PMT,P010549,P011966,0 days 00:10:21,4,22,18
91,PMT,P001686,P011823,0 days 00:10:18,-2,18,20
91,PMT,P001686,P010549,0 days 00:09:44,9,26,17
91,PMT,P010549,P011823,0 days 00:09:19,9,20,11
91,PMT,P002644,P011966,0 days 00:08:55,-1,23,24
91,PMT,P011942,P011966,0 days 00:08:49,-6,18,24
91,PMT,P002644,P011942,0 days 00:08:29,-1,26,27
91,PMT,P001686,P011947,0 days 00:08:28,0,19,19
91,PMT,P010549,P011944,0 days 00:07:53,14,22,8
91,PMT,P002020,P011823,0 days 00:07:31,9,18,9
91,PMT,P011823,P011944,0 days 00:07:27,3,14,11
91,PMT,P011942,P011944,0 days 00:06:39,-7,15,22
91,PMT,P011942,P011947,0 days 00:06:30,-4,12,16
91,PMT,P002020,P002644,0 days 00:06:23,2,15,13
91,PMT,P011823,P011942,0 days 00:06:22,-7,9,16
91,PMT,P002644,P011947,0 days 00:05:13,0,12,12
91,PMT,P002020,P011944,0 days 00:04:57,4,12,8
91,PMT,P010549,P011942,0 days 00:04:50,0,13,13
91,PMT,P011944,P011947,0 days 00:03:41,2,10,8
91,PMT,P011947,P011966,0 days 00:03:15,0,7,7
91,PMT,P011823,P011947,0 days 00:03:15,0,7,7
91,PMT,P011942,P012600,0 days 00:02:54,1,12,11
91,PMT,P011947,P012600,0 days 00:01:58,4,7,3
91,PMT,P010549,P011947,0 days 00:01:32,-2,2,4
91,PMT,P002020,P011942,0 days 00:01:00,0,2,2
92,VNC,P004381,P012591,0 days 00:23:27,8,65,57
92,VNC,P004381,P011928,0 days 00:21:47,5,65,60
92,VNC,P011928,P012591,0 days 00:21:05,21,70,49
92,VNC,P004381,P008052,0 days 00:17:45,-3,44,47
92,VNC,P008052,P012591,0 days 00:17:32,2,47,45
92,VNC,P004381,P011909,0 days 00:16:15,-3,34,37
92,VNC,P008052,P011928,0 days 00:15:31,6,49,43
92,VNC,P011909,P012591,0 days 00:14:42,1,34,33
92,VNC,P011928,P012590,0 days 00:14:35,-15,28,43
92,VNC,P009400,P011928,0 days 00:14:26,-5,30,35
92,VNC,P000968,P009400,0 days 00:13:24,1,26,25
92,VNC,P009400,P012590,0 days 00:13:20,-13,21,34
92,VNC,P011909,P011928,0 days 00:12:14,3,34,31
92,VNC,P004117,P009400,0 days 00:12:01,-4,21,25
92,VNC,P004117,P012590,0 days 00:11:55,-10,19,29
92,VNC,P000968,P012590,0 days 00:11:44,-4,21,25
92,VNC,P008052,P012590,0 days 00:11:01,2,29,27
92,VNC,P008052,P009400,0 days 00:10:47,4,29,25
92,VNC,P000968,P004117,0 days 00:10:39,3,21,18
92,VNC,P003759,P004381,0 days 00:10:37,-2,17,19
92,VNC,P004117,P011928,0 days 00:09:51,-12,15,27
92,VNC,P003759,P012591,0 days 00:09:50,0,17,17
92,VNC,P003759,P011909,0 days 00:09:49,2,17,15
92,VNC,P000968,P011928,0 days 00:09:23,-3,16,19
92,VNC,P008052,P011909,0 days 00:08:46,-8,13,21
92,VNC,P004381,P012590,0 days 00:07:39,-9,17,26
92,VNC,P000968,P008052,0 days 00:06:18,3,15,12
92,VNC,P009400,P012591,0 days 00:05:55,8,19,11
92,VNC,P004381,P009400,0 days 00:05:51,-6,14,20
92,VNC,P003759,P011928,0 days 00:05:48,8,17,9
92,VNC,P003759,P008052,0 days 00:04:59,-11,0,11
92,VNC,P012590,P012591,0 days 00:04:30,4,17,13
92,VNC,P004117,P008052,0 days 00:03:33,5,10,5
92,VNC,P004117,P004381,0 days 00:03:03,-10,4,14
92,VNC,P004117,P012591,0 days 00:01:47,3,6,3
92,VNC,P004117,P011909,0 days 00:01:41,-3,4,7
92,VNC,P000968,P012591,0 days 00:01:40,5,5,0
92,VNC,P011909,P012590,0 days 00:01:33,-4,0,4
92,VNC,P003759,P009400,0 days 00:01:16,-5,0,5
92,VNC,P003759,P012590,0 days 00:01:15,-3,0,3
92,VNC,P000968,P003759,0 days 00:00:28,-1,0,1
92,VNC,P003759,P004117,0 days 00:00:18,0,0,0
92,LLI,P009680,P012585,0 days 00:26:29,2,70,68
92,LLI,P006600,P012585,0 days 00:25:33,0,65,65
92,LLI,P006600,P009680,0 days 00:21:46,4,60,56
92,LLI,P005247,P009680,0 days 00:21:40,6,53,47
92,LLI,P012585,P012586,0 days 00:18:09,-11,37,48
92,LLI,P009649,P012585,0 days 00:17:19,-8,43,51
92,LLI,P005247,P012585,0 days 00:17:17,3,45,42
92,LLI,P009649,P009680,0 days 00:16:49,1,46,45
92,LLI,P005247,P006600,0 days 00:15:34,6,43,37
92,LLI,P006600,P009649,0 days 00:15:33,-1,43,44
92,LLI,P005247,P012586,0 days 00:15:01,1,36,35
92,LLI,P006600,P012586,0 days 00:14:49,2,38,36
92,LLI,P009680,P012586,0 days 00:13:16,-5,32,37
92,LLI,P005247,P009649,0 days 00:10:52,5,29,24
92,LLI,P009649,P012586,0 days 00:10:38,-4,21,25
92,LLI,P005247,P012020,0 days 00:10:21,5,22,17
92,LLI,P008274,P009649,0 days 00:10:16,-3,14,17
92,LLI,P009649,P012020,0 days 00:09:24,-1,16,17
92,LLI,P005247,P008274,0 days 00:09:20,15,22,7
92,LLI,P009680,P012020,0 days 00:09:06,1,18,17
92,LLI,P009649,P009672,0 days 00:08:57,3,24,21
92,LLI,P008274,P009680,0 days 00:08:56,8,16,8
92,LLI,P008274,P012585,0 days 00:08:30,0,12,12
92,LLI,P006600,P008274,0 days 00:08:15,1,13,12
92,LLI,P012020,P012586,0 days 00:07:35,-8,11,19
92,LLI,P006600,P009672,0 days 00:07:22,4,22,18
92,LLI,P009672,P012585,0 days 00:06:22,2,18,16
92,LLI,P008274,P012020,0 days 00:06:18,6,13,7
92,LLI,P012020,P012585,0 days 00:05:49,-4,10,14
92,LLI,P008274,P012586,0 days 00:05:37,-1,10,11
92,LLI,P009672,P009680,0 days 00:05:26,3,17,14
92,LLI,P009672,P012586,0 days 00:04:31,2,11,9
92,LLI,P005247,P009672,0 days 00:03:35,3,10,7
92,LLI,P009672,P012020,0 days 00:02:35,1,6,5
92,LLI,P008274,P009672,0 days 00:01:00,2,4,2
93,WOL,P004229,P006154,0 days 00:16:20,-17,29,46
93,WOL,P004645,P006154,0 days 00:16:14,-1,33,34
93,WOL,P002387,P005516,0 days 00:16:03,-7,34,41
93,WOL,P005516,P012576,0 days 00:15:20,-9,33,42
93,WOL,P004645,P012577,0 days 00:15:10,-10,30,40
93,WOL,P006154,P012577,0 days 00:14:00,-17,23,40
93,WOL,P004229,P004645,0 days 00:13:22,-6,27,33
93,WOL,P003212,P012577,0 days 00:13:18,-15,22,37
93,WOL,P005516,PLCT,0 days 00:13:06,-17,28,45
93,WOL,P005516,P012577,0 days 00:13:06,-8,27,35
93,WOL,P003212,P006154,0 days 00:12:39,-11,24,35
93,WOL,P004645,P005516,0 days 00:12:29,-6,27,33
93,WOL,P012576,P012577,0 days 00:11:49,-4,25,29
93,WOL,P005516,P006154,0 days 00:11:40,-1,26,27
93,WOL,P003212,P004229,0 days 00:11:34,-18,19,37
93,WOL,P003212,P004645,0 days 00:10:47,-8,19,27
93,WOL,P004229,P012577,0 days 00:10:40,-19,17,36
93,WOL,P002387,P003212,0 days 00:10:18,-11,22,33
93,WOL,P002387,P006154,0 days 00:10:08,-8,19,27
93,WOL,P002387,P004229,0 days 00:09:51,-15,16,31
93,WOL,P003212,P005516,0 days 00:09:09,-6,19,25
93,WOL,P012576,PLCT,0 days 00:08:50,-11,20,31
93,WOL,P002387,P012576,0 days 00:08:34,-4,18,22
93,WOL,P002387,P012577,0 days 00:07:58,-13,12,25
93,WOL,P004229,P005516,0 days 00:07:29,-3,16,19
93,WOL,P002387,PLCT,0 days 00:07:16,0,16,16
93,WOL,P003212,PLCT,0 days 00:07:08,-1,15,16
93,WOL,P012789,PLCT,0 days 00:07:04,-2,15,17
93,WOL,P004645,P012576,0 days 00:06:52,-5,15,20
93,WOL,P012577,PLCT,0 days 00:05:52,-6,12,18
93,WOL,P002387,P004645,0 days 00:05:43,-1,12,13
93,WOL,P005516,P006907,0 days 00:05:42,-9,10,19
93,WOL,P006907,PLCT,0 days 00:05:42,-9,10,19
93,WOL,P003212,P012576,0 days 00:05:33,-2,13,15
93,WOL,P003212,P012789,0 days 00:04:57,1,9,8
93,WOL,P004645,PLCT,0 days 00:04:22,-7,11,18
93,WOL,P005516,P012789,0 days 00:04:16,-6,8,14
93,WOL,P006907,P012789,0 days 00:04:16,-6,8,14
93,WOL,P006154,P012789,0 days 00:04:16,1,13,12
93,WOL,P006154,PLCT,0 days 00:04:16,1,13,12
93,WOL,P006154,P012576,0 days 00:03:20,2,6,4
93,WOL,P003212,P006907,0 days 00:02:53,-5,2,7
93,WOL,P006154,P006907,0 days 00:02:51,-5,6,11
93,WOL,P002387,P006907,0 days 00:02:10,-5,2,7
93,WOL,P002387,P012789,0 days 00:01:27,4,5,1
93,WOL,P006907,P012576,0 days 00:01:26,-3,2,5
93,WOL,P004645,P012789,0 days 00:01:21,0,2,2
93,WOL,P004229,P006907,0 days 00:00:44,-2,0,2
93,WOL,P012577,P012789,0 days 00:00:39,0,0,0
93,PRS,P012608,P012610,0 days 00:26:10,27,78,51
93,PRS,P005793,P012608,0 days 00:22:53,20,65,45
93,PRS,P005793,P012610,0 days 00:22:53,20,65,45
93,PRS,P012613,P012640,0 days 00:21:52,8,55,47
93,PRS,P004512,P012608,0 days 00:17:11,21,51,30
93,PRS,P004512,P012610,0 days 00:17:11,21,51,30
93,PRS,P004512,P005793,0 days 00:13:54,14,38,24
93,PRS,P009556,P012640,0 days 00:12:15,2,26,24
93,PRS,P009556,P011232,0 days 00:11:51,7,28,21
93,PRS,P009556,P012613,0 days 00:11:43,1,23,22
93,PRS,P012608,P012640,0 days 00:11:32,11,38,27
93,PRS,P012610,P012640,0 days 00:11:32,11,38,27
93,PRS,P012608,P012613,0 days 00:10:53,9,34,25
93,PRS,P012610,P012613,0 days 00:10:53,9,34,25
93,PRS,P005793,P012640,0 days 00:10:26,2,28,26
93,PRS,P005793,P012613,0 days 00:10:26,2,28,26
93,PRS,P011232,P012640,0 days 00:10:16,5,22,17
93,PRS,P011232,P012613,0 days 00:10:16,5,22,17
93,PRS,P009556,P011887,0 days 00:09:54,2,23,21
93,PRS,P011887,P012640,0 days 00:09:42,4,23,19
93,PRS,P011887,P012613,0 days 00:08:31,1,16,15
93,PRS,P011887,P012608,0 days 00:08:22,15,26,11
93,PRS,P004512,P011887,0 days 00:08:22,15,26,11
93,PRS,P011887,P012610,0 days 00:08:22,15,26,11
93,PRS,P011232,P011887,0 days 00:07:55,5,19,14
93,PRS,P005793,P011887,0 days 00:07:42,5,19,14
93,PRS,P012609,P012610,0 days 00:07:20,8,20,12
93,PRS,P004512,P012609,0 days 00:07:20,8,20,12
93,PRS,P005793,P012609,0 days 00:07:20,8,20,12
93,PRS,P012608,P012609,0 days 00:07:20,8,20,12
93,PRS,P009556,P012609,0 days 00:03:56,2,9,7
93,PRS,P011232,P012609,0 days 00:03:56,2,9,7
93,PRS,P012609,P012613,0 days 00:03:56,2,9,7
93,PRS,P012609,P012640,0 days 00:03:56,2,9,7
93,PRS,P004512,P012640,0 days 00:02:33,5,11,6
93,PRS,P010801,P011887,0 days 00:02:07,3,9,6
93,PRS,P011551,P011887,0 days 00:02:07,3,9,6
93,PRS,P009556,P011551,0 days 00:02:07,3,9,6
93,PRS,P010801,P011551,0 days 00:02:07,3,9,6
93,PRS,P009556,P010801,0 days 00:02:07,3,9,6
93,PRS,P004512,P012613,0 days 00:01:54,3,7,4
93,PRS,P011232,P011551,0 days 00:01:35,2,6,4
93,PRS,P010801,P011232,0 days 00:01:35,2,6,4
93,PRS,P005793,P009556,0 days 00:01:27,-4,1,5
93,PRS,P010801,P012640,0 days 00:00:32,1,3,2
93,PRS,P011551,P012640,0 days 00:00:32,1,3,2
93,PRS,P004512,P011232,0 days 00:00:19,-3,0,3
93,PRS,P005793,P011232,0 days 00:00:19,-3,0,3
93,PRS,P011232,P012608,0 days 00:00:19,-3,0,3
93,PRS,P011232,P012610,0 days 00:00:19,-3,0,3
94,LJU,P009395,P012700,0 days 00:33:35,-5,66,71
94,LJU,P003452,P012700,0 days 00:33:19,-14,67,81
94,LJU,P003452,P009395,0 days 00:32:07,-7,64,71
94,LJU,P003452,P005969,0 days 00:23:55,-12,45,57
94,LJU,P005969,P009395,0 days 00:23:07,-3,46,49
94,LJU,P005969,P012700,0 days 00:22:57,-9,44,53
94,LJU,P003452,P011261,0 days 00:20:25,-11,45,56
94,LJU,P011261,P012700,0 days 00:19:48,-8,44,52
94,LJU,P009395,P011261,0 days 00:18:57,1,43,42
94,LJU,P003452,P012598,0 days 00:18:15,-2,35,37
94,LJU,P012598,P012700,0 days 00:16:58,-6,32,38
94,LJU,P005969,P012598,0 days 00:16:53,-1,30,31
94,LJU,P009395,P012598,0 days 00:14:12,2,25,23
94,LJU,P010594,P011261,0 days 00:12:21,-1,31,32
94,LJU,P003452,P010594,0 days 00:10:40,-5,25,30
94,LJU,P005969,P011261,0 days 00:10:03,-6,22,28
94,LJU,P010594,P012700,0 days 00:09:37,-1,24,25
94,LJU,P009395,P010594,0 days 00:09:07,5,23,18
94,LJU,P009392,P012700,0 days 00:08:28,-8,13,21
94,LJU,P009392,P009395,0 days 00:08:07,-5,13,18
94,LJU,P009392,P011261,0 days 00:06:49,-2,11,13
94,LJU,P003452,P009392,0 days 00:06:46,-5,13,18
94,LJU,P005969,P010594,0 days 00:04:04,4,13,9
94,LJU,P011261,P012598,0 days 00:03:42,-6,8,14
94,LJU,P005969,P009392,0 days 00:03:00,-9,2,11
94,LJU,P010594,P012598,0 days 00:02:26,-1,8,9
94,LJU,P003042,P003452,0 days 00:02:25,-8,2,10
94,LJU,P003042,P005969,0 days 00:02:25,-8,2,10
94,LJU,P003042,P011261,0 days 00:01:43,-7,0,7
94,LJU,P003042,P012598,0 days 00:01:37,-3,2,5
94,LJU,P003042,P010594,0 days 00:00:48,-5,0,5
94,LJU,P003042,P012700,0 days 00:00:42,-1,2,3
94,LJU,P009392,P012598,0 days 00:00:21,-3,0,3
94,LJU,P009392,P010594,0 days 00:00:21,0,0,0
94,HTA,P010465,P011991,0 days 00:21:55,14,53,39
94,HTA,P007759,P011973,0 days 00:19:50,-6,35,41
94,HTA,P010550,P011973,0 days 00:19:11,-5,38,43
94,HTA,P011973,P011991,0 days 00:18:34,6,40,34
94,HTA,P007759,P010550,0 days 00:17:37,-2,36,38
94,HTA,P010550,P011991,0 days 00:16:06,0,35,35
94,HTA,P006835,P011991,0 days 00:15:58,21,47,26
94,HTA,P010465,P011973,0 days 00:15:24,-1,29,30
94,HTA,P004846,P006835,0 days 00:14:42,13,38,25
94,HTA,P007759,P011991,0 days 00:14:31,3,30,27
94,HTA,P004846,P010465,0 days 00:13:48,7,36,29
94,HTA,P003533,P006835,0 days 00:13:45,14,40,26
94,HTA,P004846,P011973,0 days 00:13:35,-2,27,29
94,HTA,P004846,P011991,0 days 00:13:21,11,35,24
94,HTA,P006835,P010465,0 days 00:13:16,18,40,22
94,HTA,P010465,P010550,0 days 00:12:55,-7,21,28
94,HTA,P004846,P007759,0 days 00:12:35,-2,25,27
94,HTA,P004267,P011991,0 days 00:11:59,10,36,26
94,HTA,P004267,P006835,0 days 00:11:19,5,29,24
94,HTA,P003533,P011991,0 days 00:11:08,11,32,21
94,HTA,P003533,P010465,0 days 00:10:47,12,32,20
94,HTA,P007759,P010465,0 days 00:10:10,-6,14,20
94,HTA,P004267,P007759,0 days 00:10:00,3,27,24
94,HTA,P003533,P004267,0 days 00:09:01,9,27,18
94,HTA,P004846,P010550,0 days 00:08:57,-4,20,24
94,HTA,P004267,P011973,0 days 00:07:49,0,19,19
94,HTA,P003533,P004846,0 days 00:07:42,7,21,14
94,HTA,P006835,P007759,0 days 00:07:12,3,17,14
94,HTA,P004267,P010465,0 days 00:06:29,7,19,12
94,HTA,P006835,P011973,0 days 00:05:53,4,12,8
94,HTA,P004267,P010550,0 days 00:05:31,4,17,13
94,HTA,P004267,P004846,0 days 00:05:12,-2,10,12
94,HTA,P003533,P007759,0 days 00:02:37,3,8,5
94,HTA,P006835,P010550,0 days 00:01:11,2,5,3
95,BES,P009582,P011936,0 days 00:21:20,1,51,50
95,BES,P008945,P011936,0 days 00:21:12,8,60,52
95,BES,P008945,P012622,0 days 00:21:02,5,47,42
95,BES,P008945,P012647,0 days 00:19:53,-1,40,41
95,BES,P008945,P009582,0 days 00:18:31,6,50,44
95,BES,P011936,P012622,0 days 00:18:16,7,42,35
95,BES,P012622,P012647,0 days 00:18:10,-3,31,34
95,BES,P011936,P012647,0 days 00:17:10,-1,35,36
95,BES,P005348,P008945,0 days 00:15:50,-8,32,40
95,BES,P009582,P012647,0 days 00:15:26,-4,31,35
95,BES,P009582,P012622,0 days 00:13:11,6,30,24
95,BES,P005348,P012622,0 days 00:12:07,-2,20,22
95,BES,P003783,P011936,0 days 00:11:01,-11,12,23
95,BES,P007914,P011936,0 days 00:10:48,-1,22,23
95,BES,P011379,P012622,0 days 00:10:36,-4,16,20
95,BES,P011379,P011936,0 days 00:09:59,4,21,17
95,BES,P005348,P011379,0 days 00:09:26,-1,17,18
95,BES,P008945,P011379,0 days 00:09:20,1,19,18
95,BES,P005348,P012647,0 days 00:09:15,-5,15,20
95,BES,P005348,P011936,0 days 00:08:55,-4,23,27
95,BES,P003783,P007914,0 days 00:08:33,-6,12,18
95,BES,P011379,P012647,0 days 00:07:52,1,10,9
95,BES,P003783,P012647,0 days 00:07:48,-13,4,17
95,BES,P011357,P011936,0 days 00:07:39,5,22,17
95,BES,P009582,P011357,0 days 00:07:39,5,22,17
95,BES,P007914,P009582,0 days 00:07:18,-3,16,19
95,BES,P005348,P009582,0 days 00:06:47,-4,15,19
95,BES,P007914,P012647,0 days 00:06:46,-2,10,12
95,BES,P003783,P009582,0 days 00:06:14,-8,6,14
95,BES,P008945,P011357,0 days 00:05:18,3,16,13
95,BES,P007914,P008945,0 days 00:05:14,1,12,11
95,BES,P007914,P011379,0 days 00:04:47,2,8,6
95,BES,P003783,P011379,0 days 00:04:46,0,6,6
95,BES,P003783,P012622,0 days 00:04:34,-6,2,8
95,BES,P007914,P011357,0 days 00:04:22,3,12,9
95,BES,P007914,P012622,0 days 00:02:32,-4,2,6
95,BES,P003783,P011357,0 days 00:02:21,2,6,4
95,BES,P005348,P011357,0 days 00:02:09,-3,4,7
95,BES,P003783,P008945,0 days 00:02:08,-7,0,7
95,BES,P005348,P007914,0 days 00:01:24,-2,2,4
95,BES,P009582,P011379,0 days 00:01:10,1,3,2
95,BES,P011357,P012622,0 days 00:01:08,5,6,1
95,BES,P003783,P005348,0 days 00:00:03,-3,0,3
95,JOV,P011247,P011248,0 days 00:23:52,3,57,54
95,JOV,P006771,P011248,0 days 00:20:55,2,46,44
95,JOV,P002507,P005094,0 days 00:18:10,7,43,36
95,JOV,P006771,P011247,0 days 00:18:05,0,42,42
95,JOV,P005094,P011247,0 days 00:17:39,-7,37,44
95,JOV,P005094,P012780,0 days 00:14:40,-1,28,29
95,JOV,P006771,P012349,0 days 00:14:32,5,31,26
95,JOV,P011247,P012780,0 days 00:14:15,1,30,29
95,JOV,P005094,P011248,0 days 00:14:11,-2,30,32
95,JOV,P002507,PJUG,0 days 00:12:32,10,33,23
95,JOV,P011248,P012349,0 days 00:12:31,7,31,24
95,JOV,P005094,PJUG,0 days 00:12:21,7,33,26
95,JOV,P011248,P012780,0 days 00:11:51,1,28,27
95,JOV,P011247,P012349,0 days 00:11:43,7,29,22
95,JOV,P002507,P009572,0 days 00:10:56,2,17,15
95,JOV,P002507,P011247,0 days 00:10:22,1,26,25
95,JOV,P006771,P010708,0 days 00:09:53,-3,18,21
95,JOV,P010708,P011248,0 days 00:09:52,-3,18,21
95,JOV,P010708,P011247,0 days 00:09:52,-3,18,21
95,JOV,P005094,P006771,0 days 00:09:37,-7,15,22
95,JOV,P005094,P009572,0 days 00:08:55,4,17,13
95,JOV,P010708,P012349,0 days 00:08:45,-1,16,17
95,JOV,P002507,P012780,0 days 00:08:30,5,19,14
95,JOV,P009572,PJUG,0 days 00:08:04,0,15,15
95,JOV,P002507,P011248,0 days 00:07:35,4,19,15
95,JOV,P002507,P006771,0 days 00:07:26,-6,6,12
95,JOV,P012780,PJUG,0 days 00:06:53,3,15,12
95,JOV,P006771,P012780,0 days 00:06:50,7,22,15
95,JOV,P011247,PJUG,0 days 00:06:34,3,18,15
95,JOV,P006771,P009572,0 days 00:06:03,-2,4,6
95,JOV,P005094,P010709,0 days 00:05:10,-3,11,14
95,JOV,P009572,P012780,0 days 00:05:01,6,13,7
95,JOV,P010709,P011247,0 days 00:03:59,-3,7,10
95,JOV,P010709,PJUG,0 days 00:03:53,-3,9,12
95,JOV,P012349,P012780,0 days 00:03:46,8,15,7
95,JOV,P006771,PJUG,0 days 00:03:14,-4,0,4
95,JOV,P002507,P010709,0 days 00:03:12,-1,9,10
95,JOV,P009572,P011248,0 days 00:02:50,2,4,2
95,JOV,P009572,P012349,0 days 00:02:49,-2,2,4
95,JOV,P002507,P012349,0 days 00:02:01,-2,0,2
95,JOV,P012349,PJUG,0 days 00:02:01,-2,0,2
95,JOV,P010709,P012780,0 days 00:01:58,-2,2,4
95,JOV,P011248,PJUG,0 days 00:01:54,6,9,3
95,JOV,P010709,P011248,0 days 00:01:17,0,2,2
95,JOV,P009572,P010709,0 days 00:01:11,0,4,4
95,JOV,P005094,P010708,0 days 00:01:08,-2,2,4
95,JOV,P009572,P011247,0 days 00:01:07,-2,0,2
95,JOV,P005094,P010161,0 days 00:00:01,0,0,0
95,JOV,P006771,P010161,0 days 00:00:01,0,0,0
95,JOV,P010161,P010708,0 days 00:00:01,0,0,0
95,JOV,P010161,PJUG,0 days 00:00:01,0,0,0
95,JOV,P010708,PJUG,0 days 00:00:01,0,0,0
96,WRO,P011900,P012699,0 days 00:28:26,-3,51,54
96,WRO,P011900,P012601,0 days 00:24:24,-2,41,43
96,WRO,P011900,P011901,0 days 00:24:12,4,47,43
96,WRO,P011901,P012601,0 days 00:23:39,3,43,40
96,WRO,P009896,P011900,0 days 00:23:01,2,45,43
96,WRO,P012601,P012699,0 days 00:22:34,-4,37,41
96,WRO,P009896,P012699,0 days 00:21:04,0,43,43
96,WRO,P009896,P011901,0 days 00:20:00,9,43,34
96,WRO,P009896,P012601,0 days 00:19:52,1,37,36
96,WRO,P011901,P012699,0 days 00:19:43,5,41,36
96,WRO,P003034,P012736,0 days 00:15:27,-10,17,27
96,WRO,P012601,P012736,0 days 00:15:13,-13,14,27
96,WRO,P011900,P012736,0 days 00:13:41,-9,16,25
96,WRO,P012699,P012736,0 days 00:11:38,-11,12,23
96,WRO,P003034,P012601,0 days 00:11:24,-8,10,18
96,WRO,P003034,P011900,0 days 00:09:59,-7,11,18
96,WRO,P003034,P012699,0 days 00:09:53,-7,9,16
96,WRO,P011901,P012736,0 days 00:07:52,-3,10,13
96,WRO,P003034,P011901,0 days 00:07:19,-7,8,15
96,WRO,P007472,P011901,0 days 00:05:53,-3,12,15
96,WRO,P011278,P012736,0 days 00:05:49,-2,5,7
96,WRO,P003034,P011278,0 days 00:05:41,-3,4,7
96,WRO,P011278,P012699,0 days 00:05:11,-2,5,7
96,WRO,P009896,P012736,0 days 00:04:58,-5,4,9
96,WRO,P003034,P007472,0 days 00:04:03,-4,4,8
96,WRO,P007472,P012736,0 days 00:03:56,-1,5,6
96,WRO,P007472,P011900,0 days 00:03:45,0,9,9
96,WRO,P003034,P012749,0 days 00:03:38,-2,5,7
96,WRO,P012736,P012749,0 days 00:03:38,-2,5,7
96,WRO,P007472,P012601,0 days 00:03:35,-2,4,6
96,WRO,P007472,P012699,0 days 00:03:32,0,9,9
96,WRO,P011278,P012601,0 days 00:03:17,-3,2,5
96,WRO,P007472,P009896,0 days 00:03:09,1,8,7
96,WRO,P011278,P011900,0 days 00:02:32,1,3,2
96,WRO,P011900,P012749,0 days 00:02:32,-2,5,7
96,WRO,P012699,P012749,0 days 00:02:19,-2,5,7
96,WRO,P007472,P012749,0 days 00:01:19,0,0,0
96,WRO,P012601,P012749,0 days 00:01:06,0,0,0
96,WRO,P011278,P011901,0 days 00:00:38,0,0,0
96,WRO,P007472,P011278,0 days 00:00:08,1,1,0
96,BOU,P010718,P012617,0 days 00:19:41,9,46,37
96,BOU,P000498,P010450,0 days 00:16:47,-5,17,22
96,BOU,P000498,P012628,0 days 00:15:14,-10,17,27
96,BOU,P004525,P010450,0 days 00:14:52,7,20,13
96,BOU,P000498,P004525,0 days 00:14:46,1,17,16
96,BOU,P012617,P012628,0 days 00:13:49,-5,25,30
96,BOU,P011836,P012617,0 days 00:12:24,10,28,18
96,BOU,P010431,P012617,0 days 00:12:20,12,30,18
96,BOU,P012617,P012618,0 days 00:12:10,4,26,22
96,BOU,P010450,P012628,0 days 00:12:04,-9,8,17
96,BOU,P011837,P012617,0 days 00:11:46,3,27,24
96,BOU,P010431,P012618,0 days 00:11:16,11,26,15
96,BOU,P010431,P010718,0 days 00:11:10,7,25,18
96,BOU,P010718,P011836,0 days 00:11:06,9,26,17
96,BOU,P010718,P011837,0 days 00:11:02,4,27,23
96,BOU,P010718,P012628,0 days 00:10:30,0,23,23
96,BOU,P004525,P012628,0 days 00:10:17,-3,11,14
96,BOU,P010450,P012619,0 days 00:09:55,1,10,9
96,BOU,P010718,P012618,0 days 00:09:43,4,21,17
96,BOU,P004525,P010431,0 days 00:09:12,11,20,9
96,BOU,P011837,P012628,0 days 00:08:43,-2,18,20
96,BOU,P004525,P012619,0 days 00:08:37,0,8,8
96,BOU,P000498,P012619,0 days 00:08:37,0,8,8
96,BOU,P011836,P012618,0 days 00:08:26,4,19,15
96,BOU,P010450,P012618,0 days 00:08:06,2,14,12
96,BOU,P010431,P010450,0 days 00:07:54,8,18,10
96,BOU,P012619,P012628,0 days 00:07:52,-2,6,8
96,BOU,P010431,P011836,0 days 00:07:31,9,19,10
96,BOU,P004525,P012618,0 days 00:06:58,7,12,5
96,BOU,P000498,P012617,0 days 00:06:29,-6,11,17
96,BOU,P000498,P012618,0 days 00:06:22,-3,7,10
96,BOU,P000498,P011837,0 days 00:06:16,-2,13,15
96,BOU,P010450,P012617,0 days 00:06:16,-3,11,14
96,BOU,P000498,P010431,0 days 00:06:01,5,11,6
96,BOU,P012618,P012628,0 days 00:05:59,-5,7,12
96,BOU,P010431,P011837,0 days 00:05:02,3,11,8
96,BOU,P011836,P012628,0 days 00:04:53,1,9,8
96,BOU,P004525,P012617,0 days 00:04:43,7,14,7
96,BOU,P004525,P010718,0 days 00:04:37,1,11,10
96,BOU,P000498,P010718,0 days 00:04:28,0,11,11
96,BOU,P004525,P011837,0 days 00:03:54,1,11,10
96,BOU,P011836,P011837,0 days 00:02:40,5,7,2
96,BOU,P010431,P012619,0 days 00:02:03,3,4,1
96,BOU,P010450,P011837,0 days 00:01:57,-4,2,6
96,BOU,P010450,P011836,0 days 00:01:18,1,2,1
96,BOU,P011836,P012619,0 days 00:01:18,1,2,1
96,BOU,P012617,P012619,0 days 00:01:18,1,2,1
96,BOU,P010431,P012628,0 days 00:00:55,-1,0,1
96,BOU,P010450,P010718,0 days 00:00:43,-2,2,4
97,TTK,P011834,P011925,0 days 00:32:11,-1,72,73
97,TTK,P006693,P011834,0 days 00:29:45,8,70,62
97,TTK,P006693,P011925,0 days 00:28:58,2,59,57
97,TTK,P004801,P011834,0 days 00:27:37,17,66,49
97,TTK,P011239,P011834,0 days 00:25:56,10,65,55
97,TTK,P004801,P011925,0 days 00:23:54,7,45,38
97,TTK,P004801,P006693,0 days 00:22:47,14,46,32
97,TTK,P011239,P011925,0 days 00:22:43,1,50,49
97,TTK,P006693,P011239,0 days 00:20:39,8,47,39
97,TTK,P004801,P011239,0 days 00:19:20,9,44,35
97,TTK,P005000,P011834,0 days 00:19:12,11,59,48
97,TTK,P005000,P011925,0 days 00:15:29,1,38,37
97,TTK,P005000,P006693,0 days 00:13:14,8,38,30
97,TTK,P005685,P011834,0 days 00:12:00,0,29,29
97,TTK,P004801,P005000,0 days 00:11:36,14,32,18
97,TTK,P005685,P011925,0 days 00:11:30,-1,23,24
97,TTK,P005685,P006693,0 days 00:11:08,1,24,23
97,TTK,P005000,P011239,0 days 00:10:40,12,39,27
97,TTK,P005000,P005685,0 days 00:10:34,0,21,21
97,TTK,P004801,P005685,0 days 00:10:19,9,23,14
97,TTK,P005000,P009845,0 days 00:04:15,2,13,11
97,TTK,P009845,P011239,0 days 00:04:15,2,13,11
97,TTK,P009845,P011834,0 days 00:04:15,2,13,11
97,TTK,P004801,P009845,0 days 00:02:56,4,10,6
97,TTK,P009845,P011925,0 days 00:01:19,-2,3,5
97,TTK,P011834,P011975,0 days 00:00:52,-7,2,9
97,TTK,P011925,P011975,0 days 00:00:52,-7,2,9
97,TTK,P005685,P011975,0 days 00:00:41,-5,0,5
97,TTK,P006693,P011975,0 days 00:00:41,-5,0,5
97,TTK,P004801,P011975,0 days 00:00:11,-2,2,4
97,TTK,P011239,P011975,0 days 00:00:11,-2,2,4
97,CLU,P010569,P011797,0 days 00:22:15,-5,46,51
97,CLU,P010569,P012698,0 days 00:21:52,3,47,44
97,CLU,P005373,P010569,0 days 00:21:43,0,44,44
97,CLU,P005373,P011797,0 days 00:20:34,0,42,42
97,CLU,P011801,P012621,0 days 00:18:59,-3,44,47
97,CLU,P011797,P012698,0 days 00:17:14,1,33,32
97,CLU,P005373,P012698,0 days 00:17:13,1,31,30
97,CLU,P005113,P011801,0 days 00:16:51,-6,36,42
97,CLU,P004862,P010569,0 days 00:16:13,-11,34,45
97,CLU,P004862,P011797,0 days 00:16:04,-15,30,45
97,CLU,P005113,P012621,0 days 00:15:34,-11,31,42
97,CLU,P010569,P011801,0 days 00:14:50,4,37,33
97,CLU,P011801,P012698,0 days 00:14:11,7,34,27
97,CLU,P004862,P005373,0 days 00:14:09,-6,29,35
97,CLU,P011797,P011801,0 days 00:13:54,-9,24,33
97,CLU,P004862,P012698,0 days 00:13:05,-2,28,30
97,CLU,P005714,P011801,0 days 00:11:44,-4,23,27
97,CLU,P005113,P005714,0 days 00:11:43,-4,23,27
97,CLU,P005714,P012621,0 days 00:11:43,-4,23,27
97,CLU,P004862,P011801,0 days 00:11:08,-7,25,32
97,CLU,P005373,P011801,0 days 00:10:11,2,21,19
97,CLU,P004862,P005113,0 days 00:09:02,-8,19,27
97,CLU,P012621,P012698,0 days 00:07:50,4,23,19
97,CLU,P005113,P012698,0 days 00:07:35,4,22,18
97,CLU,P004862,P012621,0 days 00:07:29,-8,14,22
97,CLU,P011797,P012621,0 days 00:07:00,-13,12,25
97,CLU,P010569,P012621,0 days 00:06:23,0,20,20
97,CLU,P004862,P005714,0 days 00:05:34,1,13,12
97,CLU,P005113,P011797,0 days 00:04:28,-16,1,17
97,CLU,P005113,P010569,0 days 00:04:15,-3,12,15
97,CLU,P005714,P012698,0 days 00:03:52,2,10,8
97,CLU,P005373,P012621,0 days 00:03:02,3,9,6
97,CLU,P005714,P011797,0 days 00:02:19,-7,0,7
97,CLU,P005714,P010569,0 days 00:00:01,0,0,0
98,LKB,P002012,PLXI,0 days 00:24:19,2,51,49
98,LKB,P002012,P007029,0 days 00:22:00,6,47,41
98,LKB,P002012,P008856,0 days 00:21:53,5,39,34
98,LKB,P007029,P008856,0 days 00:21:24,-1,37,38
98,LKB,P007029,PLXI,0 days 00:20:28,-6,39,45
98,LKB,P008856,PLXI,0 days 00:18:35,-5,29,34
98,LKB,P005521,PLXI,0 days 00:18:35,-8,42,50
98,LKB,P005521,P007029,0 days 00:18:13,-6,38,44
98,LKB,P002012,P005521,0 days 00:17:04,3,41,38
98,LKB,P006230,P007029,0 days 00:16:10,8,33,25
98,LKB,P006230,P008856,0 days 00:15:59,12,32,20
98,LKB,P005521,P008856,0 days 00:14:33,0,29,29
98,LKB,P002012,P006230,0 days 00:14:28,13,31,18
98,LKB,P010461,PLXI,0 days 00:14:24,-16,28,44
98,LKB,P005521,P010461,0 days 00:14:12,-4,34,38
98,LKB,P006230,PLXI,0 days 00:13:59,14,32,18
98,LKB,P002012,P010461,0 days 00:13:56,-4,30,34
98,LKB,P005521,P006230,0 days 00:11:55,-1,22,23
98,LKB,P007029,P010461,0 days 00:11:51,-8,23,31
98,LKB,P008856,P010461,0 days 00:09:52,-12,11,23
98,LKB,P004868,P005521,0 days 00:09:49,-2,20,22
98,LKB,P005521,P010190,0 days 00:06:47,-2,16,18
98,LKB,P004868,P007029,0 days 00:06:46,-3,11,14
98,LKB,P004868,P006230,0 days 00:05:37,-1,11,12
98,LKB,P010190,PLXI,0 days 00:04:59,0,14,14
98,LKB,P004868,P010190,0 days 00:04:51,-1,11,12
98,LKB,P004868,PLXI,0 days 00:04:49,-1,11,12
98,LKB,P010190,P010461,0 days 00:04:36,-2,12,14
98,LKB,P004868,P008856,0 days 00:03:12,1,7,6
98,LKB,P004868,P010461,0 days 00:02:40,-1,7,8
98,LKB,P006230,P010190,0 days 00:02:11,0,4,4
98,LKB,P002012,P010190,0 days 00:01:56,-1,5,6
98,LKB,P007029,P010190,0 days 00:01:48,-2,2,4
98,LKB,P004868,P006901,0 days 00:01:32,0,2,2
98,LKB,P005521,P006901,0 days 00:01:32,0,2,2
98,LKB,P006901,P007029,0 days 00:01:32,0,2,2
98,LKB,P006901,PLXI,0 days 00:01:32,0,2,2
98,LKB,P006230,P010461,0 days 00:00:01,3,3,0
98,BUD,P004945,P010248,0 days 00:24:19,3,56,53
98,BUD,P002740,P004945,0 days 00:20:17,6,48,42
98,BUD,P004945,P006566,0 days 00:19:19,1,46,45
98,BUD,P006566,P010248,0 days 00:18:44,4,48,44
98,BUD,P002740,P011281,0 days 00:17:50,6,38,32
98,BUD,P002740,P010248,0 days 00:17:17,7,46,39
98,BUD,P004945,P012606,0 days 00:14:26,1,28,27
98,BUD,P010248,P012606,0 days 00:14:26,1,28,27
98,BUD,P006566,P011281,0 days 00:13:12,0,31,31
98,BUD,P010432,P011281,0 days 00:13:02,-5,19,24
98,BUD,P002740,P006566,0 days 00:12:37,5,36,31
98,BUD,P004945,P011281,0 days 00:12:01,4,29,25
98,BUD,P007398,P010432,0 days 00:11:50,0,23,23
98,BUD,P007398,P011281,0 days 00:10:01,-1,17,18
98,BUD,P006566,P007398,0 days 00:09:48,-1,21,22
98,BUD,P006566,P012606,0 days 00:09:32,2,20,18
98,BUD,P004397,P012606,0 days 00:09:24,-5,12,17
98,BUD,P004397,P004945,0 days 00:09:24,-5,12,17
98,BUD,P004397,P010248,0 days 00:09:24,-5,12,17
98,BUD,P010248,P011281,0 days 00:09:01,5,27,22
98,BUD,P002740,P004397,0 days 00:08:58,-3,13,16
98,BUD,P002740,P010432,0 days 00:08:50,-2,11,13
98,BUD,P010432,P011935,0 days 00:08:23,4,18,14
98,BUD,P002740,P012606,0 days 00:08:11,4,20,16
98,BUD,P011281,P011935,0 days 00:08:06,3,14,11
98,BUD,P006566,P010432,0 days 00:07:47,-5,14,19
98,BUD,P007398,P011935,0 days 00:07:40,2,18,16
98,BUD,P006566,P011935,0 days 00:06:28,3,16,13
98,BUD,P002740,P007398,0 days 00:06:10,-4,10,14
98,BUD,P004397,P006566,0 days 00:04:44,-2,6,8
98,BUD,P004397,P011281,0 days 00:04:18,0,7,7
98,BUD,P004397,P007398,0 days 00:04:18,0,7,7
98,BUD,P004397,P010432,0 days 00:04:18,0,7,7
98,BUD,P002740,P011935,0 days 00:04:18,1,6,5
98,BUD,P006566,P012605,0 days 00:03:49,1,10,9
98,BUD,P007398,P012605,0 days 00:03:49,1,10,9
98,BUD,P007398,P010248,0 days 00:03:28,-2,7,9
98,BUD,P004945,P011935,0 days 00:03:06,2,4,2
98,BUD,P004945,P010432,0 days 00:03:01,-4,2,6
98,BUD,P011935,P012605,0 days 00:02:40,1,8,7
98,BUD,P004945,P007398,0 days 00:02:37,-2,5,7
98,BUD,P010248,P011935,0 days 00:02:23,0,4,4
98,BUD,P010432,P012605,0 days 00:02:12,-1,6,7
98,BUD,P010248,P012605,0 days 00:01:37,2,4,2
98,BUD,P007398,P012606,0 days 00:01:31,-1,2,3
98,BUD,P004945,P012605,0 days 00:00:46,2,2,0
98,BUD,P011281,P012605,0 days 00:00:23,-2,0,2
98,BUD,P011281,P012606,0 days 00:00:14,2,2,0
98,BUD,P010248,P010432,0 days 00:00:01,-3,0,3
99,CAN,P004160,P007644,0 days 00:19:48,18,46,28
99,CAN,P001607,P004160,0 days 00:17:48,12,37,25
99,CAN,P003425,P008121,0 days 00:17:47,12,42,30
99,CAN,P003425,P003637,0 days 00:16:24,9,39,30
99,CAN,P003637,P008121,0 days 00:16:22,9,39,30
99,CAN,P001607,P007644,0 days 00:15:54,12,35,23
99,CAN,P004160,P005005,0 days 00:14:19,5,33,28
99,CAN,P005005,P007644,0 days 00:12:25,5,31,26
99,CAN,P003637,P009864,0 days 00:12:24,3,30,27
99,CAN,P008121,P009864,0 days 00:12:05,4,29,25
99,CAN,P003425,P009864,0 days 00:11:51,3,28,25
99,CAN,P001607,P005005,0 days 00:11:50,2,25,23
99,CAN,P007644,P008121,0 days 00:11:41,9,25,16
99,CAN,P007644,P010385,0 days 00:11:41,17,31,14
99,CAN,P004160,P010385,0 days 00:10:02,11,24,13
99,CAN,P003425,P007644,0 days 00:09:47,6,20,14
99,CAN,P003637,P007644,0 days 00:08:55,3,19,16
99,CAN,P001607,P010452,0 days 00:08:51,2,16,14
99,CAN,P004160,P010452,0 days 00:08:51,2,16,14
99,CAN,P008121,P010452,0 days 00:08:00,6,22,16
99,CAN,P003637,P010452,0 days 00:08:00,6,22,16
99,CAN,P003425,P010452,0 days 00:08:00,6,22,16
99,CAN,P001607,P010385,0 days 00:07:48,6,19,13
99,CAN,P005005,P010385,0 days 00:07:45,7,19,12
99,CAN,P007560,P007644,0 days 00:07:39,10,19,9
99,CAN,P004160,P007560,0 days 00:07:39,10,19,9
99,CAN,P008121,P010385,0 days 00:07:36,11,18,7
99,CAN,P005005,P010452,0 days 00:07:36,-2,12,14
99,CAN,P009864,P010452,0 days 00:07:35,6,22,16
99,CAN,P003425,P010385,0 days 00:06:46,10,16,6
99,CAN,P007560,P010484,0 days 00:06:25,5,15,10
99,CAN,P007644,P010452,0 days 00:06:24,2,12,10
99,CAN,P007644,P010484,0 days 00:05:35,4,13,9
99,CAN,P004160,P010484,0 days 00:05:35,4,13,9
99,CAN,P007644,P009864,0 days 00:05:03,-2,9,11
99,CAN,P001607,P007560,0 days 00:04:37,7,9,2
99,CAN,P003637,P010385,0 days 00:04:33,6,11,5
99,CAN,P005005,P007560,0 days 00:03:50,4,12,8
99,CAN,P001607,P010484,0 days 00:03:22,3,5,2
99,CAN,P004160,P008121,0 days 00:03:19,6,8,2
99,CAN,P005005,P010484,0 days 00:03:01,2,10,8
99,CAN,P010385,P010452,0 days 00:02:52,0,4,4
99,CAN,P001607,P008121,0 days 00:01:54,3,5,2
99,CAN,P007560,P010385,0 days 00:01:39,3,4,1
99,CAN,P003425,P004160,0 days 00:01:25,3,3,0
99,CAN,P007560,P010452,0 days 00:01:15,4,4,0
99,CAN,P003425,P007560,0 days 00:00:50,1,2,1
99,CAN,P003425,P010484,0 days 00:00:50,1,2,1
99,CAN,P010385,P010484,0 days 00:00:50,1,2,1
99,CAN,P003425,P005005,0 days 00:00:48,1,2,1
99,CAN,P001607,P009864,0 days 00:00:47,1,3,2
99,CAN,P001607,P003637,0 days 00:00:33,0,2,2
99,CAN,P003637,P005005,0 days 00:00:33,0,2,2
99,CAN,P005005,P009864,0 days 00:00:33,0,2,2
99,CAN,P004160,P009864,0 days 00:00:14,1,1,0
99,CAN,P003637,P007560,0 days 00:00:02,0,0,0
99,CAN,P003637,P010484,0 days 00:00:02,0,0,0
99,ARI,P012708,P012717,0 days 00:17:59,-12,33,45
99,ARI,P004292,P012717,0 days 00:15:24,-11,31,42
99,ARI,P002867,P010387,0 days 00:13:43,-9,17,26
99,ARI,P012702,P012716,0 days 00:13:30,-4,26,30
99,ARI,P012702,P012707,0 days 00:13:19,-9,19,28
99,ARI,P004292,P012708,0 days 00:12:23,-6,28,34
99,ARI,P012716,P012717,0 days 00:11:35,-5,23,28
99,ARI,P012708,P012716,0 days 00:11:11,-2,20,22
99,ARI,P012616,P012722,0 days 00:11:06,-11,18,29
99,ARI,P004292,P012616,0 days 00:11:01,-11,17,28
99,ARI,P012702,P012717,0 days 00:10:49,-2,24,26
99,ARI,P004292,P012702,0 days 00:10:34,-4,24,28
99,ARI,P012708,P012722,0 days 00:10:04,-7,20,27
99,ARI,P010387,P012707,0 days 00:10:01,-8,13,21
99,ARI,P010387,P012616,0 days 00:09:43,-12,15,27
99,ARI,P012616,P012717,0 days 00:09:41,-7,15,22
99,ARI,P012616,P012707,0 days 00:09:34,-10,13,23
99,ARI,P010387,P012702,0 days 00:09:23,-6,12,18
99,ARI,P012707,P012717,0 days 00:09:09,-2,17,19
99,ARI,P012616,P012708,0 days 00:08:45,-7,15,22
99,ARI,P012707,P012716,0 days 00:08:29,-3,11,14
99,ARI,P002867,P012702,0 days 00:08:29,-2,12,14
99,ARI,P004292,P012722,0 days 00:08:26,-9,15,24
99,ARI,P002867,P012707,0 days 00:08:23,-4,13,17
99,ARI,P012702,P012708,0 days 00:08:20,0,17,17
99,ARI,P002867,P012716,0 days 00:08:01,-1,11,12
99,ARI,P004292,P012716,0 days 00:07:52,-6,18,24
99,ARI,P010387,P012722,0 days 00:07:25,-7,11,18
99,ARI,P012717,P012722,0 days 00:07:25,-7,14,21
99,ARI,P002867,P012722,0 days 00:07:07,-10,8,18
99,ARI,P002867,P012708,0 days 00:07:03,-11,5,16
99,ARI,P010387,P012716,0 days 00:06:48,-2,8,10
99,ARI,P012616,P012702,0 days 00:06:24,-5,10,15
99,ARI,P002867,P012616,0 days 00:06:24,-8,9,17
99,ARI,P004292,P012707,0 days 00:06:23,-3,13,16
99,ARI,P012707,P012708,0 days 00:05:31,0,10,10
99,ARI,P004292,P010387,0 days 00:05:28,-7,8,15
99,ARI,P010387,P012708,0 days 00:05:23,-1,8,9
99,ARI,P012708,P012760,0 days 00:04:58,-6,4,10
99,ARI,P012717,P012760,0 days 00:04:44,-6,4,10
99,ARI,P002867,P004292,0 days 00:04:05,-10,2,12
99,ARI,P002867,P012717,0 days 00:03:15,-8,3,11
99,ARI,P012716,P012722,0 days 00:03:11,-5,3,8
99,ARI,P012707,P012760,0 days 00:03:06,-1,4,5
99,ARI,P012707,P012722,0 days 00:02:45,0,7,7
99,ARI,P012616,P012760,0 days 00:01:54,-3,2,5
99,ARI,P004292,P012760,0 days 00:01:52,-5,0,5
99,ARI,P010177,P012616,0 days 00:01:51,0,4,4
99,ARI,P010177,P012722,0 days 00:01:51,0,4,4
99,ARI,P010177,P012717,0 days 00:01:51,0,4,4
99,ARI,P010177,P012708,0 days 00:01:51,0,4,4
99,ARI,P012716,P012760,0 days 00:01:42,2,2,0
99,ARI,P002867,P012760,0 days 00:01:22,-5,0,5
99,ARI,P012616,P012716,0 days 00:01:13,-2,2,4
99,ARI,P010387,P012760,0 days 00:00:14,0,0,0
100,TRN,P009903,P012597,0 days 00:25:51,-8,57,65
100,TRN,P005738,P012595,0 days 00:25:34,6,55,49
100,TRN,P012595,P012597,0 days 00:24:59,5,64,59
100,TRN,P005738,P012597,0 days 00:23:26,-1,48,49
100,TRN,P009903,P012595,0 days 00:22:12,-7,47,54
100,TRN,P001479,P012593,0 days 00:19:27,-2,36,38
100,TRN,P005738,P009903,0 days 00:17:42,-8,31,39
100,TRN,P012597,P012687,0 days 00:16:19,3,36,33
100,TRN,P005738,P012687,0 days 00:15:31,0,31,31
100,TRN,P009903,P012687,0 days 00:14:46,3,34,31
100,TRN,P012595,P012687,0 days 00:14:16,0,31,31
100,TRN,P001479,P012595,0 days 00:14:16,9,40,31
100,TRN,P001479,P012597,0 days 00:13:53,7,43,36
100,TRN,P012593,P012597,0 days 00:13:23,-9,27,36
100,TRN,P012593,P012595,0 days 00:13:01,-3,25,28
100,TRN,P009903,P012593,0 days 00:12:07,-11,22,33
100,TRN,P005738,P012593,0 days 00:12:02,-7,14,21
100,TRN,P001479,P005738,0 days 00:11:53,9,26,17
100,TRN,P001479,P009903,0 days 00:10:25,-3,26,29
100,TRN,P001479,P006382,0 days 00:09:53,8,25,17
100,TRN,P006382,P012593,0 days 00:08:19,-3,11,14
100,TRN,P005738,P006382,0 days 00:07:54,8,21,13
100,TRN,P006382,P012595,0 days 00:07:02,9,22,13
100,TRN,P001479,P007828,0 days 00:07:00,-7,5,12
100,TRN,P007828,P012593,0 days 00:07:00,-7,5,12
100,TRN,P006382,P009903,0 days 00:06:43,-6,8,14
100,TRN,P006382,P012597,0 days 00:06:36,3,18,15
100,TRN,P005738,P007828,0 days 00:04:18,-3,2,5
100,TRN,P007828,P012595,0 days 00:02:44,-3,0,3
100,TRN,P007828,P009903,0 days 00:02:42,-4,3,7
100,TRN,P001479,P012687,0 days 00:02:25,3,7,4
100,TRN,P006382,P007828,0 days 00:02:21,0,2,2
100,TRN,P007828,P012597,0 days 00:01:53,-4,3,7
100,TRN,P012593,P012687,0 days 00:01:53,2,4,2
100,TRN,P006382,P012687,0 days 00:00:12,1,1,0
100,TRN,P007828,P012687,0 days 00:00:02,0,0,0
100,ULM,P005422,P012603,0 days 00:22:11,-3,55,58
100,ULM,P010106,P012604,0 days 00:17:55,-12,30,42
100,ULM,P012603,P012604,0 days 00:17:16,5,40,35
100,ULM,P005422,P010106,0 days 00:15:25,-18,31,49
100,ULM,P010106,P012603,0 days 00:15:25,-18,31,49
100,ULM,P010582,P012604,0 days 00:15:25,10,34,24
100,ULM,P010582,P012603,0 days 00:14:40,12,33,21
100,ULM,P012629,P012703,0 days 00:13:59,6,29,23
100,ULM,P012603,P012703,0 days 00:13:40,24,40,16
100,ULM,P012604,P012629,0 days 00:13:20,2,27,25
100,ULM,P005422,P012604,0 days 00:12:18,-7,26,33
100,ULM,P012603,P012629,0 days 00:12:06,6,31,25
100,ULM,P006997,P012603,0 days 00:11:49,1,31,30
100,ULM,P010106,P010726,0 days 00:11:01,-2,23,25
100,ULM,P012604,P012703,0 days 00:11:00,16,29,13
100,ULM,P005422,P010582,0 days 00:10:54,4,23,19
100,ULM,P006997,P012703,0 days 00:10:40,-3,20,23
100,ULM,P010106,P010582,0 days 00:09:59,-6,16,22
100,ULM,P005422,P006997,0 days 00:09:55,4,29,25
100,ULM,P010726,P012604,0 days 00:09:17,0,16,16
100,ULM,P006997,P012629,0 days 00:09:01,-6,15,21
100,ULM,P010582,P012703,0 days 00:08:50,17,23,6
100,ULM,P010726,P012603,0 days 00:08:00,-2,21,23
100,ULM,P010582,P012629,0 days 00:07:55,7,16,9
100,ULM,P011457,P012629,0 days 00:07:43,-1,9,10
100,ULM,P006997,P010726,0 days 00:07:21,-10,15,25
100,ULM,P010106,P011457,0 days 00:07:14,3,12,9
100,ULM,P011457,P012604,0 days 00:07:14,3,12,9
100,ULM,P005422,P012703,0 days 00:06:48,15,24,9
100,ULM,P010106,P012629,0 days 00:06:31,-5,11,16
100,ULM,P010726,P012703,0 days 00:06:17,-2,11,13
100,ULM,P010726,P012629,0 days 00:06:11,-2,7,9
100,ULM,P005422,P010726,0 days 00:06:05,-4,17,21
100,ULM,P011457,P012703,0 days 00:05:31,-2,7,9
100,ULM,P005422,P012629,0 days 00:05:14,-3,15,18
100,ULM,P010726,P011457,0 days 00:04:53,2,6,4
100,ULM,P006997,P010106,0 days 00:04:47,-3,13,16
100,ULM,P010582,P011457,0 days 00:04:06,-1,6,7
100,ULM,P006997,P010582,0 days 00:03:24,1,5,4
100,ULM,P006997,P011457,0 days 00:03:00,-3,2,5
100,ULM,P010106,P012703,0 days 00:02:31,1,5,4
100,ULM,P006997,P012604,0 days 00:01:51,-5,2,7
100,ULM,P011457,P012603,0 days 00:01:13,-1,2,3
100,ULM,P010582,P010726,0 days 00:00:03,0,0,0
100,ULM,P005422,P011457,0 days 00:00:02,0,0,0
101,PMT,P011943,P012600,0 days 00:23:45,12,51,39
101,PMT,P011943,P011966,0 days 00:21:37,19,53,34
101,PMT,P011966,P012600,0 days 00:17:48,12,45,33
101,PMT,P002644,P011966,0 days 00:17:20,19,45,26
101,PMT,P011823,P012600,0 days 00:16:51,10,42,32
101,PMT,P002644,P010549,0 days 00:16:40,12,40,28
101,PMT,P010549,P011966,0 days 00:16:35,28,49,21
101,PMT,P010549,P011943,0 days 00:16:30,21,37,16
101,PMT,P002644,P011947,0 days 00:15:24,16,37,21
101,PMT,P002644,P011943,0 days 00:15:21,10,31,21
101,PMT,P011823,P011943,0 days 00:14:46,14,36,22
101,PMT,P011947,P011966,0 days 00:14:19,19,44,25
101,PMT,P010549,P011947,0 days 00:13:57,15,32,17
101,PMT,P011944,P012600,0 days 00:13:09,-9,20,29
101,PMT,P011943,P011947,0 days 00:12:39,11,28,17
101,PMT,P002644,P012600,0 days 00:11:30,-6,17,23
101,PMT,P011943,P011944,0 days 00:11:29,6,22,16
101,PMT,P010549,P012600,0 days 00:10:19,6,21,15
101,PMT,P011823,P011944,0 days 00:10:00,-4,16,20
101,PMT,P011823,P011966,0 days 00:09:51,12,30,18
101,PMT,P011947,P012600,0 days 00:07:14,0,16,16
101,PMT,P001686,P011947,0 days 00:06:14,4,18,14
101,PMT,P002644,P011944,0 days 00:06:11,-5,8,13
101,PMT,P001686,P011944,0 days 00:05:58,-4,10,14
101,PMT,P001686,P010549,0 days 00:05:51,2,16,14
101,PMT,P001686,P002644,0 days 00:05:51,2,16,14
101,PMT,P010549,P011823,0 days 00:05:41,11,13,2
101,PMT,P001686,P012600,0 days 00:05:06,-1,12,13
101,PMT,P001686,P011823,0 days 00:04:55,2,12,10
101,PMT,P011944,P011966,0 days 00:04:54,-1,8,9
101,PMT,P001686,P011966,0 days 00:04:48,8,18,10
101,PMT,P001686,P011943,0 days 00:04:21,3,10,7
101,PMT,P011823,P011947,0 days 00:04:15,3,13,10
101,PMT,P010549,P011944,0 days 00:03:51,-3,4,7
101,PMT,P002020,P011942,0 days 00:03:05,-8,2,10
101,PMT,P002020,P011944,0 days 00:03:05,-8,2,10
101,PMT,P002020,P012600,0 days 00:03:05,-8,2,10
101,PMT,P011942,P011944,0 days 00:03:05,-8,2,10
101,PMT,P011942,P012600,0 days 00:03:05,-8,2,10
101,PMT,P011944,P011947,0 days 00:03:02,0,4,4
101,PMT,P002020,P011823,0 days 00:01:55,-5,2,7
101,PMT,P011823,P011942,0 days 00:01:55,-5,2,7
101,PMT,P002020,P002644,0 days 00:01:10,-3,0,3
101,PMT,P002644,P011942,0 days 00:01:10,-3,0,3
101,PMT,P002644,P011823,0 days 00:00:23,2,2,0
101,BES,P007914,P012622,0 days 00:21:47,5,47,42
101,BES,P011936,P012622,0 days 00:18:51,-3,36,39
101,BES,P003783,P007914,0 days 00:18:50,-12,30,42
101,BES,P008945,P012622,0 days 00:17:30,6,38,32
101,BES,P007914,P011936,0 days 00:15:11,1,30,29
101,BES,P011936,P012647,0 days 00:14:56,7,32,25
101,BES,P007914,P008945,0 days 00:14:24,14,34,20
101,BES,P003783,P012622,0 days 00:14:08,-11,23,34
101,BES,P012622,P012647,0 days 00:13:41,5,30,25
101,BES,P007914,P012647,0 days 00:13:26,6,26,20
101,BES,P007914,P011379,0 days 00:13:12,-7,23,30
101,BES,P011379,P012622,0 days 00:13:06,-11,20,31
101,BES,P008945,P011936,0 days 00:12:43,3,27,24
101,BES,P003783,P012647,0 days 00:12:07,-3,18,21
101,BES,P003783,P011924,0 days 00:11:56,-11,21,32
101,BES,P003783,P009582,0 days 00:11:22,-10,17,27
101,BES,P011924,P012622,0 days 00:10:16,-17,12,29
101,BES,P008945,P012647,0 days 00:09:55,12,23,11
101,BES,P008945,P011379,0 days 00:09:35,-9,14,23
101,BES,P003783,P011379,0 days 00:09:33,-5,17,22
101,BES,P003783,P011936,0 days 00:09:33,-8,11,19
101,BES,P009582,P012647,0 days 00:08:42,-6,9,15
101,BES,P011924,P012647,0 days 00:08:30,-7,13,20
101,BES,P009582,P011924,0 days 00:08:16,-10,15,25
101,BES,P007914,P009582,0 days 00:08:04,-8,10,18
101,BES,P011379,P011936,0 days 00:07:20,-12,6,18
101,BES,P011924,P011936,0 days 00:07:05,-6,8,14
101,BES,P007914,P011924,0 days 00:05:56,-6,11,17
101,BES,P003783,P008945,0 days 00:05:50,0,10,10
101,BES,P011379,P011924,0 days 00:05:26,-3,9,12
101,BES,P008945,P011924,0 days 00:05:16,-8,6,14
101,BES,P005348,P011924,0 days 00:04:57,-11,8,19
101,BES,P003783,P005348,0 days 00:04:51,-11,8,19
101,BES,P011357,P011924,0 days 00:03:50,-13,5,18
101,BES,P003783,P011357,0 days 00:03:50,-13,5,18
101,BES,P005348,P009582,0 days 00:03:32,-2,11,13
101,BES,P009582,P011936,0 days 00:03:25,-2,2,4
101,BES,P008945,P009582,0 days 00:03:17,3,5,2
101,BES,P005348,P011357,0 days 00:02:40,-9,3,12
101,BES,P009582,P011357,0 days 00:02:15,-7,5,12
101,BES,P005348,P012647,0 days 00:02:11,-2,5,7
101,BES,P009582,P011379,0 days 00:01:56,-1,3,4
101,BES,P005348,P012622,0 days 00:01:51,-3,3,6
101,BES,P009582,P012622,0 days 00:01:47,-1,3,4
101,BES,P011357,P012622,0 days 00:01:35,-6,0,6
101,BES,P007914,P011357,0 days 00:01:10,-4,2,6
101,BES,P005348,P007914,0 days 00:00:16,3,3,0
101,BES,P005348,P008945,0 days 00:00:10,3,3,0
102,JOV,P002507,P011247,0 days 00:18:41,0,32,32
102,JOV,P006771,P011248,0 days 00:18:28,2,37,35
102,JOV,P011247,P011248,0 days 00:16:29,5,33,28
102,JOV,P002507,P011248,0 days 00:16:08,6,30,24
102,JOV,P005094,P011247,0 days 00:14:32,-6,26,32
102,JOV,P011248,P012349,0 days 00:14:31,2,27,25
102,JOV,P002507,P012349,0 days 00:14:21,0,26,26
102,JOV,P011247,PJUG,0 days 00:13:52,-6,27,33
102,JOV,P002361,P011248,0 days 00:13:47,16,39,23
102,JOV,P006771,P012349,0 days 00:13:18,3,24,21
102,JOV,P011247,P012349,0 days 00:12:36,0,23,23
102,JOV,P002361,P010708,0 days 00:12:25,6,29,23
102,JOV,P002507,PJUG,0 days 00:11:24,2,23,21
102,JOV,P005094,PJUG,0 days 00:10:59,-7,18,25
102,JOV,P010708,P011248,0 days 00:10:58,4,27,23
102,JOV,P002361,P006771,0 days 00:10:37,10,28,18
102,JOV,P002507,P005094,0 days 00:10:37,-3,17,20
102,JOV,P006771,P011247,0 days 00:09:53,-7,15,22
102,JOV,P002361,P010458,0 days 00:09:45,9,26,17
102,JOV,P002507,P006771,0 days 00:09:39,5,18,13
102,JOV,P010458,P011247,0 days 00:09:08,-10,18,28
102,JOV,P010458,P011248,0 days 00:08:43,9,27,18
102,JOV,P006771,P010708,0 days 00:08:12,0,19,19
102,JOV,P010458,P010708,0 days 00:07:44,-1,17,18
102,JOV,P005094,P011248,0 days 00:07:27,6,17,11
102,JOV,P006771,P010458,0 days 00:07:12,0,19,19
102,JOV,P005094,P010458,0 days 00:07:07,-5,14,19
102,JOV,P002361,P012349,0 days 00:07:04,2,15,13
102,JOV,P012349,PJUG,0 days 00:06:59,2,17,15
102,JOV,P002361,P005094,0 days 00:06:18,0,13,13
102,JOV,P011248,PJUG,0 days 00:06:15,2,12,10
102,JOV,P010708,P012349,0 days 00:05:19,2,12,10
102,JOV,P002361,P002507,0 days 00:05:05,4,12,8
102,JOV,P010458,P012780,0 days 00:04:41,-6,10,16
102,JOV,P011247,P012780,0 days 00:04:41,-6,10,16
102,JOV,P002361,P011247,0 days 00:04:40,3,11,8
102,JOV,P005094,P012349,0 days 00:04:32,-3,8,11
102,JOV,P005094,P010708,0 days 00:04:06,-2,7,9
102,JOV,P010708,P011247,0 days 00:03:28,-5,5,10
102,JOV,P010458,PJUG,0 days 00:03:27,-6,7,13
102,JOV,P012780,PJUG,0 days 00:03:27,-6,7,13
102,JOV,P006771,P012780,0 days 00:02:39,-2,6,8
102,JOV,P002507,P010458,0 days 00:02:29,2,6,4
102,JOV,P005094,P012780,0 days 00:02:02,-4,4,8
102,JOV,P006771,PJUG,0 days 00:02:02,1,6,5
102,JOV,P011248,P012780,0 days 00:01:14,0,3,3
102,JOV,P002361,PJUG,0 days 00:00:59,2,3,1
102,LJU,P005969,P009395,0 days 00:32:10,1,64,63
102,LJU,P005969,P012700,0 days 00:30:00,6,62,56
102,LJU,P003452,P009395,0 days 00:28:59,3,62,59
102,LJU,P009395,P012700,0 days 00:28:52,7,60,53
102,LJU,P005969,P010594,0 days 00:27:40,-3,55,58
102,LJU,P003452,P012700,0 days 00:26:13,5,57,52
102,LJU,P003452,P005969,0 days 00:26:09,-1,53,54
102,LJU,P009395,P010594,0 days 00:24:09,-1,47,48
102,LJU,P010594,P012700,0 days 00:22:07,4,45,41
102,LJU,P003452,P010594,0 days 00:18:08,-3,36,39
102,LJU,P005969,P011261,0 days 00:11:12,-4,21,25
102,LJU,P010594,P011261,0 days 00:11:12,-4,21,25
102,LJU,P009395,P011261,0 days 00:11:06,-7,16,23
102,LJU,P009395,P012598,0 days 00:10:23,3,24,21
102,LJU,P005969,P012598,0 days 00:09:35,2,23,21
102,LJU,P003452,P012598,0 days 00:08:30,-2,16,18
102,LJU,P012598,P012700,0 days 00:08:28,1,21,20
102,LJU,P011261,P012598,0 days 00:07:20,3,19,16
102,LJU,P010594,P012598,0 days 00:06:53,-2,16,18
102,LJU,P011261,P012700,0 days 00:06:10,0,11,11
102,LJU,P009392,P009395,0 days 00:05:29,-5,10,15
102,LJU,P003452,P009392,0 days 00:05:29,-5,10,15
102,LJU,P005969,P009392,0 days 00:05:29,-5,10,15
102,LJU,P009392,P012700,0 days 00:05:19,-2,10,12
102,LJU,P002561,P003452,0 days 00:04:48,-1,9,10
102,LJU,P002561,P009395,0 days 00:04:48,-1,9,10
102,LJU,P002561,P012598,0 days 00:04:27,-1,9,10
102,LJU,P003452,P011261,0 days 00:03:36,-4,5,9
102,LJU,P002561,P012700,0 days 00:02:23,-1,6,7
102,LJU,P002561,P011261,0 days 00:01:56,0,3,3
102,LJU,P002561,P005969,0 days 00:00:29,0,0,0
102,LJU,P002561,P010594,0 days 00:00:21,0,0,0
102,LJU,P009392,P010594,0 days 00:00:10,-3,0,3
103,WOL,P005516,P012576,0 days 00:26:01,7,60,53
103,WOL,P012576,P012577,0 days 00:24:11,-5,44,49
103,WOL,P002387,P006546,0 days 00:21:56,1,53,52
103,WOL,P005516,P012577,0 days 00:20:14,4,40,36
103,WOL,P002387,P005516,0 days 00:17:42,5,45,40
103,WOL,P003212,P006546,0 days 00:16:52,-15,32,47
103,WOL,P005516,P006546,0 days 00:16:36,12,47,35
103,WOL,P002387,P003212,0 days 00:16:22,-10,32,42
103,WOL,P006546,P012576,0 days 00:16:09,3,44,41
103,WOL,P002387,P012576,0 days 00:15:37,0,41,41
103,WOL,P005516,P006154,0 days 00:13:36,-2,22,24
103,WOL,P006154,P012576,0 days 00:13:30,-3,23,26
103,WOL,P006154,P012577,0 days 00:12:57,-3,21,24
103,WOL,P003212,P012576,0 days 00:12:42,-8,25,33
103,WOL,P004645,P012577,0 days 00:12:35,-3,19,22
103,WOL,P004645,P012576,0 days 00:12:35,-3,19,22
103,WOL,P003212,P005516,0 days 00:11:17,2,27,25
103,WOL,P006546,P012577,0 days 00:11:08,-4,25,29
103,WOL,P004645,P005516,0 days 00:10:57,1,18,17
103,WOL,P002387,P012577,0 days 00:10:53,-10,22,32
103,WOL,P006546,P012789,0 days 00:09:29,-6,15,21
103,WOL,P002387,P012789,0 days 00:09:29,-6,15,21
103,WOL,P004645,P006154,0 days 00:09:10,-2,13,15
103,WOL,P003212,P012577,0 days 00:08:43,-11,14,25
103,WOL,P003212,P012789,0 days 00:07:37,-5,14,19
103,WOL,P005516,P012789,0 days 00:04:57,0,9,9
103,WOL,P002387,P006154,0 days 00:04:45,-2,8,10
103,WOL,P003212,P006154,0 days 00:04:23,6,11,5
103,WOL,P006546,PLCT,0 days 00:03:57,-5,8,13
103,WOL,P002387,PLCT,0 days 00:03:40,-2,8,10
103,WOL,P004645,P006546,0 days 00:03:25,-1,6,7
103,WOL,P006154,P006546,0 days 00:03:00,3,6,3
103,WOL,P012789,PLCT,0 days 00:02:38,-6,0,6
103,WOL,P005516,PLCT,0 days 00:02:32,-1,8,9
103,WOL,P006154,P012789,0 days 00:02:27,3,4,1
103,WOL,P003212,PLCT,0 days 00:01:42,-7,0,7
103,WOL,P003212,P004645,0 days 00:01:38,-4,1,5
103,WOL,P012577,P012789,0 days 00:01:19,-4,3,7
103,WOL,P012576,PLCT,0 days 00:01:19,1,8,7
103,HTA,P010465,P011991,0 days 00:29:48,18,72,54
103,HTA,P007759,P011991,0 days 00:23:58,13,54,41
103,HTA,P007759,P010465,0 days 00:21:51,16,50,34
103,HTA,P006835,P011991,0 days 00:21:24,11,55,44
103,HTA,P010550,P011991,0 days 00:19:37,7,42,35
103,HTA,P006835,P010465,0 days 00:19:28,19,56,37
103,HTA,P010465,P010550,0 days 00:17:54,4,37,33
103,HTA,P011973,P011991,0 days 00:17:23,-2,36,38
103,HTA,P007759,P010550,0 days 00:16:38,1,29,28
103,HTA,P004846,P006835,0 days 00:14:47,7,40,33
103,HTA,P006835,P007759,0 days 00:14:30,3,34,31
103,HTA,P007759,P011973,0 days 00:14:25,-2,28,30
103,HTA,P010465,P011973,0 days 00:14:05,-1,27,28
103,HTA,P004846,P010465,0 days 00:13:23,11,41,30
103,HTA,P004846,P011991,0 days 00:13:03,9,36,27
103,HTA,P010550,P011973,0 days 00:12:56,2,24,22
103,HTA,P004267,P007759,0 days 00:12:38,-3,26,29
103,HTA,P004267,P006835,0 days 00:10:09,-2,21,23
103,HTA,P004267,P011991,0 days 00:10:09,6,25,19
103,HTA,P004846,P010550,0 days 00:08:36,-4,17,21
103,HTA,P003533,P004846,0 days 00:08:27,-8,12,20
103,HTA,P004846,P007759,0 days 00:07:45,0,17,17
103,HTA,P006835,P010550,0 days 00:06:41,5,18,13
103,HTA,P004267,P010465,0 days 00:06:00,7,16,9
103,HTA,P003533,P006835,0 days 00:05:41,-6,8,14
103,HTA,P003533,P007759,0 days 00:05:35,-4,10,14
103,HTA,P006835,P011973,0 days 00:04:32,-5,12,17
103,HTA,P004267,P004846,0 days 00:04:31,-5,5,10
103,HTA,P003533,P004267,0 days 00:04:16,-6,3,9
103,HTA,P003533,P010465,0 days 00:04:11,-2,9,11
103,HTA,P004267,P010550,0 days 00:03:30,1,7,6
103,HTA,P004267,P011973,0 days 00:03:23,-2,9,11
103,HTA,P003533,P011991,0 days 00:03:10,-2,4,6
103,HTA,P004846,P011973,0 days 00:03:08,-2,8,10
103,HTA,P003533,P010550,0 days 00:02:28,-4,2,6
104,PRS,P012608,P012610,0 days 00:23:22,7,52,45
104,PRS,P005793,P012610,0 days 00:17:37,3,41,38
104,PRS,P005793,P012608,0 days 00:17:33,5,41,36
104,PRS,P012613,P012640,0 days 00:17:28,29,60,31
104,PRS,P009556,P011232,0 days 00:16:34,25,48,23
104,PRS,P004512,P012610,0 days 00:14:54,-5,28,33
104,PRS,P004512,P012608,0 days 00:14:50,-3,28,31
104,PRS,P011232,P012613,0 days 00:13:56,25,46,21
104,PRS,P011232,P012640,0 days 00:12:37,22,43,21
104,PRS,P009556,P012640,0 days 00:12:37,22,43,21
104,PRS,P009556,P012613,0 days 00:11:52,21,40,19
104,PRS,P011232,P012609,0 days 00:11:19,22,43,21
104,PRS,P012609,P012640,0 days 00:11:15,24,43,19
104,PRS,P009556,P012609,0 days 00:11:15,24,43,19
104,PRS,P012608,P012613,0 days 00:11:05,12,32,20
104,PRS,P012610,P012613,0 days 00:11:05,12,32,20
104,PRS,P004512,P005793,0 days 00:10:05,-7,18,25
104,PRS,P005793,P012609,0 days 00:09:53,-5,13,18
104,PRS,P012609,P012610,0 days 00:09:53,-5,13,18
104,PRS,P012609,P012613,0 days 00:09:50,21,38,17
104,PRS,P012608,P012609,0 days 00:09:49,-3,13,16
104,PRS,P004512,P012609,0 days 00:07:37,-5,11,16
104,PRS,P009556,P010801,0 days 00:06:44,4,10,6
104,PRS,P010801,P011232,0 days 00:06:44,4,10,6
104,PRS,P012608,P012640,0 days 00:06:16,10,22,12
104,PRS,P012610,P012640,0 days 00:06:16,10,22,12
104,PRS,P005793,P012640,0 days 00:05:16,10,21,11
104,PRS,P005793,P012613,0 days 00:05:16,10,21,11
104,PRS,P004512,P012613,0 days 00:04:49,2,10,8
104,PRS,P011232,P011551,0 days 00:03:57,3,5,2
104,PRS,P011551,P011887,0 days 00:03:57,3,5,2
104,PRS,P011232,P011887,0 days 00:03:57,3,5,2
104,PRS,P009556,P011551,0 days 00:03:57,3,5,2
104,PRS,P010801,P011887,0 days 00:03:57,3,5,2
104,PRS,P009556,P011887,0 days 00:03:57,3,5,2
104,PRS,P010801,P011551,0 days 00:03:57,3,5,2
104,PRS,P004512,P011887,0 days 00:03:53,-8,7,15
104,PRS,P011887,P012608,0 days 00:03:53,-8,7,15
104,PRS,P011887,P012610,0 days 00:03:53,-8,7,15
104,PRS,P010801,P012640,0 days 00:03:47,1,6,5
104,PRS,P010801,P012609,0 days 00:03:41,3,7,4
104,PRS,P010801,P012608,0 days 00:03:16,0,3,3
104,PRS,P010801,P012610,0 days 00:03:16,0,3,3
104,PRS,P004512,P011232,0 days 00:02:48,4,8,4
104,PRS,P011232,P012610,0 days 00:02:48,4,8,4
104,PRS,P011232,P012608,0 days 00:02:44,6,8,2
104,PRS,P005793,P011887,0 days 00:02:28,-2,7,9
104,PRS,P010801,P012613,0 days 00:02:22,-2,1,3
104,PRS,P005793,P010801,0 days 00:02:16,0,2,2
104,PRS,P011887,P012613,0 days 00:01:25,-6,0,6
104,PRS,P004512,P009556,0 days 00:00:40,2,2,0
104,PRS,P009556,P012608,0 days 00:00:40,2,2,0
104,PRS,P009556,P012610,0 days 00:00:40,2,2,0
104,PRS,P005793,P011232,0 days 00:00:04,-2,0,2
104,VNC,P011928,P012591,0 days 00:27:14,-25,44,69
104,VNC,P011909,P011928,0 days 00:23:17,-17,37,54
104,VNC,P011928,P012590,0 days 00:22:23,-23,36,59
104,VNC,P011909,P012590,0 days 00:20:28,-14,31,45
104,VNC,P011909,P012591,0 days 00:19:58,-16,29,45
104,VNC,P012587,P012590,0 days 00:18:13,-10,36,46
104,VNC,P012590,P012591,0 days 00:18:01,-20,25,45
104,VNC,P004381,P011928,0 days 00:15:26,-18,26,44
104,VNC,P004381,P011909,0 days 00:14:51,-17,24,41
104,VNC,P008052,P011909,0 days 00:13:55,-6,28,34
104,VNC,P009400,P012590,0 days 00:13:26,-8,27,35
104,VNC,P008052,P012590,0 days 00:12:46,-5,26,31
104,VNC,P011909,P012587,0 days 00:12:36,1,24,23
104,VNC,P004381,P012591,0 days 00:12:32,-11,23,34
104,VNC,P011928,P012587,0 days 00:12:30,-9,24,33
104,VNC,P003759,P011909,0 days 00:12:16,-8,20,28
104,VNC,P003759,P012591,0 days 00:11:43,-2,22,24
104,VNC,P003759,P011928,0 days 00:11:43,-2,22,24
104,VNC,P009400,P011928,0 days 00:10:17,-12,18,30
104,VNC,P009400,P012591,0 days 00:10:14,-10,16,26
104,VNC,P012587,P012591,0 days 00:10:02,-13,15,28
104,VNC,P003759,P004381,0 days 00:09:58,-5,19,24
104,VNC,P008052,P012587,0 days 00:08:11,3,21,18
104,VNC,P003759,P012590,0 days 00:07:57,-6,12,18
104,VNC,P009400,P012587,0 days 00:07:46,-7,20,27
104,VNC,P008052,P011928,0 days 00:07:34,-6,17,23
104,VNC,P004381,P012590,0 days 00:05:54,-14,7,21
104,VNC,P004381,P008052,0 days 00:05:47,-11,9,20
104,VNC,P009400,P011909,0 days 00:05:23,1,11,10
104,VNC,P003759,P008052,0 days 00:04:15,-6,5,11
104,VNC,P008052,P009400,0 days 00:04:12,2,12,10
104,VNC,P003759,P012587,0 days 00:03:34,-5,4,9
104,VNC,P008052,P012591,0 days 00:03:12,-3,6,9
104,VNC,P003759,P009400,0 days 00:02:26,2,4,2
105,LLI,P006600,P009680,0 days 00:27:07,-2,56,58
105,LLI,P006600,P009649,0 days 00:22:52,-9,41,50
105,LLI,P009649,P009680,0 days 00:22:49,-5,43,48
105,LLI,P009680,P012585,0 days 00:21:14,-7,42,49
105,LLI,P006600,P012585,0 days 00:20:32,-7,40,47
105,LLI,P009672,P009680,0 days 00:20:20,6,50,44
105,LLI,P009649,P012585,0 days 00:19:11,-7,39,46
105,LLI,P004773,P005247,0 days 00:18:45,5,39,34
105,LLI,P006600,P009672,0 days 00:18:28,8,48,40
105,LLI,P009672,P012585,0 days 00:16:12,5,38,33
105,LLI,P009649,P009672,0 days 00:14:10,5,35,30
105,LLI,P005247,P009680,0 days 00:12:25,5,26,21
105,LLI,P005247,P012020,0 days 00:11:26,4,23,19
105,LLI,P004773,P012020,0 days 00:11:26,4,23,19
105,LLI,P004773,P009680,0 days 00:11:13,-3,23,26
105,LLI,P005247,P008274,0 days 00:11:01,2,23,21
105,LLI,P004773,P008274,0 days 00:11:01,2,23,21
105,LLI,P005247,P009672,0 days 00:10:42,0,24,24
105,LLI,P008274,P012020,0 days 00:10:16,6,23,17
105,LLI,P005247,P006600,0 days 00:09:23,1,19,18
105,LLI,P004773,P009672,0 days 00:08:38,0,21,21
105,LLI,P004773,P009649,0 days 00:08:22,-5,11,16
105,LLI,P004773,P006600,0 days 00:08:11,-7,16,23
105,LLI,P008274,P009649,0 days 00:08:03,-3,11,14
105,LLI,P005247,P009649,0 days 00:07:31,3,11,8
105,LLI,P008274,P009680,0 days 00:06:47,-2,11,13
105,LLI,P009672,P012020,0 days 00:06:23,-3,11,14
105,LLI,P006600,P008274,0 days 00:04:55,-8,4,12
105,LLI,P008274,P009672,0 days 00:04:31,-1,9,10
105,LLI,P009680,P012020,0 days 00:04:29,0,9,9
105,LLI,P008274,P012585,0 days 00:04:10,-4,4,8
105,LLI,P009649,P012020,0 days 00:03:50,5,9,4
105,LLI,P005247,P012585,0 days 00:02:03,0,3,3
105,LLI,P004773,P012585,0 days 00:00:52,-8,0,8
105,LLI,P012020,P012585,0 days 00:00:42,0,2,2
105,HAM,P009663,P012582,0 days 00:22:49,12,55,43
105,HAM,P012581,P012582,0 days 00:21:12,15,48,33
105,HAM,P012580,P012582,0 days 00:20:32,3,43,40
105,HAM,P009663,P012581,0 days 00:20:10,14,50,36
105,HAM,P011168,P012582,0 days 00:18:08,12,33,21
105,HAM,P009663,P012580,0 days 00:17:34,2,36,34
105,HAM,P011168,P012581,0 days 00:17:06,7,29,22
105,HAM,P012580,P012581,0 days 00:15:48,3,29,26
105,HAM,P011168,P012580,0 days 00:14:32,10,28,18
105,HAM,P011187,P012579,0 days 00:14:28,-5,26,31
105,HAM,P009663,P011168,0 days 00:14:25,14,31,17
105,HAM,P011168,P012579,0 days 00:12:11,1,22,21
105,HAM,P011168,P011187,0 days 00:10:46,-5,15,20
105,HAM,P010070,P012579,0 days 00:10:34,-9,17,26
105,HAM,P001990,P012582,0 days 00:09:42,7,33,26
105,HAM,P010070,P011187,0 days 00:09:21,-6,15,21
105,HAM,P012579,P012582,0 days 00:09:01,9,24,15
105,HAM,P001990,P009663,0 days 00:08:45,1,26,25
105,HAM,P001990,P012580,0 days 00:08:21,-6,19,25
105,HAM,P012579,P012581,0 days 00:07:38,2,17,15
105,HAM,P001990,P012579,0 days 00:07:13,1,19,18
105,HAM,P001990,P012581,0 days 00:07:11,4,23,19
105,HAM,P012579,P012648,0 days 00:07:05,0,13,13
105,HAM,P012582,P012648,0 days 00:06:39,-1,17,18
105,HAM,P011168,P012648,0 days 00:06:33,0,13,13
105,HAM,P011187,P012648,0 days 00:06:29,2,13,11
105,HAM,P010070,P011168,0 days 00:06:19,-1,13,14
105,HAM,P011187,P012582,0 days 00:05:53,1,11,10
105,HAM,P009663,P012579,0 days 00:05:51,3,15,12
105,HAM,P011187,P012580,0 days 00:05:49,-2,11,13
105,HAM,P012579,P012580,0 days 00:05:03,-2,11,13
105,HAM,P001990,P011187,0 days 00:04:39,0,11,11
105,HAM,P011187,P012581,0 days 00:04:37,-7,2,9
105,HAM,P009663,P012648,0 days 00:04:29,-1,13,14
105,HAM,P010070,P012648,0 days 00:04:19,2,9,7
105,HAM,P001990,P012648,0 days 00:04:03,3,13,10
105,HAM,P001990,P010070,0 days 00:03:42,-6,4,10
105,HAM,P010070,P012580,0 days 00:02:51,-3,4,7
105,HAM,P010070,P012581,0 days 00:02:51,-6,4,10
105,HAM,P012580,P012648,0 days 00:02:32,-1,7,8
105,HAM,P012581,P012648,0 days 00:01:21,2,6,4
105,HAM,P011187,P012694,0 days 00:01:17,-4,0,4
105,HAM,P012579,P012694,0 days 00:01:17,-4,0,4
105,HAM,P009663,P010070,0 days 00:01:13,-3,2,5
105,HAM,P012579,P012695,0 days 00:00:55,-4,0,4
105,HAM,P009663,P012695,0 days 00:00:52,-6,0,6
105,HAM,P012582,P012695,0 days 00:00:52,-6,0,6
105,HAM,P011168,P012694,0 days 00:00:44,-2,0,2
105,HAM,P012581,P012694,0 days 00:00:44,-2,0,2
105,HAM,P010070,P012694,0 days 00:00:33,-2,0,2
105,HAM,P010070,P012695,0 days 00:00:33,-2,0,2
105,HAM,P011187,P012695,0 days 00:00:33,-2,0,2
105,HAM,P012694,P012695,0 days 00:00:33,-2,0,2
105,HAM,P012580,P012695,0 days 00:00:30,-4,0,4
105,HAM,P012581,P012695,0 days 00:00:30,-4,0,4
105,HAM,P012648,P012695,0 days 00:00:22,-2,0,2
106,BOU,P010718,P011836,0 days 00:18:01,9,33,24
106,BOU,P010718,P012617,0 days 00:17:08,8,27,19
106,BOU,P010431,P012617,0 days 00:16:49,12,33,21
106,BOU,P011161,P012618,0 days 00:15:54,1,37,36
106,BOU,P011836,P012617,0 days 00:15:31,8,24,16
106,BOU,P010431,P010718,0 days 00:15:22,13,31,18
106,BOU,P000498,P011161,0 days 00:14:29,6,32,26
106,BOU,P011837,P012617,0 days 00:14:17,5,23,18
106,BOU,P004525,P010450,0 days 00:14:09,11,31,20
106,BOU,P010450,P011161,0 days 00:13:59,0,27,27
106,BOU,P010431,P011837,0 days 00:12:38,10,23,13
106,BOU,P010718,P011837,0 days 00:12:23,6,19,13
106,BOU,P004525,P011161,0 days 00:11:54,8,25,17
106,BOU,P010431,P011836,0 days 00:11:48,8,22,14
106,BOU,P000498,P010450,0 days 00:11:27,11,25,14
106,BOU,P011161,P011836,0 days 00:11:17,-8,21,29
106,BOU,P011836,P011837,0 days 00:10:57,4,14,10
106,BOU,P011836,P012618,0 days 00:10:33,-2,25,27
106,BOU,P000498,P004525,0 days 00:10:05,10,21,11
106,BOU,P010718,P012618,0 days 00:09:16,6,23,17
106,BOU,P010718,P011161,0 days 00:09:12,0,19,19
106,BOU,P000498,P012618,0 days 00:08:51,2,23,21
106,BOU,P004525,P010431,0 days 00:08:00,3,19,16
106,BOU,P010450,P012618,0 days 00:07:56,-1,18,19
106,BOU,P004525,P012617,0 days 00:07:01,-1,15,16
106,BOU,P004525,P012618,0 days 00:06:39,7,16,9
106,BOU,P004525,P011837,0 days 00:06:34,3,14,11
106,BOU,P011161,P012617,0 days 00:05:43,-5,6,11
106,BOU,P010450,P012617,0 days 00:05:24,-1,12,13
106,BOU,P012617,P012618,0 days 00:05:22,4,10,6
106,BOU,P004525,P012619,0 days 00:05:17,0,10,10
106,BOU,P010450,P011837,0 days 00:05:08,1,9,8
106,BOU,P011161,P011837,0 days 00:04:53,-3,5,8
106,BOU,P010450,P012619,0 days 00:04:34,4,10,6
106,BOU,P010431,P010450,0 days 00:04:26,-2,10,12
106,BOU,P000498,P011836,0 days 00:04:24,-4,11,15
106,BOU,P004525,P010718,0 days 00:04:21,-1,9,10
106,BOU,P010431,P012618,0 days 00:04:17,3,12,9
106,BOU,P010450,P011836,0 days 00:03:29,-7,6,13
106,BOU,P000498,P011837,0 days 00:03:14,2,5,3
106,BOU,P000498,P010718,0 days 00:03:02,-5,7,12
106,BOU,P010431,P011161,0 days 00:02:59,-1,8,9
106,BOU,P010431,P012619,0 days 00:02:53,-2,6,8
106,BOU,P012617,P012619,0 days 00:02:53,-2,6,8
106,BOU,P000498,P012619,0 days 00:02:24,2,4,2
106,BOU,P011161,P012619,0 days 00:02:24,2,4,2
106,BOU,P010718,P012619,0 days 00:00:43,-4,0,4
106,TRN,P009903,P012597,0 days 00:21:24,-10,27,37
106,TRN,P012595,P012597,0 days 00:19:13,4,32,28
106,TRN,P009903,P012595,0 days 00:19:12,-10,24,34
106,TRN,P005738,P012597,0 days 00:16:51,11,36,25
106,TRN,P005059,P012595,0 days 00:16:24,-1,27,28
106,TRN,P005738,P009903,0 days 00:16:19,-5,24,29
106,TRN,P005738,P012594,0 days 00:16:11,-11,25,36
106,TRN,P001479,P012595,0 days 00:14:32,-9,22,31
106,TRN,P005059,P012597,0 days 00:14:08,1,21,20
106,TRN,P012593,P012596,0 days 00:12:55,-5,26,31
106,TRN,P005738,P012595,0 days 00:12:40,8,27,19
106,TRN,P005059,P009903,0 days 00:11:45,-7,11,18
106,TRN,P005738,P012593,0 days 00:11:32,-6,18,24
106,TRN,P009903,P012594,0 days 00:11:31,-7,17,24
106,TRN,P001479,P005059,0 days 00:11:08,-9,13,22
106,TRN,P005738,P006382,0 days 00:10:44,-12,12,24
106,TRN,P012593,P012595,0 days 00:09:46,-8,20,28
106,TRN,P012594,P012597,0 days 00:09:40,1,19,18
106,TRN,P005738,P012596,0 days 00:09:04,4,21,17
106,TRN,P006382,P012594,0 days 00:08:40,-10,9,19
106,TRN,P001479,P009903,0 days 00:08:39,-10,7,17
106,TRN,P001479,P012597,0 days 00:08:39,-10,7,17
106,TRN,P005059,P005738,0 days 00:08:11,7,17,10
106,TRN,P012595,P012596,0 days 00:08:05,7,25,18
106,TRN,P012593,P012594,0 days 00:07:56,-8,12,20
106,TRN,P005059,P012596,0 days 00:07:39,3,19,16
106,TRN,P012594,P012595,0 days 00:06:50,-5,10,15
106,TRN,P001479,P012593,0 days 00:06:34,-3,15,18
106,TRN,P006382,P012593,0 days 00:06:31,-8,7,15
106,TRN,P005059,P012593,0 days 00:06:12,-6,9,15
106,TRN,P001479,P012596,0 days 00:05:53,1,15,14
106,TRN,P006382,P009903,0 days 00:05:46,-5,7,12
106,TRN,P009903,P012593,0 days 00:05:16,-6,7,13
106,TRN,P006382,P012596,0 days 00:05:03,-9,5,14
106,TRN,P012594,P012596,0 days 00:05:02,-4,8,12
106,TRN,P006382,P012597,0 days 00:04:18,-6,5,11
106,TRN,P012596,P012597,0 days 00:04:06,11,16,5
106,TRN,P012593,P012597,0 days 00:03:41,2,9,7
106,TRN,P001479,P007828,0 days 00:02:21,4,9,5
106,TRN,P007828,P012593,0 days 00:02:21,4,9,5
106,TRN,P007828,P012595,0 days 00:02:21,4,9,5
106,TRN,P007828,P012596,0 days 00:02:21,4,9,5
106,TRN,P005059,P006382,0 days 00:02:09,-4,3,7
106,TRN,P001479,P012594,0 days 00:00:22,0,0,0
106,TRN,P006382,P012595,0 days 00:00:05,-2,0,2
107,ULM,P010582,P012604,0 days 00:28:32,16,74,58
107,ULM,P010106,P012604,0 days 00:27:24,-2,61,63
107,ULM,P005422,P012604,0 days 00:26:52,-5,57,62
107,ULM,P005422,P010106,0 days 00:25:43,-1,60,61
107,ULM,P012603,P012604,0 days 00:23:18,2,59,57
107,ULM,P010582,P012603,0 days 00:22:20,20,65,45
107,ULM,P010106,P010582,0 days 00:21:37,12,59,47
107,ULM,P010106,P012603,0 days 00:21:21,1,57,56
107,ULM,P005422,P010582,0 days 00:21:17,9,55,46
107,ULM,P005422,P012603,0 days 00:20:31,-6,50,56
107,ULM,P005422,P006997,0 days 00:11:57,-1,21,22
107,ULM,P012603,P012703,0 days 00:11:42,9,27,18
107,ULM,P006997,P012604,0 days 00:11:24,-3,17,20
107,ULM,P006997,P010106,0 days 00:11:01,-1,19,20
107,ULM,P005422,P012703,0 days 00:10:00,-5,16,21
107,ULM,P010582,P012703,0 days 00:09:50,10,23,13
107,ULM,P012604,P012703,0 days 00:09:49,2,17,15
107,ULM,P010582,P011457,0 days 00:09:40,13,27,14
107,ULM,P011457,P012603,0 days 00:09:25,9,28,19
107,ULM,P006997,P010582,0 days 00:08:52,2,17,15
107,ULM,P007952,P012703,0 days 00:08:24,4,20,16
107,ULM,P011457,P012703,0 days 00:07:58,11,21,10
107,ULM,P011457,P012604,0 days 00:07:58,1,19,18
107,ULM,P005422,P010726,0 days 00:07:18,-12,10,22
107,ULM,P010106,P011457,0 days 00:06:39,-1,17,18
107,ULM,P006997,P012703,0 days 00:06:31,-3,10,13
107,ULM,P007952,P012603,0 days 00:06:15,6,18,12
107,ULM,P010106,P012703,0 days 00:05:58,-1,10,11
107,ULM,P005422,P007952,0 days 00:05:36,-2,14,16
107,ULM,P007952,P010106,0 days 00:04:58,2,15,13
107,ULM,P007952,P011457,0 days 00:04:57,5,14,9
107,ULM,P010106,P010726,0 days 00:04:47,-9,6,15
107,ULM,P006997,P010726,0 days 00:04:30,-6,6,12
107,ULM,P007952,P010726,0 days 00:04:19,0,10,10
107,ULM,P006997,P007952,0 days 00:04:03,-1,9,10
107,ULM,P010726,P012604,0 days 00:03:31,-15,0,15
107,ULM,P006997,P011457,0 days 00:03:30,-3,5,8
107,ULM,P010726,P012603,0 days 00:03:20,-9,4,13
107,ULM,P010726,P012703,0 days 00:02:40,-3,4,7
107,ULM,P007952,P010582,0 days 00:02:40,6,8,2
107,ULM,P010726,P011457,0 days 00:00:55,-6,0,6
107,ULM,P005422,P011457,0 days 00:00:38,-5,1,6
107,CAN,P008121,P009864,0 days 00:20:57,-4,45,49
107,CAN,P008121,P010452,0 days 00:18:54,-7,34,41
107,CAN,P001607,P008121,0 days 00:17:16,11,43,32
107,CAN,P003637,P008121,0 days 00:16:00,4,38,34
107,CAN,P005005,P010385,0 days 00:15:55,-7,34,41
107,CAN,P001607,P003637,0 days 00:14:23,1,36,35
107,CAN,P001607,P009864,0 days 00:14:11,3,34,31
107,CAN,P003637,P010452,0 days 00:14:05,-3,25,28
107,CAN,P003637,P010385,0 days 00:14:01,0,29,29
107,CAN,P009864,P010452,0 days 00:13:41,-11,22,33
107,CAN,P003425,P010452,0 days 00:13:04,-17,16,33
107,CAN,P004160,P006588,0 days 00:13:04,10,35,25
107,CAN,P001607,P010452,0 days 00:12:36,-4,23,27
107,CAN,P001607,P010385,0 days 00:10:49,4,26,22
107,CAN,P003425,P010385,0 days 00:10:26,-7,20,27
107,CAN,P004160,P005005,0 days 00:10:02,0,25,25
107,CAN,P003425,P008121,0 days 00:09:59,-15,11,26
107,CAN,P010385,P010452,0 days 00:09:36,-3,17,20
107,CAN,P001607,P006588,0 days 00:09:29,13,30,17
107,CAN,P005005,P006588,0 days 00:09:28,2,25,23
107,CAN,P003425,P005005,0 days 00:09:07,-3,20,23
107,CAN,P004160,P010385,0 days 00:09:03,0,22,22
107,CAN,P003637,P009864,0 days 00:08:43,-3,21,24
107,CAN,P006588,P010385,0 days 00:08:39,2,22,20
107,CAN,P007560,P008121,0 days 00:08:34,1,22,21
107,CAN,P003425,P009864,0 days 00:08:32,-11,11,22
107,CAN,P006588,P009864,0 days 00:07:51,9,26,17
107,CAN,P001607,P005005,0 days 00:07:44,-4,17,21
107,CAN,P003425,P004160,0 days 00:07:23,-6,15,21
107,CAN,P008121,P010385,0 days 00:07:17,7,17,10
107,CAN,P006588,P008121,0 days 00:07:02,9,23,14
107,CAN,P003637,P005005,0 days 00:06:52,-7,12,19
107,CAN,P001607,P004160,0 days 00:06:50,13,20,7
107,CAN,P007560,P009864,0 days 00:06:48,-2,17,19
107,CAN,P003425,P006588,0 days 00:05:46,-1,15,16
107,CAN,P004160,P009864,0 days 00:05:38,5,13,8
107,CAN,P003425,P003637,0 days 00:05:24,-6,6,12
107,CAN,P007560,P010452,0 days 00:05:12,1,14,13
107,CAN,P003637,P007644,0 days 00:05:05,-1,12,13
107,CAN,P007644,P010385,0 days 00:04:41,1,12,11
107,CAN,P004160,P008121,0 days 00:04:39,5,10,5
107,CAN,P005005,P010452,0 days 00:04:23,-7,5,12
107,CAN,P003425,P007560,0 days 00:03:48,1,10,9
107,CAN,P003637,P006588,0 days 00:03:26,1,13,12
107,CAN,P003637,P007560,0 days 00:02:57,2,8,6
107,CAN,P005005,P007644,0 days 00:02:55,-2,7,9
107,CAN,P001607,P007644,0 days 00:02:55,-2,7,9
107,CAN,P001607,P003425,0 days 00:02:23,-7,0,7
107,CAN,P007644,P008121,0 days 00:02:10,1,5,4
107,CAN,P007560,P007644,0 days 00:02:10,1,5,4
107,CAN,P007560,P010385,0 days 00:01:49,3,5,2
107,CAN,P004160,P010452,0 days 00:01:37,-5,0,5
107,CAN,P001607,P007560,0 days 00:01:24,0,4,4
107,CAN,P006588,P007560,0 days 00:01:15,-1,3,4
107,CAN,P005005,P009864,0 days 00:00:59,0,3,3
107,CAN,P004160,P007560,0 days 00:00:28,-2,0,2
107,CAN,P007644,P009864,0 days 00:00:24,-2,0,2
107,CAN,P005005,P008121,0 days 00:00:08,0,0,0
107,CAN,P005005,P007560,0 days 00:00:03,0,0,0
108,ARI,P003240,P004292,0 days 00:18:03,12,36,24
108,ARI,P003240,P012708,0 days 00:16:30,9,35,26
108,ARI,P012707,P012716,0 days 00:15:30,3,24,21
108,ARI,P003240,P012717,0 days 00:15:17,-4,22,26
108,ARI,P004292,P012717,0 days 00:15:07,-5,23,28
108,ARI,P003240,P012702,0 days 00:14:39,17,34,17
108,ARI,P004292,P012708,0 days 00:14:02,11,35,24
108,ARI,P012708,P012717,0 days 00:13:46,-5,24,29
108,ARI,P012702,P012716,0 days 00:13:19,7,31,24
108,ARI,P004292,P012702,0 days 00:13:14,9,33,24
108,ARI,P003240,P012716,0 days 00:13:10,10,25,15
108,ARI,P012616,P012716,0 days 00:13:06,3,19,16
108,ARI,P003240,P012707,0 days 00:12:41,-1,18,19
108,ARI,P012616,P012707,0 days 00:12:28,0,16,16
108,ARI,P012708,P012716,0 days 00:12:19,14,29,15
108,ARI,P004292,P012716,0 days 00:12:15,7,30,23
108,ARI,P012707,P012708,0 days 00:11:43,2,15,13
108,ARI,P012702,P012708,0 days 00:11:27,13,30,17
108,ARI,P012708,P012760,0 days 00:11:24,4,18,14
108,ARI,P012716,P012760,0 days 00:10:01,1,11,10
108,ARI,P012702,P012707,0 days 00:09:54,0,14,14
108,ARI,P003240,P012760,0 days 00:08:54,-4,10,14
108,ARI,P012707,P012760,0 days 00:08:23,3,11,8
108,ARI,P012702,P012717,0 days 00:08:13,1,17,16
108,ARI,P012616,P012702,0 days 00:08:06,1,13,12
108,ARI,P004292,P012707,0 days 00:07:39,2,14,12
108,ARI,P012717,P012760,0 days 00:07:12,-7,7,14
108,ARI,P003240,P012616,0 days 00:07:00,2,9,7
108,ARI,P004292,P012760,0 days 00:06:45,-3,9,12
108,ARI,P012707,P012717,0 days 00:05:56,-4,7,11
108,ARI,P012616,P012760,0 days 00:05:21,2,6,4
108,ARI,P004292,P012616,0 days 00:05:00,2,7,5
108,ARI,P012616,P012708,0 days 00:04:58,2,6,4
108,ARI,P004292,P012722,0 days 00:04:52,4,8,4
108,ARI,P003240,P012722,0 days 00:04:41,-4,5,9
108,ARI,P012716,P012717,0 days 00:04:32,-9,5,14
108,ARI,P012707,P012722,0 days 00:04:31,-2,8,10
108,ARI,P012717,P012722,0 days 00:03:20,-3,3,6
108,ARI,P010387,P012722,0 days 00:02:27,1,5,4
108,ARI,P010387,P012707,0 days 00:02:27,1,5,4
108,ARI,P004292,P010387,0 days 00:02:27,1,5,4
108,ARI,P003240,P010387,0 days 00:02:01,-1,2,3
108,ARI,P012616,P012717,0 days 00:01:37,0,0,0
108,ARI,P012708,P012722,0 days 00:01:35,-6,0,6
108,ARI,P012616,P012722,0 days 00:01:16,0,0,0
108,ARI,P010387,P012716,0 days 00:00:26,2,3,1
108,ARI,P012716,P012722,0 days 00:00:26,2,3,1
108,LKB,P002012,P005521,0 days 00:26:25,4,48,44
108,LKB,P005521,P007029,0 days 00:24:05,7,45,38
108,LKB,P007029,P010190,0 days 00:21:11,-6,29,35
108,LKB,P005521,P010190,0 days 00:21:08,2,32,30
108,LKB,P002012,P007029,0 days 00:20:31,2,37,35
108,LKB,P005521,P006230,0 days 00:19:00,6,33,27
108,LKB,P002012,P010190,0 days 00:18:06,3,30,27
108,LKB,P006230,P010190,0 days 00:17:46,-1,25,26
108,LKB,P006230,P007029,0 days 00:15:29,3,29,26
108,LKB,P005521,P010461,0 days 00:15:23,-4,25,29
108,LKB,P002012,P006230,0 days 00:14:26,2,23,21
108,LKB,P007029,P010461,0 days 00:14:13,-7,18,25
108,LKB,P005521,P006901,0 days 00:14:04,-4,19,23
108,LKB,P002012,P010461,0 days 00:13:09,-2,25,27
108,LKB,P004868,P006901,0 days 00:12:50,-4,17,21
108,LKB,P004868,P005521,0 days 00:10:54,-4,17,21
108,LKB,P006901,P010190,0 days 00:10:33,-12,7,19
108,LKB,P006230,P006901,0 days 00:09:43,-4,10,14
108,LKB,P004868,P010461,0 days 00:09:42,-13,9,22
108,LKB,P004868,P007029,0 days 00:09:11,-8,10,18
108,LKB,P010190,P010461,0 days 00:08:59,-8,9,17
108,LKB,P006901,P010461,0 days 00:08:48,-7,11,18
108,LKB,P006901,P007029,0 days 00:08:13,-6,8,14
108,LKB,P004868,P010190,0 days 00:08:07,-10,4,14
108,LKB,P002012,P006901,0 days 00:08:05,-5,11,16
108,LKB,P010461,P011329,0 days 00:07:18,-3,11,14
108,LKB,P005521,P011329,0 days 00:06:33,1,13,12
108,LKB,P002012,P011329,0 days 00:06:10,0,11,11
108,LKB,P007029,P011329,0 days 00:05:55,-1,12,13
108,LKB,P004868,P006230,0 days 00:05:39,2,10,8
108,LKB,P002012,P004868,0 days 00:03:28,-4,7,11
108,LKB,P006901,P011329,0 days 00:01:48,-2,1,3
108,LKB,P004868,P011329,0 days 00:01:33,-3,2,5
108,LKB,P010190,P011329,0 days 00:01:10,-4,0,4
108,LKB,P006230,P011329,0 days 00:00:25,0,2,2
109,BUD,P011935,P012606,0 days 00:20:42,2,38,36
109,BUD,P006566,P012606,0 days 00:18:19,2,36,34
109,BUD,P004945,P007398,0 days 00:16:03,-5,27,32
109,BUD,P010432,P012606,0 days 00:15:51,4,32,28
109,BUD,P004945,P010248,0 days 00:15:23,-19,22,41
109,BUD,P002740,P012606,0 days 00:15:11,0,30,30
109,BUD,P002740,P006566,0 days 00:14:26,-2,31,33
109,BUD,P007398,P012606,0 days 00:14:18,-2,27,29
109,BUD,P004945,P012606,0 days 00:13:31,-1,24,25
109,BUD,P002740,P011935,0 days 00:13:31,-6,23,29
109,BUD,P007398,P010248,0 days 00:13:01,-14,23,37
109,BUD,P010248,P012606,0 days 00:12:51,-5,22,27
109,BUD,P002740,P010248,0 days 00:12:14,-15,25,40
109,BUD,P006566,P010432,0 days 00:12:13,4,26,22
109,BUD,P010248,P011935,0 days 00:11:43,-11,17,28
109,BUD,P006566,P011935,0 days 00:11:40,7,25,18
109,BUD,P006566,P010248,0 days 00:11:08,-17,18,35
109,BUD,P009214,P010248,0 days 00:10:51,-10,24,34
109,BUD,P010432,P011935,0 days 00:10:18,6,21,15
109,BUD,P004945,P011935,0 days 00:09:49,-6,15,21
109,BUD,P010248,P011281,0 days 00:09:25,-17,13,30
109,BUD,P004945,P011281,0 days 00:09:25,-17,13,30
109,BUD,P007398,P011935,0 days 00:09:02,-5,13,18
109,BUD,P004945,P006566,0 days 00:08:55,-11,13,24
109,BUD,P002740,P010432,0 days 00:08:18,3,17,14
109,BUD,P004945,P009214,0 days 00:07:37,-7,13,20
109,BUD,P007398,P010432,0 days 00:07:33,1,15,14
109,BUD,P004945,P010432,0 days 00:07:33,1,15,14
109,BUD,P006566,P007398,0 days 00:07:23,-10,15,25
109,BUD,P002740,P009214,0 days 00:07:01,-6,19,25
109,BUD,P009214,P011281,0 days 00:06:31,-4,13,17
109,BUD,P006566,P009214,0 days 00:06:11,-15,10,25
109,BUD,P007398,P009214,0 days 00:06:02,-3,16,19
109,BUD,P002740,P007398,0 days 00:04:31,-8,11,19
109,BUD,P007398,P011281,0 days 00:04:23,-6,5,11
109,BUD,P009214,P012606,0 days 00:04:05,-4,7,11
109,BUD,P002740,P004945,0 days 00:03:28,-7,6,13
109,BUD,P002740,P011281,0 days 00:03:28,-7,6,13
109,BUD,P006566,P011281,0 days 00:03:09,-10,2,12
109,BUD,P009214,P010432,0 days 00:01:38,-3,2,5
109,BUD,P011281,P011935,0 days 00:01:19,-7,0,7
109,TTK,P006693,P011239,0 days 00:34:26,23,89,66
109,TTK,P006693,P011834,0 days 00:33:05,23,84,61
109,TTK,P011239,P011834,0 days 00:31:38,23,84,61
109,TTK,P006693,P011925,0 days 00:29:44,22,73,51
109,TTK,P011239,P011925,0 days 00:29:15,22,73,51
109,TTK,P011834,P011925,0 days 00:26:56,22,68,46
109,TTK,P004801,P011239,0 days 00:18:06,5,38,33
109,TTK,P004801,P006693,0 days 00:17:42,5,38,33
109,TTK,P004801,P011925,0 days 00:17:37,-1,34,35
109,TTK,P005000,P011239,0 days 00:15:14,8,34,26
109,TTK,P004801,P011834,0 days 00:14:54,5,33,28
109,TTK,P005000,P006693,0 days 00:14:16,8,34,26
109,TTK,P005000,P011925,0 days 00:13:16,8,30,22
109,TTK,P005000,P011834,0 days 00:11:28,8,29,21
109,TTK,P000497,P006693,0 days 00:11:21,11,30,19
109,TTK,P000497,P011834,0 days 00:11:21,11,30,19
109,TTK,P004801,P005000,0 days 00:10:34,4,21,17
109,TTK,P000497,P011239,0 days 00:10:28,11,30,19
109,TTK,P000497,P011925,0 days 00:09:53,15,28,13
109,TTK,P005685,P011925,0 days 00:04:36,0,7,7
109,TTK,P004801,P009845,0 days 00:04:07,0,7,7
109,TTK,P009845,P011925,0 days 00:04:07,0,7,7
109,TTK,P005000,P009845,0 days 00:04:07,0,7,7
109,TTK,P004801,P005685,0 days 00:03:43,0,7,7
109,TTK,P005685,P009845,0 days 00:03:09,0,7,7
109,TTK,P005000,P005685,0 days 00:03:09,0,7,7
109,TTK,P000497,P005000,0 days 00:01:28,-4,2,6
109,TTK,P005685,P006693,0 days 00:01:27,0,0,0
109,TTK,P005685,P011834,0 days 00:01:27,0,0,0
109,TTK,P006693,P011975,0 days 00:01:02,1,5,4
109,TTK,P011239,P011975,0 days 00:01:02,1,5,4
109,TTK,P011834,P011975,0 days 00:01:02,1,5,4
109,TTK,P009845,P011239,0 days 00:00:58,0,0,0
109,TTK,P000497,P005685,0 days 00:00:53,0,0,0
109,TTK,P004801,P011975,0 days 00:00:33,2,2,0
109,TTK,P006693,P012771,0 days 00:00:29,-1,3,4
109,TTK,P011239,P012771,0 days 00:00:29,-1,3,4
109,TTK,P011834,P012771,0 days 00:00:29,-1,3,4
109,TTK,P011975,P012771,0 days 00:00:29,-1,3,4
110,CLU,P011801,P012698,0 days 00:20:10,-2,36,38
110,CLU,P005113,P010569,0 days 00:19:20,11,44,33
110,CLU,P004862,P005113,0 days 00:19:11,9,44,35
110,CLU,P004862,P010569,0 days 00:19:11,9,44,35
110,CLU,P005373,P011801,0 days 00:18:54,0,32,32
110,CLU,P005714,P011801,0 days 00:18:49,-6,33,39
110,CLU,P010569,P012621,0 days 00:18:26,6,40,34
110,CLU,P005113,P012621,0 days 00:18:06,5,41,36
110,CLU,P005714,P012698,0 days 00:17:18,-4,29,33
110,CLU,P005373,P005714,0 days 00:17:10,-1,29,30
110,CLU,P005373,P012698,0 days 00:17:10,-1,29,30
110,CLU,P004862,P012621,0 days 00:16:33,3,37,34
110,CLU,P011801,P012621,0 days 00:10:11,-4,20,24
110,CLU,P005113,P011797,0 days 00:10:11,4,24,20
110,CLU,P011797,P012621,0 days 00:10:03,7,24,17
110,CLU,P011801,P012620,0 days 00:09:49,7,19,12
110,CLU,P005373,P012620,0 days 00:09:49,7,19,12
110,CLU,P004862,P012698,0 days 00:09:39,2,21,19
110,CLU,P010569,P011797,0 days 00:08:39,7,20,13
110,CLU,P004862,P011801,0 days 00:08:33,2,23,21
110,CLU,P004862,P011797,0 days 00:08:23,7,20,13
110,CLU,P005714,P012620,0 days 00:08:05,6,16,10
110,CLU,P012620,P012698,0 days 00:08:05,6,16,10
110,CLU,P012621,P012698,0 days 00:07:53,-5,11,16
110,CLU,P005373,P012621,0 days 00:06:46,-4,8,12
110,CLU,P005714,P012621,0 days 00:06:33,-7,9,16
110,CLU,P010569,P011801,0 days 00:06:23,7,18,11
110,CLU,P005113,P011801,0 days 00:06:11,3,19,16
110,CLU,P005113,P012698,0 days 00:05:44,1,13,12
110,CLU,P010569,P012698,0 days 00:05:29,6,13,7
110,CLU,P010569,P012620,0 days 00:05:25,-5,6,11
110,CLU,P012620,P012621,0 days 00:05:25,-5,6,11
110,CLU,P004862,P005714,0 days 00:04:10,-4,8,12
110,CLU,P004862,P005373,0 days 00:04:03,-2,8,10
110,CLU,P004862,P012620,0 days 00:03:41,-6,3,9
110,CLU,P005113,P012620,0 days 00:03:41,-6,3,9
110,CLU,P011797,P011801,0 days 00:01:48,-3,4,7
110,CLU,P005373,P010569,0 days 00:01:44,1,3,2
110,CLU,P005113,P005714,0 days 00:01:32,-3,4,7
110,CLU,P005714,P011797,0 days 00:01:32,-3,4,7
110,CLU,P011797,P012698,0 days 00:00:08,-3,0,3
110,CLU,P005714,P010569,0 days 00:00:07,-2,0,2
110,WRO,P011900,P012601,0 days 00:20:41,5,52,47
110,WRO,P011900,P011901,0 days 00:20:36,13,57,44
110,WRO,P012601,P012699,0 days 00:20:35,-9,36,45
110,WRO,P012699,P012736,0 days 00:20:06,-20,20,40
110,WRO,P011900,P012699,0 days 00:20:00,-2,41,43
110,WRO,P011901,P012601,0 days 00:19:30,10,50,40
110,WRO,P009896,P012699,0 days 00:18:55,-4,30,34
110,WRO,P011901,P012699,0 days 00:18:23,4,40,36
110,WRO,P003034,P012699,0 days 00:17:26,0,32,32
110,WRO,P012601,P012736,0 days 00:15:57,-16,21,37
110,WRO,P009896,P011900,0 days 00:15:26,-8,32,40
110,WRO,P009896,P012736,0 days 00:15:22,-11,18,29
110,WRO,P003034,P011901,0 days 00:14:37,14,36,22
110,WRO,P003034,P011900,0 days 00:13:56,14,35,21
110,WRO,P009896,P011901,0 days 00:13:42,-2,32,34
110,WRO,P009896,P012601,0 days 00:13:31,-10,25,35
110,WRO,P003034,P012601,0 days 00:10:56,12,28,16
110,WRO,P011900,P012736,0 days 00:10:55,-10,17,27
110,WRO,P011901,P012736,0 days 00:09:57,-4,16,20
110,WRO,P009896,P012308,0 days 00:09:05,7,20,13
110,WRO,P011278,P012736,0 days 00:08:42,0,13,13
110,WRO,P003034,P012736,0 days 00:08:06,-2,11,13
110,WRO,P011278,P012699,0 days 00:08:03,0,13,13
110,WRO,P012308,P012736,0 days 00:06:53,7,12,5
110,WRO,P012308,P012699,0 days 00:06:14,7,12,5
110,WRO,P009896,P011278,0 days 00:05:39,3,10,7
110,WRO,P011278,P012308,0 days 00:05:39,3,10,7
110,WRO,P003034,P009896,0 days 00:05:00,1,9,8
110,WRO,P012308,P012601,0 days 00:03:26,4,10,6
110,WRO,P003034,P011278,0 days 00:03:05,-7,1,8
110,WRO,P007472,P012736,0 days 00:02:58,-8,0,8
110,WRO,P003034,P007472,0 days 00:02:58,-8,0,8
110,WRO,P007472,P012699,0 days 00:02:58,-8,0,8
110,WRO,P007472,P011278,0 days 00:02:58,-8,0,8
110,WRO,P011901,P012308,0 days 00:02:51,0,8,8
110,WRO,P011900,P012308,0 days 00:02:12,0,8,8
110,WRO,P011278,P011901,0 days 00:01:16,-3,1,4
110,WRO,P011278,P011900,0 days 00:00:58,-4,2,6
110,WRO,P011278,P012601,0 days 00:00:28,0,2,2
111,LLI,P006600,P009680,0 days 00:30:07,4,72,68
111,LLI,P009680,P012585,0 days 00:27:20,3,66,63
111,LLI,P006600,P012585,0 days 00:25:30,3,62,59
111,LLI,P009672,P009680,0 days 00:23:29,12,62,50
111,LLI,P006600,P009672,0 days 00:22:21,9,57,48
111,LLI,P005247,P009680,0 days 00:20:08,-1,45,46
111,LLI,P009672,P012585,0 days 00:19:59,13,54,41
111,LLI,P005247,P006600,0 days 00:19:49,-4,42,46
111,LLI,P005247,P009672,0 days 00:19:30,-12,38,50
111,LLI,P009649,P009680,0 days 00:16:10,12,47,35
111,LLI,P005247,P012585,0 days 00:15:12,-5,32,37
111,LLI,P006600,P009649,0 days 00:14:01,9,40,31
111,LLI,P009649,P009672,0 days 00:13:55,12,38,26
111,LLI,P004773,P009649,0 days 00:13:35,-7,25,32
111,LLI,P009649,P012585,0 days 00:13:35,8,37,29
111,LLI,P004773,P005247,0 days 00:11:34,-5,17,22
111,LLI,P005247,P009649,0 days 00:10:51,-5,20,25
111,LLI,P004773,P009680,0 days 00:09:53,-2,20,22
111,LLI,P009649,P012020,0 days 00:09:41,-6,14,20
111,LLI,P004773,P012020,0 days 00:08:45,-6,12,18
111,LLI,P004773,P006600,0 days 00:08:40,-5,15,20
111,LLI,P004773,P012585,0 days 00:08:39,-1,18,19
111,LLI,P005247,P012020,0 days 00:06:56,-9,7,16
111,LLI,P004773,P009672,0 days 00:05:34,-7,6,13
111,LLI,P009672,P012020,0 days 00:04:52,-7,5,12
111,LLI,P005247,P008274,0 days 00:03:48,1,7,6
111,LLI,P004773,P008274,0 days 00:03:48,1,7,6
111,LLI,P008274,P009649,0 days 00:03:48,1,7,6
111,LLI,P008274,P012020,0 days 00:03:48,1,7,6
111,LLI,P012020,P012585,0 days 00:02:45,3,7,4
111,LLI,P009680,P012020,0 days 00:01:57,0,4,4
111,PMT,P002644,P012600,0 days 00:28:54,11,62,51
111,PMT,P001686,P010549,0 days 00:21:37,-2,54,56
111,PMT,P002644,P011944,0 days 00:20:44,-3,35,38
111,PMT,P011944,P012600,0 days 00:19:06,-2,32,34
111,PMT,P001686,P002644,0 days 00:19:02,7,49,42
111,PMT,P010549,P012600,0 days 00:18:24,1,40,39
111,PMT,P001686,P012600,0 days 00:17:59,6,46,40
111,PMT,P002644,P010549,0 days 00:17:37,6,40,34
111,PMT,P002644,P011942,0 days 00:17:04,10,43,33
111,PMT,P001686,P011944,0 days 00:16:39,-6,40,46
111,PMT,P011942,P012600,0 days 00:16:01,9,40,31
111,PMT,P010549,P011944,0 days 00:15:27,-3,35,38
111,PMT,P001686,P011942,0 days 00:13:40,3,38,35
111,PMT,P002020,P011944,0 days 00:12:41,0,26,26
111,PMT,P002644,P011966,0 days 00:11:48,-5,20,25
111,PMT,P002020,P010549,0 days 00:11:35,-3,26,29
111,PMT,P011966,P012600,0 days 00:09:58,-1,17,18
111,PMT,P011944,P011966,0 days 00:09:43,-8,14,22
111,PMT,P011942,P011944,0 days 00:09:15,-8,15,23
111,PMT,P001686,P011823,0 days 00:08:29,-3,23,26
111,PMT,P011942,P011966,0 days 00:08:29,-4,18,22
111,PMT,P010549,P011823,0 days 00:08:22,1,23,22
111,PMT,P001686,P002020,0 days 00:08:09,-3,21,24
111,PMT,P010549,P011942,0 days 00:07:54,4,22,18
111,PMT,P001686,P011966,0 days 00:07:37,-6,17,23
111,PMT,P002020,P011823,0 days 00:07:34,-1,21,22
111,PMT,P002020,P012600,0 days 00:07:34,-2,9,11
111,PMT,P002020,P002644,0 days 00:06:59,0,9,9
111,PMT,P011823,P011944,0 days 00:06:37,-2,19,21
111,PMT,P002020,P011966,0 days 00:05:02,-1,8,9
111,PMT,P010549,P011966,0 days 00:02:56,-4,4,8
111,PMT,P011823,P011966,0 days 00:02:47,-3,6,9
111,PMT,P011823,P011942,0 days 00:01:43,0,4,4
111,PMT,P002020,P011942,0 days 00:00:58,-2,0,2
111,PMT,P002644,P011823,0 days 00:00:48,2,2,0
111,PMT,P011823,P012600,0 days 00:00:48,2,2,0
112,PRS,P012608,P012610,0 days 00:22:26,9,69,60
112,PRS,P005793,P012610,0 days 00:20:02,4,56,52
112,PRS,P005793,P012608,0 days 00:20:02,4,56,52
112,PRS,P011232,P012640,0 days 00:17:34,20,51,31
112,PRS,P009556,P011232,0 days 00:17:34,20,51,31
112,PRS,P009556,P012640,0 days 00:17:34,20,51,31
112,PRS,P012613,P012640,0 days 00:15:31,14,41,27
112,PRS,P004512,P012608,0 days 00:15:10,13,51,38
112,PRS,P004512,P012610,0 days 00:15:10,13,51,38
112,PRS,P011232,P012609,0 days 00:14:04,15,36,21
112,PRS,P009556,P012609,0 days 00:14:04,15,36,21
112,PRS,P012609,P012640,0 days 00:14:04,15,36,21
112,PRS,P004512,P005793,0 days 00:12:46,8,38,30
112,PRS,P011232,P012613,0 days 00:11:30,11,28,17
112,PRS,P012609,P012613,0 days 00:11:30,11,28,17
112,PRS,P009556,P012613,0 days 00:11:30,11,28,17
112,PRS,P012609,P012610,0 days 00:10:18,10,34,24
112,PRS,P005793,P012609,0 days 00:10:18,10,34,24
112,PRS,P012608,P012609,0 days 00:10:18,10,34,24
112,PRS,P004512,P012609,0 days 00:10:18,10,34,24
112,PRS,P011551,P012640,0 days 00:07:50,8,26,18
112,PRS,P011887,P012610,0 days 00:06:21,-3,19,22
112,PRS,P011887,P012608,0 days 00:06:21,-3,19,22
112,PRS,P009556,P011551,0 days 00:06:04,9,23,14
112,PRS,P011232,P011551,0 days 00:06:04,9,23,14
112,PRS,P011232,P011887,0 days 00:05:54,10,28,18
112,PRS,P005793,P012640,0 days 00:05:47,2,16,14
112,PRS,P012608,P012640,0 days 00:05:47,2,16,14
112,PRS,P012610,P012640,0 days 00:05:47,2,16,14
112,PRS,P011551,P011887,0 days 00:04:59,-1,17,18
112,PRS,P004512,P011887,0 days 00:04:52,3,17,14
112,PRS,P012608,P012613,0 days 00:04:01,3,13,10
112,PRS,P012610,P012613,0 days 00:04:01,3,13,10
112,PRS,P005793,P012613,0 days 00:04:01,3,13,10
112,PRS,P005793,P011887,0 days 00:03:57,-8,6,14
112,PRS,P011887,P012640,0 days 00:03:30,5,15,10
112,PRS,P009556,P011887,0 days 00:03:30,5,15,10
112,PRS,P005793,P011551,0 days 00:03:15,-7,5,12
112,PRS,P011551,P012608,0 days 00:03:15,-7,5,12
112,PRS,P011551,P012610,0 days 00:03:15,-7,5,12
112,PRS,P011551,P012609,0 days 00:02:34,4,8,4
112,PRS,P004512,P011232,0 days 00:02:24,5,13,8
112,PRS,P011232,P012608,0 days 00:02:24,5,13,8
112,PRS,P011232,P012610,0 days 00:02:24,5,13,8
112,HAM,P011168,P012581,0 days 00:18:38,-20,44,64
112,HAM,P009663,P011168,0 days 00:18:03,-6,52,58
112,HAM,P012580,P012582,0 days 00:16:19,-3,41,44
112,HAM,P009663,P012581,0 days 00:16:10,-18,40,58
112,HAM,P009663,P012582,0 days 00:15:11,-6,40,46
112,HAM,P011168,P012580,0 days 00:14:46,-2,42,44
112,HAM,P001990,P012582,0 days 00:14:12,-11,25,36
112,HAM,P009663,P012580,0 days 00:14:05,1,39,38
112,HAM,P012581,P012582,0 days 00:13:55,-13,32,45
112,HAM,P001990,P012579,0 days 00:13:22,-9,26,35
112,HAM,P012579,P012582,0 days 00:12:51,0,30,30
112,HAM,P012579,P012580,0 days 00:12:37,0,29,29
112,HAM,P009663,P012579,0 days 00:11:44,-1,28,29
112,HAM,P011168,P012582,0 days 00:11:23,-1,34,35
112,HAM,P010070,P011168,0 days 00:10:14,-16,20,36
112,HAM,P011187,P012579,0 days 00:10:11,-8,23,31
112,HAM,P011168,P012579,0 days 00:10:01,4,29,25
112,HAM,P001990,P012580,0 days 00:09:09,-8,14,22
112,HAM,P001990,P011187,0 days 00:09:03,-9,17,26
112,HAM,P012579,P012581,0 days 00:08:55,-4,22,26
112,HAM,P010070,P012581,0 days 00:08:52,-11,20,31
112,HAM,P012580,P012581,0 days 00:08:35,-8,21,29
112,HAM,P001990,P012581,0 days 00:07:51,-8,14,22
112,HAM,P010070,P011187,0 days 00:07:41,-12,14,26
112,HAM,P011187,P012580,0 days 00:07:38,-5,15,20
112,HAM,P012581,P012648,0 days 00:07:09,-15,12,27
112,HAM,P011168,P012648,0 days 00:07:05,-10,15,25
112,HAM,P011187,P012582,0 days 00:06:44,-4,13,17
112,HAM,P011187,P012581,0 days 00:06:39,-8,12,20
112,HAM,P010070,P012579,0 days 00:06:10,-10,12,22
112,HAM,P001990,P009663,0 days 00:05:42,-6,9,15
112,HAM,P009663,P012648,0 days 00:05:31,-6,15,21
112,HAM,P010070,P012648,0 days 00:05:28,-11,10,21
112,HAM,P011168,P011187,0 days 00:05:22,-7,10,17
112,HAM,P009663,P010070,0 days 00:04:56,-9,10,19
112,HAM,P010070,P012580,0 days 00:04:44,-10,6,16
112,HAM,P012582,P012648,0 days 00:04:25,-6,9,15
112,HAM,P011187,P012648,0 days 00:04:22,-11,4,15
112,HAM,P009663,P012694,0 days 00:03:38,3,11,8
112,HAM,P011168,P012694,0 days 00:03:38,3,11,8
112,HAM,P012579,P012694,0 days 00:03:38,3,11,8
112,HAM,P001990,P012648,0 days 00:02:48,-7,4,11
112,HAM,P001990,P010070,0 days 00:02:23,-5,4,9
112,HAM,P012581,P012694,0 days 00:01:52,-3,3,6
112,HAM,P001990,P011168,0 days 00:01:50,-1,3,4
112,HAM,P012580,P012694,0 days 00:01:46,6,8,2
112,HAM,P012580,P012648,0 days 00:01:37,1,5,4
112,HAM,P012579,P012648,0 days 00:01:07,-3,2,5
113,HTA,P006835,P007759,0 days 00:32:18,8,75,67
113,HTA,P004846,P007759,0 days 00:25:35,20,68,48
113,HTA,P004846,P006835,0 days 00:24:33,19,64,45
113,HTA,P004846,P011973,0 days 00:24:19,29,71,42
113,HTA,P007759,P010465,0 days 00:23:45,-6,46,52
113,HTA,P004846,P010465,0 days 00:23:19,3,56,53
113,HTA,P006835,P010465,0 days 00:22:43,-7,42,49
113,HTA,P007759,P011973,0 days 00:19:26,20,56,36
113,HTA,P010465,P011973,0 days 00:18:41,12,48,36
113,HTA,P006835,P011973,0 days 00:18:38,19,52,33
113,HTA,P004267,P004846,0 days 00:14:00,32,52,20
113,HTA,P003533,P007759,0 days 00:13:54,-11,23,34
113,HTA,P003533,P006835,0 days 00:13:54,-11,23,34
113,HTA,P004267,P011973,0 days 00:13:34,26,51,25
113,HTA,P004267,P007759,0 days 00:11:21,19,40,21
113,HTA,P004267,P006835,0 days 00:10:33,18,36,18
113,HTA,P003533,P010465,0 days 00:10:25,-11,16,27
113,HTA,P010465,P011990,0 days 00:10:24,2,23,21
113,HTA,P004267,P011990,0 days 00:08:24,1,24,23
113,HTA,P006835,P011990,0 days 00:07:15,-14,8,22
113,HTA,P011973,P011990,0 days 00:07:08,8,24,16
113,HTA,P004267,P010465,0 days 00:07:07,11,25,14
113,HTA,P007759,P011990,0 days 00:07:01,-14,8,22
113,HTA,P003533,P004846,0 days 00:06:37,-2,15,17
113,HTA,P003533,P011990,0 days 00:06:33,-12,5,17
113,HTA,P004846,P011990,0 days 00:05:21,7,18,11
113,HTA,P003533,P004267,0 days 00:04:13,3,10,7
113,HTA,P011973,P012028,0 days 00:01:19,3,3,0
113,HTA,P011990,P012028,0 days 00:01:19,3,3,0
113,HTA,P004267,P012028,0 days 00:01:05,3,3,0
113,HTA,P011973,P012706,0 days 00:01:05,3,3,0
113,HTA,P011990,P012706,0 days 00:01:05,3,3,0
113,HTA,P012028,P012706,0 days 00:01:05,3,3,0
113,HTA,P004267,P012706,0 days 00:00:51,3,3,0
113,HTA,P006835,P012028,0 days 00:00:14,0,0,0
113,HTA,P011973,P012793,0 days 00:00:14,0,0,0
113,HTA,P011990,P012793,0 days 00:00:14,0,0,0
113,HTA,P012028,P012793,0 days 00:00:14,0,0,0
113,HTA,P012706,P012793,0 days 00:00:14,0,0,0
113,VNC,P003759,P012591,0 days 00:24:55,-7,52,59
113,VNC,P012590,P012591,0 days 00:24:27,-7,55,62
113,VNC,P003759,P012590,0 days 00:22:00,-6,49,55
113,VNC,P011909,P012591,0 days 00:21:14,-11,41,52
113,VNC,P004117,P012590,0 days 00:19:49,-17,34,51
113,VNC,P011909,P012590,0 days 00:19:00,-8,39,47
113,VNC,P004117,P009400,0 days 00:18:58,-11,38,49
113,VNC,P012587,P012590,0 days 00:18:19,-8,40,48
113,VNC,P012587,P012591,0 days 00:17:22,3,40,37
113,VNC,P004117,P012591,0 days 00:16:56,-7,31,38
113,VNC,P003759,P011909,0 days 00:16:39,-7,33,40
113,VNC,P003759,P012587,0 days 00:15:52,-3,33,36
113,VNC,P009400,P012587,0 days 00:15:33,-12,26,38
113,VNC,P011909,P012587,0 days 00:15:00,-7,31,38
113,VNC,P009400,P012590,0 days 00:14:22,-14,25,39
113,VNC,P009400,P012591,0 days 00:13:25,-3,25,28
113,VNC,P004117,P011909,0 days 00:13:15,-11,23,34
113,VNC,P004117,P012587,0 days 00:12:28,-9,23,32
113,VNC,P008052,P012587,0 days 00:12:26,-4,31,35
113,VNC,P003759,P004117,0 days 00:11:14,-8,18,26
113,VNC,P008052,P009400,0 days 00:10:50,-7,24,31
113,VNC,P009400,P011909,0 days 00:09:15,-8,14,22
113,VNC,P003759,P009400,0 days 00:08:49,-9,12,21
113,VNC,P004117,P008052,0 days 00:08:48,-5,21,26
113,VNC,P008052,P012590,0 days 00:08:19,-8,18,26
113,VNC,P008052,P012591,0 days 00:04:09,8,16,8
113,VNC,P003759,P008052,0 days 00:03:59,0,11,11
113,VNC,P008052,P011909,0 days 00:02:37,-4,7,11
114,WOL,P004645,P012577,0 days 00:25:19,-22,45,67
114,WOL,P006154,P012577,0 days 00:21:31,4,50,46
114,WOL,P004645,P005516,0 days 00:20:54,-15,34,49
114,WOL,P003212,P012577,0 days 00:20:30,-12,46,58
114,WOL,P005516,P012577,0 days 00:19:13,-13,30,43
114,WOL,P004645,P012576,0 days 00:16:49,-15,28,43
114,WOL,P012576,P012577,0 days 00:16:28,-13,26,39
114,WOL,P004229,P012577,0 days 00:15:46,0,40,40
114,WOL,P003212,P006154,0 days 00:15:34,-1,40,41
114,WOL,P004645,P006154,0 days 00:14:51,0,31,31
114,WOL,P003212,P004229,0 days 00:14:35,10,39,29
114,WOL,P003212,P004645,0 days 00:14:09,-16,27,43
114,WOL,P004229,P006154,0 days 00:12:03,8,34,26
114,WOL,P004229,P006907,0 days 00:11:58,13,32,19
114,WOL,P003212,P006907,0 days 00:11:52,9,30,21
114,WOL,P006154,P012576,0 days 00:11:32,-3,20,23
114,WOL,P004229,P004645,0 days 00:10:55,-4,23,27
114,WOL,P006154,P006907,0 days 00:10:48,6,27,21
114,WOL,P005516,P012576,0 days 00:10:37,-3,16,19
114,WOL,P004229,P005516,0 days 00:10:20,-5,19,24
114,WOL,P006907,P012577,0 days 00:09:18,5,23,18
114,WOL,P004645,PLCT,0 days 00:09:08,-15,14,29
114,WOL,P005516,P006154,0 days 00:08:01,6,14,8
114,WOL,P005516,PLCT,0 days 00:07:38,-13,12,25
114,WOL,P003212,P012576,0 days 00:07:23,-14,12,26
114,WOL,P003212,P005516,0 days 00:06:53,-5,11,16
114,WOL,P012577,PLCT,0 days 00:06:48,-13,10,23
114,WOL,P012576,PLCT,0 days 00:06:04,-14,8,22
114,WOL,P004645,P006907,0 days 00:04:48,-1,8,9
114,WOL,P005516,P006907,0 days 00:04:46,1,7,6
114,WOL,P003212,P012789,0 days 00:03:22,-1,5,6
114,WOL,P005516,P012789,0 days 00:03:22,-1,5,6
114,WOL,P006907,P012576,0 days 00:03:07,-6,2,8
114,WOL,P004229,PLCT,0 days 00:03:04,-1,6,7
114,WOL,P006907,PLCT,0 days 00:02:20,-2,4,6
114,WOL,P004645,P012789,0 days 00:01:59,-4,2,6
114,WOL,P012577,P012789,0 days 00:01:59,-4,2,6
114,WOL,P003212,PLCT,0 days 00:01:30,-2,2,4
114,WOL,P004229,P012789,0 days 00:01:23,3,3,0
114,WOL,P006907,P012789,0 days 00:01:23,3,3,0
114,JOV,P002507,P011247,0 days 00:17:33,6,45,39
114,JOV,P002361,P002507,0 days 00:17:26,2,42,40
114,JOV,P011248,P012780,0 days 00:17:08,11,42,31
114,JOV,P006771,P011248,0 days 00:16:55,13,38,25
114,JOV,P006771,P011247,0 days 00:16:29,15,46,31
114,JOV,P011247,P011248,0 days 00:16:07,17,43,26
114,JOV,P010458,P011247,0 days 00:16:03,8,42,34
114,JOV,P002361,P006771,0 days 00:15:47,-2,32,34
114,JOV,P006771,P010458,0 days 00:14:15,2,31,29
114,JOV,P002361,P010458,0 days 00:13:38,4,32,28
114,JOV,P011248,P012349,0 days 00:13:23,15,35,20
114,JOV,P002361,P011247,0 days 00:13:00,5,35,30
114,JOV,P006771,P012780,0 days 00:12:46,17,33,16
114,JOV,P011247,P012780,0 days 00:12:44,18,39,21
114,JOV,P010161,P011247,0 days 00:12:14,7,32,25
114,JOV,P002507,P006771,0 days 00:12:03,-1,28,29
114,JOV,P002507,P010458,0 days 00:11:26,5,30,25
114,JOV,P010458,P011248,0 days 00:11:15,0,22,22
114,JOV,P011247,P012349,0 days 00:10:42,12,30,18
114,JOV,P006771,P012349,0 days 00:10:16,10,26,16
114,JOV,P002507,P010161,0 days 00:10:05,6,26,20
114,JOV,P002361,P011248,0 days 00:09:59,-6,14,20
114,JOV,P002507,P011248,0 days 00:09:14,-4,15,19
114,JOV,P002361,P012780,0 days 00:09:14,-4,17,21
114,JOV,P010458,P012780,0 days 00:09:02,1,18,17
114,JOV,P012349,P012780,0 days 00:08:59,11,24,13
114,JOV,P010161,P011248,0 days 00:07:54,-3,16,19
114,JOV,P002361,P012349,0 days 00:07:52,-6,11,17
114,JOV,P002507,P012349,0 days 00:07:46,-2,14,16
114,JOV,P002361,P010161,0 days 00:07:46,1,18,17
114,JOV,P010161,P012780,0 days 00:06:54,-4,16,20
114,JOV,P010161,P010458,0 days 00:06:13,4,17,13
114,JOV,P010161,P012349,0 days 00:05:36,-2,9,11
114,JOV,P002361,P010709,0 days 00:02:26,-2,3,5
114,JOV,P010709,P012349,0 days 00:02:26,-2,3,5
114,JOV,P010709,P012780,0 days 00:02:26,-2,3,5
114,JOV,P002507,P012780,0 days 00:02:23,0,8,8
114,JOV,P010161,P010709,0 days 00:01:33,-3,0,3
114,JOV,P010709,P011248,0 days 00:00:53,1,3,2
114,JOV,P006771,P010161,0 days 00:00:09,2,2,0
115,LJU,P005969,P009395,0 days 00:33:43,0,71,71
115,LJU,P009395,P012700,0 days 00:31:19,-9,61,70
115,LJU,P005969,P012700,0 days 00:28:45,-8,55,63
115,LJU,P003452,P009395,0 days 00:27:17,1,61,60
115,LJU,P003452,P005969,0 days 00:25:45,-3,55,58
115,LJU,P003452,P012700,0 days 00:25:00,-6,51,57
115,LJU,P003452,P010594,0 days 00:21:34,-9,48,57
115,LJU,P010594,P012700,0 days 00:19:55,-5,45,50
115,LJU,P009395,P010594,0 days 00:17:51,-5,42,47
115,LJU,P005969,P010594,0 days 00:16:19,-9,36,45
115,LJU,P009392,P009395,0 days 00:14:51,4,33,29
115,LJU,P005969,P009392,0 days 00:14:51,4,33,29
115,LJU,P009395,P011261,0 days 00:12:45,0,24,24
115,LJU,P005969,P011261,0 days 00:12:45,0,24,24
115,LJU,P009392,P011261,0 days 00:11:14,2,24,22
115,LJU,P009392,P012700,0 days 00:10:27,-4,17,21
115,LJU,P011261,P012700,0 days 00:08:24,-7,11,18
115,LJU,P003452,P009392,0 days 00:07:58,9,22,13
115,LJU,P002561,P012700,0 days 00:07:22,3,17,14
115,LJU,P002561,P003452,0 days 00:06:51,-5,12,17
115,LJU,P002561,P010594,0 days 00:06:51,-5,12,17
115,LJU,P003452,P011261,0 days 00:05:52,5,13,8
115,LJU,P002561,P007066,0 days 00:05:50,-1,11,12
115,LJU,P002561,P009395,0 days 00:05:15,2,11,9
115,LJU,P007066,P012700,0 days 00:04:48,4,11,7
115,LJU,P003452,P007066,0 days 00:03:43,-4,6,10
115,LJU,P007066,P010594,0 days 00:03:43,-4,6,10
115,LJU,P002561,P005969,0 days 00:03:43,-2,5,7
115,LJU,P005969,P007066,0 days 00:03:09,-2,5,7
115,LJU,P007066,P009395,0 days 00:02:07,3,5,2
115,LJU,P009392,P010594,0 days 00:00:03,1,3,2
115,BES,P011936,P012647,0 days 00:28:43,1,65,64
115,BES,P011936,P012622,0 days 00:24:38,1,53,52
115,BES,P012622,P012647,0 days 00:24:14,-3,51,54
115,BES,P008945,P011936,0 days 00:20:57,14,53,39
115,BES,P008945,P012647,0 days 00:20:57,14,53,39
115,BES,P008945,P012622,0 days 00:18:34,10,44,34
115,BES,P011924,P011936,0 days 00:14:00,-8,25,33
115,BES,P007914,P012622,0 days 00:13:27,0,25,25
115,BES,P011924,P012622,0 days 00:13:04,-3,28,31
115,BES,P009582,P011924,0 days 00:12:09,-12,19,31
115,BES,P007914,P011924,0 days 00:11:40,1,23,22
115,BES,P009582,P011936,0 days 00:11:31,-5,23,28
115,BES,P011379,P011924,0 days 00:10:50,6,23,17
115,BES,P011924,P012647,0 days 00:10:32,-13,19,32
115,BES,P007914,P011936,0 days 00:10:27,-4,15,19
115,BES,P007917,P011936,0 days 00:10:02,11,28,17
115,BES,P007917,P012647,0 days 00:10:02,11,28,17
115,BES,P007917,P012622,0 days 00:10:02,11,28,17
115,BES,P007914,P011379,0 days 00:09:27,5,21,16
115,BES,P005348,P011924,0 days 00:09:11,2,22,20
115,BES,P005348,P009582,0 days 00:09:00,0,21,21
115,BES,P009582,P012647,0 days 00:08:27,-6,19,25
115,BES,P007914,P012647,0 days 00:08:22,-8,11,19
115,BES,P007917,P008945,0 days 00:08:19,14,26,12
115,BES,P009582,P011379,0 days 00:07:52,-4,11,15
115,BES,P007914,P009582,0 days 00:06:29,-5,9,14
115,BES,P005348,P011936,0 days 00:06:19,3,16,13
115,BES,P005348,P011379,0 days 00:06:11,6,17,11
115,BES,P007914,P008945,0 days 00:06:09,-4,9,13
115,BES,P009582,P012622,0 days 00:05:38,-10,7,17
115,BES,P005348,P012647,0 days 00:05:23,0,14,14
115,BES,P005348,P007914,0 days 00:05:15,3,15,12
115,BES,P011379,P012622,0 days 00:05:05,8,14,6
115,BES,P008945,P009582,0 days 00:04:10,2,11,9
115,BES,P011379,P011936,0 days 00:03:55,3,6,3
115,BES,P005348,P012622,0 days 00:02:34,6,10,4
115,BES,P005348,P008945,0 days 00:02:23,4,9,5
115,BES,P008945,P011924,0 days 00:02:19,2,7,5
115,BES,P007917,P011924,0 days 00:01:43,-3,2,5
116,CLU,P005714,P011801,0 days 00:23:10,9,53,44
116,CLU,P005373,P011801,0 days 00:22:01,11,58,47
116,CLU,P011801,P012698,0 days 00:18:00,-3,38,41
116,CLU,P010569,P012621,0 days 00:17:15,-5,34,39
116,CLU,P004862,P005373,0 days 00:17:13,5,46,41
116,CLU,P004862,P011801,0 days 00:17:09,7,48,41
116,CLU,P004862,P011797,0 days 00:16:48,-10,41,51
116,CLU,P005373,P005714,0 days 00:15:43,2,38,36
116,CLU,P005714,P012698,0 days 00:15:37,-10,28,38
116,CLU,P005373,P012698,0 days 00:14:50,-7,31,38
116,CLU,P011797,P012621,0 days 00:14:19,-17,25,42
116,CLU,P004862,P005714,0 days 00:13:44,-4,34,38
116,CLU,P011797,P011801,0 days 00:12:53,18,38,20
116,CLU,P004862,P012698,0 days 00:12:41,-6,29,35
116,CLU,P010569,P011797,0 days 00:12:10,-10,26,36
116,CLU,P005373,P011797,0 days 00:12:07,14,37,23
116,CLU,P004862,P010569,0 days 00:11:11,-16,24,40
116,CLU,P011801,P012621,0 days 00:11:08,8,23,15
116,CLU,P004862,P012621,0 days 00:10:44,-23,18,41
116,CLU,P010569,P011801,0 days 00:10:38,7,26,19
116,CLU,P005113,P012621,0 days 00:09:50,-21,16,37
116,CLU,P005113,P011797,0 days 00:09:50,-21,16,37
116,CLU,P004862,P005113,0 days 00:09:50,-21,16,37
116,CLU,P005714,P012621,0 days 00:09:13,-2,15,17
116,CLU,P005113,P010569,0 days 00:08:54,-14,16,30
116,CLU,P005714,P011797,0 days 00:08:27,2,22,20
116,CLU,P005714,P010569,0 days 00:06:41,3,14,11
116,CLU,P011797,P012698,0 days 00:05:42,0,11,11
116,CLU,P005714,P012620,0 days 00:04:17,3,8,5
116,CLU,P012620,P012621,0 days 00:04:17,3,8,5
116,CLU,P011801,P012620,0 days 00:04:17,3,8,5
116,CLU,P010569,P012620,0 days 00:04:17,3,8,5
116,CLU,P005373,P010569,0 days 00:03:57,4,12,8
116,CLU,P005373,P012621,0 days 00:03:37,3,10,7
116,CLU,P012621,P012698,0 days 00:03:29,2,7,5
116,CLU,P010569,P012698,0 days 00:03:05,0,8,8
116,CLU,P005113,P005714,0 days 00:00:56,-7,0,7
116,BOU,P010431,P011836,0 days 00:23:47,9,57,48
116,BOU,P010431,P012617,0 days 00:18:48,9,44,35
116,BOU,P011836,P012617,0 days 00:18:36,17,50,33
116,BOU,P010450,P011836,0 days 00:16:11,12,43,31
116,BOU,P010431,P010450,0 days 00:14:56,9,37,28
116,BOU,P012618,P012628,0 days 00:14:32,3,37,34
116,BOU,P010450,P011837,0 days 00:14:17,1,37,36
116,BOU,P010431,P012618,0 days 00:14:05,2,31,29
116,BOU,P011836,P012618,0 days 00:13:53,10,37,27
116,BOU,P012617,P012618,0 days 00:13:09,12,35,23
116,BOU,P011836,P011837,0 days 00:12:21,1,29,28
116,BOU,P011161,P012628,0 days 00:11:38,2,29,27
116,BOU,P004525,P011161,0 days 00:11:23,2,29,27
116,BOU,P010450,P012617,0 days 00:11:17,13,32,19
116,BOU,P010431,P011837,0 days 00:11:16,6,29,23
116,BOU,P004525,P012628,0 days 00:11:03,0,24,24
116,BOU,P000498,P011161,0 days 00:10:53,2,27,25
116,BOU,P000498,P004525,0 days 00:10:37,4,27,23
116,BOU,P010431,P012628,0 days 00:09:56,-1,23,24
116,BOU,P011836,P012628,0 days 00:09:34,-1,23,24
116,BOU,P000498,P012628,0 days 00:08:52,2,19,17
116,BOU,P000498,P011837,0 days 00:08:26,-6,19,25
116,BOU,P000498,P010450,0 days 00:08:26,-6,19,25
116,BOU,P012617,P012628,0 days 00:08:24,3,21,18
116,BOU,P011161,P012618,0 days 00:07:39,6,25,19
116,BOU,P010450,P012618,0 days 00:07:01,1,16,15
116,BOU,P011837,P012617,0 days 00:07:01,4,18,14
116,BOU,P004525,P012618,0 days 00:06:05,-1,14,15
116,BOU,P000498,P011836,0 days 00:05:52,-5,11,16
116,BOU,P010450,P011161,0 days 00:05:33,-4,16,20
116,BOU,P004525,P010450,0 days 00:05:07,-10,10,20
116,BOU,P000498,P010431,0 days 00:04:47,0,11,11
116,BOU,P011161,P011836,0 days 00:04:42,1,14,13
116,BOU,P011161,P012619,0 days 00:04:35,2,10,8
116,BOU,P000498,P012619,0 days 00:04:35,2,10,8
116,BOU,P004525,P012619,0 days 00:04:35,2,10,8
116,BOU,P012619,P012628,0 days 00:04:35,2,10,8
116,BOU,P011161,P011837,0 days 00:03:51,-5,8,13
116,BOU,P000498,P012618,0 days 00:03:28,3,9,6
116,BOU,P004525,P011837,0 days 00:03:06,-3,8,11
116,BOU,P010450,P012628,0 days 00:02:24,-8,2,10
116,BOU,P010431,P011161,0 days 00:02:15,-1,5,6
116,BOU,P011161,P012617,0 days 00:01:51,7,9,2
116,BOU,P004525,P010431,0 days 00:01:34,-1,3,4
116,BOU,P004525,P012617,0 days 00:01:34,-1,3,4
116,BOU,P011837,P012628,0 days 00:01:30,-6,0,6
117,WRO,P009896,P012699,0 days 00:26:35,11,65,54
117,WRO,P009896,P012601,0 days 00:22:06,9,51,42
117,WRO,P012601,P012699,0 days 00:20:58,6,49,43
117,WRO,P011900,P012699,0 days 00:20:09,-4,39,43
117,WRO,P009896,P011900,0 days 00:20:02,5,41,36
117,WRO,P011900,P012601,0 days 00:19:31,-5,33,38
117,WRO,P011901,P012699,0 days 00:19:06,-10,33,43
117,WRO,P011900,P011901,0 days 00:18:30,-11,30,41
117,WRO,P011278,P012749,0 days 00:18:11,11,43,32
117,WRO,P009896,P011278,0 days 00:17:52,7,43,36
117,WRO,P009896,P011901,0 days 00:17:47,-5,33,38
117,WRO,P011901,P012601,0 days 00:15:25,-5,26,31
117,WRO,P011278,P012699,0 days 00:15:24,6,42,36
117,WRO,P009896,P012749,0 days 00:13:29,14,36,22
117,WRO,P012601,P012749,0 days 00:12:48,7,32,25
117,WRO,P012699,P012749,0 days 00:11:01,13,35,22
117,WRO,P011278,P012601,0 days 00:10:47,7,29,22
117,WRO,P011278,P011900,0 days 00:09:38,1,19,18
117,WRO,P011900,P012749,0 days 00:08:34,7,18,11
117,WRO,P012736,P012749,0 days 00:05:52,-5,6,11
117,WRO,P003034,P012736,0 days 00:05:20,-5,6,11
117,WRO,P011278,P012736,0 days 00:05:09,-6,6,12
117,WRO,P003034,P011900,0 days 00:04:57,-9,3,12
117,WRO,P003034,P012749,0 days 00:04:38,-3,6,9
117,WRO,P011278,P011901,0 days 00:04:23,-7,7,14
117,WRO,P012699,P012736,0 days 00:04:14,-4,6,10
117,WRO,P003034,P012601,0 days 00:04:02,-7,3,10
117,WRO,P012308,P012749,0 days 00:03:52,2,4,2
117,WRO,P011278,P012308,0 days 00:03:52,2,4,2
117,WRO,P009896,P012308,0 days 00:03:52,2,4,2
117,WRO,P011900,P012736,0 days 00:03:38,-4,3,7
117,WRO,P003034,P012699,0 days 00:03:01,-6,3,9
117,WRO,P012601,P012736,0 days 00:02:43,-2,3,5
117,WRO,P003034,P011278,0 days 00:02:37,-3,3,6
117,WRO,P009896,P012736,0 days 00:02:32,-3,3,6
117,WRO,P007472,P011278,0 days 00:02:23,-2,4,6
117,WRO,P007472,P012601,0 days 00:02:23,-2,4,6
117,WRO,P007472,P012749,0 days 00:02:23,-2,4,6
117,WRO,P012308,P012601,0 days 00:02:09,0,2,2
117,WRO,P003034,P011901,0 days 00:02:01,-7,0,7
117,WRO,P011901,P012736,0 days 00:02:00,-3,3,6
117,WRO,P011900,P012308,0 days 00:01:43,2,2,0
117,WRO,P007472,P011900,0 days 00:01:34,2,4,2
117,WRO,P007472,P009896,0 days 00:00:49,-4,0,4
117,BUD,P010248,P011281,0 days 00:23:54,3,43,40
117,BUD,P002740,P010248,0 days 00:17:52,10,38,28
117,BUD,P010248,P011935,0 days 00:17:21,-5,35,40
117,BUD,P004397,P011281,0 days 00:15:28,-1,29,30
117,BUD,P002740,P011935,0 days 00:15:18,7,32,25
117,BUD,P002740,P011281,0 days 00:15:13,3,31,28
117,BUD,P004397,P004945,0 days 00:14:34,0,25,25
117,BUD,P006566,P011281,0 days 00:14:14,-15,21,36
117,BUD,P004397,P012606,0 days 00:14:01,8,31,23
117,BUD,P011281,P011935,0 days 00:13:57,2,27,25
117,BUD,P010248,P012606,0 days 00:12:36,11,32,21
117,BUD,P011281,P012606,0 days 00:12:12,14,33,19
117,BUD,P006566,P010248,0 days 00:11:59,-12,17,29
117,BUD,P004945,P010248,0 days 00:11:54,-6,20,26
117,BUD,P004397,P010432,0 days 00:11:26,3,27,24
117,BUD,P004397,P010248,0 days 00:11:17,0,18,18
117,BUD,P002740,P012606,0 days 00:10:10,24,32,8
117,BUD,P010432,P012606,0 days 00:10:07,6,25,19
117,BUD,P004397,P006566,0 days 00:09:51,-5,21,26
117,BUD,P004397,P007398,0 days 00:09:26,3,16,13
117,BUD,P007398,P012606,0 days 00:09:13,-2,21,23
117,BUD,P004945,P012606,0 days 00:08:54,-1,17,18
117,BUD,P004945,P011281,0 days 00:08:53,-2,14,16
117,BUD,P011935,P012606,0 days 00:08:42,9,26,17
117,BUD,P007398,P011281,0 days 00:08:18,2,13,11
117,BUD,P004945,P007398,0 days 00:08:11,-10,10,20
117,BUD,P007398,P010248,0 days 00:07:23,-9,9,18
117,BUD,P002740,P006566,0 days 00:07:05,-9,10,19
117,BUD,P007398,P010432,0 days 00:06:56,5,16,11
117,BUD,P004945,P010432,0 days 00:05:55,0,11,11
117,BUD,P006566,P011935,0 days 00:05:50,-14,5,19
117,BUD,P010432,P011281,0 days 00:05:31,-2,13,15
117,BUD,P006566,P012606,0 days 00:04:57,-1,11,12
117,BUD,P004945,P006566,0 days 00:04:54,-4,10,14
117,BUD,P007398,P011935,0 days 00:04:53,-7,9,16
117,BUD,P002740,P004397,0 days 00:04:45,7,13,6
117,BUD,P002740,P004945,0 days 00:04:42,8,11,3
117,BUD,P006566,P010432,0 days 00:03:38,-4,9,13
117,BUD,P004945,P011935,0 days 00:03:19,-9,6,15
117,BUD,P002740,P007398,0 days 00:02:56,2,6,4
117,BUD,P002740,P010432,0 days 00:02:11,4,7,3
117,BUD,P004397,P011935,0 days 00:00:04,-3,0,3
118,TTK,P011239,P011834,0 days 00:27:33,-3,55,58
118,TTK,P011834,P011925,0 days 00:26:59,-1,61,62
118,TTK,P006693,P011834,0 days 00:26:58,-5,57,62
118,TTK,P011239,P011925,0 days 00:26:04,-10,48,58
118,TTK,P005000,P011239,0 days 00:25:33,2,50,48
118,TTK,P005000,P011925,0 days 00:25:01,3,58,55
118,TTK,P005000,P011834,0 days 00:24:17,11,60,49
118,TTK,P006693,P011925,0 days 00:23:53,-7,49,56
118,TTK,P006693,P011239,0 days 00:22:55,-7,41,48
118,TTK,P004801,P011925,0 days 00:19:50,-8,48,56
118,TTK,P005000,P006693,0 days 00:19:39,7,46,39
118,TTK,P004801,P011834,0 days 00:16:25,-11,39,50
118,TTK,P004801,P006693,0 days 00:14:50,-14,33,47
118,TTK,P004801,P011239,0 days 00:14:46,-15,26,41
118,TTK,P004801,P005000,0 days 00:13:32,-2,36,38
118,TTK,P000497,P011834,0 days 00:08:11,1,18,17
118,TTK,P000497,P011239,0 days 00:07:34,4,18,14
118,TTK,P000497,P005000,0 days 00:07:16,6,18,12
118,TTK,P011925,P011975,0 days 00:05:21,-4,11,15
118,TTK,P005000,P011975,0 days 00:05:21,-4,11,15
118,TTK,P000497,P006693,0 days 00:04:31,1,11,10
118,TTK,P004801,P011975,0 days 00:04:26,-3,8,11
118,TTK,P011239,P011975,0 days 00:03:19,-3,6,9
118,TTK,P004801,P009845,0 days 00:02:55,-5,3,8
118,TTK,P006693,P009845,0 days 00:02:55,-5,3,8
118,TTK,P009845,P011834,0 days 00:02:55,-5,3,8
118,TTK,P000497,P004801,0 days 00:02:27,-7,2,9
118,TTK,P009845,P011925,0 days 00:02:18,-2,3,5
118,TTK,P000497,P011925,0 days 00:02:08,2,5,3
118,TTK,P005685,P011975,0 days 00:02:02,-1,5,6
118,TTK,P005685,P011925,0 days 00:02:02,-1,5,6
118,TTK,P005000,P005685,0 days 00:02:02,-1,5,6
118,TTK,P004801,P005685,0 days 00:02:02,-1,5,6
118,TTK,P011834,P011975,0 days 00:00:55,-1,3,4
118,TTK,P000497,P009845,0 days 00:00:37,-3,0,3
118,TTK,P004801,P011978,0 days 00:00:07,-2,0,2
118,TTK,P005000,P011978,0 days 00:00:07,-2,0,2
118,TTK,P006693,P011978,0 days 00:00:07,-2,0,2
118,TTK,P011834,P011978,0 days 00:00:07,-2,0,2
118,ARI,P012716,P012717,0 days 00:23:52,12,57,45
118,ARI,P004292,P012716,0 days 00:21:36,11,58,47
118,ARI,P004292,P012708,0 days 00:18:23,6,48,42
118,ARI,P012708,P012716,0 days 00:17:24,8,45,37
118,ARI,P004292,P012717,0 days 00:17:05,15,43,28
118,ARI,P012708,P012717,0 days 00:14:37,8,35,27
118,ARI,P004292,P012702,0 days 00:14:12,7,36,29
118,ARI,P012760,P012792,0 days 00:13:38,3,34,31
118,ARI,P003240,P012792,0 days 00:13:19,3,28,25
118,ARI,P012702,P012708,0 days 00:13:14,8,34,26
118,ARI,P012702,P012716,0 days 00:12:10,9,31,22
118,ARI,P012702,P012717,0 days 00:12:10,9,31,22
118,ARI,P012716,P012760,0 days 00:11:52,-1,32,33
118,ARI,P004292,P012760,0 days 00:11:11,5,33,28
118,ARI,P003240,P004292,0 days 00:11:01,8,31,23
118,ARI,P003240,P010387,0 days 00:10:52,4,23,19
118,ARI,P012708,P012792,0 days 00:10:18,-6,19,25
118,ARI,P003240,P012760,0 days 00:10:12,11,30,19
118,ARI,P010387,P012792,0 days 00:09:56,3,18,15
118,ARI,P003240,P012716,0 days 00:09:55,3,27,24
118,ARI,P012716,P012792,0 days 00:09:49,-6,22,28
118,ARI,P003240,P012717,0 days 00:09:15,4,22,18
118,ARI,P003240,P012722,0 days 00:08:19,-3,13,16
118,ARI,P003240,P012708,0 days 00:08:15,-6,12,18
118,ARI,P012708,P012760,0 days 00:08:10,-3,19,22
118,ARI,P004292,P012792,0 days 00:07:36,2,21,19
118,ARI,P010387,P012708,0 days 00:07:30,-4,12,16
118,ARI,P012717,P012760,0 days 00:07:29,3,17,14
118,ARI,P004292,P010387,0 days 00:06:30,3,16,13
118,ARI,P012717,P012792,0 days 00:05:53,-2,12,14
118,ARI,P010387,P012760,0 days 00:05:51,6,14,8
118,ARI,P012722,P012792,0 days 00:05:19,-5,6,11
118,ARI,P012716,P012722,0 days 00:04:22,0,9,9
118,ARI,P012708,P012722,0 days 00:04:14,-3,4,7
118,ARI,P012717,P012722,0 days 00:04:13,0,9,9
118,ARI,P010387,P012722,0 days 00:04:05,-3,4,7
118,ARI,P003240,P012702,0 days 00:03:00,-3,7,10
118,ARI,P004292,P012722,0 days 00:02:21,3,5,2
118,ARI,P010387,P012702,0 days 00:02:02,-2,5,7
118,ARI,P003240,P012616,0 days 00:01:56,-1,7,8
118,ARI,P012616,P012716,0 days 00:01:30,-1,7,8
118,ARI,P010387,P012716,0 days 00:01:06,-3,0,3
118,ARI,P004292,P012616,0 days 00:01:01,0,5,5
118,ARI,P012616,P012760,0 days 00:01:01,0,5,5
118,ARI,P012616,P012722,0 days 00:00:55,-1,2,3
118,ARI,P012616,P012717,0 days 00:00:54,-1,2,3
118,ARI,P012616,P012708,0 days 00:00:27,0,0,0
119,LKB,P004664,P007029,0 days 00:25:28,9,63,54
119,LKB,P002012,P004664,0 days 00:24:22,3,59,56
119,LKB,P002012,P007029,0 days 00:23:32,-7,53,60
119,LKB,P006230,P007029,0 days 00:20:45,10,52,42
119,LKB,P004664,P006230,0 days 00:19:57,15,52,37
119,LKB,P002012,P006230,0 days 00:17:44,5,45,40
119,LKB,P004664,P006901,0 days 00:17:04,14,46,32
119,LKB,P006901,P007029,0 days 00:16:00,5,39,34
119,LKB,P004664,P010190,0 days 00:15:43,-3,37,40
119,LKB,P006230,P006901,0 days 00:15:19,16,44,28
119,LKB,P010190,P010461,0 days 00:15:12,-16,27,43
119,LKB,P007029,P010190,0 days 00:14:02,-11,28,39
119,LKB,P006901,P010190,0 days 00:13:59,-6,29,35
119,LKB,P002012,P010190,0 days 00:13:32,-8,30,38
119,LKB,P004868,P006901,0 days 00:13:27,10,33,23
119,LKB,P004664,P010461,0 days 00:13:15,-6,28,34
119,LKB,P004868,P007029,0 days 00:11:30,6,28,22
119,LKB,P007029,P010461,0 days 00:11:23,-10,21,31
119,LKB,P004664,P004868,0 days 00:11:07,6,27,21
119,LKB,P002012,P006901,0 days 00:10:54,-2,27,29
119,LKB,P002012,P010461,0 days 00:09:18,-12,16,28
119,LKB,P004868,P006230,0 days 00:08:57,3,21,18
119,LKB,P006901,P010461,0 days 00:08:29,-9,14,23
119,LKB,P004868,P010190,0 days 00:08:18,3,19,16
119,LKB,P004868,P010461,0 days 00:06:43,1,14,13
119,LKB,P006230,P010190,0 days 00:06:34,5,18,13
119,LKB,P005521,P007029,0 days 00:06:08,6,16,10
119,LKB,P005521,P006230,0 days 00:06:08,6,16,10
119,LKB,P004664,P005521,0 days 00:06:08,6,16,10
119,LKB,P002012,P005521,0 days 00:06:08,6,16,10
119,LKB,P002012,P004868,0 days 00:02:54,-5,6,11
119,ULM,P005422,P012603,0 days 00:24:25,10,65,55
119,ULM,P005422,P012604,0 days 00:21:37,8,57,49
119,ULM,P010582,P012603,0 days 00:21:33,2,47,45
119,ULM,P012603,P012604,0 days 00:20:21,5,52,47
119,ULM,P010582,P012604,0 days 00:19:59,9,49,40
119,ULM,P005422,P010582,0 days 00:19:54,10,48,38
119,ULM,P005422,P010106,0 days 00:16:53,4,42,38
119,ULM,P010106,P012603,0 days 00:16:53,4,42,38
119,ULM,P006997,P012703,0 days 00:14:09,-11,23,34
119,ULM,P010106,P012604,0 days 00:13:18,-1,31,32
119,ULM,P010106,P010582,0 days 00:12:54,-1,25,26
119,ULM,P005422,P010726,0 days 00:11:21,-1,29,30
119,ULM,P006997,P011457,0 days 00:10:32,-12,14,26
119,ULM,P006997,P010726,0 days 00:10:29,-13,14,27
119,ULM,P007952,P012703,0 days 00:10:08,-4,22,26
119,ULM,P010726,P012603,0 days 00:10:07,1,25,24
119,ULM,P010726,P012703,0 days 00:09:50,-12,14,26
119,ULM,P005422,P012703,0 days 00:09:29,5,30,25
119,ULM,P011457,P012703,0 days 00:09:24,-11,12,23
119,ULM,P007952,P010726,0 days 00:08:31,-8,14,22
119,ULM,P010726,P011457,0 days 00:08:19,-12,11,23
119,ULM,P006997,P007952,0 days 00:07:54,-8,12,20
119,ULM,P005422,P007952,0 days 00:07:51,0,19,19
119,ULM,P012603,P012703,0 days 00:07:26,-3,21,24
119,ULM,P010726,P012604,0 days 00:07:05,4,21,17
119,ULM,P010582,P010726,0 days 00:07:02,5,20,15
119,ULM,P006997,P010582,0 days 00:06:12,0,13,13
119,ULM,P012604,P012703,0 days 00:05:39,6,18,12
119,ULM,P011457,P012603,0 days 00:05:33,-11,7,18
119,ULM,P010582,P011457,0 days 00:05:00,-7,8,15
119,ULM,P010582,P012703,0 days 00:04:56,1,11,10
119,ULM,P005422,P006997,0 days 00:04:53,0,11,11
119,ULM,P007952,P011457,0 days 00:04:23,-3,6,9
119,ULM,P006997,P012603,0 days 00:04:14,-9,4,13
119,ULM,P007952,P012603,0 days 00:04:04,5,13,8
119,ULM,P010106,P012703,0 days 00:03:59,5,17,12
119,ULM,P007952,P010106,0 days 00:03:35,5,11,6
119,ULM,P011457,P012604,0 days 00:03:24,-4,7,11
119,ULM,P006997,P012604,0 days 00:03:17,5,9,4
119,ULM,P007952,P010582,0 days 00:01:58,1,3,2
119,ULM,P005422,P011457,0 days 00:01:29,-4,3,7
120,CAN,P003425,P008121,0 days 00:14:49,-14,31,45
120,CAN,P007560,P008121,0 days 00:13:24,3,39,36
120,CAN,P003425,P007560,0 days 00:13:19,-8,29,37
120,CAN,P001607,P006588,0 days 00:11:55,6,31,25
120,CAN,P004160,P005005,0 days 00:11:36,-5,23,28
120,CAN,P003425,P010452,0 days 00:11:24,-7,23,30
120,CAN,P003425,P010385,0 days 00:11:14,-9,20,29
120,CAN,P005005,P006588,0 days 00:10:54,5,24,19
120,CAN,P006588,P007560,0 days 00:10:21,-2,23,25
120,CAN,P005005,P007644,0 days 00:10:12,-9,11,20
120,CAN,P006588,P010385,0 days 00:10:02,4,28,24
120,CAN,P007560,P010385,0 days 00:10:02,-7,20,27
120,CAN,P001607,P005005,0 days 00:09:51,2,21,19
120,CAN,P001607,P004160,0 days 00:09:32,-7,18,25
120,CAN,P004160,P007644,0 days 00:09:27,-17,8,25
120,CAN,P004160,P010385,0 days 00:09:25,3,22,19
120,CAN,P003425,P007644,0 days 00:09:24,-14,9,23
120,CAN,P006588,P008121,0 days 00:09:20,-7,20,27
120,CAN,P007560,P010452,0 days 00:09:14,-3,21,24
120,CAN,P003425,P009864,0 days 00:09:06,-3,21,24
120,CAN,P003425,P006588,0 days 00:08:42,-7,13,20
120,CAN,P003425,P003637,0 days 00:08:22,-10,9,19
120,CAN,P008121,P009864,0 days 00:08:09,-11,16,27
120,CAN,P008121,P010452,0 days 00:08:05,-2,21,23
120,CAN,P008121,P010385,0 days 00:07:46,-3,18,21
120,CAN,P001607,P007644,0 days 00:07:34,-4,13,17
120,CAN,P005005,P010385,0 days 00:07:29,4,20,16
120,CAN,P004160,P006588,0 days 00:07:02,-5,16,21
120,CAN,P003425,P005005,0 days 00:06:47,-1,10,11
120,CAN,P003425,P004160,0 days 00:06:33,-7,7,14
120,CAN,P001607,P007560,0 days 00:05:56,6,15,9
120,CAN,P006588,P007644,0 days 00:05:46,1,11,10
120,CAN,P001607,P010385,0 days 00:05:37,12,20,8
120,CAN,P005005,P009864,0 days 00:05:21,-4,7,11
120,CAN,P003637,P009864,0 days 00:05:10,-6,7,13
120,CAN,P006588,P009864,0 days 00:05:09,-9,5,14
120,CAN,P007560,P007644,0 days 00:04:50,1,10,9
120,CAN,P003637,P008121,0 days 00:04:49,-11,4,15
120,CAN,P003637,P007644,0 days 00:04:47,-8,4,12
120,CAN,P007560,P009864,0 days 00:04:43,1,14,13
120,CAN,P007644,P008121,0 days 00:04:40,-3,11,14
120,CAN,P003637,P006588,0 days 00:04:37,-2,5,7
120,CAN,P007644,P009864,0 days 00:04:25,-9,4,13
120,CAN,P001607,P009864,0 days 00:04:24,-12,2,14
120,CAN,P004160,P007560,0 days 00:04:22,-10,2,12
120,CAN,P001607,P008121,0 days 00:04:11,1,12,11
120,CAN,P009864,P010452,0 days 00:03:56,3,14,11
120,CAN,P010385,P010452,0 days 00:03:55,-2,7,9
120,CAN,P004160,P009864,0 days 00:03:37,-10,2,12
120,CAN,P003637,P005005,0 days 00:03:33,1,5,4
120,CAN,P007644,P010452,0 days 00:03:33,-8,2,10
120,CAN,P004160,P010452,0 days 00:03:19,-5,2,7
120,CAN,P007644,P010385,0 days 00:03:14,-2,5,7
120,CAN,P003637,P010452,0 days 00:02:10,-4,2,6
120,CAN,P005005,P007560,0 days 00:02:09,-1,3,4
120,CAN,P004160,P008121,0 days 00:00:47,-5,0,5
120,TRN,P005738,P012595,0 days 00:19:38,20,58,38
120,TRN,P001479,P012593,0 days 00:16:14,5,35,30
120,TRN,P012593,P012596,0 days 00:15:20,1,32,31
120,TRN,P005738,P009903,0 days 00:13:54,6,40,34
120,TRN,P009903,P012595,0 days 00:13:46,8,42,34
120,TRN,P009903,P012597,0 days 00:13:22,9,36,27
120,TRN,P001479,P012596,0 days 00:12:22,-2,23,25
120,TRN,P005738,P012597,0 days 00:11:47,2,34,32
120,TRN,P009903,P012594,0 days 00:11:28,5,32,27
120,TRN,P006382,P012596,0 days 00:11:07,13,25,12
120,TRN,P007828,P012596,0 days 00:10:51,14,23,9
120,TRN,P012594,P012595,0 days 00:10:41,2,29,27
120,TRN,P005738,P012594,0 days 00:10:19,0,27,27
120,TRN,P012595,P012597,0 days 00:09:48,7,31,24
120,TRN,P005738,P007828,0 days 00:09:47,21,29,8
120,TRN,P012595,P012596,0 days 00:09:47,10,21,11
120,TRN,P012593,P012595,0 days 00:09:47,4,23,19
120,TRN,P009903,P012593,0 days 00:09:21,6,23,17
120,TRN,P005738,P012596,0 days 00:09:00,11,23,12
120,TRN,P005059,P012593,0 days 00:08:43,6,22,16
120,TRN,P005738,P012593,0 days 00:08:27,2,20,18
120,TRN,P007828,P012595,0 days 00:08:19,16,24,8
120,TRN,P012594,P012597,0 days 00:08:12,3,23,20
120,TRN,P007828,P012593,0 days 00:07:59,6,14,8
120,TRN,P012593,P012597,0 days 00:07:27,-4,13,17
120,TRN,P012593,P012594,0 days 00:07:11,1,19,18
120,TRN,P006382,P007828,0 days 00:06:48,10,14,4
120,TRN,P005738,P006382,0 days 00:06:44,4,14,10
120,TRN,P001479,P005059,0 days 00:06:43,4,15,11
120,TRN,P006382,P012593,0 days 00:06:23,8,16,8
120,TRN,P001479,P012597,0 days 00:06:09,2,13,11
120,TRN,P005059,P012596,0 days 00:05:48,2,13,11
120,TRN,P007828,P012597,0 days 00:05:27,5,16,11
120,TRN,P001479,P007828,0 days 00:05:19,-3,5,8
120,TRN,P001479,P006382,0 days 00:05:10,12,14,2
120,TRN,P001479,P012594,0 days 00:05:04,4,15,11
120,TRN,P001479,P009903,0 days 00:04:44,7,12,5
120,TRN,P012596,P012597,0 days 00:04:34,-5,11,16
120,TRN,P005059,P012595,0 days 00:04:33,0,10,10
120,TRN,P007828,P009903,0 days 00:04:15,4,11,7
120,TRN,P006382,P012595,0 days 00:03:58,7,9,2
120,TRN,P012594,P012596,0 days 00:03:55,-1,10,11
120,TRN,P001479,P012595,0 days 00:03:55,-2,5,7
120,TRN,P006382,P012594,0 days 00:03:37,8,10,2
120,TRN,P005059,P012597,0 days 00:03:29,2,8,6
120,TRN,P005059,P009903,0 days 00:02:55,4,9,5
120,TRN,P012596,P012687,0 days 00:02:44,-7,3,10
120,TRN,P001479,P012687,0 days 00:02:44,-7,3,10
120,TRN,P005059,P005738,0 days 00:02:00,2,7,5
120,TRN,P012593,P012687,0 days 00:01:52,-7,3,10
120,TRN,P007828,P012687,0 days 00:01:39,-1,0,1
120,TRN,P006382,P012597,0 days 00:01:29,-5,3,8
120,TRN,P012594,P012687,0 days 00:01:05,-6,3,9
120,TRN,P006382,P012687,0 days 00:00:52,0,0,0
120,TRN,P006382,P009903,0 days 00:00:47,3,3,0
120,TRN,P005059,P006382,0 days 00:00:41,4,4,0
121,PMT,P001686,P011942,0 days 00:17:27,4,44,40
121,PMT,P011823,P011942,0 days 00:16:09,13,48,35
121,PMT,P011823,P011944,0 days 00:15:55,5,40,35
121,PMT,P011942,P012600,0 days 00:15:26,12,48,36
121,PMT,P002644,P011942,0 days 00:15:05,1,44,43
121,PMT,P010549,P011823,0 days 00:14:50,5,34,29
121,PMT,P002644,P011947,0 days 00:14:36,-2,38,40
121,PMT,P001686,P012600,0 days 00:13:35,6,40,34
121,PMT,P011942,P011944,0 days 00:13:12,7,42,35
121,PMT,P002644,P011944,0 days 00:13:08,1,40,39
121,PMT,P001686,P011944,0 days 00:13:04,0,40,40
121,PMT,P001686,P002644,0 days 00:12:36,-4,36,40
121,PMT,P002644,P011823,0 days 00:11:35,0,28,28
121,PMT,P002644,P012600,0 days 00:11:29,-10,30,40
121,PMT,P011823,P011947,0 days 00:11:24,5,26,21
121,PMT,P011823,P011943,0 days 00:10:35,1,21,20
121,PMT,P011823,P012600,0 days 00:10:11,2,32,30
121,PMT,P011944,P011947,0 days 00:09:56,1,28,27
121,PMT,P001686,P011823,0 days 00:09:33,3,23,20
121,PMT,P011943,P011944,0 days 00:09:25,-5,20,25
121,PMT,P010549,P011942,0 days 00:09:22,7,24,17
121,PMT,P010549,P012600,0 days 00:07:58,2,21,19
121,PMT,P001686,P011966,0 days 00:07:57,-5,20,25
121,PMT,P002644,P011943,0 days 00:07:12,3,16,13
121,PMT,P011943,P011947,0 days 00:07:12,3,16,13
121,PMT,P011942,P011947,0 days 00:07:07,2,20,18
121,PMT,P011942,P011966,0 days 00:06:43,-2,16,18
121,PMT,P001686,P011947,0 days 00:06:26,-9,16,25
121,PMT,P002020,P011823,0 days 00:06:16,6,18,12
121,PMT,P002020,P010549,0 days 00:06:16,6,18,12
121,PMT,P002644,P010549,0 days 00:06:14,-4,10,14
121,PMT,P011944,P012600,0 days 00:06:12,4,23,19
121,PMT,P010549,P011943,0 days 00:05:53,3,10,7
121,PMT,P010549,P011947,0 days 00:05:03,-1,8,9
121,PMT,P011966,P012600,0 days 00:05:02,-3,14,17
121,PMT,P002644,P011966,0 days 00:04:49,-1,14,15
121,PMT,P001686,P010549,0 days 00:04:30,3,6,3
121,PMT,P010549,P011944,0 days 00:03:34,-1,5,6
121,PMT,P001686,P011943,0 days 00:03:28,-2,11,13
121,PMT,P002020,P011942,0 days 00:03:09,8,14,6
121,PMT,P002020,P012600,0 days 00:03:09,8,14,6
121,PMT,P011823,P011966,0 days 00:03:08,-4,6,10
121,PMT,P002020,P011944,0 days 00:03:07,-2,4,6
121,PMT,P002020,P011943,0 days 00:03:07,-2,4,6
121,PMT,P011944,P011966,0 days 00:02:55,-2,6,8
121,PMT,P011947,P012600,0 days 00:01:54,-8,4,12
121,PMT,P011943,P012600,0 days 00:01:52,-1,6,7
121,PMT,P011947,P011966,0 days 00:01:14,-3,4,7
121,LJU,P005969,P009395,0 days 00:34:16,1,89,88
121,LJU,P003452,P009395,0 days 00:33:43,-1,88,89
121,LJU,P003452,P005969,0 days 00:31:28,-5,81,86
121,LJU,P009395,P011261,0 days 00:30:08,6,81,75
121,LJU,P005969,P011261,0 days 00:27:56,2,74,72
121,LJU,P003452,P011261,0 days 00:27:20,0,73,73
121,LJU,P007066,P009395,0 days 00:23:13,11,69,58
121,LJU,P003452,P007066,0 days 00:21:30,5,61,56
121,LJU,P005969,P007066,0 days 00:21:01,7,62,55
121,LJU,P007066,P011261,0 days 00:19:29,8,55,47
121,LJU,P005969,P009392,0 days 00:16:47,-16,31,47
121,LJU,P002561,P009395,0 days 00:16:35,-6,36,42
121,LJU,P003452,P009392,0 days 00:15:39,-16,31,47
121,LJU,P009392,P009395,0 days 00:15:01,-11,29,40
121,LJU,P009392,P011261,0 days 00:14:11,-12,30,42
121,LJU,P002561,P007066,0 days 00:12:57,-2,35,37
121,LJU,P002561,P005969,0 days 00:12:40,-5,27,32
121,LJU,P002561,P003452,0 days 00:12:04,-7,26,33
121,LJU,P002561,P011261,0 days 00:08:32,0,19,19
121,LJU,P002561,P009392,0 days 00:03:44,-4,1,5
121,LJU,P007066,P009392,0 days 00:01:46,-5,2,7
122,BES,P005348,P009582,0 days 00:18:21,11,34,23
122,BES,P012622,P012647,0 days 00:17:35,16,34,18
122,BES,P008945,P012622,0 days 00:17:02,15,29,14
122,BES,P008945,P012647,0 days 00:16:37,27,36,9
122,BES,P011936,P012647,0 days 00:15:49,7,32,25
122,BES,P009582,P011924,0 days 00:14:05,2,26,24
122,BES,P007914,P011936,0 days 00:14:04,-2,25,27
122,BES,P009582,P012647,0 days 00:13:48,21,32,11
122,BES,P011924,P012647,0 days 00:13:43,7,28,21
122,BES,P008945,P009582,0 days 00:13:39,13,27,14
122,BES,P009582,P011936,0 days 00:13:31,7,28,21
122,BES,P005348,P012647,0 days 00:13:14,15,29,14
122,BES,P011924,P011936,0 days 00:12:52,-2,25,27
122,BES,P005348,P011924,0 days 00:12:16,-2,20,22
122,BES,P008945,P011936,0 days 00:12:01,6,22,16
122,BES,P007914,P012622,0 days 00:11:53,0,20,20
122,BES,P011936,P012622,0 days 00:11:38,5,22,17
122,BES,P007914,P011924,0 days 00:11:29,-3,19,22
122,BES,P007914,P012647,0 days 00:10:56,-2,18,20
122,BES,P009582,P011357,0 days 00:10:17,-5,15,20
122,BES,P011924,P012622,0 days 00:09:45,3,17,14
122,BES,P007914,P008945,0 days 00:09:35,2,15,13
122,BES,P009582,P012622,0 days 00:09:22,10,16,6
122,BES,P011357,P011936,0 days 00:09:04,-3,15,18
122,BES,P007914,P011357,0 days 00:08:42,-3,14,17
122,BES,P005348,P011936,0 days 00:08:35,2,17,15
122,BES,P011357,P011924,0 days 00:08:30,-4,13,17
122,BES,P005348,P008945,0 days 00:08:17,15,19,4
122,BES,P005348,P012622,0 days 00:06:32,5,10,5
122,BES,P005348,P011357,0 days 00:06:09,-7,6,13
122,BES,P007914,P009582,0 days 00:05:47,-1,10,11
122,BES,P008945,P011924,0 days 00:05:30,6,11,5
122,BES,P008945,P011357,0 days 00:04:59,-5,6,11
122,BES,P005348,P007914,0 days 00:04:07,-5,5,10
122,BES,P011357,P012622,0 days 00:04:04,-1,5,6
122,BES,P011379,P011924,0 days 00:04:02,-3,5,8
122,BES,P011379,P012647,0 days 00:02:09,-1,3,4
122,BES,P011379,P012622,0 days 00:02:04,1,3,2
122,BES,P008945,P011379,0 days 00:02:04,1,3,2
122,BES,P007914,P011379,0 days 00:01:58,-4,2,6
122,BES,P011379,P011936,0 days 00:01:58,-4,2,6
122,BES,P011357,P011379,0 days 00:01:03,0,2,2
122,BES,P009582,P011379,0 days 00:00:50,-2,0,2
122,BES,P005348,P012233,0 days 00:00:01,-2,0,2
122,BES,P007914,P012233,0 days 00:00:01,-2,0,2
122,BES,P012233,P012622,0 days 00:00:01,-2,0,2
122,BES,P012233,P012647,0 days 00:00:01,-2,0,2
122,WOL,P006546,PLCT,0 days 00:17:14,4,32,28
122,WOL,P005516,P012577,0 days 00:17:09,-1,23,24
122,WOL,P006546,P012789,0 days 00:16:31,4,31,27
122,WOL,P012789,PLCT,0 days 00:16:27,14,37,23
122,WOL,P003212,P012789,0 days 00:16:13,-2,30,32
122,WOL,P006546,P012577,0 days 00:15:36,-10,17,27
122,WOL,P003212,P006546,0 days 00:14:13,-8,22,30
122,WOL,P003212,P012577,0 days 00:13:39,-8,22,30
122,WOL,P012577,P012789,0 days 00:13:22,0,24,24
122,WOL,P003212,PLCT,0 days 00:12:48,5,27,22
122,WOL,P005516,P006546,0 days 00:12:43,-8,12,20
122,WOL,P004645,P012789,0 days 00:11:20,-1,20,21
122,WOL,P004645,PLCT,0 days 00:11:18,1,20,19
122,WOL,P003212,P004645,0 days 00:11:17,-5,18,23
122,WOL,P004645,P006546,0 days 00:10:47,-7,16,23
122,WOL,P006154,P012577,0 days 00:09:52,1,17,16
122,WOL,P005516,P012576,0 days 00:09:45,-10,7,17
122,WOL,P002387,P005516,0 days 00:09:10,-15,5,20
122,WOL,P006546,P012576,0 days 00:09:04,-17,2,19
122,WOL,P006907,P012577,0 days 00:08:55,4,16,12
122,WOL,P002387,P012577,0 days 00:08:52,-14,6,20
122,WOL,P012577,PLCT,0 days 00:08:32,11,21,10
122,WOL,P006154,P006907,0 days 00:08:18,4,16,12
122,WOL,P002387,P006546,0 days 00:08:04,-16,2,18
122,WOL,P012576,P012577,0 days 00:07:45,-5,6,11
122,WOL,P004229,P012577,0 days 00:07:33,-2,12,14
122,WOL,P004229,P006154,0 days 00:07:33,-2,12,14
122,WOL,P005516,P012789,0 days 00:07:12,3,13,10
122,WOL,P005516,PLCT,0 days 00:07:04,0,11,11
122,WOL,P002387,P012576,0 days 00:07:02,-13,2,15
122,WOL,P005516,P006907,0 days 00:06:23,4,11,7
122,WOL,P004229,P006907,0 days 00:06:12,1,11,10
122,WOL,P005516,P006154,0 days 00:05:46,4,11,7
122,WOL,P003212,P006154,0 days 00:04:06,-3,6,9
122,WOL,P003212,P004229,0 days 00:03:53,-3,6,9
122,WOL,P002387,P012789,0 days 00:03:50,-6,5,11
122,WOL,P002387,P003212,0 days 00:03:50,-6,5,11
122,WOL,P004229,P005516,0 days 00:03:40,1,6,5
122,WOL,P012576,PLCT,0 days 00:03:25,-9,1,10
122,WOL,P004645,P012577,0 days 00:03:25,-4,4,8
122,WOL,P006907,P012576,0 days 00:02:43,3,5,2
122,WOL,P002387,PLCT,0 days 00:02:40,-6,3,9
122,WOL,P003212,P006907,0 days 00:02:32,0,5,5
122,WOL,P003212,P005516,0 days 00:02:08,-2,3,5
122,WOL,P006154,P012576,0 days 00:02:06,3,5,2
122,WOL,P006154,P006546,0 days 00:01:34,-3,1,4
122,WOL,P004645,P005516,0 days 00:01:28,0,2,2
122,WOL,P003212,P012576,0 days 00:01:25,-4,0,4
122,WOL,P004645,P012576,0 days 00:01:25,-4,0,4
122,WOL,P004229,P006546,0 days 00:01:21,-3,1,4
122,WOL,P006546,P006907,0 days 00:00:37,0,0,0
122,WOL,P006154,P012789,0 days 00:00:13,0,0,0
123,JOV,P011248,P012349,0 days 00:23:23,2,48,46
123,JOV,P011248,P012780,0 days 00:18:57,-4,40,44
123,JOV,P010161,P012780,0 days 00:17:35,8,42,34
123,JOV,P011247,P011248,0 days 00:17:13,0,38,38
123,JOV,P010161,P011248,0 days 00:16:30,1,34,33
123,JOV,P011247,P012349,0 days 00:15:46,10,40,30
123,JOV,P010161,P011247,0 days 00:15:06,13,42,29
123,JOV,P012349,P012780,0 days 00:14:03,9,36,27
123,JOV,P010161,PJUG,0 days 00:14:02,16,39,23
123,JOV,P002507,P011247,0 days 00:13:51,1,31,30
123,JOV,P012780,PJUG,0 days 00:13:34,9,33,24
123,JOV,P011247,P012780,0 days 00:13:20,14,37,23
123,JOV,P002507,P011248,0 days 00:13:17,-7,21,28
123,JOV,P010161,P010458,0 days 00:12:48,2,31,29
123,JOV,P006771,P011248,0 days 00:12:15,-4,21,25
123,JOV,P002507,P006771,0 days 00:12:11,-3,20,23
123,JOV,P011247,PJUG,0 days 00:11:15,11,34,23
123,JOV,P010161,P012349,0 days 00:11:02,8,27,19
123,JOV,P011248,PJUG,0 days 00:10:56,-1,22,23
123,JOV,P010458,PJUG,0 days 00:10:40,7,28,21
123,JOV,P006771,P012349,0 days 00:10:27,0,19,19
123,JOV,P002507,P012349,0 days 00:10:01,-2,17,19
123,JOV,P010458,P011247,0 days 00:08:49,-1,22,23
123,JOV,P002507,PJUG,0 days 00:08:14,-2,18,20
123,JOV,P006771,P011247,0 days 00:08:12,0,16,16
123,JOV,P010458,P012780,0 days 00:06:11,-2,13,15
123,JOV,P010458,P011248,0 days 00:06:07,-2,12,14
123,JOV,P002507,P010161,0 days 00:06:07,3,17,14
123,JOV,P012349,PJUG,0 days 00:05:48,5,16,11
123,JOV,P010709,P011248,0 days 00:05:46,-4,9,13
123,JOV,P010709,P012349,0 days 00:05:46,-4,9,13
123,JOV,P002507,P010458,0 days 00:05:43,1,15,14
123,JOV,P006771,P012780,0 days 00:03:44,-3,5,8
123,JOV,P002507,P012780,0 days 00:03:06,-1,5,6
123,JOV,P006771,PJUG,0 days 00:02:59,-4,3,7
123,JOV,P002507,P010709,0 days 00:02:56,2,4,2
123,JOV,P006771,P010709,0 days 00:02:56,2,4,2
123,JOV,P010161,P010709,0 days 00:02:50,-6,5,11
123,JOV,P010709,P012780,0 days 00:02:50,-6,5,11
123,JOV,P010161,P010708,0 days 00:00:56,3,3,0
123,JOV,P010708,P011248,0 days 00:00:56,3,3,0
123,JOV,P010708,PJUG,0 days 00:00:56,3,3,0
123,JOV,P010458,P010708,0 days 00:00:54,3,3,0
123,JOV,P002507,P010708,0 days 00:00:02,0,0,0
123,VNC,P003759,P012591,0 days 00:27:13,11,62,51
123,VNC,P000968,P012591,0 days 00:26:47,10,62,52
123,VNC,P011909,P012591,0 days 00:26:10,-3,53,56
123,VNC,P000968,P003759,0 days 00:24:31,12,60,48
123,VNC,P008052,P012591,0 days 00:21:02,2,47,45
123,VNC,P003759,P011909,0 days 00:20:59,8,49,41
123,VNC,P008052,P011909,0 days 00:20:43,-1,48,49
123,VNC,P000968,P011909,0 days 00:20:33,7,49,42
123,VNC,P004117,P012591,0 days 00:18:50,-8,31,39
123,VNC,P000968,P008052,0 days 00:16:00,11,41,30
123,VNC,P003759,P008052,0 days 00:14:26,12,39,27
123,VNC,P004117,P011909,0 days 00:13:51,-12,20,32
123,VNC,P000968,P004117,0 days 00:13:03,-3,23,26
123,VNC,P003759,P004117,0 days 00:12:47,-1,23,24
123,VNC,P008052,P012590,0 days 00:10:50,-18,17,35
123,VNC,P011909,P012590,0 days 00:09:31,-12,15,27
123,VNC,P009400,P012591,0 days 00:08:25,4,17,13
123,VNC,P004117,P008052,0 days 00:07:11,-14,8,22
123,VNC,P012590,P012591,0 days 00:07:02,-9,8,17
123,VNC,P004117,P012590,0 days 00:06:55,-12,8,20
123,VNC,P004117,P009400,0 days 00:06:53,-3,11,14
123,VNC,P003759,P009400,0 days 00:06:14,3,13,10
123,VNC,P000968,P009400,0 days 00:06:14,3,13,10
123,VNC,P008052,P009400,0 days 00:06:07,-6,10,16
123,VNC,P008052,P012587,0 days 00:05:48,-9,11,20
123,VNC,P012587,P012590,0 days 00:05:48,-9,11,20
123,VNC,P011909,P011928,0 days 00:05:21,-5,11,16
123,VNC,P011928,P012590,0 days 00:05:13,-5,11,16
123,VNC,P008052,P011928,0 days 00:05:13,-5,11,16
123,VNC,P011928,P012587,0 days 00:04:17,-2,11,13
123,VNC,P011909,P012587,0 days 00:04:17,-2,11,13
123,VNC,P009400,P012590,0 days 00:03:19,-6,4,10
123,VNC,P003759,P012590,0 days 00:02:42,-1,2,3
123,VNC,P004117,P012587,0 days 00:01:31,-7,0,7
123,VNC,P009400,P012587,0 days 00:01:31,-7,0,7
123,VNC,P011928,P012591,0 days 00:01:19,-3,0,3
123,VNC,P009400,P011928,0 days 00:00:38,0,0,0
123,VNC,P004117,P011928,0 days 00:00:23,0,0,0
123,VNC,P009400,P011909,0 days 00:00:23,0,0,0
124,HTA,P004267,P004846,0 days 00:26:24,22,81,59
124,HTA,P004267,P011990,0 days 00:24:55,27,80,53
124,HTA,P004846,P011990,0 days 00:23:54,17,72,55
124,HTA,P003533,P011990,0 days 00:21:28,11,67,56
124,HTA,P004846,P011973,0 days 00:20:35,2,59,57
124,HTA,P011990,P012794,0 days 00:19:39,12,64,52
124,HTA,P007759,P011973,0 days 00:19:00,3,51,48
124,HTA,P004267,P011973,0 days 00:18:51,7,55,48
124,HTA,P011973,P011990,0 days 00:18:33,-3,49,52
124,HTA,P004267,P012794,0 days 00:18:14,25,63,38
124,HTA,P003533,P012794,0 days 00:18:06,14,59,45
124,HTA,P004267,P007759,0 days 00:18:04,11,54,43
124,HTA,P007759,P011990,0 days 00:15:40,6,42,36
124,HTA,P003533,P004267,0 days 00:15:25,23,52,29
124,HTA,P004846,P012794,0 days 00:15:13,17,53,36
124,HTA,P003533,P004846,0 days 00:15:04,15,46,31
124,HTA,P004846,P007759,0 days 00:14:37,4,40,36
124,HTA,P011973,P012794,0 days 00:11:27,-3,36,39
124,HTA,P007759,P012794,0 days 00:10:14,7,35,28
124,HTA,P003533,P011973,0 days 00:08:32,-5,23,28
124,HTA,P003533,P007759,0 days 00:07:57,4,23,19
124,HTA,P004267,P012028,0 days 00:03:44,-1,7,8
124,HTA,P004846,P012028,0 days 00:03:13,-1,5,6
124,HTA,P012028,P012794,0 days 00:02:37,-6,4,10
124,HTA,P003533,P012028,0 days 00:02:37,-6,4,10
124,HTA,P011973,P012028,0 days 00:02:30,-3,5,8
124,HTA,P007759,P012028,0 days 00:02:24,-1,5,6
124,HTA,P007759,P012706,0 days 00:02:22,0,6,6
124,HTA,P011973,P012706,0 days 00:02:22,0,6,6
124,HTA,P011990,P012028,0 days 00:01:48,-6,4,10
124,HTA,P012706,P012794,0 days 00:01:31,0,4,4
124,HTA,P012592,P012794,0 days 00:01:27,-6,2,8
124,HTA,P004267,P012706,0 days 00:01:15,2,4,2
124,HTA,P011990,P012592,0 days 00:01:11,-4,2,6
124,HTA,P012028,P012592,0 days 00:01:11,-4,2,6
124,HTA,P003533,P012592,0 days 00:01:11,-4,2,6
124,HTA,P007759,P012592,0 days 00:01:07,-2,2,4
124,HTA,P011973,P012592,0 days 00:01:07,-2,2,4
124,HTA,P012592,P012706,0 days 00:01:07,-2,2,4
124,HTA,P007759,P012793,0 days 00:00:51,0,2,2
124,HTA,P011973,P012793,0 days 00:00:51,0,2,2
124,HTA,P012592,P012793,0 days 00:00:51,0,2,2
124,HTA,P012706,P012793,0 days 00:00:51,0,2,2
124,HAM,P012580,P012581,0 days 00:22:01,-7,50,57
124,HAM,P011168,P012580,0 days 00:21:26,6,55,49
124,HAM,P011168,P012581,0 days 00:21:14,9,55,46
124,HAM,P009663,P012581,0 days 00:20:57,-11,49,60
124,HAM,P009663,P012580,0 days 00:17:58,-7,40,47
124,HAM,P009663,P011168,0 days 00:17:37,-1,43,44
124,HAM,P011168,P012579,0 days 00:16:55,-9,39,48
124,HAM,P011168,P012582,0 days 00:16:41,1,42,41
124,HAM,P009663,P012582,0 days 00:16:23,-10,40,50
124,HAM,P012581,P012582,0 days 00:15:47,-4,41,45
124,HAM,P012580,P012582,0 days 00:13:19,0,34,34
124,HAM,P011168,P011187,0 days 00:11:40,3,34,31
124,HAM,P011168,P012694,0 days 00:10:20,12,36,24
124,HAM,P012581,P012694,0 days 00:09:43,9,30,21
124,HAM,P012580,P012694,0 days 00:09:08,8,28,20
124,HAM,P012579,P012580,0 days 00:09:08,-6,20,26
124,HAM,P011187,P012579,0 days 00:09:05,-2,25,27
124,HAM,P011168,P012648,0 days 00:08:58,-6,23,29
124,HAM,P012579,P012582,0 days 00:07:41,-1,20,21
124,HAM,P011187,P012580,0 days 00:07:40,-5,20,25
124,HAM,P009663,P012648,0 days 00:06:58,-10,19,29
124,HAM,P012579,P012648,0 days 00:06:50,-8,16,24
124,HAM,P011187,P012581,0 days 00:06:36,1,18,17
124,HAM,P012582,P012648,0 days 00:06:33,-9,17,26
124,HAM,P012579,P012581,0 days 00:06:08,-2,11,13
124,HAM,P011187,P012694,0 days 00:05:56,1,15,14
124,HAM,P009663,P012579,0 days 00:05:46,-10,10,20
124,HAM,P012581,P012695,0 days 00:05:35,-13,14,27
124,HAM,P009663,P012695,0 days 00:05:35,-13,14,27
124,HAM,P009663,P012694,0 days 00:05:30,5,19,14
124,HAM,P012581,P012648,0 days 00:04:55,-2,16,18
124,HAM,P012582,P012695,0 days 00:04:48,-8,14,22
124,HAM,P011187,P012648,0 days 00:04:47,0,13,13
124,HAM,P011187,P012582,0 days 00:04:44,3,16,13
124,HAM,P012579,P012694,0 days 00:04:43,0,14,14
124,HAM,P012580,P012695,0 days 00:03:28,-12,7,19
124,HAM,P010070,P011187,0 days 00:03:24,-7,7,14
124,HAM,P010070,P012579,0 days 00:03:24,-7,7,14
124,HAM,P010070,P011168,0 days 00:03:13,-7,5,12
124,HAM,P012648,P012694,0 days 00:02:56,1,10,9
124,HAM,P012648,P012695,0 days 00:02:47,-4,9,13
124,HAM,P010070,P012580,0 days 00:02:24,-13,2,15
124,HAM,P010070,P012648,0 days 00:02:16,-2,5,7
124,HAM,P009663,P011187,0 days 00:01:44,-3,2,5
124,HAM,P010070,P012695,0 days 00:01:27,-8,2,10
124,HAM,P009663,P010070,0 days 00:01:16,-8,0,8
124,HAM,P010070,P012581,0 days 00:01:16,-8,0,8
124,HAM,P011187,P012695,0 days 00:00:40,-3,2,5
124,HAM,P012579,P012695,0 days 00:00:40,-3,2,5
125,PRS,P012608,P012610,0 days 00:24:42,2,51,49
125,PRS,P005793,P012608,0 days 00:18:31,3,40,37
125,PRS,P005793,P012610,0 days 00:18:30,3,40,37
125,PRS,P004512,P012608,0 days 00:18:28,5,42,37
125,PRS,P011232,P012640,0 days 00:17:12,17,45,28
125,PRS,P004512,P012610,0 days 00:16:24,2,35,33
125,PRS,P004512,P005793,0 days 00:14:11,8,33,25
125,PRS,P012608,P012609,0 days 00:13:32,12,34,22
125,PRS,P012609,P012640,0 days 00:13:04,23,39,16
125,PRS,P004512,P012609,0 days 00:13:03,14,34,20
125,PRS,P005793,P012609,0 days 00:12:38,16,33,17
125,PRS,P012613,P012640,0 days 00:12:08,8,27,19
125,PRS,P011232,P012609,0 days 00:11:40,18,34,16
125,PRS,P012608,P012640,0 days 00:11:36,1,23,22
125,PRS,P003481,P011232,0 days 00:11:25,11,27,16
125,PRS,P003481,P012640,0 days 00:11:25,11,27,16
125,PRS,P012609,P012610,0 days 00:10:59,11,27,16
125,PRS,P012610,P012640,0 days 00:09:42,-2,18,20
125,PRS,P005793,P012640,0 days 00:08:57,-8,17,25
125,PRS,P012608,P012613,0 days 00:08:37,-8,16,24
125,PRS,P012609,P012613,0 days 00:08:26,11,22,11
125,PRS,P003481,P012609,0 days 00:07:27,6,18,12
125,PRS,P012610,P012613,0 days 00:06:34,-11,9,20
125,PRS,P011232,P012613,0 days 00:06:23,8,15,7
125,PRS,P009556,P012640,0 days 00:05:56,14,23,9
125,PRS,P009556,P011232,0 days 00:05:56,14,23,9
125,PRS,P009556,P012609,0 days 00:05:56,14,23,9
125,PRS,P005793,P011887,0 days 00:04:47,-2,12,14
125,PRS,P004512,P011887,0 days 00:04:39,-9,8,17
125,PRS,P011887,P012608,0 days 00:04:39,-9,8,17
125,PRS,P011232,P012608,0 days 00:04:28,3,9,6
125,PRS,P003481,P012608,0 days 00:04:27,3,9,6
125,PRS,P005793,P012613,0 days 00:04:20,-5,7,12
125,PRS,P004512,P012613,0 days 00:04:17,-3,9,12
125,PRS,P011887,P012610,0 days 00:04:01,-7,6,13
125,PRS,P011232,P012610,0 days 00:03:58,5,9,4
125,PRS,P003481,P012610,0 days 00:03:58,5,9,4
125,PRS,P003481,P012613,0 days 00:03:36,1,5,4
125,PRS,P005793,P011232,0 days 00:03:14,-1,8,9
125,PRS,P003481,P009556,0 days 00:03:09,7,13,6
125,PRS,P011232,P011887,0 days 00:03:00,-1,8,9
125,PRS,P011887,P012640,0 days 00:03:00,-1,8,9
125,PRS,P011887,P012613,0 days 00:02:52,-8,4,12
125,PRS,P004512,P012640,0 days 00:02:49,3,7,4
125,PRS,P009556,P012613,0 days 00:02:47,7,10,3
125,PRS,P011887,P012609,0 days 00:02:03,3,8,5
125,PRS,P011232,P011551,0 days 00:01:35,-6,2,8
125,PRS,P005793,P011551,0 days 00:01:35,-6,2,8
125,PRS,P011551,P011887,0 days 00:01:35,-6,2,8
125,PRS,P011551,P012640,0 days 00:01:35,-6,2,8
125,PRS,P003481,P005793,0 days 00:00:13,0,0,0
125,PRS,P004512,P011232,0 days 00:00:01,0,0,0
125,LLI,P009680,P012585,0 days 00:25:32,-20,44,64
125,LLI,P006600,P012585,0 days 00:24:20,-16,43,59
125,LLI,P009649,P012585,0 days 00:20:50,-13,36,49
125,LLI,P005247,P006600,0 days 00:19:19,-18,32,50
125,LLI,P006600,P009680,0 days 00:18:15,-15,31,46
125,LLI,P005247,P012585,0 days 00:17:53,-14,31,45
125,LLI,P004773,P005247,0 days 00:17:50,-6,33,39
125,LLI,P006600,P009649,0 days 00:17:23,-6,30,36
125,LLI,P004773,P009680,0 days 00:16:52,-7,33,40
125,LLI,P009649,P009680,0 days 00:16:21,-14,26,40
125,LLI,P004773,P012585,0 days 00:14:45,-11,25,36
125,LLI,P005247,P009649,0 days 00:14:32,-4,28,32
125,LLI,P009649,P009672,0 days 00:14:27,-4,31,35
125,LLI,P005247,P009680,0 days 00:13:24,-15,21,36
125,LLI,P004773,P006600,0 days 00:13:22,-10,21,31
125,LLI,P009672,P012585,0 days 00:12:04,-13,22,35
125,LLI,P004773,P009649,0 days 00:11:35,-9,20,29
125,LLI,P009649,P012020,0 days 00:10:34,-7,21,28
125,LLI,P009680,P012020,0 days 00:10:09,-3,21,24
125,LLI,P004773,P012020,0 days 00:09:46,3,25,22
125,LLI,P006600,P009672,0 days 00:08:48,-10,17,27
125,LLI,P009672,P009680,0 days 00:08:08,-12,14,26
125,LLI,P005247,P009672,0 days 00:07:19,-4,17,21
125,LLI,P012020,P012585,0 days 00:07:17,-5,13,18
125,LLI,P006600,P008274,0 days 00:06:25,7,14,7
125,LLI,P009672,P012020,0 days 00:06:09,0,14,14
125,LLI,P008274,P009649,0 days 00:06:06,5,12,7
125,LLI,P005247,P012020,0 days 00:05:41,4,14,10
125,LLI,P004773,P008274,0 days 00:04:13,5,12,7
125,LLI,P005247,P008274,0 days 00:04:02,1,8,7
125,LLI,P008274,P012585,0 days 00:03:47,8,10,2
125,LLI,P008274,P009680,0 days 00:03:39,10,12,2
125,LLI,P004773,P009672,0 days 00:02:53,3,9,6
125,LLI,P004773,P012584,0 days 00:01:16,4,6,2
125,LLI,P008274,P012020,0 days 00:01:16,4,6,2
125,LLI,P008274,P012584,0 days 00:01:16,4,6,2
125,LLI,P009680,P012584,0 days 00:01:16,4,6,2
125,LLI,P012020,P012584,0 days 00:01:16,4,6,2
126,BOU,P010718,P011836,0 days 00:27:58,6,56,50
126,BOU,P010718,P012617,0 days 00:27:48,0,57,57
126,BOU,P011836,P012617,0 days 00:23:44,-3,47,50
126,BOU,P010431,P010718,0 days 00:22:07,0,41,41
126,BOU,P010431,P011836,0 days 00:20:47,-2,37,39
126,BOU,P010718,P011837,0 days 00:19:03,6,37,31
126,BOU,P010431,P012617,0 days 00:18:35,-12,32,44
126,BOU,P010431,P011837,0 days 00:17:05,1,32,31
126,BOU,P011836,P011837,0 days 00:16:58,4,33,29
126,BOU,P012618,P012628,0 days 00:16:04,11,39,28
126,BOU,P011837,P012617,0 days 00:15:52,-4,30,34
126,BOU,P011836,P012618,0 days 00:14:04,4,29,25
126,BOU,P011161,P012618,0 days 00:13:29,4,29,25
126,BOU,P010718,P012618,0 days 00:12:59,3,29,26
126,BOU,P012617,P012618,0 days 00:12:48,1,27,26
126,BOU,P011161,P012628,0 days 00:12:35,2,26,24
126,BOU,P000498,P011161,0 days 00:12:25,2,26,24
126,BOU,P004525,P011161,0 days 00:12:15,1,26,25
126,BOU,P000498,P012628,0 days 00:12:06,2,26,24
126,BOU,P000498,P012618,0 days 00:10:39,3,23,20
126,BOU,P004525,P012628,0 days 00:09:54,-3,20,23
126,BOU,P004525,P012618,0 days 00:09:44,2,23,21
126,BOU,P000498,P004525,0 days 00:09:02,0,20,20
126,BOU,P011836,P012628,0 days 00:08:19,10,22,12
126,BOU,P000498,P011836,0 days 00:06:57,9,13,4
126,BOU,P012617,P012628,0 days 00:05:46,3,14,11
126,BOU,P010431,P012618,0 days 00:05:25,-4,9,13
126,BOU,P011161,P011836,0 days 00:05:21,4,11,7
126,BOU,P000498,P011837,0 days 00:05:20,6,10,4
126,BOU,P010718,P012628,0 days 00:05:15,8,16,8
126,BOU,P011161,P012617,0 days 00:05:11,3,11,8
126,BOU,P010718,P011161,0 days 00:05:01,3,11,8
126,BOU,P004525,P012617,0 days 00:04:56,0,10,10
126,BOU,P004525,P011837,0 days 00:04:14,-2,7,9
126,BOU,P011161,P011837,0 days 00:04:07,1,8,7
126,BOU,P004525,P010718,0 days 00:04:04,3,10,7
126,BOU,P000498,P010718,0 days 00:03:53,7,7,0
126,BOU,P000498,P010431,0 days 00:03:34,7,7,0
126,BOU,P011837,P012628,0 days 00:02:09,-4,3,7
126,BOU,P004525,P010431,0 days 00:01:43,-1,4,5
126,BOU,P010431,P012628,0 days 00:00:44,-1,2,3
126,CAN,P006588,P008121,0 days 00:30:29,-1,59,60
126,CAN,P003637,P008121,0 days 00:28:34,-1,55,56
126,CAN,P003637,P006588,0 days 00:27:53,-1,55,56
126,CAN,P003425,P008121,0 days 00:26:44,-3,54,57
126,CAN,P003425,P006588,0 days 00:25:54,-8,49,57
126,CAN,P003425,P003637,0 days 00:25:01,-4,49,53
126,CAN,P008121,P009864,0 days 00:21:31,4,42,38
126,CAN,P006588,P009864,0 days 00:20:41,-1,37,38
126,CAN,P003637,P009864,0 days 00:20:15,3,37,34
126,CAN,P003425,P009864,0 days 00:18:39,1,36,35
126,CAN,P001607,P004160,0 days 00:14:16,-8,24,32
126,CAN,P001607,P010452,0 days 00:13:41,-12,20,32
126,CAN,P004160,P010452,0 days 00:13:23,-7,25,32
126,CAN,P008121,P010385,0 days 00:12:17,-1,25,26
126,CAN,P001607,P009864,0 days 00:10:30,-3,18,21
126,CAN,P006588,P010385,0 days 00:09:48,0,22,22
126,CAN,P001607,P005005,0 days 00:09:26,-12,13,25
126,CAN,P005005,P010452,0 days 00:09:26,-12,13,25
126,CAN,P004160,P005005,0 days 00:08:59,-12,13,25
126,CAN,P004160,P009864,0 days 00:08:54,-5,17,22
126,CAN,P003637,P010385,0 days 00:08:46,-4,18,22
126,CAN,P009864,P010452,0 days 00:08:28,-1,17,18
126,CAN,P003425,P010385,0 days 00:08:05,-4,18,22
126,CAN,P001607,P010385,0 days 00:07:46,-2,12,14
126,CAN,P004160,P010385,0 days 00:07:05,-2,12,14
126,CAN,P001607,P008121,0 days 00:07:04,6,13,7
126,CAN,P010385,P010452,0 days 00:06:03,-6,8,14
126,CAN,P005005,P009864,0 days 00:05:52,-7,8,15
126,CAN,P004160,P008121,0 days 00:05:14,4,12,8
126,CAN,P001607,P006588,0 days 00:04:35,7,10,3
126,CAN,P001607,P003637,0 days 00:04:00,3,6,3
126,CAN,P005005,P010385,0 days 00:03:34,-5,5,10
126,CAN,P008121,P010452,0 days 00:03:19,4,8,4
126,CAN,P004160,P006588,0 days 00:02:36,0,4,4
126,CAN,P001607,P007560,0 days 00:01:46,1,4,3
126,CAN,P004160,P007560,0 days 00:01:46,1,4,3
126,CAN,P007560,P009864,0 days 00:01:46,1,4,3
126,CAN,P007560,P010452,0 days 00:01:46,1,4,3
126,CAN,P003425,P004160,0 days 00:01:43,1,5,4
126,CAN,P003637,P010452,0 days 00:01:08,0,0,0
126,CAN,P003425,P010452,0 days 00:00:50,5,5,0
126,CAN,P003637,P005005,0 days 00:00:27,0,0,0
127,TRN,P005738,P009903,0 days 00:19:29,1,39,38
127,TRN,P009903,P012593,0 days 00:17:31,3,41,38
127,TRN,P009903,P012594,0 days 00:17:23,-3,33,36
127,TRN,P005059,P012593,0 days 00:16:52,6,34,28
127,TRN,P005738,P012594,0 days 00:16:46,-6,28,34
127,TRN,P005738,P012597,0 days 00:15:15,1,32,31
127,TRN,P005059,P005738,0 days 00:14:52,-2,27,29
127,TRN,P005738,P012593,0 days 00:14:41,0,31,31
127,TRN,P012593,P012594,0 days 00:14:31,-1,30,31
127,TRN,P005059,P009903,0 days 00:13:24,-2,28,30
127,TRN,P006382,P012597,0 days 00:12:41,5,27,22
127,TRN,P001479,P012596,0 days 00:12:27,2,18,16
127,TRN,P005059,P012596,0 days 00:12:09,8,22,14
127,TRN,P006382,P012596,0 days 00:12:09,-2,20,22
127,TRN,P001479,P007828,0 days 00:11:18,4,17,13
127,TRN,P001479,P005059,0 days 00:10:41,8,23,15
127,TRN,P005059,P012594,0 days 00:10:38,-6,17,23
127,TRN,P009903,P012597,0 days 00:10:22,1,23,22
127,TRN,P012596,P012597,0 days 00:10:09,0,20,20
127,TRN,P001479,P012593,0 days 00:10:01,5,17,12
127,TRN,P005059,P012597,0 days 00:09:56,1,22,21
127,TRN,P007828,P012596,0 days 00:09:33,1,12,11
127,TRN,P001479,P006382,0 days 00:08:12,-2,11,13
127,TRN,P007828,P012593,0 days 00:07:41,5,12,7
127,TRN,P012594,P012597,0 days 00:07:39,-6,12,18
127,TRN,P005738,P006382,0 days 00:07:25,5,16,11
127,TRN,P005059,P006382,0 days 00:07:19,4,15,11
127,TRN,P006382,P007828,0 days 00:07:14,0,10,10
127,TRN,P012593,P012596,0 days 00:07:11,2,7,5
127,TRN,P005059,P007828,0 days 00:06:21,7,12,5
127,TRN,P012593,P012597,0 days 00:05:34,0,15,15
127,TRN,P001479,P012597,0 days 00:05:16,0,11,11
127,TRN,P007828,P012597,0 days 00:05:12,2,10,8
127,TRN,P005738,P012596,0 days 00:04:53,0,9,9
127,TRN,P007828,P009903,0 days 00:03:41,6,10,4
127,TRN,P006382,P009903,0 days 00:03:28,5,7,2
127,TRN,P001479,P009903,0 days 00:03:11,3,10,7
127,TRN,P006382,P012593,0 days 00:02:35,-2,0,2
127,TRN,P012594,P012595,0 days 00:02:11,2,5,3
127,TRN,P012593,P012595,0 days 00:02:11,2,5,3
127,TRN,P009903,P012595,0 days 00:02:11,2,5,3
127,TRN,P005738,P012595,0 days 00:02:11,2,5,3
127,TRN,P005738,P007828,0 days 00:01:56,3,5,2
127,TRN,P001479,P012594,0 days 00:01:26,0,5,5
127,TRN,P006382,P012594,0 days 00:01:25,-1,2,3
127,TRN,P012594,P012596,0 days 00:00:49,-3,0,3
127,LKB,P002012,P007029,0 days 00:24:33,-3,45,48
127,LKB,P004664,P007029,0 days 00:23:29,2,47,45
127,LKB,P002012,P010190,0 days 00:22:16,-2,41,43
127,LKB,P002012,P006230,0 days 00:20:22,-4,34,38
127,LKB,P007029,P010190,0 days 00:20:17,-4,34,38
127,LKB,P006230,P007029,0 days 00:20:07,-7,31,38
127,LKB,P006230,P010190,0 days 00:19:32,-7,34,41
127,LKB,P002012,P004664,0 days 00:19:23,4,43,39
127,LKB,P004664,P010190,0 days 00:16:40,-2,34,36
127,LKB,P009898,P010190,0 days 00:15:05,-10,21,31
127,LKB,P004664,P006230,0 days 00:14:01,-2,27,29
127,LKB,P004664,P010461,0 days 00:13:36,1,29,28
127,LKB,P007029,P009898,0 days 00:13:31,-3,25,28
127,LKB,P007029,P010461,0 days 00:12:33,6,27,21
127,LKB,P002012,P009898,0 days 00:12:04,-2,25,27
127,LKB,P004868,P010461,0 days 00:11:46,-2,16,18
127,LKB,P009898,P010461,0 days 00:11:27,-3,23,26
127,LKB,P006230,P009898,0 days 00:09:24,-5,14,19
127,LKB,P006901,P010461,0 days 00:09:01,1,11,10
127,LKB,P004868,P006901,0 days 00:09:01,1,11,10
127,LKB,P004868,P009898,0 days 00:08:47,-6,12,18
127,LKB,P004664,P009898,0 days 00:08:28,-3,23,26
127,LKB,P004664,P004868,0 days 00:08:14,-5,13,18
127,LKB,P004868,P007029,0 days 00:08:07,2,13,11
127,LKB,P010190,P010461,0 days 00:08:05,-2,12,14
127,LKB,P006901,P007029,0 days 00:08:03,3,10,7
127,LKB,P004664,P006901,0 days 00:06:37,1,8,7
127,LKB,P002012,P010461,0 days 00:06:28,3,18,15
127,LKB,P004868,P010190,0 days 00:05:21,-7,5,12
127,LKB,P006901,P009898,0 days 00:04:38,0,5,5
127,LKB,P006901,P010190,0 days 00:03:12,-2,3,5
127,LKB,P002012,P006901,0 days 00:02:14,0,2,2
127,LKB,P006230,P006901,0 days 00:02:14,0,2,2
127,LKB,P004868,P006230,0 days 00:01:24,-3,2,5
128,ULM,P005422,P012604,0 days 00:26:00,14,60,46
128,ULM,P010106,P012604,0 days 00:25:51,12,62,50
128,ULM,P010582,P012604,0 days 00:22:56,1,48,47
128,ULM,P005422,P010106,0 days 00:22:52,13,56,43
128,ULM,P006997,P012604,0 days 00:18:05,3,37,34
128,ULM,P010106,P010582,0 days 00:17:41,5,40,35
128,ULM,P010582,P012603,0 days 00:17:34,-4,35,39
128,ULM,P005422,P010582,0 days 00:16:24,12,38,26
128,ULM,P005422,P006997,0 days 00:15:23,7,32,25
128,ULM,P012603,P012604,0 days 00:13:59,2,33,31
128,ULM,P010106,P012603,0 days 00:13:36,0,31,31
128,ULM,P006997,P010106,0 days 00:13:13,9,31,22
128,ULM,P006997,P012703,0 days 00:11:23,-12,22,34
128,ULM,P010582,P012703,0 days 00:10:45,-8,15,23
128,ULM,P006997,P010582,0 days 00:10:43,3,20,17
128,ULM,P005422,P012603,0 days 00:10:09,9,28,19
128,ULM,P012604,P012703,0 days 00:09:21,-12,17,29
128,ULM,P010582,P011457,0 days 00:09:07,-10,12,22
128,ULM,P011457,P012703,0 days 00:08:43,-11,11,22
128,ULM,P006997,P010726,0 days 00:08:33,0,15,15
128,ULM,P007952,P011457,0 days 00:07:28,-9,9,18
128,ULM,P010726,P012604,0 days 00:06:56,5,13,8
128,ULM,P005422,P010726,0 days 00:06:56,5,13,8
128,ULM,P010106,P010726,0 days 00:06:37,5,13,8
128,ULM,P006997,P011457,0 days 00:06:33,-7,12,19
128,ULM,P007952,P012703,0 days 00:06:21,-4,9,13
128,ULM,P005422,P012703,0 days 00:05:48,-2,13,15
128,ULM,P007952,P010582,0 days 00:05:30,-4,7,11
128,ULM,P011457,P012603,0 days 00:04:32,-8,2,10
128,ULM,P012603,P012703,0 days 00:04:00,-4,4,8
128,ULM,P011457,P012604,0 days 00:03:56,-6,5,11
128,ULM,P006997,P007952,0 days 00:03:51,-3,7,10
128,ULM,P007952,P012603,0 days 00:03:37,-6,2,8
128,ULM,P012066,P012604,0 days 00:03:04,-7,5,12
128,ULM,P010582,P012066,0 days 00:03:04,-7,5,12
128,ULM,P012066,P012603,0 days 00:02:55,-5,5,10
128,ULM,P010106,P011457,0 days 00:02:41,-4,3,7
128,ULM,P010106,P012703,0 days 00:02:40,-3,9,12
128,ULM,P010726,P011457,0 days 00:02:17,-5,2,7
128,ULM,P010726,P012703,0 days 00:02:17,-5,2,7
128,ULM,P007952,P010726,0 days 00:01:58,-5,2,7
128,ULM,P010106,P012066,0 days 00:01:34,-4,3,7
128,ULM,P012066,P012703,0 days 00:01:30,-3,2,5
128,ULM,P007952,P010106,0 days 00:01:07,-5,0,5
128,ULM,P005422,P011457,0 days 00:00:19,0,0,0
128,ULM,P005422,P012066,0 days 00:00:09,-2,0,2
128,ULM,P010726,P012603,0 days 00:00:02,0,0,0
128,TTK,P011239,P011925,0 days 00:28:00,14,68,54
128,TTK,P006693,P011925,0 days 00:27:01,-2,50,52
128,TTK,P006693,P011239,0 days 00:24:48,6,52,46
128,TTK,P011239,P011834,0 days 00:21:56,3,51,48
128,TTK,P006693,P011834,0 days 00:21:45,-5,39,44
128,TTK,P011834,P011925,0 days 00:21:44,1,45,44
128,TTK,P005000,P011925,0 days 00:19:05,11,46,35
128,TTK,P005000,P006693,0 days 00:17:12,3,33,30
128,TTK,P010477,P011925,0 days 00:16:13,-2,30,32
128,TTK,P005000,P011239,0 days 00:15:40,17,47,30
128,TTK,P006693,P010477,0 days 00:15:28,-7,25,32
128,TTK,P004801,P006693,0 days 00:13:49,-4,25,29
128,TTK,P010477,P011239,0 days 00:13:22,5,30,25
128,TTK,P004801,P011239,0 days 00:13:21,1,32,31
128,TTK,P004801,P011925,0 days 00:13:21,0,31,31
128,TTK,P004801,P011834,0 days 00:12:34,-2,27,29
128,TTK,P004801,P005000,0 days 00:12:22,10,36,26
128,TTK,P005000,P011834,0 days 00:11:55,6,28,22
128,TTK,P005000,P010477,0 days 00:09:50,2,19,17
128,TTK,P010477,P011834,0 days 00:09:50,-5,16,21
128,TTK,P005000,P009845,0 days 00:06:59,2,12,10
128,TTK,P009845,P011834,0 days 00:05:21,-2,5,7
128,TTK,P004801,P009845,0 days 00:05:15,4,12,8
128,TTK,P009845,P011925,0 days 00:04:28,0,8,8
128,TTK,P000497,P011834,0 days 00:04:03,8,13,5
128,TTK,P000497,P011925,0 days 00:04:03,8,13,5
128,TTK,P000497,P011239,0 days 00:04:03,8,13,5
128,TTK,P005685,P011925,0 days 00:03:53,-6,5,11
128,TTK,P005685,P006693,0 days 00:03:53,-6,5,11
128,TTK,P006693,P009845,0 days 00:03:53,-2,4,6
128,TTK,P005000,P005685,0 days 00:03:53,-6,5,11
128,TTK,P005685,P010477,0 days 00:02:35,-5,0,5
128,TTK,P000497,P006693,0 days 00:02:27,9,11,2
128,TTK,P009845,P011239,0 days 00:01:54,2,7,5
128,TTK,P000497,P005000,0 days 00:01:36,-1,2,3
128,TTK,P004801,P005685,0 days 00:01:18,-1,5,6
128,TTK,P009845,P010477,0 days 00:01:10,-4,0,4
129,ARI,P012716,P012717,0 days 00:24:24,14,55,41
129,ARI,P004292,P012708,0 days 00:22:39,16,53,37
129,ARI,P012708,P012717,0 days 00:21:02,18,49,31
129,ARI,P012708,P012716,0 days 00:20:01,21,50,29
129,ARI,P004292,P012717,0 days 00:19:23,10,44,34
129,ARI,P004292,P012716,0 days 00:17:40,13,45,32
129,ARI,P012716,P012760,0 days 00:12:38,10,34,24
129,ARI,P012717,P012760,0 days 00:12:38,10,34,24
129,ARI,P003240,P012615,0 days 00:12:15,4,30,26
129,ARI,P004292,P012760,0 days 00:12:10,16,36,20
129,ARI,P012708,P012760,0 days 00:11:03,15,32,17
129,ARI,P003240,P012702,0 days 00:10:47,3,22,19
129,ARI,P003240,P012792,0 days 00:10:41,1,24,23
129,ARI,P012702,P012708,0 days 00:10:06,1,16,15
129,ARI,P004292,P012702,0 days 00:08:54,-2,13,15
129,ARI,P012615,P012792,0 days 00:08:43,4,24,20
129,ARI,P012717,P012792,0 days 00:08:18,8,19,11
129,ARI,P003240,P004292,0 days 00:07:57,11,21,10
129,ARI,P012716,P012792,0 days 00:07:33,8,19,11
129,ARI,P012615,P012702,0 days 00:07:28,1,17,16
129,ARI,P012717,P012722,0 days 00:06:54,5,16,11
129,ARI,P012716,P012722,0 days 00:06:54,5,16,11
129,ARI,P003240,P012708,0 days 00:06:53,4,14,10
129,ARI,P010387,P012792,0 days 00:06:42,-7,13,20
129,ARI,P012702,P012717,0 days 00:06:40,-1,7,8
129,ARI,P012702,P012716,0 days 00:06:22,3,11,8
129,ARI,P010387,P012615,0 days 00:06:13,-7,11,18
129,ARI,P004292,P012615,0 days 00:06:09,11,19,8
129,ARI,P012760,P012792,0 days 00:05:42,7,15,8
129,ARI,P003240,P012717,0 days 00:05:19,1,8,7
129,ARI,P003240,P012716,0 days 00:05:06,8,15,7
129,ARI,P012615,P012708,0 days 00:05:05,4,12,8
129,ARI,P012708,P012722,0 days 00:04:58,6,13,7
129,ARI,P003240,P010387,0 days 00:04:36,-11,5,16
129,ARI,P004292,P012722,0 days 00:04:23,4,11,7
129,ARI,P012702,P012792,0 days 00:04:19,-1,8,9
129,ARI,P012722,P012792,0 days 00:03:49,-5,5,10
129,ARI,P012615,P012760,0 days 00:03:28,6,10,4
129,ARI,P003240,P012760,0 days 00:03:28,6,10,4
129,ARI,P010387,P012760,0 days 00:03:17,-6,5,11
129,ARI,P003240,P012722,0 days 00:03:14,-7,3,10
129,ARI,P010387,P012717,0 days 00:03:12,-1,8,9
129,ARI,P012708,P012792,0 days 00:02:41,3,5,2
129,ARI,P004292,P012792,0 days 00:01:51,10,10,0
129,ARI,P010387,P012702,0 days 00:01:40,-4,2,6
129,ARI,P010387,P012716,0 days 00:01:39,-5,2,7
129,ARI,P012615,P012716,0 days 00:01:39,7,9,2
129,ARI,P012615,P012717,0 days 00:01:37,4,6,2
129,ARI,P010387,P012638,0 days 00:01:33,4,6,2
129,ARI,P012615,P012638,0 days 00:01:33,4,6,2
129,ARI,P012638,P012717,0 days 00:01:33,4,6,2
129,ARI,P012638,P012792,0 days 00:01:33,4,6,2
129,ARI,P010387,P012722,0 days 00:01:18,-6,0,6
129,ARI,P012615,P012722,0 days 00:01:18,-6,0,6
129,ARI,P004292,P010387,0 days 00:01:02,-5,0,5
129,WRO,P012699,P012749,0 days 00:23:25,-16,44,60
129,WRO,P009896,P012699,0 days 00:22:48,-33,35,68
129,WRO,P009896,P011900,0 days 00:21:34,-10,37,47
129,WRO,P009896,P012749,0 days 00:21:07,-17,40,57
129,WRO,P011900,P012749,0 days 00:20:55,1,42,41
129,WRO,P009896,P012601,0 days 00:20:09,-19,31,50
129,WRO,P012601,P012699,0 days 00:19:47,-14,35,49
129,WRO,P011900,P012699,0 days 00:19:07,-12,31,43
129,WRO,P009896,P011901,0 days 00:18:51,-11,31,42
129,WRO,P011901,P012699,0 days 00:16:46,-19,27,46
129,WRO,P011900,P012601,0 days 00:15:18,-4,25,29
129,WRO,P011901,P012601,0 days 00:15:14,-16,21,37
129,WRO,P011278,P012749,0 days 00:15:02,-8,30,38
129,WRO,P012601,P012749,0 days 00:14:37,-7,28,35
129,WRO,P011278,P012699,0 days 00:14:35,-10,28,38
129,WRO,P003034,P012749,0 days 00:13:09,-1,25,26
129,WRO,P011901,P012749,0 days 00:12:13,0,27,27
129,WRO,P003034,P009896,0 days 00:11:42,-3,23,26
129,WRO,P011278,P011900,0 days 00:11:33,-5,22,27
129,WRO,P003034,P011901,0 days 00:11:16,7,26,19
129,WRO,P003034,P012699,0 days 00:10:44,-8,16,24
129,WRO,P003034,P011900,0 days 00:10:35,6,19,13
129,WRO,P011900,P011901,0 days 00:10:14,0,16,16
129,WRO,P003034,P012601,0 days 00:08:01,-4,11,15
129,WRO,P009896,P011278,0 days 00:07:49,-15,11,26
129,WRO,P003034,P011278,0 days 00:07:05,-5,12,17
129,WRO,P011278,P011901,0 days 00:03:50,-1,8,9
129,WRO,P011278,P012601,0 days 00:02:34,4,9,5
130,BUD,P006566,P012606,0 days 00:21:18,4,41,37
130,BUD,P006566,P011281,0 days 00:20:06,13,48,35
130,BUD,P005637,P012606,0 days 00:18:19,-10,26,36
130,BUD,P006566,P007398,0 days 00:17:53,4,37,33
130,BUD,P008325,P012606,0 days 00:17:37,7,42,35
130,BUD,P007398,P008325,0 days 00:16:36,4,35,31
130,BUD,P007398,P012606,0 days 00:16:10,6,35,29
130,BUD,P006566,P010248,0 days 00:15:59,4,33,29
130,BUD,P010248,P011281,0 days 00:15:58,5,33,28
130,BUD,P011281,P012606,0 days 00:15:00,2,35,33
130,BUD,P006566,P008325,0 days 00:14:52,0,29,29
130,BUD,P007398,P011281,0 days 00:12:53,1,29,28
130,BUD,P002740,P006566,0 days 00:11:54,-9,15,24
130,BUD,P010248,P012606,0 days 00:11:42,-9,14,23
130,BUD,P002740,P010248,0 days 00:11:10,-13,13,26
130,BUD,P004945,P011281,0 days 00:11:08,0,29,29
130,BUD,P005637,P006566,0 days 00:10:59,-2,17,19
130,BUD,P004945,P006566,0 days 00:10:23,2,28,26
130,BUD,P002740,P011281,0 days 00:10:16,-5,15,20
130,BUD,P005637,P010248,0 days 00:10:04,-13,10,23
130,BUD,P008325,P011281,0 days 00:09:43,-3,23,26
130,BUD,P005637,P008325,0 days 00:09:23,3,16,13
130,BUD,P004945,P007398,0 days 00:09:19,3,23,20
130,BUD,P004945,P012606,0 days 00:09:06,3,24,21
130,BUD,P005637,P007398,0 days 00:08:42,-2,9,11
130,BUD,P004945,P008325,0 days 00:08:41,3,24,21
130,BUD,P004945,P010248,0 days 00:08:33,3,19,16
130,BUD,P002740,P012606,0 days 00:08:04,-11,7,18
130,BUD,P005637,P011281,0 days 00:07:40,-5,12,17
130,BUD,P002740,P005637,0 days 00:06:31,-13,5,18
130,BUD,P004945,P005637,0 days 00:06:10,2,9,7
130,BUD,P007398,P010248,0 days 00:05:54,-1,10,11
130,BUD,P002740,P004945,0 days 00:05:36,8,16,8
130,BUD,P002740,P008325,0 days 00:03:48,2,7,5
130,BUD,P002740,P007398,0 days 00:02:33,-3,2,5
130,CLU,P011797,P012621,0 days 00:22:54,11,54,43
130,CLU,P005113,P011797,0 days 00:21:51,14,52,38
130,CLU,P005113,P012621,0 days 00:21:49,12,54,42
130,CLU,P004862,P011797,0 days 00:18:49,8,44,36
130,CLU,P004862,P012621,0 days 00:17:06,11,44,33
130,CLU,P010569,P011801,0 days 00:16:49,-3,26,29
130,CLU,P011797,P011801,0 days 00:16:07,1,33,32
130,CLU,P011801,P012621,0 days 00:15:27,6,37,31
130,CLU,P005113,P011801,0 days 00:15:15,6,36,30
130,CLU,P005714,P012621,0 days 00:14:26,-4,29,33
130,CLU,P004862,P005113,0 days 00:14:06,12,39,27
130,CLU,P005113,P005714,0 days 00:13:19,0,26,26
130,CLU,P005373,P011801,0 days 00:13:05,-1,19,20
130,CLU,P004862,P011801,0 days 00:13:02,5,29,24
130,CLU,P005714,P011797,0 days 00:12:40,-7,24,31
130,CLU,P011801,P012698,0 days 00:12:28,-3,21,24
130,CLU,P005373,P010569,0 days 00:12:05,-1,17,18
130,CLU,P005373,P012698,0 days 00:11:36,0,17,17
130,CLU,P004862,P005714,0 days 00:10:20,2,24,22
130,CLU,P004862,P005373,0 days 00:10:14,-5,14,19
130,CLU,P010569,P012698,0 days 00:10:03,2,17,15
130,CLU,P010569,P011797,0 days 00:07:35,-3,9,12
130,CLU,P004862,P010569,0 days 00:07:13,-4,9,13
130,CLU,P004862,P012698,0 days 00:06:50,-1,9,10
130,CLU,P010569,P012621,0 days 00:06:42,-3,8,11
130,CLU,P005113,P010569,0 days 00:05:52,-2,9,11
130,CLU,P011801,P012620,0 days 00:05:30,-2,11,13
130,CLU,P005373,P011797,0 days 00:05:22,-6,5,11
130,CLU,P005373,P012621,0 days 00:04:49,-1,7,8
130,CLU,P005714,P011801,0 days 00:04:33,-10,5,15
130,CLU,P012620,P012698,0 days 00:03:22,-1,6,7
130,CLU,P005373,P012620,0 days 00:03:17,1,6,5
130,CLU,P010569,P012620,0 days 00:03:17,1,6,5
130,CLU,P011797,P012698,0 days 00:02:25,-5,4,9
130,CLU,P005714,P012620,0 days 00:02:13,-3,5,8
130,CLU,P010997,P011801,0 days 00:02:12,1,3,2
130,CLU,P010997,P011797,0 days 00:02:12,1,3,2
130,CLU,P010569,P010997,0 days 00:02:12,1,3,2
130,CLU,P005113,P010997,0 days 00:02:12,1,3,2
130,CLU,P005113,P012620,0 days 00:02:08,-1,5,6
130,CLU,P012620,P012621,0 days 00:02:08,-1,5,6
130,CLU,P012621,P012698,0 days 00:01:59,1,6,5
130,CLU,P005373,P005714,0 days 00:01:12,-3,3,6
130,CLU,P005113,P012698,0 days 00:00:40,2,4,2
130,CLU,P005714,P012698,0 days 00:00:29,-7,0,7
130,CLU,P011797,P012620,0 days 00:00:05,-2,0,2
131,PRS,P012608,P012610,0 days 00:23:26,9,59,50
131,PRS,P011232,P012640,0 days 00:16:31,10,32,22
131,PRS,P004512,P012608,0 days 00:16:16,11,48,37
131,PRS,P004512,P012610,0 days 00:16:13,9,46,37
131,PRS,P009556,P011232,0 days 00:15:44,10,30,20
131,PRS,P009556,P012640,0 days 00:15:44,10,30,20
131,PRS,P011232,P012609,0 days 00:13:37,9,26,17
131,PRS,P012609,P012640,0 days 00:13:34,7,24,17
131,PRS,P009556,P012609,0 days 00:12:47,7,22,15
131,PRS,P012610,P012613,0 days 00:12:18,11,30,19
131,PRS,P012608,P012613,0 days 00:12:18,11,30,19
131,PRS,P005793,P012608,0 days 00:11:11,0,31,31
131,PRS,P005793,P012610,0 days 00:11:08,-2,29,31
131,PRS,P012612,P012640,0 days 00:10:57,3,23,20
131,PRS,P003481,P011232,0 days 00:09:13,3,16,13
131,PRS,P003481,P012640,0 days 00:09:13,3,16,13
131,PRS,P003481,P012609,0 days 00:09:13,3,16,13
131,PRS,P003481,P009556,0 days 00:09:13,3,16,13
131,PRS,P012608,P012640,0 days 00:08:49,5,21,16
131,PRS,P012610,P012640,0 days 00:08:49,5,21,16
131,PRS,P012613,P012640,0 days 00:08:47,14,24,10
131,PRS,P012608,P012609,0 days 00:08:17,9,28,19
131,PRS,P004512,P012609,0 days 00:08:17,9,28,19
131,PRS,P012609,P012610,0 days 00:08:14,7,26,19
131,PRS,P004512,P012613,0 days 00:08:09,6,22,16
131,PRS,P004512,P005793,0 days 00:08:07,5,26,21
131,PRS,P012610,P012612,0 days 00:07:13,0,13,13
131,PRS,P012608,P012612,0 days 00:07:13,0,13,13
131,PRS,P005793,P012609,0 days 00:06:28,6,20,14
131,PRS,P012609,P012613,0 days 00:06:10,7,16,9
131,PRS,P012612,P012613,0 days 00:05:10,5,10,5
131,PRS,P011887,P012610,0 days 00:05:02,-4,8,12
131,PRS,P004512,P011887,0 days 00:05:02,-4,8,12
131,PRS,P011887,P012608,0 days 00:05:02,-4,8,12
131,PRS,P005793,P012640,0 days 00:04:23,-5,5,10
131,PRS,P011232,P012613,0 days 00:03:57,3,10,7
131,PRS,P011232,P012612,0 days 00:03:44,3,10,7
131,PRS,P009556,P011887,0 days 00:02:57,3,8,5
131,PRS,P009556,P012612,0 days 00:02:57,3,8,5
131,PRS,P011232,P011887,0 days 00:02:57,3,8,5
131,PRS,P011887,P012612,0 days 00:02:57,3,8,5
131,PRS,P011887,P012640,0 days 00:02:57,3,8,5
131,PRS,P005793,P012612,0 days 00:02:50,-5,5,10
131,PRS,P005793,P011887,0 days 00:02:32,-3,4,7
131,PRS,P011887,P012613,0 days 00:02:30,-1,4,5
131,PRS,P009556,P012613,0 days 00:02:01,4,6,2
131,PRS,P005793,P011232,0 days 00:01:48,4,4,0
131,PRS,P004512,P012640,0 days 00:01:36,5,8,3
131,PRS,P005793,P009556,0 days 00:01:33,0,0,0
131,PRS,P004512,P011232,0 days 00:01:24,3,6,3
131,PRS,P011232,P012608,0 days 00:01:24,3,6,3
131,PRS,P011232,P012610,0 days 00:01:21,1,4,3
131,PRS,P012609,P012612,0 days 00:00:47,0,2,2
131,PMT,P001686,P011823,0 days 00:20:18,-14,36,50
131,PMT,P001686,P011943,0 days 00:19:56,-19,31,50
131,PMT,P011823,P011943,0 days 00:14:49,-19,23,42
131,PMT,P011823,P011947,0 days 00:14:48,-6,31,37
131,PMT,P001686,P011944,0 days 00:14:39,-15,24,39
131,PMT,P011823,P012600,0 days 00:14:07,-23,25,48
131,PMT,P011823,P011944,0 days 00:13:53,-15,27,42
131,PMT,P001686,P011947,0 days 00:13:33,-3,24,27
131,PMT,P011943,P011944,0 days 00:13:23,-13,22,35
131,PMT,P011944,P012600,0 days 00:12:08,-12,26,38
131,PMT,P002020,P011943,0 days 00:11:52,0,18,18
131,PMT,P011943,P012600,0 days 00:11:41,-19,17,36
131,PMT,P001686,P012600,0 days 00:11:24,-17,17,34
131,PMT,P005301,P011966,0 days 00:10:25,-1,20,21
131,PMT,P001686,P011942,0 days 00:10:18,4,22,18
131,PMT,P001686,P011966,0 days 00:10:10,0,20,20
131,PMT,P011823,P011966,0 days 00:10:08,-1,21,22
131,PMT,P011823,P011942,0 days 00:09:55,7,24,17
131,PMT,P011942,P011966,0 days 00:09:50,6,21,15
131,PMT,P011942,P011943,0 days 00:09:11,3,17,14
131,PMT,P011943,P011947,0 days 00:08:29,-6,11,17
131,PMT,P011942,P011947,0 days 00:08:22,7,20,13
131,PMT,P011943,P011966,0 days 00:08:10,-1,13,14
131,PMT,P002020,P011966,0 days 00:08:04,1,15,14
131,PMT,P005301,P011823,0 days 00:08:01,-6,18,24
131,PMT,P001686,P002020,0 days 00:07:30,-3,12,15
131,PMT,P005301,P011942,0 days 00:06:56,2,12,10
131,PMT,P005301,P011943,0 days 00:06:45,0,10,10
131,PMT,P002020,P005301,0 days 00:06:34,1,10,9
131,PMT,P011944,P011966,0 days 00:06:27,-5,12,17
131,PMT,P002020,P011942,0 days 00:06:02,-1,8,9
131,PMT,P011947,P011966,0 days 00:06:00,3,14,11
131,PMT,P002020,P011944,0 days 00:05:32,-3,10,13
131,PMT,P005301,P011944,0 days 00:05:28,-4,15,19
131,PMT,P011947,P012600,0 days 00:05:22,-12,8,20
131,PMT,P005301,P011947,0 days 00:04:37,-3,9,12
131,PMT,P005301,P012600,0 days 00:04:13,-5,11,16
131,PMT,P011944,P011947,0 days 00:03:34,-3,8,11
131,PMT,P002691,P011947,0 days 00:03:21,-1,5,6
131,PMT,P002691,P005301,0 days 00:02:58,-3,3,6
131,PMT,P002020,P011947,0 days 00:02:58,0,2,2
131,PMT,P011942,P011944,0 days 00:02:36,-2,4,6
131,PMT,P002691,P011943,0 days 00:02:28,-2,2,4
131,PMT,P001686,P005301,0 days 00:02:23,-1,4,5
131,PMT,P002691,P011823,0 days 00:02:09,-3,3,6
131,PMT,P011966,P012600,0 days 00:02:03,-1,5,6
131,PMT,P002020,P002691,0 days 00:01:50,0,2,2
131,PMT,P002691,P011966,0 days 00:01:31,-1,3,4
131,PMT,P002020,P012600,0 days 00:01:30,1,3,2
131,PMT,P001686,P002691,0 days 00:01:01,0,2,2
131,PMT,P002691,P011942,0 days 00:00:38,-2,0,2
132,HTA,P011973,P012794,0 days 00:30:48,5,74,69
132,HTA,P004846,P011973,0 days 00:26:37,7,77,70
132,HTA,P004846,P007759,0 days 00:24:27,-5,64,69
132,HTA,P010550,P011973,0 days 00:23:54,3,59,56
132,HTA,P007759,P011973,0 days 00:23:48,-3,62,65
132,HTA,P007759,P010550,0 days 00:23:14,-6,53,59
132,HTA,P004846,P010550,0 days 00:23:09,5,61,56
132,HTA,P004846,P012794,0 days 00:22:12,13,65,52
132,HTA,P010550,P012794,0 days 00:20:08,9,49,40
132,HTA,P007759,P012794,0 days 00:19:23,3,50,47
132,HTA,P011973,P011990,0 days 00:10:49,3,22,19
132,HTA,P003533,P007867,0 days 00:10:45,-7,18,25
132,HTA,P011990,P012794,0 days 00:10:28,3,22,19
132,HTA,P007867,P011973,0 days 00:10:26,-9,13,22
132,HTA,P007867,P012794,0 days 00:09:33,-9,11,20
132,HTA,P007867,P010550,0 days 00:08:36,-8,13,21
132,HTA,P004267,P004846,0 days 00:08:32,-6,29,35
132,HTA,P004267,P007759,0 days 00:08:32,-6,29,35
132,HTA,P004267,P011973,0 days 00:08:32,-6,29,35
132,HTA,P007867,P011990,0 days 00:08:22,-7,11,18
132,HTA,P007759,P007867,0 days 00:07:51,-4,15,19
132,HTA,P010550,P011990,0 days 00:07:45,6,21,15
132,HTA,P003533,P011990,0 days 00:06:58,-3,11,14
132,HTA,P003533,P011973,0 days 00:05:58,-4,8,12
132,HTA,P003533,P012794,0 days 00:05:58,-4,8,12
132,HTA,P003533,P007759,0 days 00:04:47,-3,10,13
132,HTA,P003533,P010550,0 days 00:04:47,-3,10,13
132,HTA,P004267,P012794,0 days 00:04:42,0,17,17
132,HTA,P004846,P007867,0 days 00:04:40,-4,9,13
132,HTA,P004846,P011990,0 days 00:04:24,10,16,6
132,HTA,P003533,P004846,0 days 00:03:47,-4,7,11
132,HTA,P004267,P010550,0 days 00:03:11,-6,10,16
132,HTA,P007759,P011990,0 days 00:02:18,0,5,5
132,HTA,P004267,P007867,0 days 00:00:39,0,2,2
132,LLI,P009649,P012586,0 days 00:25:33,9,66,57
132,LLI,P006600,P012585,0 days 00:24:49,-2,64,66
132,LLI,P009680,P012585,0 days 00:22:09,2,58,56
132,LLI,P006600,P009680,0 days 00:21:36,5,58,53
132,LLI,P012585,P012586,0 days 00:19:50,1,45,44
132,LLI,P006600,P012586,0 days 00:19:15,-1,45,46
132,LLI,P004773,P012797,0 days 00:17:47,3,43,40
132,LLI,P004773,P012586,0 days 00:17:37,6,41,35
132,LLI,P006600,P009649,0 days 00:17:07,0,45,45
132,LLI,P009649,P012585,0 days 00:15:18,1,41,40
132,LLI,P012586,P012797,0 days 00:14:34,-4,33,37
132,LLI,P009680,P012586,0 days 00:14:13,7,35,28
132,LLI,P009649,P012797,0 days 00:14:09,-5,36,41
132,LLI,P004773,P012020,0 days 00:13:22,7,32,25
132,LLI,P012585,P012797,0 days 00:12:54,-8,31,39
132,LLI,P009649,P009680,0 days 00:12:39,9,36,27
132,LLI,P004773,P012585,0 days 00:12:28,-5,27,32
132,LLI,P012020,P012586,0 days 00:12:15,9,31,22
132,LLI,P004773,P009649,0 days 00:12:14,8,32,24
132,LLI,P006600,P012797,0 days 00:11:46,-7,31,38
132,LLI,P004773,P006600,0 days 00:11:20,-4,27,31
132,LLI,P012020,P012797,0 days 00:10:39,2,24,22
132,LLI,P004773,P009680,0 days 00:10:38,-5,24,29
132,LLI,P009649,P012020,0 days 00:10:25,9,28,19
132,LLI,P009680,P012797,0 days 00:07:51,-1,22,23
132,LLI,P004773,P012584,0 days 00:03:22,2,10,8
132,LLI,P012020,P012585,0 days 00:02:57,-2,4,6
132,LLI,P009649,P012584,0 days 00:02:43,5,8,3
132,LLI,P012020,P012584,0 days 00:02:43,5,8,3
132,LLI,P012584,P012586,0 days 00:02:43,5,8,3
132,LLI,P009680,P012020,0 days 00:01:07,-2,1,3
132,LLI,P006600,P012584,0 days 00:00:39,-3,2,5
132,LLI,P009680,P012584,0 days 00:00:39,-3,2,5
132,LLI,P012584,P012585,0 days 00:00:39,-3,2,5
133,HAM,P011168,P012581,0 days 00:22:05,-3,52,55
133,HAM,P009663,P012582,0 days 00:22:00,-11,52,63
133,HAM,P012581,P012582,0 days 00:21:49,0,55,55
133,HAM,P009663,P012581,0 days 00:20:12,-8,50,58
133,HAM,P011168,P012582,0 days 00:18:40,-5,39,44
133,HAM,P011168,P012580,0 days 00:18:00,-2,33,35
133,HAM,P009663,P011168,0 days 00:17:34,-10,34,44
133,HAM,P012580,P012581,0 days 00:16:40,-4,33,37
133,HAM,P011168,P012579,0 days 00:15:26,-5,30,35
133,HAM,P009663,P012648,0 days 00:15:09,6,38,32
133,HAM,P009663,P012580,0 days 00:14:48,-8,28,36
133,HAM,P012580,P012582,0 days 00:14:06,-7,25,32
133,HAM,P012579,P012581,0 days 00:13:07,-6,30,36
133,HAM,P012581,P012648,0 days 00:13:02,7,39,32
133,HAM,P012579,P012580,0 days 00:10:52,-2,19,21
133,HAM,P012582,P012648,0 days 00:09:41,5,28,23
133,HAM,P010070,P012648,0 days 00:09:01,2,21,19
133,HAM,P001990,P012648,0 days 00:08:49,7,23,16
133,HAM,P001990,P009663,0 days 00:08:44,2,23,21
133,HAM,P012579,P012582,0 days 00:08:29,-8,17,25
133,HAM,P009663,P012579,0 days 00:07:48,-13,12,25
133,HAM,P011168,P012648,0 days 00:07:46,-1,19,20
133,HAM,P001990,P012581,0 days 00:07:30,-1,19,20
133,HAM,P001990,P010070,0 days 00:06:27,2,14,12
133,HAM,P010070,P012581,0 days 00:05:47,-2,13,15
133,HAM,P009663,P010070,0 days 00:05:32,-1,10,11
133,HAM,P012580,P012648,0 days 00:05:11,3,14,11
133,HAM,P011168,P012696,0 days 00:05:04,0,10,10
133,HAM,P012580,P012696,0 days 00:05:04,0,10,10
133,HAM,P012579,P012696,0 days 00:05:04,0,10,10
133,HAM,P001990,P012580,0 days 00:04:27,3,12,9
133,HAM,P010070,P012580,0 days 00:04:27,3,12,9
133,HAM,P010070,P012579,0 days 00:04:13,-2,7,9
133,HAM,P001990,P012582,0 days 00:04:04,1,13,12
133,HAM,P012579,P012648,0 days 00:04:02,-2,7,9
133,HAM,P012581,P012696,0 days 00:03:46,-2,8,10
133,HAM,P010070,P011168,0 days 00:03:13,-2,7,9
133,HAM,P009663,P012695,0 days 00:02:15,1,7,6
133,HAM,P012582,P012695,0 days 00:02:15,1,7,6
133,HAM,P012648,P012695,0 days 00:02:07,1,7,6
133,HAM,P001990,P012579,0 days 00:02:03,-2,4,6
133,HAM,P012581,P012695,0 days 00:01:30,3,5,2
133,HAM,P009663,P012696,0 days 00:01:18,2,2,0
133,HAM,P012580,P012695,0 days 00:00:53,-2,2,4
133,JOV,P006771,P010458,0 days 00:21:53,2,52,50
133,JOV,P010458,P011248,0 days 00:21:38,6,53,47
133,JOV,P006771,P011248,0 days 00:19:37,10,50,40
133,JOV,P002507,P011248,0 days 00:19:30,10,56,46
133,JOV,P011247,P011248,0 days 00:18:32,6,45,39
133,JOV,P010458,P012780,0 days 00:16:29,1,36,35
133,JOV,P006771,P011247,0 days 00:14:51,13,43,30
133,JOV,P011248,PJUG,0 days 00:14:25,0,34,34
133,JOV,P006771,P012780,0 days 00:14:22,8,36,28
133,JOV,P010458,P011247,0 days 00:14:19,3,34,31
133,JOV,P011248,P012780,0 days 00:14:18,3,30,27
133,JOV,P011247,P012780,0 days 00:14:11,5,29,24
133,JOV,P002507,P011247,0 days 00:13:25,8,40,32
133,JOV,P010458,PJUG,0 days 00:13:06,4,32,28
133,JOV,P010161,P011248,0 days 00:12:18,-4,29,33
133,JOV,P002507,P006771,0 days 00:11:53,10,34,24
133,JOV,P010161,P011247,0 days 00:10:52,-7,19,26
133,JOV,P002507,P010458,0 days 00:10:21,6,30,24
133,JOV,P011247,P012349,0 days 00:10:17,-4,21,25
133,JOV,P010161,P012349,0 days 00:10:14,-10,19,29
133,JOV,P002507,P012349,0 days 00:10:09,-4,23,27
133,JOV,P002507,P010161,0 days 00:10:03,-1,26,27
133,JOV,P006771,PJUG,0 days 00:09:58,-2,20,22
133,JOV,P002507,PJUG,0 days 00:09:49,-1,20,21
133,JOV,P011248,P012349,0 days 00:09:10,-7,19,26
133,JOV,P010709,P011247,0 days 00:06:20,2,17,15
133,JOV,P012780,PJUG,0 days 00:05:54,-1,14,15
133,JOV,P010709,P012780,0 days 00:05:12,1,13,12
133,JOV,P010458,P010709,0 days 00:05:12,1,13,12
133,JOV,P006771,P010709,0 days 00:05:12,1,13,12
133,JOV,P010161,PJUG,0 days 00:05:10,0,14,14
133,JOV,P010161,P012780,0 days 00:04:41,-4,7,11
133,JOV,P010161,P010458,0 days 00:04:22,5,14,9
133,JOV,P012349,PJUG,0 days 00:02:37,-6,2,8
133,JOV,P011247,PJUG,0 days 00:01:53,-2,0,2
133,JOV,P012349,P012780,0 days 00:01:27,-4,0,4
133,JOV,P002507,P012780,0 days 00:01:26,7,7,0
133,JOV,P006771,P012349,0 days 00:01:22,2,4,2
133,JOV,P002507,P010709,0 days 00:01:08,1,4,3
133,JOV,P010161,P010709,0 days 00:01:08,1,4,3
133,JOV,P010709,P012349,0 days 00:01:08,1,4,3
133,JOV,P006771,P010161,0 days 00:00:08,0,0,0
134,VNC,P004381,P012591,0 days 00:30:45,6,68,62
134,VNC,P004381,P011909,0 days 00:29:46,8,69,61
134,VNC,P011909,P012591,0 days 00:27:36,10,64,54
134,VNC,P004381,P008052,0 days 00:20:49,6,55,49
134,VNC,P008052,P012796,0 days 00:20:07,23,65,42
134,VNC,P008052,P012591,0 days 00:19:39,8,54,46
134,VNC,P003759,P004381,0 days 00:17:39,-9,23,32
134,VNC,P008052,P011909,0 days 00:17:31,10,48,38
134,VNC,P011928,P012591,0 days 00:17:28,-11,28,39
134,VNC,P004381,P011928,0 days 00:17:10,-8,28,36
134,VNC,P003759,P012591,0 days 00:16:14,-6,20,26
134,VNC,P003759,P011909,0 days 00:14:58,-3,20,23
134,VNC,P008052,P009400,0 days 00:14:43,7,39,32
134,VNC,P011909,P011928,0 days 00:14:15,-3,25,28
134,VNC,P004381,P012796,0 days 00:12:44,13,44,31
134,VNC,P012591,P012796,0 days 00:12:41,15,46,31
134,VNC,P011909,P012796,0 days 00:12:30,12,43,31
134,VNC,P003759,P011928,0 days 00:10:51,-4,13,17
134,VNC,P008052,P012587,0 days 00:10:46,5,29,24
134,VNC,P009400,P012796,0 days 00:10:44,12,30,18
134,VNC,P000968,P008052,0 days 00:10:02,9,30,21
134,VNC,P000968,P009400,0 days 00:10:02,9,30,21
134,VNC,P000968,P012796,0 days 00:09:07,9,27,18
134,VNC,P009400,P012587,0 days 00:09:02,9,26,17
134,VNC,P012587,P012796,0 days 00:08:44,5,23,18
134,VNC,P000968,P012587,0 days 00:07:37,12,23,11
134,VNC,P003759,P008052,0 days 00:07:25,-2,13,15
134,VNC,P009400,P012591,0 days 00:07:08,-7,13,20
134,VNC,P004381,P009400,0 days 00:06:34,-5,11,16
134,VNC,P009400,P011928,0 days 00:04:09,-8,5,13
134,VNC,P008052,P011928,0 days 00:03:38,-6,7,13
134,VNC,P003759,P009400,0 days 00:03:18,-3,6,9
134,VNC,P004381,P012587,0 days 00:03:09,-7,6,13
134,VNC,P000968,P012591,0 days 00:02:25,-3,7,10
134,VNC,P011928,P012796,0 days 00:02:03,-1,6,7
134,VNC,P003759,P012587,0 days 00:02:02,0,6,6
134,VNC,P009400,P011909,0 days 00:02:00,2,4,2
134,VNC,P011909,P012587,0 days 00:01:44,-4,3,7
134,VNC,P000968,P003759,0 days 00:00:37,3,3,0
134,VNC,P000968,P011928,0 days 00:00:18,-3,0,3
134,BES,P008945,P012647,0 days 00:31:54,-7,65,72
134,BES,P008945,P012622,0 days 00:30:39,8,66,58
134,BES,P012622,P012647,0 days 00:27:57,-4,55,59
134,BES,P011936,P012647,0 days 00:25:50,5,54,49
134,BES,P008945,P011936,0 days 00:23:09,1,47,46
134,BES,P007914,P008945,0 days 00:21:16,0,56,56
134,BES,P011936,P012622,0 days 00:20:52,4,42,38
134,BES,P007914,P011924,0 days 00:18:31,1,45,44
134,BES,P007914,P012647,0 days 00:18:05,0,46,46
134,BES,P007914,P012622,0 days 00:15:12,12,43,31
134,BES,P008945,P011379,0 days 00:14:27,-9,18,27
134,BES,P008945,P011924,0 days 00:14:22,0,35,35
134,BES,P011379,P012647,0 days 00:13:46,-7,18,25
134,BES,P012647,P012711,0 days 00:13:10,-15,30,45
134,BES,P007914,P011936,0 days 00:13:01,4,34,30
134,BES,P011924,P012647,0 days 00:12:57,-6,28,34
134,BES,P011379,P011936,0 days 00:12:54,-3,17,20
134,BES,P011379,P012622,0 days 00:11:49,-3,15,18
134,BES,P007914,P012711,0 days 00:11:38,-12,27,39
134,BES,P011924,P012711,0 days 00:11:15,-11,23,34
134,BES,P011936,P012711,0 days 00:11:03,-3,29,32
134,BES,P011924,P012622,0 days 00:10:36,4,27,23
134,BES,P008945,P012711,0 days 00:09:45,-13,23,36
134,BES,P011924,P011936,0 days 00:07:42,-1,19,20
134,BES,P011357,P011924,0 days 00:07:10,3,20,17
134,BES,P007914,P011357,0 days 00:07:10,3,20,17
134,BES,P012622,P012711,0 days 00:07:09,-13,14,27
134,BES,P008945,P011357,0 days 00:04:09,6,14,8
134,BES,P011357,P012622,0 days 00:04:09,6,14,8
134,BES,P011357,P011936,0 days 00:03:01,-3,6,9
134,BES,P011357,P012711,0 days 00:03:01,-3,6,9
134,BES,P011379,P011924,0 days 00:02:27,-6,3,9
134,BES,P005348,P011924,0 days 00:01:52,-8,0,8
134,BES,P007914,P011379,0 days 00:01:46,-6,1,7
134,BES,P005348,P012647,0 days 00:01:17,-6,0,6
134,BES,P005348,P012622,0 days 00:01:17,-6,0,6
134,BES,P005348,P012711,0 days 00:01:07,-6,0,6
134,BES,P005348,P008945,0 days 00:00:55,-2,0,2
134,BES,P005348,P011379,0 days 00:00:55,-2,0,2
134,BES,P005348,P007914,0 days 00:00:45,-2,0,2
135,WOL,P006546,P011150,0 days 00:27:24,2,65,63
135,WOL,P006546,P012576,0 days 00:25:54,0,56,56
135,WOL,P011150,P012576,0 days 00:23:25,2,54,52
135,WOL,P002387,P006546,0 days 00:23:14,-5,51,56
135,WOL,P002387,P011150,0 days 00:22:16,-5,49,54
135,WOL,P002387,P012576,0 days 00:21:14,-3,45,48
135,WOL,P005516,P011150,0 days 00:20:14,5,47,42
135,WOL,P005516,P006546,0 days 00:18:33,3,42,39
135,WOL,P002387,P005516,0 days 00:16:34,1,37,36
135,WOL,P005516,P012576,0 days 00:16:29,3,37,34
135,WOL,P003212,P012577,0 days 00:14:04,3,32,29
135,WOL,P011150,P012577,0 days 00:11:00,4,31,27
135,WOL,P003212,P006546,0 days 00:10:20,-1,22,23
135,WOL,P003212,P012789,0 days 00:10:20,0,25,25
135,WOL,P006154,P012577,0 days 00:09:57,-2,19,21
135,WOL,P003212,P006154,0 days 00:09:57,-2,19,21
135,WOL,P006546,P012577,0 days 00:09:56,-3,21,24
135,WOL,P003212,P011150,0 days 00:09:43,4,27,23
135,WOL,P006154,P012789,0 days 00:08:26,0,19,19
135,WOL,P012577,P012789,0 days 00:08:26,0,19,19
135,WOL,P003212,P012576,0 days 00:07:48,1,16,15
135,WOL,P012576,P012577,0 days 00:07:15,-1,16,17
135,WOL,P006907,P012577,0 days 00:06:30,1,15,14
135,WOL,P002387,P003212,0 days 00:05:34,0,13,13
135,WOL,P006907,P012789,0 days 00:04:49,-1,10,11
135,WOL,P006154,P006907,0 days 00:04:49,-1,10,11
135,WOL,P003212,P006907,0 days 00:04:49,-1,10,11
135,WOL,P011150,P012789,0 days 00:04:23,1,13,12
135,WOL,P005516,P012577,0 days 00:03:45,2,10,8
135,WOL,P004645,P011150,0 days 00:03:41,4,10,6
135,WOL,P004645,P005516,0 days 00:03:40,4,10,6
135,WOL,P004645,P012577,0 days 00:03:40,4,10,6
135,WOL,P002387,P012577,0 days 00:03:11,-4,7,11
135,WOL,P006546,P012789,0 days 00:02:31,-2,6,8
135,WOL,P006154,P011150,0 days 00:02:29,1,7,6
135,WOL,P002387,P012789,0 days 00:02:25,2,8,6
135,WOL,P006154,P006546,0 days 00:02:08,-4,0,4
135,WOL,P004645,P006546,0 days 00:02:00,2,5,3
135,WOL,P004645,P006907,0 days 00:01:41,2,5,3
135,WOL,P005516,P006907,0 days 00:01:41,2,5,3
135,WOL,P006907,P011150,0 days 00:01:41,2,5,3
135,WOL,P006154,P012576,0 days 00:01:31,-2,0,2
135,WOL,P002387,P006154,0 days 00:00:31,2,2,0
135,WOL,P002387,P004645,0 days 00:00:01,0,0,0
135,WOL,P003212,P004645,0 days 00:00:01,0,0,0
135,LJU,P005969,P009395,0 days 00:19:19,6,47,41
135,LJU,P005969,P012700,0 days 00:19:12,3,47,44
135,LJU,P009392,P011261,0 days 00:15:38,-3,35,38
135,LJU,P009395,P012700,0 days 00:15:16,-2,33,35
135,LJU,P005969,P010594,0 days 00:15:16,-1,32,33
135,LJU,P001235,P009395,0 days 00:14:40,8,38,30
135,LJU,P010594,P012700,0 days 00:14:27,-1,32,33
135,LJU,P003514,P009392,0 days 00:13:46,-5,28,33
135,LJU,P003514,P011261,0 days 00:13:25,1,29,28
135,LJU,P005969,P009392,0 days 00:12:59,3,34,31
135,LJU,P009395,P010594,0 days 00:12:14,2,22,20
135,LJU,P007066,P009392,0 days 00:11:44,-8,20,28
135,LJU,P001235,P005969,0 days 00:11:39,3,30,27
135,LJU,P007066,P011261,0 days 00:11:39,-8,21,29
135,LJU,P009392,P009395,0 days 00:11:22,3,33,30
135,LJU,P003514,P007066,0 days 00:11:12,-6,20,26
135,LJU,P003452,P012700,0 days 00:11:03,-2,23,25
135,LJU,P003452,P005969,0 days 00:10:19,2,23,21
135,LJU,P005969,P011261,0 days 00:10:08,-3,23,26
135,LJU,P001235,P009392,0 days 00:09:43,-1,25,26
135,LJU,P003452,P010594,0 days 00:09:31,-2,19,21
135,LJU,P005969,P007066,0 days 00:08:56,-4,19,23
135,LJU,P003452,P009395,0 days 00:08:17,-5,13,18
135,LJU,P002561,P009392,0 days 00:08:12,-7,15,22
135,LJU,P009395,P011261,0 days 00:07:31,7,22,15
135,LJU,P002561,P007066,0 days 00:07:28,-3,15,18
135,LJU,P002561,P003514,0 days 00:07:28,-3,15,18
135,LJU,P001235,P011261,0 days 00:07:24,3,18,15
135,LJU,P001235,P012700,0 days 00:06:59,3,20,17
135,LJU,P002561,P011261,0 days 00:05:29,-1,12,13
135,LJU,P001235,P010594,0 days 00:05:29,7,13,6
135,LJU,P009392,P012700,0 days 00:05:29,0,15,15
135,LJU,P003514,P005969,0 days 00:05:12,-1,9,10
135,LJU,P003514,P009395,0 days 00:05:01,5,12,7
135,LJU,P003452,P007066,0 days 00:04:45,1,13,12
135,LJU,P007066,P010594,0 days 00:04:40,1,14,13
135,LJU,P007066,P012700,0 days 00:04:40,1,14,13
135,LJU,P001235,P003514,0 days 00:04:22,3,8,5
135,LJU,P010594,P011261,0 days 00:03:32,2,8,6
135,LJU,P003452,P009392,0 days 00:03:31,-2,7,9
135,LJU,P002561,P003452,0 days 00:02:43,-6,3,9
135,LJU,P003514,P010594,0 days 00:02:27,4,4,0
135,LJU,P003452,P003514,0 days 00:01:59,-2,3,5
135,LJU,P011261,P012700,0 days 00:01:54,-2,4,6
135,LJU,P002561,P009395,0 days 00:00:44,-4,0,4
135,LJU,P002561,P012700,0 days 00:00:44,-4,0,4
135,LJU,P001235,P007066,0 days 00:00:32,-2,0,2
136,BUD,P011935,P012606,0 days 00:20:31,-3,39,42
136,BUD,P004945,P011281,0 days 00:20:04,2,45,43
136,BUD,P004945,P010248,0 days 00:19:59,4,38,34
136,BUD,P005637,P010248,0 days 00:17:37,9,37,28
136,BUD,P010248,P011281,0 days 00:17:23,7,34,27
136,BUD,P004945,P005637,0 days 00:17:15,4,39,35
136,BUD,P005637,P011281,0 days 00:17:04,4,39,35
136,BUD,P002740,P010248,0 days 00:16:54,8,35,27
136,BUD,P002740,P004945,0 days 00:16:22,6,33,27
136,BUD,P012606,P012630,0 days 00:15:05,0,24,24
136,BUD,P002740,P011281,0 days 00:14:47,11,33,22
136,BUD,P002740,P005637,0 days 00:14:12,11,33,22
136,BUD,P011935,P012630,0 days 00:12:25,1,20,19
136,BUD,P010248,P012606,0 days 00:11:24,8,23,15
136,BUD,P008325,P012606,0 days 00:10:51,-8,16,24
136,BUD,P007398,P012606,0 days 00:10:20,7,22,15
136,BUD,P008325,P011935,0 days 00:09:57,-6,14,20
136,BUD,P007398,P010248,0 days 00:09:42,5,20,15
136,BUD,P010248,P011935,0 days 00:08:55,5,19,14
136,BUD,P004945,P012606,0 days 00:08:55,-2,21,23
136,BUD,P004945,P011935,0 days 00:08:12,-4,19,23
136,BUD,P007398,P012630,0 days 00:08:02,4,17,13
136,BUD,P008325,P012630,0 days 00:08:00,-8,8,16
136,BUD,P011281,P012606,0 days 00:07:48,-2,16,18
136,BUD,P010248,P012630,0 days 00:07:34,8,16,8
136,BUD,P011281,P011935,0 days 00:07:25,-2,16,18
136,BUD,P007398,P011935,0 days 00:06:57,6,16,10
136,BUD,P002740,P011935,0 days 00:06:09,-7,7,14
136,BUD,P002740,P012606,0 days 00:06:09,-7,7,14
136,BUD,P008325,P011281,0 days 00:04:52,-1,9,10
136,BUD,P002740,P012630,0 days 00:04:37,-4,5,9
136,BUD,P005637,P012606,0 days 00:04:33,-1,12,13
136,BUD,P005637,P007398,0 days 00:04:19,-4,6,10
136,BUD,P002740,P008325,0 days 00:04:02,-4,5,9
136,BUD,P011281,P012630,0 days 00:03:59,0,2,2
136,BUD,P004945,P007398,0 days 00:03:37,-2,5,7
136,BUD,P004945,P008325,0 days 00:02:51,0,8,8
136,BUD,P005637,P012630,0 days 00:02:17,-1,4,5
136,BUD,P007398,P008325,0 days 00:01:57,-3,2,5
136,BUD,P007398,P011281,0 days 00:01:42,-5,0,5
136,BUD,P005637,P011935,0 days 00:01:33,-2,6,8
136,BUD,P005637,P008325,0 days 00:00:54,-2,2,4
136,BUD,P004945,P012630,0 days 00:00:41,0,0,0
136,BUD,P002740,P006566,0 days 00:00:32,2,2,0
136,BUD,P005637,P006566,0 days 00:00:32,2,2,0
136,BUD,P006566,P010248,0 days 00:00:32,2,2,0
136,BUD,P006566,P011281,0 days 00:00:32,2,2,0
136,BOU,P010431,P010718,0 days 00:22:12,-8,43,51
136,BOU,P000498,P012618,0 days 00:15:02,-2,28,30
136,BOU,P010718,P011837,0 days 00:14:30,-6,21,27
136,BOU,P000498,P004525,0 days 00:14:12,7,27,20
136,BOU,P010450,P011161,0 days 00:14:10,-1,25,26
136,BOU,P011837,P012617,0 days 00:14:08,-11,21,32
136,BOU,P010431,P011836,0 days 00:14:01,0,31,31
136,BOU,P010431,P011837,0 days 00:13:53,-8,19,27
136,BOU,P011836,P012617,0 days 00:13:28,-5,24,29
136,BOU,P010718,P011836,0 days 00:13:11,-1,28,29
136,BOU,P010718,P012617,0 days 00:12:57,-9,22,31
136,BOU,P004525,P012618,0 days 00:12:42,4,23,19
136,BOU,P010450,P012618,0 days 00:12:06,3,20,17
136,BOU,P010431,P012617,0 days 00:12:00,-11,20,31
136,BOU,P004525,P010718,0 days 00:11:58,-2,27,29
136,BOU,P004525,P011161,0 days 00:11:43,9,26,17
136,BOU,P000498,P010431,0 days 00:11:28,6,24,18
136,BOU,P011836,P011837,0 days 00:11:23,-7,15,22
136,BOU,P004525,P010431,0 days 00:11:18,-1,26,27
136,BOU,P000498,P010718,0 days 00:10:44,2,20,18
136,BOU,P011161,P012618,0 days 00:10:44,-1,16,17
136,BOU,P004525,P010450,0 days 00:10:38,9,23,14
136,BOU,P000498,P010450,0 days 00:09:58,1,16,15
136,BOU,P010431,P012618,0 days 00:08:25,0,18,18
136,BOU,P000498,P011161,0 days 00:08:16,-3,12,15
136,BOU,P010718,P012618,0 days 00:08:01,-4,14,18
136,BOU,P004525,P011837,0 days 00:07:27,1,14,13
136,BOU,P011161,P012617,0 days 00:07:25,4,14,10
136,BOU,P004525,P012617,0 days 00:07:07,1,17,16
136,BOU,P010450,P012617,0 days 00:06:28,2,12,10
136,BOU,P011836,P012618,0 days 00:05:29,-5,11,16
136,BOU,P010450,P011836,0 days 00:05:16,-7,7,14
136,BOU,P011161,P011837,0 days 00:04:57,2,10,8
136,BOU,P011161,P011836,0 days 00:04:51,-7,6,13
136,BOU,P000498,P011837,0 days 00:04:42,5,8,3
136,BOU,P000498,P011836,0 days 00:04:34,-4,9,13
136,BOU,P010450,P011837,0 days 00:04:20,0,8,8
136,BOU,P012617,P012618,0 days 00:04:07,1,6,5
136,BOU,P010718,P011161,0 days 00:03:11,1,7,6
136,BOU,P010431,P010450,0 days 00:03:08,2,7,5
136,BOU,P004525,P011836,0 days 00:01:35,4,9,5
136,BOU,P010450,P010718,0 days 00:01:24,-1,2,3
136,BOU,P010431,P011161,0 days 00:00:51,0,4,4
137,CLU,P010569,P012621,0 days 00:22:49,9,54,45
137,CLU,P004862,P012621,0 days 00:21:03,10,51,41
137,CLU,P004862,P010569,0 days 00:21:03,10,51,41
137,CLU,P004862,P005113,0 days 00:20:10,7,48,41
137,CLU,P005113,P012621,0 days 00:18:58,12,48,36
137,CLU,P005373,P011801,0 days 00:18:32,9,40,31
137,CLU,P005113,P010569,0 days 00:18:30,10,46,36
137,CLU,P005714,P011801,0 days 00:17:38,5,36,31
137,CLU,P011801,P012621,0 days 00:16:26,3,26,23
137,CLU,P011801,P012698,0 days 00:16:12,2,33,31
137,CLU,P005714,P012698,0 days 00:16:12,2,33,31
137,CLU,P005373,P005714,0 days 00:15:03,8,32,24
137,CLU,P012621,P012698,0 days 00:14:21,14,38,24
137,CLU,P004862,P012698,0 days 00:13:49,17,43,26
137,CLU,P005373,P012698,0 days 00:13:37,5,29,24
137,CLU,P004862,P011801,0 days 00:13:09,2,25,23
137,CLU,P005373,P012621,0 days 00:11:12,5,20,15
137,CLU,P005113,P012698,0 days 00:09:40,12,31,19
137,CLU,P010569,P011801,0 days 00:08:38,-3,12,15
137,CLU,P005714,P012621,0 days 00:08:15,4,14,10
137,CLU,P010569,P012698,0 days 00:07:59,11,27,16
137,CLU,P011797,P012621,0 days 00:07:58,0,18,18
137,CLU,P010569,P011797,0 days 00:07:58,0,18,18
137,CLU,P004862,P005373,0 days 00:07:10,7,19,12
137,CLU,P005113,P011801,0 days 00:06:50,-3,8,11
137,CLU,P004862,P011797,0 days 00:06:39,-1,15,16
137,CLU,P004862,P005714,0 days 00:06:17,4,16,12
137,CLU,P005113,P011797,0 days 00:06:16,-1,15,16
137,CLU,P011801,P012620,0 days 00:04:32,0,9,9
137,CLU,P005714,P012620,0 days 00:04:32,0,9,9
137,CLU,P005373,P012620,0 days 00:04:32,0,9,9
137,CLU,P005373,P010569,0 days 00:03:52,1,8,7
137,CLU,P012620,P012698,0 days 00:03:06,-3,6,9
137,CLU,P005113,P005714,0 days 00:02:08,-1,4,5
137,CLU,P005373,P011797,0 days 00:01:42,1,3,2
137,CLU,P012620,P012621,0 days 00:01:26,3,3,0
137,CLU,P011797,P011801,0 days 00:01:19,1,3,2
137,CLU,P005714,P010569,0 days 00:00:27,-2,0,2
137,ARI,P012716,P012792,0 days 00:20:12,2,43,41
137,ARI,P003240,P012717,0 days 00:19:33,-7,39,46
137,ARI,P012708,P012717,0 days 00:18:56,0,43,43
137,ARI,P012702,P012708,0 days 00:17:56,4,40,36
137,ARI,P012702,P012717,0 days 00:16:42,5,37,32
137,ARI,P012717,P012792,0 days 00:16:41,1,39,38
137,ARI,P012716,P012717,0 days 00:16:36,-7,34,41
137,ARI,P004292,P012708,0 days 00:15:23,-16,24,40
137,ARI,P003240,P012708,0 days 00:15:08,-7,25,32
137,ARI,P012708,P012792,0 days 00:14:48,3,36,33
137,ARI,P003240,P012702,0 days 00:13:42,0,24,24
137,ARI,P012702,P012792,0 days 00:13:28,12,33,21
137,ARI,P012708,P012716,0 days 00:12:45,0,27,27
137,ARI,P012702,P012716,0 days 00:12:34,6,28,22
137,ARI,P003240,P012792,0 days 00:11:39,-6,21,27
137,ARI,P012615,P012708,0 days 00:10:58,-12,13,25
137,ARI,P003240,P004292,0 days 00:10:49,-5,18,23
137,ARI,P012615,P012792,0 days 00:10:36,-4,17,21
137,ARI,P003240,P012716,0 days 00:10:32,-12,14,26
137,ARI,P004292,P012717,0 days 00:10:14,-2,22,24
137,ARI,P012615,P012716,0 days 00:09:24,-1,13,14
137,ARI,P012760,P012792,0 days 00:08:48,-13,15,28
137,ARI,P004292,P012702,0 days 00:08:38,-7,13,20
137,ARI,P012717,P012760,0 days 00:08:15,-8,20,28
137,ARI,P012716,P012760,0 days 00:07:59,-8,15,23
137,ARI,P004292,P012615,0 days 00:07:17,-12,6,18
137,ARI,P003240,P012615,0 days 00:06:54,-10,2,12
137,ARI,P012708,P012760,0 days 00:06:21,-7,12,19
137,ARI,P003240,P012760,0 days 00:06:05,-10,13,23
137,ARI,P004292,P012760,0 days 00:05:41,-4,11,15
137,ARI,P012615,P012702,0 days 00:05:24,0,9,9
137,ARI,P004292,P012792,0 days 00:04:53,-5,8,13
137,ARI,P012615,P012722,0 days 00:03:53,-5,4,9
137,ARI,P012708,P012722,0 days 00:03:53,-5,4,9
137,ARI,P004292,P012716,0 days 00:03:51,-2,6,8
137,ARI,P012615,P012760,0 days 00:03:23,-6,2,8
137,ARI,P004292,P012722,0 days 00:03:06,-3,4,7
137,ARI,P012615,P012717,0 days 00:02:23,-2,2,4
137,ARI,P012722,P012792,0 days 00:01:59,-2,4,6
137,ARI,P003240,P012722,0 days 00:01:54,-3,0,3
137,ARI,P012716,P012722,0 days 00:00:47,-2,0,2
138,WRO,P012601,P012699,0 days 00:21:41,7,54,47
138,WRO,P012010,P012699,0 days 00:21:10,6,51,45
138,WRO,P012010,P012601,0 days 00:20:55,6,52,46
138,WRO,P009896,P012601,0 days 00:18:05,3,48,45
138,WRO,P012094,P012699,0 days 00:16:40,16,48,32
138,WRO,P009896,P012699,0 days 00:16:05,8,44,36
138,WRO,P009896,P012010,0 days 00:16:03,8,40,32
138,WRO,P012094,P012601,0 days 00:15:49,5,46,41
138,WRO,P009896,P012736,0 days 00:15:19,-2,36,38
138,WRO,P003034,P012094,0 days 00:14:54,9,38,29
138,WRO,P012010,P012094,0 days 00:13:31,8,38,30
138,WRO,P009896,P012094,0 days 00:13:16,4,39,35
138,WRO,P012094,P012736,0 days 00:13:06,-2,36,38
138,WRO,P011901,P012094,0 days 00:13:03,4,32,28
138,WRO,P012010,P012736,0 days 00:12:27,-1,25,26
138,WRO,P011278,P012094,0 days 00:12:21,8,31,23
138,WRO,P003034,P012699,0 days 00:11:41,7,27,20
138,WRO,P012601,P012736,0 days 00:11:36,-4,29,33
138,WRO,P011278,P012736,0 days 00:10:38,0,22,22
138,WRO,P011278,P011901,0 days 00:10:14,7,26,19
138,WRO,P012699,P012736,0 days 00:10:00,-1,22,23
138,WRO,P003034,P011278,0 days 00:09:22,6,23,17
138,WRO,P003034,P012010,0 days 00:09:14,-1,21,22
138,WRO,P009896,P011901,0 days 00:09:02,-3,21,24
138,WRO,P011901,P012736,0 days 00:08:47,-4,19,23
138,WRO,P011901,P012699,0 days 00:07:50,9,21,12
138,WRO,P003034,P011901,0 days 00:07:27,8,19,11
138,WRO,P003034,P012601,0 days 00:07:19,1,17,16
138,WRO,P003034,P012736,0 days 00:06:47,-2,15,17
138,WRO,P011901,P012601,0 days 00:06:23,-2,14,16
138,WRO,P011278,P012699,0 days 00:06:13,8,17,9
138,WRO,P009896,P011278,0 days 00:05:10,2,12,10
138,WRO,P011278,P012010,0 days 00:04:22,1,9,8
138,WRO,P011901,P012010,0 days 00:03:26,1,8,7
138,WRO,P011278,P012601,0 days 00:00:04,0,0,0
138,ULM,P005422,P012604,0 days 00:25:39,5,59,54
138,ULM,P010582,P012604,0 days 00:24:40,1,60,59
138,ULM,P005422,P010582,0 days 00:23:58,1,54,53
138,ULM,P012603,P012604,0 days 00:22:35,-3,53,56
138,ULM,P010106,P012604,0 days 00:21:44,-5,45,50
138,ULM,P010582,P012603,0 days 00:20:40,-8,49,57
138,ULM,P005422,P012703,0 days 00:20:34,-13,43,56
138,ULM,P005422,P012603,0 days 00:20:33,-1,47,48
138,ULM,P010106,P012603,0 days 00:20:32,0,46,46
138,ULM,P005422,P010106,0 days 00:20:05,0,43,43
138,ULM,P010582,P012703,0 days 00:18:13,-10,40,50
138,ULM,P012604,P012703,0 days 00:17:36,-6,41,47
138,ULM,P010106,P010582,0 days 00:14:44,0,33,33
138,ULM,P011457,P012703,0 days 00:13:32,-4,26,30
138,ULM,P005422,P011457,0 days 00:13:05,-4,26,30
138,ULM,P012603,P012703,0 days 00:11:42,-14,27,41
138,ULM,P010582,P011457,0 days 00:09:40,2,20,18
138,ULM,P010106,P012703,0 days 00:09:38,-12,17,29
138,ULM,P011457,P012604,0 days 00:09:26,1,21,20
138,ULM,P010726,P012604,0 days 00:06:24,-1,17,18
138,ULM,P010726,P012603,0 days 00:05:57,-1,17,18
138,ULM,P005422,P007952,0 days 00:05:08,-9,5,14
138,ULM,P007952,P012703,0 days 00:05:08,-9,5,14
138,ULM,P007952,P010582,0 days 00:04:37,-6,5,11
138,ULM,P010106,P010726,0 days 00:04:21,0,11,11
138,ULM,P007952,P011457,0 days 00:04:06,-5,5,10
138,ULM,P010106,P011457,0 days 00:03:52,-6,6,12
138,ULM,P010582,P010726,0 days 00:03:45,-3,11,14
138,ULM,P005422,P011391,0 days 00:02:51,-1,9,10
138,ULM,P011391,P012603,0 days 00:02:51,-1,9,10
138,ULM,P005422,P010726,0 days 00:02:39,2,6,4
138,ULM,P011391,P012703,0 days 00:02:30,-3,7,10
138,ULM,P010106,P011391,0 days 00:02:09,2,7,5
138,ULM,P010726,P012703,0 days 00:02:03,-1,6,7
138,ULM,P010582,P011391,0 days 00:01:03,-1,4,5
138,ULM,P007952,P012603,0 days 00:01:02,-4,0,4
138,ULM,P007952,P010106,0 days 00:00:31,-3,0,3
138,ULM,P010726,P011457,0 days 00:00:27,0,0,0
139,TTK,P011239,P011925,0 days 00:27:08,13,58,45
139,TTK,P006693,P011925,0 days 00:24:58,24,59,35
139,TTK,P006693,P011239,0 days 00:24:52,23,60,37
139,TTK,P004801,P006693,0 days 00:21:14,15,50,35
139,TTK,P004801,P011925,0 days 00:18:08,11,42,31
139,TTK,P006693,P011834,0 days 00:17:56,9,36,27
139,TTK,P005000,P011925,0 days 00:17:44,-2,33,35
139,TTK,P004801,P011239,0 days 00:17:29,10,41,31
139,TTK,P005000,P011239,0 days 00:16:46,6,35,29
139,TTK,P005000,P006693,0 days 00:16:45,11,34,23
139,TTK,P011239,P011834,0 days 00:15:55,0,31,31
139,TTK,P011834,P011925,0 days 00:15:06,1,29,28
139,TTK,P006693,P010477,0 days 00:14:23,11,28,17
139,TTK,P005000,P010477,0 days 00:14:16,-7,19,26
139,TTK,P010477,P011239,0 days 00:14:15,2,27,25
139,TTK,P010477,P011925,0 days 00:13:43,-3,23,26
139,TTK,P010477,P011834,0 days 00:12:01,-2,18,20
139,TTK,P004801,P005000,0 days 00:10:33,4,25,21
139,TTK,P004801,P011834,0 days 00:10:12,5,22,17
139,TTK,P005000,P006883,0 days 00:08:05,-12,7,19
139,TTK,P006883,P010477,0 days 00:07:54,-9,7,16
139,TTK,P005000,P011834,0 days 00:06:31,-7,5,12
139,TTK,P006693,P006883,0 days 00:05:14,-2,5,7
139,TTK,P006883,P011925,0 days 00:05:07,-13,4,17
139,TTK,P006883,P011834,0 days 00:05:07,-1,5,6
139,TTK,P004801,P009845,0 days 00:04:31,0,9,9
139,TTK,P004801,P011975,0 days 00:04:05,2,9,7
139,TTK,P006693,P011975,0 days 00:04:05,2,9,7
139,TTK,P009845,P011925,0 days 00:03:31,-2,7,9
139,TTK,P006693,P009845,0 days 00:03:01,3,7,4
139,TTK,P009845,P011975,0 days 00:03:01,3,7,4
139,TTK,P004801,P010477,0 days 00:02:30,2,6,4
139,TTK,P006883,P011239,0 days 00:02:23,-5,2,7
139,TTK,P004801,P006883,0 days 00:02:14,-1,4,5
139,TTK,P011834,P011975,0 days 00:02:06,-1,4,5
139,TTK,P011925,P011975,0 days 00:01:59,3,5,2
139,TTK,P005000,P009845,0 days 00:01:32,-5,2,7
139,TTK,P006883,P009845,0 days 00:01:32,-5,2,7
139,TTK,P011239,P011975,0 days 00:01:04,-1,2,3
139,TTK,P009845,P011834,0 days 00:01:02,0,2,2
139,TTK,P009845,P010477,0 days 00:00:02,-2,0,2
139,TRN,P005738,P012593,0 days 00:23:58,-19,35,54
139,TRN,P012593,P012597,0 days 00:21:59,-18,37,55
139,TRN,P009903,P012593,0 days 00:20:41,-6,37,43
139,TRN,P005738,P009903,0 days 00:19:57,-9,32,41
139,TRN,P001479,P005059,0 days 00:19:15,5,38,33
139,TRN,P005738,P012597,0 days 00:18:53,-21,28,49
139,TRN,P005059,P012597,0 days 00:17:53,3,38,35
139,TRN,P005059,P012593,0 days 00:16:28,-1,29,30
139,TRN,P001479,P012597,0 days 00:16:02,4,33,29
139,TRN,P005059,P012596,0 days 00:15:18,8,30,22
139,TRN,P001479,P012596,0 days 00:15:18,8,30,22
139,TRN,P009903,P012597,0 days 00:14:52,-11,25,36
139,TRN,P005738,P012594,0 days 00:13:58,-9,21,30
139,TRN,P009903,P012594,0 days 00:13:58,-9,21,30
139,TRN,P012593,P012594,0 days 00:13:58,-9,21,30
139,TRN,P012596,P012597,0 days 00:13:37,6,30,24
139,TRN,P012594,P012597,0 days 00:13:01,-10,20,30
139,TRN,P005059,P006382,0 days 00:12:16,9,23,14
139,TRN,P001479,P006382,0 days 00:10:50,7,21,14
139,TRN,P005059,P005738,0 days 00:10:09,-5,15,20
139,TRN,P006382,P012596,0 days 00:10:06,4,16,12
139,TRN,P001479,P012593,0 days 00:09:32,-2,17,19
139,TRN,P005059,P009903,0 days 00:07:40,4,17,13
139,TRN,P006382,P012597,0 days 00:07:37,6,16,10
139,TRN,P012593,P012596,0 days 00:06:23,-3,9,12
139,TRN,P005059,P012687,0 days 00:04:48,0,9,9
139,TRN,P006382,P012593,0 days 00:04:39,3,7,4
139,TRN,P012593,P012687,0 days 00:03:30,-5,4,9
139,TRN,P005738,P012687,0 days 00:03:30,-5,4,9
139,TRN,P001479,P005738,0 days 00:03:13,-6,3,9
139,TRN,P012596,P012687,0 days 00:02:54,-3,5,8
139,TRN,P012597,P012687,0 days 00:02:54,-3,5,8
139,TRN,P009903,P012687,0 days 00:02:42,-1,4,5
139,TRN,P006382,P009903,0 days 00:02:10,5,7,2
139,TRN,P001479,P012687,0 days 00:02:06,1,5,4
139,TRN,P005738,P006382,0 days 00:01:26,2,2,0
139,TRN,P005059,P012594,0 days 00:00:57,1,1,0
139,TRN,P005738,P012596,0 days 00:00:48,-4,0,4
139,TRN,P001479,P009903,0 days 00:00:44,3,5,2
140,LKB,P007029,P009898,0 days 00:25:15,5,61,56
140,LKB,P002012,P007029,0 days 00:19:49,2,51,49
140,LKB,P002012,P009898,0 days 00:19:43,1,49,48
140,LKB,P009898,P010461,0 days 00:18:25,12,48,36
140,LKB,P007029,P010461,0 days 00:18:09,18,46,28
140,LKB,P006901,P009898,0 days 00:15:58,4,37,33
140,LKB,P009898,PLXI,0 days 00:15:41,-3,35,38
140,LKB,P007029,PLXI,0 days 00:15:33,-3,28,31
140,LKB,P002012,PLXI,0 days 00:15:15,-1,33,34
140,LKB,P010461,PLXI,0 days 00:15:02,-4,28,32
140,LKB,P002012,P010461,0 days 00:14:48,10,41,31
140,LKB,P004868,P007029,0 days 00:13:47,-10,25,35
140,LKB,P004868,P009898,0 days 00:13:27,-3,28,31
140,LKB,P006901,P007029,0 days 00:13:25,3,35,32
140,LKB,P006230,P009898,0 days 00:12:42,-6,25,31
140,LKB,P006230,P007029,0 days 00:12:00,-12,18,30
140,LKB,P006901,P010461,0 days 00:11:48,5,29,24
140,LKB,P002012,P006901,0 days 00:11:29,-8,27,35
140,LKB,P004868,P010190,0 days 00:10:43,-10,18,28
140,LKB,P007029,P010190,0 days 00:10:30,-7,16,23
140,LKB,P004868,P010461,0 days 00:08:31,-3,12,15
140,LKB,P009898,P010190,0 days 00:08:21,-2,17,19
140,LKB,P004868,P006901,0 days 00:08:16,4,23,19
140,LKB,P010190,P010461,0 days 00:07:57,-10,8,18
140,LKB,P002012,P006230,0 days 00:07:19,-7,11,18
140,LKB,P004868,P006230,0 days 00:07:03,-1,14,15
140,LKB,P010190,PLXI,0 days 00:06:58,-12,3,15
140,LKB,P006230,P006901,0 days 00:06:54,-3,13,16
140,LKB,P006230,P010190,0 days 00:06:40,2,12,10
140,LKB,P006901,P010190,0 days 00:06:36,-3,16,19
140,LKB,P002012,P010190,0 days 00:06:07,-6,14,20
140,LKB,P004868,PLXI,0 days 00:05:59,-14,2,16
140,LKB,P006230,PLXI,0 days 00:04:50,-5,7,12
140,LKB,P006901,PLXI,0 days 00:03:10,-6,4,10
140,LKB,P002012,P004868,0 days 00:01:50,-7,6,13
140,CAN,P006588,P008121,0 days 00:20:07,10,52,42
140,CAN,P003425,P006588,0 days 00:19:20,12,52,40
140,CAN,P003425,P008121,0 days 00:19:07,12,52,40
140,CAN,P008121,P009864,0 days 00:17:38,9,51,42
140,CAN,P003425,P009864,0 days 00:17:30,16,52,36
140,CAN,P006588,P009864,0 days 00:15:36,15,46,31
140,CAN,P003425,P005005,0 days 00:12:10,11,37,26
140,CAN,P004160,P010452,0 days 00:10:59,1,22,21
140,CAN,P003425,P003637,0 days 00:10:59,6,25,19
140,CAN,P003637,P008121,0 days 00:10:59,6,25,19
140,CAN,P003637,P006588,0 days 00:10:59,6,25,19
140,CAN,P001607,P004160,0 days 00:10:48,-5,16,21
140,CAN,P004160,P010385,0 days 00:10:48,-5,16,21
140,CAN,P010385,P010452,0 days 00:10:37,0,17,17
140,CAN,P005005,P010452,0 days 00:10:34,7,21,14
140,CAN,P003637,P009864,0 days 00:09:54,6,25,19
140,CAN,P005005,P009864,0 days 00:09:16,6,26,20
140,CAN,P001607,P010385,0 days 00:08:38,-2,12,14
140,CAN,P001607,P010452,0 days 00:08:09,-2,12,14
140,CAN,P004160,P005005,0 days 00:07:45,2,12,10
140,CAN,P004466,P010452,0 days 00:07:40,-1,17,18
140,CAN,P003425,P010452,0 days 00:07:30,7,21,14
140,CAN,P008121,P010385,0 days 00:06:28,-2,10,12
140,CAN,P005005,P010385,0 days 00:06:26,4,9,5
140,CAN,P003425,P010385,0 days 00:06:14,-3,9,12
140,CAN,P001607,P005005,0 days 00:05:57,1,8,7
140,CAN,P003425,P004160,0 days 00:05:55,0,14,14
140,CAN,P004160,P008121,0 days 00:05:45,-2,12,14
140,CAN,P005005,P008121,0 days 00:05:34,6,20,14
140,CAN,P005005,P006588,0 days 00:05:26,6,20,14
140,CAN,P001607,P008121,0 days 00:05:23,-5,13,18
140,CAN,P004466,P010385,0 days 00:05:21,-7,7,14
140,CAN,P003425,P004466,0 days 00:05:18,6,15,9
140,CAN,P004466,P005005,0 days 00:04:48,4,11,7
140,CAN,P004160,P009864,0 days 00:04:36,0,10,10
140,CAN,P001607,P004466,0 days 00:04:28,-13,5,18
140,CAN,P004466,P007644,0 days 00:04:20,0,13,13
140,CAN,P006588,P010385,0 days 00:04:15,-5,4,9
140,CAN,P001607,P009864,0 days 00:04:14,-7,7,14
140,CAN,P007644,P009864,0 days 00:04:04,-4,10,14
140,CAN,P001607,P007644,0 days 00:04:03,-9,7,16
140,CAN,P005005,P007644,0 days 00:04:00,1,8,7
140,CAN,P004160,P007644,0 days 00:03:40,-1,8,9
140,CAN,P004160,P006588,0 days 00:03:23,-5,4,9
140,CAN,P004160,P004466,0 days 00:03:13,-5,6,11
140,CAN,P003425,P007644,0 days 00:03:01,9,13,4
140,CAN,P007644,P010452,0 days 00:02:47,4,10,6
140,CAN,P007644,P008121,0 days 00:02:21,-3,8,11
140,CAN,P009864,P010452,0 days 00:02:15,1,6,5
140,CAN,P008121,P010452,0 days 00:02:05,3,6,3
140,CAN,P004466,P008121,0 days 00:02:01,-6,3,9
140,CAN,P004466,P009864,0 days 00:01:53,-6,3,9
140,CAN,P001607,P006588,0 days 00:01:16,-2,2,4
140,CAN,P003637,P010385,0 days 00:01:05,0,0,0
140,CAN,P004466,P006588,0 days 00:00:34,0,0,0
140,CAN,P006588,P007644,0 days 00:00:24,3,3,0
140,CAN,P001607,P003425,0 days 00:00:16,0,2,2
140,CAN,P007644,P010385,0 days 00:00:08,0,0,0
141,PMT,P001686,P002644,0 days 00:20:55,17,48,31
141,PMT,P001686,P011942,0 days 00:17:32,7,41,34
141,PMT,P002644,P011942,0 days 00:17:12,12,38,26
141,PMT,P005301,P011942,0 days 00:16:59,7,41,34
141,PMT,P001686,P005301,0 days 00:15:06,6,35,29
141,PMT,P001686,P011966,0 days 00:14:56,24,40,16
141,PMT,P011942,P011944,0 days 00:14:53,-6,27,33
141,PMT,P011947,P011966,0 days 00:14:47,21,39,18
141,PMT,P002644,P011966,0 days 00:14:36,23,39,16
141,PMT,P011947,P012600,0 days 00:13:24,17,35,18
141,PMT,P002644,P005301,0 days 00:12:32,10,31,21
141,PMT,P011966,P012600,0 days 00:12:21,19,35,16
141,PMT,P002644,P011947,0 days 00:11:57,8,23,15
141,PMT,P001686,P011944,0 days 00:11:54,-5,23,28
141,PMT,P001686,P011947,0 days 00:11:41,9,22,13
141,PMT,P002644,P012600,0 days 00:10:59,12,24,12
141,PMT,P001686,P012600,0 days 00:10:39,16,28,12
141,PMT,P002644,P011944,0 days 00:10:00,-4,16,20
141,PMT,P005301,P011944,0 days 00:09:45,-7,19,26
141,PMT,P011823,P011943,0 days 00:08:37,6,21,15
141,PMT,P011823,P011942,0 days 00:08:34,-2,18,20
141,PMT,P005301,P011966,0 days 00:07:38,14,22,8
141,PMT,P011942,P011966,0 days 00:07:22,16,24,8
141,PMT,P011823,P011944,0 days 00:06:30,-2,13,15
141,PMT,P011823,P011947,0 days 00:06:24,10,18,8
141,PMT,P001686,P011823,0 days 00:06:21,2,15,13
141,PMT,P011943,P012600,0 days 00:06:21,9,17,8
141,PMT,P011942,P011943,0 days 00:06:04,-1,9,10
141,PMT,P011823,P012600,0 days 00:06:01,13,21,8
141,PMT,P011823,P011966,0 days 00:05:23,10,18,8
141,PMT,P005301,P011823,0 days 00:05:17,-3,10,13
141,PMT,P011944,P012600,0 days 00:04:39,6,10,4
141,PMT,P011943,P011944,0 days 00:04:36,-1,6,7
141,PMT,P011943,P011947,0 days 00:04:30,5,13,8
141,PMT,P011942,P011947,0 days 00:04:07,1,6,5
141,PMT,P002020,P011943,0 days 00:03:40,-2,5,7
141,PMT,P002020,P011942,0 days 00:03:40,-2,5,7
141,PMT,P002020,P011823,0 days 00:03:40,-2,5,7
141,PMT,P011942,P012600,0 days 00:03:36,8,10,2
141,PMT,P005301,P011947,0 days 00:03:26,4,6,2
141,PMT,P011944,P011947,0 days 00:03:08,-3,2,5
141,PMT,P002691,P011943,0 days 00:03:05,0,5,5
141,PMT,P002691,P011942,0 days 00:03:05,0,5,5
141,PMT,P002020,P002691,0 days 00:03:05,0,5,5
141,PMT,P002691,P011823,0 days 00:03:05,0,5,5
141,PMT,P011943,P011966,0 days 00:02:53,5,11,6
141,PMT,P002644,P011943,0 days 00:01:57,-2,1,3
141,PMT,P002020,P011944,0 days 00:00:35,-2,0,2
141,PMT,P005301,P011943,0 days 00:00:33,-3,0,3
141,WOL,P006546,P012789,0 days 00:23:29,-8,43,51
141,WOL,P006546,P012577,0 days 00:20:46,-11,39,50
141,WOL,P012577,P012789,0 days 00:20:45,-2,41,43
141,WOL,P002387,P012789,0 days 00:19:10,0,37,37
141,WOL,P005516,P006546,0 days 00:18:18,-10,32,42
141,WOL,P006154,P012577,0 days 00:17:33,-16,24,40
141,WOL,P006154,P012789,0 days 00:16:48,-6,27,33
141,WOL,P002387,P006546,0 days 00:16:04,0,30,30
141,WOL,P006154,P006546,0 days 00:15:21,-8,22,30
141,WOL,P002387,P006154,0 days 00:14:53,-2,24,26
141,WOL,P005516,P012789,0 days 00:14:21,-4,26,30
141,WOL,P002387,P012577,0 days 00:13:50,-4,25,29
141,WOL,P005516,P012577,0 days 00:13:11,-6,25,31
141,WOL,P006546,P011150,0 days 00:11:42,-7,23,30
141,WOL,P006154,P006907,0 days 00:11:05,-5,19,24
141,WOL,P006907,P012789,0 days 00:11:05,-5,19,24
141,WOL,P005516,P011150,0 days 00:09:55,-5,21,26
141,WOL,P006907,P012577,0 days 00:09:51,-12,14,26
141,WOL,P012576,P012577,0 days 00:09:16,-23,8,31
141,WOL,P011150,P012789,0 days 00:09:15,-5,17,22
141,WOL,P011150,P012577,0 days 00:08:46,-11,16,27
141,WOL,P002387,P006907,0 days 00:08:29,0,15,15
141,WOL,P002387,P005516,0 days 00:08:19,-4,14,18
141,WOL,P006546,P012576,0 days 00:07:16,-5,11,16
141,WOL,P006154,P012576,0 days 00:06:18,-8,5,13
141,WOL,P006546,P006907,0 days 00:05:58,-6,9,15
141,WOL,P005516,P006154,0 days 00:05:11,-5,4,9
141,WOL,P002387,P012576,0 days 00:04:39,-6,3,9
141,WOL,P002387,P011150,0 days 00:04:26,-4,7,11
141,WOL,P004645,P012576,0 days 00:04:08,-4,3,7
141,WOL,P002387,P004645,0 days 00:04:08,-4,3,7
141,WOL,P004645,P006154,0 days 00:04:08,-4,3,7
141,WOL,P005516,P012576,0 days 00:03:57,-6,6,12
141,WOL,P011150,P012576,0 days 00:03:57,-10,6,16
141,WOL,P003212,P012577,0 days 00:03:47,-8,4,12
141,WOL,P003212,P012576,0 days 00:03:00,-10,2,12
141,WOL,P004645,P012577,0 days 00:02:19,-7,0,7
141,WOL,P003212,P006546,0 days 00:02:17,0,4,4
141,WOL,P003212,P011150,0 days 00:02:10,-8,2,10
141,WOL,P006907,P012576,0 days 00:01:49,-8,0,8
141,WOL,P003212,P006907,0 days 00:01:49,-8,0,8
141,WOL,P004645,P006546,0 days 00:01:49,3,3,0
141,WOL,P006907,P011150,0 days 00:01:30,-8,0,8
141,WOL,P002387,P003212,0 days 00:01:18,0,2,2
141,WOL,P006154,P011150,0 days 00:01:07,-2,0,2
141,WOL,P003212,P012789,0 days 00:00:47,2,2,0
142,LJU,P003452,P005969,0 days 00:30:50,-7,73,80
142,LJU,P003452,P009395,0 days 00:28:55,-6,66,72
142,LJU,P005969,P009395,0 days 00:27:33,-9,60,69
142,LJU,P002561,P003452,0 days 00:20:30,8,60,52
142,LJU,P002561,P005969,0 days 00:18:41,2,51,49
142,LJU,P002561,P009395,0 days 00:15:08,4,41,37
142,LJU,P003452,P010594,0 days 00:14:44,-6,34,40
142,LJU,P005969,P010594,0 days 00:14:17,-9,31,40
142,LJU,P003514,P005969,0 days 00:12:08,-11,20,31
142,LJU,P003452,P009392,0 days 00:12:00,7,32,25
142,LJU,P005969,P009392,0 days 00:12:00,7,32,25
142,LJU,P002561,P007066,0 days 00:11:56,-6,28,34
142,LJU,P003514,P009395,0 days 00:11:54,-14,21,35
142,LJU,P009392,P009395,0 days 00:10:48,2,24,22
142,LJU,P009395,P010594,0 days 00:10:45,-8,23,31
142,LJU,P003452,P007066,0 days 00:10:33,-4,28,32
142,LJU,P003452,P003514,0 days 00:10:30,-10,17,27
142,LJU,P005969,P007066,0 days 00:09:57,-4,26,30
142,LJU,P002561,P010594,0 days 00:09:51,2,26,24
142,LJU,P007066,P009395,0 days 00:07:24,-7,17,24
142,LJU,P003514,P010594,0 days 00:06:40,-14,6,20
142,LJU,P003514,P009392,0 days 00:06:33,-2,14,16
142,LJU,P002561,P009392,0 days 00:05:38,6,18,12
142,LJU,P007066,P011261,0 days 00:04:59,-5,7,12
142,LJU,P001235,P009395,0 days 00:04:41,-4,12,16
142,LJU,P003514,P007066,0 days 00:04:23,-5,5,10
142,LJU,P007066,P010594,0 days 00:04:22,-2,7,9
142,LJU,P002561,P011261,0 days 00:04:21,3,12,9
142,LJU,P010771,P011261,0 days 00:04:09,3,11,8
142,LJU,P003514,P011261,0 days 00:04:05,-8,5,13
142,LJU,P002561,P010771,0 days 00:03:31,4,13,9
142,LJU,P003452,P011261,0 days 00:03:27,5,12,7
142,LJU,P001235,P005969,0 days 00:03:17,0,8,8
142,LJU,P001235,P003452,0 days 00:03:17,0,8,8
142,LJU,P001235,P010594,0 days 00:03:17,0,8,8
142,LJU,P001235,P003514,0 days 00:03:11,-6,5,11
142,LJU,P001235,P011261,0 days 00:03:11,-6,5,11
142,LJU,P001235,P007066,0 days 00:03:00,-3,5,8
142,LJU,P010594,P011261,0 days 00:02:59,0,6,6
142,LJU,P003514,P010771,0 days 00:02:56,-3,4,7
142,LJU,P009395,P011261,0 days 00:02:46,-1,10,11
142,LJU,P002561,P003514,0 days 00:02:32,-3,3,6
142,LJU,P003452,P010771,0 days 00:02:22,5,10,5
142,LJU,P010594,P010771,0 days 00:02:09,1,7,6
142,LJU,P001235,P010771,0 days 00:01:47,-2,1,3
142,LJU,P007066,P010771,0 days 00:01:47,-2,1,3
142,LJU,P007066,P009392,0 days 00:01:23,2,8,6
142,LJU,P009395,P010771,0 days 00:01:22,3,6,3
142,LJU,P005969,P010771,0 days 00:01:09,-1,3,4
142,LJU,P001235,P009392,0 days 00:00:11,-3,0,3
142,LJU,P009392,P011261,0 days 00:00:11,-3,0,3
142,VNC,P004381,P012591,0 days 00:27:09,16,73,57
142,VNC,P011928,P012591,0 days 00:23:52,4,61,57
142,VNC,P004381,P011928,0 days 00:21:30,11,56,45
142,VNC,P012591,P012796,0 days 00:18:46,-1,49,50
142,VNC,P004381,P012796,0 days 00:17:38,6,49,43
142,VNC,P003759,P012591,0 days 00:15:42,6,37,31
142,VNC,P011928,P012796,0 days 00:14:30,-3,38,41
142,VNC,P004381,P009400,0 days 00:12:46,-3,27,30
142,VNC,P003759,P004381,0 days 00:12:30,10,31,21
142,VNC,P008052,P012259,0 days 00:12:28,6,34,28
142,VNC,P009400,P012796,0 days 00:11:35,3,30,27
142,VNC,P000968,P012591,0 days 00:11:06,-8,26,34
142,VNC,P008052,P012591,0 days 00:10:36,1,25,24
142,VNC,P009400,P012591,0 days 00:10:06,-3,20,23
142,VNC,P003759,P011928,0 days 00:09:22,7,23,16
142,VNC,P003759,P012259,0 days 00:09:11,4,25,21
142,VNC,P000968,P012796,0 days 00:08:45,-2,23,25
142,VNC,P004381,P008052,0 days 00:08:38,5,24,19
142,VNC,P008052,P009400,0 days 00:08:23,4,24,20
142,VNC,P003759,P008052,0 days 00:08:21,3,22,19
142,VNC,P011909,P012591,0 days 00:07:57,13,23,10
142,VNC,P008052,P012796,0 days 00:07:47,4,21,17
142,VNC,P012259,P012591,0 days 00:07:46,1,19,18
142,VNC,P004381,P011909,0 days 00:07:17,13,23,10
142,VNC,P009400,P011928,0 days 00:07:15,-1,14,15
142,VNC,P000968,P008052,0 days 00:07:11,2,19,17
142,VNC,P011909,P011928,0 days 00:06:49,10,20,10
142,VNC,P003759,P011909,0 days 00:06:49,10,20,10
142,VNC,P000968,P012259,0 days 00:06:31,2,19,17
142,VNC,P004381,P012259,0 days 00:06:28,5,18,13
142,VNC,P000968,P011928,0 days 00:06:28,-4,18,22
142,VNC,P009400,P012259,0 days 00:05:51,6,18,12
142,VNC,P000968,P003759,0 days 00:04:54,0,14,14
142,VNC,P011928,P012587,0 days 00:04:52,-9,11,20
142,VNC,P012587,P012591,0 days 00:04:52,-9,11,20
142,VNC,P012587,P012796,0 days 00:04:52,-9,11,20
142,VNC,P012259,P012796,0 days 00:04:07,3,12,9
142,VNC,P000968,P004381,0 days 00:04:06,3,13,10
142,VNC,P003759,P009400,0 days 00:04:03,0,8,8
142,VNC,P000968,P009400,0 days 00:02:33,6,11,5
142,VNC,P004381,P012587,0 days 00:02:30,-2,6,8
142,VNC,P000968,P012587,0 days 00:02:22,-7,5,12
142,VNC,P008052,P011909,0 days 00:01:08,3,3,0
142,VNC,P011909,P012796,0 days 00:01:08,3,3,0
142,VNC,P011928,P012259,0 days 00:00:50,1,3,2
142,VNC,P000968,P011909,0 days 00:00:40,0,0,0
143,HAM,P012580,P012581,0 days 00:22:49,-20,34,54
143,HAM,P011168,P012581,0 days 00:19:19,-6,35,41
143,HAM,P009663,P012580,0 days 00:19:00,-8,30,38
143,HAM,P011187,P012581,0 days 00:17:39,-9,30,39
143,HAM,P011187,P012579,0 days 00:15:29,5,38,33
143,HAM,P009663,P012581,0 days 00:15:19,-16,21,37
143,HAM,P011168,P012582,0 days 00:15:15,-1,32,33
143,HAM,P010070,P012580,0 days 00:14:52,5,32,27
143,HAM,P011168,P011187,0 days 00:14:52,-5,28,33
143,HAM,P012579,P012581,0 days 00:14:38,-5,31,36
143,HAM,P012581,P012582,0 days 00:14:30,-11,24,35
143,HAM,P012579,P012580,0 days 00:14:05,3,30,27
143,HAM,P011168,P012580,0 days 00:13:44,-7,23,30
143,HAM,P009663,P012579,0 days 00:13:33,-6,19,25
143,HAM,P011187,P012580,0 days 00:13:25,-9,20,29
143,HAM,P009663,P012582,0 days 00:12:51,-9,17,26
143,HAM,P010070,P012579,0 days 00:12:34,9,32,23
143,HAM,P001990,P012580,0 days 00:12:09,1,22,21
143,HAM,P012580,P012582,0 days 00:11:48,-7,19,26
143,HAM,P010070,P011187,0 days 00:11:23,-2,22,24
143,HAM,P011168,P012579,0 days 00:11:05,-3,25,28
143,HAM,P001990,P012579,0 days 00:10:57,14,27,13
143,HAM,P010070,P012581,0 days 00:10:29,-2,21,23
143,HAM,P001990,P010070,0 days 00:10:11,6,23,17
143,HAM,P012579,P012582,0 days 00:09:38,1,19,18
143,HAM,P001990,P009663,0 days 00:08:36,-3,11,14
143,HAM,P009663,P011168,0 days 00:07:59,-3,13,16
143,HAM,P011187,P012582,0 days 00:07:31,1,19,18
143,HAM,P001990,P011187,0 days 00:07:25,6,20,14
143,HAM,P012579,P012648,0 days 00:07:11,-5,12,17
143,HAM,P001990,P012581,0 days 00:06:39,-7,11,18
143,HAM,P009663,P010070,0 days 00:06:08,5,13,8
143,HAM,P010070,P011168,0 days 00:05:15,-4,9,13
143,HAM,P001990,P012582,0 days 00:05:07,-7,4,11
143,HAM,P012582,P012648,0 days 00:04:48,1,10,9
143,HAM,P009663,P012648,0 days 00:04:40,-8,4,12
143,HAM,P011187,P012694,0 days 00:03:23,2,7,5
143,HAM,P012581,P012694,0 days 00:03:23,2,7,5
143,HAM,P011168,P012694,0 days 00:02:40,-2,3,5
143,HAM,P011187,P012648,0 days 00:02:31,3,8,5
143,HAM,P011168,P012648,0 days 00:02:31,3,8,5
143,HAM,P012581,P012648,0 days 00:02:23,-6,2,8
143,HAM,P001990,P012648,0 days 00:02:17,-2,2,4
143,HAM,P012579,P012694,0 days 00:02:14,3,7,4
143,HAM,P012580,P012648,0 days 00:01:55,-5,2,7
143,HAM,P009663,P011187,0 days 00:01:30,-4,0,4
143,HAM,P012580,P012694,0 days 00:01:09,-1,0,1
143,HAM,P001990,P012694,0 days 00:00:43,4,4,0
143,HAM,P010070,P012648,0 days 00:00:28,-1,0,1
143,BES,P012622,P012647,0 days 00:27:53,25,67,42
143,BES,P011936,P012647,0 days 00:26:25,20,59,39
143,BES,P011379,P012622,0 days 00:23:46,13,47,34
143,BES,P011936,P012622,0 days 00:22:29,20,50,30
143,BES,P008945,P012647,0 days 00:21:26,16,49,33
143,BES,P008945,P012622,0 days 00:20:38,7,42,35
143,BES,P008945,P011936,0 days 00:20:25,6,39,33
143,BES,P011379,P012647,0 days 00:18:48,13,40,27
143,BES,P011924,P012711,0 days 00:16:23,-4,32,36
143,BES,P008945,P011924,0 days 00:16:16,6,37,31
143,BES,P011379,P011936,0 days 00:16:14,13,31,18
143,BES,P011924,P012622,0 days 00:15:56,3,37,34
143,BES,P011924,P012647,0 days 00:15:52,11,46,35
143,BES,P008945,P011379,0 days 00:14:57,0,25,25
143,BES,P003783,P012622,0 days 00:14:01,11,35,24
143,BES,P003783,P012647,0 days 00:13:09,9,35,26
143,BES,P012647,P012711,0 days 00:11:15,-2,25,27
143,BES,P008945,P012711,0 days 00:11:00,-1,18,19
143,BES,P003783,P011379,0 days 00:10:45,11,24,13
143,BES,P011379,P011924,0 days 00:10:26,-1,19,20
143,BES,P003783,P011924,0 days 00:10:21,-11,20,31
143,BES,P011924,P011936,0 days 00:10:20,5,25,20
143,BES,P003783,P012711,0 days 00:09:42,-7,20,27
143,BES,P003783,P011936,0 days 00:09:40,8,26,18
143,BES,P012622,P012711,0 days 00:09:19,1,18,17
143,BES,P011936,P012711,0 days 00:09:11,-2,18,20
143,BES,P007917,P012711,0 days 00:06:31,-11,8,19
143,BES,P011379,P012711,0 days 00:06:26,-2,9,11
143,BES,P007917,P011924,0 days 00:04:49,-5,8,13
143,BES,P007917,P008945,0 days 00:04:35,-4,7,11
143,BES,P011357,P012711,0 days 00:03:01,-4,4,8
143,BES,P011357,P011924,0 days 00:03:01,-4,4,8
143,BES,P008945,P011357,0 days 00:03:01,-4,4,8
143,BES,P007917,P011357,0 days 00:03:01,-4,4,8
143,BES,P007917,P012647,0 days 00:02:28,-4,3,7
143,BES,P003783,P007917,0 days 00:02:08,-7,1,8
143,BES,P007917,P011936,0 days 00:01:28,-6,0,6
143,BES,P007917,P011379,0 days 00:01:26,-3,1,4
143,BES,P003783,P008945,0 days 00:01:02,-2,3,5
143,BES,P007917,P012622,0 days 00:00:26,0,0,0
144,LLI,P006600,P009680,0 days 00:28:04,-13,44,57
144,LLI,P009649,P009680,0 days 00:26:16,-20,37,57
144,LLI,P006600,P009649,0 days 00:24:20,-16,35,51
144,LLI,P009649,P012797,0 days 00:21:11,10,46,36
144,LLI,P009680,P012585,0 days 00:20:10,-12,36,48
144,LLI,P009649,P012586,0 days 00:19:54,-10,39,49
144,LLI,P006600,P012797,0 days 00:19:30,9,34,25
144,LLI,P012586,P012797,0 days 00:19:12,11,44,33
144,LLI,P009680,P012797,0 days 00:19:06,8,33,25
144,LLI,P009649,P012585,0 days 00:18:49,-3,43,46
144,LLI,P006600,P012585,0 days 00:18:38,-7,35,42
144,LLI,P006600,P012586,0 days 00:16:52,-18,20,38
144,LLI,P012585,P012797,0 days 00:16:34,33,51,18
144,LLI,P009680,P012586,0 days 00:16:28,-19,19,38
144,LLI,P012585,P012586,0 days 00:14:44,5,39,34
144,LLI,P004773,P012585,0 days 00:11:40,1,23,22
144,LLI,P004773,P012797,0 days 00:11:15,7,27,20
144,LLI,P012020,P012797,0 days 00:09:36,14,33,19
144,LLI,P004773,P012020,0 days 00:09:24,-2,19,21
144,LLI,P012020,P012586,0 days 00:09:21,14,33,19
144,LLI,P012020,P012585,0 days 00:08:41,15,29,14
144,LLI,P004773,P012586,0 days 00:08:21,1,18,17
144,LLI,P004773,P009649,0 days 00:08:20,-16,12,28
144,LLI,P004773,P009680,0 days 00:08:00,-8,13,21
144,LLI,P009649,P012020,0 days 00:07:10,3,24,21
144,LLI,P004773,P006600,0 days 00:06:28,-3,12,15
144,LLI,P009680,P012020,0 days 00:01:56,-4,2,6
144,JOV,P006771,P010677,0 days 00:23:56,8,47,39
144,JOV,P002507,P010458,0 days 00:23:38,15,50,35
144,JOV,P002507,P006771,0 days 00:23:20,8,49,41
144,JOV,P006771,P010458,0 days 00:22:12,13,46,33
144,JOV,P010458,P010677,0 days 00:21:18,7,46,39
144,JOV,P010458,P011247,0 days 00:21:00,16,51,35
144,JOV,P002507,P010677,0 days 00:20:44,10,42,32
144,JOV,P002507,P011247,0 days 00:19:15,15,49,34
144,JOV,P006771,P011247,0 days 00:17:14,10,42,32
144,JOV,P010677,P011247,0 days 00:14:21,12,38,26
144,JOV,P006771,P011248,0 days 00:13:14,-6,21,27
144,JOV,P010677,P011248,0 days 00:13:05,-3,26,29
144,JOV,P011248,P012780,0 days 00:13:04,-8,26,34
144,JOV,P010458,P011248,0 days 00:12:39,2,24,22
144,JOV,P011247,P011248,0 days 00:12:37,-6,26,32
144,JOV,P011248,P012349,0 days 00:11:00,-8,23,31
144,JOV,P002507,P011248,0 days 00:10:35,2,21,19
144,JOV,P012349,P012780,0 days 00:08:54,-4,17,21
144,JOV,P010677,P012780,0 days 00:08:42,-5,19,24
144,JOV,P010677,P012349,0 days 00:08:08,-2,15,17
144,JOV,P011248,PJUG,0 days 00:07:47,1,19,18
144,JOV,P010458,PJUG,0 days 00:06:42,-5,10,15
144,JOV,P006771,P012349,0 days 00:06:40,-10,10,20
144,JOV,P012780,PJUG,0 days 00:05:48,-2,14,16
144,JOV,P011247,P012780,0 days 00:05:40,-6,10,16
144,JOV,P011247,PJUG,0 days 00:05:38,2,12,10
144,JOV,P006771,P012780,0 days 00:05:32,-5,7,12
144,JOV,P010677,PJUG,0 days 00:05:09,-7,9,16
144,JOV,P002507,PJUG,0 days 00:04:59,-3,7,10
144,JOV,P010458,P012780,0 days 00:04:19,-4,9,13
144,JOV,P012349,PJUG,0 days 00:04:05,0,11,11
144,JOV,P011247,P012349,0 days 00:03:55,-7,8,15
144,JOV,P002507,P012349,0 days 00:03:09,-5,6,11
144,JOV,P006771,PJUG,0 days 00:03:00,-6,2,8
144,JOV,P010161,P012349,0 days 00:01:18,1,2,1
144,JOV,P010161,P010677,0 days 00:01:18,1,2,1
144,JOV,P010677,P010709,0 days 00:01:03,-1,0,1
144,JOV,P010709,P012349,0 days 00:01:03,-1,0,1
144,JOV,P002507,P010709,0 days 00:00:54,-1,0,1
144,JOV,P010161,P012780,0 days 00:00:44,2,2,0
144,JOV,P010161,P010709,0 days 00:00:43,-1,0,1
144,JOV,P010161,P011248,0 days 00:00:35,2,2,0
144,JOV,P002507,P010161,0 days 00:00:34,-1,0,1
144,JOV,P006771,P010709,0 days 00:00:20,0,0,0
144,JOV,P010709,P012780,0 days 00:00:09,0,0,0
145,HTA,P007759,P010550,0 days 00:24:55,-13,44,57
145,HTA,P007759,P012794,0 days 00:24:35,-4,57,61
145,HTA,P007867,P010550,0 days 00:22:52,-7,50,57
145,HTA,P007867,P012794,0 days 00:20:18,-8,46,54
145,HTA,P010550,P012794,0 days 00:20:07,-1,42,43
145,HTA,P007759,P007867,0 days 00:19:36,-12,39,51
145,HTA,P004846,P012794,0 days 00:17:13,-5,36,41
145,HTA,P007867,P011973,0 days 00:16:37,-15,35,50
145,HTA,P004846,P007759,0 days 00:16:31,-9,29,38
145,HTA,P004846,P007867,0 days 00:16:19,-17,32,49
145,HTA,P004846,P010550,0 days 00:16:08,-10,28,38
145,HTA,P007759,P011973,0 days 00:15:34,-13,32,45
145,HTA,P010550,P011973,0 days 00:15:25,-12,30,42
145,HTA,P003533,P012794,0 days 00:14:49,4,35,31
145,HTA,P003533,P004846,0 days 00:14:35,2,30,28
145,HTA,P011973,P012794,0 days 00:13:08,-6,32,38
145,HTA,P004846,P010465,0 days 00:12:22,-4,31,35
145,HTA,P010465,P012794,0 days 00:12:14,-8,24,32
145,HTA,P007867,P010465,0 days 00:11:48,-16,22,38
145,HTA,P003533,P007759,0 days 00:11:41,7,28,21
145,HTA,P004846,P011973,0 days 00:11:36,-17,22,39
145,HTA,P003533,P010550,0 days 00:10:35,7,25,18
145,HTA,P003533,P007867,0 days 00:09:34,3,24,21
145,HTA,P003533,P010465,0 days 00:07:38,-3,18,21
145,HTA,P007759,P010465,0 days 00:06:44,0,15,15
145,HTA,P010465,P010550,0 days 00:06:18,-8,13,21
145,HTA,P010465,P011973,0 days 00:04:44,-1,13,14
145,HTA,P003533,P012028,0 days 00:00:52,-2,4,6
145,HTA,P003533,P012706,0 days 00:00:52,-2,4,6
145,HTA,P007759,P012028,0 days 00:00:52,-2,4,6
145,HTA,P007759,P012706,0 days 00:00:52,-2,4,6
145,HTA,P012028,P012706,0 days 00:00:52,-2,4,6
145,HTA,P012028,P012794,0 days 00:00:52,-2,4,6
145,HTA,P012706,P012794,0 days 00:00:52,-2,4,6
145,PRS,P012608,P012610,0 days 00:28:03,29,74,45
145,PRS,P004512,P012610,0 days 00:16:34,26,52,26
145,PRS,P004512,P012608,0 days 00:16:34,26,52,26
145,PRS,P012610,P012613,0 days 00:14:43,20,44,24
145,PRS,P012608,P012613,0 days 00:14:43,20,44,24
145,PRS,P012609,P012613,0 days 00:13:50,-6,27,33
145,PRS,P012611,P012613,0 days 00:13:15,10,37,27
145,PRS,P011232,P012609,0 days 00:13:02,-13,33,46
145,PRS,P012610,P012611,0 days 00:12:18,19,37,18
145,PRS,P012608,P012611,0 days 00:12:18,19,37,18
145,PRS,P009556,P012609,0 days 00:11:57,-11,30,41
145,PRS,P009556,P011232,0 days 00:11:57,-11,30,41
145,PRS,P012609,P012610,0 days 00:11:51,9,29,20
145,PRS,P012608,P012609,0 days 00:11:51,9,29,20
145,PRS,P012612,P012640,0 days 00:10:58,-2,23,25
145,PRS,P011232,P012640,0 days 00:10:42,-11,21,32
145,PRS,P005793,P012608,0 days 00:10:11,13,27,14
145,PRS,P005793,P012610,0 days 00:10:11,13,27,14
145,PRS,P004512,P012613,0 days 00:09:13,15,28,13
145,PRS,P011232,P012613,0 days 00:08:40,-9,20,29
145,PRS,P012609,P012640,0 days 00:08:38,-9,21,30
145,PRS,P009556,P012640,0 days 00:08:38,-9,21,30
145,PRS,P004512,P012609,0 days 00:08:04,10,24,14
145,PRS,P012608,P012612,0 days 00:07:42,4,17,13
145,PRS,P012610,P012612,0 days 00:07:42,4,17,13
145,PRS,P012609,P012611,0 days 00:07:06,-3,14,17
145,PRS,P011232,P012612,0 days 00:07:03,-2,17,19
145,PRS,P009556,P012613,0 days 00:06:58,-11,13,24
145,PRS,P004512,P012611,0 days 00:06:48,14,21,7
145,PRS,P004512,P005793,0 days 00:06:16,13,21,8
145,PRS,P012610,P012640,0 days 00:05:59,-2,6,8
145,PRS,P012608,P012640,0 days 00:05:59,-2,6,8
145,PRS,P012609,P012612,0 days 00:04:59,0,17,17
145,PRS,P009556,P012612,0 days 00:04:59,0,17,17
145,PRS,P011232,P012608,0 days 00:04:51,-2,10,12
145,PRS,P011232,P012610,0 days 00:04:51,-2,10,12
145,PRS,P005793,P012640,0 days 00:03:55,0,6,6
145,PRS,P005793,P012612,0 days 00:03:55,0,6,6
145,PRS,P005793,P012609,0 days 00:03:54,6,12,6
145,PRS,P012613,P012640,0 days 00:03:39,-9,4,13
145,PRS,P009556,P012611,0 days 00:03:19,-2,9,11
145,PRS,P011232,P012611,0 days 00:03:19,-2,9,11
145,PRS,P004512,P011232,0 days 00:02:47,0,10,10
145,PRS,P005793,P012611,0 days 00:02:22,7,9,2
145,PRS,P012611,P012612,0 days 00:01:43,6,11,5
145,PRS,P012612,P012613,0 days 00:01:43,6,11,5
146,BOU,P000498,P004525,0 days 00:16:26,5,34,29
146,BOU,P004525,P012618,0 days 00:16:18,12,40,28
146,BOU,P010718,P011836,0 days 00:16:13,14,44,30
146,BOU,P004525,P012628,0 days 00:15:59,11,38,27
146,BOU,P000498,P012628,0 days 00:15:46,2,32,30
146,BOU,P011161,P012628,0 days 00:15:41,10,36,26
146,BOU,P010718,P012617,0 days 00:15:32,16,46,30
146,BOU,P010431,P010718,0 days 00:15:06,11,42,31
146,BOU,P000498,P011161,0 days 00:14:28,0,26,26
146,BOU,P004525,P011161,0 days 00:14:08,11,32,21
146,BOU,P010431,P011836,0 days 00:13:27,14,38,24
146,BOU,P012618,P012628,0 days 00:12:38,4,26,22
146,BOU,P010431,P012617,0 days 00:12:29,6,34,28
146,BOU,P000498,P012618,0 days 00:11:45,-6,18,24
146,BOU,P011836,P012617,0 days 00:10:50,9,30,21
146,BOU,P011836,P011837,0 days 00:09:52,9,29,20
146,BOU,P010718,P011837,0 days 00:09:52,9,29,20
146,BOU,P010431,P011837,0 days 00:09:52,9,29,20
146,BOU,P011837,P012617,0 days 00:09:52,9,29,20
146,BOU,P011161,P012618,0 days 00:09:27,0,16,16
146,BOU,P012617,P012618,0 days 00:07:06,15,25,10
146,BOU,P004525,P010450,0 days 00:06:51,15,24,9
146,BOU,P010718,P012618,0 days 00:06:13,5,17,12
146,BOU,P004525,P012617,0 days 00:06:08,15,24,9
146,BOU,P000498,P012619,0 days 00:05:05,6,15,9
146,BOU,P011836,P012619,0 days 00:05:01,7,14,7
146,BOU,P010450,P012618,0 days 00:04:58,13,20,7
146,BOU,P010718,P012619,0 days 00:04:50,7,14,7
146,BOU,P004525,P010718,0 days 00:04:42,7,16,9
146,BOU,P012619,P012628,0 days 00:04:41,3,13,10
146,BOU,P011161,P012619,0 days 00:04:41,3,13,10
146,BOU,P010431,P012618,0 days 00:04:26,-4,7,11
146,BOU,P000498,P010431,0 days 00:04:26,4,10,6
146,BOU,P000498,P011836,0 days 00:04:23,2,10,8
146,BOU,P011161,P011837,0 days 00:03:59,7,11,4
146,BOU,P011161,P011836,0 days 00:03:59,-1,8,9
146,BOU,P000498,P011837,0 days 00:03:59,7,11,4
146,BOU,P004525,P011837,0 days 00:03:59,7,11,4
146,BOU,P000498,P010450,0 days 00:03:48,5,12,7
146,BOU,P004525,P010431,0 days 00:03:28,-4,6,10
146,BOU,P011836,P012628,0 days 00:03:26,1,8,7
146,BOU,P000498,P010718,0 days 00:03:10,3,8,5
146,BOU,P010450,P010718,0 days 00:03:03,10,12,2
146,BOU,P010450,P012617,0 days 00:03:03,10,12,2
146,BOU,P010718,P011161,0 days 00:02:46,0,6,6
146,BOU,P010431,P012619,0 days 00:02:37,5,8,3
146,BOU,P011836,P012618,0 days 00:02:33,-3,3,6
146,BOU,P004525,P012619,0 days 00:02:17,1,7,6
146,BOU,P010718,P012628,0 days 00:02:13,2,6,4
146,BOU,P011837,P012628,0 days 00:02:06,5,7,2
146,BOU,P010450,P012628,0 days 00:01:55,3,8,5
146,BOU,P010450,P011161,0 days 00:01:53,2,4,2
146,BOU,P010450,P011837,0 days 00:01:53,2,4,2
146,BOU,P010431,P012628,0 days 00:01:49,-1,2,3
146,BOU,P011161,P012617,0 days 00:01:26,8,8,0
146,BOU,P012617,P012628,0 days 00:01:26,8,8,0
146,LKB,P002012,P007029,0 days 00:23:20,-16,45,61
146,LKB,P007029,P009898,0 days 00:23:18,-14,43,57
146,LKB,P006230,P007029,0 days 00:19:50,-18,37,55
146,LKB,P002012,P009898,0 days 00:19:33,-15,38,53
146,LKB,P002012,P006230,0 days 00:17:07,-10,33,43
146,LKB,P002012,P006901,0 days 00:16:04,-28,27,55
146,LKB,P006230,P009898,0 days 00:15:40,-15,29,44
146,LKB,P006901,P007029,0 days 00:15:35,-16,25,41
146,LKB,P006901,P009898,0 days 00:13:59,-15,22,37
146,LKB,P009898,P010461,0 days 00:12:46,-1,21,22
146,LKB,P010190,P010461,0 days 00:12:12,-17,19,36
146,LKB,P002012,P010190,0 days 00:11:58,-22,21,43
146,LKB,P002012,P010461,0 days 00:11:18,-22,19,41
146,LKB,P004868,P009898,0 days 00:11:15,-3,16,19
146,LKB,P006901,P010461,0 days 00:11:12,-13,20,33
146,LKB,P007029,P010461,0 days 00:10:48,-2,20,22
146,LKB,P004868,P007029,0 days 00:10:24,-8,16,24
146,LKB,P006230,P006901,0 days 00:09:48,-18,13,31
146,LKB,P009898,P010190,0 days 00:09:15,-3,17,20
146,LKB,P010461,PLXI,0 days 00:09:09,1,15,14
146,LKB,P004868,P010461,0 days 00:09:01,5,15,10
146,LKB,P007029,P010190,0 days 00:08:21,-5,17,22
146,LKB,P009898,PLXI,0 days 00:07:58,2,14,12
146,LKB,P007029,PLXI,0 days 00:07:30,0,17,17
146,LKB,P004868,PLXI,0 days 00:06:59,3,14,11
146,LKB,P010190,PLXI,0 days 00:06:32,4,12,8
146,LKB,P002012,P011329,0 days 00:06:26,-11,11,22
146,LKB,P006901,P011329,0 days 00:06:26,-11,11,22
146,LKB,P004868,P010190,0 days 00:06:09,1,9,8
146,LKB,P006901,P010190,0 days 00:05:40,-21,7,28
146,LKB,P004868,P006230,0 days 00:05:40,-10,8,18
146,LKB,P006230,P010190,0 days 00:05:11,-2,11,13
146,LKB,P004868,P006901,0 days 00:04:56,-3,6,9
146,LKB,P002012,PLXI,0 days 00:04:48,0,10,10
146,LKB,P010461,P011329,0 days 00:04:14,-11,7,18
146,LKB,P010190,P011329,0 days 00:04:14,-11,7,18
146,LKB,P006230,P011329,0 days 00:03:26,-1,8,9
146,LKB,P007029,P011329,0 days 00:03:26,-1,8,9
146,LKB,P002012,P004868,0 days 00:03:06,-4,4,8
146,LKB,P006230,PLXI,0 days 00:02:38,2,9,7
146,LKB,P004868,P011329,0 days 00:01:14,-1,4,5
146,LKB,P011329,PLXI,0 days 00:01:14,-1,4,5
146,LKB,P006901,PLXI,0 days 00:00:20,1,1,0
147,CAN,P003425,P008121,0 days 00:24:05,16,59,43
147,CAN,P003425,P003637,0 days 00:21:18,5,44,39
147,CAN,P003425,P006588,0 days 00:21:03,7,48,41
147,CAN,P008121,P009864,0 days 00:20:14,5,45,40
147,CAN,P003425,P009864,0 days 00:19:50,9,45,36
147,CAN,P003637,P006588,0 days 00:19:20,4,40,36
147,CAN,P006588,P008121,0 days 00:18:22,17,48,31
147,CAN,P003637,P008121,0 days 00:16:39,14,40,26
147,CAN,P003637,P009864,0 days 00:16:03,11,39,28
147,CAN,P006588,P009864,0 days 00:15:34,9,37,28
147,CAN,P005005,P010385,0 days 00:12:33,-18,9,27
147,CAN,P010385,P010452,0 days 00:10:03,-9,12,21
147,CAN,P001607,P010452,0 days 00:08:41,-18,6,24
147,CAN,P005005,P010452,0 days 00:08:35,-10,7,17
147,CAN,P003425,P010385,0 days 00:08:30,-2,13,15
147,CAN,P001607,P010385,0 days 00:08:27,-15,5,20
147,CAN,P003425,P007644,0 days 00:07:51,2,18,16
147,CAN,P001607,P005005,0 days 00:07:41,-13,4,17
147,CAN,P004160,P010385,0 days 00:07:00,-3,8,11
147,CAN,P007644,P008121,0 days 00:06:44,-1,15,16
147,CAN,P004160,P008121,0 days 00:06:29,-3,12,15
147,CAN,P004466,P010452,0 days 00:06:12,-13,7,20
147,CAN,P003425,P005005,0 days 00:05:58,-6,7,13
147,CAN,P003425,P004160,0 days 00:05:43,-1,11,12
147,CAN,P004160,P007644,0 days 00:05:33,-4,7,11
147,CAN,P003637,P010385,0 days 00:05:15,-6,5,11
147,CAN,P004160,P010452,0 days 00:05:14,-1,7,8
147,CAN,P001607,P004160,0 days 00:05:04,-4,3,7
147,CAN,P001607,P004466,0 days 00:04:53,-16,4,20
147,CAN,P004466,P010385,0 days 00:04:42,-8,5,13
147,CAN,P004466,P005005,0 days 00:04:42,-8,5,13
147,CAN,P003637,P005005,0 days 00:04:39,-9,4,13
147,CAN,P008121,P010385,0 days 00:04:24,1,9,8
147,CAN,P004160,P005005,0 days 00:04:18,-2,2,4
147,CAN,P007644,P009864,0 days 00:04:16,0,8,8
147,CAN,P004160,P009864,0 days 00:03:47,-2,6,8
147,CAN,P006588,P010385,0 days 00:03:46,-5,3,8
147,CAN,P004466,P008121,0 days 00:03:13,-2,10,12
147,CAN,P007644,P010385,0 days 00:03:08,-3,3,6
147,CAN,P003425,P004466,0 days 00:03:02,6,11,5
147,CAN,P008121,P010452,0 days 00:02:58,-4,7,11
147,CAN,P003425,P010452,0 days 00:02:52,4,8,4
147,CAN,P005005,P006588,0 days 00:02:41,-10,0,10
147,CAN,P005005,P007644,0 days 00:02:23,1,4,3
147,CAN,P001607,P008121,0 days 00:02:16,-7,3,10
147,CAN,P003637,P007644,0 days 00:01:51,1,4,3
147,CAN,P004466,P006588,0 days 00:01:43,3,8,5
147,CAN,P004466,P007644,0 days 00:01:43,3,8,5
147,CAN,P006588,P007644,0 days 00:01:43,3,8,5
147,CAN,P001607,P009864,0 days 00:01:30,-5,2,7
147,CAN,P009864,P010452,0 days 00:01:30,-5,2,7
147,CAN,P004466,P009864,0 days 00:01:30,-5,2,7
147,CAN,P001607,P007644,0 days 00:01:16,-2,1,3
147,CAN,P005005,P009864,0 days 00:01:06,-1,2,3
147,CAN,P003637,P010452,0 days 00:00:07,0,0,0
147,TTK,P006693,P011925,0 days 00:30:40,7,63,56
147,TTK,P006693,P011834,0 days 00:23:29,4,51,47
147,TTK,P006883,P011834,0 days 00:22:50,12,54,42
147,TTK,P011834,P011925,0 days 00:22:46,2,48,46
147,TTK,P006693,P006883,0 days 00:17:49,19,47,28
147,TTK,P006883,P011925,0 days 00:17:43,17,44,27
147,TTK,P005000,P006883,0 days 00:17:39,9,44,35
147,TTK,P005000,P006693,0 days 00:17:01,3,34,31
147,TTK,P005000,P011925,0 days 00:16:55,1,31,30
147,TTK,P005000,P011834,0 days 00:16:01,-1,36,37
147,TTK,P004801,P005000,0 days 00:15:52,6,33,27
147,TTK,P004801,P006883,0 days 00:15:41,17,39,22
147,TTK,P010477,P011925,0 days 00:12:52,2,25,23
147,TTK,P006693,P010477,0 days 00:12:49,2,25,23
147,TTK,P004801,P011834,0 days 00:12:38,9,29,20
147,TTK,P011239,P011834,0 days 00:12:03,-10,21,31
147,TTK,P004801,P006693,0 days 00:11:49,11,25,14
147,TTK,P004801,P011925,0 days 00:11:40,9,22,13
147,TTK,P010477,P011834,0 days 00:11:00,0,23,23
147,TTK,P005000,P009845,0 days 00:09:16,1,15,14
147,TTK,P011239,P011925,0 days 00:07:29,-5,12,17
147,TTK,P006693,P011239,0 days 00:07:29,-5,12,17
147,TTK,P009845,P011925,0 days 00:07:15,-5,7,12
147,TTK,P010477,P011239,0 days 00:07:00,-5,12,17
147,TTK,P004801,P009845,0 days 00:06:47,1,11,10
147,TTK,P006693,P009845,0 days 00:06:38,-5,7,12
147,TTK,P005000,P011239,0 days 00:05:41,-5,9,14
147,TTK,P006883,P011239,0 days 00:04:53,-5,9,14
147,TTK,P004801,P011239,0 days 00:04:53,-5,9,14
147,TTK,P006883,P010477,0 days 00:04:19,5,11,6
147,TTK,P009845,P011834,0 days 00:02:57,4,10,6
147,TTK,P006883,P009845,0 days 00:02:38,6,8,2
147,TTK,P005000,P010477,0 days 00:01:55,2,2,0
147,TTK,P009845,P010477,0 days 00:01:33,2,2,0
148,TRN,P009903,P012597,0 days 00:24:39,5,54,49
148,TRN,P005738,P012597,0 days 00:23:04,-1,53,54
148,TRN,P005738,P009903,0 days 00:21:56,-1,48,49
148,TRN,P005059,P012593,0 days 00:19:04,3,37,34
148,TRN,P005059,P012597,0 days 00:18:16,7,41,34
148,TRN,P005059,P009903,0 days 00:17:33,5,37,32
148,TRN,P005059,P005738,0 days 00:16:02,3,35,32
148,TRN,P006382,P012597,0 days 00:15:54,3,34,31
148,TRN,P009903,P012593,0 days 00:14:25,6,31,25
148,TRN,P005738,P012593,0 days 00:13:54,0,27,27
148,TRN,P006382,P009903,0 days 00:13:51,2,25,23
148,TRN,P012593,P012597,0 days 00:12:20,3,28,25
148,TRN,P005738,P012687,0 days 00:11:12,-3,26,29
148,TRN,P012597,P012687,0 days 00:11:12,-3,26,29
148,TRN,P001479,P012594,0 days 00:11:10,5,26,21
148,TRN,P012594,P012596,0 days 00:10:40,-2,24,26
148,TRN,P005738,P006382,0 days 00:10:09,-4,17,21
148,TRN,P001479,P012596,0 days 00:09:43,2,23,21
148,TRN,P009903,P012687,0 days 00:09:26,-3,21,24
148,TRN,P001479,P006382,0 days 00:09:12,8,22,14
148,TRN,P001479,P005059,0 days 00:08:58,4,15,11
148,TRN,P001479,P012597,0 days 00:08:47,4,18,14
148,TRN,P006382,P012687,0 days 00:08:07,-2,17,19
148,TRN,P005059,P012596,0 days 00:07:27,2,13,11
148,TRN,P012596,P012597,0 days 00:07:12,-2,17,19
148,TRN,P001479,P012593,0 days 00:06:35,6,15,9
148,TRN,P012593,P012594,0 days 00:06:07,5,14,9
148,TRN,P012593,P012596,0 days 00:06:04,0,11,11
148,TRN,P012594,P012597,0 days 00:06:00,-4,13,17
148,TRN,P006382,P012594,0 days 00:05:56,5,17,12
148,TRN,P006382,P012596,0 days 00:05:30,2,14,12
148,TRN,P005059,P006382,0 days 00:05:18,1,5,4
148,TRN,P005059,P012594,0 days 00:05:14,0,9,9
148,TRN,P001479,P009903,0 days 00:05:11,7,9,2
148,TRN,P006382,P012593,0 days 00:03:27,1,5,4
148,TRN,P005738,P012596,0 days 00:03:10,-2,5,7
148,TRN,P005059,P012687,0 days 00:02:08,3,8,5
148,TRN,P012596,P012687,0 days 00:01:46,0,5,5
148,TRN,P009903,P012594,0 days 00:01:27,3,3,0
148,TRN,P005738,P012594,0 days 00:00:57,-4,1,5
148,TRN,P012594,P012687,0 days 00:00:57,-4,1,5
148,WRO,P005531,P012699,0 days 00:23:48,-5,43,48
148,WRO,P009896,P012601,0 days 00:22:46,9,52,43
148,WRO,P005531,P012601,0 days 00:21:10,4,45,41
148,WRO,P009896,P012094,0 days 00:21:01,0,45,45
148,WRO,P012094,P012601,0 days 00:19:30,-7,40,47
148,WRO,P012601,P012699,0 days 00:19:07,-1,41,42
148,WRO,P005531,P012010,0 days 00:15:45,-1,30,31
148,WRO,P012010,P012601,0 days 00:15:42,-2,30,32
148,WRO,P012010,P012699,0 days 00:15:34,-6,28,34
148,WRO,P005531,P009896,0 days 00:15:24,10,32,22
148,WRO,P009896,P012699,0 days 00:14:39,3,28,25
148,WRO,P012094,P012736,0 days 00:14:05,3,34,31
148,WRO,P009896,P012736,0 days 00:13:35,9,34,25
148,WRO,P005531,P012094,0 days 00:12:27,-4,20,24
148,WRO,P003034,P005531,0 days 00:11:59,-11,18,29
148,WRO,P012094,P012699,0 days 00:11:36,-7,18,25
148,WRO,P003034,P012699,0 days 00:11:30,-13,18,31
148,WRO,P011901,P012601,0 days 00:11:09,1,24,23
148,WRO,P012601,P012736,0 days 00:10:06,5,29,24
148,WRO,P009896,P011901,0 days 00:09:40,5,24,19
148,WRO,P003034,P012010,0 days 00:09:38,-10,16,26
148,WRO,P011901,P012094,0 days 00:09:27,-1,22,23
148,WRO,P009896,P012010,0 days 00:09:00,3,16,13
148,WRO,P003034,P012601,0 days 00:08:44,-8,16,24
148,WRO,P011901,P012736,0 days 00:07:19,3,21,18
148,WRO,P005531,P012736,0 days 00:06:38,0,12,12
148,WRO,P012699,P012736,0 days 00:06:35,0,12,12
148,WRO,P011278,P012010,0 days 00:04:48,-8,4,12
148,WRO,P005531,P011901,0 days 00:04:13,0,6,6
148,WRO,P003034,P011278,0 days 00:02:56,-5,2,7
148,WRO,P005531,P011278,0 days 00:02:56,-5,2,7
148,WRO,P011278,P012699,0 days 00:02:56,-5,2,7
148,WRO,P012010,P012094,0 days 00:02:53,-6,2,8
148,WRO,P011278,P012601,0 days 00:02:34,-5,3,8
148,WRO,P011278,P012094,0 days 00:02:27,-3,5,8
148,WRO,P009896,P011278,0 days 00:02:27,-3,5,8
148,WRO,P003034,P012094,0 days 00:02:02,-3,2,5
148,WRO,P011901,P012010,0 days 00:01:12,2,2,0
148,WRO,P011278,P011901,0 days 00:00:35,0,3,3
148,WRO,P011901,P012699,0 days 00:00:23,2,2,0
148,WRO,P003034,P011901,0 days 00:00:10,0,0,0
148,WRO,P011278,P012736,-1 days +23:59:53,2,2,0
148,WRO,P003034,P012736,-1 days +23:59:41,-2,0,2
149,ULM,P010106,P012603,0 days 00:26:38,5,61,56
149,ULM,P010106,P010582,0 days 00:24:44,-1,57,58
149,ULM,P010106,P012604,0 days 00:24:38,-6,50,56
149,ULM,P010582,P012604,0 days 00:23:48,-6,48,54
149,ULM,P012603,P012604,0 days 00:23:17,-2,48,50
149,ULM,P010582,P012603,0 days 00:21:42,-2,48,50
149,ULM,P005422,P010106,0 days 00:19:13,-9,37,46
149,ULM,P005422,P010582,0 days 00:18:25,-7,35,42
149,ULM,P005422,P012603,0 days 00:17:25,-11,31,42
149,ULM,P005422,P012604,0 days 00:16:13,-9,29,38
149,ULM,P011457,P012703,0 days 00:15:50,-2,29,31
149,ULM,P010582,P012703,0 days 00:13:27,-2,29,31
149,ULM,P010106,P012703,0 days 00:12:46,13,37,24
149,ULM,P012604,P012703,0 days 00:12:13,-1,23,24
149,ULM,P007952,P011457,0 days 00:10:41,6,25,19
149,ULM,P012603,P012703,0 days 00:10:37,14,30,16
149,ULM,P007952,P012703,0 days 00:09:53,4,23,19
149,ULM,P010582,P011457,0 days 00:09:23,-7,16,23
149,ULM,P010726,P011457,0 days 00:08:49,-10,9,19
149,ULM,P010726,P012703,0 days 00:08:49,-10,9,19
149,ULM,P010106,P011457,0 days 00:07:51,10,24,14
149,ULM,P007952,P010582,0 days 00:07:01,-3,16,19
149,ULM,P005422,P007952,0 days 00:06:46,-2,10,12
149,ULM,P007952,P010726,0 days 00:06:25,-8,7,15
149,ULM,P011457,P012604,0 days 00:06:19,-6,8,14
149,ULM,P005422,P011457,0 days 00:05:50,0,8,8
149,ULM,P007952,P010106,0 days 00:05:46,12,22,10
149,ULM,P005422,P012703,0 days 00:05:37,-4,4,8
149,ULM,P010582,P010726,0 days 00:05:34,-8,7,15
149,ULM,P011457,P012603,0 days 00:04:05,9,13,4
149,ULM,P007952,P012603,0 days 00:03:32,7,13,6
149,ULM,P005422,P010726,0 days 00:03:15,-2,2,4
149,ULM,P010726,P012604,0 days 00:02:24,-2,2,4
149,ULM,P005422,P011391,0 days 00:00:16,0,0,0
149,ULM,P010582,P011391,0 days 00:00:16,0,0,0
149,ULM,P011391,P011457,0 days 00:00:16,0,0,0
149,ULM,P011391,P012703,0 days 00:00:16,0,0,0
149,CLU,P005714,P011801,0 days 00:21:54,9,50,41
149,CLU,P011797,P012621,0 days 00:21:04,3,44,41
149,CLU,P005373,P011801,0 days 00:20:41,17,51,34
149,CLU,P005373,P005714,0 days 00:18:35,14,45,31
149,CLU,P011801,P012621,0 days 00:18:24,13,50,37
149,CLU,P010569,P012621,0 days 00:18:19,-5,34,39
149,CLU,P010569,P011797,0 days 00:17:06,-6,33,39
149,CLU,P005113,P012621,0 days 00:16:50,-8,29,37
149,CLU,P005113,P010569,0 days 00:15:39,-8,29,37
149,CLU,P005113,P011797,0 days 00:15:35,-8,29,37
149,CLU,P005714,P012621,0 days 00:15:21,12,44,32
149,CLU,P005373,P012621,0 days 00:14:08,20,45,25
149,CLU,P005714,P012620,0 days 00:13:56,12,34,22
149,CLU,P011801,P012620,0 days 00:13:35,12,34,22
149,CLU,P005373,P012620,0 days 00:12:43,13,32,19
149,CLU,P004862,P012621,0 days 00:10:32,-4,22,26
149,CLU,P012620,P012621,0 days 00:10:30,12,33,21
149,CLU,P011797,P011801,0 days 00:10:09,-1,19,20
149,CLU,P004862,P010569,0 days 00:10:09,-2,22,24
149,CLU,P004862,P005113,0 days 00:08:58,-2,19,21
149,CLU,P005373,P011797,0 days 00:08:52,4,19,15
149,CLU,P004862,P011797,0 days 00:08:01,0,19,19
149,CLU,P011797,P012698,0 days 00:07:50,-10,11,21
149,CLU,P005714,P011797,0 days 00:07:37,1,13,12
149,CLU,P010569,P012698,0 days 00:05:29,-7,7,14
149,CLU,P011801,P012698,0 days 00:05:28,-4,6,10
149,CLU,P005113,P012698,0 days 00:05:08,-7,7,14
149,CLU,P005373,P012698,0 days 00:05:04,-1,6,7
149,CLU,P012621,P012698,0 days 00:05:00,-3,7,10
149,CLU,P005714,P012698,0 days 00:04:59,-2,4,6
149,CLU,P010569,P011801,0 days 00:04:35,-5,7,12
149,CLU,P012620,P012698,0 days 00:03:14,2,4,2
149,CLU,P005113,P011801,0 days 00:03:06,-8,2,10
149,CLU,P011797,P012620,0 days 00:02:58,1,5,4
149,CLU,P005113,P012620,0 days 00:02:35,0,7,7
149,CLU,P004862,P011801,0 days 00:02:31,-4,3,7
149,CLU,P010569,P012620,0 days 00:02:04,1,5,4
149,CLU,P004862,P005714,0 days 00:01:57,-4,3,7
149,CLU,P005714,P010569,0 days 00:01:55,-2,3,5
149,CLU,P005113,P005714,0 days 00:01:45,-3,2,5
149,CLU,P005373,P010569,0 days 00:01:40,2,4,2
149,CLU,P005373,P010997,0 days 00:01:01,-1,2,3
149,CLU,P005714,P010997,0 days 00:01:01,-1,2,3
149,CLU,P010997,P011801,0 days 00:01:01,-1,2,3
149,CLU,P010997,P012620,0 days 00:01:01,-1,2,3
150,ARI,P004292,P012708,0 days 00:21:37,-6,42,48
150,ARI,P012708,P012760,0 days 00:20:02,4,39,35
150,ARI,P003240,P012760,0 days 00:19:34,7,38,31
150,ARI,P004292,P012760,0 days 00:19:06,9,42,33
150,ARI,P012708,P012717,0 days 00:18:40,-2,35,37
150,ARI,P012615,P012716,0 days 00:18:04,5,38,33
150,ARI,P003240,P012708,0 days 00:17:25,-6,30,36
150,ARI,P003240,P004292,0 days 00:17:07,1,34,33
150,ARI,P003240,P012717,0 days 00:15:36,-5,26,31
150,ARI,P012615,P012708,0 days 00:14:32,-1,31,32
150,ARI,P012717,P012760,0 days 00:13:49,2,25,23
150,ARI,P012708,P012716,0 days 00:13:00,1,29,28
150,ARI,P004292,P012717,0 days 00:12:58,-5,25,30
150,ARI,P012702,P012708,0 days 00:12:46,-7,25,32
150,ARI,P004292,P012615,0 days 00:12:43,5,26,21
150,ARI,P012716,P012760,0 days 00:11:44,10,23,13
150,ARI,P012615,P012760,0 days 00:11:32,8,24,16
150,ARI,P004292,P012716,0 days 00:11:11,7,24,17
150,ARI,P012708,P012792,0 days 00:09:34,2,21,19
150,ARI,P003240,P012716,0 days 00:08:49,5,13,8
150,ARI,P003240,P012615,0 days 00:08:37,3,14,11
150,ARI,P012702,P012792,0 days 00:07:40,0,16,16
150,ARI,P012717,P012792,0 days 00:07:26,3,11,8
150,ARI,P012702,P012716,0 days 00:07:11,-5,14,19
150,ARI,P012615,P012702,0 days 00:07:11,-5,14,19
150,ARI,P012716,P012792,0 days 00:06:36,-3,12,15
150,ARI,P012702,P012717,0 days 00:06:35,-4,11,15
150,ARI,P004292,P012702,0 days 00:06:06,-9,9,18
150,ARI,P003240,P012792,0 days 00:05:05,-4,3,7
150,ARI,P012615,P012792,0 days 00:04:52,-3,11,14
150,ARI,P002867,P012717,0 days 00:04:48,3,10,7
150,ARI,P002867,P012708,0 days 00:04:48,3,10,7
150,ARI,P012760,P012792,0 days 00:04:14,0,4,4
150,ARI,P003240,P012702,0 days 00:04:10,-9,2,11
150,ARI,P002867,P012702,0 days 00:03:25,3,9,6
150,ARI,P002867,P012792,0 days 00:03:21,5,8,3
150,ARI,P012716,P012717,0 days 00:01:44,0,1,1
150,ARI,P002867,P004292,0 days 00:01:27,-2,2,4
150,ARI,P002867,P012760,0 days 00:01:23,0,1,1
150,ARI,P012615,P012722,0 days 00:00:53,0,2,2
150,ARI,P012716,P012722,0 days 00:00:53,0,2,2
150,ARI,P003240,P012722,0 days 00:00:29,0,0,0
150,ARI,P004292,P012722,0 days 00:00:29,0,0,0
150,ARI,P012708,P012722,0 days 00:00:24,0,2,2
150,ARI,P012722,P012792,0 days 00:00:24,0,2,2
150,ARI,P012615,P012717,0 days 00:00:00,0,0,0
150,BUD,P010248,P012606,0 days 00:21:08,-7,38,45
150,BUD,P005637,P012606,0 days 00:21:01,1,40,39
150,BUD,P005637,P010248,0 days 00:20:02,-4,35,39
150,BUD,P012606,P012630,0 days 00:17:34,-11,30,41
150,BUD,P002740,P004945,0 days 00:17:15,8,35,27
150,BUD,P004945,P012606,0 days 00:14:58,6,28,22
150,BUD,P011281,P012606,0 days 00:14:47,1,28,27
150,BUD,P005637,P011281,0 days 00:13:36,-3,21,24
150,BUD,P002740,P005637,0 days 00:13:17,-6,21,27
150,BUD,P004945,P005637,0 days 00:13:15,-6,18,24
150,BUD,P002740,P010248,0 days 00:13:14,-10,21,31
150,BUD,P010248,P012630,0 days 00:12:58,-7,22,29
150,BUD,P002740,P012606,0 days 00:12:54,2,26,24
150,BUD,P005637,P012630,0 days 00:12:37,-1,26,27
150,BUD,P004945,P010248,0 days 00:12:34,-8,20,28
150,BUD,P010248,P011281,0 days 00:12:24,-6,19,25
150,BUD,P011281,P012630,0 days 00:11:30,3,26,23
150,BUD,P004945,P011281,0 days 00:11:28,0,21,21
150,BUD,P008325,P011935,0 days 00:11:19,13,28,15
150,BUD,P008325,P011281,0 days 00:10:32,9,28,19
150,BUD,P011935,P012606,0 days 00:10:23,-4,16,20
150,BUD,P008325,P012606,0 days 00:10:16,4,18,14
150,BUD,P004945,P008325,0 days 00:10:01,14,23,9
150,BUD,P004945,P011935,0 days 00:09:49,12,25,13
150,BUD,P011281,P011935,0 days 00:09:24,6,26,20
150,BUD,P002740,P011935,0 days 00:08:40,10,24,14
150,BUD,P002740,P008325,0 days 00:08:14,14,24,10
150,BUD,P002740,P011281,0 days 00:08:11,2,19,17
150,BUD,P011935,P012630,0 days 00:05:54,-8,8,16
150,BUD,P008325,P012630,0 days 00:05:33,-2,12,14
150,BUD,P005637,P008325,0 days 00:04:40,-1,7,8
150,BUD,P010248,P011935,0 days 00:04:22,-9,5,14
150,BUD,P002740,P012630,0 days 00:04:15,-4,10,14
150,BUD,P009214,P012606,0 days 00:02:35,-4,0,4
150,BUD,P009214,P012630,0 days 00:02:35,-4,0,4
150,BUD,P009214,P011935,0 days 00:02:34,-4,0,4
150,BUD,P008325,P009214,0 days 00:01:41,-3,0,3
150,BUD,P004945,P012630,0 days 00:01:08,-2,2,4
150,BUD,P009214,P010248,0 days 00:00:54,-1,0,1
150,BUD,P005637,P011935,0 days 00:00:27,0,0,0
150,BUD,P005637,P009214,0 days 00:00:01,0,0,0
151,HTA,P007759,P011973,0 days 00:21:54,-1,60,61
151,HTA,P010465,P010550,0 days 00:21:51,3,58,55
151,HTA,P010465,P011973,0 days 00:21:02,-5,53,58
151,HTA,P010550,P011973,0 days 00:19:14,2,52,50
151,HTA,P007759,P010465,0 days 00:18:40,-12,42,54
151,HTA,P007867,P011973,0 days 00:18:14,3,53,50
151,HTA,P007759,P010550,0 days 00:17:18,-4,43,47
151,HTA,P007759,P007867,0 days 00:16:21,3,48,45
151,HTA,P004846,P012794,0 days 00:16:19,-8,40,48
151,HTA,P004846,P010550,0 days 00:15:44,-7,35,42
151,HTA,P010550,P012794,0 days 00:15:33,5,49,44
151,HTA,P004846,P011973,0 days 00:15:24,-7,36,43
151,HTA,P007867,P010550,0 days 00:15:10,1,43,42
151,HTA,P011973,P012794,0 days 00:14:10,3,44,41
151,HTA,P007867,P012794,0 days 00:13:53,1,43,42
151,HTA,P004846,P010465,0 days 00:13:50,-8,30,38
151,HTA,P010465,P012794,0 days 00:13:41,0,41,41
151,HTA,P007867,P010465,0 days 00:13:18,5,38,33
151,HTA,P003533,P012794,0 days 00:13:15,-9,33,42
151,HTA,P007759,P012794,0 days 00:12:39,-6,33,39
151,HTA,P004846,P007759,0 days 00:12:36,-8,27,35
151,HTA,P003533,P004846,0 days 00:10:26,-10,24,34
151,HTA,P003533,P010550,0 days 00:10:20,-2,27,29
151,HTA,P003533,P010465,0 days 00:08:26,-3,22,25
151,HTA,P004846,P007867,0 days 00:07:31,-10,15,25
151,HTA,P003533,P007759,0 days 00:04:24,-8,7,15
151,HTA,P003533,P007867,0 days 00:04:17,-3,12,15
151,HTA,P003533,P011990,0 days 00:03:06,2,9,7
151,HTA,P004846,P011990,0 days 00:03:06,2,9,7
151,HTA,P010550,P011990,0 days 00:03:06,2,9,7
151,HTA,P011990,P012794,0 days 00:03:06,2,9,7
151,HTA,P003533,P011973,0 days 00:02:06,-3,6,9
151,PMT,P001686,P012600,0 days 00:26:11,3,71,68
151,PMT,P001686,P011944,0 days 00:23:52,14,65,51
151,PMT,P001686,P011942,0 days 00:23:06,17,70,53
151,PMT,P011944,P012600,0 days 00:22:16,8,61,53
151,PMT,P002644,P012600,0 days 00:22:09,12,71,59
151,PMT,P011942,P011944,0 days 00:22:06,16,67,51
151,PMT,P011942,P012600,0 days 00:18:19,14,57,43
151,PMT,P001686,P011823,0 days 00:17:16,-5,39,44
151,PMT,P001686,P002644,0 days 00:16:44,10,53,43
151,PMT,P002644,P011944,0 days 00:15:30,9,50,41
151,PMT,P002644,P011942,0 days 00:14:40,11,49,38
151,PMT,P011823,P011944,0 days 00:11:34,3,25,22
151,PMT,P001686,P005301,0 days 00:11:26,-3,24,27
151,PMT,P005301,P011823,0 days 00:10:51,-4,21,25
151,PMT,P005301,P011944,0 days 00:10:15,0,24,24
151,PMT,P011823,P011942,0 days 00:10:13,5,27,22
151,PMT,P001686,P011966,0 days 00:10:08,-9,27,36
151,PMT,P011823,P012600,0 days 00:10:02,-6,21,27
151,PMT,P011966,P012600,0 days 00:09:55,-2,31,33
151,PMT,P011947,P011966,0 days 00:09:49,-3,29,32
151,PMT,P011947,P012600,0 days 00:08:34,-3,27,30
151,PMT,P005301,P011942,0 days 00:07:19,3,22,19
151,PMT,P001686,P011947,0 days 00:07:17,-7,19,26
151,PMT,P002644,P011966,0 days 00:07:14,4,24,20
151,PMT,P002644,P011947,0 days 00:06:23,2,20,18
151,PMT,P005301,P012600,0 days 00:06:03,-4,11,15
151,PMT,P011823,P011966,0 days 00:05:42,-8,14,22
151,PMT,P005301,P011966,0 days 00:03:37,-2,8,10
151,PMT,P011943,P012600,0 days 00:03:34,2,13,11
151,PMT,P002644,P011943,0 days 00:03:34,2,13,11
151,PMT,P011823,P011947,0 days 00:03:26,-5,9,14
151,PMT,P002644,P005301,0 days 00:03:01,2,11,9
151,PMT,P011942,P011966,0 days 00:02:47,0,9,9
151,PMT,P011943,P011947,0 days 00:02:32,4,10,6
151,PMT,P011943,P011966,0 days 00:02:32,4,10,6
151,PMT,P002644,P010549,0 days 00:01:41,0,5,5
151,PMT,P005301,P010549,0 days 00:01:41,0,5,5
151,PMT,P010549,P011944,0 days 00:01:41,0,5,5
151,PMT,P010549,P012600,0 days 00:01:41,0,5,5
151,PMT,P005301,P011947,0 days 00:01:15,0,2,2
151,PMT,P011942,P011943,0 days 00:01:02,-2,3,5
151,PMT,P011943,P011944,0 days 00:01:02,-2,3,5
152,PRS,P012608,P012610,0 days 00:26:14,9,55,46
152,PRS,P005793,P012610,0 days 00:18:21,3,37,34
152,PRS,P005793,P012608,0 days 00:18:11,5,37,32
152,PRS,P012609,P012640,0 days 00:16:06,5,42,37
152,PRS,P012610,P012613,0 days 00:14:45,-6,27,33
152,PRS,P012608,P012613,0 days 00:14:35,-4,27,31
152,PRS,P011232,P012640,0 days 00:14:25,4,38,34
152,PRS,P012612,P012640,0 days 00:14:04,4,38,34
152,PRS,P011232,P012612,0 days 00:14:04,4,38,34
152,PRS,P011232,P012609,0 days 00:13:36,0,34,34
152,PRS,P012609,P012612,0 days 00:13:36,0,34,34
152,PRS,P004512,P012608,0 days 00:12:48,7,27,20
152,PRS,P004512,P012610,0 days 00:12:48,7,27,20
152,PRS,P012613,P012640,0 days 00:11:36,5,29,24
152,PRS,P012609,P012610,0 days 00:11:19,8,27,19
152,PRS,P012608,P012609,0 days 00:11:09,10,27,17
152,PRS,P005793,P012613,0 days 00:10:38,-1,21,22
152,PRS,P012610,P012611,0 days 00:09:57,-14,11,25
152,PRS,P012608,P012611,0 days 00:09:47,-12,11,23
152,PRS,P004512,P012609,0 days 00:09:41,9,24,15
152,PRS,P011232,P012611,0 days 00:09:36,-1,21,22
152,PRS,P011232,P012613,0 days 00:09:31,-5,19,24
152,PRS,P012611,P012613,0 days 00:08:48,-14,11,25
152,PRS,P005793,P012609,0 days 00:08:46,3,19,16
152,PRS,P012609,P012613,0 days 00:08:42,-3,19,22
152,PRS,P012610,P012640,0 days 00:07:51,16,25,9
152,PRS,P012608,P012640,0 days 00:07:51,16,25,9
152,PRS,P004512,P005793,0 days 00:07:43,4,16,12
152,PRS,P012612,P012613,0 days 00:07:04,-2,16,18
152,PRS,P012609,P012611,0 days 00:06:45,0,18,18
152,PRS,P012611,P012640,0 days 00:06:32,2,18,16
152,PRS,P012611,P012612,0 days 00:06:32,2,18,16
152,PRS,P005793,P012611,0 days 00:05:13,-9,5,14
152,PRS,P005793,P012640,0 days 00:04:32,7,13,6
152,PRS,P011232,P012608,0 days 00:03:53,1,7,6
152,PRS,P011232,P012610,0 days 00:03:53,1,7,6
152,PRS,P004512,P012640,0 days 00:02:51,5,8,3
152,PRS,P004512,P012611,0 days 00:02:46,-2,3,5
152,PRS,P004512,P012613,0 days 00:01:37,-2,3,5
152,PRS,P004512,P011232,0 days 00:00:58,0,0,0
152,PRS,P012608,P012612,0 days 00:00:28,4,4,0
152,PRS,P012610,P012612,0 days 00:00:28,4,4,0
152,JOV,P006771,P011247,0 days 00:22:28,-17,38,55
152,JOV,P002507,P011247,0 days 00:21:03,-5,47,52
152,JOV,P010677,P011247,0 days 00:19:45,2,45,43
152,JOV,P002507,P010677,0 days 00:18:30,-5,40,45
152,JOV,P010677,P012349,0 days 00:16:52,6,42,36
152,JOV,P010458,P011247,0 days 00:15:18,-2,31,33
152,JOV,P011247,P012349,0 days 00:14:36,8,35,27
152,JOV,P006771,P010677,0 days 00:13:58,-9,28,37
152,JOV,P011247,P012780,0 days 00:13:42,-3,21,24
152,JOV,P012349,PJUG,0 days 00:13:15,9,36,27
152,JOV,P002507,P006771,0 days 00:13:10,-14,25,39
152,JOV,P006771,P012780,0 days 00:13:00,-6,23,29
152,JOV,P012780,PJUG,0 days 00:12:46,0,28,28
152,JOV,P010677,PJUG,0 days 00:12:36,2,31,29
152,JOV,P012349,P012780,0 days 00:12:03,1,26,25
152,JOV,P011247,PJUG,0 days 00:11:46,8,29,21
152,JOV,P006771,P010458,0 days 00:11:43,-7,21,28
152,JOV,P002507,P010458,0 days 00:11:02,-10,22,32
152,JOV,P006771,P012349,0 days 00:10:58,-7,21,28
152,JOV,P010677,P012780,0 days 00:09:21,-3,18,21
152,JOV,P002507,P012349,0 days 00:09:17,3,22,19
152,JOV,P010458,P010677,0 days 00:09:08,-6,20,26
152,JOV,P002507,PJUG,0 days 00:08:37,-5,17,22
152,JOV,P010161,P011247,0 days 00:08:30,6,19,13
152,JOV,P010161,P010458,0 days 00:07:00,-3,14,17
152,JOV,P006771,PJUG,0 days 00:06:45,-5,15,20
152,JOV,P002507,P010161,0 days 00:06:19,-5,12,17
152,JOV,P011248,P012349,0 days 00:06:08,0,11,11
152,JOV,P011248,P012780,0 days 00:06:00,2,11,9
152,JOV,P010161,P010677,0 days 00:05:00,-4,8,12
152,JOV,P010458,P012780,0 days 00:04:35,2,7,5
152,JOV,P006771,P010161,0 days 00:04:05,-2,6,8
152,JOV,P011248,PJUG,0 days 00:04:05,1,8,7
152,JOV,P010161,P012780,0 days 00:03:51,4,7,3
152,JOV,P010458,PJUG,0 days 00:03:40,0,7,7
152,JOV,P010677,P011248,0 days 00:03:30,1,8,7
152,JOV,P010161,PJUG,0 days 00:03:14,-2,5,7
152,JOV,P011247,P011248,0 days 00:03:10,-1,3,4
152,JOV,P010161,P012349,0 days 00:02:47,2,5,3
152,JOV,P006771,P011248,0 days 00:02:35,-1,3,4
152,JOV,P002507,P012780,0 days 00:02:22,-5,3,8
152,JOV,P002507,P011248,0 days 00:00:40,-2,0,2
152,JOV,P010458,P011248,0 days 00:00:32,0,0,0
152,JOV,P010458,P012349,0 days 00:00:10,2,2,0
152,JOV,P006771,P010708,0 days 00:00:02,0,0,0
152,JOV,P010161,P010708,0 days 00:00:02,0,0,0
152,JOV,P010708,P011247,0 days 00:00:02,0,0,0
152,JOV,P010708,P012349,0 days 00:00:02,0,0,0
153,LLI,P012585,P012797,0 days 00:24:36,22,64,42
153,LLI,P006600,P012797,0 days 00:19:57,2,41,39
153,LLI,P006600,P012585,0 days 00:18:29,4,38,34
153,LLI,P009649,P012797,0 days 00:18:27,0,36,36
153,LLI,P009680,P012797,0 days 00:17:13,-6,28,34
153,LLI,P009649,P009680,0 days 00:16:55,-12,25,37
153,LLI,P006600,P009649,0 days 00:16:52,-1,32,33
153,LLI,P006600,P009680,0 days 00:16:26,-4,28,32
153,LLI,P012020,P012586,0 days 00:15:51,25,47,22
153,LLI,P009649,P012585,0 days 00:15:24,2,31,29
153,LLI,P009680,P012585,0 days 00:14:58,-2,25,27
153,LLI,P005247,P012586,0 days 00:14:18,26,47,21
153,LLI,P004773,P012020,0 days 00:13:15,-1,23,24
153,LLI,P004773,P012586,0 days 00:11:15,4,23,19
153,LLI,P012586,P012797,0 days 00:10:46,29,44,15
153,LLI,P012585,P012586,0 days 00:09:38,24,39,15
153,LLI,P004479,P012586,0 days 00:09:28,6,19,13
153,LLI,P005247,P012020,0 days 00:09:12,20,31,11
153,LLI,P004479,P004773,0 days 00:09:08,-2,14,16
153,LLI,P004479,P012020,0 days 00:08:55,0,14,14
153,LLI,P005247,P012797,0 days 00:08:14,24,34,10
153,LLI,P012020,P012797,0 days 00:08:02,21,31,10
153,LLI,P005247,P012585,0 days 00:07:54,21,31,10
153,LLI,P004479,P005247,0 days 00:07:48,3,16,13
153,LLI,P009649,P012020,0 days 00:07:34,-1,14,15
153,LLI,P009649,P012586,0 days 00:07:31,10,21,11
153,LLI,P004773,P009649,0 days 00:07:16,-7,10,17
153,LLI,P005247,P006600,0 days 00:06:50,7,19,12
153,LLI,P004773,P005247,0 days 00:06:22,3,14,11
153,LLI,P012020,P012585,0 days 00:06:07,18,26,8
153,LLI,P006600,P012586,0 days 00:05:30,7,18,11
153,LLI,P004479,P009649,0 days 00:04:52,1,8,7
153,LLI,P004773,P012797,0 days 00:04:41,0,10,10
153,LLI,P004773,P009680,0 days 00:03:41,-9,3,12
153,LLI,P009680,P012020,0 days 00:02:13,-7,0,7
153,LLI,P004479,P006600,0 days 00:01:59,1,5,4
153,LLI,P005247,P009649,0 days 00:01:46,3,5,2
153,LLI,P005247,P009680,0 days 00:01:44,1,3,2
153,LLI,P004773,P006600,0 days 00:01:41,-4,3,7
153,LLI,P004479,P009680,0 days 00:01:26,-5,0,5
153,LLI,P004773,P012585,0 days 00:01:18,-1,2,3
153,LLI,P004773,P012584,0 days 00:01:07,-3,2,5
153,LLI,P009649,P012584,0 days 00:01:07,-3,2,5
153,LLI,P012020,P012584,0 days 00:01:07,-3,2,5
153,LLI,P012584,P012586,0 days 00:01:07,-3,2,5
153,BES,P008945,P012622,0 days 00:18:04,-4,31,35
153,BES,P008945,P011936,0 days 00:17:58,-11,31,42
153,BES,P011936,P012711,0 days 00:17:27,-18,32,50
153,BES,P008945,P012647,0 days 00:15:35,-1,31,32
153,BES,P007914,P012711,0 days 00:14:50,-10,28,38
153,BES,P011936,P012622,0 days 00:14:25,-2,26,28
153,BES,P011936,P012647,0 days 00:14:19,-8,25,33
153,BES,P011379,P012622,0 days 00:13:48,-8,23,31
153,BES,P008945,P012711,0 days 00:13:00,-9,24,33
153,BES,P012622,P012711,0 days 00:12:52,8,29,21
153,BES,P003783,P011924,0 days 00:12:52,0,24,24
153,BES,P003783,P007914,0 days 00:12:22,-6,20,26
153,BES,P008945,P011379,0 days 00:10:41,-5,16,21
153,BES,P007914,P012647,0 days 00:10:37,-17,16,33
153,BES,P003783,P012711,0 days 00:10:25,0,21,21
153,BES,P012647,P012711,0 days 00:10:18,-13,18,31
153,BES,P012622,P012647,0 days 00:10:15,5,19,14
153,BES,P007914,P011936,0 days 00:09:48,-20,16,36
153,BES,P011924,P012622,0 days 00:09:22,3,21,18
153,BES,P007914,P011924,0 days 00:08:58,4,16,12
153,BES,P011379,P011936,0 days 00:07:51,-3,12,15
153,BES,P007917,P011924,0 days 00:07:45,-8,12,20
153,BES,P007914,P008945,0 days 00:07:43,-9,15,24
153,BES,P003783,P012622,0 days 00:07:02,6,19,13
153,BES,P007917,P008945,0 days 00:07:01,-9,12,21
153,BES,P003783,P011357,0 days 00:06:56,-1,14,15
153,BES,P011379,P011924,0 days 00:06:36,-8,11,19
153,BES,P007914,P012622,0 days 00:06:32,7,16,9
153,BES,P011924,P012711,0 days 00:05:58,9,13,4
153,BES,P003783,P012647,0 days 00:05:44,-13,6,19
153,BES,P007917,P012622,0 days 00:05:40,-8,9,17
153,BES,P007917,P012647,0 days 00:05:01,-2,9,11
153,BES,P011357,P012711,0 days 00:05:01,-1,9,10
153,BES,P007917,P011379,0 days 00:05:00,-12,6,18
153,BES,P008945,P011924,0 days 00:04:45,-3,9,12
153,BES,P007914,P011357,0 days 00:04:32,-2,7,9
153,BES,P011357,P011924,0 days 00:04:28,1,8,7
153,BES,P003783,P011936,0 days 00:04:27,-9,8,17
153,BES,P003783,P007917,0 days 00:04:21,-6,6,12
153,BES,P011924,P012647,0 days 00:04:20,-6,6,12
153,BES,P007914,P007917,0 days 00:04:19,-4,6,10
153,BES,P011379,P012711,0 days 00:03:49,-2,6,8
153,BES,P003783,P011379,0 days 00:03:46,-6,7,13
153,BES,P011379,P012647,0 days 00:03:43,3,6,3
153,BES,P011357,P011936,0 days 00:02:28,-2,6,8
153,BES,P011357,P012622,0 days 00:02:24,1,7,6
153,BES,P011357,P011379,0 days 00:01:55,0,5,5
153,BES,P003783,P008945,0 days 00:01:21,-1,3,4
153,BES,P007917,P011936,0 days 00:00:57,-7,0,7
153,BES,P007914,P011379,0 days 00:00:39,-3,0,3
154,HAM,P012580,P012581,0 days 00:21:16,-30,36,66
154,HAM,P011168,P012581,0 days 00:19:40,-11,38,49
154,HAM,P009663,P012581,0 days 00:17:56,-16,37,53
154,HAM,P009663,P012580,0 days 00:16:39,-25,31,56
154,HAM,P011168,P012580,0 days 00:16:37,-12,32,44
154,HAM,P012580,P012648,0 days 00:15:25,-11,35,46
154,HAM,P009663,P011168,0 days 00:14:01,-11,30,41
154,HAM,P012581,P012648,0 days 00:13:54,-11,27,38
154,HAM,P011187,P012581,0 days 00:12:50,-10,22,32
154,HAM,P009663,P012648,0 days 00:11:48,-9,25,34
154,HAM,P011187,P012580,0 days 00:11:44,-4,27,31
154,HAM,P011168,P012579,0 days 00:10:57,4,31,27
154,HAM,P012581,P012582,0 days 00:10:37,-5,17,22
154,HAM,P011168,P012582,0 days 00:10:37,-5,17,22
154,HAM,P011187,P012648,0 days 00:10:29,-7,23,30
154,HAM,P011187,P012579,0 days 00:10:27,-9,21,30
154,HAM,P001990,P012580,0 days 00:10:08,-13,23,36
154,HAM,P011168,P011187,0 days 00:09:15,3,19,16
154,HAM,P001990,P012648,0 days 00:09:03,-13,20,33
154,HAM,P001990,P011187,0 days 00:08:59,-15,17,32
154,HAM,P012579,P012581,0 days 00:08:54,-6,20,26
154,HAM,P011168,P012648,0 days 00:08:45,1,19,18
154,HAM,P010070,P012648,0 days 00:08:37,-6,20,26
154,HAM,P012579,P012580,0 days 00:08:34,-7,21,28
154,HAM,P009663,P010070,0 days 00:07:47,4,24,20
154,HAM,P012580,P012582,0 days 00:07:12,-9,11,20
154,HAM,P010070,P012581,0 days 00:06:51,0,18,18
154,HAM,P001990,P012581,0 days 00:06:37,-11,12,23
154,HAM,P001990,P010070,0 days 00:06:26,-7,15,22
154,HAM,P009663,P012582,0 days 00:06:07,-11,9,20
154,HAM,P012579,P012648,0 days 00:05:45,-2,14,16
154,HAM,P010070,P012579,0 days 00:05:11,-9,11,20
154,HAM,P009663,P012579,0 days 00:05:01,0,15,15
154,HAM,P010070,P011187,0 days 00:04:42,-12,7,19
154,HAM,P001990,P012579,0 days 00:04:31,-13,5,18
154,HAM,P011187,P012582,0 days 00:04:30,6,8,2
154,HAM,P009663,P012695,0 days 00:04:29,-4,9,13
154,HAM,P012648,P012695,0 days 00:04:29,-4,9,13
154,HAM,P012581,P012695,0 days 00:04:29,-4,9,13
154,HAM,P010070,P012580,0 days 00:04:19,-1,13,14
154,HAM,P001990,P009663,0 days 00:03:16,-4,8,12
154,HAM,P010070,P011168,0 days 00:03:12,-1,10,11
154,HAM,P010070,P012695,0 days 00:02:51,0,6,6
154,HAM,P012579,P012582,0 days 00:02:32,6,6,0
154,HAM,P012580,P012695,0 days 00:01:38,-4,3,7
154,HAM,P012582,P012648,0 days 00:00:53,-2,0,2
154,LJU,P005969,P012700,0 days 00:21:37,31,68,37
154,LJU,P003452,P010594,0 days 00:18:30,18,56,38
154,LJU,P003452,P009395,0 days 00:18:26,21,56,35
154,LJU,P005969,P010594,0 days 00:17:17,23,55,32
154,LJU,P010594,P012700,0 days 00:17:07,22,53,31
154,LJU,P009395,P012700,0 days 00:16:34,22,52,30
154,LJU,P005969,P009395,0 days 00:16:08,19,50,31
154,LJU,P003452,P012700,0 days 00:16:05,25,52,27
154,LJU,P009395,P010594,0 days 00:16:02,15,48,33
154,LJU,P003452,P005969,0 days 00:15:39,22,50,28
154,LJU,P003514,P007066,0 days 00:14:20,7,39,32
154,LJU,P003514,P009392,0 days 00:10:41,2,26,24
154,LJU,P007066,P009392,0 days 00:10:36,7,28,21
154,LJU,P002561,P003514,0 days 00:08:46,8,24,16
154,LJU,P002561,P007066,0 days 00:08:46,8,24,16
154,LJU,P003452,P003514,0 days 00:08:35,10,28,18
154,LJU,P002561,P003452,0 days 00:08:08,11,28,17
154,LJU,P002561,P010594,0 days 00:07:57,-2,20,22
154,LJU,P005969,P009392,0 days 00:07:35,3,21,18
154,LJU,P003514,P005969,0 days 00:07:31,-10,17,27
154,LJU,P009392,P011261,0 days 00:07:10,-3,11,14
154,LJU,P005969,P007066,0 days 00:06:51,3,19,16
154,LJU,P003514,P010594,0 days 00:06:29,-2,17,19
154,LJU,P009392,P012700,0 days 00:06:24,6,19,13
154,LJU,P002561,P009392,0 days 00:06:18,5,16,11
154,LJU,P003452,P007066,0 days 00:06:14,14,24,10
154,LJU,P003452,P009392,0 days 00:06:10,17,24,7
154,LJU,P002561,P011261,0 days 00:06:07,-8,8,16
154,LJU,P007066,P012700,0 days 00:05:40,6,17,11
154,LJU,P010771,P011261,0 days 00:05:28,2,15,13
154,LJU,P007066,P010594,0 days 00:05:01,4,15,11
154,LJU,P007066,P011261,0 days 00:05:00,-5,6,11
154,LJU,P003514,P012700,0 days 00:04:52,-1,13,14
154,LJU,P003514,P011261,0 days 00:04:36,-7,4,11
154,LJU,P005969,P011261,0 days 00:04:21,5,13,8
154,LJU,P010594,P011261,0 days 00:04:11,2,12,10
154,LJU,P010912,P011261,0 days 00:04:11,2,12,10
154,LJU,P010594,P010912,0 days 00:04:11,2,12,10
154,LJU,P010771,P010912,0 days 00:04:11,2,12,10
154,LJU,P010594,P010771,0 days 00:04:11,2,12,10
154,LJU,P002561,P010771,0 days 00:03:35,-2,8,10
154,LJU,P002561,P010912,0 days 00:03:35,-2,8,10
154,LJU,P009392,P009395,0 days 00:02:53,3,8,5
154,LJU,P003514,P009395,0 days 00:02:50,-7,4,11
154,LJU,P011261,P012700,0 days 00:02:34,4,7,3
154,LJU,P002561,P012700,0 days 00:01:54,-3,4,7
154,LJU,P002561,P009395,0 days 00:01:54,-3,4,7
154,LJU,P005969,P010771,0 days 00:01:53,4,7,3
154,LJU,P009392,P010771,0 days 00:01:17,0,3,3
154,LJU,P010771,P012700,0 days 00:01:17,0,3,3
154,LJU,P003452,P011261,0 days 00:00:53,2,2,0
154,LJU,P009395,P011261,0 days 00:00:53,2,2,0
154,LJU,P005969,P010912,0 days 00:00:36,4,4,0
155,VNC,P004381,P012259,0 days 00:26:04,-13,39,52
155,VNC,P004381,P009400,0 days 00:26:01,4,45,41
155,VNC,P003759,P012259,0 days 00:23:37,-4,38,42
155,VNC,P003759,P004381,0 days 00:21:44,5,41,36
155,VNC,P004381,P011928,0 days 00:21:17,-16,30,46
155,VNC,P004117,P004381,0 days 00:19:35,-26,18,44
155,VNC,P008052,P012259,0 days 00:19:14,-9,25,34
155,VNC,P003759,P009400,0 days 00:19:07,14,42,28
155,VNC,P009400,P012259,0 days 00:18:19,2,34,32
155,VNC,P004381,P008052,0 days 00:16:52,-4,22,26
155,VNC,P004117,P012259,0 days 00:16:12,-25,16,41
155,VNC,P011928,P012259,0 days 00:14:19,-16,19,35
155,VNC,P009400,P011928,0 days 00:13:52,-2,23,25
155,VNC,P003759,P008052,0 days 00:12:56,1,19,18
155,VNC,P004117,P008052,0 days 00:12:46,-16,11,27
155,VNC,P004117,P011928,0 days 00:12:04,-22,10,32
155,VNC,P008052,P009400,0 days 00:11:14,5,18,13
155,VNC,P009400,P012587,0 days 00:10:50,-2,15,17
155,VNC,P003759,P011928,0 days 00:10:30,0,21,21
155,VNC,P004117,P009400,0 days 00:10:26,-11,11,22
155,VNC,P004117,P012587,0 days 00:09:55,-11,8,19
155,VNC,P003759,P004117,0 days 00:09:55,-11,10,21
155,VNC,P004381,P012587,0 days 00:09:16,0,13,13
155,VNC,P003759,P012587,0 days 00:07:07,3,13,10
155,VNC,P011928,P012587,0 days 00:06:58,0,11,11
155,VNC,P008052,P012587,0 days 00:06:58,-5,7,12
155,VNC,P008052,P011928,0 days 00:06:08,-8,6,14
155,VNC,P012259,P012587,0 days 00:04:40,-5,5,10
155,VNC,P004117,P012588,0 days 00:00:31,-2,0,2
155,VNC,P004381,P012588,0 days 00:00:31,-2,0,2
155,VNC,P009400,P012588,0 days 00:00:31,-2,0,2
155,VNC,P012259,P012588,0 days 00:00:31,-2,0,2
155,WOL,P002387,P005516,0 days 00:25:16,19,54,35
155,WOL,P005516,P012576,0 days 00:22:09,7,42,35
155,WOL,P002387,P012576,0 days 00:21:04,11,42,31
155,WOL,P005516,P006154,0 days 00:19:53,1,30,29
155,WOL,P005516,P012577,0 days 00:18:57,12,37,25
155,WOL,P005516,P006546,0 days 00:17:37,-1,31,32
155,WOL,P012577,P012789,0 days 00:16:01,11,28,17
155,WOL,P006154,P012577,0 days 00:15:24,7,23,16
155,WOL,P002387,P006154,0 days 00:14:46,1,25,24
155,WOL,P002387,P006546,0 days 00:14:43,3,28,25
155,WOL,P006546,P012576,0 days 00:14:42,2,26,24
155,WOL,P006154,P012576,0 days 00:12:56,-5,19,24
155,WOL,P004645,P012789,0 days 00:12:31,4,19,15
155,WOL,P006154,P012789,0 days 00:12:31,9,20,11
155,WOL,P006154,P006546,0 days 00:12:22,-1,19,20
155,WOL,P004645,P012577,0 days 00:12:17,1,16,15
155,WOL,P005516,P012789,0 days 00:12:02,8,24,16
155,WOL,P002387,P006907,0 days 00:12:01,16,33,17
155,WOL,P005516,P006907,0 days 00:11:55,18,34,16
155,WOL,P002387,P012577,0 days 00:11:41,15,28,13
155,WOL,P004645,P006154,0 days 00:10:41,3,14,11
155,WOL,P006907,P012576,0 days 00:09:28,12,23,11
155,WOL,P004645,P005516,0 days 00:08:55,-4,12,16
155,WOL,P012576,P012577,0 days 00:07:57,5,16,11
155,WOL,P006907,P012577,0 days 00:07:04,13,17,4
155,WOL,P006546,P012789,0 days 00:07:04,-1,13,14
155,WOL,P004645,P006546,0 days 00:07:03,-2,11,13
155,WOL,P006546,P006907,0 days 00:07:02,4,17,13
155,WOL,P006546,P012577,0 days 00:06:31,0,11,11
155,WOL,P006907,P012789,0 days 00:05:10,6,14,8
155,WOL,P002387,P012789,0 days 00:05:05,7,14,7
155,WOL,P006154,P006907,0 days 00:03:15,1,6,5
155,WOL,P004645,P006907,0 days 00:02:37,2,4,2
155,WOL,P004645,P012576,0 days 00:01:20,-4,0,4
156,ARI,P004292,P012716,0 days 00:23:34,-6,36,42
156,ARI,P012708,P012717,0 days 00:21:30,-5,34,39
156,ARI,P004292,P012708,0 days 00:20:03,-2,34,36
156,ARI,P004292,P012717,0 days 00:19:40,-5,27,32
156,ARI,P012702,P012716,0 days 00:18:17,-10,30,40
156,ARI,P004292,P012702,0 days 00:17:18,-11,28,39
156,ARI,P012615,P012792,0 days 00:16:35,-3,30,33
156,ARI,P012716,P012717,0 days 00:16:10,-9,20,29
156,ARI,P012716,P012792,0 days 00:15:40,-1,32,33
156,ARI,P012708,P012716,0 days 00:15:32,-7,24,31
156,ARI,P004292,P012615,0 days 00:15:00,0,31,31
156,ARI,P012615,P012716,0 days 00:14:23,2,25,23
156,ARI,P012702,P012708,0 days 00:14:11,-12,24,36
156,ARI,P012702,P012717,0 days 00:12:59,-13,20,33
156,ARI,P004292,P012760,0 days 00:12:45,10,23,13
156,ARI,P004292,P012792,0 days 00:11:07,1,24,23
156,ARI,P012615,P012760,0 days 00:10:59,-4,19,23
156,ARI,P012708,P012760,0 days 00:10:42,5,19,14
156,ARI,P012702,P012792,0 days 00:10:24,-2,20,22
156,ARI,P012716,P012760,0 days 00:10:23,3,17,14
156,ARI,P012760,P012792,0 days 00:09:09,-3,19,22
156,ARI,P002867,P012760,0 days 00:09:08,1,15,14
156,ARI,P012615,P012702,0 days 00:08:51,0,18,18
156,ARI,P012717,P012760,0 days 00:08:50,8,12,4
156,ARI,P012708,P012792,0 days 00:08:15,-6,16,22
156,ARI,P012615,P012708,0 days 00:07:45,-5,16,21
156,ARI,P002867,P012708,0 days 00:07:38,0,13,13
156,ARI,P002867,P012615,0 days 00:06:17,-6,10,16
156,ARI,P012615,P012717,0 days 00:05:34,-4,7,11
156,ARI,P002867,P012792,0 days 00:05:14,-5,8,13
156,ARI,P002867,P012717,0 days 00:04:57,5,9,4
156,ARI,P002867,P004292,0 days 00:04:57,5,9,4
156,ARI,P012717,P012792,0 days 00:03:40,-1,7,8
156,ARI,P002867,P012716,0 days 00:02:33,0,4,4
156,BOU,P010718,P012617,0 days 00:23:56,5,44,39
156,BOU,P010431,P010718,0 days 00:22:21,8,44,36
156,BOU,P010431,P012617,0 days 00:21:56,8,44,36
156,BOU,P010718,P011836,0 days 00:21:15,7,40,33
156,BOU,P010431,P011836,0 days 00:20:10,4,39,35
156,BOU,P011836,P012617,0 days 00:20:08,5,38,33
156,BOU,P010431,P011837,0 days 00:19:17,6,37,31
156,BOU,P010718,P011837,0 days 00:19:01,2,34,32
156,BOU,P011837,P012617,0 days 00:18:53,2,34,32
156,BOU,P011836,P011837,0 days 00:15:39,1,29,28
156,BOU,P000498,P012628,0 days 00:14:57,1,30,29
156,BOU,P011161,P012618,0 days 00:14:32,5,29,24
156,BOU,P000498,P011161,0 days 00:14:12,2,29,27
156,BOU,P000498,P012618,0 days 00:14:00,5,29,24
156,BOU,P004525,P011161,0 days 00:13:37,-3,27,30
156,BOU,P011161,P012628,0 days 00:13:30,0,27,27
156,BOU,P000498,P004525,0 days 00:13:27,2,29,27
156,BOU,P004525,P012628,0 days 00:13:27,2,29,27
156,BOU,P012618,P012628,0 days 00:13:01,3,27,24
156,BOU,P004525,P012618,0 days 00:11:57,3,27,24
156,BOU,P011836,P012618,0 days 00:07:06,5,12,7
156,BOU,P010718,P012618,0 days 00:06:02,5,12,7
156,BOU,P004525,P011837,0 days 00:05:18,-1,8,9
156,BOU,P012617,P012618,0 days 00:05:03,3,10,7
156,BOU,P010431,P012618,0 days 00:04:31,3,10,7
156,BOU,P004525,P010718,0 days 00:03:48,0,6,6
156,BOU,P004525,P012617,0 days 00:03:48,0,6,6
156,BOU,P004525,P010431,0 days 00:03:38,5,8,3
156,BOU,P010718,P011161,0 days 00:02:42,-1,2,3
156,BOU,P000498,P011836,0 days 00:02:37,1,3,2
156,BOU,P011161,P011836,0 days 00:02:35,2,2,0
156,BOU,P000498,P011837,0 days 00:02:04,-2,3,5
156,BOU,P011161,P012617,0 days 00:02:00,-3,0,3
156,BOU,P011837,P012628,0 days 00:01:56,-2,3,5
156,BOU,P000498,P010431,0 days 00:01:52,1,3,2
156,BOU,P011161,P011837,0 days 00:01:40,-6,0,6
156,BOU,P011836,P012628,0 days 00:01:30,-1,1,2
156,BOU,P010431,P012628,0 days 00:01:27,1,3,2
156,BOU,P000498,P010718,0 days 00:01:07,2,2,0
157,BUD,P008325,P012606,0 days 00:25:44,6,47,41
157,BUD,P002740,P011281,0 days 00:21:03,-6,36,42
157,BUD,P005637,P011281,0 days 00:20:14,8,41,33
157,BUD,P002740,P004945,0 days 00:18:21,-1,32,33
157,BUD,P010248,P011281,0 days 00:18:15,-8,31,39
157,BUD,P002740,P010248,0 days 00:16:52,-3,29,32
157,BUD,P002740,P011935,0 days 00:16:46,-11,28,39
157,BUD,P008325,P012630,0 days 00:16:36,6,32,26
157,BUD,P011281,P012606,0 days 00:16:26,6,35,29
157,BUD,P008325,P011281,0 days 00:16:04,9,35,26
157,BUD,P004945,P011281,0 days 00:15:53,-11,26,37
157,BUD,P012606,P012630,0 days 00:15:35,8,30,22
157,BUD,P011281,P012630,0 days 00:15:30,13,35,22
157,BUD,P008325,P011935,0 days 00:14:21,-6,21,27
157,BUD,P004945,P010248,0 days 00:14:12,-8,24,32
157,BUD,P011281,P011935,0 days 00:13:51,-7,25,32
157,BUD,P004945,P005637,0 days 00:13:41,-2,23,25
157,BUD,P005637,P012606,0 days 00:13:33,5,30,25
157,BUD,P011935,P012606,0 days 00:13:20,-4,19,23
157,BUD,P011935,P012630,0 days 00:13:14,-1,20,21
157,BUD,P002740,P008325,0 days 00:12:31,0,21,21
157,BUD,P002740,P005637,0 days 00:12:23,8,22,14
157,BUD,P005637,P008325,0 days 00:12:10,10,28,18
157,BUD,P002740,P012606,0 days 00:11:30,2,19,17
157,BUD,P005637,P010248,0 days 00:10:28,-3,17,20
157,BUD,P004945,P012606,0 days 00:08:36,-6,14,20
157,BUD,P002740,P012630,0 days 00:08:06,-1,13,14
157,BUD,P010248,P011935,0 days 00:07:47,-5,14,19
157,BUD,P004945,P011935,0 days 00:07:44,-7,13,20
157,BUD,P004945,P008325,0 days 00:07:13,-1,12,13
157,BUD,P005637,P012630,0 days 00:07:11,7,19,12
157,BUD,P010248,P012630,0 days 00:04:03,0,7,7
157,BUD,P008325,P009214,0 days 00:02:21,-8,0,8
157,BUD,P009214,P012606,0 days 00:02:21,-8,0,8
157,BUD,P009214,P012630,0 days 00:02:21,-8,0,8
157,BUD,P009214,P011935,0 days 00:01:29,-3,0,3
157,BUD,P010248,P012606,0 days 00:01:23,-5,2,7
157,BUD,P005637,P009214,0 days 00:00:52,-5,0,5
157,ULM,P012603,P012604,0 days 00:30:55,-5,56,61
157,ULM,P010582,P012603,0 days 00:27:52,3,50,47
157,ULM,P010106,P012603,0 days 00:26:32,0,53,53
157,ULM,P010582,P012604,0 days 00:25:06,-7,38,45
157,ULM,P010106,P012604,0 days 00:24:24,-5,46,51
157,ULM,P005422,P012604,0 days 00:21:46,0,34,34
157,ULM,P010106,P010582,0 days 00:21:27,4,41,37
157,ULM,P005422,P012603,0 days 00:20:12,2,34,32
157,ULM,P005422,P010582,0 days 00:18:49,-8,26,34
157,ULM,P012603,P012703,0 days 00:18:16,3,39,36
157,ULM,P012604,P012703,0 days 00:18:09,-2,34,36
157,ULM,P011457,P012703,0 days 00:17:41,-7,31,38
157,ULM,P005422,P010106,0 days 00:15:28,-3,24,27
157,ULM,P010106,P012703,0 days 00:13:12,-3,28,31
157,ULM,P005422,P012703,0 days 00:13:00,11,24,13
157,ULM,P010582,P012703,0 days 00:12:56,-1,21,22
157,ULM,P010726,P012703,0 days 00:10:31,9,22,13
157,ULM,P007952,P011457,0 days 00:10:23,6,21,15
157,ULM,P007952,P012703,0 days 00:10:23,6,21,15
157,ULM,P007952,P010726,0 days 00:10:21,10,23,13
157,ULM,P010726,P011457,0 days 00:08:44,5,16,11
157,ULM,P011457,P012603,0 days 00:07:25,-8,15,23
157,ULM,P005422,P010726,0 days 00:07:23,12,18,6
157,ULM,P011457,P012604,0 days 00:07:18,-13,10,23
157,ULM,P005422,P011457,0 days 00:07:08,4,12,8
157,ULM,P010106,P011457,0 days 00:07:05,-9,14,23
157,ULM,P005422,P007952,0 days 00:05:34,6,12,6
157,ULM,P007952,P010106,0 days 00:05:16,2,11,9
157,ULM,P010106,P010726,0 days 00:05:16,2,11,9
157,ULM,P010582,P011457,0 days 00:05:00,-6,5,11
157,ULM,P007952,P010582,0 days 00:04:18,6,12,6
157,ULM,P010726,P012603,0 days 00:03:55,9,13,4
157,ULM,P007952,P012603,0 days 00:03:49,8,12,4
157,ULM,P010726,P012604,0 days 00:02:18,4,6,2
157,ULM,P010582,P010726,0 days 00:02:08,5,7,2
158,CLU,P011797,P011801,0 days 00:26:12,21,66,45
158,CLU,P005113,P011797,0 days 00:22:47,0,45,45
158,CLU,P011797,P012621,0 days 00:21:07,-2,41,43
158,CLU,P005113,P011801,0 days 00:19:53,13,43,30
158,CLU,P010569,P011797,0 days 00:19:40,10,45,35
158,CLU,P011797,P012698,0 days 00:19:18,2,47,45
158,CLU,P011801,P012698,0 days 00:19:00,8,51,43
158,CLU,P005714,P012698,0 days 00:18:22,-8,40,48
158,CLU,P011801,P012621,0 days 00:18:21,12,45,33
158,CLU,P005113,P010569,0 days 00:16:39,4,34,30
158,CLU,P005714,P011801,0 days 00:16:25,3,41,38
158,CLU,P010569,P011801,0 days 00:16:15,13,38,25
158,CLU,P010569,P012621,0 days 00:16:01,2,32,30
158,CLU,P005113,P012621,0 days 00:15:12,-9,24,33
158,CLU,P005373,P012698,0 days 00:15:10,0,33,33
158,CLU,P005714,P011797,0 days 00:13:18,0,30,30
158,CLU,P005373,P005714,0 days 00:13:04,-2,28,30
158,CLU,P005373,P011801,0 days 00:12:06,2,32,30
158,CLU,P012621,P012698,0 days 00:12:01,-7,26,33
158,CLU,P005113,P012698,0 days 00:10:29,-4,23,27
158,CLU,P005373,P012621,0 days 00:09:48,9,26,17
158,CLU,P005714,P012621,0 days 00:09:40,-1,22,23
158,CLU,P005373,P011797,0 days 00:09:30,9,26,17
158,CLU,P010569,P012698,0 days 00:07:58,5,20,15
158,CLU,P005113,P005714,0 days 00:06:08,-4,11,15
158,CLU,P005373,P010569,0 days 00:03:28,6,11,5
158,CLU,P005373,P012620,0 days 00:03:02,-8,0,8
158,CLU,P012620,P012698,0 days 00:03:02,-8,0,8
158,CLU,P005714,P012620,0 days 00:02:35,-8,0,8
158,CLU,P011801,P012620,0 days 00:02:28,-8,0,8
158,CLU,P012620,P012621,0 days 00:00:34,0,0,0
158,CLU,P010569,P012620,0 days 00:00:27,0,0,0
158,TRN,P005738,P012597,0 days 00:26:07,-5,55,60
158,TRN,P005059,P005738,0 days 00:22:58,-1,51,52
158,TRN,P005059,P012597,0 days 00:22:58,-1,51,52
158,TRN,P012596,P012597,0 days 00:17:14,-4,28,32
158,TRN,P012595,P012597,0 days 00:17:07,-12,33,45
158,TRN,P005738,P012595,0 days 00:15:55,-5,35,40
158,TRN,P009903,P012593,0 days 00:13:35,-2,31,33
158,TRN,P005738,P012596,0 days 00:13:22,-2,23,25
158,TRN,P005738,P009903,0 days 00:13:18,1,34,33
158,TRN,P005738,P012593,0 days 00:13:02,8,33,25
158,TRN,P009903,P012597,0 days 00:12:51,-4,29,33
158,TRN,P012593,P012597,0 days 00:12:35,3,28,25
158,TRN,P005059,P012593,0 days 00:11:43,5,28,23
158,TRN,P001479,P012594,0 days 00:11:42,-1,23,24
158,TRN,P005059,P009903,0 days 00:11:40,-4,27,31
158,TRN,P005059,P012595,0 days 00:11:27,-4,26,30
158,TRN,P009903,P012595,0 days 00:10:54,0,26,26
158,TRN,P012595,P012596,0 days 00:10:45,-8,15,23
158,TRN,P005059,P012596,0 days 00:10:32,4,21,17
158,TRN,P001479,P006382,0 days 00:09:16,4,20,16
158,TRN,P006382,P012594,0 days 00:09:16,4,20,16
158,TRN,P009903,P012594,0 days 00:08:42,4,23,19
158,TRN,P012594,P012595,0 days 00:08:19,-3,16,19
158,TRN,P001479,P009903,0 days 00:08:15,-1,18,19
158,TRN,P006382,P009903,0 days 00:06:55,6,20,14
158,TRN,P001479,P012595,0 days 00:06:30,-4,9,13
158,TRN,P012593,P012594,0 days 00:05:55,1,17,16
158,TRN,P012594,P012596,0 days 00:05:41,-6,7,13
158,TRN,P001479,P012593,0 days 00:05:28,-4,12,16
158,TRN,P012594,P012597,0 days 00:05:14,-6,7,13
158,TRN,P006382,P012595,0 days 00:05:02,3,8,5
158,TRN,P001479,P012597,0 days 00:04:44,-4,5,9
158,TRN,P006382,P012596,0 days 00:04:39,-5,2,7
158,TRN,P006382,P012597,0 days 00:04:34,-3,4,7
158,TRN,P001479,P012596,0 days 00:04:19,-2,5,7
158,TRN,P012593,P012596,0 days 00:04:12,7,11,4
158,TRN,P006382,P012593,0 days 00:03:49,1,12,11
158,TRN,P012593,P012595,0 days 00:03:41,-3,8,11
158,TRN,P005738,P012594,0 days 00:02:41,-1,7,8
158,TRN,P005738,P006382,0 days 00:02:21,-3,2,5
158,TRN,P005059,P006382,0 days 00:00:34,-3,0,3
158,TRN,P001479,P007828,0 days 00:00:02,0,0,0
158,TRN,P006382,P007828,0 days 00:00:02,0,0,0
158,TRN,P007828,P009903,0 days 00:00:02,0,0,0
158,TRN,P007828,P012594,0 days 00:00:02,0,0,0
159,WRO,P005531,P012601,0 days 00:19:56,-18,33,51
159,WRO,P005531,P009896,0 days 00:18:56,-17,31,48
159,WRO,P009896,P012601,0 days 00:18:00,-17,29,46
159,WRO,P003034,P012736,0 days 00:17:01,0,31,31
159,WRO,P012094,P012699,0 days 00:14:39,-9,30,39
159,WRO,P005531,P012699,0 days 00:14:29,-10,26,36
159,WRO,P003034,P011900,0 days 00:14:20,-12,22,34
159,WRO,P011900,P012736,0 days 00:12:33,-5,20,25
159,WRO,P003034,P012699,0 days 00:11:44,-3,22,25
159,WRO,P005531,P012094,0 days 00:11:15,-8,23,31
159,WRO,P011901,P012601,0 days 00:11:14,-9,15,24
159,WRO,P012601,P012699,0 days 00:11:08,-7,21,28
159,WRO,P009896,P012094,0 days 00:11:05,-10,21,31
159,WRO,P003034,P011901,0 days 00:11:02,-3,17,20
159,WRO,P011900,P012094,0 days 00:10:50,-7,21,28
159,WRO,P012094,P012736,0 days 00:10:42,-9,19,28
159,WRO,P005531,P011901,0 days 00:10:19,-13,13,26
159,WRO,P011900,P012699,0 days 00:10:04,-5,18,23
159,WRO,P003034,P012094,0 days 00:09:56,-7,19,26
159,WRO,P011901,P012736,0 days 00:09:46,-1,16,17
159,WRO,P011900,P011901,0 days 00:09:46,-10,9,19
159,WRO,P012094,P012601,0 days 00:09:33,-8,19,27
159,WRO,P009896,P012699,0 days 00:09:28,-9,17,26
159,WRO,P005531,P011900,0 days 00:09:23,-6,14,20
159,WRO,P012699,P012736,0 days 00:09:22,-2,17,19
159,WRO,P011900,P012601,0 days 00:07:42,-3,11,14
159,WRO,P009896,P011901,0 days 00:07:38,-8,9,17
159,WRO,P011902,P012736,0 days 00:06:00,3,13,10
159,WRO,P009896,P011900,0 days 00:05:46,0,9,9
159,WRO,P003034,P005531,0 days 00:05:17,-4,9,13
159,WRO,P012308,P012736,0 days 00:05:04,3,11,8
159,WRO,P011902,P012308,0 days 00:05:04,3,11,8
159,WRO,P011901,P012308,0 days 00:05:01,1,9,8
159,WRO,P005531,P012736,0 days 00:05:00,-3,9,12
159,WRO,P003034,P012308,0 days 00:04:28,5,11,6
159,WRO,P003034,P011902,0 days 00:04:28,5,11,6
159,WRO,P011901,P012699,0 days 00:03:54,-3,5,8
159,WRO,P012601,P012736,0 days 00:03:54,-4,6,10
159,WRO,P009896,P012736,0 days 00:03:46,-6,6,12
159,WRO,P011901,P011902,0 days 00:03:40,6,9,3
159,WRO,P003034,P012601,0 days 00:03:36,-1,6,7
159,WRO,P011901,P012094,0 days 00:02:20,-4,2,6
159,WRO,P011902,P012094,0 days 00:02:20,-3,4,7
159,WRO,P009896,P012308,0 days 00:01:57,-7,0,7
159,WRO,P009896,P011902,0 days 00:01:32,-2,2,4
159,WRO,P012094,P012308,0 days 00:01:24,-3,2,5
159,WRO,P005531,P012308,0 days 00:01:21,-5,0,5
159,WRO,P012308,P012601,0 days 00:01:21,-5,0,5
159,WRO,P005531,P011902,0 days 00:00:56,0,2,2
159,CAN,P004160,P004466,0 days 00:15:57,0,31,31
159,CAN,P003425,P003637,0 days 00:15:38,12,41,29
159,CAN,P001607,P004160,0 days 00:14:57,11,33,22
159,CAN,P004160,P007644,0 days 00:12:09,3,24,21
159,CAN,P004160,P010452,0 days 00:11:54,0,23,23
159,CAN,P005005,P010385,0 days 00:10:56,13,31,18
159,CAN,P003425,P006588,0 days 00:10:38,11,32,21
159,CAN,P004160,P009864,0 days 00:10:20,9,27,18
159,CAN,P003637,P010385,0 days 00:10:04,8,25,17
159,CAN,P004466,P007644,0 days 00:10:00,-3,17,20
159,CAN,P003425,P005005,0 days 00:09:53,11,30,19
159,CAN,P001607,P010385,0 days 00:09:27,8,18,10
159,CAN,P003425,P010385,0 days 00:09:23,8,25,17
159,CAN,P003637,P005005,0 days 00:09:18,8,26,18
159,CAN,P004466,P009864,0 days 00:09:04,6,23,17
159,CAN,P005005,P006588,0 days 00:09:02,13,30,17
159,CAN,P004160,P010385,0 days 00:08:46,8,18,10
159,CAN,P007560,P007644,0 days 00:08:46,0,15,15
159,CAN,P003637,P006588,0 days 00:08:36,10,28,18
159,CAN,P001607,P004466,0 days 00:08:29,2,17,15
159,CAN,P003425,P009864,0 days 00:08:17,5,20,15
159,CAN,P007644,P010385,0 days 00:08:09,8,16,8
159,CAN,P001607,P010452,0 days 00:08:00,5,17,12
159,CAN,P004466,P010452,0 days 00:07:35,-3,14,17
159,CAN,P004160,P005005,0 days 00:07:28,14,23,9
159,CAN,P007560,P010452,0 days 00:07:20,-6,9,15
159,CAN,P006588,P009864,0 days 00:07:08,9,20,11
159,CAN,P001607,P007644,0 days 00:07:05,6,16,10
159,CAN,P003637,P007560,0 days 00:07:01,4,15,11
159,CAN,P003425,P007560,0 days 00:07:01,4,15,11
159,CAN,P004160,P007560,0 days 00:06:58,-2,11,13
159,CAN,P003637,P009864,0 days 00:06:15,4,16,12
159,CAN,P001607,P009864,0 days 00:06:11,3,15,12
159,CAN,P005005,P009864,0 days 00:05:50,9,18,9
159,CAN,P006588,P010385,0 days 00:05:41,5,18,13
159,CAN,P007560,P010385,0 days 00:05:36,4,10,6
159,CAN,P009864,P010452,0 days 00:05:17,1,12,11
159,CAN,P001607,P005005,0 days 00:05:15,8,13,5
159,CAN,P004466,P007560,0 days 00:05:04,-3,8,11
159,CAN,P010385,P010452,0 days 00:05:00,3,9,6
159,CAN,P003637,P007644,0 days 00:04:45,3,9,6
159,CAN,P003425,P007644,0 days 00:04:45,3,9,6
159,CAN,P007644,P010452,0 days 00:04:35,-5,6,11
159,CAN,P005005,P010452,0 days 00:04:32,3,10,7
159,CAN,P004160,P006588,0 days 00:04:13,4,10,6
159,CAN,P007644,P009864,0 days 00:04:10,3,11,8
159,CAN,P007560,P009864,0 days 00:03:48,3,10,7
159,CAN,P005005,P007644,0 days 00:03:12,6,9,3
159,CAN,P003637,P010452,0 days 00:02:58,-1,4,5
159,CAN,P004466,P006588,0 days 00:02:57,1,6,5
159,CAN,P006588,P007560,0 days 00:02:28,3,8,5
159,CAN,P004466,P010385,0 days 00:02:18,-1,2,3
159,CAN,P003425,P010452,0 days 00:02:17,-1,4,5
159,CAN,P003425,P004160,0 days 00:02:02,1,4,3
159,CAN,P001607,P007560,0 days 00:01:54,1,3,2
159,CAN,P004466,P005005,0 days 00:01:38,3,6,3
159,CAN,P003425,P004466,0 days 00:00:46,-2,0,2
159,CAN,P001607,P003637,0 days 00:00:41,0,0,0
159,CAN,P001607,P006588,0 days 00:00:33,0,0,0
160,TTK,P006883,P011925,0 days 00:29:59,27,74,47
160,TTK,P006693,P011925,0 days 00:29:46,12,67,55
160,TTK,P006883,P011834,0 days 00:26:23,20,61,41
160,TTK,P006693,P006883,0 days 00:25:39,20,65,45
160,TTK,P011834,P011925,0 days 00:23:44,17,54,37
160,TTK,P005000,P011925,0 days 00:22:59,17,58,41
160,TTK,P006693,P011834,0 days 00:21:38,14,52,38
160,TTK,P005000,P006883,0 days 00:21:37,17,58,41
160,TTK,P004801,P006883,0 days 00:18:48,8,37,29
160,TTK,P005000,P006693,0 days 00:18:39,10,49,39
160,TTK,P004801,P011925,0 days 00:17:59,2,30,28
160,TTK,P004801,P006693,0 days 00:17:53,-3,28,31
160,TTK,P004801,P011834,0 days 00:16:13,-2,27,29
160,TTK,P005000,P011834,0 days 00:14:15,13,38,25
160,TTK,P010477,P011925,0 days 00:11:57,3,27,24
160,TTK,P005000,P010477,0 days 00:11:09,3,24,21
160,TTK,P004801,P005000,0 days 00:09:18,-2,17,19
160,TTK,P005000,P009845,0 days 00:09:00,-1,16,17
160,TTK,P006883,P010477,0 days 00:08:39,3,20,17
160,TTK,P009845,P011925,0 days 00:08:29,-5,14,19
160,TTK,P006693,P010477,0 days 00:07:46,0,20,20
160,TTK,P004801,P009845,0 days 00:06:49,-7,9,16
160,TTK,P006693,P009845,0 days 00:06:15,-9,7,16
160,TTK,P010477,P011834,0 days 00:04:59,3,10,7
160,TTK,P006883,P009845,0 days 00:03:52,2,9,7
160,TTK,P009845,P010477,0 days 00:03:18,0,7,7
160,TTK,P009845,P011834,0 days 00:02:45,-8,2,10
160,TTK,P005000,P011272,0 days 00:00:03,-1,0,1
160,TTK,P006883,P011272,0 days 00:00:03,-1,0,1
160,TTK,P011272,P011834,0 days 00:00:03,-1,0,1
160,TTK,P011272,P011925,0 days 00:00:03,-1,0,1
160,LKB,P007029,PLXI,0 days 00:28:24,-17,46,63
160,LKB,P004868,P007029,0 days 00:26:51,-3,48,51
160,LKB,P007029,P010461,0 days 00:24:56,-8,43,51
160,LKB,P010461,PLXI,0 days 00:24:11,-9,41,50
160,LKB,P004868,PLXI,0 days 00:23:22,0,45,45
160,LKB,P007029,P009898,0 days 00:22:32,-6,43,49
160,LKB,P009898,PLXI,0 days 00:22:27,-11,41,52
160,LKB,P004868,P010461,0 days 00:20:42,5,39,34
160,LKB,P004868,P009898,0 days 00:18:21,4,38,34
160,LKB,P009898,P010461,0 days 00:17:42,-3,33,36
160,LKB,P005521,PLXI,0 days 00:13:15,-12,26,38
160,LKB,P005521,P007029,0 days 00:12:04,-15,21,36
160,LKB,P007029,P010190,0 days 00:11:05,-4,18,22
160,LKB,P005521,P009898,0 days 00:10:29,-10,20,30
160,LKB,P006230,P007029,0 days 00:10:10,-8,18,26
160,LKB,P004868,P010190,0 days 00:10:02,-4,15,19
160,LKB,P006230,P009898,0 days 00:09:35,-4,20,24
160,LKB,P005521,P010461,0 days 00:09:18,-8,17,25
160,LKB,P006230,PLXI,0 days 00:09:07,-7,17,24
160,LKB,P004868,P005521,0 days 00:08:21,-2,17,19
160,LKB,P004868,P006230,0 days 00:08:20,-6,16,22
160,LKB,P005521,P006230,0 days 00:07:40,-6,16,22
160,LKB,P010190,P010461,0 days 00:06:35,0,11,11
160,LKB,P010190,PLXI,0 days 00:06:14,-4,7,11
160,LKB,P006901,PLXI,0 days 00:06:12,-4,9,13
160,LKB,P006901,P009898,0 days 00:05:03,-1,9,10
160,LKB,P005521,P006901,0 days 00:04:53,0,12,12
160,LKB,P006230,P010190,0 days 00:04:30,-4,7,11
160,LKB,P006901,P007029,0 days 00:04:22,-3,7,10
160,LKB,P006230,P006901,0 days 00:04:02,-1,10,11
160,LKB,P006901,P010461,0 days 00:03:12,-1,4,5
160,LKB,P009898,P010190,0 days 00:02:59,3,8,5
160,LKB,P005521,P010190,0 days 00:01:52,-3,3,6
160,LKB,P006901,P010190,0 days 00:01:03,0,3,3
160,LKB,P004868,P006901,0 days 00:00:09,2,2,0
161,VNC,P003759,P004381,0 days 00:19:36,-13,40,53
161,VNC,P004381,P009400,0 days 00:18:22,-5,39,44
161,VNC,P008052,P012259,0 days 00:17:48,18,60,42
161,VNC,P003759,P009400,0 days 00:16:42,-5,34,39
161,VNC,P003759,P004117,0 days 00:15:12,2,33,31
161,VNC,P011928,P012591,0 days 00:14:20,18,47,29
161,VNC,P008052,P012591,0 days 00:12:35,22,48,26
161,VNC,P008052,P011928,0 days 00:12:31,23,46,23
161,VNC,P000968,P008052,0 days 00:12:29,18,45,27
161,VNC,P003759,P012259,0 days 00:12:25,8,36,28
161,VNC,P000968,P012259,0 days 00:12:20,19,42,23
161,VNC,P003759,P012591,0 days 00:12:15,-5,25,30
161,VNC,P004117,P012259,0 days 00:12:11,4,28,24
161,VNC,P004381,P012591,0 days 00:12:03,-3,26,29
161,VNC,P004381,P008052,0 days 00:11:31,4,35,31
161,VNC,P003759,P008052,0 days 00:11:29,-1,34,35
161,VNC,P011928,P012259,0 days 00:11:29,15,38,23
161,VNC,P004381,P012259,0 days 00:11:05,2,30,28
161,VNC,P009400,P012591,0 days 00:10:48,3,26,23
161,VNC,P000968,P004117,0 days 00:09:37,0,23,23
161,VNC,P000968,P011928,0 days 00:09:29,14,33,19
161,VNC,P012259,P012591,0 days 00:09:22,21,35,14
161,VNC,P004117,P009400,0 days 00:09:10,2,18,16
161,VNC,P004381,P011928,0 days 00:09:08,0,22,22
161,VNC,P004117,P004381,0 days 00:09:05,-7,13,20
161,VNC,P000968,P012591,0 days 00:09:04,17,34,17
161,VNC,P004117,P008052,0 days 00:08:38,-4,20,24
161,VNC,P004117,P012591,0 days 00:07:51,0,16,16
161,VNC,P009400,P011928,0 days 00:07:08,-1,17,18
161,VNC,P004381,P012587,0 days 00:06:14,-4,15,19
161,VNC,P009400,P012259,0 days 00:05:56,4,16,12
161,VNC,P003759,P012587,0 days 00:05:55,0,16,16
161,VNC,P008052,P009400,0 days 00:05:30,6,19,13
161,VNC,P000968,P003759,0 days 00:05:01,4,15,11
161,VNC,P004117,P011928,0 days 00:04:37,-4,8,12
161,VNC,P003759,P011928,0 days 00:04:21,-6,7,13
161,VNC,P009400,P012587,0 days 00:03:52,-2,7,9
161,VNC,P008052,P012587,0 days 00:03:29,2,13,11
161,VNC,P012259,P012587,0 days 00:03:00,1,11,10
161,VNC,P004117,P012587,0 days 00:02:55,-1,5,6
161,VNC,P011928,P012587,0 days 00:00:57,-1,2,3
161,VNC,P012587,P012591,0 days 00:00:38,3,3,0
161,VNC,P004381,P012290,0 days 00:00:28,-2,0,2
161,VNC,P009400,P012290,0 days 00:00:28,-2,0,2
161,VNC,P011928,P012290,0 days 00:00:28,-2,0,2
161,VNC,P012290,P012587,0 days 00:00:28,-2,0,2
161,PMT,P005301,P011944,0 days 00:15:27,1,35,34
161,PMT,P002644,P005301,0 days 00:14:10,0,31,31
161,PMT,P011823,P011942,0 days 00:14:01,-2,32,34
161,PMT,P011823,P011944,0 days 00:14:00,3,32,29
161,PMT,P002644,P011966,0 days 00:12:56,-6,36,42
161,PMT,P005301,P011823,0 days 00:11:43,-3,29,32
161,PMT,P011942,P011944,0 days 00:10:55,2,25,23
161,PMT,P001686,P011966,0 days 00:10:33,-10,25,35
161,PMT,P005301,P011942,0 days 00:10:33,-1,27,28
161,PMT,P002644,P012600,0 days 00:10:14,-7,26,33
161,PMT,P010549,P011943,0 days 00:09:47,-2,21,23
161,PMT,P002020,P011944,0 days 00:09:42,13,29,16
161,PMT,P001686,P011823,0 days 00:09:35,-15,14,29
161,PMT,P001686,P002644,0 days 00:09:28,-13,23,36
161,PMT,P011966,P012600,0 days 00:09:08,-7,22,29
161,PMT,P002020,P011823,0 days 00:09:04,8,26,18
161,PMT,P001686,P011942,0 days 00:09:03,-18,17,35
161,PMT,P005301,P011943,0 days 00:08:21,-2,18,20
161,PMT,P001686,P011944,0 days 00:08:19,-14,12,26
161,PMT,P005301,P010549,0 days 00:07:58,0,18,18
161,PMT,P002644,P011942,0 days 00:07:41,-15,17,32
161,PMT,P011942,P011966,0 days 00:07:40,-12,18,30
161,PMT,P001686,P005301,0 days 00:07:39,-10,14,24
161,PMT,P001686,P011947,0 days 00:07:36,-8,18,26
161,PMT,P002644,P011944,0 days 00:07:36,-5,12,17
161,PMT,P001686,P012600,0 days 00:07:35,-10,17,27
161,PMT,P002644,P010549,0 days 00:07:24,-5,12,17
161,PMT,P002020,P005301,0 days 00:07:22,9,23,14
161,PMT,P011947,P011966,0 days 00:07:10,-2,20,22
161,PMT,P005301,P011966,0 days 00:07:07,1,19,18
161,PMT,P002020,P011942,0 days 00:07:04,10,22,12
161,PMT,P005301,P012600,0 days 00:06:28,2,19,17
161,PMT,P002644,P011943,0 days 00:06:27,0,12,12
161,PMT,P011823,P011947,0 days 00:06:15,-3,13,16
161,PMT,P002644,P011947,0 days 00:05:45,1,17,16
161,PMT,P011947,P012600,0 days 00:05:30,2,13,11
161,PMT,P010549,P011942,0 days 00:04:51,-8,9,17
161,PMT,P011944,P011947,0 days 00:04:50,0,10,10
161,PMT,P011942,P011943,0 days 00:04:17,-5,9,14
161,PMT,P011823,P011966,0 days 00:04:03,-5,6,11
161,PMT,P011942,P011947,0 days 00:04:00,0,13,13
161,PMT,P010549,P011944,0 days 00:03:48,-3,4,7
161,PMT,P011823,P011943,0 days 00:03:43,-4,9,13
161,PMT,P002020,P011947,0 days 00:03:34,3,9,6
161,PMT,P011944,P012600,0 days 00:03:31,1,10,9
161,PMT,P005301,P011947,0 days 00:03:20,-1,7,8
161,PMT,P010549,P011823,0 days 00:03:20,-2,9,11
161,PMT,P011942,P012600,0 days 00:03:19,-11,7,18
161,PMT,P011943,P011966,0 days 00:03:02,-1,8,9
161,PMT,P010549,P011966,0 days 00:03:02,-1,8,9
161,PMT,P011943,P011944,0 days 00:02:51,2,4,2
161,PMT,P001686,P010549,0 days 00:02:46,-7,3,10
161,PMT,P002020,P012600,0 days 00:02:26,5,8,3
161,PMT,P011823,P012600,0 days 00:02:25,1,6,5
161,PMT,P001686,P011943,0 days 00:02:12,-4,3,7
161,PMT,P011944,P011966,0 days 00:02:01,0,3,3
161,PMT,P002020,P002644,0 days 00:01:52,4,6,2
161,PMT,P001686,P002020,0 days 00:01:26,-3,2,5
161,PMT,P002020,P011966,0 days 00:01:14,-1,3,4
161,PMT,P002644,P011823,0 days 00:00:51,-2,0,2
162,WOL,P004645,P006546,0 days 00:21:46,6,52,46
162,WOL,P005516,P006546,0 days 00:19:09,8,46,38
162,WOL,P006546,P012576,0 days 00:18:43,-4,40,44
162,WOL,P006546,P012577,0 days 00:18:42,19,56,37
162,WOL,P004645,P012576,0 days 00:17:25,-1,38,39
162,WOL,P004645,P012577,0 days 00:16:10,20,51,31
162,WOL,P003212,P012577,0 days 00:15:11,-3,34,37
162,WOL,P002387,P012789,0 days 00:14:54,6,33,27
162,WOL,P004645,P005516,0 days 00:14:24,13,37,24
162,WOL,P005516,P012576,0 days 00:14:14,7,34,27
162,WOL,P012576,P012577,0 days 00:14:00,9,39,30
162,WOL,P002387,P006154,0 days 00:13:33,7,33,26
162,WOL,P012577,P012789,0 days 00:13:15,15,36,21
162,WOL,P005516,P006154,0 days 00:12:58,-5,21,26
162,WOL,P006154,P012789,0 days 00:12:13,10,30,20
162,WOL,P005516,P012577,0 days 00:12:11,26,43,17
162,WOL,P002387,P012577,0 days 00:11:12,3,26,23
162,WOL,P005516,P012789,0 days 00:10:15,7,25,18
162,WOL,P002387,P005516,0 days 00:10:05,1,22,21
162,WOL,P003212,P012789,0 days 00:09:21,8,24,16
162,WOL,P006546,P012789,0 days 00:09:04,6,24,18
162,WOL,P003212,P006546,0 days 00:08:38,-6,18,24
162,WOL,P006154,P012577,0 days 00:08:28,6,21,15
162,WOL,P003212,P004645,0 days 00:08:03,-6,18,24
162,WOL,P006154,P006546,0 days 00:07:50,-13,8,21
162,WOL,P002387,P003212,0 days 00:07:48,1,18,17
162,WOL,P006154,P012576,0 days 00:07:11,-11,5,16
162,WOL,P003212,P006154,0 days 00:06:53,2,17,15
162,WOL,P004645,P006154,0 days 00:06:38,-11,6,17
162,WOL,P002387,P006546,0 days 00:06:01,-4,12,16
162,WOL,P003212,P012576,0 days 00:05:43,-10,8,18
162,WOL,P002387,P006907,0 days 00:05:07,-3,11,14
162,WOL,P004645,P012789,0 days 00:04:42,9,16,7
162,WOL,P005516,P006907,0 days 00:04:40,-1,8,9
162,WOL,P006907,P012789,0 days 00:04:40,-1,8,9
162,WOL,P006154,P006907,0 days 00:03:40,3,11,8
162,WOL,P002387,P012576,0 days 00:02:32,-2,4,6
162,WOL,P006546,P006907,0 days 00:01:15,-4,0,4
162,WOL,P003212,P006907,0 days 00:00:27,-2,3,5
162,WOL,P002387,P004645,0 days 00:00:20,-1,1,2
162,WOL,P004645,P006907,0 days 00:00:20,-1,1,2
162,WOL,P006907,P012577,0 days 00:00:19,-3,2,5
162,HAM,P011168,P012581,0 days 00:25:34,-4,54,58
162,HAM,P009663,P012581,0 days 00:20:23,2,46,44
162,HAM,P009663,P011168,0 days 00:19:06,-1,36,37
162,HAM,P010070,P012581,0 days 00:18:53,2,41,39
162,HAM,P011168,P012580,0 days 00:18:40,8,43,35
162,HAM,P010070,P011168,0 days 00:17:17,8,38,30
162,HAM,P012580,P012581,0 days 00:17:13,10,42,32
162,HAM,P011168,P012579,0 days 00:15:10,-11,29,40
162,HAM,P009663,P010070,0 days 00:14:48,0,30,30
162,HAM,P012579,P012580,0 days 00:14:23,1,30,29
162,HAM,P012580,P012582,0 days 00:13:35,-10,25,35
162,HAM,P012579,P012581,0 days 00:13:02,-8,26,34
162,HAM,P012579,P012582,0 days 00:12:59,-8,24,32
162,HAM,P009663,P012580,0 days 00:12:17,8,29,21
162,HAM,P011168,P012582,0 days 00:11:43,-13,25,38
162,HAM,P011187,P012582,0 days 00:11:30,-13,19,32
162,HAM,P010070,P012580,0 days 00:11:03,20,29,9
162,HAM,P012581,P012582,0 days 00:10:03,-10,21,31
162,HAM,P011187,P012579,0 days 00:09:57,-6,17,23
162,HAM,P011187,P012580,0 days 00:09:27,-1,17,18
162,HAM,P010070,P012579,0 days 00:08:40,-1,19,20
162,HAM,P012580,P012695,0 days 00:08:00,1,16,15
162,HAM,P011168,P011187,0 days 00:07:29,-8,18,26
162,HAM,P012581,P012648,0 days 00:07:16,-10,17,27
162,HAM,P009663,P012579,0 days 00:07:11,-5,13,18
162,HAM,P012579,P012695,0 days 00:06:54,2,14,12
162,HAM,P011187,P012695,0 days 00:06:47,-6,7,13
162,HAM,P012582,P012695,0 days 00:06:34,-1,10,11
162,HAM,P012581,P012695,0 days 00:04:59,-5,13,18
162,HAM,P011168,P012648,0 days 00:04:53,-3,13,16
162,HAM,P011187,P012581,0 days 00:04:49,-13,8,21
162,HAM,P011187,P012648,0 days 00:04:19,-8,8,16
162,HAM,P009663,P012582,0 days 00:03:58,3,11,8
162,HAM,P009663,P012648,0 days 00:03:22,-2,9,11
162,HAM,P010070,P012648,0 days 00:03:18,-5,7,12
162,HAM,P012648,P012695,0 days 00:02:48,-7,4,11
162,HAM,P012582,P012648,0 days 00:02:46,-4,5,9
162,HAM,P010070,P012695,0 days 00:02:24,-3,6,9
162,HAM,P010070,P011187,0 days 00:02:21,-1,6,7
162,HAM,P012580,P012648,0 days 00:02:02,-1,5,6
162,HAM,P009663,P012695,0 days 00:01:42,3,10,7
162,HAM,P009663,P011187,0 days 00:00:25,0,0,0
163,LJU,P003452,P009395,0 days 00:29:04,4,68,64
163,LJU,P005969,P009395,0 days 00:26:33,-4,60,64
163,LJU,P003452,P005969,0 days 00:25:26,2,58,56
163,LJU,P005969,P012700,0 days 00:24:56,-3,55,58
163,LJU,P009395,P012700,0 days 00:24:03,-4,55,59
163,LJU,P003452,P012700,0 days 00:20:45,0,48,48
163,LJU,P010594,P012700,0 days 00:17:20,7,38,31
163,LJU,P009395,P010594,0 days 00:16:15,9,38,29
163,LJU,P005969,P010594,0 days 00:15:22,5,33,28
163,LJU,P003452,P010594,0 days 00:13:18,11,31,20
163,LJU,P007066,P012700,0 days 00:12:37,-14,19,33
163,LJU,P005969,P007066,0 days 00:12:07,-3,22,25
163,LJU,P003452,P007066,0 days 00:11:27,-9,21,30
163,LJU,P007066,P009395,0 days 00:10:54,-7,21,28
163,LJU,P003514,P007066,0 days 00:08:29,-7,15,22
163,LJU,P002561,P003514,0 days 00:07:53,-8,15,23
163,LJU,P009395,P011261,0 days 00:07:07,2,20,18
163,LJU,P002561,P007066,0 days 00:06:25,-11,9,20
163,LJU,P003514,P009392,0 days 00:06:23,-6,13,19
163,LJU,P005969,P011261,0 days 00:06:14,-2,15,17
163,LJU,P002561,P012700,0 days 00:06:12,-6,10,16
163,LJU,P003514,P012700,0 days 00:05:49,-5,10,15
163,LJU,P002561,P009395,0 days 00:05:49,4,15,11
163,LJU,P003452,P003514,0 days 00:05:39,-2,13,15
163,LJU,P011261,P012700,0 days 00:05:31,-4,13,17
163,LJU,P009392,P012700,0 days 00:05:28,-10,7,17
163,LJU,P003514,P009395,0 days 00:05:27,-2,13,15
163,LJU,P010594,P011261,0 days 00:04:53,-4,7,11
163,LJU,P007066,P011261,0 days 00:04:31,2,7,5
163,LJU,P009392,P009395,0 days 00:04:16,-2,10,12
163,LJU,P002561,P003452,0 days 00:04:11,0,10,10
163,LJU,P003452,P011261,0 days 00:04:10,4,13,9
163,LJU,P002561,P009392,0 days 00:03:57,-5,9,14
163,LJU,P005969,P009392,0 days 00:03:56,-3,6,9
163,LJU,P003452,P009392,0 days 00:03:55,0,10,10
163,LJU,P007066,P009392,0 days 00:03:37,-6,5,11
163,LJU,P003514,P005969,0 days 00:03:35,1,8,7
163,LJU,P002561,P011261,0 days 00:02:30,2,5,3
163,LJU,P002561,P010594,0 days 00:02:30,2,5,3
163,LJU,P007066,P010771,0 days 00:02:24,1,5,4
163,LJU,P003514,P010771,0 days 00:02:24,1,5,4
163,LJU,P002561,P010771,0 days 00:02:05,-2,2,4
163,LJU,P010771,P012700,0 days 00:01:51,3,5,2
163,LJU,P007066,P010594,0 days 00:01:37,-2,0,2
163,LJU,P003452,P010771,0 days 00:00:33,-2,0,2
163,LJU,P005969,P010771,0 days 00:00:19,3,3,0
163,LJU,P003514,P010594,0 days 00:00:13,0,0,0
163,LLI,P006600,P012585,0 days 00:25:35,1,56,55
163,LLI,P009680,P012585,0 days 00:20:01,10,57,47
163,LLI,P009649,P012585,0 days 00:19:47,-16,29,45
163,LLI,P006600,P009649,0 days 00:19:27,-16,29,45
163,LLI,P012585,P012797,0 days 00:17:26,-7,39,46
163,LLI,P006600,P012797,0 days 00:16:29,-8,36,44
163,LLI,P009680,P012797,0 days 00:16:15,-4,38,42
163,LLI,P006600,P009680,0 days 00:16:06,8,45,37
163,LLI,P012585,P012586,0 days 00:14:45,0,27,27
163,LLI,P004773,P009680,0 days 00:14:36,16,45,29
163,LLI,P004773,P012020,0 days 00:14:25,6,36,30
163,LLI,P009649,P012586,0 days 00:13:56,-6,20,26
163,LLI,P004773,P012585,0 days 00:13:43,28,53,25
163,LLI,P009649,P012797,0 days 00:13:08,-17,19,36
163,LLI,P004479,P004773,0 days 00:12:30,10,32,22
163,LLI,P004479,P012020,0 days 00:11:40,8,30,22
163,LLI,P009649,P009680,0 days 00:11:11,-7,22,29
163,LLI,P006600,P012586,0 days 00:10:28,-5,13,18
163,LLI,P009680,P012020,0 days 00:08:28,-1,18,19
163,LLI,P004773,P012586,0 days 00:08:16,5,24,19
163,LLI,P004773,P012797,0 days 00:07:38,5,22,17
163,LLI,P012020,P012586,0 days 00:07:25,4,21,17
163,LLI,P004479,P009680,0 days 00:07:15,1,14,13
163,LLI,P004773,P006600,0 days 00:06:59,18,30,12
163,LLI,P012020,P012585,0 days 00:06:44,10,23,13
163,LLI,P008274,P012585,0 days 00:06:04,6,13,7
163,LLI,P006600,P008274,0 days 00:06:04,6,13,7
163,LLI,P004479,P012586,0 days 00:05:37,7,18,11
163,LLI,P004773,P009649,0 days 00:05:32,2,14,12
163,LLI,P004479,P012585,0 days 00:05:11,12,19,7
163,LLI,P004479,P009649,0 days 00:04:43,-1,11,12
163,LLI,P009649,P012020,0 days 00:04:41,1,11,10
163,LLI,P012586,P012797,0 days 00:04:31,-8,3,11
163,LLI,P012020,P012797,0 days 00:04:17,-4,5,9
163,LLI,P008274,P012586,0 days 00:04:07,0,5,5
163,LLI,P008274,P009649,0 days 00:04:07,0,5,5
163,LLI,P004479,P012797,0 days 00:03:20,-5,2,7
163,LLI,P009680,P012586,0 days 00:02:27,-1,5,6
163,LLI,P004773,P008274,0 days 00:01:57,6,8,2
163,LLI,P008274,P009680,0 days 00:01:57,6,8,2
163,LLI,P004479,P006600,0 days 00:01:12,0,2,2
164,BES,P011936,P012647,0 days 00:25:54,-1,54,55
164,BES,P011936,P012622,0 days 00:24:02,1,52,51
164,BES,P008945,P012647,0 days 00:23:55,1,48,47
164,BES,P008945,P011936,0 days 00:22:18,1,47,46
164,BES,P012622,P012647,0 days 00:21:49,-1,47,48
164,BES,P008945,P012622,0 days 00:19:41,-1,41,42
164,BES,P011379,P011936,0 days 00:14:16,-13,26,39
164,BES,P007914,P011379,0 days 00:11:30,-15,16,31
164,BES,P011379,P012647,0 days 00:11:14,-11,20,31
164,BES,P007917,P008945,0 days 00:10:46,2,25,23
164,BES,P003783,P007914,0 days 00:10:45,-25,11,36
164,BES,P007914,P011936,0 days 00:10:36,-11,15,26
164,BES,P007914,P012647,0 days 00:10:35,-11,12,23
164,BES,P007917,P012622,0 days 00:10:13,10,27,17
164,BES,P011379,P012622,0 days 00:10:00,-7,21,28
164,BES,P011924,P012622,0 days 00:09:22,2,22,20
164,BES,P007917,P011936,0 days 00:09:21,8,25,17
164,BES,P003783,P012622,0 days 00:09:05,-4,14,18
164,BES,P003783,P011379,0 days 00:08:55,-17,11,28
164,BES,P003783,P012647,0 days 00:08:54,-14,9,23
164,BES,P003783,P011936,0 days 00:08:46,-12,10,22
164,BES,P007917,P012647,0 days 00:08:45,10,25,15
164,BES,P008945,P011379,0 days 00:08:05,-13,11,24
164,BES,P007914,P008945,0 days 00:07:30,-6,9,15
164,BES,P011924,P012647,0 days 00:07:13,-6,12,18
164,BES,P003783,P011924,0 days 00:05:34,-8,9,17
164,BES,P011379,P011924,0 days 00:05:22,1,14,13
164,BES,P007914,P012622,0 days 00:05:12,-3,8,11
164,BES,P011924,P012711,0 days 00:05:09,-8,5,13
164,BES,P011924,P011936,0 days 00:04:54,4,14,10
164,BES,P003783,P008945,0 days 00:04:41,-7,4,11
164,BES,P007914,P011924,0 days 00:04:33,-8,5,13
164,BES,P008945,P011924,0 days 00:04:07,-1,6,7
164,BES,P007914,P012711,0 days 00:03:38,-12,2,14
164,BES,P003783,P012711,0 days 00:03:31,-10,4,14
164,BES,P003783,P007917,0 days 00:03:21,-7,4,11
164,BES,P012647,P012711,0 days 00:03:13,-7,1,8
164,BES,P008945,P012711,0 days 00:02:41,-4,1,5
164,BES,P012622,P012711,0 days 00:02:34,-2,3,5
164,BES,P007917,P012711,0 days 00:02:32,-3,4,7
164,BES,P007914,P007917,0 days 00:02:29,-9,2,11
164,BES,P011357,P011379,0 days 00:02:02,1,5,4
164,BES,P011357,P012622,0 days 00:02:02,1,5,4
164,BES,P011357,P011936,0 days 00:02:02,1,5,4
164,BES,P011357,P011924,0 days 00:02:02,1,5,4
164,BES,P007917,P011924,0 days 00:01:56,-1,4,5
164,BES,P007917,P011379,0 days 00:01:25,-6,0,6
164,BES,P011936,P012711,0 days 00:01:03,-6,0,6
164,BES,P011379,P012711,0 days 00:00:27,-4,0,4
164,PRS,P012608,P012610,0 days 00:25:03,10,59,49
164,PRS,P012610,P012613,0 days 00:22:21,11,52,41
164,PRS,P012608,P012613,0 days 00:22:21,11,52,41
164,PRS,P004512,P012608,0 days 00:19:41,17,53,36
164,PRS,P004512,P012610,0 days 00:19:20,16,52,36
164,PRS,P004512,P012613,0 days 00:16:38,17,45,28
164,PRS,P011232,P012612,0 days 00:14:36,12,35,23
164,PRS,P011232,P012609,0 days 00:13:24,7,30,23
164,PRS,P011232,P012611,0 days 00:13:23,9,31,22
164,PRS,P011232,P012640,0 days 00:13:03,6,29,23
164,PRS,P012609,P012612,0 days 00:13:03,6,29,23
164,PRS,P012609,P012640,0 days 00:13:03,6,29,23
164,PRS,P012612,P012640,0 days 00:13:03,6,29,23
164,PRS,P004512,P012611,0 days 00:11:19,10,28,18
164,PRS,P012608,P012611,0 days 00:11:19,10,28,18
164,PRS,P012610,P012611,0 days 00:10:58,9,27,18
164,PRS,P012611,P012612,0 days 00:10:20,9,23,14
164,PRS,P005793,P012640,0 days 00:09:59,-3,19,22
164,PRS,P012609,P012611,0 days 00:09:08,4,18,14
164,PRS,P012611,P012640,0 days 00:08:47,3,17,14
164,PRS,P012608,P012609,0 days 00:08:43,8,26,18
164,PRS,P004512,P012609,0 days 00:08:43,8,26,18
164,PRS,P012609,P012610,0 days 00:08:22,7,25,18
164,PRS,P012609,P012613,0 days 00:08:22,7,25,18
164,PRS,P012611,P012613,0 days 00:08:16,10,20,10
164,PRS,P005793,P012612,0 days 00:05:49,9,18,9
164,PRS,P005793,P011232,0 days 00:05:49,9,18,9
164,PRS,P012610,P012640,0 days 00:05:43,-6,7,13
164,PRS,P012613,P012640,0 days 00:05:43,-6,7,13
164,PRS,P012608,P012640,0 days 00:05:43,-6,7,13
164,PRS,P005793,P012613,0 days 00:05:43,-6,7,13
164,PRS,P005793,P012610,0 days 00:05:43,-6,7,13
164,PRS,P005793,P012608,0 days 00:05:43,-6,7,13
164,PRS,P005793,P012609,0 days 00:04:16,3,12,9
164,PRS,P004512,P011232,0 days 00:03:03,0,8,8
164,PRS,P011232,P012608,0 days 00:03:03,0,8,8
164,PRS,P011232,P012610,0 days 00:02:42,-1,7,8
164,PRS,P005793,P009556,0 days 00:01:33,6,6,0
164,PRS,P005793,P012611,0 days 00:01:33,6,6,0
164,PRS,P009556,P011232,0 days 00:01:33,6,6,0
164,PRS,P009556,P012611,0 days 00:01:33,6,6,0
164,PRS,P009556,P012612,0 days 00:01:33,6,6,0
165,JOV,P010677,P012780,0 days 00:19:24,5,48,43
165,JOV,P006771,P011247,0 days 00:18:17,-16,35,51
165,JOV,P002507,PJUG,0 days 00:17:40,-1,33,34
165,JOV,P010677,P012349,0 days 00:17:19,-2,37,39
165,JOV,P002507,P011247,0 days 00:16:08,9,42,33
165,JOV,P002507,P010677,0 days 00:15:51,13,39,26
165,JOV,P010677,P011247,0 days 00:15:27,8,38,30
165,JOV,P002507,P010161,0 days 00:14:37,5,32,27
165,JOV,P011247,P012780,0 days 00:14:36,3,33,30
165,JOV,P010161,P010677,0 days 00:14:28,7,36,29
165,JOV,P006771,PJUG,0 days 00:13:52,-8,25,33
165,JOV,P002507,P006771,0 days 00:13:47,-11,25,36
165,JOV,P006771,P010677,0 days 00:13:42,-7,26,33
165,JOV,P006771,P012349,0 days 00:13:20,-5,28,33
165,JOV,P010677,PJUG,0 days 00:13:18,-2,28,30
165,JOV,P010458,PJUG,0 days 00:13:06,-11,18,29
165,JOV,P011247,P012349,0 days 00:12:39,-4,29,33
165,JOV,P012349,P012780,0 days 00:12:32,-7,25,32
165,JOV,P002507,P010458,0 days 00:12:26,-14,15,29
165,JOV,P006771,P010458,0 days 00:10:44,-14,15,29
165,JOV,P010161,PJUG,0 days 00:10:29,-1,22,23
165,JOV,P006771,P012780,0 days 00:10:20,-10,18,28
165,JOV,P010161,P012780,0 days 00:10:12,9,31,22
165,JOV,P011247,PJUG,0 days 00:09:30,3,23,20
165,JOV,P010161,P011247,0 days 00:08:40,5,22,17
165,JOV,P010458,P011247,0 days 00:08:31,-8,14,22
165,JOV,P012349,PJUG,0 days 00:08:22,8,24,16
165,JOV,P012780,PJUG,0 days 00:07:55,0,23,23
165,JOV,P002507,P012780,0 days 00:06:49,14,23,9
165,JOV,P002507,P012349,0 days 00:06:46,5,19,14
165,JOV,P010161,P012349,0 days 00:06:14,-3,14,17
165,JOV,P010161,P010458,0 days 00:04:54,-9,3,12
165,JOV,P010458,P010677,0 days 00:04:15,-6,4,10
165,JOV,P006771,P010161,0 days 00:02:26,-13,0,13
165,JOV,P010458,P012780,0 days 00:01:24,-2,3,5
165,HTA,P007867,P011973,0 days 00:24:00,10,54,44
165,HTA,P007759,P007867,0 days 00:22:19,7,53,46
165,HTA,P011973,P012794,0 days 00:20:23,17,50,33
165,HTA,P007759,P011973,0 days 00:20:03,2,48,46
165,HTA,P007759,P010550,0 days 00:18:33,9,42,33
165,HTA,P007867,P010550,0 days 00:17:26,13,43,30
165,HTA,P007867,P012794,0 days 00:17:18,20,44,24
165,HTA,P010550,P011973,0 days 00:17:15,7,37,30
165,HTA,P006835,P011991,0 days 00:16:29,-1,35,36
165,HTA,P010550,P012794,0 days 00:15:37,7,36,29
165,HTA,P006835,P007759,0 days 00:15:23,-13,32,45
165,HTA,P007759,P012794,0 days 00:15:09,13,43,30
165,HTA,P007759,P011991,0 days 00:12:11,-11,21,32
165,HTA,P006835,P007867,0 days 00:12:00,7,31,24
165,HTA,P004846,P007759,0 days 00:11:37,-11,23,34
165,HTA,P004846,P006835,0 days 00:11:33,-9,25,34
165,HTA,P006835,P011973,0 days 00:11:15,1,28,27
165,HTA,P007867,P011991,0 days 00:09:53,4,22,18
165,HTA,P004846,P011973,0 days 00:09:44,-10,18,28
165,HTA,P011973,P011991,0 days 00:09:39,-4,16,20
165,HTA,P004846,P011991,0 days 00:08:56,-9,14,23
165,HTA,P006835,P012794,0 days 00:08:24,10,24,14
165,HTA,P004846,P010550,0 days 00:08:08,-8,10,18
165,HTA,P003533,P007759,0 days 00:07:17,0,18,18
165,HTA,P004846,P007867,0 days 00:07:11,-3,17,20
165,HTA,P003533,P006835,0 days 00:07:07,2,19,17
165,HTA,P004846,P012794,0 days 00:06:32,-5,12,17
165,HTA,P011991,P012794,0 days 00:06:32,1,12,11
165,HTA,P003533,P011991,0 days 00:06:14,2,17,15
165,HTA,P010550,P011991,0 days 00:05:30,-10,3,13
165,HTA,P003533,P004846,0 days 00:04:51,-1,13,14
165,HTA,P003533,P007867,0 days 00:04:36,5,15,10
165,HTA,P006835,P010550,0 days 00:03:28,-2,5,7
165,HTA,P003533,P012794,0 days 00:02:08,0,6,6
165,HTA,P003533,P010550,0 days 00:01:15,0,4,4
165,HTA,P006835,P010465,0 days 00:01:01,5,5,0
165,HTA,P007867,P010465,0 days 00:01:01,5,5,0
165,HTA,P010465,P011973,0 days 00:01:01,5,5,0
165,HTA,P010465,P012794,0 days 00:01:01,5,5,0
166,TTK,P006883,P011925,0 days 00:25:33,6,45,39
166,TTK,P011834,P011925,0 days 00:24:25,0,42,42
166,TTK,P006883,P011834,0 days 00:22:40,2,38,36
166,TTK,P005000,P011925,0 days 00:19:48,2,34,32
166,TTK,P010477,P011925,0 days 00:18:50,3,36,33
166,TTK,P004801,P011925,0 days 00:17:48,3,30,27
166,TTK,P006693,P011925,0 days 00:17:41,-4,32,36
166,TTK,P006693,P011834,0 days 00:16:55,-6,26,32
166,TTK,P006883,P010477,0 days 00:16:14,2,27,25
166,TTK,P010477,P011834,0 days 00:15:25,5,27,22
166,TTK,P006693,P010477,0 days 00:13:30,-5,22,27
166,TTK,P006693,P006883,0 days 00:13:19,-3,22,25
166,TTK,P004801,P005000,0 days 00:13:19,1,22,21
166,TTK,P005000,P006883,0 days 00:13:02,0,19,19
166,TTK,P004801,P011239,0 days 00:11:02,-3,16,19
166,TTK,P005000,P011834,0 days 00:10:42,-8,12,20
166,TTK,P011239,P011925,0 days 00:10:36,-1,16,17
166,TTK,P005000,P010477,0 days 00:09:14,1,14,13
166,TTK,P011239,P011834,0 days 00:07:55,-6,8,14
166,TTK,P004801,P011834,0 days 00:07:37,-6,8,14
166,TTK,P004801,P006693,0 days 00:07:31,-7,10,17
166,TTK,P006693,P011239,0 days 00:07:31,-7,10,17
166,TTK,P004801,P006883,0 days 00:07:25,5,11,6
166,TTK,P005000,P006693,0 days 00:06:53,-8,6,14
166,TTK,P005000,P011239,0 days 00:06:07,-3,8,11
166,TTK,P005000,P009845,0 days 00:05:13,-5,7,12
166,TTK,P009845,P011925,0 days 00:05:13,-5,7,12
166,TTK,P009845,P011834,0 days 00:04:37,-5,7,12
166,TTK,P004801,P010477,0 days 00:04:24,-1,9,10
166,TTK,P006883,P009845,0 days 00:04:18,-3,7,10
166,TTK,P004801,P011975,0 days 00:03:47,5,7,2
166,TTK,P011925,P011975,0 days 00:03:47,5,7,2
166,TTK,P005000,P011975,0 days 00:03:47,5,7,2
166,TTK,P006883,P011975,0 days 00:03:47,5,7,2
166,TTK,P011272,P011925,0 days 00:03:43,-1,7,8
166,TTK,P010477,P011272,0 days 00:03:43,-1,7,8
166,TTK,P005000,P011272,0 days 00:03:43,-1,7,8
166,TTK,P004801,P011272,0 days 00:03:43,-1,7,8
166,TTK,P006883,P011239,0 days 00:03:06,2,4,2
166,TTK,P009845,P011239,0 days 00:00:55,-2,0,2
166,TTK,P009845,P010477,0 days 00:00:36,0,0,0
166,TTK,P010477,P011239,0 days 00:00:36,0,2,2
166,BOU,P010718,P012617,0 days 00:24:11,0,39,39
166,BOU,P010718,P011836,0 days 00:21:06,-3,36,39
166,BOU,P011836,P012617,0 days 00:20:48,-3,34,37
166,BOU,P010431,P010718,0 days 00:18:30,1,29,28
166,BOU,P010431,P012617,0 days 00:18:30,1,29,28
166,BOU,P010431,P011836,0 days 00:15:41,-4,24,28
166,BOU,P010718,P011837,0 days 00:15:13,2,31,29
166,BOU,P011837,P012617,0 days 00:15:13,2,31,29
166,BOU,P000498,P012628,0 days 00:14:44,4,27,23
166,BOU,P004525,P012628,0 days 00:13:49,-1,21,22
166,BOU,P011836,P011837,0 days 00:13:09,-1,26,27
166,BOU,P012618,P012628,0 days 00:12:57,6,23,17
166,BOU,P010431,P011837,0 days 00:12:36,3,27,24
166,BOU,P000498,P004525,0 days 00:12:28,1,21,20
166,BOU,P000498,P012618,0 days 00:12:28,6,25,19
166,BOU,P004525,P012618,0 days 00:12:00,3,17,14
166,BOU,P011161,P012618,0 days 00:11:29,3,22,19
166,BOU,P010431,P012618,0 days 00:10:44,1,11,10
166,BOU,P011161,P012628,0 days 00:10:41,1,18,17
166,BOU,P011836,P012618,0 days 00:10:13,1,16,15
166,BOU,P000498,P011161,0 days 00:10:12,1,20,19
166,BOU,P012617,P012618,0 days 00:09:45,-2,8,10
166,BOU,P010718,P012618,0 days 00:09:16,-2,10,12
166,BOU,P004525,P011161,0 days 00:08:25,-2,12,14
166,BOU,P004525,P010431,0 days 00:07:39,8,14,6
166,BOU,P011161,P011836,0 days 00:06:43,4,16,12
166,BOU,P011161,P012617,0 days 00:04:51,1,8,7
166,BOU,P000498,P010431,0 days 00:04:50,3,9,6
166,BOU,P010431,P012628,0 days 00:04:50,3,9,6
166,BOU,P004525,P011837,0 days 00:04:33,1,9,8
166,BOU,P010718,P011161,0 days 00:04:22,1,10,9
166,BOU,P004525,P012617,0 days 00:04:10,3,5,2
166,BOU,P011837,P012628,0 days 00:04:06,-4,6,10
166,BOU,P011161,P011837,0 days 00:03:29,-1,6,7
166,BOU,P011836,P012628,0 days 00:03:24,3,8,5
166,BOU,P004525,P010718,0 days 00:03:23,3,5,2
166,BOU,P000498,P011836,0 days 00:02:39,3,8,5
166,BOU,P000498,P011837,0 days 00:02:29,-2,4,6
166,BOU,P012617,P012628,0 days 00:02:24,-2,2,4
166,BOU,P010718,P012628,0 days 00:01:37,-2,2,4
166,BOU,P000498,P010718,0 days 00:00:18,0,2,2
166,BOU,P004525,P011836,0 days 00:00:05,0,0,0
167,LKB,P007029,PLXI,0 days 00:26:01,8,57,49
167,LKB,P007029,P010461,0 days 00:24:47,4,56,52
167,LKB,P010461,PLXI,0 days 00:23:09,8,55,47
167,LKB,P002012,P009898,0 days 00:22:05,1,45,44
167,LKB,P002012,P007029,0 days 00:19:39,8,41,33
167,LKB,P007029,P009898,0 days 00:18:39,-3,37,40
167,LKB,P002012,P010461,0 days 00:17:58,5,36,31
167,LKB,P009898,P010461,0 days 00:17:21,-4,36,40
167,LKB,P006901,P010190,0 days 00:16:18,7,38,31
167,LKB,P002012,PLXI,0 days 00:16:06,11,35,24
167,LKB,P002012,P010190,0 days 00:15:44,19,43,24
167,LKB,P006901,P009898,0 days 00:15:10,9,38,29
167,LKB,P007029,P010190,0 days 00:15:09,12,38,26
167,LKB,P009898,PLXI,0 days 00:14:37,0,31,31
167,LKB,P010190,P010461,0 days 00:14:12,8,36,28
167,LKB,P009898,P010190,0 days 00:13:18,11,36,25
167,LKB,P004868,P006901,0 days 00:12:56,10,29,19
167,LKB,P010190,PLXI,0 days 00:12:50,14,35,21
167,LKB,P006901,P007029,0 days 00:11:17,-4,22,26
167,LKB,P004868,P009898,0 days 00:11:03,10,27,17
167,LKB,P004868,P010190,0 days 00:10:42,13,28,15
167,LKB,P002012,P006901,0 days 00:09:53,6,25,19
167,LKB,P002012,P004868,0 days 00:09:51,10,27,17
167,LKB,P006901,PLXI,0 days 00:09:05,-3,19,22
167,LKB,P006901,P010461,0 days 00:08:06,-5,19,24
167,LKB,P004868,P007029,0 days 00:05:28,3,9,6
167,LKB,P004868,PLXI,0 days 00:03:04,2,4,2
167,LKB,P006901,P011329,0 days 00:01:23,0,2,2
167,LKB,P009898,P011329,0 days 00:01:23,0,2,2
167,LKB,P010190,P011329,0 days 00:01:23,0,2,2
167,LKB,P010461,P011329,0 days 00:01:23,0,2,2
167,WRO,P012094,P012699,0 days 00:23:41,-1,50,51
167,WRO,P011900,P012094,0 days 00:20:06,-8,43,51
167,WRO,P011900,P012699,0 days 00:19:25,-6,39,45
167,WRO,P012094,P012601,0 days 00:19:22,-7,39,46
167,WRO,P012601,P012699,0 days 00:17:43,-8,33,41
167,WRO,P005531,P012094,0 days 00:17:27,11,43,32
167,WRO,P011900,P012601,0 days 00:17:21,-11,34,45
167,WRO,P009896,P012699,0 days 00:15:43,-5,27,32
167,WRO,P009896,P012601,0 days 00:15:28,-14,24,38
167,WRO,P009896,P012094,0 days 00:14:25,-9,25,34
167,WRO,P003034,P012094,0 days 00:13:43,7,37,30
167,WRO,P005531,P012699,0 days 00:13:31,5,31,26
167,WRO,P005531,P012601,0 days 00:13:14,-4,23,27
167,WRO,P005531,P009896,0 days 00:13:01,0,22,22
167,WRO,P009896,P011900,0 days 00:12:59,-12,19,31
167,WRO,P003034,P011900,0 days 00:12:31,2,33,31
167,WRO,P003034,P012601,0 days 00:12:16,-1,25,26
167,WRO,P003034,P005531,0 days 00:10:35,2,25,23
167,WRO,P011901,P012736,0 days 00:10:22,-14,11,25
167,WRO,P003034,P012699,0 days 00:10:01,5,27,22
167,WRO,P005531,P011900,0 days 00:09:44,2,24,22
167,WRO,P011901,P012601,0 days 00:09:13,-6,12,18
167,WRO,P009896,P011901,0 days 00:09:10,-10,12,22
167,WRO,P005531,P011901,0 days 00:09:03,-6,13,19
167,WRO,P005531,P012736,0 days 00:07:17,-11,6,17
167,WRO,P009896,P012736,0 days 00:07:11,-7,8,15
167,WRO,P012601,P012736,0 days 00:06:19,-9,6,15
167,WRO,P011900,P011901,0 days 00:05:55,-9,9,18
167,WRO,P003034,P011901,0 days 00:05:10,1,10,9
167,WRO,P011900,P012736,0 days 00:03:40,-6,5,11
167,WRO,P011901,P012699,0 days 00:03:33,1,9,8
167,WRO,P009896,P011902,0 days 00:03:23,-7,3,10
167,WRO,P011901,P011902,0 days 00:03:23,-7,3,10
167,WRO,P011902,P012736,0 days 00:03:11,-3,3,6
167,WRO,P003034,P012736,0 days 00:03:08,-4,3,7
167,WRO,P011901,P012094,0 days 00:02:47,2,9,7
167,WRO,P005531,P011902,0 days 00:01:48,-3,1,4
167,WRO,P011900,P011902,0 days 00:01:35,-4,2,6
167,WRO,P012094,P012736,0 days 00:00:49,1,2,1
167,WRO,P012699,P012736,0 days 00:00:35,-3,0,3
167,WRO,P011902,P012094,0 days 00:00:12,-4,0,4
168,CAN,P003425,P008121,0 days 00:29:12,-5,76,81
168,CAN,P006588,P008121,0 days 00:28:32,-7,72,79
168,CAN,P003425,P006588,0 days 00:27:14,-5,70,75
168,CAN,P003425,P003637,0 days 00:22:19,-6,55,61
168,CAN,P003637,P006588,0 days 00:22:19,-6,55,61
168,CAN,P003637,P008121,0 days 00:22:19,-6,55,61
168,CAN,P008121,P010385,0 days 00:17:48,7,50,43
168,CAN,P008121,P009864,0 days 00:16:21,-11,38,49
168,CAN,P003425,P010385,0 days 00:15:54,5,44,39
168,CAN,P006588,P009864,0 days 00:15:04,-12,34,46
168,CAN,P003637,P009864,0 days 00:14:55,-9,36,45
168,CAN,P001607,P010452,0 days 00:14:02,5,33,28
168,CAN,P006588,P010385,0 days 00:13:42,5,38,33
168,CAN,P003425,P009864,0 days 00:13:32,-10,32,42
168,CAN,P005005,P010452,0 days 00:12:10,-1,24,25
168,CAN,P001607,P009864,0 days 00:11:48,-3,22,25
168,CAN,P001607,P005005,0 days 00:10:57,2,23,21
168,CAN,P009864,P010452,0 days 00:10:16,-1,20,21
168,CAN,P003637,P010385,0 days 00:09:42,2,23,21
168,CAN,P001607,P007560,0 days 00:09:09,6,23,17
168,CAN,P005005,P009864,0 days 00:08:59,-2,16,18
168,CAN,P007560,P010452,0 days 00:08:36,11,26,15
168,CAN,P005005,P010385,0 days 00:06:54,6,23,17
168,CAN,P007560,P008121,0 days 00:06:07,2,17,15
168,CAN,P010385,P010452,0 days 00:05:58,6,19,13
168,CAN,P007560,P009864,0 days 00:05:43,0,10,10
168,CAN,P008121,P010452,0 days 00:05:37,3,16,13
168,CAN,P005005,P008121,0 days 00:05:02,2,16,14
168,CAN,P001607,P008121,0 days 00:04:57,1,12,11
168,CAN,P007560,P010385,0 days 00:04:56,7,18,11
168,CAN,P003425,P005005,0 days 00:04:56,2,16,14
168,CAN,P004160,P009864,0 days 00:04:42,-4,8,12
168,CAN,P005005,P007560,0 days 00:04:32,5,11,6
168,CAN,P004160,P005005,0 days 00:04:01,-2,8,10
168,CAN,P004160,P010452,0 days 00:03:47,-2,8,10
168,CAN,P001607,P004160,0 days 00:03:47,-2,8,10
168,CAN,P001607,P010385,0 days 00:03:46,6,13,7
168,CAN,P005005,P006588,0 days 00:03:43,5,15,10
168,CAN,P003637,P010452,0 days 00:02:18,-1,4,5
168,CAN,P003637,P005005,0 days 00:02:18,-1,4,5
168,CAN,P001607,P003637,0 days 00:02:18,-1,4,5
168,CAN,P003425,P010452,0 days 00:02:12,0,6,6
168,CAN,P006588,P007560,0 days 00:02:03,-4,2,6
168,CAN,P001607,P006588,0 days 00:01:32,-2,2,4
168,CAN,P003425,P007560,0 days 00:01:30,1,5,4
168,CAN,P003425,P004160,0 days 00:00:55,-2,0,2
168,CAN,P004160,P006588,0 days 00:00:55,-2,0,2
168,CAN,P004160,P008121,0 days 00:00:41,-2,0,2
168,CLU,P010569,P011801,0 days 00:32:24,11,80,69
168,CLU,P005373,P011801,0 days 00:29:53,18,88,70
168,CLU,P010569,P012621,0 days 00:29:53,-5,70,75
168,CLU,P011801,P012621,0 days 00:29:29,5,76,71
168,CLU,P010569,P012698,0 days 00:28:14,4,69,65
168,CLU,P011801,P012698,0 days 00:26:40,15,72,57
168,CLU,P012621,P012698,0 days 00:24:53,-1,64,65
168,CLU,P005373,P010569,0 days 00:24:33,17,70,53
168,CLU,P005373,P012621,0 days 00:23:59,9,68,59
168,CLU,P005373,P012698,0 days 00:23:15,18,70,52
168,CLU,P005714,P011801,0 days 00:17:36,-5,44,49
168,CLU,P005113,P010569,0 days 00:15:53,-16,28,44
168,CLU,P005373,P005714,0 days 00:13:44,2,40,38
168,CLU,P005714,P010569,0 days 00:13:36,-5,29,34
168,CLU,P005714,P012621,0 days 00:13:15,-2,34,36
168,CLU,P005113,P012621,0 days 00:12:00,-13,23,36
168,CLU,P010569,P012620,0 days 00:11:29,-1,29,30
168,CLU,P005714,P012698,0 days 00:11:01,-1,31,32
168,CLU,P005113,P012698,0 days 00:10:19,-13,17,30
168,CLU,P005113,P011801,0 days 00:08:37,-6,13,19
168,CLU,P012620,P012698,0 days 00:08:22,-1,22,23
168,CLU,P005113,P012620,0 days 00:08:07,-9,16,25
168,CLU,P012620,P012621,0 days 00:07:23,-9,17,26
168,CLU,P005113,P005714,0 days 00:05:12,-6,7,13
168,CLU,P011801,P012620,0 days 00:05:11,10,17,7
168,CLU,P005373,P012620,0 days 00:03:22,8,13,5
168,CLU,P005113,P010997,0 days 00:02:38,-1,5,6
168,CLU,P010569,P010997,0 days 00:02:38,-1,5,6
168,CLU,P010997,P012620,0 days 00:01:40,-2,2,4
168,CLU,P010997,P012698,0 days 00:01:32,-1,3,4
168,CLU,P010997,P011801,0 days 00:01:06,0,2,2
168,CLU,P005714,P010997,0 days 00:00:58,1,3,2
168,CLU,P005113,P005373,0 days 00:00:46,0,3,3
168,CLU,P005714,P012620,0 days 00:00:22,0,0,0
169,TRN,P005059,P005738,0 days 00:21:18,-11,42,53
169,TRN,P005738,P012595,0 days 00:19:34,-1,46,47
169,TRN,P012595,P012596,0 days 00:18:59,-9,37,46
169,TRN,P012595,P012597,0 days 00:18:12,-5,39,44
169,TRN,P005059,P012597,0 days 00:17:31,-18,30,48
169,TRN,P005738,P012597,0 days 00:16:52,-5,33,38
169,TRN,P005059,P009903,0 days 00:15:31,-17,27,44
169,TRN,P005059,P012595,0 days 00:15:30,-13,35,48
169,TRN,P005738,P009903,0 days 00:14:56,-13,25,38
169,TRN,P005738,P006382,0 days 00:14:50,-7,23,30
169,TRN,P006382,P012595,0 days 00:14:37,-3,28,31
169,TRN,P009903,P012597,0 days 00:12:35,-13,21,34
169,TRN,P005059,P006382,0 days 00:12:10,-5,19,24
169,TRN,P012596,P012597,0 days 00:11:57,-3,22,25
169,TRN,P006382,P012597,0 days 00:11:56,-6,15,21
169,TRN,P006382,P009903,0 days 00:11:38,-8,16,24
169,TRN,P006382,P012596,0 days 00:10:39,-2,21,23
169,TRN,P009903,P012595,0 days 00:09:44,-8,23,31
169,TRN,P001479,P012595,0 days 00:09:00,1,18,17
169,TRN,P005738,P012596,0 days 00:08:55,0,21,21
169,TRN,P012594,P012595,0 days 00:08:54,-11,16,27
169,TRN,P012594,P012596,0 days 00:07:49,-10,12,22
169,TRN,P005059,P012596,0 days 00:07:39,-3,17,20
169,TRN,P012595,P012687,0 days 00:07:34,-4,16,20
169,TRN,P006382,P012594,0 days 00:07:24,-7,12,19
169,TRN,P007828,P012595,0 days 00:06:48,5,18,13
169,TRN,P001479,P012597,0 days 00:05:50,0,12,12
169,TRN,P012596,P012687,0 days 00:05:31,-5,12,17
169,TRN,P001479,P007828,0 days 00:05:23,7,14,7
169,TRN,P007828,P012597,0 days 00:04:45,4,14,10
169,TRN,P006382,P012687,0 days 00:04:25,-4,10,14
169,TRN,P001479,P012687,0 days 00:04:16,0,8,8
169,TRN,P001479,P012596,0 days 00:03:37,-6,4,10
169,TRN,P001479,P005738,0 days 00:03:23,5,9,4
169,TRN,P005738,P007828,0 days 00:03:23,5,9,4
169,TRN,P005738,P012594,0 days 00:03:17,-6,6,12
169,TRN,P012594,P012597,0 days 00:03:12,-1,4,5
169,TRN,P005738,P012687,0 days 00:02:56,1,6,5
169,TRN,P007828,P009903,0 days 00:02:35,-2,7,9
169,TRN,P012594,P012687,0 days 00:02:25,-4,6,10
169,TRN,P007828,P012687,0 days 00:02:03,1,4,3
169,TRN,P001479,P009903,0 days 00:02:00,2,5,3
169,TRN,P005059,P012594,0 days 00:01:30,-4,4,8
169,TRN,P001479,P005059,0 days 00:01:24,-5,0,5
169,TRN,P001479,P006382,0 days 00:01:07,0,2,2
169,TRN,P012597,P012687,0 days 00:01:06,-1,2,3
169,TRN,P009903,P012594,0 days 00:01:05,-1,4,5
169,TRN,P006382,P007828,0 days 00:00:50,2,2,0
169,TRN,P007828,P012596,0 days 00:00:50,2,2,0
169,TRN,P005059,P007828,0 days 00:00:35,-4,2,6
169,BUD,P010248,P011281,0 days 00:20:57,21,56,35
169,BUD,P005637,P011281,0 days 00:17:47,28,50,22
169,BUD,P011935,P012630,0 days 00:17:22,-5,38,43
169,BUD,P005637,P010248,0 days 00:17:14,26,48,22
169,BUD,P006566,P010248,0 days 00:17:06,15,43,28
169,BUD,P006566,P011281,0 days 00:17:06,15,43,28
169,BUD,P011935,P012606,0 days 00:16:53,-7,34,41
169,BUD,P008325,P012606,0 days 00:15:36,3,37,34
169,BUD,P012606,P012630,0 days 00:13:39,0,30,30
169,BUD,P008325,P011935,0 days 00:13:26,-2,30,32
169,BUD,P005637,P006566,0 days 00:13:23,20,35,15
169,BUD,P004945,P005637,0 days 00:10:36,11,26,15
169,BUD,P002740,P005637,0 days 00:10:19,18,32,14
169,BUD,P008325,P012630,0 days 00:10:16,5,26,21
169,BUD,P004945,P010248,0 days 00:09:30,10,23,13
169,BUD,P004945,P011281,0 days 00:09:30,10,23,13
169,BUD,P010389,P012606,0 days 00:09:11,-8,17,25
169,BUD,P004945,P006566,0 days 00:09:05,13,23,10
169,BUD,P002740,P011281,0 days 00:08:42,15,27,12
169,BUD,P010389,P011935,0 days 00:08:40,-10,15,25
169,BUD,P002740,P010248,0 days 00:08:09,13,25,12
169,BUD,P002740,P012606,0 days 00:08:08,2,21,19
169,BUD,P004945,P008325,0 days 00:08:05,4,20,16
169,BUD,P004945,P012606,0 days 00:08:05,4,20,16
169,BUD,P004945,P012630,0 days 00:06:59,3,17,14
169,BUD,P004945,P011935,0 days 00:06:59,3,17,14
169,BUD,P002740,P008325,0 days 00:06:34,-2,13,15
169,BUD,P008325,P010389,0 days 00:05:44,-3,13,16
169,BUD,P010248,P012630,0 days 00:05:39,0,13,13
169,BUD,P011281,P012630,0 days 00:05:39,0,13,13
169,BUD,P010389,P012630,0 days 00:05:26,-3,11,14
169,BUD,P002740,P011935,0 days 00:04:28,-7,6,13
169,BUD,P002740,P006566,0 days 00:04:22,7,12,5
169,BUD,P006566,P011935,0 days 00:03:47,-5,8,13
169,BUD,P002740,P010389,0 days 00:03:45,-5,6,11
169,BUD,P010248,P011935,0 days 00:03:43,-5,8,13
169,BUD,P011281,P011935,0 days 00:03:43,-5,8,13
169,BUD,P006566,P012630,0 days 00:03:43,-5,8,13
169,BUD,P005637,P012606,0 days 00:03:40,9,15,6
169,BUD,P009214,P012606,0 days 00:03:23,-5,4,9
169,BUD,P009214,P012630,0 days 00:03:23,-5,4,9
169,BUD,P009214,P010389,0 days 00:03:23,-5,4,9
169,BUD,P009214,P011935,0 days 00:03:23,-5,4,9
169,BUD,P002740,P012630,0 days 00:03:10,5,7,2
169,BUD,P005637,P008325,0 days 00:02:10,5,7,2
169,BUD,P011281,P012606,0 days 00:02:03,6,10,4
169,BUD,P005637,P012630,0 days 00:01:56,5,5,0
169,BUD,P002740,P004945,0 days 00:01:31,-2,3,5
169,BUD,P010248,P012606,0 days 00:01:30,4,8,4
169,BUD,P008325,P011281,0 days 00:00:33,2,2,0
169,BUD,P005637,P010389,0 days 00:00:31,2,2,0
169,BUD,P006566,P010389,0 days 00:00:04,0,0,0
169,BUD,P006566,P012606,0 days 00:00:04,0,0,0
170,ULM,P010582,P012603,0 days 00:20:21,-4,39,43
170,ULM,P012603,P012604,0 days 00:20:20,-3,44,47
170,ULM,P012604,P012703,0 days 00:19:37,-9,37,46
170,ULM,P005422,P012603,0 days 00:19:36,-8,41,49
170,ULM,P012603,P012703,0 days 00:19:08,-9,39,48
170,ULM,P005422,P012604,0 days 00:18:38,-7,39,46
170,ULM,P010582,P012604,0 days 00:18:35,-10,35,45
170,ULM,P005422,P012703,0 days 00:18:15,-10,36,46
170,ULM,P005422,P010582,0 days 00:18:14,-7,37,44
170,ULM,P010582,P012703,0 days 00:16:21,-6,32,38
170,ULM,P010726,P011457,0 days 00:15:52,-9,21,30
170,ULM,P010726,P011188,0 days 00:13:59,-8,16,24
170,ULM,P007952,P010726,0 days 00:13:33,-4,18,22
170,ULM,P011188,P011457,0 days 00:13:22,-8,16,24
170,ULM,P007952,P011457,0 days 00:13:05,-8,18,26
170,ULM,P007952,P011188,0 days 00:12:43,-1,18,19
170,ULM,P010582,P010726,0 days 00:10:11,1,20,19
170,ULM,P010582,P011457,0 days 00:09:25,0,15,15
170,ULM,P007952,P010582,0 days 00:09:04,3,17,14
170,ULM,P010726,P012604,0 days 00:08:52,-5,16,21
170,ULM,P010726,P012603,0 days 00:08:18,2,18,16
170,ULM,P010582,P011188,0 days 00:07:18,-3,13,16
170,ULM,P010726,P012703,0 days 00:06:49,-4,11,15
170,ULM,P005422,P010726,0 days 00:06:40,-3,13,16
170,ULM,P007952,P012704,0 days 00:06:32,-8,3,11
170,ULM,P011188,P012704,0 days 00:06:25,-5,3,8
170,ULM,P010726,P012704,0 days 00:05:26,-6,3,9
170,ULM,P011457,P012704,0 days 00:05:24,-8,3,11
170,ULM,P011457,P012703,0 days 00:05:08,-6,7,13
170,ULM,P011457,P012604,0 days 00:04:53,-5,5,10
170,ULM,P011457,P012603,0 days 00:04:28,-2,7,9
170,ULM,P011188,P012703,0 days 00:04:09,-4,4,8
170,ULM,P007952,P012703,0 days 00:03:40,-4,6,10
170,ULM,P005422,P007952,0 days 00:03:38,-6,4,10
170,ULM,P007952,P012603,0 days 00:03:37,-4,4,8
170,ULM,P011188,P012604,0 days 00:03:12,-9,0,9
170,ULM,P005422,P011188,0 days 00:02:32,-2,2,4
170,ULM,P005422,P012704,0 days 00:01:16,-3,0,3
170,ULM,P010582,P012704,0 days 00:01:07,-2,0,2
170,ULM,P005422,P011457,0 days 00:00:15,-6,0,6
170,ULM,P012604,P012704,0 days 00:00:01,0,0,0
170,ULM,P012703,P012704,0 days 00:00:01,0,0,0
170,ARI,P004292,P012716,0 days 00:26:19,21,68,47
170,ARI,P012716,P012717,0 days 00:19:38,16,52,36
170,ARI,P004292,P012717,0 days 00:18:46,17,54,37
170,ARI,P012716,P012792,0 days 00:17:14,10,31,21
170,ARI,P010387,P012716,0 days 00:16:41,25,40,15
170,ARI,P012615,P012716,0 days 00:14:56,10,26,16
170,ARI,P012716,P012760,0 days 00:13:16,13,28,15
170,ARI,P012615,P012792,0 days 00:13:04,7,22,15
170,ARI,P012702,P012716,0 days 00:13:01,9,32,23
170,ARI,P004292,P012792,0 days 00:11:49,5,27,22
170,ARI,P004292,P010387,0 days 00:10:49,20,32,12
170,ARI,P004292,P012760,0 days 00:10:17,9,24,15
170,ARI,P010387,P012615,0 days 00:10:01,7,18,11
170,ARI,P004292,P012702,0 days 00:09:48,8,28,20
170,ARI,P010387,P012717,0 days 00:09:42,19,28,9
170,ARI,P012717,P012792,0 days 00:09:36,-3,17,20
170,ARI,P004292,P012615,0 days 00:09:17,2,16,14
170,ARI,P010387,P012792,0 days 00:09:10,7,15,8
170,ARI,P012702,P012717,0 days 00:09:04,6,23,17
170,ARI,P012760,P012792,0 days 00:09:00,5,17,12
170,ARI,P012722,P012792,0 days 00:08:35,-4,14,18
170,ARI,P012615,P012760,0 days 00:08:16,11,17,6
170,ARI,P012716,P012722,0 days 00:08:10,1,15,14
170,ARI,P010387,P012760,0 days 00:08:00,13,19,6
170,ARI,P004292,P012722,0 days 00:07:51,-1,15,16
170,ARI,P012717,P012760,0 days 00:07:31,-1,15,16
170,ARI,P012708,P012717,0 days 00:06:27,-7,13,20
170,ARI,P012717,P012722,0 days 00:05:54,3,15,12
170,ARI,P010387,P012722,0 days 00:05:51,1,11,10
170,ARI,P010387,P012702,0 days 00:05:45,9,13,4
170,ARI,P012615,P012722,0 days 00:05:11,-5,4,9
170,ARI,P012702,P012792,0 days 00:04:58,0,5,5
170,ARI,P012708,P012760,0 days 00:04:53,-5,6,11
170,ARI,P012708,P012716,0 days 00:04:44,-2,11,13
170,ARI,P004292,P012708,0 days 00:04:44,-2,11,13
170,ARI,P002867,P012792,0 days 00:04:43,-8,4,12
170,ARI,P012615,P012702,0 days 00:03:57,3,9,6
170,ARI,P002867,P012717,0 days 00:03:46,-6,7,13
170,ARI,P002867,P012716,0 days 00:03:11,-1,5,6
170,ARI,P002867,P012615,0 days 00:03:00,-3,2,5
170,ARI,P002867,P012722,0 days 00:02:48,-3,2,5
170,ARI,P002867,P004292,0 days 00:02:32,-3,5,8
170,ARI,P012708,P012792,0 days 00:02:31,-3,4,7
170,ARI,P012702,P012708,0 days 00:02:22,0,9,9
170,ARI,P002867,P012702,0 days 00:02:03,-1,5,6
170,ARI,P002867,P012760,0 days 00:01:55,-5,2,7
170,ARI,P002867,P012708,0 days 00:01:55,-5,2,7
170,ARI,P002867,P010387,0 days 00:01:11,-1,2,3
170,ARI,P010177,P010387,0 days 00:01:06,2,4,2
170,ARI,P010177,P012615,0 days 00:01:06,2,4,2
170,ARI,P010177,P012702,0 days 00:01:06,2,4,2
170,ARI,P010177,P012716,0 days 00:01:06,2,4,2
170,ARI,P012615,P012708,0 days 00:00:48,2,2,0
170,ARI,P010387,P012708,0 days 00:00:36,2,2,0
171,PMT,P011942,P011944,0 days 00:28:27,18,74,56
171,PMT,P002644,P011942,0 days 00:26:56,20,67,47
171,PMT,P002644,P011947,0 days 00:25:19,27,66,39
171,PMT,P011942,P011947,0 days 00:24:11,26,64,38
171,PMT,P011942,P012600,0 days 00:23:04,21,63,42
171,PMT,P002644,P011944,0 days 00:23:02,23,64,41
171,PMT,P011944,P011947,0 days 00:20:26,28,61,33
171,PMT,P011944,P012600,0 days 00:20:02,15,53,38
171,PMT,P002644,P012600,0 days 00:17:58,18,46,28
171,PMT,P011947,P012600,0 days 00:15:07,20,41,21
171,PMT,P001686,P011944,0 days 00:13:41,-6,25,31
171,PMT,P001686,P002644,0 days 00:13:38,0,27,27
171,PMT,P001686,P011942,0 days 00:13:38,-3,25,28
171,PMT,P001686,P011947,0 days 00:12:17,4,27,23
171,PMT,P011823,P012600,0 days 00:10:53,-7,23,30
171,PMT,P002020,P012600,0 days 00:10:50,-3,28,31
171,PMT,P011966,P012600,0 days 00:08:49,-4,16,20
171,PMT,P002020,P011823,0 days 00:08:23,-1,23,24
171,PMT,P002020,P011942,0 days 00:07:33,4,24,20
171,PMT,P011823,P011942,0 days 00:07:17,4,21,17
171,PMT,P011823,P011944,0 days 00:06:53,-7,12,19
171,PMT,P002644,P011966,0 days 00:06:05,-2,7,9
171,PMT,P011947,P011966,0 days 00:05:50,-5,5,10
171,PMT,P002020,P011944,0 days 00:05:47,-3,15,18
171,PMT,P011942,P011966,0 days 00:05:46,6,14,8
171,PMT,P002020,P011966,0 days 00:05:03,0,13,13
171,PMT,P001686,P012600,0 days 00:04:50,-8,2,10
171,PMT,P011823,P011966,0 days 00:04:00,0,11,11
171,PMT,P010549,P012600,0 days 00:03:51,-8,4,12
171,PMT,P010549,P011823,0 days 00:02:48,-8,2,10
171,PMT,P010549,P011966,0 days 00:02:29,-4,4,8
171,PMT,P002020,P010549,0 days 00:02:29,-4,4,8
171,PMT,P002020,P002644,0 days 00:02:27,-2,5,7
171,PMT,P001686,P011823,0 days 00:02:21,-5,0,5
171,PMT,P001686,P011966,0 days 00:02:18,1,2,1
171,PMT,P010549,P011944,0 days 00:01:22,-4,0,4
171,PMT,P001686,P010549,0 days 00:01:13,-3,0,3
171,PMT,P002644,P010549,0 days 00:01:03,0,2,2
171,PMT,P011823,P011947,0 days 00:00:57,-4,0,4
171,PMT,P002020,P011947,0 days 00:00:48,-3,0,3
171,PMT,P010549,P011947,0 days 00:00:09,-1,0,1
171,JOV,P006771,P011247,0 days 00:17:36,6,38,32
171,JOV,P010677,P012780,0 days 00:17:09,-16,31,47
171,JOV,P010677,P012349,0 days 00:17:07,-5,39,44
171,JOV,P006771,P010677,0 days 00:16:56,-20,28,48
171,JOV,P012349,P012780,0 days 00:15:44,-4,34,38
171,JOV,P002507,P010458,0 days 00:15:32,-6,27,33
171,JOV,P006771,P012780,0 days 00:15:03,-12,27,39
171,JOV,P006771,P012349,0 days 00:13:38,2,32,30
171,JOV,P002361,P002507,0 days 00:13:25,-1,29,30
171,JOV,P002361,P010458,0 days 00:13:20,-5,27,32
171,JOV,P010677,P011247,0 days 00:12:20,-5,27,32
171,JOV,P011247,P012780,0 days 00:11:46,7,30,23
171,JOV,P002361,P006771,0 days 00:10:53,-2,17,19
171,JOV,P006771,P010458,0 days 00:10:46,-7,15,22
171,JOV,P006771,PJUG,0 days 00:10:26,-5,17,22
171,JOV,P012349,PJUG,0 days 00:10:25,-2,24,26
171,JOV,P010458,P011247,0 days 00:10:22,1,17,16
171,JOV,P010161,P010677,0 days 00:10:15,-3,24,27
171,JOV,P010677,PJUG,0 days 00:09:58,-9,19,28
171,JOV,P002507,P006771,0 days 00:09:53,6,18,12
171,JOV,P002507,PJUG,0 days 00:09:49,-1,21,22
171,JOV,P011247,P012349,0 days 00:09:17,5,27,22
171,JOV,P002507,P010677,0 days 00:08:38,-5,18,23
171,JOV,P010458,P010677,0 days 00:08:17,-15,12,27
171,JOV,P002507,P011247,0 days 00:08:16,-2,12,14
171,JOV,P002507,P010161,0 days 00:08:05,-3,22,25
171,JOV,P002361,P010677,0 days 00:08:04,-14,10,24
171,JOV,P002361,P011247,0 days 00:08:01,1,13,12
171,JOV,P010458,PJUG,0 days 00:07:23,-7,11,18
171,JOV,P010161,P010458,0 days 00:06:46,-2,17,19
171,JOV,P012780,PJUG,0 days 00:06:44,-6,11,17
171,JOV,P010161,PJUG,0 days 00:06:16,1,18,17
171,JOV,P002361,P010161,0 days 00:05:53,-2,15,17
171,JOV,P011247,PJUG,0 days 00:05:40,-3,9,12
171,JOV,P010161,P012349,0 days 00:05:30,1,15,14
171,JOV,P002361,PJUG,0 days 00:05:07,-4,10,14
171,JOV,P002361,P012780,0 days 00:04:36,-8,3,11
171,JOV,P010161,P012780,0 days 00:04:20,2,10,8
171,JOV,P002507,P012349,0 days 00:03:50,4,13,9
171,JOV,P002361,P012349,0 days 00:02:45,-1,4,5
171,JOV,P010161,P011247,0 days 00:02:26,2,7,5
171,JOV,P010458,P012780,0 days 00:01:34,-3,2,5
171,JOV,P006771,P010161,0 days 00:00:09,0,0,0
172,BES,P011924,P012647,0 days 00:23:20,-7,47,54
172,BES,P003783,P011936,0 days 00:20:14,-15,37,52
172,BES,P011936,P012647,0 days 00:20:11,-12,34,46
172,BES,P012647,P012711,0 days 00:16:47,-6,32,38
172,BES,P003783,P012647,0 days 00:16:28,-13,29,42
172,BES,P011924,P012711,0 days 00:15:53,-6,31,37
172,BES,P011924,P011936,0 days 00:15:48,-10,27,37
172,BES,P012622,P012647,0 days 00:15:35,-1,36,37
172,BES,P011924,P012622,0 days 00:14:05,0,32,32
172,BES,P011936,P012711,0 days 00:13:14,-12,20,32
172,BES,P003783,P011924,0 days 00:13:06,-9,24,33
172,BES,P008945,P012647,0 days 00:12:16,0,27,27
172,BES,P008945,P012622,0 days 00:11:51,1,27,26
172,BES,P007914,P012647,0 days 00:11:41,-7,17,24
172,BES,P011936,P012622,0 days 00:11:28,-10,17,27
172,BES,P008945,P011924,0 days 00:11:18,-2,25,27
172,BES,P003783,P012711,0 days 00:11:04,-11,17,28
172,BES,P003783,P007917,0 days 00:10:12,-5,22,27
172,BES,P007914,P011936,0 days 00:09:56,-7,14,21
172,BES,P007917,P012647,0 days 00:09:10,-6,18,24
172,BES,P007914,P012711,0 days 00:09:06,-7,13,20
172,BES,P007917,P011936,0 days 00:09:05,-3,20,23
172,BES,P008945,P011936,0 days 00:08:39,-5,10,15
172,BES,P007914,P012622,0 days 00:08:15,-4,11,15
172,BES,P003783,P007914,0 days 00:08:10,-11,11,22
172,BES,P012622,P012711,0 days 00:08:00,0,20,20
172,BES,P008945,P012711,0 days 00:07:27,0,19,19
172,BES,P007914,P011924,0 days 00:06:44,-4,10,14
172,BES,P011357,P011936,0 days 00:06:29,-6,9,15
172,BES,P003783,P012622,0 days 00:06:04,-8,10,18
172,BES,P007914,P008945,0 days 00:05:45,0,9,9
172,BES,P007917,P011924,0 days 00:04:15,-2,10,12
172,BES,P007914,P007917,0 days 00:04:13,-2,8,10
172,BES,P011357,P012622,0 days 00:04:09,-3,5,8
172,BES,P011357,P011924,0 days 00:03:39,-4,6,10
172,BES,P003783,P011357,0 days 00:03:39,-4,6,10
172,BES,P007917,P012622,0 days 00:03:13,-3,6,9
172,BES,P008945,P011357,0 days 00:02:50,-2,3,5
172,BES,P007914,P011357,0 days 00:02:50,-2,3,5
172,BES,P011357,P012711,0 days 00:02:20,-3,4,7
172,BES,P007917,P012711,0 days 00:01:13,1,4,3
172,BES,P007917,P008945,0 days 00:00:11,0,0,0
172,BES,P003783,P008945,0 days 00:00:07,0,0,0
172,HTA,P011973,P011991,0 days 00:21:46,9,55,46
172,HTA,P007759,P011973,0 days 00:21:00,5,48,43
172,HTA,P007867,P010550,0 days 00:18:45,4,46,42
172,HTA,P007867,P011973,0 days 00:18:25,9,50,41
172,HTA,P010550,P011973,0 days 00:17:37,2,41,39
172,HTA,P007759,P010550,0 days 00:17:33,9,46,37
172,HTA,P004846,P006835,0 days 00:16:59,12,38,26
172,HTA,P010550,P011991,0 days 00:16:48,8,40,32
172,HTA,P007759,P011991,0 days 00:16:13,6,40,34
172,HTA,P007759,P007867,0 days 00:15:55,8,43,35
172,HTA,P007867,P011991,0 days 00:15:16,8,42,34
172,HTA,P004846,P007867,0 days 00:11:58,5,26,21
172,HTA,P004846,P012794,0 days 00:11:27,7,23,16
172,HTA,P006835,P012794,0 days 00:11:27,7,23,16
172,HTA,P006835,P011991,0 days 00:10:54,13,27,14
172,HTA,P006835,P010465,0 days 00:09:00,2,18,16
172,HTA,P006835,P007867,0 days 00:08:49,6,20,14
172,HTA,P003533,P012794,0 days 00:08:37,0,15,15
172,HTA,P004846,P011991,0 days 00:08:36,10,22,12
172,HTA,P004846,P010550,0 days 00:08:33,6,18,12
172,HTA,P010465,P011973,0 days 00:08:29,3,17,14
172,HTA,P006835,P011973,0 days 00:08:05,8,22,14
172,HTA,P004846,P011973,0 days 00:08:04,4,21,17
172,HTA,P007867,P012794,0 days 00:07:41,3,15,12
172,HTA,P010465,P011991,0 days 00:07:20,3,15,12
172,HTA,P010550,P012794,0 days 00:06:42,12,19,7
172,HTA,P003533,P006835,0 days 00:06:30,-2,9,11
172,HTA,P003533,P004846,0 days 00:06:30,-2,9,11
172,HTA,P007759,P010465,0 days 00:06:25,3,13,10
172,HTA,P004846,P010465,0 days 00:05:57,1,13,12
172,HTA,P006835,P010550,0 days 00:05:31,9,14,5
172,HTA,P010465,P012794,0 days 00:05:05,1,11,10
172,HTA,P003533,P007867,0 days 00:04:44,3,8,5
172,HTA,P003533,P010465,0 days 00:03:53,-3,7,10
172,HTA,P007759,P012794,0 days 00:03:39,4,10,6
172,HTA,P006835,P007759,0 days 00:03:21,5,9,4
172,HTA,P011973,P012794,0 days 00:02:44,2,6,4
172,HTA,P010465,P010550,0 days 00:02:33,3,5,2
172,HTA,P004846,P007759,0 days 00:02:28,1,6,5
172,HTA,P011991,P012794,0 days 00:02:23,7,7,0
172,HTA,P003533,P007759,0 days 00:02:07,2,6,4
172,HTA,P003533,P011973,0 days 00:00:58,-2,0,2
172,HTA,P003533,P012592,0 days 00:00:39,1,3,2
172,HTA,P007759,P012592,0 days 00:00:39,1,3,2
172,HTA,P010465,P012592,0 days 00:00:39,1,3,2
172,HTA,P012592,P012794,0 days 00:00:39,1,3,2
172,HTA,P003533,P010550,0 days 00:00:30,3,3,0
172,HTA,P007867,P010465,0 days 00:00:07,2,2,0
173,PRS,P012608,P012610,0 days 00:21:58,35,70,35
173,PRS,P011232,P012640,0 days 00:21:48,20,60,40
173,PRS,P012608,P012611,0 days 00:18:12,33,59,26
173,PRS,P012610,P012611,0 days 00:18:12,33,59,26
173,PRS,P011232,P012612,0 days 00:18:02,18,49,31
173,PRS,P012612,P012640,0 days 00:18:02,18,49,31
173,PRS,P004512,P012608,0 days 00:17:54,33,59,26
173,PRS,P004512,P012610,0 days 00:17:54,33,59,26
173,PRS,P004512,P012611,0 days 00:17:54,33,59,26
173,PRS,P009556,P011232,0 days 00:17:53,20,49,29
173,PRS,P009556,P012612,0 days 00:17:53,20,49,29
173,PRS,P009556,P012640,0 days 00:17:53,20,49,29
173,PRS,P012610,P012613,0 days 00:17:33,28,54,26
173,PRS,P012608,P012613,0 days 00:17:33,28,54,26
173,PRS,P005793,P011232,0 days 00:16:26,16,43,27
173,PRS,P005793,P012640,0 days 00:16:26,16,43,27
173,PRS,P005793,P012612,0 days 00:16:26,16,43,27
173,PRS,P005793,P009556,0 days 00:16:17,18,43,25
173,PRS,P012611,P012613,0 days 00:13:47,26,43,17
173,PRS,P004512,P012613,0 days 00:13:29,26,43,17
173,PRS,P005793,P012608,0 days 00:04:34,5,16,11
173,PRS,P004512,P005793,0 days 00:04:25,7,16,9
173,PRS,P005793,P012610,0 days 00:04:25,7,16,9
173,PRS,P005793,P012611,0 days 00:04:25,7,16,9
173,PRS,P011232,P012608,0 days 00:04:13,0,11,11
173,PRS,P011232,P012613,0 days 00:04:04,2,11,9
173,PRS,P011232,P012610,0 days 00:04:04,2,11,9
173,PRS,P012608,P012640,0 days 00:03:55,0,11,11
173,PRS,P012610,P012640,0 days 00:03:46,2,11,9
173,PRS,P012613,P012640,0 days 00:03:46,2,11,9
173,PRS,P011232,P012611,0 days 00:01:54,2,6,4
173,PRS,P009556,P012611,0 days 00:01:36,2,6,4
173,PRS,P012611,P012612,0 days 00:01:36,2,6,4
173,PRS,P012611,P012640,0 days 00:01:36,2,6,4
173,PRS,P012608,P012612,0 days 00:00:09,-2,0,2
173,LJU,P005969,P012700,0 days 00:19:46,-22,32,54
173,LJU,P003452,P005969,0 days 00:19:14,-17,40,57
173,LJU,P003514,P005969,0 days 00:18:48,-22,29,51
173,LJU,P005969,P007066,0 days 00:15:17,-20,27,47
173,LJU,P009392,P011261,0 days 00:14:52,-17,28,45
173,LJU,P003452,P007066,0 days 00:14:41,-21,29,50
173,LJU,P010771,P012700,0 days 00:14:20,-18,26,44
173,LJU,P005969,P009392,0 days 00:14:11,-7,33,40
173,LJU,P005969,P010771,0 days 00:14:04,-12,27,39
173,LJU,P003514,P010594,0 days 00:12:47,-23,15,38
173,LJU,P003452,P012700,0 days 00:12:44,-10,23,33
173,LJU,P003514,P012700,0 days 00:12:01,-17,15,32
173,LJU,P003452,P003514,0 days 00:11:53,-15,22,37
173,LJU,P003514,P009392,0 days 00:11:44,-16,13,29
173,LJU,P009392,P010771,0 days 00:11:01,-10,21,31
173,LJU,P003514,P007066,0 days 00:10:16,-15,16,31
173,LJU,P002561,P010594,0 days 00:10:07,-23,10,33
173,LJU,P007066,P010594,0 days 00:09:23,-19,12,31
173,LJU,P003514,P010771,0 days 00:09:23,-13,13,26
173,LJU,P005969,P011261,0 days 00:09:18,-6,24,30
173,LJU,P010594,P011261,0 days 00:09:16,-17,10,27
173,LJU,P003514,P011261,0 days 00:09:11,-12,11,23
173,LJU,P010771,P011261,0 days 00:08:58,-14,16,30
173,LJU,P007066,P012700,0 days 00:08:58,-13,10,23
173,LJU,P005969,P010594,0 days 00:08:54,-14,12,26
173,LJU,P002561,P011261,0 days 00:08:44,-19,8,27
173,LJU,P010594,P012700,0 days 00:08:13,-17,7,24
173,LJU,P003452,P010594,0 days 00:07:46,-17,12,29
173,LJU,P009392,P012700,0 days 00:07:45,-7,16,23
173,LJU,P002561,P003514,0 days 00:06:57,-15,6,21
173,LJU,P009392,P010594,0 days 00:06:06,-9,6,15
173,LJU,P011261,P012700,0 days 00:05:53,-11,11,22
173,LJU,P002561,P009392,0 days 00:05:34,-11,4,15
173,LJU,P003452,P010771,0 days 00:05:34,1,13,12
173,LJU,P003452,P009392,0 days 00:05:09,4,17,13
173,LJU,P002561,P010771,0 days 00:03:32,-9,4,13
173,LJU,P002561,P012700,0 days 00:03:32,-9,4,13
173,LJU,P010594,P010771,0 days 00:03:32,-9,4,13
173,LJU,P003452,P011261,0 days 00:02:58,-2,10,12
173,LJU,P007066,P011261,0 days 00:02:58,-2,10,12
173,LJU,P007066,P009392,0 days 00:02:38,1,10,9
173,LJU,P002561,P003452,0 days 00:01:01,-3,2,5
173,LJU,P002561,P007066,0 days 00:01:01,-3,2,5
174,LLI,P012586,P012797,0 days 00:20:25,-10,36,46
174,LLI,P006600,P012797,0 days 00:20:19,-8,41,49
174,LLI,P005247,P009680,0 days 00:18:30,3,41,38
174,LLI,P006600,P012586,0 days 00:17:08,-10,32,42
174,LLI,P005247,P012797,0 days 00:15:15,0,30,30
174,LLI,P012585,P012586,0 days 00:15:09,5,29,24
174,LLI,P012585,P012797,0 days 00:14:37,5,31,26
174,LLI,P009680,P012020,0 days 00:13:53,5,32,27
174,LLI,P004773,P012586,0 days 00:13:31,-8,26,34
174,LLI,P009649,P012797,0 days 00:12:44,-10,23,33
174,LLI,P004773,P009680,0 days 00:12:38,-1,25,26
174,LLI,P009680,P012586,0 days 00:12:22,-2,28,30
174,LLI,P009680,P012797,0 days 00:12:21,-3,25,28
174,LLI,P006600,P009649,0 days 00:12:15,-9,23,32
174,LLI,P009649,P012586,0 days 00:12:13,-10,21,31
174,LLI,P005247,P006600,0 days 00:12:00,-1,25,26
174,LLI,P006600,P012585,0 days 00:11:53,4,25,21
174,LLI,P005247,P012586,0 days 00:11:34,-1,24,25
174,LLI,P009680,P012585,0 days 00:11:29,9,28,19
174,LLI,P005247,P012585,0 days 00:11:09,8,27,19
174,LLI,P004773,P012020,0 days 00:10:55,-4,20,24
174,LLI,P005247,P012020,0 days 00:10:11,3,23,20
174,LLI,P004773,P005247,0 days 00:09:50,-4,17,21
174,LLI,P012020,P012586,0 days 00:09:33,0,20,20
174,LLI,P006600,P009680,0 days 00:09:06,-4,20,24
174,LLI,P004773,P012797,0 days 00:08:23,-11,10,21
174,LLI,P004773,P006600,0 days 00:08:10,-6,13,19
174,LLI,P012020,P012585,0 days 00:07:48,6,19,13
174,LLI,P012020,P012797,0 days 00:05:48,-3,8,11
174,LLI,P009649,P012585,0 days 00:05:38,1,10,9
174,LLI,P004773,P009649,0 days 00:05:20,-10,7,17
174,LLI,P005247,P008274,0 days 00:04:48,6,11,5
174,LLI,P004773,P012585,0 days 00:04:35,2,9,7
174,LLI,P008274,P009680,0 days 00:04:35,6,11,5
174,LLI,P004773,P008274,0 days 00:02:58,2,5,3
174,LLI,P006600,P008274,0 days 00:02:45,2,5,3
174,LLI,P009649,P009680,0 days 00:02:26,-5,6,11
174,LLI,P008274,P012020,0 days 00:02:03,4,6,2
174,LLI,P008274,P012585,0 days 00:01:50,4,6,2
174,LLI,P005247,P009649,0 days 00:00:51,-2,2,4
174,LLI,P009649,P012020,0 days 00:00:49,-3,0,3
174,LLI,P008274,P012586,0 days 00:00:13,0,0,0
174,WOL,P005516,P006546,0 days 00:25:25,10,57,47
174,WOL,P004645,P005516,0 days 00:23:24,6,48,42
174,WOL,P004645,P006546,0 days 00:20:35,8,45,37
174,WOL,P005516,P012576,0 days 00:18:29,9,43,34
174,WOL,P006546,P012576,0 days 00:18:29,9,43,34
174,WOL,P005516,P006154,0 days 00:17:50,3,38,35
174,WOL,P004645,P006154,0 days 00:16:09,1,32,31
174,WOL,P006154,P006546,0 days 00:14:28,5,35,30
174,WOL,P006154,P012576,0 days 00:14:26,10,39,29
174,WOL,P004645,P012576,0 days 00:13:39,7,31,24
174,WOL,P012577,P012789,0 days 00:11:42,-5,20,25
174,WOL,P002387,P003212,0 days 00:11:11,-3,25,28
174,WOL,P006907,P012576,0 days 00:10:25,4,23,19
174,WOL,P005516,P006907,0 days 00:10:22,4,23,19
174,WOL,P006546,P006907,0 days 00:10:04,4,23,19
174,WOL,P006154,P012789,0 days 00:09:40,-8,15,23
174,WOL,P003212,P012789,0 days 00:09:29,0,22,22
174,WOL,P002387,P012577,0 days 00:08:55,-5,21,26
174,WOL,P003212,P012577,0 days 00:08:44,-5,21,26
174,WOL,P006154,P012577,0 days 00:08:44,-3,17,20
174,WOL,P005516,P012789,0 days 00:08:43,-3,15,18
174,WOL,P006546,P012789,0 days 00:08:43,-5,19,24
174,WOL,P004645,P012789,0 days 00:08:10,-3,15,18
174,WOL,P002387,P006154,0 days 00:08:04,1,18,17
174,WOL,P003212,P006154,0 days 00:07:51,1,18,17
174,WOL,P002387,P012789,0 days 00:07:44,-4,16,20
174,WOL,P003212,P006546,0 days 00:06:57,1,16,15
174,WOL,P006546,P012577,0 days 00:06:18,-7,8,15
174,WOL,P005516,P012577,0 days 00:06:18,-5,4,9
174,WOL,P006154,P006907,0 days 00:05:32,6,12,6
174,WOL,P003212,P012576,0 days 00:05:19,2,12,10
174,WOL,P004645,P006907,0 days 00:05:12,2,11,9
174,WOL,P002387,P012576,0 days 00:04:29,4,12,8
174,WOL,P002387,P006546,0 days 00:04:09,-1,10,11
174,WOL,P004645,P012577,0 days 00:04:07,-1,4,5
174,WOL,P003212,P006907,0 days 00:03:46,3,7,4
174,WOL,P003212,P005516,0 days 00:03:35,5,9,4
174,WOL,P012576,P012577,0 days 00:03:20,-5,5,10
174,WOL,P002387,P006907,0 days 00:03:18,5,7,2
174,WOL,P003212,P004645,0 days 00:02:20,4,6,2
174,WOL,P006907,P012577,0 days 00:02:00,-4,0,4
174,WOL,P002387,P005516,0 days 00:01:02,3,3,0
174,WOL,P006907,P012789,0 days 00:00:53,0,2,2
175,HAM,P009663,P012581,0 days 00:20:48,-2,51,53
175,HAM,P009663,P012580,0 days 00:17:01,-8,36,44
175,HAM,P012580,P012581,0 days 00:14:53,-10,31,41
175,HAM,P009663,P012579,0 days 00:14:41,6,35,29
175,HAM,P011168,P012581,0 days 00:13:38,2,35,33
175,HAM,P012581,P012694,0 days 00:12:30,1,28,27
175,HAM,P001990,P012580,0 days 00:12:29,-8,21,29
175,HAM,P009663,P011168,0 days 00:12:18,1,33,32
175,HAM,P001990,P009663,0 days 00:12:15,-4,25,29
175,HAM,P012579,P012581,0 days 00:11:07,6,30,24
175,HAM,P012579,P012694,0 days 00:10:53,0,23,23
175,HAM,P009663,P012694,0 days 00:10:14,2,26,24
175,HAM,P011187,P012648,0 days 00:10:00,-4,15,19
175,HAM,P001990,P012579,0 days 00:09:45,2,19,17
175,HAM,P009663,P010070,0 days 00:09:29,-1,21,22
175,HAM,P001990,P012581,0 days 00:08:50,-7,18,25
175,HAM,P011187,P012579,0 days 00:08:49,-3,14,17
175,HAM,P011168,P012694,0 days 00:08:43,-4,19,23
175,HAM,P011168,P012580,0 days 00:08:37,-2,20,22
175,HAM,P012579,P012648,0 days 00:08:11,-1,13,14
175,HAM,P012579,P012580,0 days 00:08:07,-7,10,17
175,HAM,P011187,P012695,0 days 00:07:43,0,15,15
175,HAM,P011187,P012694,0 days 00:07:31,-1,11,12
175,HAM,P010070,P012579,0 days 00:07:31,8,19,11
175,HAM,P012579,P012695,0 days 00:07:27,3,15,12
175,HAM,P010070,P012581,0 days 00:06:54,1,17,16
175,HAM,P011187,P012581,0 days 00:06:49,-2,13,15
175,HAM,P012580,P012694,0 days 00:06:28,1,14,13
175,HAM,P011168,P012579,0 days 00:06:18,-2,15,17
175,HAM,P012581,P012582,0 days 00:06:17,-5,14,19
175,HAM,P012648,P012695,0 days 00:06:14,-2,10,12
175,HAM,P010070,P012580,0 days 00:05:53,-7,10,17
175,HAM,P012648,P012694,0 days 00:05:39,0,9,9
175,HAM,P011187,P012580,0 days 00:05:35,-7,5,12
175,HAM,P001990,P012694,0 days 00:05:20,2,11,9
175,HAM,P001990,P012648,0 days 00:05:17,2,11,9
175,HAM,P012581,P012695,0 days 00:05:09,1,11,10
175,HAM,P012580,P012648,0 days 00:05:03,-2,9,11
175,HAM,P012580,P012582,0 days 00:04:48,-5,8,13
175,HAM,P009663,P012582,0 days 00:04:48,-5,8,13
175,HAM,P001990,P010070,0 days 00:04:22,-5,6,11
175,HAM,P001990,P011187,0 days 00:03:57,-2,5,7
175,HAM,P012694,P012695,0 days 00:03:42,3,7,4
175,HAM,P012581,P012648,0 days 00:03:33,-1,8,9
175,HAM,P010070,P011168,0 days 00:03:25,3,12,9
175,HAM,P001990,P012582,0 days 00:02:33,-4,4,8
175,HAM,P010070,P012695,0 days 00:02:22,3,5,2
175,HAM,P011168,P012582,0 days 00:02:15,-1,4,5
175,HAM,P011168,P011187,0 days 00:02:05,-3,2,5
175,HAM,P011187,P012582,0 days 00:01:51,0,6,6
175,HAM,P012582,P012695,0 days 00:01:51,0,6,6
175,HAM,P009663,P012648,0 days 00:01:44,2,6,4
175,HAM,P009663,P012695,0 days 00:01:42,1,3,2
175,HAM,P012580,P012695,0 days 00:01:30,-5,0,5
175,HAM,P012579,P012582,0 days 00:01:11,0,3,3
175,HAM,P012582,P012648,0 days 00:01:02,0,3,3
175,HAM,P010070,P011187,0 days 00:00:40,2,2,0
175,HAM,P011168,P012648,0 days 00:00:13,-2,0,2
175,VNC,P004117,P008052,0 days 00:20:27,9,48,39
175,VNC,P004117,P012587,0 days 00:18:39,4,41,37
175,VNC,P008052,P012587,0 days 00:17:47,4,41,37
175,VNC,P004381,P011928,0 days 00:16:09,-5,30,35
175,VNC,P004381,P012591,0 days 00:14:58,10,38,28
175,VNC,P009400,P012591,0 days 00:14:39,-5,30,35
175,VNC,P004117,P004381,0 days 00:14:15,6,33,27
175,VNC,P003759,P004381,0 days 00:13:51,19,42,23
175,VNC,P004381,P012587,0 days 00:13:36,7,33,26
175,VNC,P004381,P008052,0 days 00:13:12,11,33,22
175,VNC,P011928,P012591,0 days 00:13:00,-1,28,29
175,VNC,P003759,P004117,0 days 00:12:22,10,34,24
175,VNC,P012588,P012591,0 days 00:12:17,-5,27,32
175,VNC,P003759,P012591,0 days 00:11:59,4,29,25
175,VNC,P004117,P011928,0 days 00:11:16,-1,19,20
175,VNC,P003759,P008052,0 days 00:11:07,12,31,19
175,VNC,P011928,P012587,0 days 00:10:45,-3,19,22
175,VNC,P004381,P009400,0 days 00:09:55,5,24,19
175,VNC,P008052,P011928,0 days 00:09:52,-7,17,24
175,VNC,P004381,P012588,0 days 00:09:32,3,23,20
175,VNC,P003759,P012587,0 days 00:09:31,8,27,19
175,VNC,P008052,P012259,0 days 00:09:26,-1,20,21
175,VNC,P009400,P012588,0 days 00:09:19,-6,17,23
175,VNC,P009400,P011928,0 days 00:09:15,-5,18,23
175,VNC,P003759,P009400,0 days 00:09:08,2,22,20
175,VNC,P004117,P012259,0 days 00:08:54,3,20,17
175,VNC,P003759,P012259,0 days 00:07:39,-7,14,21
175,VNC,P012259,P012587,0 days 00:07:15,0,15,15
175,VNC,P011928,P012588,0 days 00:06:59,-3,12,15
175,VNC,P012259,P012591,0 days 00:06:23,-7,11,18
175,VNC,P011928,P012259,0 days 00:05:59,0,12,12
175,VNC,P008052,P012591,0 days 00:05:26,8,14,6
175,VNC,P003759,P011928,0 days 00:05:17,5,13,8
175,VNC,P003759,P012588,0 days 00:05:06,-5,12,17
175,VNC,P009400,P012259,0 days 00:04:44,-10,6,16
175,VNC,P004117,P012591,0 days 00:04:30,5,12,7
175,VNC,P012259,P012588,0 days 00:04:12,-6,6,12
175,VNC,P012587,P012588,0 days 00:03:39,5,9,4
175,VNC,P004117,P012588,0 days 00:02:13,0,5,5
175,VNC,P012587,P012591,0 days 00:02:12,3,7,4
175,VNC,P008052,P012588,0 days 00:01:39,5,5,0
175,VNC,P008052,P009400,0 days 00:01:36,-1,3,4
176,BOU,P010449,P012628,0 days 00:17:27,-8,33,41
176,BOU,P010718,P011836,0 days 00:16:58,3,35,32
176,BOU,P010450,P011161,0 days 00:16:01,5,35,30
176,BOU,P010450,P012628,0 days 00:15:49,-1,31,32
176,BOU,P011161,P012628,0 days 00:15:35,-4,29,33
176,BOU,P010449,P010718,0 days 00:15:14,10,37,27
176,BOU,P000498,P010718,0 days 00:14:13,-13,22,35
176,BOU,P010449,P012618,0 days 00:13:56,9,35,26
176,BOU,P010449,P011836,0 days 00:13:06,4,28,24
176,BOU,P010449,P011161,0 days 00:13:02,-5,27,32
176,BOU,P010449,P010450,0 days 00:12:23,-6,23,29
176,BOU,P012618,P012628,0 days 00:12:15,5,29,24
176,BOU,P010450,P012619,0 days 00:12:05,-8,21,29
176,BOU,P011161,P012619,0 days 00:11:51,0,24,24
176,BOU,P010718,P011837,0 days 00:10:37,-9,14,23
176,BOU,P000498,P011836,0 days 00:10:37,-9,14,23
176,BOU,P011836,P011837,0 days 00:10:37,-9,14,23
176,BOU,P000498,P011837,0 days 00:10:37,-9,14,23
176,BOU,P012619,P012628,0 days 00:10:32,-5,19,24
176,BOU,P010718,P012618,0 days 00:09:35,14,29,15
176,BOU,P010450,P012618,0 days 00:09:20,7,24,17
176,BOU,P010718,P012617,0 days 00:09:11,-10,15,25
176,BOU,P010450,P012617,0 days 00:09:02,5,22,17
176,BOU,P000498,P012617,0 days 00:08:52,-10,15,25
176,BOU,P012617,P012619,0 days 00:08:27,0,17,17
176,BOU,P010450,P010718,0 days 00:07:24,-2,16,18
176,BOU,P010718,P012628,0 days 00:07:09,5,18,13
176,BOU,P011836,P012628,0 days 00:06:52,3,15,12
176,BOU,P011161,P012618,0 days 00:06:47,4,17,13
176,BOU,P010449,P012619,0 days 00:06:18,-10,11,21
176,BOU,P011161,P012617,0 days 00:05:36,9,14,5
176,BOU,P011836,P012617,0 days 00:05:26,-6,7,13
176,BOU,P000498,P010449,0 days 00:05:21,-3,7,10
176,BOU,P010449,P011837,0 days 00:05:21,-3,7,10
176,BOU,P011836,P012618,0 days 00:05:18,8,15,7
176,BOU,P012617,P012628,0 days 00:05:17,9,14,5
176,BOU,P011837,P012617,0 days 00:05:16,-6,7,13
176,BOU,P010718,P012619,0 days 00:04:16,-6,10,16
176,BOU,P000498,P010450,0 days 00:03:36,-4,8,12
176,BOU,P010718,P011161,0 days 00:03:03,8,12,4
176,BOU,P000498,P012619,0 days 00:02:51,-9,3,12
176,BOU,P011161,P011836,0 days 00:02:37,-1,6,7
176,BOU,P011836,P012619,0 days 00:02:37,-1,6,7
176,BOU,P000498,P012618,0 days 00:00:45,5,5,0
176,BOU,P012617,P012618,0 days 00:00:45,5,5,0
176,BOU,P012618,P012619,0 days 00:00:03,-1,1,2
176,ULM,P010582,P012603,0 days 00:23:11,10,51,41
176,ULM,P010582,P012703,0 days 00:21:16,2,42,40
176,ULM,P012603,P012703,0 days 00:20:41,-2,40,42
176,ULM,P012604,P012703,0 days 00:20:39,-4,43,47
176,ULM,P012603,P012604,0 days 00:20:15,-1,43,44
176,ULM,P010582,P012604,0 days 00:18:41,4,43,39
176,ULM,P005422,P012703,0 days 00:17:46,5,37,32
176,ULM,P005422,P010582,0 days 00:14:46,8,29,21
176,ULM,P005422,P012603,0 days 00:12:35,6,25,19
176,ULM,P010726,P011457,0 days 00:11:22,1,27,26
176,ULM,P010726,P011188,0 days 00:11:20,2,28,26
176,ULM,P011188,P012703,0 days 00:10:37,-7,19,26
176,ULM,P005422,P007952,0 days 00:10:18,5,20,15
176,ULM,P007952,P011188,0 days 00:10:13,-1,21,22
176,ULM,P005422,P012604,0 days 00:10:03,3,23,20
176,ULM,P010726,P012703,0 days 00:10:02,-11,17,28
176,ULM,P011457,P012703,0 days 00:10:01,-15,13,28
176,ULM,P005422,P010726,0 days 00:09:43,3,24,21
176,ULM,P005422,P011188,0 days 00:09:43,3,24,21
176,ULM,P007952,P010726,0 days 00:09:34,0,21,21
176,ULM,P011457,P012603,0 days 00:09:32,-3,19,22
176,ULM,P010582,P011457,0 days 00:09:20,4,22,18
176,ULM,P011457,P012604,0 days 00:08:53,-5,16,21
176,ULM,P007952,P012703,0 days 00:08:23,-6,10,16
176,ULM,P010726,P012603,0 days 00:07:24,0,15,15
176,ULM,P011188,P011457,0 days 00:07:00,-1,16,17
176,ULM,P007952,P010582,0 days 00:06:58,6,11,5
176,ULM,P010582,P010726,0 days 00:06:21,11,18,7
176,ULM,P007952,P011457,0 days 00:05:41,-2,13,15
176,ULM,P010726,P012604,0 days 00:05:34,-2,10,12
176,ULM,P010582,P011188,0 days 00:04:26,3,9,6
176,ULM,P010726,P011391,0 days 00:03:36,4,12,8
176,ULM,P010582,P012066,0 days 00:03:31,1,9,8
176,ULM,P012066,P012603,0 days 00:03:31,1,9,8
176,ULM,P012066,P012703,0 days 00:03:31,1,9,8
176,ULM,P012066,P012604,0 days 00:03:31,1,9,8
176,ULM,P007952,P012603,0 days 00:03:25,2,4,2
176,ULM,P005422,P011457,0 days 00:02:21,2,8,6
176,ULM,P011391,P012703,0 days 00:02:16,1,6,5
176,ULM,P011188,P012604,0 days 00:02:12,0,5,5
176,ULM,P010582,P011391,0 days 00:01:58,3,6,3
176,ULM,P011391,P011457,0 days 00:01:58,3,6,3
176,ULM,P011391,P012603,0 days 00:01:58,3,6,3
176,ULM,P005422,P011391,0 days 00:01:57,1,6,5
176,ULM,P011188,P011391,0 days 00:01:57,1,6,5
177,ARI,P003240,P012615,0 days 00:19:09,14,44,30
177,ARI,P004292,P012716,0 days 00:16:24,2,36,34
177,ARI,P012716,P012792,0 days 00:15:33,7,39,32
177,ARI,P003240,P012792,0 days 00:14:14,-4,28,32
177,ARI,P002867,P003240,0 days 00:14:09,5,27,22
177,ARI,P012716,P012717,0 days 00:14:00,-11,22,33
177,ARI,P004292,P012717,0 days 00:13:26,-13,22,35
177,ARI,P012615,P012792,0 days 00:12:54,12,35,23
177,ARI,P010387,P012716,0 days 00:12:35,10,36,26
177,ARI,P012702,P012792,0 days 00:12:14,-11,18,29
177,ARI,P012615,P012716,0 days 00:11:54,17,36,19
177,ARI,P003240,P012716,0 days 00:11:51,7,28,21
177,ARI,P003240,P004292,0 days 00:11:39,8,25,17
177,ARI,P012717,P012792,0 days 00:10:42,-11,16,27
177,ARI,P004292,P012615,0 days 00:10:32,19,30,11
177,ARI,P003240,P012702,0 days 00:10:11,0,19,19
177,ARI,P012702,P012716,0 days 00:10:04,-2,19,21
177,ARI,P004292,P012702,0 days 00:10:02,-3,20,23
177,ARI,P012702,P012717,0 days 00:09:40,-8,15,23
177,ARI,P002867,P012615,0 days 00:09:31,6,19,13
177,ARI,P004292,P012792,0 days 00:09:10,1,22,21
177,ARI,P012716,P012760,0 days 00:08:18,-6,12,18
177,ARI,P010387,P012792,0 days 00:07:54,16,29,13
177,ARI,P002867,P012702,0 days 00:07:37,-2,11,13
177,ARI,P002867,P012722,0 days 00:07:33,5,16,11
177,ARI,P002867,P012792,0 days 00:07:32,-5,10,15
177,ARI,P003240,P012722,0 days 00:07:27,5,16,11
177,ARI,P010387,P012615,0 days 00:07:26,14,27,13
177,ARI,P004292,P012760,0 days 00:07:12,-6,10,16
177,ARI,P012615,P012702,0 days 00:07:03,2,14,12
177,ARI,P003240,P012717,0 days 00:06:48,-6,10,16
177,ARI,P004292,P010387,0 days 00:06:42,2,17,15
177,ARI,P002867,P004292,0 days 00:06:02,7,14,7
177,ARI,P012717,P012760,0 days 00:05:47,-6,9,15
177,ARI,P002867,P012717,0 days 00:05:39,-3,8,11
177,ARI,P003240,P010387,0 days 00:05:11,5,16,11
177,ARI,P010387,P012717,0 days 00:05:10,-4,9,13
177,ARI,P010387,P012760,0 days 00:05:09,-4,9,13
177,ARI,P004292,P012722,0 days 00:04:43,7,12,5
177,ARI,P012615,P012722,0 days 00:04:25,7,11,4
177,ARI,P003240,P012760,0 days 00:03:09,-2,3,5
177,ARI,P012717,P012722,0 days 00:03:08,-2,5,7
177,ARI,P012722,P012792,0 days 00:02:50,-2,4,6
177,ARI,P002867,P012716,0 days 00:02:36,-1,3,4
177,ARI,P012615,P012760,0 days 00:02:31,0,3,3
177,ARI,P012760,P012792,0 days 00:01:06,0,2,2
177,ARI,P010177,P010387,0 days 00:00:15,1,1,0
177,ARI,P010177,P012615,0 days 00:00:15,1,1,0
177,ARI,P010177,P012716,0 days 00:00:15,1,1,0
177,ARI,P010177,P012792,0 days 00:00:15,1,1,0
177,ARI,P012716,P012722,0 days 00:00:06,0,0,0
177,ARI,P002867,P010387,0 days 00:00:01,0,0,0
177,ARI,P010387,P012702,0 days 00:00:01,0,0,0
177,TRN,P012595,P012597,0 days 00:23:38,-11,50,61
177,TRN,P005059,P012595,0 days 00:23:21,-6,45,51
177,TRN,P009903,P012595,0 days 00:20:17,-13,39,52
177,TRN,P009903,P012597,0 days 00:19:50,-13,37,50
177,TRN,P005738,P012595,0 days 00:19:25,4,42,38
177,TRN,P005059,P005738,0 days 00:19:25,4,42,38
177,TRN,P005059,P012597,0 days 00:18:04,-4,39,43
177,TRN,P005059,P009903,0 days 00:17:36,-4,39,43
177,TRN,P001479,P012596,0 days 00:16:52,3,33,30
177,TRN,P005738,P009903,0 days 00:16:34,1,37,36
177,TRN,P001479,P012597,0 days 00:16:30,-1,32,33
177,TRN,P005738,P012597,0 days 00:16:06,1,35,34
177,TRN,P006382,P012596,0 days 00:15:54,4,25,21
177,TRN,P001479,P007828,0 days 00:15:42,-1,30,31
177,TRN,P007828,P012597,0 days 00:15:33,-1,30,31
177,TRN,P012596,P012597,0 days 00:13:49,8,32,24
177,TRN,P001479,P006382,0 days 00:13:03,1,20,19
177,TRN,P007828,P012596,0 days 00:13:01,8,30,22
177,TRN,P006382,P012597,0 days 00:11:02,1,21,20
177,TRN,P012595,P012596,0 days 00:09:43,0,19,19
177,TRN,P001479,P012595,0 days 00:09:33,-12,14,26
177,TRN,P006382,P007828,0 days 00:09:12,6,17,11
177,TRN,P005059,P006382,0 days 00:08:11,-7,12,19
177,TRN,P006382,P012595,0 days 00:07:24,-7,10,17
177,TRN,P005059,P012596,0 days 00:06:41,-2,8,10
177,TRN,P007828,P012595,0 days 00:06:39,-7,13,20
177,TRN,P001479,P005059,0 days 00:03:50,-5,3,8
177,TRN,P005738,P006382,0 days 00:03:19,3,7,4
177,TRN,P005738,P012596,0 days 00:02:51,3,5,2
177,TRN,P001479,P009903,0 days 00:02:42,-9,0,9
177,TRN,P007828,P009903,0 days 00:02:41,-9,0,9
177,TRN,P006382,P009903,0 days 00:01:31,-5,4,9
177,TRN,P009903,P012596,0 days 00:00:01,0,0,0
178,BUD,P008325,P011935,0 days 00:17:54,26,53,27
178,BUD,P007398,P008325,0 days 00:15:29,21,42,21
178,BUD,P010389,P011935,0 days 00:15:10,14,39,25
178,BUD,P006566,P011281,0 days 00:15:01,6,33,27
178,BUD,P006566,P010248,0 days 00:13:10,-5,22,27
178,BUD,P010248,P011281,0 days 00:12:40,1,24,23
178,BUD,P007398,P011935,0 days 00:12:32,19,36,17
178,BUD,P008325,P010389,0 days 00:12:15,15,36,21
178,BUD,P007398,P011281,0 days 00:11:39,13,32,19
178,BUD,P011935,P012606,0 days 00:10:54,13,31,18
178,BUD,P008325,P012606,0 days 00:10:42,15,31,16
178,BUD,P005637,P010248,0 days 00:10:36,-2,19,21
178,BUD,P008325,P011281,0 days 00:10:21,11,28,17
178,BUD,P007398,P010389,0 days 00:10:10,0,22,22
178,BUD,P011281,P011935,0 days 00:10:07,10,25,15
178,BUD,P005637,P006566,0 days 00:10:03,-2,19,21
178,BUD,P005637,P011281,0 days 00:09:43,1,19,18
178,BUD,P010389,P012606,0 days 00:09:42,13,29,16
178,BUD,P006566,P011935,0 days 00:08:46,6,20,14
178,BUD,P010248,P010389,0 days 00:08:37,-10,11,21
178,BUD,P010389,P012630,0 days 00:08:03,-5,18,23
178,BUD,P010248,P012630,0 days 00:07:50,-10,13,23
178,BUD,P010389,P011281,0 days 00:07:41,2,15,13
178,BUD,P007398,P012630,0 days 00:07:40,-7,13,20
178,BUD,P004945,P005637,0 days 00:07:30,0,14,14
178,BUD,P004945,P011281,0 days 00:07:30,0,14,14
178,BUD,P012606,P012630,0 days 00:07:10,3,19,16
178,BUD,P008325,P012630,0 days 00:07:00,6,19,13
178,BUD,P007398,P009214,0 days 00:06:40,-9,11,20
178,BUD,P009214,P012630,0 days 00:06:40,-9,11,20
178,BUD,P007398,P012606,0 days 00:06:20,8,16,8
178,BUD,P006566,P010389,0 days 00:06:08,0,10,10
178,BUD,P007398,P010248,0 days 00:05:59,-10,9,19
178,BUD,P004945,P010248,0 days 00:05:47,-1,10,11
178,BUD,P006566,P008325,0 days 00:05:39,9,17,8
178,BUD,P011935,P012630,0 days 00:05:34,7,17,10
178,BUD,P004945,P006566,0 days 00:05:14,-1,10,11
178,BUD,P009214,P010248,0 days 00:05:14,-8,9,17
178,BUD,P006566,P007398,0 days 00:04:51,7,15,8
178,BUD,P011281,P012630,0 days 00:04:11,3,10,7
178,BUD,P006566,P012606,0 days 00:03:48,-2,6,8
178,BUD,P009214,P010389,0 days 00:03:29,-10,3,13
178,BUD,P009214,P011281,0 days 00:03:11,1,8,7
178,BUD,P010248,P011935,0 days 00:03:07,-3,3,6
178,BUD,P010248,P012606,0 days 00:02:48,-4,4,8
178,BUD,P006566,P012630,0 days 00:02:36,-2,4,6
178,BUD,P005637,P012630,0 days 00:02:36,-2,4,6
178,BUD,P005637,P012606,0 days 00:02:36,-2,4,6
178,BUD,P004945,P007398,0 days 00:02:16,1,4,3
178,BUD,P005637,P007398,0 days 00:02:16,1,4,3
178,BUD,P005637,P010389,0 days 00:02:13,1,5,4
178,BUD,P004945,P008325,0 days 00:01:43,1,4,3
178,BUD,P005637,P008325,0 days 00:01:43,1,4,3
178,BUD,P008325,P009214,0 days 00:01:26,-1,2,3
178,CAN,P006588,P008121,0 days 00:23:16,-3,47,50
178,CAN,P003425,P008121,0 days 00:22:38,1,47,46
178,CAN,P003425,P006588,0 days 00:22:22,-3,45,48
178,CAN,P007644,P008121,0 days 00:18:10,-6,34,40
178,CAN,P006588,P007644,0 days 00:17:34,-4,32,36
178,CAN,P003425,P007644,0 days 00:14:14,3,30,27
178,CAN,P005005,P008121,0 days 00:12:01,-2,26,28
178,CAN,P003637,P008121,0 days 00:11:37,-6,17,23
178,CAN,P010385,P010452,0 days 00:10:57,-2,22,24
178,CAN,P003425,P005005,0 days 00:10:35,5,26,21
178,CAN,P005005,P006588,0 days 00:10:24,3,24,21
178,CAN,P001607,P010452,0 days 00:09:54,-7,18,25
178,CAN,P007560,P010452,0 days 00:09:51,2,21,19
178,CAN,P003637,P006588,0 days 00:09:13,-5,13,18
178,CAN,P008121,P010385,0 days 00:09:07,-3,19,22
178,CAN,P003425,P010385,0 days 00:09:01,-2,19,21
178,CAN,P005005,P007644,0 days 00:08:51,0,17,17
178,CAN,P007560,P010385,0 days 00:08:26,4,21,17
178,CAN,P003425,P003637,0 days 00:08:24,-3,11,14
178,CAN,P004466,P007560,0 days 00:08:11,6,20,14
178,CAN,P001607,P010385,0 days 00:08:09,-1,19,20
178,CAN,P001607,P007560,0 days 00:07:58,1,17,16
178,CAN,P006588,P010385,0 days 00:07:35,-1,18,19
178,CAN,P003637,P007644,0 days 00:06:32,-2,10,12
178,CAN,P004466,P010452,0 days 00:06:18,8,17,9
178,CAN,P003637,P010385,0 days 00:06:04,-8,7,15
178,CAN,P001607,P004466,0 days 00:05:57,3,15,12
178,CAN,P004466,P010385,0 days 00:05:48,6,17,11
178,CAN,P001607,P007644,0 days 00:05:27,-12,4,16
178,CAN,P005005,P010385,0 days 00:05:24,1,14,13
178,CAN,P003425,P004160,0 days 00:05:11,-5,12,17
178,CAN,P001607,P008121,0 days 00:04:39,-10,6,16
178,CAN,P004160,P006588,0 days 00:04:34,-5,10,15
178,CAN,P004160,P010452,0 days 00:04:32,-10,4,14
178,CAN,P001607,P003637,0 days 00:04:12,-7,6,13
178,CAN,P008121,P010452,0 days 00:04:01,-6,6,12
178,CAN,P005005,P010452,0 days 00:03:51,-2,7,9
178,CAN,P001607,P006588,0 days 00:03:42,-6,5,11
178,CAN,P004160,P008121,0 days 00:03:39,-1,10,11
178,CAN,P004160,P007644,0 days 00:03:39,-1,10,11
178,CAN,P004160,P010385,0 days 00:03:37,-6,4,10
178,CAN,P004160,P007560,0 days 00:03:33,-6,4,10
178,CAN,P003637,P010452,0 days 00:03:23,-5,4,9
178,CAN,P001607,P004160,0 days 00:03:00,-6,2,8
178,CAN,P007644,P010452,0 days 00:02:59,-2,5,7
178,CAN,P006588,P007560,0 days 00:02:48,-6,3,9
178,CAN,P003425,P010452,0 days 00:02:43,-4,4,8
178,CAN,P007560,P007644,0 days 00:02:23,0,3,3
178,CAN,P004466,P007644,0 days 00:02:23,0,3,3
178,CAN,P005005,P007560,0 days 00:02:14,3,5,2
178,CAN,P004466,P005005,0 days 00:02:14,3,5,2
178,CAN,P004466,P006588,0 days 00:01:53,-2,3,5
178,CAN,P003425,P007560,0 days 00:01:32,-4,2,6
178,CAN,P001607,P005005,0 days 00:01:26,-7,0,7
178,CAN,P003637,P004160,0 days 00:00:59,-4,0,4
178,CAN,P006588,P010452,0 days 00:00:55,-4,0,4
179,LKB,P007029,PLXI,0 days 00:29:17,-13,54,67
179,LKB,P009898,P010461,0 days 00:27:46,12,68,56
179,LKB,P009898,PLXI,0 days 00:27:35,4,62,58
179,LKB,P010461,PLXI,0 days 00:25:20,8,56,48
179,LKB,P007029,P009898,0 days 00:25:13,-4,52,56
179,LKB,P007029,P010461,0 days 00:25:00,6,55,49
179,LKB,P011329,PLXI,0 days 00:16:16,2,38,36
179,LKB,P006901,P007029,0 days 00:15:49,-3,38,41
179,LKB,P009898,P010190,0 days 00:15:43,14,45,31
179,LKB,P010190,P010461,0 days 00:14:47,14,42,28
179,LKB,P010461,P011329,0 days 00:13:47,9,34,25
179,LKB,P007029,P011329,0 days 00:13:42,-4,28,32
179,LKB,P005521,PLXI,0 days 00:13:21,-8,25,33
179,LKB,P005521,P007029,0 days 00:13:17,-6,25,31
179,LKB,P006901,PLXI,0 days 00:12:05,-9,24,33
179,LKB,P006901,P009898,0 days 00:12:03,-4,25,29
179,LKB,P005521,P006901,0 days 00:11:38,-5,26,31
179,LKB,P010190,PLXI,0 days 00:11:38,12,33,21
179,LKB,P007029,P010190,0 days 00:10:50,4,28,24
179,LKB,P009898,P011329,0 days 00:10:06,7,27,20
179,LKB,P006901,P010461,0 days 00:09:39,6,26,20
179,LKB,P005521,P011329,0 days 00:09:38,-1,23,24
179,LKB,P005521,P010461,0 days 00:09:29,1,19,18
179,LKB,P005521,P009898,0 days 00:09:18,-5,17,22
179,LKB,P006901,P011329,0 days 00:06:17,1,18,17
179,LKB,P006901,P010190,0 days 00:05:17,2,15,13
179,LKB,P010190,P011329,0 days 00:02:54,10,12,2
179,LKB,P005521,P010190,0 days 00:02:15,0,5,5
179,CLU,P004862,P012621,0 days 00:26:10,-11,54,65
179,CLU,P004862,P011801,0 days 00:26:08,14,61,47
179,CLU,P010569,P012621,0 days 00:24:23,8,60,52
179,CLU,P004862,P005113,0 days 00:22:40,4,53,49
179,CLU,P010569,P011801,0 days 00:22:29,13,58,45
179,CLU,P011801,P012621,0 days 00:22:22,5,52,47
179,CLU,P004862,P010569,0 days 00:22:15,9,55,46
179,CLU,P005113,P012621,0 days 00:19:12,-6,43,49
179,CLU,P005113,P011801,0 days 00:16:14,14,42,28
179,CLU,P005113,P010569,0 days 00:15:17,9,41,32
179,CLU,P004862,P005714,0 days 00:14:16,-5,24,29
179,CLU,P011801,P012698,0 days 00:12:44,2,30,28
179,CLU,P010569,P012698,0 days 00:12:34,-5,28,33
179,CLU,P004862,P012698,0 days 00:12:14,0,27,27
179,CLU,P005373,P011801,0 days 00:12:01,-3,26,29
179,CLU,P005714,P012621,0 days 00:10:43,-16,13,29
179,CLU,P005373,P012621,0 days 00:10:19,-9,20,29
179,CLU,P005113,P005714,0 days 00:10:14,-8,17,25
179,CLU,P005714,P011801,0 days 00:10:14,7,19,12
179,CLU,P005113,P012698,0 days 00:10:14,0,21,21
179,CLU,P005373,P010569,0 days 00:10:08,-2,23,25
179,CLU,P012621,P012698,0 days 00:09:49,-9,21,30
179,CLU,P004862,P005373,0 days 00:09:23,-9,17,26
179,CLU,P005373,P012698,0 days 00:07:26,0,19,19
179,CLU,P005714,P012698,0 days 00:06:31,4,14,10
179,CLU,P004862,P012620,0 days 00:04:18,-14,5,19
179,CLU,P005714,P012620,0 days 00:04:18,-14,5,19
179,CLU,P012620,P012621,0 days 00:04:18,-14,5,19
179,CLU,P005714,P010569,0 days 00:03:26,4,7,3
179,CLU,P005373,P005714,0 days 00:03:22,-4,5,9
179,CLU,P005113,P012620,0 days 00:02:49,-9,3,12
179,CLU,P005373,P012620,0 days 00:01:29,-5,2,7
180,WRO,P005531,P012094,0 days 00:30:12,-6,63,69
180,WRO,P005531,P009896,0 days 00:27:54,-6,54,60
180,WRO,P009896,P012699,0 days 00:26:32,-11,49,60
180,WRO,P009896,P012094,0 days 00:25:57,-7,56,63
180,WRO,P005531,P012699,0 days 00:24:34,-12,45,57
180,WRO,P012094,P012699,0 days 00:23:24,-15,47,62
180,WRO,P005531,P011900,0 days 00:20:35,-11,36,47
180,WRO,P009896,P011900,0 days 00:20:20,-14,34,48
180,WRO,P011900,P012094,0 days 00:19:49,-14,38,52
180,WRO,P005531,P012736,0 days 00:19:41,0,35,35
180,WRO,P009896,P012736,0 days 00:19:33,2,36,34
180,WRO,P011900,P012699,0 days 00:18:55,-14,28,42
180,WRO,P012094,P012736,0 days 00:18:21,-3,37,40
180,WRO,P012699,P012736,0 days 00:17:40,-8,29,37
180,WRO,P011900,P012736,0 days 00:12:15,-3,17,20
180,WRO,P011900,P011902,0 days 00:11:54,-4,19,23
180,WRO,P005531,P011902,0 days 00:10:29,-12,14,26
180,WRO,P011902,P012094,0 days 00:09:22,-10,14,24
180,WRO,P011902,P012736,0 days 00:08:50,-3,11,14
180,WRO,P011902,P012699,0 days 00:07:24,-4,8,12
180,WRO,P009896,P011902,0 days 00:06:41,-3,10,13
180,WRO,P005531,P012308,0 days 00:04:17,1,5,4
180,WRO,P009896,P012308,0 days 00:04:17,1,5,4
180,WRO,P012094,P012308,0 days 00:03:27,3,5,2
180,WRO,P012308,P012736,0 days 00:03:02,1,3,2
180,WRO,P012308,P012699,0 days 00:01:15,0,2,2
180,WRO,P005531,P007472,0 days 00:00:50,-2,0,2
180,WRO,P007472,P009896,0 days 00:00:50,-2,0,2
180,WRO,P007472,P012308,0 days 00:00:50,-2,0,2
180,WRO,P007472,P012736,0 days 00:00:50,-2,0,2
180,TTK,P006693,P011925,0 days 00:33:17,5,70,65
180,TTK,P004801,P006693,0 days 00:27:27,13,61,48
180,TTK,P011239,P011925,0 days 00:26:56,15,67,52
180,TTK,P006693,P011834,0 days 00:26:48,12,62,50
180,TTK,P004801,P011925,0 days 00:26:37,11,59,48
180,TTK,P011834,P011925,0 days 00:25:58,10,60,50
180,TTK,P006693,P011239,0 days 00:23:51,9,58,49
180,TTK,P011239,P011834,0 days 00:23:50,12,57,45
180,TTK,P004801,P011834,0 days 00:23:34,19,57,38
180,TTK,P004801,P011239,0 days 00:21:08,13,51,38
180,TTK,P006883,P011925,0 days 00:12:31,2,21,19
180,TTK,P005000,P006883,0 days 00:11:38,4,20,16
180,TTK,P005000,P011925,0 days 00:10:24,1,19,18
180,TTK,P010477,P011925,0 days 00:09:45,0,20,20
180,TTK,P006693,P006883,0 days 00:09:26,-4,12,16
180,TTK,P004801,P006883,0 days 00:07:44,0,12,12
180,TTK,P006883,P010477,0 days 00:07:35,5,14,9
180,TTK,P004801,P005000,0 days 00:07:23,-4,10,14
180,TTK,P010477,P011239,0 days 00:07:21,5,19,14
180,TTK,P005000,P006693,0 days 00:07:19,-5,10,15
180,TTK,P006693,P010477,0 days 00:06:40,-6,11,17
180,TTK,P006883,P011834,0 days 00:06:29,4,11,7
180,TTK,P005000,P011239,0 days 00:06:12,9,16,7
180,TTK,P010477,P011834,0 days 00:06:02,-4,10,14
180,TTK,P005000,P010477,0 days 00:05:49,8,14,6
180,TTK,P006883,P011239,0 days 00:04:38,9,12,3
180,TTK,P005000,P011834,0 days 00:02:48,3,5,2
180,TTK,P004801,P009845,0 days 00:01:15,0,2,2
180,TTK,P005000,P009845,0 days 00:01:15,0,2,2
180,TTK,P006883,P009845,0 days 00:01:15,0,2,2
180,TTK,P009845,P011834,0 days 00:01:15,0,2,2
180,TTK,P004801,P011272,0 days 00:00:50,2,2,0
180,TTK,P004801,P011975,0 days 00:00:50,2,2,0
180,TTK,P006693,P011272,0 days 00:00:50,2,2,0
180,TTK,P006693,P011975,0 days 00:00:50,2,2,0
180,TTK,P011272,P011834,0 days 00:00:50,2,2,0
180,TTK,P011272,P011975,0 days 00:00:50,2,2,0
180,TTK,P011834,P011975,0 days 00:00:50,2,2,0
181,LLI,P012586,P012797,0 days 00:22:38,16,61,45
181,LLI,P006600,P012586,0 days 00:21:41,15,60,45
181,LLI,P006600,P012797,0 days 00:21:19,17,60,43
181,LLI,P012585,P012797,0 days 00:20:30,13,52,39
181,LLI,P012585,P012586,0 days 00:20:07,13,52,39
181,LLI,P009649,P012586,0 days 00:19:55,11,52,41
181,LLI,P009649,P012585,0 days 00:19:33,13,52,39
181,LLI,P009649,P012797,0 days 00:19:33,13,52,39
181,LLI,P006600,P009649,0 days 00:19:10,12,51,39
181,LLI,P006600,P012585,0 days 00:18:48,14,51,37
181,LLI,P005247,P012020,0 days 00:17:34,9,39,30
181,LLI,P005247,P009680,0 days 00:17:00,9,39,30
181,LLI,P009680,P012020,0 days 00:17:00,9,39,30
181,LLI,P005247,P009672,0 days 00:16:38,12,44,32
181,LLI,P009672,P009680,0 days 00:15:14,11,39,28
181,LLI,P009672,P012020,0 days 00:15:14,11,39,28
181,LLI,P004773,P005247,0 days 00:13:08,2,29,27
181,LLI,P004773,P009680,0 days 00:12:01,0,25,25
181,LLI,P004773,P012020,0 days 00:12:01,0,25,25
181,LLI,P004773,P009672,0 days 00:11:00,0,25,25
181,LLI,P005247,P012797,0 days 00:06:29,9,17,8
181,LLI,P012020,P012797,0 days 00:04:43,5,9,4
181,LLI,P009672,P012797,0 days 00:04:25,7,13,6
181,LLI,P009680,P012797,0 days 00:03:24,6,8,2
181,LLI,P012020,P012585,0 days 00:03:17,2,7,5
181,LLI,P005247,P012586,0 days 00:03:05,3,9,6
181,LLI,P005247,P012585,0 days 00:02:32,3,6,3
181,LLI,P005247,P006600,0 days 00:02:31,3,9,6
181,LLI,P009680,P012585,0 days 00:01:58,3,6,3
181,LLI,P006600,P009672,0 days 00:01:46,-1,5,6
181,LLI,P009672,P012586,0 days 00:01:46,-1,5,6
181,LLI,P009672,P012585,0 days 00:01:35,3,6,3
181,LLI,P004773,P012586,0 days 00:01:29,0,4,4
181,LLI,P004773,P006600,0 days 00:01:29,0,4,4
181,LLI,P008274,P012020,0 days 00:01:23,-2,0,2
181,LLI,P005247,P008274,0 days 00:01:23,-2,0,2
181,LLI,P008274,P009680,0 days 00:01:23,-2,0,2
181,LLI,P004773,P008274,0 days 00:01:23,-2,0,2
181,LLI,P012020,P012586,0 days 00:01:19,-1,1,2
181,LLI,P004773,P012797,0 days 00:01:07,2,4,2
181,LLI,P009649,P012020,0 days 00:00:45,-1,1,2
181,LLI,P004773,P009649,0 days 00:00:22,-2,0,2
181,LLI,P009649,P009672,0 days 00:00:22,-2,0,2
181,TTK,P006693,P011925,0 days 00:23:36,-13,50,63
181,TTK,P011239,P011925,0 days 00:22:45,-12,42,54
181,TTK,P006693,P011239,0 days 00:20:54,-16,36,52
181,TTK,P011834,P011925,0 days 00:20:25,-8,46,54
181,TTK,P010477,P011834,0 days 00:17:53,-15,31,46
181,TTK,P004801,P011925,0 days 00:17:36,-4,41,45
181,TTK,P005000,P006693,0 days 00:17:08,-18,27,45
181,TTK,P010477,P011925,0 days 00:17:03,-10,32,42
181,TTK,P005000,P011239,0 days 00:16:56,-12,29,41
181,TTK,P006693,P010477,0 days 00:16:25,-21,27,48
181,TTK,P004801,P011239,0 days 00:15:49,-1,32,33
181,TTK,P005000,P011925,0 days 00:15:39,-5,32,37
181,TTK,P006693,P011834,0 days 00:15:02,-15,27,42
181,TTK,P006883,P011925,0 days 00:14:59,1,37,36
181,TTK,P006883,P011834,0 days 00:14:52,-6,35,41
181,TTK,P011239,P011834,0 days 00:12:36,-10,19,29
181,TTK,P004801,P005000,0 days 00:12:12,-2,24,26
181,TTK,P004801,P006693,0 days 00:11:28,-2,25,27
181,TTK,P010477,P011239,0 days 00:11:01,-15,14,29
181,TTK,P006883,P010477,0 days 00:08:55,-3,18,21
181,TTK,P005000,P010477,0 days 00:08:48,-12,12,24
181,TTK,P005000,P011834,0 days 00:08:09,-6,11,17
181,TTK,P004801,P011834,0 days 00:07:53,-2,19,21
181,TTK,P004801,P006883,0 days 00:07:20,-1,19,20
181,TTK,P009845,P011834,0 days 00:06:14,-6,12,18
181,TTK,P006693,P006883,0 days 00:05:12,-3,14,17
181,TTK,P009845,P011925,0 days 00:05:10,-7,10,17
181,TTK,P006883,P011239,0 days 00:04:52,-1,8,9
181,TTK,P004801,P009845,0 days 00:04:27,-2,10,12
181,TTK,P005000,P006883,0 days 00:04:04,-2,7,9
181,TTK,P006883,P009845,0 days 00:03:23,-3,8,11
181,TTK,P006693,P009845,0 days 00:01:47,-4,2,6
181,TTK,P009845,P010477,0 days 00:01:47,-4,2,6
181,TTK,P004801,P011975,0 days 00:01:23,2,2,0
181,TTK,P006883,P011975,0 days 00:01:23,2,2,0
181,TTK,P011239,P011975,0 days 00:01:23,2,2,0
181,TTK,P011925,P011975,0 days 00:01:23,2,2,0
181,TTK,P005000,P009845,0 days 00:01:04,1,2,1
181,TTK,P009845,P011239,0 days 00:01:04,1,2,1
182,ULM,P010582,P012603,0 days 00:23:48,1,50,49
182,ULM,P010582,P012604,0 days 00:20:36,0,47,47
182,ULM,P005422,P012603,0 days 00:20:34,7,41,34
182,ULM,P010106,P010582,0 days 00:19:51,2,45,43
182,ULM,P005422,P010582,0 days 00:19:34,2,37,35
182,ULM,P012603,P012604,0 days 00:18:50,14,47,33
182,ULM,P005422,P012604,0 days 00:17:28,14,39,25
182,ULM,P010106,P012604,0 days 00:17:26,2,40,38
182,ULM,P005422,P010106,0 days 00:16:49,9,33,24
182,ULM,P010106,P012603,0 days 00:16:13,8,37,29
182,ULM,P011457,P012703,0 days 00:13:44,-5,25,30
182,ULM,P011188,P011457,0 days 00:11:08,-7,18,25
182,ULM,P010582,P012703,0 days 00:11:02,-7,17,24
182,ULM,P011457,P012604,0 days 00:10:37,-13,24,37
182,ULM,P012604,P012703,0 days 00:09:33,-5,18,23
182,ULM,P012603,P012703,0 days 00:09:06,-1,19,20
182,ULM,P006997,P011457,0 days 00:08:32,-7,12,19
182,ULM,P011188,P012703,0 days 00:08:31,-2,14,16
182,ULM,P010582,P011457,0 days 00:08:21,-8,19,27
182,ULM,P006997,P012703,0 days 00:07:50,-7,10,17
182,ULM,P010106,P011188,0 days 00:07:32,-7,15,22
182,ULM,P005422,P012703,0 days 00:07:08,-2,15,17
182,ULM,P010106,P011457,0 days 00:07:06,-8,17,25
182,ULM,P010582,P011188,0 days 00:07:05,-6,12,18
182,ULM,P006997,P011188,0 days 00:06:51,1,12,11
182,ULM,P007952,P012603,0 days 00:06:29,-7,9,16
182,ULM,P007952,P010582,0 days 00:06:29,-7,9,16
182,ULM,P005422,P007952,0 days 00:06:29,-7,9,16
182,ULM,P011188,P012604,0 days 00:06:09,-9,11,20
182,ULM,P011457,P012603,0 days 00:04:39,3,18,15
182,ULM,P005422,P011457,0 days 00:04:23,5,11,6
182,ULM,P010726,P012604,0 days 00:04:20,-7,6,13
182,ULM,P006997,P010106,0 days 00:04:04,-1,8,9
182,ULM,P006997,P010582,0 days 00:03:48,2,6,4
182,ULM,P007952,P012703,0 days 00:03:36,-7,5,12
182,ULM,P005422,P011188,0 days 00:03:23,0,7,7
182,ULM,P010106,P012703,0 days 00:03:22,-1,6,7
182,ULM,P010726,P012703,0 days 00:03:20,-7,3,10
182,ULM,P010582,P010726,0 days 00:02:58,1,6,5
182,ULM,P007952,P010106,0 days 00:02:53,0,4,4
182,ULM,P006997,P012604,0 days 00:01:41,-8,0,8
182,ULM,P010726,P012603,0 days 00:01:37,3,3,0
182,ULM,P006997,P010726,0 days 00:01:22,-8,0,8
182,ULM,P010726,P011457,0 days 00:01:22,-8,0,8
182,ULM,P010726,P011188,0 days 00:01:21,-2,3,5
182,ULM,P010106,P010726,0 days 00:01:00,0,3,3
182,JOV,P002507,P011247,0 days 00:22:52,2,43,41
182,JOV,P010458,P011248,0 days 00:22:46,16,55,39
182,JOV,P002361,P010458,0 days 00:22:02,9,48,39
182,JOV,P010458,P011247,0 days 00:19:00,9,48,39
182,JOV,P011247,P011248,0 days 00:18:14,18,53,35
182,JOV,P002361,P011248,0 days 00:17:47,17,44,27
182,JOV,P002361,P011247,0 days 00:16:27,10,43,33
182,JOV,P010677,P011247,0 days 00:16:26,0,35,35
182,JOV,P002507,P011248,0 days 00:15:10,8,36,28
182,JOV,P002507,P010677,0 days 00:14:59,2,30,28
182,JOV,P002507,P010458,0 days 00:14:34,4,31,27
182,JOV,P002361,P012780,0 days 00:13:31,10,36,26
182,JOV,P010458,P012780,0 days 00:12:52,5,29,24
182,JOV,P010161,P011247,0 days 00:12:25,-2,26,28
182,JOV,P011248,P012780,0 days 00:11:23,10,29,19
182,JOV,P010161,P010677,0 days 00:10:36,-5,18,23
182,JOV,P006771,P011247,0 days 00:10:24,-10,17,27
182,JOV,P002361,P002507,0 days 00:10:11,0,18,18
182,JOV,P010677,P011248,0 days 00:09:58,6,25,19
182,JOV,P002507,P010161,0 days 00:09:18,-1,15,16
182,JOV,P006771,P010161,0 days 00:08:36,-6,14,20
182,JOV,P006771,P010677,0 days 00:08:25,-6,10,16
182,JOV,P011247,P012780,0 days 00:08:24,3,29,26
182,JOV,P010458,P010677,0 days 00:07:54,4,18,14
182,JOV,P010458,PJUG,0 days 00:07:52,1,15,14
182,JOV,P002361,PJUG,0 days 00:07:52,1,15,14
182,JOV,P011248,PJUG,0 days 00:06:24,3,13,10
182,JOV,P002507,P006771,0 days 00:05:56,-2,6,8
182,JOV,P006771,P012780,0 days 00:05:46,-8,12,20
182,JOV,P012780,PJUG,0 days 00:05:24,2,10,8
182,JOV,P010161,P011248,0 days 00:03:56,4,12,8
182,JOV,P010677,P012780,0 days 00:03:22,-5,4,9
182,JOV,P002361,P006771,0 days 00:03:18,-2,8,10
182,JOV,P010161,P012780,0 days 00:03:14,-1,11,12
182,JOV,P006771,P010458,0 days 00:03:13,-4,4,8
182,JOV,P002507,PJUG,0 days 00:02:28,-1,5,6
182,JOV,P002361,P010677,0 days 00:02:20,0,4,4
182,JOV,P002361,P010161,0 days 00:01:56,3,8,5
182,JOV,P011247,PJUG,0 days 00:01:28,-2,2,4
182,JOV,P006771,P011248,0 days 00:01:10,-2,1,3
182,JOV,P010161,P010458,0 days 00:00:07,0,0,0
183,CAN,P003425,P008121,0 days 00:23:35,4,46,42
183,CAN,P003425,P003637,0 days 00:20:39,10,48,38
183,CAN,P006588,P008121,0 days 00:20:37,3,39,36
183,CAN,P003425,P006588,0 days 00:18:58,1,34,33
183,CAN,P003637,P008121,0 days 00:18:12,4,38,34
183,CAN,P003425,P010385,0 days 00:17:22,8,40,32
183,CAN,P003637,P006588,0 days 00:16:04,3,34,31
183,CAN,P008121,P009864,0 days 00:16:01,0,30,30
183,CAN,P010385,P010452,0 days 00:14:18,3,32,29
183,CAN,P003637,P010385,0 days 00:13:44,3,30,27
183,CAN,P006588,P009864,0 days 00:12:54,3,26,23
183,CAN,P008121,P010385,0 days 00:12:40,2,27,25
183,CAN,P003425,P009864,0 days 00:12:00,1,21,20
183,CAN,P005005,P010452,0 days 00:11:27,-2,21,23
183,CAN,P003425,P010452,0 days 00:10:24,8,27,19
183,CAN,P003637,P009864,0 days 00:10:08,2,21,19
183,CAN,P001607,P010452,0 days 00:09:30,-12,14,26
183,CAN,P005005,P010385,0 days 00:09:21,1,18,17
183,CAN,P004160,P010452,0 days 00:08:53,0,18,18
183,CAN,P003425,P005005,0 days 00:08:19,1,15,14
183,CAN,P008121,P010452,0 days 00:08:04,-1,18,19
183,CAN,P004160,P010385,0 days 00:07:53,1,13,12
183,CAN,P003637,P010452,0 days 00:07:48,2,17,15
183,CAN,P006588,P010385,0 days 00:07:43,0,13,13
183,CAN,P001607,P009864,0 days 00:06:06,-4,12,16
183,CAN,P001607,P008121,0 days 00:05:53,-3,13,16
183,CAN,P003637,P005005,0 days 00:05:40,1,13,12
183,CAN,P004160,P005005,0 days 00:05:40,-5,8,13
183,CAN,P003425,P004160,0 days 00:05:28,-2,9,11
183,CAN,P001607,P005005,0 days 00:05:16,-7,6,13
183,CAN,P001607,P010385,0 days 00:05:03,-6,7,13
183,CAN,P009864,P010452,0 days 00:04:50,-6,7,13
183,CAN,P004160,P008121,0 days 00:04:28,3,10,7
183,CAN,P001607,P004160,0 days 00:04:13,-2,7,9
183,CAN,P005005,P009864,0 days 00:04:00,-5,3,8
183,CAN,P001607,P007560,0 days 00:02:57,-2,7,9
183,CAN,P007560,P008121,0 days 00:02:57,-2,7,9
183,CAN,P007560,P009864,0 days 00:02:57,-2,7,9
183,CAN,P001607,P003637,0 days 00:02:46,-7,1,8
183,CAN,P005005,P008121,0 days 00:02:17,-2,0,2
183,CAN,P004160,P009864,0 days 00:02:00,-1,5,6
183,CAN,P005005,P006588,0 days 00:01:54,-2,0,2
183,CAN,P001607,P006588,0 days 00:01:39,2,5,3
183,CAN,P006588,P007560,0 days 00:01:39,2,5,3
183,CAN,P007560,P010452,0 days 00:01:18,-4,2,6
183,CAN,P001607,P003425,0 days 00:01:13,1,4,3
183,CAN,P004160,P006588,0 days 00:01:00,0,0,0
183,CAN,P003637,P004160,0 days 00:00:27,2,2,0
183,CAN,P003425,P007560,0 days 00:00:15,-2,0,2
183,CAN,P003425,P007644,0 days 00:00:15,-2,0,2
183,CAN,P004160,P007560,0 days 00:00:15,-2,0,2
183,CAN,P004160,P007644,0 days 00:00:15,-2,0,2
183,CAN,P005005,P007560,0 days 00:00:15,-2,0,2
183,CAN,P005005,P007644,0 days 00:00:15,-2,0,2
183,CAN,P007560,P007644,0 days 00:00:15,-2,0,2
183,BES,P008945,P012622,0 days 00:25:35,2,53,51
183,BES,P012622,P012711,0 days 00:21:22,5,43,38
183,BES,P011936,P012622,0 days 00:20:41,4,41,37
183,BES,P008945,P011936,0 days 00:20:27,6,42,36
183,BES,P012622,P012647,0 days 00:19:36,-3,38,41
183,BES,P008945,P012647,0 days 00:18:11,-4,36,40
183,BES,P008945,P012711,0 days 00:16:01,13,35,22
183,BES,P003783,P012622,0 days 00:15:48,-1,37,38
183,BES,P011379,P012622,0 days 00:15:44,0,26,26
183,BES,P011936,P012647,0 days 00:14:59,1,31,30
183,BES,P011379,P011936,0 days 00:14:08,2,25,23
183,BES,P011936,P012711,0 days 00:13:32,14,30,16
183,BES,P011924,P012622,0 days 00:12:32,-4,25,29
183,BES,P008945,P011379,0 days 00:12:15,0,21,21
183,BES,P011924,P012711,0 days 00:11:42,-7,20,27
183,BES,P003783,P011924,0 days 00:11:18,-4,22,26
183,BES,P003783,P007914,0 days 00:09:25,2,21,19
183,BES,P003783,P012711,0 days 00:09:23,-6,17,23
183,BES,P007914,P012622,0 days 00:09:08,3,22,19
183,BES,P012647,P012711,0 days 00:09:06,5,17,12
183,BES,P003783,P012647,0 days 00:08:36,1,19,18
183,BES,P011379,P012711,0 days 00:08:04,8,16,8
183,BES,P007914,P011924,0 days 00:07:45,0,15,15
183,BES,P007914,P008945,0 days 00:07:20,6,19,13
183,BES,P007914,P012711,0 days 00:06:58,4,15,11
183,BES,P011379,P012647,0 days 00:06:49,-5,10,15
183,BES,P007914,P012647,0 days 00:06:28,0,13,13
183,BES,P003783,P008945,0 days 00:05:15,1,17,16
183,BES,P003783,P007917,0 days 00:04:48,-8,7,15
183,BES,P007917,P011924,0 days 00:04:48,-8,7,15
183,BES,P007917,P012711,0 days 00:04:48,-8,7,15
183,BES,P003783,P011379,0 days 00:04:18,3,8,5
183,BES,P007917,P012622,0 days 00:04:06,-6,7,13
183,BES,P011924,P012647,0 days 00:04:03,-3,4,7
183,BES,P008945,P011924,0 days 00:03:52,0,9,9
183,BES,P003783,P011936,0 days 00:03:13,0,8,8
183,BES,P007914,P011379,0 days 00:02:29,3,6,3
183,BES,P011379,P011924,0 days 00:02:25,1,4,3
183,BES,P007914,P011936,0 days 00:01:45,4,5,1
183,BES,P007914,P007917,0 days 00:00:42,-2,0,2
183,BES,P011924,P011936,0 days 00:00:35,1,2,1
184,PMT,P005301,P011942,0 days 00:20:38,20,54,34
184,PMT,P011943,P011944,0 days 00:17:42,16,46,30
184,PMT,P005301,P011943,0 days 00:17:13,7,38,31
184,PMT,P005301,P011944,0 days 00:16:48,13,39,26
184,PMT,P002644,P011944,0 days 00:15:55,7,34,27
184,PMT,P011942,P011944,0 days 00:15:49,13,40,27
184,PMT,P002644,P012600,0 days 00:15:22,10,36,26
184,PMT,P011947,P012600,0 days 00:15:18,12,36,24
184,PMT,P011944,P012600,0 days 00:14:30,14,36,22
184,PMT,P002644,P011947,0 days 00:14:15,6,31,25
184,PMT,P001686,P012600,0 days 00:13:54,7,30,23
184,PMT,P002644,P005301,0 days 00:13:39,8,32,24
184,PMT,P011942,P011943,0 days 00:12:33,8,30,22
184,PMT,P002644,P011943,0 days 00:12:27,-1,23,24
184,PMT,P011823,P011942,0 days 00:11:48,7,28,21
184,PMT,P002644,P011942,0 days 00:11:02,13,31,18
184,PMT,P011823,P011944,0 days 00:10:48,15,32,17
184,PMT,P001686,P011944,0 days 00:10:29,9,26,17
184,PMT,P011942,P012600,0 days 00:10:17,12,29,17
184,PMT,P005301,P011823,0 days 00:09:59,9,26,17
184,PMT,P001686,P002644,0 days 00:09:37,0,17,17
184,PMT,P001686,P011947,0 days 00:09:22,1,16,15
184,PMT,P005301,P011947,0 days 00:09:20,6,23,17
184,PMT,P011823,P011943,0 days 00:08:49,12,27,15
184,PMT,P005301,P012600,0 days 00:08:46,12,24,12
184,PMT,P011823,P012600,0 days 00:07:41,11,21,10
184,PMT,P011942,P011947,0 days 00:07:24,9,22,13
184,PMT,P011944,P011947,0 days 00:06:45,5,15,10
184,PMT,P011943,P012600,0 days 00:06:24,6,16,10
184,PMT,P001686,P011943,0 days 00:06:08,6,16,10
184,PMT,P011943,P011947,0 days 00:05:39,-3,8,11
184,PMT,P002691,P011943,0 days 00:04:24,-1,8,9
184,PMT,P002691,P005301,0 days 00:04:24,-1,8,9
184,PMT,P001686,P011823,0 days 00:04:17,7,13,6
184,PMT,P011823,P011947,0 days 00:03:42,3,9,6
184,PMT,P002691,P011947,0 days 00:03:27,-3,6,9
184,PMT,P002644,P002691,0 days 00:02:19,-3,4,7
184,PMT,P002020,P002691,0 days 00:02:05,2,4,2
184,PMT,P002020,P005301,0 days 00:02:05,2,4,2
184,PMT,P002020,P011943,0 days 00:02:05,2,4,2
184,PMT,P001686,P011942,0 days 00:01:49,-2,2,4
184,PMT,P002020,P011947,0 days 00:01:08,0,2,2
184,PMT,P002020,P011944,0 days 00:00:57,2,2,0
184,PMT,P002691,P011944,0 days 00:00:57,2,2,0
184,ARI,P003240,P004292,0 days 00:22:26,-16,35,51
184,ARI,P003240,P012717,0 days 00:21:13,-15,35,50
184,ARI,P004292,P012717,0 days 00:21:01,-11,38,49
184,ARI,P012716,P012717,0 days 00:20:30,-13,39,52
184,ARI,P004292,P012716,0 days 00:20:23,-9,36,45
184,ARI,P003240,P012716,0 days 00:20:23,-15,31,46
184,ARI,P003240,P012615,0 days 00:13:42,-7,24,31
184,ARI,P003240,P012760,0 days 00:12:36,-12,19,31
184,ARI,P012717,P012760,0 days 00:12:36,-12,19,31
184,ARI,P012615,P012716,0 days 00:11:59,-8,16,24
184,ARI,P004292,P012615,0 days 00:11:45,-6,20,26
184,ARI,P012615,P012792,0 days 00:11:43,-12,18,30
184,ARI,P012716,P012760,0 days 00:10:55,-14,15,29
184,ARI,P003240,P012792,0 days 00:10:47,-4,22,26
184,ARI,P012702,P012792,0 days 00:09:59,-13,17,30
184,ARI,P004292,P012760,0 days 00:09:16,-13,12,25
184,ARI,P002867,P012792,0 days 00:08:46,-11,11,22
184,ARI,P012717,P012792,0 days 00:08:24,-8,16,24
184,ARI,P012716,P012792,0 days 00:08:17,-8,13,21
184,ARI,P012615,P012702,0 days 00:08:15,-8,12,20
184,ARI,P012702,P012716,0 days 00:07:16,-2,14,16
184,ARI,P012615,P012717,0 days 00:07:06,-5,11,16
184,ARI,P004292,P012722,0 days 00:06:15,3,14,11
184,ARI,P003240,P012702,0 days 00:06:11,0,13,13
184,ARI,P002867,P012615,0 days 00:05:20,-8,5,13
184,ARI,P004292,P012792,0 days 00:05:17,-2,12,14
184,ARI,P002867,P012716,0 days 00:05:03,-7,5,12
184,ARI,P002867,P012702,0 days 00:05:00,-11,6,17
184,ARI,P010387,P012717,0 days 00:04:39,-2,11,13
184,ARI,P010387,P012722,0 days 00:04:35,1,9,8
184,ARI,P004292,P010387,0 days 00:04:19,3,9,6
184,ARI,P004292,P012702,0 days 00:04:01,3,10,7
184,ARI,P012716,P012722,0 days 00:04:00,1,8,7
184,ARI,P010387,P012792,0 days 00:03:55,-9,6,15
184,ARI,P012702,P012717,0 days 00:03:47,-2,10,12
184,ARI,P012760,P012792,0 days 00:03:40,1,7,6
184,ARI,P010387,P012702,0 days 00:03:39,-7,6,13
184,ARI,P012717,P012722,0 days 00:03:37,1,9,8
184,ARI,P012722,P012792,0 days 00:03:32,-4,6,10
184,ARI,P002867,P012717,0 days 00:03:26,-3,6,9
184,ARI,P012615,P012722,0 days 00:03:21,-2,6,8
184,ARI,P003240,P010387,0 days 00:02:55,-1,4,5
184,ARI,P003240,P012722,0 days 00:02:54,0,5,5
184,ARI,P010387,P012615,0 days 00:02:37,-4,4,8
184,ARI,P010387,P012716,0 days 00:02:30,3,7,4
184,ARI,P002867,P012760,0 days 00:02:21,2,4,2
184,ARI,P010177,P012722,0 days 00:02:05,-2,2,4
184,ARI,P010177,P012717,0 days 00:02:05,-2,2,4
184,ARI,P010177,P010387,0 days 00:02:05,-2,2,4
184,ARI,P002867,P003240,0 days 00:02:01,2,4,2
184,ARI,P004292,P010177,0 days 00:01:49,0,2,2
184,ARI,P002867,P010387,0 days 00:01:42,-6,2,8
184,ARI,P002867,P012722,0 days 00:01:25,-2,1,3
184,ARI,P012615,P012760,0 days 00:00:20,0,0,0
184,ARI,P010177,P012792,0 days 00:00:16,-2,0,2
185,PRS,P012608,P012610,0 days 00:24:23,16,56,40
185,PRS,P012608,P012613,0 days 00:23:50,15,57,42
185,PRS,P012610,P012613,0 days 00:22:15,11,49,38
185,PRS,P012609,P012610,0 days 00:18:30,12,44,32
185,PRS,P012608,P012609,0 days 00:18:30,12,44,32
185,PRS,P011232,P012640,0 days 00:18:24,5,38,33
185,PRS,P011232,P012608,0 days 00:17:37,18,43,25
185,PRS,P003481,P011232,0 days 00:16:52,8,37,29
185,PRS,P012609,P012613,0 days 00:16:22,7,37,30
185,PRS,P003481,P005793,0 days 00:14:02,-4,22,26
185,PRS,P011232,P012610,0 days 00:13:59,11,30,19
185,PRS,P011232,P012613,0 days 00:13:26,10,31,21
185,PRS,P003481,P012640,0 days 00:13:24,-2,26,28
185,PRS,P005793,P011232,0 days 00:13:09,-1,22,23
185,PRS,P005793,P009556,0 days 00:11:59,-7,17,24
185,PRS,P003481,P009556,0 days 00:11:59,-7,17,24
185,PRS,P012608,P012640,0 days 00:11:51,19,36,17
185,PRS,P005793,P012640,0 days 00:11:49,-6,18,24
185,PRS,P009556,P011232,0 days 00:11:06,-4,17,21
185,PRS,P011232,P012609,0 days 00:10:19,9,22,13
185,PRS,P012613,P012640,0 days 00:09:48,16,31,15
185,PRS,P009556,P012640,0 days 00:09:46,-9,13,22
185,PRS,P012610,P012640,0 days 00:09:06,9,23,14
185,PRS,P004512,P012609,0 days 00:06:53,-4,11,15
185,PRS,P004512,P012608,0 days 00:06:53,-4,11,15
185,PRS,P004512,P012613,0 days 00:06:53,-4,11,15
185,PRS,P004512,P012610,0 days 00:06:53,-4,11,15
185,PRS,P003481,P012608,0 days 00:05:46,12,20,8
185,PRS,P003481,P012609,0 days 00:04:21,7,11,4
185,PRS,P005793,P012609,0 days 00:03:24,3,8,5
185,PRS,P005793,P012608,0 days 00:03:14,4,9,5
185,PRS,P003481,P012610,0 days 00:03:01,2,7,5
185,PRS,P012609,P012640,0 days 00:02:20,8,11,3
185,PRS,P009556,P012609,0 days 00:02:13,2,4,2
185,PRS,P005793,P012610,0 days 00:02:04,-2,4,6
185,PRS,P003481,P012613,0 days 00:01:35,4,8,4
185,PRS,P005793,P012613,0 days 00:01:11,1,4,3
185,PRS,P009556,P012610,0 days 00:00:53,-3,0,3
185,JOV,P011247,P011248,0 days 00:29:17,-10,57,67
185,JOV,P002507,P011248,0 days 00:21:08,-10,41,51
185,JOV,P002361,P011248,0 days 00:20:42,-3,41,44
185,JOV,P002507,P011247,0 days 00:20:39,-6,42,48
185,JOV,P010458,P011248,0 days 00:19:24,-4,39,43
185,JOV,P002361,P011247,0 days 00:18:27,2,41,39
185,JOV,P011248,P012780,0 days 00:17:59,-10,28,38
185,JOV,P010458,P011247,0 days 00:17:38,0,36,36
185,JOV,P002361,P002507,0 days 00:16:17,0,33,33
185,JOV,P002361,P010458,0 days 00:16:15,0,29,29
185,JOV,P010677,P011248,0 days 00:14:31,-15,22,37
185,JOV,P011247,P012780,0 days 00:13:55,-6,25,31
185,JOV,P010677,P012780,0 days 00:13:23,-11,16,27
185,JOV,P010677,P011247,0 days 00:13:01,-11,20,31
185,JOV,P002507,P010458,0 days 00:12:24,-2,24,26
185,JOV,P011248,P012349,0 days 00:11:27,-6,18,24
185,JOV,P011247,P012349,0 days 00:10:44,-6,19,25
185,JOV,P010458,P010677,0 days 00:09:24,-11,16,27
185,JOV,P010677,P012349,0 days 00:08:59,3,14,11
185,JOV,P010458,P012780,0 days 00:08:45,-4,15,19
185,JOV,P002361,P012780,0 days 00:08:35,-8,12,20
185,JOV,P002507,P010677,0 days 00:07:32,-13,12,25
185,JOV,P002507,P012349,0 days 00:06:47,-1,15,16
185,JOV,P012349,P012780,0 days 00:06:32,-1,7,8
185,JOV,P002361,P012349,0 days 00:06:25,-2,14,16
185,JOV,P010161,P010677,0 days 00:05:26,-5,7,12
185,JOV,P002507,P012780,0 days 00:04:34,-8,6,14
185,JOV,P006771,P011248,0 days 00:03:49,-1,3,4
185,JOV,P006771,P012780,0 days 00:03:49,-1,3,4
185,JOV,P002507,P010161,0 days 00:03:34,-2,7,9
185,JOV,P006771,P012349,0 days 00:03:33,4,6,2
185,JOV,P002361,P010677,0 days 00:03:18,-5,3,8
185,JOV,P010161,P010458,0 days 00:03:15,-6,3,9
185,JOV,P006771,P010677,0 days 00:03:02,4,6,2
185,JOV,P002361,P006771,0 days 00:02:33,1,3,2
185,JOV,P010161,P011247,0 days 00:02:11,1,4,3
185,JOV,P010161,P012349,0 days 00:02:11,1,4,3
185,JOV,P002361,P010161,0 days 00:02:04,-5,0,5
185,JOV,P010161,P012780,0 days 00:01:52,-3,0,3
185,JOV,P010458,P012349,0 days 00:01:26,0,3,3
185,JOV,P010161,P011248,0 days 00:01:11,-1,3,4
185,JOV,P002507,P006771,0 days 00:01:09,-2,0,2
185,JOV,P006771,P010458,0 days 00:00:53,3,3,0
186,CLU,P005714,P012698,0 days 00:22:41,2,52,50
186,CLU,P012621,P012698,0 days 00:19:41,4,43,39
186,CLU,P004862,P012621,0 days 00:19:37,-3,38,41
186,CLU,P005714,P012621,0 days 00:18:51,5,42,37
186,CLU,P010569,P012621,0 days 00:17:07,-8,29,37
186,CLU,P005113,P012621,0 days 00:15:48,-13,26,39
186,CLU,P011801,P012698,0 days 00:15:42,-5,35,40
186,CLU,P004862,P005714,0 days 00:15:14,-7,27,34
186,CLU,P004862,P010569,0 days 00:14:59,-8,26,34
186,CLU,P010569,P012698,0 days 00:13:27,-2,26,28
186,CLU,P005373,P012698,0 days 00:13:00,2,30,28
186,CLU,P004862,P012698,0 days 00:12:53,-5,23,28
186,CLU,P005714,P011801,0 days 00:12:28,-3,30,33
186,CLU,P010569,P011797,0 days 00:11:08,-10,21,31
186,CLU,P005714,P010569,0 days 00:11:05,-2,21,23
186,CLU,P004862,P005113,0 days 00:11:04,-7,20,27
186,CLU,P005373,P011801,0 days 00:10:41,3,26,23
186,CLU,P011801,P012621,0 days 00:10:40,-9,20,29
186,CLU,P005373,P005714,0 days 00:10:25,4,27,23
186,CLU,P011797,P012621,0 days 00:09:55,-11,15,26
186,CLU,P005113,P011797,0 days 00:09:55,-11,15,26
186,CLU,P004862,P011797,0 days 00:09:43,-9,17,26
186,CLU,P011797,P012698,0 days 00:09:31,-2,18,20
186,CLU,P005373,P012621,0 days 00:08:41,4,24,20
186,CLU,P005113,P010569,0 days 00:07:36,-9,12,21
186,CLU,P010569,P011801,0 days 00:07:10,-8,12,20
186,CLU,P011797,P011801,0 days 00:07:06,-2,13,15
186,CLU,P005714,P011797,0 days 00:06:31,0,15,15
186,CLU,P005113,P005714,0 days 00:05:53,-2,11,13
186,CLU,P012620,P012621,0 days 00:05:12,3,11,8
186,CLU,P005714,P012620,0 days 00:05:12,3,11,8
186,CLU,P005113,P012698,0 days 00:04:51,-2,9,11
186,CLU,P005113,P012620,0 days 00:04:47,2,9,7
186,CLU,P004862,P005373,0 days 00:04:01,-2,8,10
186,CLU,P004862,P012620,0 days 00:03:46,-1,7,8
186,CLU,P005373,P011797,0 days 00:03:27,1,6,5
186,CLU,P005113,P011801,0 days 00:03:18,-10,2,12
186,CLU,P005373,P010569,0 days 00:03:00,-1,5,6
186,CLU,P004862,P011801,0 days 00:02:03,-6,2,8
186,CLU,P012620,P012698,0 days 00:01:26,4,4,0
186,CLU,P005373,P012620,0 days 00:00:25,1,2,1
186,LLI,P005247,P012020,0 days 00:22:14,12,52,40
186,LLI,P005247,P009672,0 days 00:21:16,6,47,41
186,LLI,P009672,P012020,0 days 00:19:22,9,46,37
186,LLI,P012585,P012586,0 days 00:19:17,3,44,41
186,LLI,P009680,P012586,0 days 00:18:44,3,42,39
186,LLI,P009649,P012585,0 days 00:18:19,-1,43,44
186,LLI,P009680,P012585,0 days 00:17:17,4,39,35
186,LLI,P009649,P012797,0 days 00:17:05,13,40,27
186,LLI,P009680,P012797,0 days 00:16:32,6,35,29
186,LLI,P009649,P009680,0 days 00:15:52,3,38,35
186,LLI,P009649,P012586,0 days 00:15:23,4,36,32
186,LLI,P012585,P012797,0 days 00:15:06,10,35,25
186,LLI,P009672,P012585,0 days 00:14:03,-6,31,37
186,LLI,P012586,P012797,0 days 00:13:41,6,32,26
186,LLI,P005247,P012585,0 days 00:11:32,-2,25,27
186,LLI,P004773,P012020,0 days 00:10:49,15,31,16
186,LLI,P004773,P005247,0 days 00:10:49,15,31,16
186,LLI,P012020,P012585,0 days 00:10:16,-6,24,30
186,LLI,P009649,P009672,0 days 00:08:22,-4,17,21
186,LLI,P004773,P009672,0 days 00:07:57,12,25,13
186,LLI,P005247,P009680,0 days 00:07:46,5,14,9
186,LLI,P009672,P012797,0 days 00:07:27,-2,11,13
186,LLI,P009672,P009680,0 days 00:07:25,-2,14,16
186,LLI,P005247,P012586,0 days 00:07:15,-2,14,16
186,LLI,P005247,P012797,0 days 00:06:58,-1,9,10
186,LLI,P012020,P012586,0 days 00:06:55,-1,14,15
186,LLI,P009672,P012586,0 days 00:06:25,-8,12,20
186,LLI,P009680,P012020,0 days 00:06:01,5,13,8
186,LLI,P009649,P012020,0 days 00:06:00,-3,11,14
186,LLI,P005247,P009649,0 days 00:05:51,0,11,11
186,LLI,P012020,P012797,0 days 00:05:04,2,8,6
186,LLI,P004773,P009680,0 days 00:04:55,8,13,5
186,LLI,P004773,P012585,0 days 00:03:46,2,11,9
186,LLI,P004773,P012586,0 days 00:02:52,3,6,3
186,LLI,P004479,P005247,0 days 00:02:51,3,9,6
186,LLI,P004479,P009672,0 days 00:02:51,3,9,6
186,LLI,P004479,P012020,0 days 00:02:51,3,9,6
186,LLI,P004479,P004773,0 days 00:02:08,5,7,2
186,LLI,P004479,P012797,0 days 00:00:43,-2,2,4
187,BOU,P010431,P011836,0 days 00:21:54,8,54,46
187,BOU,P011836,P012617,0 days 00:20:31,23,57,34
187,BOU,P010431,P012617,0 days 00:19:15,12,51,39
187,BOU,P010718,P011836,0 days 00:17:51,2,41,39
187,BOU,P010718,P012617,0 days 00:17:21,6,41,35
187,BOU,P010431,P010718,0 days 00:16:54,0,39,39
187,BOU,P011837,P012617,0 days 00:16:43,13,43,30
187,BOU,P010431,P011837,0 days 00:16:01,11,39,28
187,BOU,P011836,P011837,0 days 00:14:51,16,39,23
187,BOU,P010449,P012628,0 days 00:14:27,0,30,30
187,BOU,P010718,P011837,0 days 00:13:14,5,29,24
187,BOU,P004525,P010449,0 days 00:12:19,-1,27,28
187,BOU,P011161,P012628,0 days 00:12:04,9,29,20
187,BOU,P010449,P011161,0 days 00:11:45,0,25,25
187,BOU,P012618,P012628,0 days 00:11:16,5,22,17
187,BOU,P004525,P012628,0 days 00:11:11,3,25,22
187,BOU,P010449,P012618,0 days 00:10:57,-4,18,22
187,BOU,P004525,P011161,0 days 00:10:38,3,23,20
187,BOU,P011836,P012628,0 days 00:09:33,13,29,16
187,BOU,P011837,P012628,0 days 00:09:28,11,32,21
187,BOU,P011161,P012618,0 days 00:09:27,5,17,12
187,BOU,P004525,P010431,0 days 00:07:51,-6,20,26
187,BOU,P010431,P012628,0 days 00:07:49,5,21,16
187,BOU,P004525,P010718,0 days 00:07:18,-6,18,24
187,BOU,P004525,P011837,0 days 00:07:00,-2,18,20
187,BOU,P011836,P012618,0 days 00:06:40,0,13,13
187,BOU,P004525,P012618,0 days 00:06:27,2,11,9
187,BOU,P012617,P012628,0 days 00:06:17,16,24,8
187,BOU,P004525,P012617,0 days 00:06:10,-2,16,18
187,BOU,P010449,P011836,0 days 00:06:02,-10,9,19
187,BOU,P010431,P010449,0 days 00:05:28,-7,9,16
187,BOU,P010449,P011837,0 days 00:05:08,1,14,13
187,BOU,P004525,P011836,0 days 00:05:02,-3,14,17
187,BOU,P011161,P011837,0 days 00:04:59,1,14,13
187,BOU,P011161,P011836,0 days 00:03:48,3,8,5
187,BOU,P010431,P012618,0 days 00:03:40,-3,7,10
187,BOU,P010449,P010718,0 days 00:02:46,-7,4,11
187,BOU,P011161,P012617,0 days 00:02:41,6,6,0
187,BOU,P010718,P011161,0 days 00:02:22,-3,2,5
187,BOU,P012617,P012618,0 days 00:02:10,6,6,0
187,BOU,P010718,P012618,0 days 00:01:51,-3,2,5
187,BOU,P010718,P012628,0 days 00:00:51,2,4,2
187,PMT,P002644,P012600,0 days 00:23:28,0,52,52
187,PMT,P011944,P012600,0 days 00:19:11,-4,40,44
187,PMT,P005301,P012600,0 days 00:16:50,-4,34,38
187,PMT,P011942,P011943,0 days 00:14:48,-7,29,36
187,PMT,P005301,P011944,0 days 00:14:29,-8,23,31
187,PMT,P002644,P002691,0 days 00:13:59,1,35,34
187,PMT,P002644,P011944,0 days 00:13:29,-5,26,31
187,PMT,P002644,P005301,0 days 00:13:08,-6,26,32
187,PMT,P002691,P012600,0 days 00:12:50,1,33,32
187,PMT,P002644,P011942,0 days 00:12:48,5,33,28
187,PMT,P011823,P011944,0 days 00:11:59,-10,20,30
187,PMT,P001686,P012600,0 days 00:10:52,-1,21,22
187,PMT,P011943,P011944,0 days 00:10:34,-8,19,27
187,PMT,P001686,P005301,0 days 00:10:18,1,23,22
187,PMT,P002644,P011943,0 days 00:10:03,10,29,19
187,PMT,P005301,P011823,0 days 00:09:55,-2,19,21
187,PMT,P011942,P012600,0 days 00:09:50,6,25,19
187,PMT,P011943,P012600,0 days 00:09:45,9,27,18
187,PMT,P011942,P011944,0 days 00:09:24,-9,15,24
187,PMT,P005301,P011942,0 days 00:09:07,-3,17,20
187,PMT,P011823,P011943,0 days 00:08:25,-15,10,25
187,PMT,P011944,P011966,0 days 00:08:19,-8,12,20
187,PMT,P011943,P011966,0 days 00:07:58,-5,17,22
187,PMT,P001686,P002644,0 days 00:07:42,-6,12,18
187,PMT,P002644,P011966,0 days 00:07:38,1,16,15
187,PMT,P011966,P012600,0 days 00:07:37,0,13,13
187,PMT,P001686,P011944,0 days 00:07:36,-2,11,13
187,PMT,P005301,P011966,0 days 00:07:17,-5,13,18
187,PMT,P002691,P011942,0 days 00:07:07,2,16,14
187,PMT,P011823,P011942,0 days 00:06:54,-13,6,19
187,PMT,P001686,P002691,0 days 00:06:45,-3,12,15
187,PMT,P011823,P012600,0 days 00:06:40,1,16,15
187,PMT,P005301,P011943,0 days 00:06:35,-6,13,19
187,PMT,P011942,P011966,0 days 00:06:13,-9,11,20
187,PMT,P002691,P011943,0 days 00:05:07,4,12,8
187,PMT,P001686,P011823,0 days 00:04:56,3,11,8
187,PMT,P011823,P011966,0 days 00:04:50,-10,6,16
187,PMT,P002691,P005301,0 days 00:04:25,1,12,11
187,PMT,P002691,P011944,0 days 00:04:13,-4,9,13
187,PMT,P002020,P002644,0 days 00:03:29,-4,11,15
187,PMT,P002020,P012600,0 days 00:03:29,-4,11,15
187,PMT,P002020,P002691,0 days 00:03:21,-4,11,15
187,PMT,P002020,P011944,0 days 00:02:38,-2,9,11
187,PMT,P001686,P011942,0 days 00:01:46,-2,2,4
187,PMT,P002020,P011942,0 days 00:00:51,-2,2,4
187,PMT,P001686,P011943,0 days 00:00:37,-2,0,2
187,PMT,P002691,P011823,0 days 00:00:37,-2,0,2
187,PMT,P002020,P005301,0 days 00:00:08,0,0,0
188,HTA,P007867,P010550,0 days 00:25:47,-4,59,63
188,HTA,P004846,P006835,0 days 00:22:30,10,56,46
188,HTA,P004846,P007867,0 days 00:21:49,2,55,53
188,HTA,P006835,P007867,0 days 00:19:25,9,48,39
188,HTA,P004846,P010550,0 days 00:19:14,-1,44,45
188,HTA,P007867,P011973,0 days 00:18:38,-13,38,51
188,HTA,P006835,P007759,0 days 00:14:39,-1,24,25
188,HTA,P006835,P010550,0 days 00:14:34,7,34,27
188,HTA,P007867,P010465,0 days 00:14:19,-5,34,39
188,HTA,P010465,P010550,0 days 00:14:16,2,32,30
188,HTA,P010550,P011973,0 days 00:13:22,-11,28,39
188,HTA,P004846,P011973,0 days 00:12:20,-14,26,40
188,HTA,P004846,P007759,0 days 00:10:32,1,19,18
188,HTA,P010465,P011973,0 days 00:10:29,-3,26,29
188,HTA,P007759,P007867,0 days 00:09:23,-1,17,18
188,HTA,P004267,P004846,0 days 00:09:20,4,25,21
188,HTA,P004267,P006835,0 days 00:09:20,6,26,20
188,HTA,P006835,P010465,0 days 00:09:05,-17,16,33
188,HTA,P007759,P011973,0 days 00:08:09,-4,16,20
188,HTA,P007759,P010550,0 days 00:08:08,-2,17,19
188,HTA,P006835,P011973,0 days 00:08:04,-4,17,21
188,HTA,P004846,P010465,0 days 00:08:00,-9,19,28
188,HTA,P007867,P011991,0 days 00:07:10,7,15,8
188,HTA,P004267,P007867,0 days 00:07:07,4,20,16
188,HTA,P011973,P011991,0 days 00:06:49,4,14,10
188,HTA,P010550,P011991,0 days 00:06:48,7,15,8
188,HTA,P007759,P010465,0 days 00:06:37,-5,11,16
188,HTA,P007867,P012794,0 days 00:05:46,-11,11,22
188,HTA,P011973,P012794,0 days 00:05:36,-11,11,22
188,HTA,P004846,P012794,0 days 00:05:00,-6,9,15
188,HTA,P004267,P010550,0 days 00:04:55,1,12,11
188,HTA,P010465,P011991,0 days 00:04:53,3,10,7
188,HTA,P010550,P012794,0 days 00:04:40,-15,7,22
188,HTA,P004267,P007759,0 days 00:04:04,0,7,7
188,HTA,P003533,P004846,0 days 00:04:00,3,10,7
188,HTA,P003533,P006835,0 days 00:04:00,3,10,7
188,HTA,P003533,P004267,0 days 00:04:00,3,10,7
188,HTA,P006835,P011991,0 days 00:03:39,7,9,2
188,HTA,P004846,P011991,0 days 00:03:23,6,9,3
188,HTA,P004267,P011973,0 days 00:02:17,-4,4,8
188,HTA,P003533,P007759,0 days 00:02:16,-1,3,4
188,HTA,P007759,P011991,0 days 00:01:50,2,4,2
188,HTA,P003533,P007867,0 days 00:01:44,4,7,3
188,HTA,P006835,P012794,0 days 00:01:16,4,4,0
188,HTA,P007759,P012794,0 days 00:00:46,-5,2,7
188,HTA,P004267,P010465,0 days 00:00:01,-2,0,2
188,BES,P011936,P012647,0 days 00:26:01,15,74,59
188,BES,P011936,P012711,0 days 00:21:38,13,57,44
188,BES,P011936,P012622,0 days 00:21:29,23,61,38
188,BES,P012622,P012647,0 days 00:18:39,26,58,32
188,BES,P003783,P012711,0 days 00:17:50,-6,36,42
188,BES,P008945,P011936,0 days 00:17:38,13,49,36
188,BES,P008945,P012622,0 days 00:17:35,14,45,31
188,BES,P008945,P012647,0 days 00:16:21,10,49,39
188,BES,P012622,P012711,0 days 00:16:18,17,40,23
188,BES,P012647,P012711,0 days 00:15:28,18,50,32
188,BES,P003783,P011936,0 days 00:15:11,0,35,35
188,BES,P003783,P012647,0 days 00:13:41,6,35,29
188,BES,P008945,P011379,0 days 00:13:34,-10,22,32
188,BES,P011379,P011936,0 days 00:13:25,-3,24,27
188,BES,P003783,P011924,0 days 00:12:59,-13,22,35
188,BES,P011924,P012647,0 days 00:12:00,-2,31,33
188,BES,P011924,P011936,0 days 00:11:35,-6,26,32
188,BES,P011924,P012711,0 days 00:10:43,-13,18,31
188,BES,P011379,P012622,0 days 00:10:25,-7,13,20
188,BES,P011379,P012647,0 days 00:09:51,-7,19,26
188,BES,P003783,P012622,0 days 00:09:46,4,18,14
188,BES,P008945,P012711,0 days 00:09:43,9,24,15
188,BES,P011379,P012711,0 days 00:07:39,-6,10,16
188,BES,P011924,P012622,0 days 00:06:47,-4,11,15
188,BES,P007914,P012647,0 days 00:06:20,-2,16,18
188,BES,P011379,P011924,0 days 00:05:46,-5,12,17
188,BES,P003783,P011379,0 days 00:05:37,-7,7,14
188,BES,P007914,P011924,0 days 00:05:03,0,10,10
188,BES,P003783,P007914,0 days 00:04:34,-4,7,11
188,BES,P008945,P011924,0 days 00:04:19,3,14,11
188,BES,P007914,P008945,0 days 00:04:05,-7,9,16
188,BES,P007914,P011379,0 days 00:03:43,-7,9,16
188,BES,P007914,P012711,0 days 00:03:17,-4,5,9
188,BES,P007914,P012622,0 days 00:02:54,-1,2,3
188,BES,P007914,P011936,0 days 00:02:32,-3,6,9
188,BES,P003783,P008945,0 days 00:01:54,-4,0,4
188,BES,P007917,P008945,0 days 00:00:55,0,4,4
188,BES,P007917,P011936,0 days 00:00:55,0,4,4
188,BES,P007917,P012622,0 days 00:00:55,0,4,4
188,BES,P007917,P012647,0 days 00:00:55,0,4,4
189,PRS,P012608,P012610,0 days 00:24:54,15,64,49
189,PRS,P011232,P012640,0 days 00:20:04,6,56,50
189,PRS,P011232,P012609,0 days 00:19:22,9,52,43
189,PRS,P012609,P012640,0 days 00:19:08,8,51,43
189,PRS,P012609,P012613,0 days 00:16:16,0,36,36
189,PRS,P012613,P012640,0 days 00:15:34,-1,37,38
189,PRS,P012610,P012611,0 days 00:15:02,4,32,28
189,PRS,P012608,P012611,0 days 00:15:02,4,32,28
189,PRS,P004512,P012608,0 days 00:14:47,10,32,22
189,PRS,P011232,P012613,0 days 00:14:20,-4,32,36
189,PRS,P004512,P012610,0 days 00:13:50,9,31,22
189,PRS,P009556,P011232,0 days 00:13:27,-3,34,37
189,PRS,P009556,P012640,0 days 00:13:27,-3,34,37
189,PRS,P009556,P012613,0 days 00:11:57,-1,30,31
189,PRS,P009556,P012609,0 days 00:11:57,-1,30,31
189,PRS,P005793,P012610,0 days 00:11:26,3,27,24
189,PRS,P012608,P012613,0 days 00:11:05,3,22,19
189,PRS,P011232,P012610,0 days 00:11:05,6,34,28
189,PRS,P004512,P012611,0 days 00:11:04,9,23,14
189,PRS,P012608,P012609,0 days 00:10:39,10,28,18
189,PRS,P011232,P012608,0 days 00:10:17,8,30,22
189,PRS,P005793,P012608,0 days 00:09:56,5,23,18
189,PRS,P012608,P012640,0 days 00:09:32,9,29,20
189,PRS,P012610,P012613,0 days 00:09:26,2,21,19
189,PRS,P012610,P012640,0 days 00:09:23,6,32,26
189,PRS,P012609,P012610,0 days 00:09:00,9,27,18
189,PRS,P005793,P012611,0 days 00:08:45,3,19,16
189,PRS,P004512,P005793,0 days 00:07:34,2,15,13
189,PRS,P004512,P012613,0 days 00:07:13,8,17,9
189,PRS,P012611,P012613,0 days 00:06:17,1,13,12
189,PRS,P005793,P011232,0 days 00:03:52,1,12,11
189,PRS,P004512,P012640,0 days 00:02:55,0,7,7
189,PRS,P011232,P012611,0 days 00:02:29,-3,6,9
189,PRS,P005793,P012640,0 days 00:01:53,-1,6,7
189,PRS,P004512,P012609,0 days 00:01:45,2,3,1
189,PRS,P005793,P009556,0 days 00:01:30,-2,4,6
189,PRS,P009556,P012610,0 days 00:01:30,-2,4,6
189,PRS,P012609,P012611,0 days 00:01:29,-2,3,5
189,PRS,P005793,P012609,0 days 00:00:48,1,2,1
189,LLI,P012585,P012797,0 days 00:21:39,-10,46,56
189,LLI,P009649,P012586,0 days 00:19:19,-4,39,43
189,LLI,P009649,P012797,0 days 00:18:03,1,39,38
189,LLI,P006600,P012797,0 days 00:17:28,-2,36,38
189,LLI,P006600,P009649,0 days 00:17:24,-1,39,40
189,LLI,P009649,P012585,0 days 00:15:26,-4,34,38
189,LLI,P006600,P012586,0 days 00:15:15,-7,34,41
189,LLI,P012585,P012586,0 days 00:14:55,-1,32,33
189,LLI,P006600,P012585,0 days 00:14:43,-7,31,38
189,LLI,P009672,P009680,0 days 00:13:43,-14,23,37
189,LLI,P012586,P012797,0 days 00:13:37,-2,29,31
189,LLI,P004773,P009672,0 days 00:12:51,-3,25,28
189,LLI,P005247,P009680,0 days 00:12:35,-11,26,37
189,LLI,P005247,P009672,0 days 00:12:09,-12,26,38
189,LLI,P009649,P009672,0 days 00:09:05,-5,13,18
189,LLI,P009672,P012585,0 days 00:09:02,-10,17,27
189,LLI,P005247,P012585,0 days 00:08:59,-5,19,24
189,LLI,P009672,P012797,0 days 00:08:54,-5,16,21
189,LLI,P004773,P009680,0 days 00:08:42,-10,13,23
189,LLI,P009672,P012586,0 days 00:08:35,-3,14,17
189,LLI,P006600,P009672,0 days 00:08:04,3,22,19
189,LLI,P009680,P012586,0 days 00:07:50,-3,12,15
189,LLI,P009680,P012585,0 days 00:07:48,-1,18,19
189,LLI,P005247,P012797,0 days 00:06:29,-5,13,18
189,LLI,P004773,P009649,0 days 00:05:58,1,8,7
189,LLI,P004773,P012586,0 days 00:05:52,-4,8,12
189,LLI,P004479,P006600,0 days 00:05:45,0,19,19
189,LLI,P004773,P005247,0 days 00:05:32,-6,12,18
189,LLI,P009680,P012797,0 days 00:05:18,-1,12,13
189,LLI,P009649,P009680,0 days 00:04:47,2,10,8
189,LLI,P004773,P006600,0 days 00:04:41,5,12,7
189,LLI,P006600,P009680,0 days 00:04:38,3,16,13
189,LLI,P004479,P012586,0 days 00:04:26,2,14,12
189,LLI,P009672,P012020,0 days 00:04:14,-10,7,17
189,LLI,P012020,P012797,0 days 00:04:11,2,11,9
189,LLI,P005247,P006600,0 days 00:04:10,-2,11,13
189,LLI,P009649,P012020,0 days 00:04:03,2,11,9
189,LLI,P012020,P012585,0 days 00:04:03,2,11,9
189,LLI,P004479,P009649,0 days 00:03:47,0,11,11
189,LLI,P004479,P009672,0 days 00:03:43,-1,13,14
189,LLI,P005247,P012586,0 days 00:03:10,-1,5,6
189,LLI,P004773,P012797,0 days 00:02:38,6,6,0
189,LLI,P004773,P012020,0 days 00:02:36,-5,5,10
189,LLI,P005247,P012020,0 days 00:02:28,-5,5,10
189,LLI,P009680,P012020,0 days 00:02:28,-5,5,10
189,LLI,P012020,P012586,0 days 00:02:25,7,9,2
189,LLI,P004479,P009680,0 days 00:02:15,0,9,9
189,LLI,P004479,P004773,0 days 00:02:05,0,7,7
189,LLI,P004773,P012585,0 days 00:01:05,0,4,4
189,LLI,P004479,P005247,0 days 00:00:36,-1,3,4
189,LLI,P004479,P012797,0 days 00:00:23,0,0,0
189,LLI,P006600,P012020,0 days 00:00:08,0,0,0
190,BOU,P010718,P012617,0 days 00:20:31,2,51,49
190,BOU,P011836,P012617,0 days 00:19:35,-3,43,46
190,BOU,P010718,P011836,0 days 00:19:24,1,44,43
190,BOU,P010431,P011836,0 days 00:19:00,0,37,37
190,BOU,P011837,P012617,0 days 00:17:37,7,39,32
190,BOU,P010431,P012617,0 days 00:16:55,-3,34,37
190,BOU,P010431,P010718,0 days 00:15:14,0,32,32
190,BOU,P011836,P011837,0 days 00:15:12,-1,28,29
190,BOU,P010718,P011837,0 days 00:13:59,7,34,27
190,BOU,P010431,P011837,0 days 00:13:56,-1,24,25
190,BOU,P004525,P012628,0 days 00:12:33,5,27,22
190,BOU,P011161,P011836,0 days 00:11:57,-2,24,26
190,BOU,P010449,P012628,0 days 00:10:45,1,18,17
190,BOU,P011161,P012628,0 days 00:10:41,6,21,15
190,BOU,P010449,P011161,0 days 00:10:17,0,18,18
190,BOU,P010449,P011836,0 days 00:09:48,2,18,16
190,BOU,P004525,P011161,0 days 00:09:46,4,19,15
190,BOU,P011836,P012618,0 days 00:09:26,6,23,17
190,BOU,P004525,P012617,0 days 00:08:44,11,27,16
190,BOU,P011161,P012617,0 days 00:08:30,8,20,12
190,BOU,P011836,P012628,0 days 00:08:25,-1,17,18
190,BOU,P011161,P011837,0 days 00:07:55,5,17,12
190,BOU,P011161,P012618,0 days 00:07:41,9,16,7
190,BOU,P011837,P012628,0 days 00:07:38,9,19,10
190,BOU,P010449,P012618,0 days 00:07:21,7,14,7
190,BOU,P010431,P012618,0 days 00:07:11,3,18,15
190,BOU,P010718,P012618,0 days 00:07:11,-3,13,16
190,BOU,P004525,P011837,0 days 00:06:32,11,19,8
190,BOU,P004525,P010449,0 days 00:06:23,-4,8,12
190,BOU,P012617,P012628,0 days 00:06:10,9,19,10
190,BOU,P012617,P012618,0 days 00:06:10,1,15,14
190,BOU,P004525,P010718,0 days 00:06:03,3,19,16
190,BOU,P012618,P012628,0 days 00:05:14,7,11,4
190,BOU,P010718,P011161,0 days 00:04:58,3,12,9
190,BOU,P004525,P011836,0 days 00:04:45,-6,10,16
190,BOU,P010431,P010449,0 days 00:04:12,5,8,3
190,BOU,P010449,P011837,0 days 00:04:07,3,8,5
190,BOU,P004525,P012618,0 days 00:03:50,2,6,4
190,BOU,P010718,P012628,0 days 00:03:29,1,11,10
190,BOU,P010431,P011161,0 days 00:03:23,-1,5,6
190,BOU,P010449,P010718,0 days 00:02:55,2,4,2
190,BOU,P010431,P012628,0 days 00:02:45,3,5,2
190,BOU,P004525,P010431,0 days 00:01:52,2,5,3
190,BES,P008945,P012647,0 days 00:24:22,-5,47,52
190,BES,P008945,P011936,0 days 00:20:30,-11,35,46
190,BES,P011936,P012647,0 days 00:18:28,-7,33,40
190,BES,P011379,P012647,0 days 00:17:51,-7,31,38
190,BES,P008945,P011379,0 days 00:17:42,-5,33,38
190,BES,P008945,P012622,0 days 00:17:40,-6,30,36
190,BES,P012622,P012647,0 days 00:16:15,-5,25,30
190,BES,P011936,P012622,0 days 00:14:48,-8,21,29
190,BES,P011379,P011936,0 days 00:13:59,-5,24,29
190,BES,P003783,P012711,0 days 00:12:24,3,30,27
190,BES,P007914,P012647,0 days 00:12:09,-7,16,23
190,BES,P007914,P011924,0 days 00:11:52,-1,28,29
190,BES,P003783,P007914,0 days 00:11:43,1,26,25
190,BES,P007914,P011379,0 days 00:10:53,0,24,24
190,BES,P007914,P008945,0 days 00:10:52,-5,18,23
190,BES,P011379,P012622,0 days 00:10:41,4,22,18
190,BES,P011924,P012711,0 days 00:10:29,-4,19,23
190,BES,P003783,P012647,0 days 00:10:24,0,20,20
190,BES,P011924,P012647,0 days 00:10:17,-5,18,23
190,BES,P011379,P011924,0 days 00:10:16,3,29,26
190,BES,P003783,P011924,0 days 00:09:41,-2,20,22
190,BES,P008945,P012711,0 days 00:09:38,-2,18,20
190,BES,P008945,P011924,0 days 00:09:17,-7,18,25
190,BES,P007914,P012711,0 days 00:08:41,4,22,18
190,BES,P012647,P012711,0 days 00:08:06,4,18,14
190,BES,P003783,P011379,0 days 00:07:39,4,20,16
190,BES,P012622,P012711,0 days 00:07:26,-7,8,15
190,BES,P003783,P008945,0 days 00:07:15,1,17,16
190,BES,P011924,P012622,0 days 00:07:11,-2,11,13
190,BES,P003783,P012622,0 days 00:06:30,-4,6,10
190,BES,P011936,P012711,0 days 00:05:52,-3,11,14
190,BES,P007914,P012622,0 days 00:05:39,-4,9,13
190,BES,P007914,P011936,0 days 00:04:40,-11,0,11
190,BES,P003783,P011936,0 days 00:04:31,-2,8,10
190,BES,P011924,P011936,0 days 00:04:12,-5,8,13
190,BES,P011379,P012711,0 days 00:03:39,6,13,7
190,BES,P003783,P007917,0 days 00:01:15,-5,1,6
190,BES,P007914,P007917,0 days 00:01:15,-5,1,6
190,BES,P007917,P011924,0 days 00:01:15,-5,1,6
190,BES,P007917,P012711,0 days 00:01:15,-5,1,6
190,BES,P003783,P011357,0 days 00:00:22,0,0,0
190,BES,P011357,P011924,0 days 00:00:22,0,0,0
190,BES,P011357,P012622,0 days 00:00:22,0,0,0
190,BES,P011357,P012711,0 days 00:00:22,0,0,0
191,LLI,P009680,P012585,0 days 00:22:27,-6,53,59
191,LLI,P006600,P012585,0 days 00:21:09,-12,37,49
191,LLI,P006600,P009680,0 days 00:20:16,-12,36,48
191,LLI,P009672,P012585,0 days 00:16:41,-5,41,46
191,LLI,P005247,P009672,0 days 00:16:04,13,49,36
191,LLI,P009680,P012797,0 days 00:14:29,-13,22,35
191,LLI,P004773,P009672,0 days 00:13:41,6,34,28
191,LLI,P005247,P012585,0 days 00:13:02,5,36,31
191,LLI,P012585,P012797,0 days 00:12:53,-8,23,31
191,LLI,P006600,P012797,0 days 00:12:47,-13,16,29
191,LLI,P005247,P009680,0 days 00:12:27,7,35,28
191,LLI,P009672,P009680,0 days 00:12:03,2,36,34
191,LLI,P009649,P012797,0 days 00:11:49,-10,21,31
191,LLI,P009672,P012020,0 days 00:11:41,6,28,22
191,LLI,P004773,P012020,0 days 00:11:13,8,30,22
191,LLI,P005247,P006600,0 days 00:11:02,3,24,21
191,LLI,P006600,P009672,0 days 00:10:26,-3,22,25
191,LLI,P009649,P012585,0 days 00:10:12,-11,16,27
191,LLI,P012020,P012586,0 days 00:09:26,3,21,18
191,LLI,P004773,P012797,0 days 00:08:51,-4,16,20
191,LLI,P009649,P009680,0 days 00:08:41,-13,12,25
191,LLI,P005247,P012797,0 days 00:08:35,4,18,14
191,LLI,P004773,P005247,0 days 00:08:28,9,25,16
191,LLI,P009649,P012020,0 days 00:08:27,-6,15,21
191,LLI,P004773,P009680,0 days 00:08:27,-14,13,27
191,LLI,P009672,P012586,0 days 00:08:07,1,15,14
191,LLI,P012020,P012797,0 days 00:07:03,2,18,16
191,LLI,P006600,P009649,0 days 00:06:58,-9,10,19
191,LLI,P004773,P012586,0 days 00:06:23,8,17,9
191,LLI,P005247,P012020,0 days 00:06:10,9,18,9
191,LLI,P004773,P012585,0 days 00:06:09,-7,13,20
191,LLI,P009672,P012797,0 days 00:05:57,4,16,12
191,LLI,P009649,P012586,0 days 00:05:28,-3,10,13
191,LLI,P004773,P009649,0 days 00:05:13,-4,9,13
191,LLI,P009649,P009672,0 days 00:04:52,-4,7,11
191,LLI,P004773,P006600,0 days 00:04:47,-10,3,13
191,LLI,P012020,P012585,0 days 00:04:42,-3,9,12
191,LLI,P012585,P012586,0 days 00:04:09,-5,4,9
191,LLI,P005247,P012586,0 days 00:04:04,6,11,5
191,LLI,P009680,P012020,0 days 00:02:22,-3,5,8
191,LLI,P012586,P012797,0 days 00:01:52,2,6,4
191,LLI,P006600,P012586,0 days 00:00:27,0,0,0
191,PRS,P012608,P012610,0 days 00:27:01,4,65,61
191,PRS,P004512,P012608,0 days 00:20:25,8,50,42
191,PRS,P011232,P012640,0 days 00:20:12,5,47,42
191,PRS,P004512,P012610,0 days 00:20:11,8,50,42
191,PRS,P012608,P012611,0 days 00:19:17,3,46,43
191,PRS,P011232,P012609,0 days 00:19:03,-2,41,43
191,PRS,P012610,P012611,0 days 00:19:03,3,46,43
191,PRS,P004512,P012611,0 days 00:18:11,8,44,36
191,PRS,P012609,P012640,0 days 00:17:43,3,39,36
191,PRS,P011232,P012613,0 days 00:13:56,6,30,24
191,PRS,P012613,P012640,0 days 00:13:31,6,30,24
191,PRS,P009556,P011232,0 days 00:12:45,4,28,24
191,PRS,P012609,P012613,0 days 00:12:45,4,28,24
191,PRS,P009556,P012640,0 days 00:12:45,4,28,24
191,PRS,P009556,P012613,0 days 00:12:45,4,28,24
191,PRS,P009556,P012609,0 days 00:12:45,4,28,24
191,PRS,P011232,P012608,0 days 00:09:24,-1,24,25
191,PRS,P012610,P012613,0 days 00:09:16,4,23,19
191,PRS,P012608,P012613,0 days 00:09:16,4,23,19
191,PRS,P011232,P012610,0 days 00:09:10,-1,24,25
191,PRS,P004512,P012613,0 days 00:08:30,2,21,19
191,PRS,P012608,P012609,0 days 00:08:15,-4,16,20
191,PRS,P012611,P012613,0 days 00:08:05,2,21,19
191,PRS,P012609,P012610,0 days 00:08:01,-4,16,20
191,PRS,P004512,P005793,0 days 00:07:55,1,17,16
191,PRS,P005793,P012608,0 days 00:07:55,1,17,16
191,PRS,P005793,P012610,0 days 00:07:55,1,17,16
191,PRS,P005793,P012611,0 days 00:07:49,1,17,16
191,PRS,P012610,P012640,0 days 00:07:27,1,19,18
191,PRS,P012608,P012640,0 days 00:07:27,1,19,18
191,PRS,P012609,P012611,0 days 00:03:11,-3,5,8
191,PRS,P004512,P011232,0 days 00:02:34,3,9,6
191,PRS,P004512,P012609,0 days 00:02:11,2,3,1
191,PRS,P004512,P012640,0 days 00:01:43,0,6,6
191,PRS,P011232,P012611,0 days 00:01:32,-2,5,7
191,PRS,P005793,P012609,0 days 00:00:06,0,0,0
192,BES,P011936,P012647,0 days 00:26:48,11,55,44
192,BES,P011936,P012622,0 days 00:25:37,4,51,47
192,BES,P012622,P012647,0 days 00:23:39,3,43,40
192,BES,P008945,P012647,0 days 00:23:24,-7,38,45
192,BES,P008945,P012622,0 days 00:22:23,-9,33,42
192,BES,P008945,P011936,0 days 00:22:18,-5,39,44
192,BES,P007914,P011936,0 days 00:15:52,-2,30,32
192,BES,P007914,P012711,0 days 00:15:48,3,32,29
192,BES,P007914,P012622,0 days 00:15:27,-3,27,30
192,BES,P007914,P012647,0 days 00:13:54,-3,22,25
192,BES,P007914,P008945,0 days 00:13:31,-9,19,28
192,BES,P011379,P012647,0 days 00:12:58,9,30,21
192,BES,P011379,P011936,0 days 00:12:58,9,30,21
192,BES,P003783,P011936,0 days 00:12:45,19,38,19
192,BES,P011936,P012711,0 days 00:11:54,4,27,23
192,BES,P003783,P007914,0 days 00:11:48,9,30,21
192,BES,P003783,P012647,0 days 00:11:26,20,34,14
192,BES,P012622,P012711,0 days 00:10:43,0,23,23
192,BES,P011379,P012622,0 days 00:10:38,7,23,16
192,BES,P003783,P012622,0 days 00:09:54,12,28,16
192,BES,P008945,P011379,0 days 00:09:50,1,19,18
192,BES,P008945,P012711,0 days 00:09:43,2,20,18
192,BES,P012647,P012711,0 days 00:08:11,3,16,13
192,BES,P003783,P012711,0 days 00:07:40,4,18,14
192,BES,P003783,P011379,0 days 00:07:16,16,25,9
192,BES,P003783,P008945,0 days 00:04:02,5,12,7
192,BES,P008945,P011924,0 days 00:03:49,-2,4,6
192,BES,P011924,P012622,0 days 00:03:47,-2,4,6
192,BES,P007914,P011924,0 days 00:03:14,5,9,4
192,BES,P011924,P012711,0 days 00:03:14,5,9,4
192,BES,P011924,P011936,0 days 00:02:52,-4,2,6
192,BES,P011924,P012647,0 days 00:02:52,-4,2,6
192,BES,P007914,P011379,0 days 00:02:50,0,7,7
192,BES,P011379,P011924,0 days 00:02:19,3,7,4
192,BES,P011379,P012711,0 days 00:02:19,3,7,4
192,BES,P003783,P011924,0 days 00:02:17,3,7,4
192,BOU,P010431,P011836,0 days 00:19:37,-12,33,45
192,BOU,P010718,P011836,0 days 00:19:14,-2,34,36
192,BOU,P010431,P010718,0 days 00:19:08,-2,36,38
192,BOU,P010431,P011837,0 days 00:18:29,-12,31,43
192,BOU,P010718,P011837,0 days 00:16:34,-7,29,36
192,BOU,P012618,P012628,0 days 00:16:28,-7,28,35
192,BOU,P011836,P011837,0 days 00:16:06,-15,24,39
192,BOU,P011161,P012618,0 days 00:15:37,-6,25,31
192,BOU,P010431,P012617,0 days 00:15:30,-8,25,33
192,BOU,P010449,P012618,0 days 00:14:53,9,32,23
192,BOU,P011837,P012617,0 days 00:14:36,-8,23,31
192,BOU,P011836,P012617,0 days 00:14:10,-11,22,33
192,BOU,P004525,P012618,0 days 00:14:07,-6,22,28
192,BOU,P004525,P012628,0 days 00:14:07,-6,22,28
192,BOU,P010718,P012617,0 days 00:13:35,-3,23,26
192,BOU,P011161,P012628,0 days 00:13:08,-9,20,29
192,BOU,P004525,P011161,0 days 00:11:44,-10,16,26
192,BOU,P010449,P012628,0 days 00:11:12,-1,24,25
192,BOU,P010449,P011161,0 days 00:09:53,2,19,17
192,BOU,P010449,P011836,0 days 00:09:20,3,20,17
192,BOU,P004525,P010449,0 days 00:08:58,4,18,14
192,BOU,P010431,P010449,0 days 00:08:53,3,21,18
192,BOU,P010449,P010718,0 days 00:08:02,4,18,14
192,BOU,P011161,P012617,0 days 00:07:39,-13,8,21
192,BOU,P011836,P012618,0 days 00:07:24,7,18,11
192,BOU,P004525,P012617,0 days 00:07:04,-5,9,14
192,BOU,P012617,P012618,0 days 00:06:38,-8,8,16
192,BOU,P010431,P012618,0 days 00:05:54,7,15,8
192,BOU,P011161,P011836,0 days 00:05:48,-1,11,12
192,BOU,P012617,P012628,0 days 00:05:44,-8,6,14
192,BOU,P010718,P012618,0 days 00:05:03,8,12,4
192,BOU,P004525,P010431,0 days 00:04:18,9,11,2
192,BOU,P010449,P011837,0 days 00:03:53,-4,8,12
192,BOU,P010431,P012628,0 days 00:03:48,0,10,10
192,BOU,P010718,P011161,0 days 00:02:29,3,5,2
192,BOU,P011836,P012628,0 days 00:02:21,-1,6,7
192,BOU,P010431,P011161,0 days 00:01:55,-5,2,7
192,BOU,P011161,P011837,0 days 00:01:55,-5,2,7
192,BOU,P004525,P010718,0 days 00:01:55,5,5,0
192,BOU,P004525,P011837,0 days 00:01:55,5,5,0
192,BOU,P010718,P012628,0 days 00:00:28,-2,2,4
192,BOU,P011837,P012628,0 days 00:00:28,-2,2,4
194,BOU,P011836,P012617,0 days 00:15:38,6,35,29
194,BOU,P010449,P011161,0 days 00:15:21,17,37,20
194,BOU,P010718,P011837,0 days 00:15:11,18,36,18
194,BOU,P004525,P011161,0 days 00:14:37,13,34,21
194,BOU,P010718,P011836,0 days 00:14:15,1,33,32
194,BOU,P010431,P011836,0 days 00:14:02,8,35,27
194,BOU,P011161,P011836,0 days 00:13:15,2,30,28
194,BOU,P004525,P011836,0 days 00:11:06,10,28,18
194,BOU,P010718,P012617,0 days 00:11:02,6,28,22
194,BOU,P011161,P012628,0 days 00:10:44,0,18,18
194,BOU,P010449,P012628,0 days 00:10:19,4,19,15
194,BOU,P010431,P010718,0 days 00:10:18,3,23,20
194,BOU,P004525,P010449,0 days 00:10:18,1,22,21
194,BOU,P004525,P012628,0 days 00:10:07,4,18,14
194,BOU,P010449,P011837,0 days 00:09:15,19,24,5
194,BOU,P010449,P010718,0 days 00:09:09,8,18,10
194,BOU,P010431,P012617,0 days 00:09:06,7,22,15
194,BOU,P011161,P012617,0 days 00:08:59,0,18,18
194,BOU,P011836,P011837,0 days 00:08:42,5,20,15
194,BOU,P004525,P012617,0 days 00:08:41,11,20,9
194,BOU,P010431,P011837,0 days 00:08:36,10,21,11
194,BOU,P012618,P012628,0 days 00:08:25,-3,14,17
194,BOU,P010431,P010449,0 days 00:08:25,7,22,15
194,BOU,P010450,P011837,0 days 00:08:15,19,22,3
194,BOU,P010449,P012618,0 days 00:08:12,-1,14,15
194,BOU,P004525,P010431,0 days 00:08:03,5,20,15
194,BOU,P011161,P012618,0 days 00:07:59,-8,12,20
194,BOU,P010450,P010718,0 days 00:07:48,14,17,3
194,BOU,P010449,P011836,0 days 00:07:47,-1,18,19
194,BOU,P010718,P011161,0 days 00:07:40,6,18,12
194,BOU,P010449,P010450,0 days 00:07:19,18,18,0
194,BOU,P010450,P011161,0 days 00:06:32,13,16,3
194,BOU,P004525,P012618,0 days 00:06:31,1,12,11
194,BOU,P011161,P011837,0 days 00:06:25,14,18,4
194,BOU,P010431,P011161,0 days 00:06:04,11,19,8
194,BOU,P011837,P012617,0 days 00:05:58,4,14,10
194,BOU,P011836,P012628,0 days 00:05:30,-1,8,9
194,BOU,P004525,P010718,0 days 00:05:11,2,12,10
194,BOU,P010450,P012628,0 days 00:04:05,6,9,3
194,BOU,P010718,P012628,0 days 00:04:05,6,9,3
194,BOU,P012617,P012628,0 days 00:04:03,1,6,5
194,BOU,P011837,P012628,0 days 00:03:42,6,9,3
194,BOU,P011836,P012618,0 days 00:03:04,-9,4,13
194,BOU,P010431,P010450,0 days 00:02:53,5,8,3
194,BOU,P000498,P010450,0 days 00:02:07,1,4,3
194,BOU,P000498,P010718,0 days 00:02:07,1,4,3
194,BOU,P000498,P012628,0 days 00:02:07,1,4,3
194,BOU,P000498,P011837,0 days 00:01:44,1,4,3
194,BOU,P010431,P012618,0 days 00:01:36,0,4,4
194,BOU,P010450,P012617,0 days 00:01:30,0,3,3
194,BOU,P012617,P012618,0 days 00:01:23,-7,2,9
194,BOU,P004525,P010450,0 days 00:01:22,1,2,1
194,BOU,P010431,P012628,0 days 00:01:17,0,2,2
194,BOU,P010718,P012618,0 days 00:01:10,-5,2,7
194,BOU,P010450,P011836,0 days 00:00:37,-1,1,2
194,BOU,P000498,P010449,0 days 00:00:23,0,0,0
194,BES,P007914,P008945,0 days 00:23:51,-6,43,49
194,BES,P008945,P011379,0 days 00:23:33,-17,37,54
194,BES,P007914,P011379,0 days 00:22:53,-9,39,48
194,BES,P008945,P011924,0 days 00:17:59,-24,20,44
194,BES,P007914,P011924,0 days 00:17:44,-14,22,36
194,BES,P011379,P011924,0 days 00:17:25,-21,23,44
194,BES,P003783,P011924,0 days 00:14:57,-12,21,33
194,BES,P003783,P012711,0 days 00:13:29,-7,21,28
194,BES,P008945,P012711,0 days 00:12:54,-7,22,29
194,BES,P011379,P012711,0 days 00:12:43,-6,21,27
194,BES,P003783,P008945,0 days 00:12:42,-10,21,31
194,BES,P007914,P012711,0 days 00:12:34,-2,26,28
194,BES,P011924,P012711,0 days 00:12:23,-17,10,27
194,BES,P008945,P011936,0 days 00:11:50,-3,20,23
194,BES,P011379,P011936,0 days 00:11:04,-3,21,24
194,BES,P003783,P011379,0 days 00:10:38,-10,18,28
194,BES,P008945,P011357,0 days 00:10:20,-15,10,25
194,BES,P003783,P007914,0 days 00:09:47,3,22,19
194,BES,P008945,P012647,0 days 00:09:20,3,25,22
194,BES,P007914,P012647,0 days 00:09:04,5,22,17
194,BES,P011936,P012711,0 days 00:08:45,-3,14,17
194,BES,P007914,P011357,0 days 00:08:25,-9,9,18
194,BES,P011924,P012647,0 days 00:08:11,-5,17,22
194,BES,P007914,P011936,0 days 00:07:56,4,17,13
194,BES,P011357,P011379,0 days 00:07:54,-16,6,22
194,BES,P011379,P012647,0 days 00:07:31,2,19,17
194,BES,P011357,P011924,0 days 00:07:29,-8,8,16
194,BES,P003783,P011936,0 days 00:07:00,-8,8,16
194,BES,P003783,P011357,0 days 00:05:54,-6,7,13
194,BES,P011936,P012647,0 days 00:05:50,3,14,11
194,BES,P003783,P012647,0 days 00:04:53,0,15,15
194,BES,P007917,P008945,0 days 00:04:51,-9,2,11
194,BES,P011924,P011936,0 days 00:04:20,-5,7,12
194,BES,P007917,P011924,0 days 00:04:08,-6,4,10
194,BES,P003783,P007917,0 days 00:04:08,-6,3,9
194,BES,P007917,P012711,0 days 00:03:52,-7,1,8
194,BES,P012647,P012711,0 days 00:03:24,1,9,8
194,BES,P007917,P011936,0 days 00:03:09,-3,3,6
194,BES,P011357,P011936,0 days 00:02:14,-6,0,6
194,BES,P007917,P012647,0 days 00:01:31,-1,3,4
194,BES,P007914,P007917,0 days 00:01:02,0,0,0
194,BES,P007917,P011379,0 days 00:00:23,0,0,0
195,PRS,P012608,P012610,0 days 00:22:19,19,45,26
195,PRS,P012608,P012611,0 days 00:20:23,10,36,26
195,PRS,P012610,P012611,0 days 00:18:35,10,32,22
195,PRS,P012609,P012640,0 days 00:18:06,8,38,30
195,PRS,P004512,P012611,0 days 00:17:54,4,31,27
195,PRS,P012608,P012613,0 days 00:17:43,13,37,24
195,PRS,P004512,P012608,0 days 00:17:28,9,31,22
195,PRS,P004512,P012610,0 days 00:17:28,9,31,22
195,PRS,P012610,P012613,0 days 00:15:33,15,33,18
195,PRS,P009556,P012640,0 days 00:15:31,-4,28,32
195,PRS,P011232,P012640,0 days 00:15:27,-1,28,29
195,PRS,P009556,P011232,0 days 00:15:05,1,28,27
195,PRS,P011232,P012609,0 days 00:14:22,-1,25,26
195,PRS,P003481,P009556,0 days 00:14:00,1,25,24
195,PRS,P009556,P012609,0 days 00:14:00,1,25,24
195,PRS,P003481,P012640,0 days 00:14:00,1,25,24
195,PRS,P003481,P012609,0 days 00:14:00,1,25,24
195,PRS,P003481,P011232,0 days 00:14:00,1,25,24
195,PRS,P012611,P012613,0 days 00:13:37,6,24,18
195,PRS,P004512,P012613,0 days 00:10:42,5,19,14
195,PRS,P011232,P012608,0 days 00:08:05,3,15,12
195,PRS,P011232,P012611,0 days 00:07:43,5,15,10
195,PRS,P011232,P012610,0 days 00:05:55,5,11,6
195,PRS,P004512,P011232,0 days 00:05:03,5,11,6
195,PRS,P005793,P012611,0 days 00:04:12,-5,6,11
195,PRS,P012608,P012609,0 days 00:04:06,7,13,6
195,PRS,P012608,P012640,0 days 00:04:06,7,13,6
195,PRS,P012609,P012613,0 days 00:04:06,7,13,6
195,PRS,P012613,P012640,0 days 00:04:06,7,13,6
195,PRS,P005793,P012608,0 days 00:03:46,0,6,6
195,PRS,P012609,P012610,0 days 00:03:44,9,13,4
195,PRS,P012610,P012640,0 days 00:03:44,9,13,4
195,PRS,P011232,P012613,0 days 00:03:02,-2,4,6
195,PRS,P005793,P011232,0 days 00:02:53,0,7,7
195,PRS,P004512,P005793,0 days 00:02:09,-6,1,7
195,PRS,P005793,P012613,0 days 00:02:03,1,5,4
195,PRS,P005793,P012610,0 days 00:01:58,0,2,2
195,PRS,P005793,P009556,0 days 00:01:31,-5,3,8
195,PRS,P005793,P012640,0 days 00:01:31,-5,3,8
195,PRS,P005793,P011887,0 days 00:01:05,0,3,3
195,PRS,P009556,P011887,0 days 00:01:05,0,3,3
195,PRS,P011232,P011887,0 days 00:01:05,0,3,3
195,PRS,P011887,P012640,0 days 00:01:05,0,3,3
195,PRS,P004512,P009556,0 days 00:00:26,-5,0,5
195,PRS,P004512,P012640,0 days 00:00:26,-5,0,5
195,PRS,P009556,P012611,0 days 00:00:26,-5,0,5
195,PRS,P012611,P012640,0 days 00:00:26,-5,0,5
195,BOU,P010718,P011836,0 days 00:20:03,-14,31,45
195,BOU,P010718,P012617,0 days 00:16:05,-5,22,27
195,BOU,P012618,P012628,0 days 00:15:14,-3,21,24
195,BOU,P011836,P012618,0 days 00:13:35,-3,19,22
195,BOU,P011836,P012617,0 days 00:12:54,-4,17,21
195,BOU,P010449,P012628,0 days 00:12:49,4,22,18
195,BOU,P010449,P011161,0 days 00:12:32,-3,16,19
195,BOU,P010718,P011837,0 days 00:11:53,-7,19,26
195,BOU,P004525,P012628,0 days 00:11:35,0,20,20
195,BOU,P012617,P012618,0 days 00:11:35,-4,17,21
195,BOU,P000498,P011836,0 days 00:10:56,-2,22,24
195,BOU,P004525,P011161,0 days 00:10:32,-4,13,17
195,BOU,P011161,P011837,0 days 00:10:29,-5,15,20
195,BOU,P011161,P012628,0 days 00:10:24,-1,14,15
195,BOU,P000498,P010718,0 days 00:10:02,-4,20,24
195,BOU,P010718,P012618,0 days 00:09:01,-6,11,17
195,BOU,P004525,P010449,0 days 00:08:52,0,14,14
195,BOU,P010449,P012618,0 days 00:08:44,2,13,11
195,BOU,P010718,P011161,0 days 00:08:41,-9,11,20
195,BOU,P011161,P012618,0 days 00:08:36,-5,10,15
195,BOU,P011161,P011836,0 days 00:08:33,-6,12,18
195,BOU,P004525,P011837,0 days 00:08:22,0,14,14
195,BOU,P011836,P012628,0 days 00:08:13,-1,10,11
195,BOU,P011836,P011837,0 days 00:08:05,-5,14,19
195,BOU,P011837,P012617,0 days 00:07:50,-2,11,13
195,BOU,P010431,P010718,0 days 00:07:07,-8,15,23
195,BOU,P010431,P011836,0 days 00:07:07,-8,15,23
195,BOU,P004525,P012618,0 days 00:07:01,-2,11,13
195,BOU,P012617,P012628,0 days 00:06:59,-5,8,13
195,BOU,P004525,P010718,0 days 00:06:45,-5,11,16
195,BOU,P010431,P012617,0 days 00:06:41,-4,11,15
195,BOU,P004525,P012617,0 days 00:06:31,-2,11,13
195,BOU,P004525,P010431,0 days 00:06:17,-4,12,16
195,BOU,P010449,P011837,0 days 00:06:13,0,11,11
195,BOU,P010449,P011836,0 days 00:06:05,2,10,8
195,BOU,P000498,P011837,0 days 00:04:46,-2,10,12
195,BOU,P000498,P012618,0 days 00:04:44,6,12,6
195,BOU,P011161,P012617,0 days 00:04:41,-3,7,10
195,BOU,P011837,P012628,0 days 00:04:34,2,9,7
195,BOU,P000498,P004525,0 days 00:04:28,0,12,12
195,BOU,P000498,P012617,0 days 00:04:24,5,8,3
195,BOU,P010431,P012618,0 days 00:03:54,-5,6,11
195,BOU,P000498,P010431,0 days 00:03:46,-5,10,15
195,BOU,P010718,P012628,0 days 00:03:39,-4,2,6
195,BOU,P010431,P011837,0 days 00:03:36,-1,9,10
195,BOU,P010431,P012628,0 days 00:03:20,-1,6,7
195,BOU,P004525,P011836,0 days 00:02:57,-3,6,9
195,BOU,P000498,P010449,0 days 00:02:25,5,8,3
195,BOU,P000498,P012628,0 days 00:02:25,5,8,3
195,BOU,P010449,P010718,0 days 00:02:08,-2,2,4
195,BOU,P000498,P011161,0 days 00:01:52,-4,2,6
196,BOU,P011836,P012617,0 days 00:18:42,-3,40,43
196,BOU,P011837,P012617,0 days 00:18:18,-5,36,41
196,BOU,P010718,P012617,0 days 00:17:51,-4,36,40
196,BOU,P010718,P011837,0 days 00:17:42,-5,36,41
196,BOU,P010449,P011836,0 days 00:16:47,-11,28,39
196,BOU,P010449,P012618,0 days 00:16:04,2,36,34
196,BOU,P010449,P011161,0 days 00:13:59,5,31,26
196,BOU,P011836,P012628,0 days 00:13:45,-14,22,36
196,BOU,P011836,P011837,0 days 00:13:42,-7,26,33
196,BOU,P010718,P011836,0 days 00:13:18,-1,29,30
196,BOU,P011161,P012618,0 days 00:12:38,2,27,25
196,BOU,P011836,P012618,0 days 00:12:06,-6,22,28
196,BOU,P010431,P012617,0 days 00:11:00,1,27,26
196,BOU,P010449,P012628,0 days 00:10:27,-7,18,25
196,BOU,P012618,P012628,0 days 00:10:27,-8,18,26
196,BOU,P010431,P011836,0 days 00:10:08,-4,24,28
196,BOU,P010431,P011837,0 days 00:09:45,9,26,17
196,BOU,P012617,P012628,0 days 00:09:13,-7,18,25
196,BOU,P004525,P011161,0 days 00:08:42,7,22,15
196,BOU,P011161,P011836,0 days 00:08:18,-3,13,16
196,BOU,P004525,P010718,0 days 00:08:16,3,19,16
196,BOU,P010431,P010718,0 days 00:08:15,5,22,17
196,BOU,P010449,P010718,0 days 00:08:03,3,18,15
196,BOU,P010449,P012617,0 days 00:07:45,-1,15,16
196,BOU,P004525,P012617,0 days 00:07:39,-3,15,18
196,BOU,P010449,P011837,0 days 00:07:16,-5,10,15
196,BOU,P004525,P010431,0 days 00:07:00,2,15,13
196,BOU,P004525,P011837,0 days 00:06:43,3,14,11
196,BOU,P004525,P010449,0 days 00:06:33,8,18,10
196,BOU,P010718,P011161,0 days 00:06:20,5,16,11
196,BOU,P011161,P012628,0 days 00:05:50,-2,9,11
196,BOU,P004525,P012618,0 days 00:05:33,2,14,12
196,BOU,P004525,P012628,0 days 00:04:26,-2,10,12
196,BOU,P011161,P011837,0 days 00:04:22,2,8,6
196,BOU,P010431,P012628,0 days 00:04:21,-11,5,16
196,BOU,P010431,P010449,0 days 00:04:12,-3,7,10
196,BOU,P012617,P012618,0 days 00:04:11,-1,9,10
196,BOU,P010718,P012618,0 days 00:03:52,7,12,5
196,BOU,P011837,P012628,0 days 00:03:52,-8,4,12
196,BOU,P010431,P012618,0 days 00:03:31,-11,3,14
196,BOU,P011161,P012617,0 days 00:03:01,-1,4,5
196,BOU,P010718,P012628,0 days 00:02:39,-5,4,9
196,BOU,P010431,P011161,0 days 00:02:36,4,7,3
196,BOU,P010450,P012618,0 days 00:02:14,-3,3,6
196,BOU,P010450,P011161,0 days 00:02:14,-3,3,6
196,BOU,P010449,P010450,0 days 00:02:14,-3,3,6
196,BOU,P010450,P011836,0 days 00:02:14,-3,3,6
196,BOU,P004525,P011836,0 days 00:01:56,0,5,5
196,PRS,P012608,P012610,0 days 00:26:09,0,56,56
196,PRS,P012610,P012613,0 days 00:25:31,2,56,54
196,PRS,P012608,P012613,0 days 00:25:28,4,56,52
196,PRS,P012609,P012640,0 days 00:20:06,16,47,31
196,PRS,P004512,P012610,0 days 00:18:13,-8,36,44
196,PRS,P004512,P012608,0 days 00:18:10,-6,36,42
196,PRS,P004512,P012613,0 days 00:17:32,-4,36,40
196,PRS,P012610,P012611,0 days 00:17:24,-6,35,41
196,PRS,P012611,P012613,0 days 00:17:24,-6,35,41
196,PRS,P012608,P012611,0 days 00:17:21,-4,35,39
196,PRS,P004512,P012611,0 days 00:17:20,-5,35,40
196,PRS,P011232,P012640,0 days 00:16:06,7,39,32
196,PRS,P003481,P012640,0 days 00:13:48,10,33,23
196,PRS,P011232,P012609,0 days 00:13:48,10,33,23
196,PRS,P003481,P012609,0 days 00:13:48,10,33,23
196,PRS,P003481,P011232,0 days 00:13:48,10,33,23
196,PRS,P012608,P012640,0 days 00:12:47,4,34,30
196,PRS,P012608,P012609,0 days 00:10:25,8,28,20
196,PRS,P009556,P011232,0 days 00:09:41,8,19,11
196,PRS,P009556,P012609,0 days 00:09:41,8,19,11
196,PRS,P009556,P012640,0 days 00:09:41,8,19,11
196,PRS,P003481,P009556,0 days 00:09:41,8,19,11
196,PRS,P012610,P012640,0 days 00:08:40,2,20,18
196,PRS,P012613,P012640,0 days 00:07:59,6,20,14
196,PRS,P011232,P012608,0 days 00:06:37,0,21,21
196,PRS,P012609,P012613,0 days 00:06:18,6,14,8
196,PRS,P012609,P012610,0 days 00:06:18,6,14,8
196,PRS,P003481,P012608,0 days 00:04:07,2,14,12
196,PRS,P011232,P012610,0 days 00:02:33,-4,7,11
196,PRS,P011232,P012613,0 days 00:01:52,0,7,7
196,PRS,P004512,P011232,0 days 00:00:56,-5,1,6
196,PRS,P004512,P012640,0 days 00:00:41,-4,0,4
196,PRS,P012611,P012640,0 days 00:00:04,-1,0,1
196,PRS,P011232,P012611,0 days 00:00:03,-2,0,2
