Gamecode,CODETEAM,J1,J2,TIME,DELTA_SCORE,OFF,DEF
1,BER,P006919,P007025,19.6,-10,29,39
1,BER,P006919,P008062,3.55,-1,8,9
1,BER,P006919,P008173,3.75,-1,7,8
1,BER,P006919,P008780,23.7,-8,40,48
1,BER,P006919,P010791,16.767,-14,23,37
1,BER,P006919,P011631,7.267,-9,5,14
1,BER,P006919,P011934,7.95,-3,13,16
1,BER,P006919,P012604,15.183,0,32,32
1,BER,P006919,P012721,3.433,6,11,5
1,BER,P007025,P008780,21.15,-7,34,41
1,BER,P007025,P010791,16.167,-12,23,35
1,BER,P007025,P011631,8.767,-6,10,16
1,BER,P007025,P011934,5.4,0,8,8
1,BER,P007025,P012604,11.133,-1,22,23
1,BER,P007025,P012721,2.383,8,10,2
1,BER,P008062,P008173,12.7,-11,25,36
1,BER,P008062,P008780,2.55,3,8,5
1,BER,P008062,P010791,2.65,1,7,6
1,BER,P008062,P011631,0.6,2,2,0
1,BER,P008062,P011934,12.05,-11,25,36
1,BER,P008062,P012604,12.6,-9,26,35
1,BER,P008062,P012721,14.3,-6,31,37
1,BER,P008173,P008780,3.6,5,10,5
1,BER,P008173,P010791,5.65,4,15,11
1,BER,P008173,P011631,1.45,4,5,1
1,BER,P008173,P011934,13.65,-12,28,40
1,BER,P008173,P012604,11.2,-8,22,30
1,BER,P008173,P012721,13.2,-5,28,33
1,BER,P008780,P010791,20.367,-5,35,40
1,BER,P008780,P011631,10.817,0,17,17
1,BER,P008780,P011934,7.0,-1,11,12
1,BER,P008780,P012604,13.633,2,30,28
1,BER,P008780,P012721,6.383,15,23,8
1,BER,P010791,P011631,10.817,0,17,17
1,BER,P010791,P011934,4.9,-2,10,12
1,BER,P010791,P012604,6.7,-4,13,17
1,BER,P010791,P012721,5.65,8,17,9
1,BER,P011631,P012721,3.55,9,12,3
1,BER,P011934,P012604,14.15,-10,26,36
1,BER,P011934,P012721,11.1,-9,23,32
1,BER,P012604,P012721,12.533,-2,29,31
1,PAN,P001926,P002328,6.584,-1,13,14
1,PAN,P001926,P003842,11.701,4,29,25
1,PAN,P001926,P004088,5.55,1,13,12
1,PAN,P001926,P005353,4.3,1,11,10
1,PAN,P001926,P007866,6.467,0,10,10
1,PAN,P001926,P011204,9.534,5,30,25
1,PAN,P001926,P012712,9.534,5,30,25
1,PAN,P001926,P012774,10.334,5,24,19
1,PAN,P002328,P003842,17.251,11,36,25
1,PAN,P002328,P004088,2.4,5,5,0
1,PAN,P002328,P005353,1.4,1,3,2
1,PAN,P002328,P007866,12.084,6,23,17
1,PAN,P002328,P009622,10.667,12,23,11
1,PAN,P002328,P011204,1.367,-1,5,6
1,PAN,P002328,P012712,1.367,-1,5,6
1,PAN,P002328,P012774,15.884,12,31,19
1,PAN,P003842,P004088,7.583,2,12,10
1,PAN,P003842,P005353,1.4,1,3,2
1,PAN,P003842,P007866,14.934,8,30,22
1,PAN,P003842,P009622,13.717,9,28,19
1,PAN,P003842,P011204,8.4,-6,19,25
1,PAN,P003842,P011209,0.833,-5,0,5
1,PAN,P003842,P012712,8.4,-6,19,25
1,PAN,P003842,P012774,24.317,14,52,38
1,PAN,P004088,P005353,7.067,-4,15,19
1,PAN,P004088,P007866,2.85,2,7,5
1,PAN,P004088,P009622,6.117,2,12,10
1,PAN,P004088,P011204,9.4,-9,15,24
1,PAN,P004088,P012712,9.4,-9,15,24
1,PAN,P004088,P012774,8.233,2,14,12
1,PAN,P005353,P009622,7.867,7,20,13
1,PAN,P005353,P011204,12.867,2,30,28
1,PAN,P005353,P012712,12.867,2,30,28
1,PAN,P005353,P012774,9.3,2,20,18
1,PAN,P007866,P009622,8.467,8,20,12
1,PAN,P007866,P012774,14.934,8,30,22
1,PAN,P009622,P011204,7.917,1,17,16
1,PAN,P009622,P012712,7.917,1,17,16
1,PAN,P009622,P012774,18.067,20,43,23
1,PAN,P011204,P011209,0.833,-5,0,5
1,PAN,P011204,P012712,21.267,-4,49,53
1,PAN,P011204,P012774,13.483,1,31,30
1,PAN,P011209,P012712,0.833,-5,0,5
1,PAN,P011209,P012774,0.833,-5,0,5
1,PAN,P012712,P012774,13.483,1,31,30
2,MCO,P002581,P005763,13.066,1,27,26
2,MCO,P002581,P005985,17.3,6,39,33
2,MCO,P002581,P008099,3.3,-2,10,12
2,MCO,P002581,P011212,7.534,3,22,19
2,MCO,P002581,P011226,20.6,4,49,45
2,MCO,P002581,P011231,3.867,-1,11,12
2,MCO,P002581,PLCZ,16.733,5,38,33
2,MCO,P005763,P005844,1.267,3,3,0
2,MCO,P005763,P005985,14.333,4,30,26
2,MCO,P005763,P011226,13.716,1,27,26
2,MCO,P005763,P011231,2.1,3,5,2
2,MCO,P005763,PLCZ,12.85,4,28,24
2,MCO,P005844,P005985,1.267,3,3,0
2,MCO,P005844,P008099,18.134,6,41,35
2,MCO,P005844,P011212,18.134,6,41,35
2,MCO,P005844,P011226,8.85,4,18,14
2,MCO,P005844,P011231,16.751,12,42,30
2,MCO,P005844,P013365,6.417,0,15,15
2,MCO,P005844,PLCZ,6.784,2,13,11
2,MCO,P005985,P011212,4.234,5,12,7
2,MCO,P005985,P011226,17.95,6,39,33
2,MCO,P005985,P011231,3.567,3,10,7
2,MCO,P005985,PLCZ,15.617,9,35,26
2,MCO,P008099,P011212,21.434,4,51,47
2,MCO,P008099,P011226,11.5,2,28,26
2,MCO,P008099,P011231,17.051,8,43,35
2,MCO,P008099,P013365,6.417,0,15,15
2,MCO,P008099,PLCZ,7.9,-2,16,18
2,MCO,P011212,P011226,15.734,7,40,33
2,MCO,P011212,P011231,18.518,8,48,40
2,MCO,P011212,P013365,6.417,0,15,15
2,MCO,P011212,PLCZ,10.667,3,23,20
2,MCO,P011226,P011231,10.067,6,27,21
2,MCO,P011226,PLCZ,19.383,2,40,38
2,MCO,P011231,P013365,6.417,0,15,15
2,MCO,P011231,PLCZ,4.134,5,11,6
2,MIL,P000796,P001392,12.834,-10,16,26
2,MIL,P000796,P001518,7.417,0,18,18
2,MIL,P000796,P006085,18.617,-5,46,51
2,MIL,P000796,P007831,27.317,-15,53,68
2,MIL,P000796,P008985,12.183,-11,19,30
2,MIL,P000796,P008987,5.183,-4,10,14
2,MIL,P000796,P011199,20.717,-9,41,50
2,MIL,P000796,P013384,3.583,-4,7,11
2,MIL,P000796,P013386,1.417,-2,2,4
2,MIL,P001392,P006085,4.134,0,9,9
2,MIL,P001392,P007831,13.534,-11,16,27
2,MIL,P001392,P008985,11.283,-6,12,18
2,MIL,P001392,P008987,4.183,4,8,4
2,MIL,P001392,P011199,10.517,-9,11,20
2,MIL,P001392,P013384,1.883,5,5,0
2,MIL,P001392,P013386,3.3,3,7,4
2,MIL,P001518,P006085,9.467,-4,20,24
2,MIL,P001518,P007831,7.717,-2,18,20
2,MIL,P001518,P008985,0.3,-2,0,2
2,MIL,P001518,P008987,2.35,-6,2,8
2,MIL,P001518,P011199,8.4,-5,18,23
2,MIL,P001518,P013384,2.05,-4,2,6
2,MIL,P001518,P013386,1.367,-1,2,3
2,MIL,P006085,P007831,18.617,-5,46,51
2,MIL,P006085,P008985,6.883,-2,18,20
2,MIL,P006085,P008987,10.633,-9,18,27
2,MIL,P006085,P011199,12.7,-2,34,36
2,MIL,P006085,P013384,9.033,-9,15,24
2,MIL,P006085,P013386,6.184,-4,10,14
2,MIL,P006509,P008985,4.35,5,14,9
2,MIL,P006509,P008987,4.35,5,14,9
2,MIL,P006509,P013384,4.35,5,14,9
2,MIL,P006509,P013386,4.35,5,14,9
2,MIL,P007831,P008985,13.183,-14,19,33
2,MIL,P007831,P008987,6.183,-7,10,17
2,MIL,P007831,P011199,21.717,-12,41,53
2,MIL,P007831,P013384,3.583,-4,7,11
2,MIL,P007831,P013386,1.417,-2,2,4
2,MIL,P008985,P008987,10.633,6,25,19
2,MIL,P008985,P011199,13.183,-14,19,33
2,MIL,P008985,P013384,9.633,9,25,16
2,MIL,P008985,P013386,9.633,9,25,16
2,MIL,P008987,P011199,1.683,-6,0,6
2,MIL,P008987,P013384,15.266,1,34,33
2,MIL,P008987,P013386,11.0,8,27,19
2,MIL,P011199,P013384,0.683,-3,0,3
2,MIL,P013384,P013386,11.0,8,27,19
3,BAR,P000925,P002939,15.168,-2,22,24
3,BAR,P000925,P003478,14.834,-6,18,24
3,BAR,P000925,P006435,15.734,8,22,14
3,BAR,P000925,P009862,9.367,-12,10,22
3,BAR,P000925,P010106,4.8,-5,0,5
3,BAR,P000925,P012745,10.334,5,17,12
3,BAR,P000925,P012795,2.5,-4,0,4
3,BAR,P000925,P013379,10.467,-12,7,19
3,BAR,P002939,P003196,9.566,-5,17,22
3,BAR,P002939,P003478,13.917,3,32,29
3,BAR,P002939,P006435,13.367,15,31,16
3,BAR,P002939,P009862,18.1,-17,25,42
3,BAR,P002939,P012745,18.667,7,36,29
3,BAR,P002939,P012795,11.699,-12,16,28
3,BAR,P002939,P013379,11.516,-9,21,30
3,BAR,P003196,P003478,3.45,3,11,8
3,BAR,P003196,P006435,2.0,1,6,5
3,BAR,P003196,P009862,11.566,-4,23,27
3,BAR,P003196,P012745,7.083,-4,12,16
3,BAR,P003196,P012795,8.116,-7,12,19
3,BAR,P003196,P013379,4.483,0,11,11
3,BAR,P003478,P006435,18.983,6,34,28
3,BAR,P003478,P009862,7.867,-10,16,26
3,BAR,P003478,P010106,5.233,-5,0,5
3,BAR,P003478,P012745,10.933,9,24,15
3,BAR,P003478,P012795,1.083,-1,4,5
3,BAR,P003478,P013379,15.7,-11,25,36
3,BAR,P006435,P009862,8.35,4,19,15
3,BAR,P006435,P010106,5.583,-3,2,5
3,BAR,P006435,P012745,13.983,12,29,17
3,BAR,P006435,P012795,1.766,-1,6,7
3,BAR,P006435,P013379,14.166,2,27,25
3,BAR,P009862,P010106,2.233,4,6,2
3,BAR,P009862,P012745,15.5,-3,27,30
3,BAR,P009862,P012795,13.182,-9,18,27
3,BAR,P009862,P013379,13.299,-9,24,33
3,BAR,P010106,P012745,3.599,1,6,5
3,BAR,P010106,P012795,1.883,2,4,2
3,BAR,P010106,P013379,6.533,2,6,4
3,BAR,P012745,P012795,9.216,-8,13,21
3,BAR,P012745,P013379,6.549,5,16,11
3,BAR,P012795,P013379,7.615,0,15,15
3,ZAL,P002329,P003048,9.383,7,17,10
3,ZAL,P002329,P003210,0.467,0,0,0
3,ZAL,P002329,P005504,1.383,-4,0,4
3,ZAL,P002329,P007029,7.516,2,10,8
3,ZAL,P002329,P007513,6.183,5,15,10
3,ZAL,P002329,P007975,3.516,4,8,4
3,ZAL,P002329,P011051,4.417,4,4,0
3,ZAL,P002329,P011925,6.7,2,6,4
3,ZAL,P002329,P011983,7.667,5,11,6
3,ZAL,P002329,P012622,13.5,3,13,10
3,ZAL,P002676,P003048,6.984,3,19,16
3,ZAL,P002676,P005504,17.833,-3,34,37
3,ZAL,P002676,P007029,4.866,-4,10,14
3,ZAL,P002676,P007513,20.301,0,42,42
3,ZAL,P002676,P007975,14.217,7,33,26
3,ZAL,P002676,P011925,8.966,-6,16,22
3,ZAL,P002676,P011983,17.984,3,37,34
3,ZAL,P002676,P012622,8.117,0,21,21
3,ZAL,P003048,P007029,8.266,3,17,14
3,ZAL,P003048,P007513,10.934,11,30,19
3,ZAL,P003048,P007975,5.767,8,19,11
3,ZAL,P003048,P011925,5.533,3,10,7
3,ZAL,P003048,P011983,7.284,5,16,11
3,ZAL,P003048,P012622,11.317,0,16,16
3,ZAL,P003210,P007029,0.467,0,0,0
3,ZAL,P003210,P011051,0.467,0,0,0
3,ZAL,P003210,P012622,0.467,0,0,0
3,ZAL,P005504,P007029,2.866,-5,3,8
3,ZAL,P005504,P007513,15.55,-6,27,33
3,ZAL,P005504,P007975,11.183,3,22,19
3,ZAL,P005504,P011925,6.966,-11,8,19
3,ZAL,P005504,P011983,15.2,-1,28,29
3,ZAL,P005504,P012622,5.883,-1,14,15
3,ZAL,P007029,P007513,4.366,5,14,9
3,ZAL,P007029,P007975,5.899,5,14,9
3,ZAL,P007029,P011051,1.25,0,0,0
3,ZAL,P007029,P011925,5.716,-7,6,13
3,ZAL,P007029,P012622,8.316,-7,6,13
3,ZAL,P007513,P007975,13.567,6,34,28
3,ZAL,P007513,P011925,6.783,-1,12,13
3,ZAL,P007513,P011983,20.151,-1,37,38
3,ZAL,P007513,P012622,8.101,1,17,16
3,ZAL,P007975,P011051,0.783,0,0,0
3,ZAL,P007975,P011983,9.867,5,21,16
3,ZAL,P007975,P012622,6.133,6,13,7
3,ZAL,P011051,P011925,3.167,4,4,0
3,ZAL,P011051,P011983,3.167,4,4,0
3,ZAL,P011051,P012622,4.417,4,4,0
3,ZAL,P011925,P011983,9.95,3,16,13
3,ZAL,P011925,P012622,8.883,-3,10,13
3,ZAL,P011983,P012622,11.334,9,22,13
4,BAS,P004058,P008072,1.05,1,4,3
4,BAS,P004058,P011085,1.05,1,4,3
4,BAS,P004058,P011948,1.05,1,4,3
4,BAS,P004058,P012201,1.05,1,4,3
4,BAS,P007230,P008072,9.55,-3,25,28
4,BAS,P007230,P011196,17.117,-1,36,37
4,BAS,P007230,P011948,7.251,-1,19,20
4,BAS,P007230,P012080,24.934,-5,54,59
4,BAS,P007230,P012201,22.55,-2,49,51
4,BAS,P007230,P012597,8.967,-3,16,19
4,BAS,P007230,P013367,18.167,-1,45,46
4,BAS,P008072,P011085,4.783,0,9,9
4,BAS,P008072,P011948,13.666,4,31,27
4,BAS,P008072,P012080,10.983,1,25,24
4,BAS,P008072,P012201,12.615,4,27,23
4,BAS,P008072,P012597,10.816,3,22,19
4,BAS,P008072,P013367,5.333,-2,13,15
4,BAS,P011085,P011196,2.133,-3,2,5
4,BAS,P011085,P011948,6.916,-3,11,14
4,BAS,P011085,P012201,6.916,-3,11,14
4,BAS,P011085,P012597,5.866,-4,7,11
4,BAS,P011196,P011948,5.983,5,15,10
4,BAS,P011196,P012080,19.433,7,45,38
4,BAS,P011196,P012201,22.333,4,49,45
4,BAS,P011196,P012597,5.483,-5,6,11
4,BAS,P011196,P013367,16.85,9,43,34
4,BAS,P011948,P012080,11.0,11,28,17
4,BAS,P011948,P012201,15.532,11,34,23
4,BAS,P011948,P012597,11.783,0,20,20
4,BAS,P011948,P013367,7.283,8,22,14
4,BAS,P012080,P012201,26.299,10,58,48
4,BAS,P012080,P012597,10.65,4,21,17
4,BAS,P012080,P013367,20.233,4,49,45
4,BAS,P012201,P012597,13.499,-3,20,23
4,BAS,P012201,P013367,20.866,10,52,42
4,PAR,P004761,P006591,11.451,4,25,21
4,PAR,P004761,P006760,17.517,-2,44,46
4,PAR,P004761,P007870,20.334,7,47,40
4,PAR,P004761,P010781,17.483,2,43,41
4,PAR,P004761,P011981,20.534,3,45,42
4,PAR,P004761,P012720,16.366,4,37,33
4,PAR,P004761,P013369,12.051,6,31,25
4,PAR,P006591,P006760,9.701,0,21,21
4,PAR,P006591,P007870,15.551,-8,30,38
4,PAR,P006591,P010781,0.783,0,0,0
4,PAR,P006591,P011981,11.951,-6,24,30
4,PAR,P006591,P012720,4.95,-11,5,16
4,PAR,P006591,P013369,17.085,-7,35,42
4,PAR,P006760,P007870,14.267,-2,32,34
4,PAR,P006760,P010781,13.933,-3,32,35
4,PAR,P006760,P011981,14.851,-6,30,36
4,PAR,P006760,P012720,11.666,-1,24,25
4,PAR,P006760,P013369,12.601,2,29,27
4,PAR,P007870,P010781,15.866,3,31,28
4,PAR,P007870,P011981,21.851,-8,38,46
4,PAR,P007870,P012720,17.766,-6,28,34
4,PAR,P007870,P013369,16.901,-6,38,44
4,PAR,P010781,P011981,20.05,-3,35,38
4,PAR,P010781,P012720,20.649,3,39,36
4,PAR,P010781,P013369,2.9,2,8,6
4,PAR,P011981,P012720,22.55,-10,38,48
4,PAR,P011981,P013369,13.085,-6,26,32
4,PAR,P012720,P013369,5.317,-11,5,16
5,MAD,P003583,P003733,1.467,0,2,2
5,MAD,P003583,P005928,5.317,6,15,9
5,MAD,P003583,P006540,8.167,1,20,19
5,MAD,P003583,P007630,2.15,-1,7,8
5,MAD,P003583,P009005,16.434,-7,40,47
5,MAD,P003583,P009213,1.65,-5,0,5
5,MAD,P003583,P011247,10.117,-10,21,31
5,MAD,P003583,P011649,7.284,2,22,20
5,MAD,P003583,P013378,8.666,-8,25,33
5,MAD,P003583,PTGB,4.484,-6,8,14
5,MAD,P003733,P005791,14.067,12,38,26
5,MAD,P003733,P005928,17.101,9,42,33
5,MAD,P003733,P006540,12.467,4,29,25
5,MAD,P003733,P007630,1.567,-3,2,5
5,MAD,P003733,P009005,4.634,5,13,8
5,MAD,P003733,P009213,12.467,4,29,25
5,MAD,P003733,PTGB,4.634,5,13,8
5,MAD,P005791,P005928,19.567,3,45,42
5,MAD,P005791,P006540,16.1,0,34,34
5,MAD,P005791,P009005,8.617,-2,18,20
5,MAD,P005791,P009213,12.467,4,29,25
5,MAD,P005791,P011247,1.517,-1,2,3
5,MAD,P005791,P011649,0.183,0,0,0
5,MAD,P005791,P013378,4.867,-1,9,10
5,MAD,P005791,PTGB,6.951,-7,13,20
5,MAD,P005928,P006540,19.9,8,47,39
5,MAD,P005928,P007630,2.484,-3,2,5
5,MAD,P005928,P009005,14.901,2,33,31
5,MAD,P005928,P009213,12.517,2,29,27
5,MAD,P005928,P011649,2.1,3,6,3
5,MAD,P005928,P013378,6.05,3,14,11
5,MAD,P005928,PTGB,9.535,-9,15,24
5,MAD,P006540,P009005,11.8,-3,25,28
5,MAD,P006540,P009213,14.067,1,29,28
5,MAD,P006540,P011247,4.234,-2,7,9
5,MAD,P006540,P011649,3.967,2,11,9
5,MAD,P006540,P013378,3.349,5,12,7
5,MAD,P006540,PTGB,3.017,-12,2,14
5,MAD,P007630,P009005,4.634,-4,9,13
5,MAD,P007630,P011247,1.283,-3,3,6
5,MAD,P007630,P013378,3.067,-1,7,8
5,MAD,P007630,PTGB,3.351,-1,6,7
5,MAD,P009005,P009213,1.65,-5,0,5
5,MAD,P009005,P011247,11.634,-11,23,34
5,MAD,P009005,P011649,7.467,2,22,20
5,MAD,P009005,P013378,14.45,-9,34,43
5,MAD,P009005,PTGB,13.919,-16,23,39
5,MAD,P009213,P011247,1.6,-3,0,3
5,MAD,P009213,P013378,0.05,-2,0,2
5,MAD,P011247,P011649,5.367,-1,16,17
5,MAD,P011247,P013378,7.4,-9,16,25
5,MAD,P011247,PTGB,3.384,-4,4,8
5,MAD,P011649,P013378,3.5,0,11,11
5,MAD,P013378,PTGB,6.401,-14,8,22
5,MUN,P001288,P001557,1.716,-2,5,7
5,MUN,P001288,P004508,13.083,-2,27,29
5,MUN,P001288,P007056,15.7,0,31,31
5,MUN,P001288,P007201,22.833,-14,44,58
5,MUN,P001288,P010391,16.282,-4,36,40
5,MUN,P001288,P011224,7.167,2,20,18
5,MUN,P001288,P011244,5.65,-9,11,20
5,MUN,P001288,P011987,10.033,-7,22,29
5,MUN,P001557,P007056,9.25,13,26,13
5,MUN,P001557,P007201,12.466,1,28,27
5,MUN,P001557,P007639,4.25,6,17,11
5,MUN,P001557,P010391,1.783,1,7,6
5,MUN,P001557,P011224,17.099,19,51,32
5,MUN,P001557,P011244,9.233,7,25,18
5,MUN,P001557,P011987,18.599,15,53,38
5,MUN,P004508,P007056,11.533,1,24,23
5,MUN,P004508,P007201,13.083,-2,27,29
5,MUN,P004508,P010391,13.083,-2,27,29
5,MUN,P004508,P011244,1.55,-3,3,6
5,MUN,P007056,P007201,23.35,10,54,44
5,MUN,P007056,P010391,12.4,-1,26,27
5,MUN,P007056,P011224,12.55,14,31,17
5,MUN,P007056,P011244,1.6,3,3,0
5,MUN,P007056,P011987,13.417,12,33,21
5,MUN,P007201,P010391,16.866,-11,33,44
5,MUN,P007201,P011224,17.05,7,41,34
5,MUN,P007201,P011244,9.033,-11,16,27
5,MUN,P007201,P011987,20.783,-4,45,49
5,MUN,P007639,P011224,4.25,6,17,11
5,MUN,P007639,P011244,4.25,6,17,11
5,MUN,P007639,P011987,4.25,6,17,11
5,MUN,P010391,P011224,0.333,7,7,0
5,MUN,P010391,P011244,3.783,-10,5,15
5,MUN,P010391,P011987,4.066,-4,11,15
5,MUN,P011224,P011244,11.1,8,31,23
5,MUN,P011224,P011987,23.183,21,66,45
5,MUN,P011244,P011987,13.333,1,33,32
6,ASV,P000229,P002100,8.1,3,24,21
6,ASV,P000229,P004194,13.518,-10,18,28
6,ASV,P000229,P007027,13.851,-11,19,30
6,ASV,P000229,P008991,12.95,-3,31,34
6,ASV,P000229,P010545,5.317,-2,10,12
6,ASV,P000229,P011225,13.068,-12,18,30
6,ASV,P000229,P012731,12.117,-1,27,28
6,ASV,P000229,P013371,8.883,4,25,21
6,ASV,P002100,P003526,4.65,0,6,6
6,ASV,P002100,P004194,3.55,-3,4,7
6,ASV,P002100,P008991,9.817,6,26,20
6,ASV,P002100,P011225,1.217,0,2,2
6,ASV,P002100,P012731,13.367,3,30,27
6,ASV,P002100,P013371,12.767,3,28,25
6,ASV,P003526,P004194,8.833,-6,19,25
6,ASV,P003526,P007027,9.35,0,22,22
6,ASV,P003526,P008991,4.2,6,7,1
6,ASV,P003526,P010545,7.967,-3,19,22
6,ASV,P003526,P011225,7.733,-2,18,20
6,ASV,P003526,P012731,7.0,3,11,8
6,ASV,P003526,P013371,6.267,2,10,8
6,ASV,P004194,P007027,22.234,-12,44,56
6,ASV,P004194,P008991,4.517,-5,6,11
6,ASV,P004194,P010545,15.75,-4,38,42
6,ASV,P004194,P011225,20.867,-16,40,56
6,ASV,P004194,P012731,5.517,-6,4,10
6,ASV,P004194,P013371,4.917,1,8,7
6,ASV,P004194,PKIR,3.433,1,11,10
6,ASV,P007027,P008991,7.95,-3,12,15
6,ASV,P007027,P010545,16.717,-4,40,44
6,ASV,P007027,P011225,23.634,-13,45,58
6,ASV,P007027,P012731,6.367,-1,8,9
6,ASV,P007027,P013371,3.0,3,7,4
6,ASV,P007027,PKIR,3.433,1,11,10
6,ASV,P008991,P011225,7.534,-2,11,13
6,ASV,P008991,P012731,13.25,8,32,24
6,ASV,P008991,P013371,10.85,5,27,22
6,ASV,P010545,P011225,15.1,-6,36,42
6,ASV,P010545,P012731,0.967,0,2,2
6,ASV,P010545,P013371,1.617,2,4,2
6,ASV,P010545,PKIR,3.433,1,11,10
6,ASV,P011225,P012731,6.201,-2,7,9
6,ASV,P011225,P013371,0.617,0,0,0
6,ASV,P011225,PKIR,3.433,1,11,10
6,ASV,P012731,P013371,14.15,4,31,27
6,TEL,P004233,P006835,4.367,-8,7,15
6,TEL,P004233,P007519,4.367,-8,7,15
6,TEL,P004233,P007855,2.167,-2,5,7
6,TEL,P004233,P007990,2.75,-6,5,11
6,TEL,P004233,P009754,1.617,-2,2,4
6,TEL,P004233,P011214,2.2,-6,2,8
6,TEL,P006835,P007519,15.101,-11,24,35
6,TEL,P006835,P007855,2.284,-2,5,7
6,TEL,P006835,P007990,12.984,-4,22,26
6,TEL,P006835,P009754,9.933,11,29,18
6,TEL,P006835,P011193,10.233,10,27,17
6,TEL,P006835,P011214,10.45,-6,18,24
6,TEL,P006835,P011219,7.167,1,14,13
6,TEL,P006835,P013381,3.367,1,5,4
6,TEL,P006835,P013382,9.65,4,21,17
6,TEL,P007519,P007855,2.167,-2,5,7
6,TEL,P007519,P007990,9.417,-9,14,23
6,TEL,P007519,P009754,5.734,0,12,12
6,TEL,P007519,P011193,4.067,0,8,8
6,TEL,P007519,P011214,9.1,-5,16,21
6,TEL,P007519,P011219,3.834,-4,3,7
6,TEL,P007519,P013381,3.25,1,5,4
6,TEL,P007519,P013382,3.367,-6,2,8
6,TEL,P007855,P007990,2.284,-2,5,7
6,TEL,P007855,P013381,0.117,0,0,0
6,TEL,P007855,P013382,0.117,0,0,0
6,TEL,P007990,P009754,6.3,10,14,4
6,TEL,P007990,P011193,8.783,9,18,9
6,TEL,P007990,P011214,9.666,0,18,18
6,TEL,P007990,P011219,6.917,-4,7,11
6,TEL,P007990,P013381,3.367,1,5,4
6,TEL,P007990,P013382,10.8,5,20,15
6,TEL,P009754,P011193,23.382,21,67,46
6,TEL,P009754,P011214,22.75,8,54,46
6,TEL,P009754,P011219,15.566,9,47,38
6,TEL,P009754,P013382,20.782,19,59,40
6,TEL,P011193,P011214,24.033,7,56,49
6,TEL,P011193,P011219,18.649,9,51,42
6,TEL,P011193,P013382,26.249,16,65,49
6,TEL,P011214,P011219,15.316,4,40,36
6,TEL,P011214,P013381,0.133,2,2,0
6,TEL,P011214,P013382,22.616,4,50,46
6,TEL,P011219,P013381,3.117,-1,3,4
6,TEL,P011219,P013382,19.366,6,51,45
6,TEL,P013381,P013382,0.117,0,0,0
7,OLY,P001255,P003469,7.184,10,19,9
7,OLY,P001255,P007853,12.967,0,23,23
7,OLY,P001255,P007947,1.8,4,4,0
7,OLY,P001255,P007982,1.584,-1,2,3
7,OLY,P001255,P008829,7.367,-11,6,17
7,OLY,P001255,P008855,12.751,-5,21,26
7,OLY,P001255,P011194,8.051,-10,8,18
7,OLY,P001255,P012878,6.5,9,17,8
7,OLY,P003469,P007853,11.683,3,25,22
7,OLY,P003469,P007947,3.867,2,10,8
7,OLY,P003469,P007982,19.801,-8,33,41
7,OLY,P003469,P008855,12.267,0,25,25
7,OLY,P003469,P009849,16.451,-8,29,37
7,OLY,P003469,P011194,8.534,-2,17,19
7,OLY,P003469,P012878,21.984,-2,41,43
7,OLY,P003469,P013380,20.301,-11,33,44
7,OLY,P007853,P007947,1.8,4,4,0
7,OLY,P007853,P007982,3.033,-3,6,9
7,OLY,P007853,P008829,8.317,-5,13,18
7,OLY,P007853,P008855,18.2,-6,34,40
7,OLY,P007853,P011194,13.5,-11,21,32
7,OLY,P007853,P012878,6.5,9,17,8
7,OLY,P007853,P013380,4.0,1,9,8
7,OLY,P007947,P009849,2.067,-2,6,8
7,OLY,P007947,P012878,3.867,2,10,8
7,OLY,P007947,P013380,2.067,-2,6,8
7,OLY,P007982,P008829,1.167,-2,0,2
7,OLY,P007982,P008855,6.584,-4,10,14
7,OLY,P007982,P009849,14.384,-6,23,29
7,OLY,P007982,P011194,7.551,-1,15,16
7,OLY,P007982,P012878,13.417,-9,18,27
7,OLY,P007982,P013380,16.351,-6,25,31
7,OLY,P008829,P008855,9.484,-7,13,20
7,OLY,P008829,P011194,9.484,-7,13,20
7,OLY,P008829,P013380,2.117,4,7,3
7,OLY,P008855,P011194,17.051,-12,25,37
7,OLY,P008855,P012878,4.7,5,13,8
7,OLY,P008855,P013380,5.967,1,11,10
7,OLY,P009849,P011194,0.967,3,5,2
7,OLY,P009849,P012878,15.484,-11,24,35
7,OLY,P009849,P013380,16.451,-8,29,37
7,OLY,P011194,P013380,6.934,4,16,12
7,OLY,P012878,P013380,15.484,-11,24,35
7,ULK,P002849,P002968,9.633,-5,20,25
7,ULK,P002849,P004004,2.316,-5,4,9
7,ULK,P002849,P007182,2.867,4,6,2
7,ULK,P002849,P008104,1.867,4,4,0
7,ULK,P002849,P008962,7.283,11,19,8
7,ULK,P002849,P009783,9.467,4,19,15
7,ULK,P002849,P009863,17.733,0,37,37
7,ULK,P002849,P010560,10.466,2,24,22
7,ULK,P002849,P011205,17.617,11,39,28
7,ULK,P002849,PLMG,0.483,-2,0,2
7,ULK,P002968,P004004,1.833,-3,4,7
7,ULK,P002968,P009783,2.5,-2,3,5
7,ULK,P002968,P009863,9.633,-5,20,25
7,ULK,P002968,P010560,7.133,-3,17,20
7,ULK,P002968,P011205,7.8,-2,16,18
7,ULK,P004004,P006661,1.017,-5,0,5
7,ULK,P004004,P007182,3.234,-4,3,7
7,ULK,P004004,P008962,18.284,4,36,32
7,ULK,P004004,P009783,18.767,2,36,34
7,ULK,P004004,P009863,16.133,9,39,30
7,ULK,P004004,P010560,1.833,-3,4,7
7,ULK,P004004,P011205,3.45,-5,1,6
7,ULK,P004004,PLMG,15.533,6,33,27
7,ULK,P006661,P007182,2.084,-3,2,5
7,ULK,P006661,P008962,2.084,-3,2,5
7,ULK,P006661,P009783,1.534,-5,0,5
7,ULK,P006661,P010560,0.55,2,2,0
7,ULK,P006661,P011205,1.067,2,2,0
7,ULK,P007182,P008104,2.584,3,5,2
7,ULK,P007182,P008962,5.351,-1,8,9
7,ULK,P007182,P009783,4.618,-4,5,9
7,ULK,P007182,P009863,1.634,-2,2,4
7,ULK,P007182,P010560,3.267,5,7,2
7,ULK,P007182,P011205,5.901,6,10,4
7,ULK,P008104,P008962,0.717,-1,1,2
7,ULK,P008104,P010560,2.584,3,5,2
7,ULK,P008104,P011205,2.584,3,5,2
7,ULK,P008962,P009783,24.618,14,52,38
7,ULK,P008962,P009863,20.767,23,52,29
7,ULK,P008962,P010560,2.733,2,6,4
7,ULK,P008962,P011205,12.517,7,23,16
7,ULK,P008962,PLMG,15.05,8,33,25
7,ULK,P009783,P009863,23.084,16,52,36
7,ULK,P009783,P011205,12.951,1,20,19
7,ULK,P009783,PLMG,15.533,6,33,27
7,ULK,P009863,P010560,8.466,-2,20,22
7,ULK,P009863,P011205,15.417,5,33,28
7,ULK,P009863,PLMG,13.333,12,33,21
7,ULK,P010560,P011205,9.9,6,23,17
7,ULK,P011205,PLMG,2.2,-6,0,6
8,PRS,P004197,P007032,0.717,-2,0,2
8,PRS,P004197,P010390,13.284,0,23,23
8,PRS,P004197,P012608,12.567,2,23,21
8,PRS,P004197,P012610,13.284,0,23,23
8,PRS,P004197,P012613,13.284,0,23,23
8,PRS,P004512,P007032,11.434,-5,27,32
8,PRS,P004512,P012609,11.434,-5,27,32
8,PRS,P004512,P012613,4.317,5,16,11
8,PRS,P004512,P012640,11.434,-5,27,32
8,PRS,P004512,P013373,7.117,-10,11,21
8,PRS,P007032,P010390,6.967,1,9,8
8,PRS,P007032,P012608,6.25,3,9,6
8,PRS,P007032,P012609,11.434,-5,27,32
8,PRS,P007032,P012610,6.967,1,9,8
8,PRS,P007032,P012613,11.284,6,25,19
8,PRS,P007032,P012640,11.434,-5,27,32
8,PRS,P007032,P013373,7.117,-10,11,21
8,PRS,P010390,P012608,27.85,4,50,46
8,PRS,P010390,P012610,28.567,2,50,48
8,PRS,P010390,P012613,21.534,2,37,35
8,PRS,P010390,P012640,9.033,-1,18,19
8,PRS,P010390,P013373,7.033,0,13,13
8,PRS,P012608,P012610,27.85,4,50,46
8,PRS,P012608,P012613,20.817,4,37,33
8,PRS,P012608,P012640,9.033,-1,18,19
8,PRS,P012608,P013373,7.033,0,13,13
8,PRS,P012609,P012613,4.317,5,16,11
8,PRS,P012609,P012640,11.434,-5,27,32
8,PRS,P012609,P013373,7.117,-10,11,21
8,PRS,P012610,P012613,21.534,2,37,35
8,PRS,P012610,P012640,9.033,-1,18,19
8,PRS,P012610,P013373,7.033,0,13,13
8,PRS,P012613,P012640,6.317,4,21,17
8,PRS,P012640,P013373,14.15,-10,24,34
8,RED,P000848,P002553,13.999,8,31,23
8,RED,P000848,P004007,1.4,-4,0,4
8,RED,P000848,P004866,12.767,4,28,24
8,RED,P000848,P006240,2.517,-5,6,11
8,RED,P000848,P006436,17.533,-1,38,39
8,RED,P000848,P007960,0.417,-2,0,2
8,RED,P000848,P009035,6.184,2,15,13
8,RED,P000848,P009048,22.283,7,52,45
8,RED,P000848,P010612,11.983,16,35,19
8,RED,P000848,P012044,1.717,-5,3,8
8,RED,P002553,P004007,3.833,-9,5,14
8,RED,P002553,P004866,13.832,6,30,24
8,RED,P002553,P006436,12.399,-4,24,28
8,RED,P002553,P009048,18.715,5,40,35
8,RED,P002553,P010612,14.665,4,32,28
8,RED,P002553,P012044,2.433,-4,3,7
8,RED,P002553,P012786,4.716,-2,7,9
8,RED,P004007,P006436,3.833,-9,5,14
8,RED,P004007,P009048,3.833,-9,5,14
8,RED,P004007,P010612,2.433,-5,5,10
8,RED,P004866,P006436,11.15,3,23,20
8,RED,P004866,P007960,2.5,-4,2,6
8,RED,P004866,P009035,13.801,1,21,20
8,RED,P004866,P009048,14.683,10,34,24
8,RED,P004866,P010612,19.616,11,37,26
8,RED,P004866,P012044,12.95,-3,17,20
8,RED,P004866,P012786,9.233,0,12,12
8,RED,P006240,P006436,2.517,-5,6,11
8,RED,P006240,P009048,2.517,-5,6,11
8,RED,P006240,P010612,1.217,-2,3,5
8,RED,P006240,P012044,1.3,-3,3,6
8,RED,P006436,P009035,8.6,8,22,14
8,RED,P006436,P009048,20.016,-4,45,49
8,RED,P006436,P010612,13.216,8,35,27
8,RED,P006436,P012044,4.8,0,10,10
8,RED,P007960,P009035,2.5,-4,2,6
8,RED,P007960,P010612,2.083,-2,2,4
8,RED,P007960,P012044,2.5,-4,2,6
8,RED,P009035,P009048,5.817,6,17,11
8,RED,P009035,P010612,13.4,12,28,16
8,RED,P009035,P012044,10.517,1,14,13
8,RED,P009035,P012786,4.517,2,5,3
8,RED,P009048,P010612,16.749,15,46,31
8,RED,P009048,P012044,1.3,-3,3,6
8,RED,P009048,P012786,2.283,2,4,2
8,RED,P010612,P012044,12.533,-1,17,18
8,RED,P010612,P012786,9.233,0,12,12
8,RED,P012044,P012786,6.95,-2,8,10
9,IST,P004887,P006590,11.4,5,23,18
9,IST,P004887,P007109,13.167,5,25,20
9,IST,P004887,P007200,13.8,1,25,24
9,IST,P004887,P009513,2.4,-4,2,6
9,IST,P004887,P009846,0.633,-4,0,4
9,IST,P004887,P011078,3.933,8,12,4
9,IST,P004887,P012710,0.633,-4,0,4
9,IST,P004887,P013363,9.234,-3,13,16
9,IST,P006590,P007109,16.7,9,35,26
9,IST,P006590,P007200,15.384,6,31,25
9,IST,P006590,P009664,1.417,2,5,3
9,IST,P006590,P009846,3.0,5,9,4
9,IST,P006590,P011078,7.466,14,24,10
9,IST,P006590,P012788,6.717,6,17,11
9,IST,P006590,P013363,10.384,-3,16,19
9,IST,P007109,P007200,18.284,4,33,29
9,IST,P007109,P009513,1.767,0,2,2
9,IST,P007109,P009664,0.967,1,3,2
9,IST,P007109,P009846,3.95,2,7,5
9,IST,P007109,P011078,8.683,11,22,11
9,IST,P007109,P012788,7.667,3,15,12
9,IST,P007109,P013363,12.151,-3,18,21
9,IST,P007200,P009513,4.0,-6,2,8
9,IST,P007200,P009664,2.8,-8,1,9
9,IST,P007200,P009846,6.433,-16,1,17
9,IST,P007200,P011078,7.733,3,16,13
9,IST,P007200,P012710,3.166,-10,0,10
9,IST,P007200,P012788,9.517,-11,9,20
9,IST,P007200,P013363,12.151,-3,18,21
9,IST,P009513,P009846,2.233,-6,0,6
9,IST,P009513,P012710,2.233,-6,0,6
9,IST,P009513,P012788,1.6,-2,0,2
9,IST,P009513,P013363,1.767,0,2,2
9,IST,P009664,P009846,12.0,8,26,18
9,IST,P009664,P011078,10.8,12,26,14
9,IST,P009664,P012710,8.016,9,17,8
9,IST,P009664,P012788,12.0,8,26,18
9,IST,P009846,P011078,19.683,13,43,30
9,IST,P009846,P012710,16.149,3,30,27
9,IST,P009846,P012788,22.483,7,43,36
9,IST,P009846,P013364,5.9,0,13,13
9,IST,P011078,P012710,12.983,13,30,17
9,IST,P011078,P012788,20.483,14,46,32
9,IST,P011078,P013364,5.9,0,13,13
9,IST,P012710,P012788,15.516,7,30,23
9,IST,P012710,P013364,5.9,0,13,13
9,IST,P012788,P013363,2.917,0,5,5
9,IST,P012788,P013364,5.9,0,13,13
9,VIR,P001133,P001844,19.483,-7,36,43
9,VIR,P001133,P002084,6.417,2,13,11
9,VIR,P001133,P004554,19.05,2,33,31
9,VIR,P001133,P004888,14.583,-11,19,30
9,VIR,P001133,P006739,4.899,8,12,4
9,VIR,P001133,P009549,27.066,6,54,48
9,VIR,P001133,P011816,0.783,-2,2,4
9,VIR,P001133,P012585,11.983,12,25,13
9,VIR,P001133,P012591,4.917,2,10,8
9,VIR,P001133,P013374,3.299,6,10,4
9,VIR,P001133,PBCN,5.716,14,18,4
9,VIR,P001844,P002084,6.517,2,13,11
9,VIR,P001844,P004554,12.1,-7,19,26
9,VIR,P001844,P004888,10.333,-12,15,27
9,VIR,P001844,P006739,0.283,0,2,2
9,VIR,P001844,P009549,19.483,-7,36,43
9,VIR,P001844,P011816,0.783,-2,2,4
9,VIR,P001844,P012585,4.15,3,9,6
9,VIR,P001844,P012591,4.917,2,10,8
9,VIR,P001844,P013374,0.283,0,2,2
9,VIR,P002084,P004554,1.95,-2,2,4
9,VIR,P002084,P004888,4.1,-2,5,7
9,VIR,P002084,P006739,10.199,-17,9,26
9,VIR,P002084,P009549,10.717,-9,17,26
9,VIR,P002084,P012585,5.833,-1,9,10
9,VIR,P002084,P012591,3.066,-1,4,5
9,VIR,P002084,P013374,8.499,-15,7,22
9,VIR,P002084,PBCN,10.166,-17,9,26
9,VIR,P004554,P004888,13.233,-7,17,24
9,VIR,P004554,P006739,3.3,0,4,4
9,VIR,P004554,P009549,20.85,0,35,35
9,VIR,P004554,P012585,5.6,7,12,5
9,VIR,P004554,P012591,3.55,1,6,5
9,VIR,P004554,PBCN,4.367,6,12,6
9,VIR,P004888,P006739,5.133,2,7,5
9,VIR,P004888,P009549,14.583,-11,19,30
9,VIR,P004888,P011816,0.783,-2,2,4
9,VIR,P004888,P012585,2.75,-1,2,3
9,VIR,P004888,P013374,3.533,0,5,5
9,VIR,P004888,PBCN,3.433,0,5,5
9,VIR,P006739,P009549,6.466,-5,12,17
9,VIR,P006739,P012585,3.916,-2,4,6
9,VIR,P006739,P012591,1.366,-2,0,2
9,VIR,P006739,P013374,11.798,-9,17,26
9,VIR,P006739,PBCN,13.032,-11,17,28
9,VIR,P009549,P011816,0.783,-2,2,4
9,VIR,P009549,P012585,9.75,10,21,11
9,VIR,P009549,P012591,5.1,2,10,8
9,VIR,P009549,P013374,3.316,-5,8,13
9,VIR,P009549,PBCN,7.35,1,18,17
9,VIR,P012585,P013374,3.916,-2,4,6
9,VIR,P012585,PBCN,6.766,6,14,8
9,VIR,P012591,P013374,1.033,-2,0,2
9,VIR,P012591,PBCN,1.183,-2,0,2
9,VIR,P013374,PBCN,11.515,-9,15,24
10,MCO,P002581,P005985,21.066,5,49,44
10,MCO,P002581,P008099,13.3,5,32,27
10,MCO,P002581,P011212,10.2,4,25,21
10,MCO,P002581,P011226,16.95,9,41,32
10,MCO,P002581,P011231,5.866,-1,13,14
10,MCO,P002581,PLCZ,21.75,6,52,46
10,MCO,P005844,P005985,10.233,4,20,16
10,MCO,P005844,P008099,13.649,-5,25,30
10,MCO,P005844,P011212,16.783,-1,30,31
10,MCO,P005844,P011226,12.333,-1,21,22
10,MCO,P005844,P011231,14.866,4,30,26
10,MCO,P005844,P012515,0.15,0,0,0
10,MCO,P005844,P013365,2.85,-5,2,7
10,MCO,P005985,P008099,18.249,3,41,38
10,MCO,P005985,P011212,18.283,6,39,33
10,MCO,P005985,P011226,20.583,11,46,35
10,MCO,P005985,P011231,14.332,3,31,28
10,MCO,P005985,P012515,0.15,0,0,0
10,MCO,P005985,P013365,1.767,0,2,2
10,MCO,P005985,PLCZ,20.533,4,48,44
10,MCO,P008099,P011212,14.083,-3,27,30
10,MCO,P008099,P011226,16.233,2,34,32
10,MCO,P008099,P011231,17.899,-2,37,39
10,MCO,P008099,P013365,1.083,-5,0,5
10,MCO,P008099,PLCZ,13.3,5,32,27
10,MCO,P011212,P011226,21.6,3,44,41
10,MCO,P011212,P011231,14.466,5,29,24
10,MCO,P011212,P013365,2.85,-5,2,7
10,MCO,P011212,PLCZ,9.667,3,24,21
10,MCO,P011226,P011231,10.016,5,20,15
10,MCO,P011226,P012515,0.15,0,0,0
10,MCO,P011226,P013365,2.85,-5,2,7
10,MCO,P011226,PLCZ,16.417,8,40,32
10,MCO,P011231,P012515,0.15,0,0,0
10,MCO,P011231,PLCZ,5.333,-2,12,14
10,TEL,P005145,P006835,3.017,-2,7,9
10,TEL,P005145,P009754,5.867,-2,14,16
10,TEL,P005145,P011193,5.867,-2,14,16
10,TEL,P005145,P011214,5.867,-2,14,16
10,TEL,P005145,P013382,2.85,0,7,7
10,TEL,P006835,P007519,9.15,1,19,18
10,TEL,P006835,P007855,0.867,-3,0,3
10,TEL,P006835,P007990,13.899,-3,26,29
10,TEL,P006835,P009754,16.866,-9,32,41
10,TEL,P006835,P011193,19.066,-9,35,44
10,TEL,P006835,P011214,14.949,-5,29,34
10,TEL,P006835,P011219,11.033,0,23,23
10,TEL,P006835,P013381,2.6,-6,3,9
10,TEL,P006835,P013382,21.549,0,42,42
10,TEL,P007519,P007855,2.884,-2,4,6
10,TEL,P007519,P007990,11.467,3,23,20
10,TEL,P007519,P009754,5.917,-2,10,12
10,TEL,P007519,P011214,6.633,-2,12,14
10,TEL,P007519,P011219,6.667,5,13,8
10,TEL,P007519,P013381,0.867,-3,0,3
10,TEL,P007519,P013382,8.283,4,19,15
10,TEL,P007855,P007990,2.884,-2,4,6
10,TEL,P007855,P009754,2.017,1,4,3
10,TEL,P007855,P011219,2.017,1,4,3
10,TEL,P007855,P013381,0.867,-3,0,3
10,TEL,P007990,P009754,6.333,-3,10,13
10,TEL,P007990,P011193,6.216,-5,9,14
10,TEL,P007990,P011214,7.599,-3,12,15
10,TEL,P007990,P011219,9.65,3,20,17
10,TEL,P007990,P013381,0.867,-3,0,3
10,TEL,P007990,P013382,11.949,1,24,23
10,TEL,P009754,P011193,22.666,-3,47,50
10,TEL,P009754,P011214,18.916,-2,40,42
10,TEL,P009754,P011219,15.183,-1,29,30
10,TEL,P009754,P013381,2.616,-2,6,8
10,TEL,P009754,P013382,18.083,-1,36,37
10,TEL,P011193,P011214,18.016,0,38,38
10,TEL,P011193,P011219,13.266,-2,28,30
10,TEL,P011193,P013381,2.616,-2,6,8
10,TEL,P011193,P013382,20.283,-1,39,40
10,TEL,P011214,P011219,6.883,2,14,12
10,TEL,P011214,P013381,0.883,1,3,2
10,TEL,P011214,P013382,18.982,-1,38,39
10,TEL,P011219,P013381,2.616,-2,6,8
10,TEL,P011219,P013382,12.417,6,27,21
11,BAS,P007230,P008072,7.85,-7,8,15
11,BAS,P007230,P011085,3.25,-6,0,6
11,BAS,P007230,P011196,21.284,-6,33,39
11,BAS,P007230,P011948,9.599,-1,17,18
11,BAS,P007230,P012080,21.418,-15,29,44
11,BAS,P007230,P012201,22.384,-6,35,41
11,BAS,P007230,P012597,11.217,-2,18,20
11,BAS,P007230,P013367,17.334,-5,24,29
11,BAS,P008072,P011085,7.45,-10,8,18
11,BAS,P008072,P011196,0.55,-1,0,1
11,BAS,P008072,P011948,10.466,-8,16,24
11,BAS,P008072,P012080,5.934,-6,6,12
11,BAS,P008072,P012201,5.85,-5,10,15
11,BAS,P008072,P012597,7.5,-7,12,19
11,BAS,P008072,P013367,2.6,0,4,4
11,BAS,P011085,P011196,6.767,8,17,9
11,BAS,P011085,P011948,13.417,1,25,24
11,BAS,P011085,P012080,2.417,-4,0,4
11,BAS,P011085,P012201,10.8,4,25,21
11,BAS,P011085,P012597,7.717,-2,15,17
11,BAS,P011085,P013367,5.05,1,10,9
11,BAS,P011196,P011948,10.217,15,31,16
11,BAS,P011196,P012080,15.484,-9,23,32
11,BAS,P011196,P012201,28.334,3,55,52
11,BAS,P011196,P012597,11.134,5,26,21
11,BAS,P011196,P013367,20.234,-3,35,38
11,BAS,P011948,P012080,4.9,-4,6,10
11,BAS,P011948,P012201,14.783,13,41,28
11,BAS,P011948,P012597,12.15,5,33,28
11,BAS,P011948,P013367,7.2,7,19,12
11,BAS,P012080,P012201,16.051,-11,23,34
11,BAS,P012080,P012597,4.051,-5,6,11
11,BAS,P012080,P013367,15.417,-6,23,29
11,BAS,P012201,P012597,15.7,3,36,33
11,BAS,P012201,P013367,20.634,-5,35,40
11,BAS,P012597,P013367,2.867,-1,6,7
11,RED,P000848,P002553,8.199,8,20,12
11,RED,P000848,P004007,5.416,2,14,12
11,RED,P000848,P004866,2.733,-4,0,4
11,RED,P000848,P006436,8.483,8,20,12
11,RED,P000848,P007960,3.25,6,6,0
11,RED,P000848,P009035,3.017,-4,0,4
11,RED,P000848,P009048,0.867,-3,0,3
11,RED,P000848,P010612,0.117,0,0,0
11,RED,P000848,P012044,10.433,9,20,11
11,RED,P000848,P012786,2.667,-4,0,4
11,RED,P000848,PLUO,0.15,-2,0,2
11,RED,P002553,P004007,9.565,-3,19,22
11,RED,P002553,P004866,2.483,-9,1,10
11,RED,P002553,P006436,10.599,4,24,20
11,RED,P002553,P007960,2.783,6,6,0
11,RED,P002553,P009048,4.333,-9,5,14
11,RED,P002553,P010612,4.516,-9,5,14
11,RED,P002553,P012044,8.232,10,20,10
11,RED,P002553,PLUO,0.15,-2,0,2
11,RED,P004007,P004866,8.299,2,17,15
11,RED,P004007,P006436,10.049,-1,23,24
11,RED,P004007,P007960,3.934,-2,7,9
11,RED,P004007,P009035,8.3,4,19,15
11,RED,P004007,P009048,11.666,-2,23,25
11,RED,P004007,P010612,8.032,1,15,14
11,RED,P004007,P012044,6.049,5,15,10
11,RED,P004007,PLUO,0.15,-2,0,2
11,RED,P004866,P006436,1.967,-8,4,12
11,RED,P004866,P007960,2.95,2,7,5
11,RED,P004866,P009035,24.583,11,50,39
11,RED,P004866,P009048,24.333,6,51,45
11,RED,P004866,P010612,22.033,5,45,40
11,RED,P004866,P012044,2.733,-4,0,4
11,RED,P004866,P012786,16.15,7,29,22
11,RED,P006436,P007960,5.367,3,9,6
11,RED,P006436,P009035,4.184,-7,7,14
11,RED,P006436,P009048,4.767,-9,10,19
11,RED,P006436,P010612,3.7,-8,6,14
11,RED,P006436,P012044,9.866,8,21,13
11,RED,P006436,PLUO,0.15,-2,0,2
11,RED,P007960,P009035,5.534,-1,10,11
11,RED,P007960,P009048,4.467,-2,9,11
11,RED,P007960,P010612,1.133,1,3,2
11,RED,P007960,P012044,3.85,7,7,0
11,RED,P009035,P009048,23.55,11,52,41
11,RED,P009035,P010612,19.733,14,44,30
11,RED,P009035,P012044,3.617,-3,1,4
11,RED,P009035,P012786,16.15,7,29,22
11,RED,P009048,P010612,23.433,8,49,41
11,RED,P009048,P012044,0.117,0,0,0
11,RED,P009048,P012786,14.467,8,29,21
11,RED,P010612,P012044,1.05,-3,0,3
11,RED,P010612,P012786,13.717,11,29,18
11,RED,P012044,P012786,1.917,-1,0,1
12,IST,P004887,P006590,9.05,-6,10,16
12,IST,P004887,P006640,1.217,-6,0,6
12,IST,P004887,P007109,6.833,-10,6,16
12,IST,P004887,P007200,11.884,-16,14,30
12,IST,P004887,P009664,5.067,-1,6,7
12,IST,P004887,P009846,4.634,-5,8,13
12,IST,P004887,P011078,1.617,-4,4,8
12,IST,P004887,P012710,2.034,-5,4,9
12,IST,P004887,P013363,5.2,-11,4,15
12,IST,P006590,P007109,7.216,-4,9,13
12,IST,P006590,P007200,21.066,1,45,44
12,IST,P006590,P009664,9.266,3,20,17
12,IST,P006590,P009846,4.633,4,12,8
12,IST,P006590,P011078,7.266,12,25,13
12,IST,P006590,P012710,1.616,5,8,3
12,IST,P006590,P012788,10.0,4,27,23
12,IST,P006590,P013363,12.583,1,28,27
12,IST,P006590,P013364,4.7,-4,8,12
12,IST,P006640,P007109,0.8,-5,0,5
12,IST,P006640,P007200,1.217,-6,0,6
12,IST,P006640,P012710,0.417,-1,0,1
12,IST,P006640,P013363,1.217,-6,0,6
12,IST,P007109,P007200,8.566,-11,9,20
12,IST,P007109,P009664,6.3,3,9,6
12,IST,P007109,P009846,3.067,2,4,2
12,IST,P007109,P011078,2.517,4,4,0
12,IST,P007109,P013363,4.783,-10,4,14
12,IST,P007109,P013364,4.25,3,7,4
12,IST,P007200,P009664,9.033,-2,17,19
12,IST,P007200,P009846,6.017,-5,13,18
12,IST,P007200,P011078,8.1,5,26,21
12,IST,P007200,P012710,2.867,-3,9,12
12,IST,P007200,P012788,10.0,4,27,23
12,IST,P007200,P013363,13.8,-5,28,33
12,IST,P007200,P013364,5.25,-6,8,14
12,IST,P009664,P009846,13.45,3,23,20
12,IST,P009664,P011078,9.05,4,14,10
12,IST,P009664,P012710,3.299,-1,8,9
12,IST,P009664,P012788,7.15,-5,10,15
12,IST,P009664,P013364,9.717,4,17,13
12,IST,P009846,P011078,17.167,2,33,31
12,IST,P009846,P012710,11.416,-3,27,30
12,IST,P009846,P012788,12.25,-1,22,23
12,IST,P009846,P013364,13.634,7,26,19
12,IST,P011078,P012710,10.583,-5,22,27
12,IST,P011078,P012788,18.733,8,44,36
12,IST,P011078,P013363,6.483,9,22,13
12,IST,P011078,P013364,13.084,9,26,17
12,IST,P012710,P012788,8.183,-4,15,19
12,IST,P012710,P013363,0.417,-1,0,1
12,IST,P012710,P013364,6.5,2,15,13
12,IST,P012788,P013363,8.6,6,24,18
12,IST,P012788,P013364,14.084,0,27,27
12,IST,P013363,P013364,2.117,-3,2,5
12,ULK,P002849,P004004,5.083,-4,6,10
12,ULK,P002849,P006961,10.383,15,25,10
12,ULK,P002849,P007182,14.416,18,39,21
12,ULK,P002849,P008104,11.9,18,30,12
12,ULK,P002849,P008962,6.333,-3,4,7
12,ULK,P002849,P009783,6.482,-1,13,14
12,ULK,P002849,P009863,12.116,-1,18,19
12,ULK,P002849,P011205,16.283,18,37,19
12,ULK,P002968,P004004,5.55,1,13,12
12,ULK,P002968,P006961,0.683,-1,0,1
12,ULK,P002968,P008962,6.233,0,13,13
12,ULK,P002968,P009783,6.233,0,13,13
12,ULK,P002968,P009863,6.233,0,13,13
12,ULK,P004004,P007182,12.233,-2,25,27
12,ULK,P004004,P008104,2.167,3,5,2
12,ULK,P004004,P008962,17.417,2,39,37
12,ULK,P004004,P009783,16.65,-5,33,38
12,ULK,P004004,P009863,18.5,0,41,41
12,ULK,P004004,P011205,4.4,1,10,9
12,ULK,P006961,P007182,8.416,12,25,13
12,ULK,P006961,P008104,5.75,12,16,4
12,ULK,P006961,P008962,6.216,-8,4,12
12,ULK,P006961,P009783,5.332,-3,11,14
12,ULK,P006961,P009863,5.483,-8,2,10
12,ULK,P006961,P011205,9.133,17,25,8
12,ULK,P007182,P008104,13.233,13,31,18
12,ULK,P007182,P008962,12.299,-11,24,35
12,ULK,P007182,P009783,12.399,-9,27,36
12,ULK,P007182,P009863,17.349,-9,36,45
12,ULK,P007182,P011205,16.515,16,45,29
12,ULK,P008104,P008962,2.05,-4,4,8
12,ULK,P008104,P009863,6.75,0,16,16
12,ULK,P008104,P011205,13.95,14,34,20
12,ULK,P008962,P009783,20.082,-10,35,45
12,ULK,P008962,P009863,24.849,-13,42,55
12,ULK,P008962,P011205,6.849,-5,11,16
12,ULK,P009783,P009863,20.432,-12,35,47
12,ULK,P009783,P011205,2.782,0,9,9
12,ULK,P009863,P011205,10.816,-1,21,22
13,ASV,P000229,P002100,8.867,-12,10,22
13,ASV,P000229,P004194,4.95,-5,3,8
13,ASV,P000229,P007027,4.583,6,11,5
13,ASV,P000229,P008991,10.033,-3,16,19
13,ASV,P000229,P010545,1.55,-1,3,4
13,ASV,P000229,P012731,8.134,-1,18,19
13,ASV,P000229,P013371,11.75,-2,21,23
13,ASV,P000229,P013372,0.533,2,2,0
13,ASV,P002100,P003526,12.616,4,35,31
13,ASV,P002100,P004194,13.966,-2,29,31
13,ASV,P002100,P007027,15.899,-2,36,38
13,ASV,P002100,P008991,7.45,-10,8,18
13,ASV,P002100,P010545,14.166,0,33,33
13,ASV,P002100,P012731,7.55,-8,18,26
13,ASV,P002100,P013371,9.35,-9,16,25
13,ASV,P002100,P013372,7.366,-2,16,18
13,ASV,P002100,PKIR,3.766,-3,7,10
13,ASV,P003526,P004194,7.583,4,22,18
13,ASV,P003526,P007027,20.6,10,51,41
13,ASV,P003526,P010545,19.317,12,48,36
13,ASV,P003526,P012731,2.616,-1,9,10
13,ASV,P003526,P013371,10.65,8,28,20
13,ASV,P003526,P013372,13.3,6,34,28
13,ASV,P003526,PKIR,1.05,1,1,0
13,ASV,P004194,P007027,10.033,-2,22,24
13,ASV,P004194,P008991,3.533,-3,1,4
13,ASV,P004194,P010545,8.3,0,19,19
13,ASV,P004194,P012731,3.633,-1,11,12
13,ASV,P004194,P013371,6.933,-4,11,15
13,ASV,P004194,PKIR,2.933,-3,6,9
13,ASV,P007027,P008991,3.233,7,8,1
13,ASV,P007027,P010545,26.133,6,60,54
13,ASV,P007027,P012731,4.683,4,12,8
13,ASV,P007027,P013371,14.75,13,35,22
13,ASV,P007027,P013372,16.166,6,39,33
13,ASV,P007027,PKIR,6.516,-4,10,14
13,ASV,P008991,P012731,6.7,0,15,15
13,ASV,P008991,P013371,9.783,-3,16,19
13,ASV,P008991,PKIR,0.2,0,0,0
13,ASV,P010545,P012731,0.617,-1,1,2
13,ASV,P010545,P013371,11.967,6,27,21
13,ASV,P010545,P013372,16.166,6,39,33
13,ASV,P010545,PKIR,6.316,-4,10,14
13,ASV,P012731,P013371,9.667,0,24,24
13,ASV,P012731,PKIR,0.2,0,0,0
13,ASV,P013371,P013372,8.8,8,23,15
13,ASV,P013371,PKIR,2.75,-1,3,4
13,ASV,P013372,PKIR,2.333,-2,3,5
13,VIR,P001133,P001844,5.617,-4,15,19
13,VIR,P001133,P002084,4.85,1,9,8
13,VIR,P001133,P004554,15.267,-10,33,43
13,VIR,P001133,P004888,20.484,-9,41,50
13,VIR,P001133,P006739,16.168,-4,31,35
13,VIR,P001133,P009549,27.917,-1,58,59
13,VIR,P001133,P012585,8.6,3,12,9
13,VIR,P001133,P013374,8.201,6,16,10
13,VIR,P001133,PBCN,9.5,6,17,11
13,VIR,P001844,P004554,5.25,-2,15,17
13,VIR,P001844,P004888,5.25,-2,15,17
13,VIR,P001844,P006739,0.367,-2,0,2
13,VIR,P001844,P009549,5.25,-2,15,17
13,VIR,P001844,P013374,0.367,-2,0,2
13,VIR,P001844,PBCN,0.367,-2,0,2
13,VIR,P002084,P004554,1.7,-4,0,4
13,VIR,P002084,P004888,3.5,2,8,6
13,VIR,P002084,P006739,10.45,1,27,26
13,VIR,P002084,P009549,7.95,4,17,13
13,VIR,P002084,P012585,13.0,-1,28,29
13,VIR,P002084,P013374,9.15,5,27,22
13,VIR,P002084,PBCN,12.2,0,28,28
13,VIR,P004554,P004888,15.267,-10,33,43
13,VIR,P004554,P006739,10.017,-14,14,28
13,VIR,P004554,P009549,15.117,-10,33,43
13,VIR,P004554,P012585,3.55,-2,4,6
13,VIR,P004554,PBCN,1.7,-4,0,4
13,VIR,P004888,P006739,13.184,-6,27,33
13,VIR,P004888,P009549,21.617,-7,46,53
13,VIR,P004888,P012585,3.483,1,4,3
13,VIR,P004888,P013374,3.45,3,10,7
13,VIR,P004888,PBCN,0.833,0,0,0
13,VIR,P006739,P009549,16.217,0,36,36
13,VIR,P006739,P012585,8.617,-2,19,21
13,VIR,P006739,P013374,13.767,9,38,29
13,VIR,P006739,PBCN,12.017,2,28,26
13,VIR,P009549,P012585,9.55,4,15,11
13,VIR,P009549,P013374,10.217,11,24,13
13,VIR,P009549,PBCN,10.233,9,20,11
13,VIR,P012585,P013374,10.351,4,24,20
13,VIR,P012585,PBCN,15.517,1,30,29
13,VIR,P013374,PBCN,13.901,8,33,25
14,MUN,P001288,P004508,10.967,-4,20,24
14,MUN,P001288,P007056,13.717,-7,25,32
14,MUN,P001288,P007201,20.501,-11,36,47
14,MUN,P001288,P007639,6.784,-4,11,15
14,MUN,P001288,P010391,6.15,-6,8,14
14,MUN,P001288,P011052,4.817,2,12,10
14,MUN,P001288,P011224,9.534,-7,16,23
14,MUN,P001288,P011987,9.534,-7,16,23
14,MUN,P004508,P007056,13.417,-13,23,36
14,MUN,P004508,P007201,15.734,-11,29,40
14,MUN,P004508,P007639,7.35,5,18,13
14,MUN,P004508,P010391,13.25,-6,25,31
14,MUN,P004508,P011052,13.25,0,31,31
14,MUN,P004508,P011224,1.367,-2,2,4
14,MUN,P004508,P011244,5.033,3,12,9
14,MUN,P004508,P011987,2.7,-4,4,8
14,MUN,P007056,P007201,22.6,-12,41,53
14,MUN,P007056,P010391,13.584,-9,23,32
14,MUN,P007056,P011052,7.983,-3,18,21
14,MUN,P007056,P011224,13.884,-1,28,29
14,MUN,P007056,P011244,3.334,0,8,8
14,MUN,P007056,P011987,15.2,-3,30,33
14,MUN,P007056,P012123,0.017,0,0,0
14,MUN,P007201,P007639,6.784,-4,11,15
14,MUN,P007201,P010391,10.25,-9,15,24
14,MUN,P007201,P011052,10.3,-1,24,25
14,MUN,P007201,P011224,15.017,-7,25,32
14,MUN,P007201,P011987,16.35,-9,27,36
14,MUN,P007639,P010391,5.033,3,12,9
14,MUN,P007639,P011052,9.6,3,25,22
14,MUN,P007639,P011224,4.467,-6,5,11
14,MUN,P007639,P011244,7.283,1,19,18
14,MUN,P007639,P011987,6.717,-8,12,20
14,MUN,P007639,P012123,2.25,-2,7,9
14,MUN,P010391,P011052,7.1,0,17,17
14,MUN,P010391,P011224,5.367,0,10,10
14,MUN,P010391,P011244,8.367,3,20,17
14,MUN,P010391,P011987,5.35,0,10,10
14,MUN,P010391,P012123,0.017,0,0,0
14,MUN,P011052,P011224,2.083,2,5,3
14,MUN,P011052,P011244,7.283,1,19,18
14,MUN,P011052,P011987,5.666,-2,14,16
14,MUN,P011052,P012123,2.25,-2,7,9
14,MUN,P011224,P011244,3.334,0,8,8
14,MUN,P011224,P011987,18.334,-7,33,40
14,MUN,P011224,P012123,0.017,0,0,0
14,MUN,P011244,P011987,5.567,-2,15,17
14,MUN,P011244,P012123,2.267,-2,7,9
14,MUN,P011987,P012123,2.25,-2,7,9
14,PAN,P001926,P002328,3.284,-8,5,13
14,PAN,P001926,P003842,10.55,2,22,20
14,PAN,P001926,P004088,8.3,2,18,16
14,PAN,P001926,P005161,3.983,-4,8,12
14,PAN,P001926,P005353,2.8,-8,5,13
14,PAN,P001926,P007866,8.05,6,18,12
14,PAN,P001926,P009622,0.067,0,0,0
14,PAN,P001926,P011204,0.067,0,0,0
14,PAN,P001926,P012712,3.217,-8,5,13
14,PAN,P001926,P012774,13.35,-6,27,33
14,PAN,P002328,P003842,0.767,2,2,0
14,PAN,P002328,P004088,0.067,0,0,0
14,PAN,P002328,P005353,9.616,-5,17,22
14,PAN,P002328,P007866,0.083,-1,0,1
14,PAN,P002328,P009622,5.333,5,12,7
14,PAN,P002328,P011204,7.233,5,14,9
14,PAN,P002328,P012712,10.3,-2,19,21
14,PAN,P002328,P012774,5.117,-8,7,15
14,PAN,P003842,P004088,10.899,10,30,20
14,PAN,P003842,P005161,13.366,1,31,30
14,PAN,P003842,P007866,10.383,13,27,14
14,PAN,P003842,P009622,12.049,9,29,20
14,PAN,P003842,P011204,9.715,17,35,18
14,PAN,P003842,P011209,5.716,6,18,12
14,PAN,P003842,P012712,12.816,11,31,20
14,PAN,P003842,P012774,23.599,17,59,42
14,PAN,P004088,P005161,2.083,-4,4,8
14,PAN,P004088,P005353,2.85,-2,6,8
14,PAN,P004088,P007866,9.916,10,25,15
14,PAN,P004088,P009622,1.817,2,7,5
14,PAN,P004088,P011204,5.583,6,18,12
14,PAN,P004088,P012712,1.75,2,7,5
14,PAN,P004088,P012774,11.999,6,29,23
14,PAN,P005161,P007866,1.9,0,4,4
14,PAN,P005161,P009622,7.2,3,14,11
14,PAN,P005161,P011204,2.183,2,9,7
14,PAN,P005161,P011209,2.183,2,9,7
14,PAN,P005161,P012712,7.2,3,14,11
14,PAN,P005161,P012774,13.366,1,31,30
14,PAN,P005353,P007866,1.516,-4,2,6
14,PAN,P005353,P009622,6.683,6,16,10
14,PAN,P005353,P011204,9.666,1,18,17
14,PAN,P005353,P012712,10.95,-3,21,24
14,PAN,P005353,P012774,5.783,-13,7,20
14,PAN,P007866,P009622,0.083,-1,0,1
14,PAN,P007866,P011204,3.849,3,11,8
14,PAN,P007866,P012774,11.816,10,29,19
14,PAN,P009622,P011204,11.599,12,31,19
14,PAN,P009622,P011209,3.533,4,9,5
14,PAN,P009622,P012712,18.649,16,45,29
14,PAN,P009622,P012774,8.183,4,17,13
14,PAN,P011204,P011209,5.716,6,18,12
14,PAN,P011204,P012712,13.349,13,33,20
14,PAN,P011204,P012774,8.832,7,25,18
14,PAN,P011209,P012712,3.533,4,9,5
14,PAN,P011209,P012774,2.183,2,9,7
14,PAN,P012712,P012774,13.3,-4,24,28
15,MAD,P003108,P003583,6.801,-1,13,14
15,MAD,P003108,P003733,0.567,2,2,0
15,MAD,P003108,P005791,10.284,0,20,20
15,MAD,P003108,P005928,11.985,3,25,22
15,MAD,P003108,P006540,12.317,-5,17,22
15,MAD,P003108,P009005,2.4,-4,4,8
15,MAD,P003108,P009213,14.118,1,27,26
15,MAD,P003108,P011247,5.1,-4,8,12
15,MAD,P003108,P013378,4.201,2,14,12
15,MAD,P003108,PTGB,0.567,2,2,0
15,MAD,P003583,P003733,7.567,8,22,14
15,MAD,P003583,P005928,20.802,6,52,46
15,MAD,P003583,P006540,6.7,1,14,13
15,MAD,P003583,P009005,15.384,4,41,37
15,MAD,P003583,P009213,9.501,-8,16,24
15,MAD,P003583,P011247,0.033,0,0,0
15,MAD,P003583,P013378,13.168,11,40,29
15,MAD,P003583,PTGB,5.184,-5,10,15
15,MAD,P003733,P005791,3.134,-3,6,9
15,MAD,P003733,P005928,9.301,8,26,18
15,MAD,P003733,P009005,8.634,6,24,18
15,MAD,P003733,P009213,1.5,-3,2,5
15,MAD,P003733,P011247,1.4,-3,2,5
15,MAD,P003733,P013378,5.5,9,18,9
15,MAD,P003733,PTGB,5.201,-4,10,14
15,MAD,P005791,P005928,6.951,4,16,12
15,MAD,P005791,P006540,7.917,-2,12,14
15,MAD,P005791,P009005,3.134,-3,6,9
15,MAD,P005791,P009213,10.284,0,20,20
15,MAD,P005791,P011247,6.467,-7,10,17
15,MAD,P005791,P013378,2.367,2,8,6
15,MAD,P005791,PTGB,3.134,-3,6,9
15,MAD,P005928,P006540,9.517,3,18,15
15,MAD,P005928,P009005,16.668,6,45,39
15,MAD,P005928,P009213,14.235,-2,28,30
15,MAD,P005928,P013378,15.052,15,48,33
15,MAD,P005928,PTGB,6.501,-3,14,17
15,MAD,P006540,P009005,9.033,5,24,19
15,MAD,P006540,P009213,16.184,6,32,26
15,MAD,P006540,P011247,5.1,-4,8,12
15,MAD,P006540,P013378,7.6,10,24,14
15,MAD,P006540,PTGB,5.3,6,15,9
15,MAD,P009005,P009213,9.467,0,22,22
15,MAD,P009005,P011247,1.4,-3,2,5
15,MAD,P009005,P013378,17.601,18,53,35
15,MAD,P009005,PTGB,11.551,-1,27,28
15,MAD,P009213,P011247,5.1,-4,8,12
15,MAD,P009213,P013378,11.051,4,29,25
15,MAD,P009213,PTGB,8.9,-2,20,22
15,MAD,P011247,P013378,0.033,0,0,0
15,MAD,P011247,PTGB,1.367,-3,2,5
15,MAD,P013378,PTGB,6.767,5,18,13
15,PAR,P004761,P006591,13.234,-6,30,36
15,PAR,P004761,P006760,16.966,-11,34,45
15,PAR,P004761,P007632,2.233,1,3,2
15,PAR,P004761,P007870,11.717,-1,30,31
15,PAR,P004761,P008232,2.133,1,9,8
15,PAR,P004761,P010781,1.466,5,7,2
15,PAR,P004761,P011981,11.783,1,27,26
15,PAR,P004761,P012720,12.116,-5,31,36
15,PAR,P004761,P013369,13.616,-5,29,34
15,PAR,P006591,P006760,18.734,-7,43,50
15,PAR,P006591,P007632,2.983,1,7,6
15,PAR,P006591,P007870,17.667,1,44,43
15,PAR,P006591,P010781,2.983,1,7,6
15,PAR,P006591,P011981,5.501,2,13,11
15,PAR,P006591,P012720,11.001,-2,27,29
15,PAR,P006591,P013369,11.701,2,29,27
15,PAR,P006760,P007632,10.883,0,17,17
15,PAR,P006760,P007870,21.434,0,51,51
15,PAR,P006760,P010781,10.05,2,19,17
15,PAR,P006760,P011981,16.617,-7,28,35
15,PAR,P006760,P012720,20.701,1,49,48
15,PAR,P006760,P013369,21.483,-10,39,49
15,PAR,P007632,P007870,5.1,4,12,8
15,PAR,P007632,P010781,8.65,-1,14,15
15,PAR,P007632,P011981,5.783,-4,5,9
15,PAR,P007632,P012720,2.117,3,5,2
15,PAR,P007632,P013369,5.783,-4,5,9
15,PAR,P007870,P008232,1.433,-5,0,5
15,PAR,P007870,P010781,7.9,2,17,15
15,PAR,P007870,P011981,7.517,1,16,15
15,PAR,P007870,P012720,16.651,-5,35,40
15,PAR,P007870,P013369,10.917,3,27,24
15,PAR,P008232,P010781,2.866,0,7,7
15,PAR,P008232,P011981,3.566,-4,9,13
15,PAR,P008232,P012720,3.566,-4,9,13
15,PAR,P008232,P013369,0.7,-4,2,6
15,PAR,P010781,P011981,7.783,-2,14,16
15,PAR,P010781,P012720,6.383,6,17,11
15,PAR,P010781,P013369,3.583,-5,2,7
15,PAR,P011981,P012720,12.883,-2,32,34
15,PAR,P011981,P013369,18.167,-9,32,41
15,PAR,P012720,P013369,11.65,-4,27,31
16,MIL,P000796,P001392,9.216,2,19,17
16,MIL,P000796,P001518,13.35,16,35,19
16,MIL,P000796,P006085,21.832,7,50,43
16,MIL,P000796,P006509,6.799,-5,14,19
16,MIL,P000796,P006701,1.866,-4,2,6
16,MIL,P000796,P007831,25.832,6,58,52
16,MIL,P000796,P008987,20.548,7,48,41
16,MIL,P000796,P013384,5.798,-13,5,18
16,MIL,P000796,P013386,7.683,-4,13,17
16,MIL,P001392,P001518,7.367,5,12,7
16,MIL,P001392,P006085,9.133,1,19,18
16,MIL,P001392,P006509,7.067,0,14,14
16,MIL,P001392,P007831,13.582,1,24,23
16,MIL,P001392,P008987,13.049,5,27,22
16,MIL,P001392,P013384,6.683,1,11,10
16,MIL,P001392,P013385,8.167,1,17,16
16,MIL,P001392,P013386,2.4,-4,1,5
16,MIL,P001518,P006085,10.45,13,29,16
16,MIL,P001518,P006509,3.017,-1,5,6
16,MIL,P001518,P006701,1.033,0,2,2
16,MIL,P001518,P007831,14.967,17,36,19
16,MIL,P001518,P008987,10.733,13,23,10
16,MIL,P001518,P013384,6.366,4,10,6
16,MIL,P001518,P013385,3.717,2,8,6
16,MIL,P001518,P013386,4.4,3,12,9
16,MIL,P006085,P006509,8.15,-1,18,19
16,MIL,P006085,P007831,22.682,5,52,47
16,MIL,P006085,P008987,19.949,6,47,41
16,MIL,P006085,P013384,2.149,-6,0,6
16,MIL,P006085,P013385,4.45,-1,9,10
16,MIL,P006085,P013386,6.333,0,12,12
16,MIL,P006509,P006701,2.65,-3,1,4
16,MIL,P006509,P007831,6.466,-4,13,17
16,MIL,P006509,P008987,11.783,-3,22,25
16,MIL,P006509,P013384,4.967,-3,5,8
16,MIL,P006509,P013385,7.901,0,12,12
16,MIL,P006701,P008987,3.683,-3,3,6
16,MIL,P006701,P013384,3.683,-3,3,6
16,MIL,P006701,P013385,1.817,1,1,0
16,MIL,P007831,P008987,21.215,8,47,39
16,MIL,P007831,P013384,6.082,-5,7,12
16,MIL,P007831,P013385,2.683,0,6,6
16,MIL,P007831,P013386,7.683,-4,13,17
16,MIL,P008987,P013384,7.165,-5,5,10
16,MIL,P008987,P013385,6.267,0,10,10
16,MIL,P013384,P013385,4.934,5,9,4
16,MIL,P013384,P013386,2.233,-7,1,8
16,PRS,P004197,P010390,14.167,1,27,26
16,PRS,P004197,P012608,14.167,1,27,26
16,PRS,P004197,P012610,14.167,1,27,26
16,PRS,P004197,P012613,14.167,1,27,26
16,PRS,P004512,P005793,10.65,5,22,17
16,PRS,P004512,P007032,10.65,5,22,17
16,PRS,P004512,P012609,10.65,5,22,17
16,PRS,P004512,P012640,10.65,5,22,17
16,PRS,P005793,P007032,12.917,4,25,21
16,PRS,P005793,P012608,1.683,0,6,6
16,PRS,P005793,P012609,14.6,4,31,27
16,PRS,P005793,P012610,1.683,0,6,6
16,PRS,P005793,P012613,1.683,0,6,6
16,PRS,P005793,P012640,12.917,4,25,21
16,PRS,P005793,P013373,2.267,-1,3,4
16,PRS,P007032,P010390,2.783,-4,1,5
16,PRS,P007032,P012608,2.783,-4,1,5
16,PRS,P007032,P012609,12.917,4,25,21
16,PRS,P007032,P012610,2.783,-4,1,5
16,PRS,P007032,P012613,2.783,-4,1,5
16,PRS,P007032,P012640,12.917,4,25,21
16,PRS,P007032,P013373,2.267,-1,3,4
16,PRS,P010390,P012608,25.399,-9,43,52
16,PRS,P010390,P012609,6.966,-5,15,20
16,PRS,P010390,P012610,24.566,-13,39,52
16,PRS,P010390,P012613,25.399,-9,43,52
16,PRS,P010390,P012640,2.316,3,4,1
16,PRS,P012608,P012609,8.649,-5,21,26
16,PRS,P012608,P012610,26.249,-13,45,58
16,PRS,P012608,P012613,27.082,-9,49,58
16,PRS,P012608,P012640,2.316,3,4,1
16,PRS,P012609,P012610,7.816,-9,17,26
16,PRS,P012609,P012613,8.649,-5,21,26
16,PRS,P012609,P012640,13.75,8,29,21
16,PRS,P012609,P013373,2.267,-1,3,4
16,PRS,P012610,P012613,26.249,-13,45,58
16,PRS,P012610,P012640,1.483,-1,0,1
16,PRS,P012613,P012640,2.316,3,4,1
16,PRS,P012640,P013373,2.267,-1,3,4
17,BAR,P000925,P002939,5.201,-7,5,12
17,BAR,P000925,P003478,8.834,4,18,14
17,BAR,P000925,P006435,8.55,4,15,11
17,BAR,P000925,P009862,18.201,6,33,27
17,BAR,P000925,P009992,0.3,2,2,0
17,BAR,P000925,P010106,5.084,5,13,8
17,BAR,P000925,P012745,18.518,4,33,29
17,BAR,P000925,P012795,9.384,-2,13,15
17,BAR,P002939,P003196,8.65,12,27,15
17,BAR,P002939,P003478,9.067,10,23,13
17,BAR,P002939,P006435,4.817,1,10,9
17,BAR,P002939,P006568,4.367,1,10,9
17,BAR,P002939,P009862,5.617,-4,7,11
17,BAR,P002939,P009992,8.117,9,25,16
17,BAR,P002939,P010106,0.317,-2,0,2
17,BAR,P002939,P012745,6.501,-6,8,14
17,BAR,P002939,P012795,9.801,-6,19,25
17,BAR,P002939,P013379,13.017,8,34,26
17,BAR,P003196,P003478,9.2,14,25,11
17,BAR,P003196,P006435,3.567,0,7,7
17,BAR,P003196,P009862,2.5,1,6,5
17,BAR,P003196,P009992,14.301,12,40,28
17,BAR,P003196,P010106,3.717,1,8,7
17,BAR,P003196,P012745,2.434,-2,4,6
17,BAR,P003196,P012795,4.517,-1,13,14
17,BAR,P003196,P013379,13.05,15,38,23
17,BAR,P003478,P006435,4.183,-1,8,9
17,BAR,P003478,P009862,9.817,3,21,18
17,BAR,P003478,P009992,9.85,12,25,13
17,BAR,P003478,P010106,6.417,6,15,9
17,BAR,P003478,P012745,11.134,-1,21,22
17,BAR,P003478,P013379,10.166,13,28,15
17,BAR,P006435,P006568,4.367,1,10,9
17,BAR,P006435,P009862,9.533,3,18,15
17,BAR,P006435,P009992,3.117,0,7,7
17,BAR,P006435,P012745,10.183,6,21,15
17,BAR,P006435,P012795,13.284,5,27,22
17,BAR,P006435,P013379,8.267,-3,17,20
17,BAR,P006568,P012745,0.65,3,3,0
17,BAR,P006568,P012795,4.367,1,10,9
17,BAR,P006568,P013379,3.717,-2,7,9
17,BAR,P009862,P009992,2.067,2,6,4
17,BAR,P009862,P010106,6.534,7,17,10
17,BAR,P009862,P012745,20.951,5,40,35
17,BAR,P009862,P012795,9.8,1,15,14
17,BAR,P009862,P013379,1.716,0,5,5
17,BAR,P009992,P010106,4.017,3,10,7
17,BAR,P009992,P012745,3.384,-2,6,8
17,BAR,P009992,P012795,3.334,-2,11,13
17,BAR,P009992,P013379,12.517,12,36,24
17,BAR,P010106,P012745,7.518,3,17,14
17,BAR,P010106,P012795,0.317,-2,0,2
17,BAR,P010106,P013379,1.283,3,4,1
17,BAR,P012745,P012795,10.034,1,16,15
17,BAR,P012745,P013379,1.633,-3,3,6
17,BAR,P012795,P013379,8.234,-3,20,23
17,BER,P006251,P006919,0.8,4,4,0
17,BER,P006251,P008062,3.05,-6,5,11
17,BER,P006251,P008173,1.767,0,4,4
17,BER,P006251,P008384,2.867,-10,3,13
17,BER,P006251,P008780,3.184,4,10,6
17,BER,P006251,P010791,2.517,4,8,4
17,BER,P006251,P011934,2.917,-10,3,13
17,BER,P006251,P012721,4.634,-10,7,17
17,BER,P006919,P007025,2.467,-2,3,5
17,BER,P006919,P008062,2.7,0,9,9
17,BER,P006919,P008173,21.1,-8,34,42
17,BER,P006919,P008780,21.333,-6,40,46
17,BER,P006919,P010791,13.766,0,27,27
17,BER,P006919,P011631,4.833,-3,10,13
17,BER,P006919,P011934,14.367,-8,21,29
17,BER,P006919,P012604,13.834,-9,24,33
17,BER,P007025,P008173,2.467,-2,3,5
17,BER,P007025,P011934,2.467,-2,3,5
17,BER,P007025,P012604,2.467,-2,3,5
17,BER,P008062,P008384,10.1,-12,17,29
17,BER,P008062,P008780,3.367,3,12,9
17,BER,P008062,P010791,11.067,3,28,25
17,BER,P008062,P011631,4.267,1,9,8
17,BER,P008062,P011934,2.4,-12,1,13
17,BER,P008062,P012604,6.15,-4,15,19
17,BER,P008062,P012721,10.767,-9,20,29
17,BER,P008173,P008780,23.45,-4,39,43
17,BER,P008173,P010791,13.65,0,24,24
17,BER,P008173,P011631,6.116,-3,10,13
17,BER,P008173,P011934,16.6,-6,23,29
17,BER,P008173,P012604,13.701,-3,23,26
17,BER,P008173,P012721,4.817,2,8,6
17,BER,P008384,P008780,0.617,0,2,2
17,BER,P008384,P010791,7.85,-2,16,18
17,BER,P008384,P011631,3.6,-2,6,8
17,BER,P008384,P011934,2.867,-10,3,13
17,BER,P008384,P012604,4.25,0,10,10
17,BER,P008384,P012721,10.717,-12,19,31
17,BER,P008780,P010791,16.867,5,36,31
17,BER,P008780,P011631,6.783,0,13,13
17,BER,P008780,P011934,14.9,-6,22,28
17,BER,P008780,P012604,13.134,-5,25,30
17,BER,P008780,P012721,6.101,5,13,8
17,BER,P010791,P011631,9.1,-2,19,21
17,BER,P010791,P011934,4.333,0,5,5
17,BER,P010791,P012604,8.767,1,20,19
17,BER,P010791,P012721,10.951,3,25,22
17,BER,P011631,P011934,1.283,0,0,0
17,BER,P011631,P012721,5.55,1,9,8
17,BER,P011934,P012604,11.084,-8,18,26
17,BER,P011934,P012721,5.25,-10,5,15
17,BER,P012604,P012721,6.017,2,14,12
18,OLY,P001255,P003469,5.333,-10,10,20
18,OLY,P001255,P007947,7.617,0,12,12
18,OLY,P001255,P007982,7.283,6,15,9
18,OLY,P001255,P008811,4.617,-2,7,9
18,OLY,P001255,P008829,14.233,7,29,22
18,OLY,P001255,P008855,7.433,-9,15,24
18,OLY,P001255,P009849,12.25,-5,19,24
18,OLY,P001255,P011194,8.616,-5,14,19
18,OLY,P001255,P012878,5.867,0,14,14
18,OLY,P001255,P013380,4.083,-2,13,15
18,OLY,P003469,P007853,1.8,-1,0,1
18,OLY,P003469,P007947,14.916,10,30,20
18,OLY,P003469,P007982,5.916,1,9,8
18,OLY,P003469,P008811,2.2,-3,4,7
18,OLY,P003469,P008829,0.233,2,2,0
18,OLY,P003469,P008855,17.166,-3,30,33
18,OLY,P003469,P009849,6.183,-11,7,18
18,OLY,P003469,P011194,4.582,-4,9,13
18,OLY,P003469,P012878,17.617,2,28,26
18,OLY,P003469,P013380,22.582,5,43,38
18,OLY,P007853,P007982,1.25,-1,0,1
18,OLY,P007853,P008855,0.55,0,0,0
18,OLY,P007853,P012878,1.8,-1,0,1
18,OLY,P007853,P013380,1.8,-1,0,1
18,OLY,P007947,P007982,5.017,13,15,2
18,OLY,P007947,P008811,5.817,-1,11,12
18,OLY,P007947,P008829,8.634,6,16,10
18,OLY,P007947,P008855,12.716,4,20,16
18,OLY,P007947,P009849,5.817,-1,11,12
18,OLY,P007947,P011194,3.366,0,7,7
18,OLY,P007947,P012878,14.367,17,28,11
18,OLY,P007947,P013380,15.933,16,34,18
18,OLY,P007982,P008811,0.65,-2,0,2
18,OLY,P007982,P008829,8.65,10,19,9
18,OLY,P007982,P009849,8.299,-1,13,14
18,OLY,P007982,P011194,6.499,-1,9,10
18,OLY,P007982,P012878,7.417,14,19,5
18,OLY,P007982,P013380,7.283,5,13,8
18,OLY,P008811,P008829,4.267,0,7,7
18,OLY,P008811,P009849,6.467,-3,11,14
18,OLY,P008811,P013380,1.85,-1,4,5
18,OLY,P008829,P008855,2.683,1,7,6
18,OLY,P008829,P009849,10.2,3,19,16
18,OLY,P008829,P011194,7.033,-2,11,13
18,OLY,P008829,P012878,4.067,11,13,2
18,OLY,P008829,P013380,2.4,6,9,3
18,OLY,P008855,P009849,2.267,-6,2,8
18,OLY,P008855,P011194,5.116,-5,11,16
18,OLY,P008855,P012878,14.267,-1,22,23
18,OLY,P008855,P013380,16.266,3,33,30
18,OLY,P009849,P011194,5.866,-3,7,10
18,OLY,P009849,P012878,4.05,-2,8,10
18,OLY,P009849,P013380,4.133,-3,7,10
18,OLY,P011194,P013380,5.382,-4,12,16
18,OLY,P012878,P013380,17.284,12,32,20
18,ZAL,P002329,P003048,15.349,-12,15,27
18,ZAL,P002329,P003210,3.416,-3,1,4
18,ZAL,P002329,P005504,0.333,-2,0,2
18,ZAL,P002329,P007029,12.116,-17,13,30
18,ZAL,P002329,P007513,13.666,-7,12,19
18,ZAL,P002329,P007975,14.949,-11,19,30
18,ZAL,P002329,P011051,7.483,-4,11,15
18,ZAL,P002329,P011925,2.167,-2,1,3
18,ZAL,P002329,P011983,7.099,-4,5,9
18,ZAL,P002329,P012622,6.55,-6,7,13
18,ZAL,P002676,P003048,5.917,8,18,10
18,ZAL,P002676,P003210,6.483,8,18,10
18,ZAL,P002676,P005504,9.217,-2,15,17
18,ZAL,P002676,P007029,12.867,14,40,26
18,ZAL,P002676,P007513,14.651,9,37,28
18,ZAL,P002676,P007975,7.984,8,27,19
18,ZAL,P002676,P011051,3.85,7,14,7
18,ZAL,P002676,P011925,4.517,-3,2,5
18,ZAL,P002676,P011983,10.45,3,17,14
18,ZAL,P003048,P003210,1.916,-2,0,2
18,ZAL,P003048,P007029,12.483,-4,22,26
18,ZAL,P003048,P007513,14.5,8,26,18
18,ZAL,P003048,P007975,17.633,-3,30,33
18,ZAL,P003048,P011051,2.383,-1,5,6
18,ZAL,P003048,P011925,3.067,-2,3,5
18,ZAL,P003048,P011983,5.266,-2,6,8
18,ZAL,P003048,P012622,6.55,-6,7,13
18,ZAL,P003210,P005504,3.0,-2,4,6
18,ZAL,P003210,P007029,7.199,1,15,14
18,ZAL,P003210,P007513,5.799,-1,9,10
18,ZAL,P003210,P007975,0.233,-2,0,2
18,ZAL,P003210,P011051,4.983,9,15,6
18,ZAL,P003210,P011983,7.266,6,14,8
18,ZAL,P003210,P012622,0.233,-2,0,2
18,ZAL,P005504,P007029,5.933,-1,15,16
18,ZAL,P005504,P007513,6.55,-2,11,13
18,ZAL,P005504,P007975,2.933,1,11,10
18,ZAL,P005504,P011925,3.617,-3,0,3
18,ZAL,P005504,P011983,6.617,-5,4,9
18,ZAL,P007029,P007513,13.767,1,34,33
18,ZAL,P007029,P007975,14.933,-5,35,40
18,ZAL,P007029,P011051,8.95,1,21,20
18,ZAL,P007029,P011925,3.067,-2,3,5
18,ZAL,P007029,P011983,6.733,0,12,12
18,ZAL,P007029,P012622,2.816,-8,2,10
18,ZAL,P007513,P007975,16.05,5,37,32
18,ZAL,P007513,P011051,7.267,-4,12,16
18,ZAL,P007513,P011925,5.334,-2,3,5
18,ZAL,P007513,P011983,12.416,-5,10,15
18,ZAL,P007513,P012622,4.2,-2,5,7
18,ZAL,P007975,P011051,4.75,-2,10,12
18,ZAL,P007975,P011925,1.35,-3,0,3
18,ZAL,P007975,P011983,5.066,0,8,8
18,ZAL,P007975,P012622,6.783,-8,7,15
18,ZAL,P011051,P011983,5.666,6,12,6
18,ZAL,P011925,P011983,3.617,-3,0,3
19,ASV,P000229,P002100,12.85,-14,17,31
19,ASV,P000229,P003526,14.017,12,37,25
19,ASV,P000229,P007027,15.083,17,42,25
19,ASV,P000229,P008991,7.8,-10,11,21
19,ASV,P000229,P010545,19.2,12,46,34
19,ASV,P000229,P011225,17.95,15,46,31
19,ASV,P000229,P013371,8.683,-16,9,25
19,ASV,P000229,P013372,0.15,-1,0,1
19,ASV,P000229,PKIR,13.399,-11,20,31
19,ASV,P002100,P003526,4.15,-8,6,14
19,ASV,P002100,P007027,3.3,-6,4,10
19,ASV,P002100,P008991,8.433,-14,13,27
19,ASV,P002100,P010545,7.55,-10,8,18
19,ASV,P002100,P011225,4.35,-1,8,9
19,ASV,P002100,P013371,9.166,-18,11,29
19,ASV,P002100,P013372,1.667,-5,0,5
19,ASV,P002100,PKIR,12.466,-20,17,37
19,ASV,P003526,P007027,25.234,6,55,49
19,ASV,P003526,P008991,0.633,-4,2,6
19,ASV,P003526,P010545,25.818,11,57,46
19,ASV,P003526,P011225,24.434,15,57,42
19,ASV,P003526,P013371,0.483,-2,2,4
19,ASV,P003526,P013372,9.534,0,18,18
19,ASV,P003526,PKIR,2.633,-6,2,8
19,ASV,P007027,P008991,0.15,-2,0,2
19,ASV,P007027,P010545,26.884,16,62,46
19,ASV,P007027,P011225,24.85,18,60,42
19,ASV,P007027,P013372,9.534,0,18,18
19,ASV,P007027,PKIR,4.233,3,7,4
19,ASV,P008991,P011225,1.05,0,2,2
19,ASV,P008991,P013371,7.233,-12,11,23
19,ASV,P008991,PKIR,8.433,-14,13,27
19,ASV,P010545,P011225,27.034,19,64,45
19,ASV,P010545,P013371,1.933,-6,0,6
19,ASV,P010545,P013372,9.384,1,18,17
19,ASV,P010545,PKIR,7.333,-3,9,12
19,ASV,P011225,P013372,7.867,5,18,13
19,ASV,P011225,PKIR,5.933,1,9,8
19,ASV,P013371,PKIR,9.166,-18,11,29
19,BER,P006251,P006919,1.7,-5,0,5
19,BER,P006251,P007025,12.0,17,36,19
19,BER,P006251,P008173,11.433,4,25,21
19,BER,P006251,P008780,2.8,14,17,3
19,BER,P006251,P011934,1.433,-3,0,3
19,BER,P006251,P012604,12.4,19,39,20
19,BER,P006251,P012721,13.566,18,39,21
19,BER,P006919,P007025,4.083,5,9,4
19,BER,P006919,P008173,13.349,-2,25,27
19,BER,P006919,P008384,13.267,-14,20,34
19,BER,P006919,P008780,21.583,-20,36,56
19,BER,P006919,P010791,13.5,-14,20,34
19,BER,P006919,P011934,20.983,-14,34,48
19,BER,P006919,P012604,8.966,7,20,13
19,BER,P006919,P012721,9.033,-7,16,23
19,BER,P007025,P008173,13.416,12,31,19
19,BER,P007025,P008780,2.883,10,14,4
19,BER,P007025,P011934,3.816,7,9,2
19,BER,P007025,P012604,15.333,26,45,19
19,BER,P007025,P012721,11.733,19,36,17
19,BER,P008173,P008780,8.716,-4,19,23
19,BER,P008173,P010791,0.233,0,0,0
19,BER,P008173,P011934,7.816,0,14,14
19,BER,P008173,P012604,18.599,16,45,29
19,BER,P008173,P012721,18.766,2,41,39
19,BER,P008384,P008780,14.517,-14,20,34
19,BER,P008384,P010791,14.517,-14,20,34
19,BER,P008384,P011934,14.417,-14,20,34
19,BER,P008384,P012604,0.1,0,0,0
19,BER,P008384,P012721,1.25,0,0,0
19,BER,P008780,P010791,14.75,-14,20,34
19,BER,P008780,P011934,17.467,-20,25,45
19,BER,P008780,P012604,8.166,14,28,14
19,BER,P008780,P012721,11.65,10,33,23
19,BER,P010791,P011934,14.417,-14,20,34
19,BER,P010791,P012604,0.333,0,0,0
19,BER,P010791,P012721,1.25,0,0,0
19,BER,P011934,P012604,3.333,9,9,0
19,BER,P011934,P012721,5.25,-7,5,12
19,BER,P012604,P012721,17.166,21,50,29
20,RED,P000848,P002553,8.617,2,16,14
20,RED,P000848,P004866,12.616,4,24,20
20,RED,P000848,P006436,6.934,-6,8,14
20,RED,P000848,P007960,5.384,6,15,9
20,RED,P000848,P009035,11.15,8,25,17
20,RED,P000848,P009048,7.25,10,19,9
20,RED,P000848,P012044,5.417,-2,10,12
20,RED,P000848,P012786,14.6,16,35,19
20,RED,P000848,PJDR,7.1,2,12,10
20,RED,P002553,P004007,0.2,0,0,0
20,RED,P002553,P004866,2.383,-3,2,5
20,RED,P002553,P006436,4.767,-1,7,8
20,RED,P002553,P007960,4.667,5,12,7
20,RED,P002553,P012044,2.8,-1,5,6
20,RED,P002553,P012786,6.017,3,11,8
20,RED,P002553,PJDR,5.817,3,11,8
20,RED,P004007,P004866,1.25,1,3,2
20,RED,P004007,P006436,0.2,0,0,0
20,RED,P004007,P007960,0.517,1,1,0
20,RED,P004007,P009035,1.733,-1,3,4
20,RED,P004007,P009048,1.416,-2,2,4
20,RED,P004007,P010612,1.416,-2,2,4
20,RED,P004007,P012786,1.0,-1,1,2
20,RED,P004866,P006436,5.967,-1,6,7
20,RED,P004866,P007960,0.317,1,1,0
20,RED,P004866,P009035,29.783,18,57,39
20,RED,P004866,P009048,26.05,20,53,33
20,RED,P004866,P010612,19.233,10,34,24
20,RED,P004866,P012044,2.133,-2,2,4
20,RED,P004866,P012786,25.266,16,51,35
20,RED,P004866,PJDR,3.666,-4,3,7
20,RED,P006436,P007960,3.0,-1,5,6
20,RED,P006436,P009035,5.967,-1,6,7
20,RED,P006436,P009048,4.384,3,6,3
20,RED,P006436,P010612,3.6,4,5,1
20,RED,P006436,P012044,4.383,-5,5,10
20,RED,P006436,P012786,1.967,0,2,2
20,RED,P006436,PJDR,1.767,0,2,2
20,RED,P007960,P009035,1.234,2,4,2
20,RED,P007960,P012044,3.717,0,8,8
20,RED,P007960,P012786,3.101,8,11,3
20,RED,P007960,PJDR,1.667,6,7,1
20,RED,P009035,P009048,26.533,18,53,35
20,RED,P009035,P010612,19.716,8,34,26
20,RED,P009035,P012044,3.05,-1,5,6
20,RED,P009035,P012786,24.283,18,52,34
20,RED,P009035,PJDR,1.283,-1,1,2
20,RED,P009048,P010612,19.283,8,34,26
20,RED,P009048,P012786,21.216,15,45,30
20,RED,P010612,P012044,0.433,0,0,0
20,RED,P010612,P012786,15.183,4,27,23
20,RED,P012044,P012786,1.467,3,5,2
20,RED,P012786,PJDR,7.1,2,12,10
20,ULK,P002849,P002968,4.533,-4,10,14
20,ULK,P002849,P002969,4.533,-4,10,14
20,ULK,P002849,P007182,3.316,-1,2,3
20,ULK,P002849,P008104,5.233,3,8,5
20,ULK,P002849,P008962,8.767,5,17,12
20,ULK,P002849,P009783,5.55,-2,14,16
20,ULK,P002849,P009863,14.799,-5,24,29
20,ULK,P002849,P010560,11.066,2,15,13
20,ULK,P002849,P011205,8.667,6,16,10
20,ULK,P002968,P002969,7.1,-9,12,21
20,ULK,P002968,P008104,5.466,-3,5,8
20,ULK,P002968,P008962,9.633,-5,12,17
20,ULK,P002968,P009783,12.432,-6,20,26
20,ULK,P002968,P009863,7.516,-3,15,18
20,ULK,P002968,P010560,3.4,-7,2,9
20,ULK,P002968,P011205,9.916,-7,12,19
20,ULK,P002969,P007182,1.0,-2,0,2
20,ULK,P002969,P008962,3.567,-7,2,9
20,ULK,P002969,P009783,4.533,-4,10,14
20,ULK,P002969,P009863,4.533,-4,10,14
20,ULK,P002969,P010560,3.567,-7,2,9
20,ULK,P002969,P011205,3.567,-7,2,9
20,ULK,P007182,P008104,1.883,2,2,0
20,ULK,P007182,P008962,7.65,0,11,11
20,ULK,P007182,P009783,5.15,-1,5,6
20,ULK,P007182,P009863,9.599,1,13,12
20,ULK,P007182,P010560,6.183,0,8,8
20,ULK,P007182,P011205,9.083,-3,11,14
20,ULK,P008104,P008962,13.25,-12,16,28
20,ULK,P008104,P009783,10.733,-15,10,25
20,ULK,P008104,P009863,9.233,-14,8,22
20,ULK,P008104,P010560,6.066,1,8,7
20,ULK,P008104,P011205,6.733,2,10,8
20,ULK,P008104,PLMG,5.267,-12,5,17
20,ULK,P008962,P009783,18.5,-11,24,35
20,ULK,P008962,P009863,21.483,-9,33,42
20,ULK,P008962,P010560,13.184,-1,21,22
20,ULK,P008962,P011205,23.967,4,39,35
20,ULK,P008962,PLMG,5.267,-12,5,17
20,ULK,P009783,P009863,18.583,-14,29,43
20,ULK,P009783,P010560,1.2,-2,0,2
20,ULK,P009783,P011205,13.516,-1,19,20
20,ULK,P009783,PLMG,5.267,-12,5,17
20,ULK,P009863,P010560,10.749,0,16,16
20,ULK,P009863,P011205,15.566,4,27,23
20,ULK,P009863,PLMG,5.267,-12,5,17
20,ULK,P010560,P011205,13.917,-2,20,22
21,MIL,P000796,P001392,4.367,7,13,6
21,MIL,P000796,P001518,9.25,3,22,19
21,MIL,P000796,P006085,18.517,-8,29,37
21,MIL,P000796,P006509,5.883,-9,5,14
21,MIL,P000796,P007831,24.7,-2,42,44
21,MIL,P000796,P008985,9.584,0,13,13
21,MIL,P000796,P008987,12.65,2,25,23
21,MIL,P000796,P013384,2.6,-3,2,5
21,MIL,P000796,P013385,8.167,-11,6,17
21,MIL,P000796,P013386,4.15,5,11,6
21,MIL,P001392,P001518,6.017,-12,8,20
21,MIL,P001392,P005670,1.75,0,4,4
21,MIL,P001392,P006085,8.384,-4,17,21
21,MIL,P001392,P007831,6.067,6,15,9
21,MIL,P001392,P008985,11.517,-1,26,27
21,MIL,P001392,P008987,15.018,-4,32,36
21,MIL,P001392,P013385,9.634,-10,16,26
21,MIL,P001392,P013386,2.25,-2,5,7
21,MIL,P001518,P005670,1.233,-1,2,3
21,MIL,P001518,P006085,14.0,2,30,28
21,MIL,P001518,P007831,10.3,1,25,24
21,MIL,P001518,P008985,4.15,-14,5,19
21,MIL,P001518,P008987,12.767,-16,22,38
21,MIL,P001518,P013384,1.833,-1,2,3
21,MIL,P001518,P013385,6.65,-13,8,21
21,MIL,P001518,P013386,6.4,3,16,13
21,MIL,P005670,P008985,1.75,0,4,4
21,MIL,P005670,P008987,0.517,1,2,1
21,MIL,P005670,P013385,1.75,0,4,4
21,MIL,P006085,P006509,5.883,-9,5,14
21,MIL,P006085,P007831,18.25,-6,29,35
21,MIL,P006085,P008985,6.784,-4,9,13
21,MIL,P006085,P008987,17.85,-8,31,39
21,MIL,P006085,P013384,1.833,-1,2,3
21,MIL,P006085,P013385,13.317,-16,16,32
21,MIL,P006085,P013386,5.45,10,16,6
21,MIL,P006509,P007831,5.883,-9,5,14
21,MIL,P006509,P008987,0.933,-1,1,2
21,MIL,P006509,P013385,4.95,-8,4,12
21,MIL,P007831,P008985,12.868,-7,18,25
21,MIL,P007831,P008987,15.667,-3,30,33
21,MIL,P007831,P013384,2.6,-3,2,5
21,MIL,P007831,P013385,11.451,-18,11,29
21,MIL,P007831,P013386,4.15,5,11,6
21,MIL,P008985,P008987,14.768,-10,27,37
21,MIL,P008985,P013384,2.6,-3,2,5
21,MIL,P008985,P013385,11.901,-10,20,30
21,MIL,P008985,P013386,0.95,-7,0,7
21,MIL,P008987,P013384,1.833,-1,2,3
21,MIL,P008987,P013385,11.551,-14,19,33
21,MIL,P008987,P013386,2.25,-2,5,7
21,MIL,P013384,P013385,4.433,-4,4,8
21,OLY,P001255,P003469,20.0,9,47,38
21,OLY,P001255,P007853,7.966,6,24,18
21,OLY,P001255,P007947,5.416,5,17,12
21,OLY,P001255,P008811,12.433,11,30,19
21,OLY,P001255,P008829,5.416,5,17,12
21,OLY,P001255,P008855,20.0,9,47,38
21,OLY,P001255,P011194,1.483,0,5,5
21,OLY,P001255,P012878,11.5,3,29,26
21,OLY,P001255,P013380,17.45,8,40,32
21,OLY,P003469,P007853,6.199,4,14,10
21,OLY,P003469,P007947,1.366,4,5,1
21,OLY,P003469,P008811,10.0,3,20,17
21,OLY,P003469,P008855,22.283,8,49,41
21,OLY,P003469,P009849,0.933,1,2,1
21,OLY,P003469,P011194,0.933,1,2,1
21,OLY,P003469,P012878,12.716,8,32,24
21,OLY,P003469,P013380,20.166,10,45,35
21,OLY,P007853,P007947,17.715,13,40,27
21,OLY,P007853,P008811,2.433,8,10,2
21,OLY,P007853,P008829,16.349,9,35,26
21,OLY,P007853,P008855,4.833,0,9,9
21,OLY,P007853,P009849,8.499,9,14,5
21,OLY,P007853,P010392,1.75,0,4,4
21,OLY,P007853,P011194,6.549,3,13,10
21,OLY,P007853,P012878,13.566,2,26,24
21,OLY,P007853,P013380,4.333,-2,7,9
21,OLY,P007947,P008811,2.433,8,10,2
21,OLY,P007947,P008829,16.349,9,35,26
21,OLY,P007947,P009849,8.499,9,14,5
21,OLY,P007947,P010392,1.75,0,4,4
21,OLY,P007947,P011194,6.549,3,13,10
21,OLY,P007947,P012878,8.733,2,17,15
21,OLY,P007947,P013380,2.05,-1,5,6
21,OLY,P008811,P008829,2.433,8,10,2
21,OLY,P008811,P008855,10.0,3,20,17
21,OLY,P008811,P013380,10.0,3,20,17
21,OLY,P008829,P009849,7.566,8,12,4
21,OLY,P008829,P010392,1.75,0,4,4
21,OLY,P008829,P011194,5.616,2,11,9
21,OLY,P008829,P012878,8.3,-1,14,15
21,OLY,P008829,P013380,1.617,-4,2,6
21,OLY,P008855,P012878,12.283,5,29,24
21,OLY,P008855,P013380,19.733,7,42,35
21,OLY,P009849,P011194,3.316,3,4,1
21,OLY,P009849,P012878,5.183,6,10,4
21,OLY,P010392,P011194,1.75,0,4,4
21,OLY,P012878,P013380,11.783,3,27,24
22,BAS,P004058,P008072,3.667,0,5,5
22,BAS,P004058,P011085,3.667,0,5,5
22,BAS,P004058,P012080,3.667,0,5,5
22,BAS,P004058,P012201,3.667,0,5,5
22,BAS,P007230,P008072,16.417,-2,29,31
22,BAS,P007230,P011085,0.05,0,0,0
22,BAS,P007230,P011196,7.517,-5,16,21
22,BAS,P007230,P011948,13.783,-2,30,32
22,BAS,P007230,P012058,12.35,-3,22,25
22,BAS,P007230,P012080,10.45,-1,19,20
22,BAS,P007230,P012201,11.75,-2,25,27
22,BAS,P007230,P012597,18.817,-2,41,43
22,BAS,P007230,P013367,5.266,-3,6,9
22,BAS,P008072,P011085,11.95,11,24,13
22,BAS,P008072,P011196,0.017,0,0,0
22,BAS,P008072,P011948,10.5,6,26,20
22,BAS,P008072,P012058,7.767,-2,12,14
22,BAS,P008072,P012080,17.767,3,27,24
22,BAS,P008072,P012201,20.55,11,41,30
22,BAS,P008072,P012597,12.184,3,25,22
22,BAS,P008072,P013367,12.449,6,23,17
22,BAS,P011085,P011196,0.633,0,0,0
22,BAS,P011085,P011948,2.833,5,8,3
22,BAS,P011085,P012058,2.167,-2,5,7
22,BAS,P011085,P012080,11.867,4,21,17
22,BAS,P011085,P012201,14.75,9,29,20
22,BAS,P011085,P012597,1.05,2,2,0
22,BAS,P011085,P013367,10.033,7,22,15
22,BAS,P011196,P011948,7.15,-5,10,15
22,BAS,P011196,P012058,4.6,-1,10,11
22,BAS,P011196,P012080,3.4,0,6,6
22,BAS,P011196,P012201,4.75,-4,6,10
22,BAS,P011196,P012597,8.083,-5,16,21
22,BAS,P011196,P013367,1.25,0,0,0
22,BAS,P011948,P012058,7.5,-5,15,20
22,BAS,P011948,P012080,1.383,2,2,0
22,BAS,P011948,P012201,10.316,8,23,15
22,BAS,P011948,P012597,14.349,0,30,30
22,BAS,P011948,P013367,3.45,3,8,5
22,BAS,P012058,P012080,7.017,0,12,12
22,BAS,P012058,P012201,2.167,-2,5,7
22,BAS,P012058,P012597,10.9,-3,20,23
22,BAS,P012058,P013367,3.6,-2,7,9
22,BAS,P012080,P012201,18.667,1,33,32
22,BAS,P012080,P012597,6.867,2,15,13
22,BAS,P012080,P013367,12.983,1,20,19
22,BAS,P012201,P012597,9.55,3,23,20
22,BAS,P012201,P013367,14.433,4,26,22
22,MAD,P003108,P003583,6.55,-7,7,14
22,MAD,P003108,P003733,5.3,-7,7,14
22,MAD,P003108,P005791,20.917,-3,40,43
22,MAD,P003108,P006540,22.317,-1,42,43
22,MAD,P003108,P009005,13.4,-9,22,31
22,MAD,P003108,P009213,14.284,1,27,26
22,MAD,P003108,P013378,7.5,-2,12,14
22,MAD,P003108,PTGB,20.2,-4,39,43
22,MAD,P003583,P003733,5.517,-7,7,14
22,MAD,P003583,P006540,1.3,0,0,0
22,MAD,P003583,P009005,6.817,-7,7,14
22,MAD,P003583,P009213,0.267,0,0,0
22,MAD,P003583,P013378,6.55,-7,7,14
22,MAD,P003583,PTGB,0.267,0,0,0
22,MAD,P003733,P005791,2.466,-4,2,6
22,MAD,P003733,P006540,1.433,-4,2,6
22,MAD,P003733,P009005,7.983,-11,9,20
22,MAD,P003733,P009213,2.733,-4,2,6
22,MAD,P003733,P013378,5.25,-7,7,14
22,MAD,P003733,PTGB,1.25,0,0,0
22,MAD,P005791,P006540,32.0,1,63,62
22,MAD,P005791,P009005,18.816,0,36,36
22,MAD,P005791,P009213,26.383,5,50,45
22,MAD,P005791,P013378,8.434,5,18,13
22,MAD,P005791,PTGB,23.116,0,43,43
22,MAD,P006540,P009005,19.233,2,38,36
22,MAD,P006540,P009213,25.367,5,50,45
22,MAD,P006540,P013378,9.867,7,20,13
22,MAD,P006540,PTGB,22.283,2,45,43
22,MAD,P009005,P009213,12.45,4,23,19
22,MAD,P009005,P013378,15.117,0,27,27
22,MAD,P009005,PTGB,9.316,1,18,17
22,MAD,P009213,P013378,7.617,2,15,13
22,MAD,P009213,PTGB,17.567,7,33,26
22,MAD,P013378,PTGB,0.133,2,2,0
23,PAN,P001926,P002328,4.35,-1,9,10
23,PAN,P001926,P003842,8.518,-4,16,20
23,PAN,P001926,P004088,6.117,-5,10,15
23,PAN,P001926,P005161,1.567,3,5,2
23,PAN,P001926,P005353,4.6,-6,8,14
23,PAN,P001926,P007866,5.884,-2,13,15
23,PAN,P001926,P009622,8.051,0,17,17
23,PAN,P001926,P011204,9.101,-4,18,22
23,PAN,P001926,P012712,6.317,-5,11,16
23,PAN,P001926,P012774,4.967,-4,9,13
23,PAN,P002328,P003842,13.133,0,22,22
23,PAN,P002328,P004088,1.933,4,9,5
23,PAN,P002328,P005161,5.333,4,13,9
23,PAN,P002328,P007866,9.167,4,17,13
23,PAN,P002328,P009622,3.35,0,7,7
23,PAN,P002328,P011204,12.383,6,27,21
23,PAN,P002328,P012712,0.133,1,4,3
23,PAN,P002328,P012774,13.15,6,28,22
23,PAN,P003842,P004088,8.584,-2,17,19
23,PAN,P003842,P005161,11.267,4,22,18
23,PAN,P003842,P007866,10.484,-3,17,20
23,PAN,P003842,P009622,12.535,3,29,26
23,PAN,P003842,P011204,24.785,1,48,47
23,PAN,P003842,P011209,0.55,0,2,2
23,PAN,P003842,P012712,9.951,6,23,17
23,PAN,P003842,P012774,19.601,3,36,33
23,PAN,P004088,P005161,1.083,1,2,1
23,PAN,P004088,P005353,2.483,-2,4,6
23,PAN,P004088,P007866,2.634,-2,6,8
23,PAN,P004088,P009622,6.2,-3,11,14
23,PAN,P004088,P011204,7.467,1,21,20
23,PAN,P004088,P012712,8.2,0,20,20
23,PAN,P004088,P012774,2.967,4,12,8
23,PAN,P005161,P009622,6.334,-2,12,14
23,PAN,P005161,P011204,7.917,4,15,11
23,PAN,P005161,P012712,2.95,2,4,2
23,PAN,P005161,P012774,8.617,0,15,15
23,PAN,P005353,P007866,1.917,-6,2,8
23,PAN,P005353,P009622,5.967,-10,10,20
23,PAN,P005353,P011204,3.5,-8,2,10
23,PAN,P005353,P011209,1.033,0,0,0
23,PAN,P005353,P012712,5.633,-6,8,14
23,PAN,P005353,P012774,5.067,-10,6,16
23,PAN,P007866,P009622,3.784,-4,7,11
23,PAN,P007866,P011204,14.868,-4,27,31
23,PAN,P007866,P012774,10.734,1,19,18
23,PAN,P009622,P011204,9.385,-4,21,25
23,PAN,P009622,P012712,8.384,-1,20,21
23,PAN,P009622,P012774,10.018,-7,22,29
23,PAN,P011204,P011209,1.583,0,2,2
23,PAN,P011204,P012712,9.95,4,24,20
23,PAN,P011204,P012774,22.601,0,43,43
23,PAN,P011209,P012712,1.583,0,2,2
23,PAN,P011209,P012774,1.583,0,2,2
23,PAN,P012712,P012774,9.767,3,24,21
23,PRS,P004197,P010390,11.7,-4,22,26
23,PRS,P004197,P012608,19.717,1,40,39
23,PRS,P004197,P012609,7.217,5,17,12
23,PRS,P004197,P012610,13.333,-7,24,31
23,PRS,P004197,P012612,7.2,5,18,13
23,PRS,P004197,P012613,18.884,4,39,35
23,PRS,P004197,P013373,0.817,0,0,0
23,PRS,P005793,P012608,0.75,2,2,0
23,PRS,P005793,P012609,13.333,12,29,17
23,PRS,P005793,P012610,3.0,-3,4,7
23,PRS,P005793,P012611,9.583,13,23,10
23,PRS,P005793,P012612,4.216,-1,10,11
23,PRS,P005793,P012613,0.55,3,3,0
23,PRS,P005793,P012640,13.333,12,29,17
23,PRS,P005793,P013373,8.567,10,16,6
23,PRS,P010390,P012608,18.55,-14,36,50
23,PRS,P010390,P012609,3.883,-10,6,16
23,PRS,P010390,P012610,18.55,-14,36,50
23,PRS,P010390,P012613,14.667,-4,30,34
23,PRS,P010390,P012640,6.85,-10,14,24
23,PRS,P012608,P012609,11.017,0,24,24
23,PRS,P012608,P012610,20.283,-16,39,55
23,PRS,P012608,P012611,0.1,1,1,0
23,PRS,P012608,P012612,7.2,5,18,13
23,PRS,P012608,P012613,22.784,2,49,47
23,PRS,P012608,P012640,7.7,-7,17,24
23,PRS,P012608,P013373,1.567,2,2,0
23,PRS,P012609,P012610,6.883,-13,10,23
23,PRS,P012609,P012611,9.583,13,23,10
23,PRS,P012609,P012612,9.783,7,26,19
23,PRS,P012609,P012613,6.934,11,19,8
23,PRS,P012609,P012640,16.383,5,34,29
23,PRS,P012609,P013373,9.384,10,16,6
23,PRS,P012610,P012611,0.1,1,1,0
23,PRS,P012610,P012612,2.916,-5,4,9
23,PRS,P012610,P012613,16.4,-6,33,39
23,PRS,P012610,P012640,9.95,-12,19,31
23,PRS,P012610,P013373,1.717,-1,2,3
23,PRS,P012611,P012612,2.933,1,8,7
23,PRS,P012611,P012613,0.65,4,4,0
23,PRS,P012611,P012640,9.683,14,24,10
23,PRS,P012611,P013373,6.1,9,12,3
23,PRS,P012612,P012613,7.2,5,18,13
23,PRS,P012612,P012640,4.216,-1,10,11
23,PRS,P012613,P012640,4.45,1,13,12
23,PRS,P012613,P013373,0.817,0,0,0
23,PRS,P012640,P013373,8.567,10,16,6
24,VIR,P001133,P001844,6.233,-4,6,10
24,VIR,P001133,P002084,4.699,-1,5,6
24,VIR,P001133,P004554,5.617,-2,8,10
24,VIR,P001133,P004888,26.717,3,50,47
24,VIR,P001133,P005738,4.167,-10,7,17
24,VIR,P001133,P006739,18.8,5,35,30
24,VIR,P001133,P009549,10.967,-1,16,17
24,VIR,P001133,P012585,5.15,-6,11,17
24,VIR,P001133,P012591,4.85,-2,8,10
24,VIR,P001133,P013374,13.967,14,31,17
24,VIR,P001133,PBCN,12.633,8,27,19
24,VIR,P001844,P002084,8.9,-2,12,14
24,VIR,P001844,P004554,4.384,-9,3,12
24,VIR,P001844,P004888,10.617,2,18,16
24,VIR,P001844,P006739,2.833,-3,5,8
24,VIR,P001844,P009549,9.45,-2,16,18
24,VIR,P001844,P012591,3.234,-6,3,9
24,VIR,P001844,P013374,6.284,0,13,13
24,VIR,P001844,PBCN,3.601,-12,0,12
24,VIR,P002084,P004554,1.367,-5,0,5
24,VIR,P002084,P004888,10.666,10,17,7
24,VIR,P002084,P006739,5.883,-1,7,8
24,VIR,P002084,P009549,8.117,-1,12,13
24,VIR,P002084,P013374,7.634,5,13,8
24,VIR,P002084,PBCN,7.534,-9,6,15
24,VIR,P004554,P004888,4.967,-2,8,10
24,VIR,P004554,P006739,2.6,2,5,3
24,VIR,P004554,P009549,2.134,-5,0,5
24,VIR,P004554,P012591,4.85,-2,8,10
24,VIR,P004554,PBCN,2.017,-5,0,5
24,VIR,P004888,P005738,4.167,-10,7,17
24,VIR,P004888,P006739,22.95,7,42,35
24,VIR,P004888,P009549,15.167,7,28,21
24,VIR,P004888,P012585,5.15,-6,11,17
24,VIR,P004888,P012591,4.417,-4,8,12
24,VIR,P004888,P013374,23.567,19,48,29
24,VIR,P004888,PBCN,16.883,6,31,25
24,VIR,P005738,P006739,0.65,-4,0,4
24,VIR,P005738,P009549,2.517,-4,6,10
24,VIR,P005738,P012585,4.167,-10,7,17
24,VIR,P005738,PBCN,1.0,-2,1,3
24,VIR,P006739,P009549,9.067,-1,12,13
24,VIR,P006739,P012585,0.65,-4,0,4
24,VIR,P006739,P012591,1.833,2,5,3
24,VIR,P006739,P013374,18.634,10,35,25
24,VIR,P006739,PBCN,13.9,7,26,19
24,VIR,P009549,P012585,2.517,-4,6,10
24,VIR,P009549,P013374,10.334,5,20,15
24,VIR,P009549,PBCN,2.534,-10,0,10
24,VIR,P012585,P013374,0.983,4,4,0
24,VIR,P012585,PBCN,1.983,2,5,3
24,VIR,P012591,P013374,0.217,-2,0,2
24,VIR,P012591,PBCN,0.867,-2,0,2
24,VIR,P013374,PBCN,14.984,5,28,23
24,ZAL,P002329,P002676,3.283,4,8,4
24,ZAL,P002329,P003048,12.383,-18,9,27
24,ZAL,P002329,P003210,2.783,-11,0,11
24,ZAL,P002329,P005504,6.567,-6,10,16
24,ZAL,P002329,P007029,10.617,-6,12,18
24,ZAL,P002329,P007513,24.116,-6,40,46
24,ZAL,P002329,P007975,17.884,4,39,35
24,ZAL,P002329,P011051,7.883,16,26,10
24,ZAL,P002329,P011983,12.983,-14,15,29
24,ZAL,P002329,P012622,8.833,5,21,16
24,ZAL,P002676,P003048,4.1,-2,2,4
24,ZAL,P002676,P003210,6.484,5,12,7
24,ZAL,P002676,P005504,8.15,10,21,11
24,ZAL,P002676,P007029,9.284,10,18,8
24,ZAL,P002676,P007513,9.533,5,20,15
24,ZAL,P002676,P007975,9.733,9,21,12
24,ZAL,P002676,P011051,4.2,7,11,4
24,ZAL,P002676,P011983,0.383,0,0,0
24,ZAL,P002676,P012622,10.65,12,23,11
24,ZAL,P003048,P003210,4.45,-4,1,5
24,ZAL,P003048,P007029,12.784,-9,11,20
24,ZAL,P003048,P007513,11.499,-19,5,24
24,ZAL,P003048,P007975,8.3,-12,7,19
24,ZAL,P003048,P011983,9.616,-13,9,22
24,ZAL,P003048,P012622,2.8,-3,0,3
24,ZAL,P003210,P005504,4.1,-5,8,13
24,ZAL,P003210,P007029,2.984,4,4,0
24,ZAL,P003210,P007513,7.0,-7,11,18
24,ZAL,P003210,P007975,1.2,1,1,0
24,ZAL,P003210,P011051,0.717,3,3,0
24,ZAL,P003210,P011983,1.85,-7,0,7
24,ZAL,P003210,P012622,5.5,-3,8,11
24,ZAL,P005504,P007029,5.117,7,13,6
24,ZAL,P005504,P007513,10.067,-5,18,23
24,ZAL,P005504,P007975,10.617,9,23,14
24,ZAL,P005504,P011983,2.75,-4,3,7
24,ZAL,P005504,P012622,11.5,10,28,18
24,ZAL,P007029,P007513,10.267,-4,11,15
24,ZAL,P007029,P007975,12.984,4,23,19
24,ZAL,P007029,P011051,2.0,6,6,0
24,ZAL,P007029,P011983,7.65,-5,9,14
24,ZAL,P007029,P012622,5.917,9,13,4
24,ZAL,P007513,P007975,17.0,3,35,32
24,ZAL,P007513,P011051,8.8,19,29,10
24,ZAL,P007513,P011983,10.649,-12,10,22
24,ZAL,P007513,P012622,12.533,6,29,23
24,ZAL,P007975,P011051,6.65,14,24,10
24,ZAL,P007975,P011983,6.583,-4,11,15
24,ZAL,P007975,P012622,11.317,16,32,16
24,ZAL,P011051,P011983,1.0,3,3,0
24,ZAL,P011051,P012622,3.95,8,14,6
26,MUN,P004508,P005460,5.966,9,18,9
26,MUN,P004508,P007056,23.666,-4,52,56
26,MUN,P004508,P007201,18.366,-5,39,44
26,MUN,P004508,P007639,1.05,-4,0,4
26,MUN,P004508,P010391,23.816,5,57,52
26,MUN,P004508,P011052,1.1,-3,0,3
26,MUN,P004508,P011224,17.482,-5,36,41
26,MUN,P004508,P011244,4.583,2,9,7
26,MUN,P004508,P011987,14.899,-3,33,36
26,MUN,P005460,P007056,2.95,3,9,6
26,MUN,P005460,P010391,5.6,8,17,9
26,MUN,P005460,P011224,7.966,9,17,8
26,MUN,P005460,P011244,7.966,9,17,8
26,MUN,P005460,P011987,8.266,7,18,11
26,MUN,P005460,P012123,4.95,3,8,5
26,MUN,P007056,P007201,19.216,-7,39,46
26,MUN,P007056,P010391,24.816,-1,55,56
26,MUN,P007056,P011052,1.1,-3,0,3
26,MUN,P007056,P011224,15.949,-9,30,39
26,MUN,P007056,P011244,2.2,0,3,3
26,MUN,P007056,P011987,14.899,-3,32,35
26,MUN,P007201,P010391,18.35,-2,39,41
26,MUN,P007201,P011052,0.583,-3,0,3
26,MUN,P007201,P011224,12.433,-7,23,30
26,MUN,P007201,P011987,7.916,-4,16,20
26,MUN,P007639,P011052,4.783,-7,6,13
26,MUN,P007639,P011224,1.05,-4,0,4
26,MUN,P007639,P011244,5.833,-11,6,17
26,MUN,P007639,P011987,5.833,-11,6,17
26,MUN,P007639,P012123,4.783,-7,6,13
26,MUN,P010391,P011224,18.316,-2,38,40
26,MUN,P010391,P011244,4.333,5,11,6
26,MUN,P010391,P011987,13.516,2,32,30
26,MUN,P010391,P012123,1.117,1,3,2
26,MUN,P011052,P011244,5.3,-7,6,13
26,MUN,P011052,P011987,5.883,-10,6,16
26,MUN,P011052,P012123,4.783,-7,6,13
26,MUN,P011224,P011244,10.699,5,20,15
26,MUN,P011224,P011987,11.015,-6,16,22
26,MUN,P011224,P012123,4.95,3,8,5
26,MUN,P011244,P011987,13.349,-7,18,25
26,MUN,P011244,P012123,9.733,-4,14,18
26,MUN,P011987,P012123,8.616,-5,11,16
26,PAR,P004761,P006591,11.985,5,26,21
26,PAR,P004761,P006760,21.068,5,49,44
26,PAR,P004761,P007632,0.267,0,0,0
26,PAR,P004761,P007870,10.967,1,24,23
26,PAR,P004761,P010781,16.001,3,36,33
26,PAR,P004761,P011050,0.267,0,0,0
26,PAR,P004761,P011981,10.901,3,26,23
26,PAR,P004761,P012720,11.768,-4,25,29
26,PAR,P004761,P013369,5.384,3,14,11
26,PAR,P006591,P006760,11.901,9,28,19
26,PAR,P006591,P007632,4.95,-3,5,8
26,PAR,P006591,P007870,4.217,4,12,8
26,PAR,P006591,P008232,13.667,2,27,25
26,PAR,P006591,P010781,8.401,6,23,17
26,PAR,P006591,P011050,7.2,-9,8,17
26,PAR,P006591,P011981,16.235,18,41,23
26,PAR,P006591,P012720,12.602,8,31,23
26,PAR,P006591,P013369,19.518,12,43,31
26,PAR,P006760,P007632,1.633,3,3,0
26,PAR,P006760,P007870,10.967,1,24,23
26,PAR,P006760,P010781,15.184,4,35,31
26,PAR,P006760,P011981,11.717,7,28,21
26,PAR,P006760,P012720,11.584,-3,24,27
26,PAR,P006760,P013369,6.75,6,17,11
26,PAR,P007632,P008232,5.216,-10,3,13
26,PAR,P007632,P011050,3.95,-6,2,8
26,PAR,P007632,P011981,3.166,-1,4,5
26,PAR,P007632,P012720,2.166,-4,1,5
26,PAR,P007632,P013369,7.116,-7,6,13
26,PAR,P007870,P008232,1.867,3,6,3
26,PAR,P007870,P010781,9.867,-2,21,23
26,PAR,P007870,P012720,10.484,3,24,21
26,PAR,P007870,P013369,2.967,6,9,3
26,PAR,P008232,P011050,6.933,-9,8,17
26,PAR,P008232,P011981,6.4,4,14,10
26,PAR,P008232,P012720,11.517,4,26,22
26,PAR,P008232,P013369,15.2,-2,28,30
26,PAR,P010781,P011981,7.151,8,20,12
26,PAR,P010781,P012720,10.451,2,24,22
26,PAR,P010781,P013369,1.017,3,5,2
26,PAR,P011050,P012720,3.25,-3,6,9
26,PAR,P011050,P013369,7.2,-9,8,17
26,PAR,P011981,P012720,11.184,3,26,23
26,PAR,P011981,P013369,13.05,10,33,23
26,PAR,P012720,P013369,14.734,6,37,31
27,IST,P004887,P006590,9.884,5,29,24
27,IST,P004887,P006640,1.567,-5,3,8
27,IST,P004887,P007109,7.001,-11,10,21
27,IST,P004887,P007200,21.799,11,61,50
27,IST,P004887,P009664,9.233,-3,23,26
27,IST,P004887,P011078,25.567,9,65,56
27,IST,P004887,P012710,17.433,14,46,32
27,IST,P004887,P013363,24.833,15,69,54
27,IST,P004887,P013364,3.551,-3,10,13
27,IST,P006590,P006640,7.233,-8,12,20
27,IST,P006590,P007109,7.467,-1,12,13
27,IST,P006590,P007200,3.433,3,12,9
27,IST,P006590,P009664,6.55,4,17,13
27,IST,P006590,P011078,7.384,6,17,11
27,IST,P006590,P012710,6.183,-2,14,16
27,IST,P006590,P012788,6.016,-4,10,14
27,IST,P006590,P013363,13.116,2,31,29
27,IST,P006590,P013364,4.934,-1,10,11
27,IST,P006640,P007109,5.05,-1,10,11
27,IST,P006640,P009664,0.35,-1,1,2
27,IST,P006640,P011078,0.35,-1,1,2
27,IST,P006640,P012710,2.183,-7,2,9
27,IST,P006640,P012788,6.016,-4,10,14
27,IST,P006640,P013363,2.916,-8,3,11
27,IST,P006640,P013364,4.667,-1,10,11
27,IST,P007109,P007200,5.784,-9,8,17
27,IST,P007109,P009664,5.6,-8,2,10
27,IST,P007109,P011078,8.051,-10,10,20
27,IST,P007109,P012710,1.617,-6,0,6
27,IST,P007109,P012788,3.833,3,8,5
27,IST,P007109,P013363,5.45,-8,2,10
27,IST,P007109,P013364,8.551,-5,18,23
27,IST,P007200,P009664,5.649,1,17,16
27,IST,P007200,P011078,18.75,5,49,44
27,IST,P007200,P012710,15.433,3,36,33
27,IST,P007200,P013363,18.932,10,53,43
27,IST,P007200,P013364,3.884,-4,8,12
27,IST,P009664,P011078,8.6,-6,15,21
27,IST,P009664,P013363,9.55,1,25,24
27,IST,P011078,P012710,17.434,11,44,33
27,IST,P011078,P013363,23.884,11,59,48
27,IST,P011078,P013364,2.384,-1,8,9
27,IST,P012710,P012788,2.183,-7,2,9
27,IST,P012710,P013363,20.916,3,48,45
27,IST,P012710,P013364,1.55,-5,0,5
27,IST,P012788,P013363,2.566,-7,2,9
27,IST,P012788,P013364,3.45,3,8,5
27,IST,P013363,P013364,1.233,-3,0,3
27,TEL,P004233,P006835,5.367,-7,9,16
27,TEL,P004233,P007990,0.1,-2,0,2
27,TEL,P004233,P011193,5.367,-7,9,16
27,TEL,P004233,P011219,5.267,-5,9,14
27,TEL,P004233,P013381,0.1,-2,0,2
27,TEL,P004233,P013382,5.267,-5,9,14
27,TEL,P005145,P006835,6.868,13,26,13
27,TEL,P005145,P007990,8.018,14,27,13
27,TEL,P005145,P011193,3.101,7,14,7
27,TEL,P005145,P011214,5.667,6,16,10
27,TEL,P005145,P011219,3.984,5,13,8
27,TEL,P005145,P013381,0.067,0,0,0
27,TEL,P005145,P013382,3.45,3,9,6
27,TEL,P005145,P013389,10.385,16,35,19
27,TEL,P006835,P007990,15.569,9,40,31
27,TEL,P006835,P011193,24.302,-8,59,67
27,TEL,P006835,P011214,15.901,0,33,33
27,TEL,P006835,P011219,22.668,-11,47,58
27,TEL,P006835,P013381,0.1,-2,0,2
27,TEL,P006835,P013382,27.235,-13,53,66
27,TEL,P006835,P013389,18.802,11,49,38
27,TEL,P007990,P011193,7.868,4,25,21
27,TEL,P007990,P011214,13.967,12,32,20
27,TEL,P007990,P011219,8.034,0,19,19
27,TEL,P007990,P013381,0.167,-2,0,2
27,TEL,P007990,P013382,16.701,4,36,32
27,TEL,P007990,P013389,15.052,13,37,24
27,TEL,P011193,P011214,10.817,-6,23,29
27,TEL,P011193,P011219,22.117,-9,47,56
27,TEL,P011193,P013381,0.167,-2,0,2
27,TEL,P011193,P013382,23.301,-12,50,62
27,TEL,P011193,P013389,8.968,5,29,24
27,TEL,P011214,P011219,8.233,-6,14,20
27,TEL,P011214,P013382,19.417,1,40,39
27,TEL,P011214,P013389,12.534,9,30,21
27,TEL,P011219,P013382,20.967,-15,39,54
27,TEL,P011219,P013389,8.534,1,20,19
27,TEL,P013381,P013389,0.067,0,0,0
27,TEL,P013382,P013389,15.534,1,32,31
25,BAR,P000925,P002939,9.217,4,18,14
25,BAR,P000925,P003196,5.55,5,14,9
25,BAR,P000925,P003478,1.717,2,2,0
25,BAR,P000925,P006435,9.883,4,22,18
25,BAR,P000925,P009862,9.017,8,20,12
25,BAR,P000925,P009992,11.833,1,24,23
25,BAR,P000925,P012745,11.75,11,28,17
25,BAR,P000925,P012795,10.083,0,20,20
25,BAR,P000925,P013379,7.35,-3,12,15
25,BAR,P002939,P003196,11.467,12,30,18
25,BAR,P002939,P003478,8.433,5,18,13
25,BAR,P002939,P009862,18.3,15,44,29
25,BAR,P002939,P009992,6.234,3,12,9
25,BAR,P002939,P012745,16.933,9,38,29
25,BAR,P002939,P012795,1.917,-2,0,2
25,BAR,P002939,P013379,8.367,6,16,10
25,BAR,P003196,P003478,5.85,6,15,9
25,BAR,P003196,P006435,4.483,8,14,6
25,BAR,P003196,P009862,16.434,13,42,29
25,BAR,P003196,P009992,2.567,4,8,4
25,BAR,P003196,P010106,4.45,3,12,9
25,BAR,P003196,P012745,15.067,7,36,29
25,BAR,P003196,P012795,4.45,3,12,9
25,BAR,P003196,P013379,3.35,11,13,2
25,BAR,P003478,P006435,4.217,5,9,4
25,BAR,P003478,P009862,12.65,10,27,17
25,BAR,P003478,P012745,12.65,10,27,17
25,BAR,P003478,P013379,5.083,2,10,8
25,BAR,P006435,P009862,4.217,5,9,4
25,BAR,P006435,P009992,8.799,-2,20,22
25,BAR,P006435,P010106,4.3,1,8,7
25,BAR,P006435,P012745,9.9,0,18,18
25,BAR,P006435,P012795,13.099,-1,28,29
25,BAR,P006435,P013379,10.366,-4,20,24
25,BAR,P009862,P009992,4.317,5,12,7
25,BAR,P009862,P010106,2.467,-2,5,7
25,BAR,P009862,P012745,23.617,12,52,40
25,BAR,P009862,P012795,2.467,-2,5,7
25,BAR,P009862,P013379,6.45,8,16,8
25,BAR,P009992,P012745,6.316,-2,14,16
25,BAR,P009992,P012795,10.716,-4,20,24
25,BAR,P009992,P013379,9.35,-1,18,19
25,BAR,P010106,P012745,4.784,-6,6,12
25,BAR,P010106,P012795,6.767,-1,13,14
25,BAR,P010106,P013379,4.3,1,8,7
25,BAR,P012745,P012795,8.15,-7,14,21
25,BAR,P012745,P013379,8.033,-6,11,17
25,BAR,P012795,P013379,12.283,-6,20,26
25,MCO,P002581,P005985,21.533,-18,33,51
25,MCO,P002581,P008099,5.167,4,14,10
25,MCO,P002581,P009754,22.1,-9,37,46
25,MCO,P002581,P011212,13.55,1,26,25
25,MCO,P002581,P011226,15.617,0,32,32
25,MCO,P002581,P011231,24.15,-11,42,53
25,MCO,P002581,P013365,0.45,2,2,0
25,MCO,P002581,PLCZ,10.833,-9,18,27
25,MCO,P005844,P005985,1.15,-3,0,3
25,MCO,P005844,P008099,8.334,-6,13,19
25,MCO,P005844,P009754,1.15,-3,0,3
25,MCO,P005844,P011212,9.484,-9,13,22
25,MCO,P005844,P011226,8.584,-6,13,19
25,MCO,P005844,P011231,5.617,-8,6,14
25,MCO,P005844,P013365,3.617,-1,7,8
25,MCO,P005985,P009754,21.6,-16,33,49
25,MCO,P005985,P011212,8.733,-10,11,21
25,MCO,P005985,P011226,10.35,-6,19,25
25,MCO,P005985,P011231,18.233,-22,24,46
25,MCO,P005985,P013365,0.85,0,3,3
25,MCO,P005985,PLCZ,11.683,-9,21,30
25,MCO,P008099,P011212,14.818,2,31,29
25,MCO,P008099,P011226,14.818,2,31,29
25,MCO,P008099,P011231,9.884,-1,20,21
25,MCO,P008099,P013365,4.934,3,11,8
25,MCO,P008099,PLCZ,1.317,4,4,0
25,MCO,P009754,P011212,8.45,-1,12,13
25,MCO,P009754,P011226,10.7,-4,18,22
25,MCO,P009754,P011231,18.8,-13,28,41
25,MCO,P009754,P013365,0.45,2,2,0
25,MCO,P009754,PLCZ,9.75,-4,18,22
25,MCO,P011212,P011226,17.118,4,36,32
25,MCO,P011212,P011231,17.8,-9,28,37
25,MCO,P011212,P013365,6.234,5,16,11
25,MCO,P011212,PLCZ,4.617,1,11,10
25,MCO,P011226,P011231,17.501,-4,33,37
25,MCO,P011226,P013365,5.784,3,14,11
25,MCO,P011226,PLCZ,5.0,3,12,9
25,MCO,P011231,P013365,0.45,2,2,0
25,MCO,P011231,PLCZ,6.633,-10,9,19
25,MCO,P013365,PLCZ,2.167,4,7,3
28,BER,P006251,P006919,10.733,4,30,26
28,BER,P006251,P008062,0.433,2,2,0
28,BER,P006251,P008173,11.55,6,32,26
28,BER,P006251,P008384,3.8,-5,4,9
28,BER,P006251,P008780,14.917,-1,34,35
28,BER,P006251,P011934,4.0,-5,11,16
28,BER,P006251,P012604,11.35,6,25,19
28,BER,P006251,P012721,4.617,-3,6,9
28,BER,P006919,P007025,9.233,2,17,15
28,BER,P006919,P008062,4.683,-3,9,12
28,BER,P006919,P008173,15.716,3,38,35
28,BER,P006919,P008384,0.633,-3,0,3
28,BER,P006919,P008780,20.899,5,46,41
28,BER,P006919,P010791,7.35,2,12,10
28,BER,P006919,P011934,12.983,-3,25,28
28,BER,P006919,P012604,17.215,3,36,33
28,BER,P006919,P012721,2.883,-2,7,9
28,BER,P007025,P008062,2.167,-2,2,4
28,BER,P007025,P008780,9.233,2,17,15
28,BER,P007025,P010791,9.517,0,14,14
28,BER,P007025,P011934,11.4,0,19,19
28,BER,P007025,P012604,1.883,0,5,5
28,BER,P007025,P012721,2.167,-2,2,4
28,BER,P008062,P008173,12.216,-4,17,21
28,BER,P008062,P008384,0.1,-3,0,3
28,BER,P008062,P010791,9.55,-6,10,16
28,BER,P008062,P011934,5.917,-8,2,10
28,BER,P008062,P012604,10.183,-4,17,21
28,BER,P008062,P012721,12.683,-8,17,25
28,BER,P008173,P008780,11.95,5,31,26
28,BER,P008173,P010791,7.383,-4,8,12
28,BER,P008173,P011934,5.4,-2,8,10
28,BER,P008173,P012604,21.216,1,41,40
28,BER,P008173,P012721,11.233,-1,17,18
28,BER,P008384,P008780,4.333,-5,4,9
28,BER,P008384,P011934,3.716,-8,4,12
28,BER,P008384,P012604,1.25,0,0,0
28,BER,P008384,P012721,3.9,-8,4,12
28,BER,P008780,P010791,7.35,2,12,10
28,BER,P008780,P011934,14.599,-2,29,31
28,BER,P008780,P012604,14.166,5,29,24
28,BER,P008780,P012721,4.617,-3,6,9
28,BER,P010791,P011934,11.55,0,14,14
28,BER,P010791,P012604,5.35,-4,8,12
28,BER,P010791,P012721,9.55,-6,10,16
28,BER,P011934,P012604,4.866,-2,6,8
28,BER,P011934,P012721,7.633,-10,6,16
28,BER,P012604,P012721,9.917,-1,17,18
28,ULK,P002849,P006961,16.349,-2,29,31
28,ULK,P002849,P007182,7.032,3,14,11
28,ULK,P002849,P008104,12.899,1,20,19
28,ULK,P002849,P008962,7.616,-6,18,24
28,ULK,P002849,P009783,2.416,0,5,5
28,ULK,P002849,P009863,9.782,-4,23,27
28,ULK,P002849,P010560,15.982,6,30,24
28,ULK,P002849,P011205,5.866,2,19,17
28,ULK,P002849,PLMG,6.45,4,10,6
28,ULK,P002968,P008962,6.533,-6,6,12
28,ULK,P002968,P009783,6.533,-6,6,12
28,ULK,P002968,P009863,6.533,-6,6,12
28,ULK,P002968,P011205,6.533,-6,6,12
28,ULK,P006961,P007182,5.982,2,9,7
28,ULK,P006961,P008104,14.466,5,23,18
28,ULK,P006961,P008962,12.199,1,31,30
28,ULK,P006961,P009783,3.549,3,10,7
28,ULK,P006961,P009863,11.132,0,28,28
28,ULK,P006961,P010560,12.666,8,22,14
28,ULK,P006961,P011205,6.233,5,22,17
28,ULK,P006961,PLMG,12.616,10,26,16
28,ULK,P007182,P008104,1.533,-2,0,2
28,ULK,P007182,P008962,0.833,-1,0,1
28,ULK,P007182,P009783,3.249,-1,5,6
28,ULK,P007182,P009863,3.249,-1,5,6
28,ULK,P007182,P010560,6.499,3,14,11
28,ULK,P007182,P011205,3.083,5,9,4
28,ULK,P008104,P008962,9.349,6,21,15
28,ULK,P008104,P009863,7.749,5,18,13
28,ULK,P008104,P010560,12.366,4,19,15
28,ULK,P008104,P011205,0.433,4,4,0
28,ULK,P008104,PLMG,10.533,9,19,10
28,ULK,P008962,P009783,14.466,-1,25,26
28,ULK,P008962,P009863,24.915,-1,51,52
28,ULK,P008962,P010560,4.383,2,9,7
28,ULK,P008962,P011205,14.683,-2,30,32
28,ULK,P008962,PLMG,11.083,8,25,17
28,ULK,P009783,P009863,16.882,-1,30,31
28,ULK,P009783,P010560,1.883,0,5,5
28,ULK,P009783,P011205,11.55,-1,18,19
28,ULK,P009783,PLMG,7.0,3,16,13
28,ULK,P009863,P010560,4.666,1,11,10
28,ULK,P009863,P011205,14.683,-2,30,32
28,ULK,P009863,PLMG,9.733,5,22,17
28,ULK,P010560,P011205,3.083,5,9,4
28,ULK,P010560,PLMG,7.8,7,13,6
28,ULK,P011205,PLMG,4.917,2,9,7
29,MIL,P000796,P001392,2.983,2,7,5
29,MIL,P000796,P001518,16.218,5,34,29
29,MIL,P000796,P006085,21.551,-3,41,44
29,MIL,P000796,P006509,8.866,1,23,22
29,MIL,P000796,P007831,25.501,2,53,51
29,MIL,P000796,P008985,15.367,-3,37,40
29,MIL,P000796,P008987,21.6,1,44,43
29,MIL,P000796,P013384,6.05,6,17,11
29,MIL,P000796,P013385,3.083,8,10,2
29,MIL,P000796,P013386,3.717,5,10,5
29,MIL,P001392,P006085,4.516,2,9,7
29,MIL,P001392,P007831,4.516,2,9,7
29,MIL,P001392,P008987,3.466,-2,5,7
29,MIL,P001392,P013386,2.583,4,6,2
29,MIL,P001518,P006085,12.334,-5,21,26
29,MIL,P001518,P006509,5.234,-5,8,13
29,MIL,P001518,P007831,14.301,3,28,25
29,MIL,P001518,P008985,9.434,-8,19,27
29,MIL,P001518,P008987,15.067,4,30,26
29,MIL,P001518,P013384,2.067,-1,2,3
29,MIL,P001518,P013385,1.417,-1,2,3
29,MIL,P006085,P006509,3.95,-4,8,12
29,MIL,P006085,P007831,22.117,-5,39,44
29,MIL,P006085,P008985,6.417,-18,9,27
29,MIL,P006085,P008987,18.399,-7,31,38
29,MIL,P006085,P013384,1.834,-1,4,5
29,MIL,P006085,P013386,4.15,5,10,5
29,MIL,P006509,P007831,4.45,-1,11,12
29,MIL,P006509,P008985,13.117,-2,30,32
29,MIL,P006509,P008987,8.617,-4,17,21
29,MIL,P006509,P013384,8.3,2,18,16
29,MIL,P006509,P013385,8.934,5,21,16
29,MIL,P007831,P008985,11.684,-11,25,36
29,MIL,P007831,P008987,24.233,-3,48,51
29,MIL,P007831,P013384,2.967,-2,7,9
29,MIL,P007831,P013385,1.317,2,4,2
29,MIL,P007831,P013386,5.25,5,12,7
29,MIL,P008985,P008987,14.684,-11,29,40
29,MIL,P008985,P013384,9.667,0,20,20
29,MIL,P008985,P013385,8.934,5,21,16
29,MIL,P008985,P013386,1.1,0,2,2
29,MIL,P008987,P013384,3.767,-4,5,9
29,MIL,P008987,P013385,4.434,-2,9,11
29,MIL,P008987,P013386,1.533,0,2,2
29,MIL,P013384,P013385,7.617,3,17,14
29,MIL,P013384,P013386,2.667,1,6,5
29,ZAL,P002329,P002676,7.283,-1,11,12
29,ZAL,P002329,P003048,5.416,-1,7,8
29,ZAL,P002329,P003210,3.766,-5,6,11
29,ZAL,P002329,P005504,7.467,0,16,16
29,ZAL,P002329,P007029,15.816,11,42,31
29,ZAL,P002329,P007513,26.849,4,57,53
29,ZAL,P002329,P007975,15.217,6,33,27
29,ZAL,P002329,P011051,15.033,3,36,33
29,ZAL,P002329,P011983,1.067,-2,2,4
29,ZAL,P002329,P012622,13.75,-7,26,33
29,ZAL,P002676,P003048,4.783,-8,5,13
29,ZAL,P002676,P003210,2.934,-4,4,8
29,ZAL,P002676,P005504,4.05,-8,3,11
29,ZAL,P002676,P007029,3.05,-1,6,7
29,ZAL,P002676,P007513,12.683,-1,23,24
29,ZAL,P002676,P007975,10.116,-11,10,21
29,ZAL,P002676,P011051,6.8,7,16,9
29,ZAL,P002676,P011983,2.95,-8,1,9
29,ZAL,P002676,P012622,7.883,-1,17,18
29,ZAL,P003048,P003210,4.15,-5,5,10
29,ZAL,P003048,P007029,2.133,3,5,2
29,ZAL,P003048,P007513,8.866,-6,12,18
29,ZAL,P003048,P007975,2.583,-4,2,6
29,ZAL,P003048,P012622,7.533,-3,12,15
29,ZAL,P003210,P005504,2.734,9,11,2
29,ZAL,P003210,P007029,4.084,9,14,5
29,ZAL,P003210,P007513,8.85,-4,17,21
29,ZAL,P003210,P007975,1.634,4,6,2
29,ZAL,P003210,P011051,3.5,-4,7,11
29,ZAL,P003210,P012622,8.617,-1,19,20
29,ZAL,P003210,P012715,1.467,1,3,2
29,ZAL,P005504,P007029,11.734,6,28,22
29,ZAL,P005504,P007513,8.65,7,21,14
29,ZAL,P005504,P007975,13.101,-4,25,29
29,ZAL,P005504,P011983,4.017,-10,3,13
29,ZAL,P005504,P012622,3.834,3,10,7
29,ZAL,P005504,P012715,1.417,1,3,2
29,ZAL,P007029,P007513,17.749,23,52,29
29,ZAL,P007029,P007975,12.734,11,35,24
29,ZAL,P007029,P011051,8.683,10,28,18
29,ZAL,P007029,P011983,3.267,-8,3,11
29,ZAL,P007029,P012622,9.683,11,28,17
29,ZAL,P007029,P012715,1.467,1,3,2
29,ZAL,P007513,P007975,16.133,8,35,27
29,ZAL,P007513,P011051,16.833,8,43,35
29,ZAL,P007513,P012622,20.933,-3,44,47
29,ZAL,P007513,P012715,0.05,0,0,0
29,ZAL,P007975,P011051,6.0,10,17,7
29,ZAL,P007975,P011983,4.017,-10,3,13
29,ZAL,P007975,P012622,3.934,-3,7,10
29,ZAL,P007975,P012715,1.467,1,3,2
29,ZAL,P011051,P012622,10.483,-2,25,27
29,ZAL,P011983,P012622,0.75,-2,0,2
30,MUN,P004508,P007056,20.533,-1,52,53
30,MUN,P004508,P007201,18.866,-4,48,52
30,MUN,P004508,P010391,18.2,-1,45,46
30,MUN,P004508,P011052,2.4,-1,6,7
30,MUN,P004508,P011224,9.1,2,29,27
30,MUN,P004508,P011244,7.9,-1,18,19
30,MUN,P004508,P011987,14.6,1,36,35
30,MUN,P004508,P012123,1.333,-3,2,5
30,MUN,P005460,P007201,0.3,1,3,2
30,MUN,P005460,P010391,3.6,5,11,6
30,MUN,P005460,P011052,7.133,3,24,21
30,MUN,P005460,P011224,11.033,9,38,29
30,MUN,P005460,P011244,11.033,9,38,29
30,MUN,P005460,P011987,11.033,9,38,29
30,MUN,P007056,P007201,16.583,1,45,44
30,MUN,P007056,P010391,22.601,-4,55,59
30,MUN,P007056,P011052,4.7,-2,9,11
30,MUN,P007056,P011224,12.717,0,36,36
30,MUN,P007056,P011244,10.517,-9,19,28
30,MUN,P007056,P011987,16.084,-6,38,44
30,MUN,P007056,P012123,1.333,-3,2,5
30,MUN,P007201,P010391,15.833,6,45,39
30,MUN,P007201,P011052,2.4,-1,6,7
30,MUN,P007201,P011224,6.317,3,25,22
30,MUN,P007201,P011244,4.333,-3,12,15
30,MUN,P007201,P011987,12.367,4,34,30
30,MUN,P007201,P012123,1.333,-3,2,5
30,MUN,P010391,P011052,3.95,2,9,7
30,MUN,P010391,P011224,13.984,4,40,36
30,MUN,P010391,P011244,11.034,0,23,23
30,MUN,P010391,P011987,17.934,0,44,44
30,MUN,P011052,P011224,9.433,2,27,25
30,MUN,P011052,P011244,9.433,2,27,25
30,MUN,P011052,P011987,7.883,-1,24,25
30,MUN,P011224,P011244,21.467,2,60,58
30,MUN,P011224,P011987,19.417,2,61,59
30,MUN,P011244,P011987,19.95,-1,57,58
30,MUN,P011244,P012123,1.333,-3,2,5
30,PRS,P004197,P010390,13.367,-10,25,35
30,PRS,P004197,P012608,17.083,-7,35,42
30,PRS,P004197,P012609,2.383,2,5,3
30,PRS,P004197,P012610,14.7,-9,30,39
30,PRS,P004197,P012612,2.383,2,5,3
30,PRS,P004197,P012613,17.083,-7,35,42
30,PRS,P004197,P013373,1.333,1,5,4
30,PRS,P005793,P010390,0.0,0,0,0
30,PRS,P005793,P012608,0.733,2,2,0
30,PRS,P005793,P012609,13.167,-2,37,39
30,PRS,P005793,P012610,2.6,5,12,7
30,PRS,P005793,P012611,11.267,-1,31,32
30,PRS,P005793,P012612,4.367,-3,8,11
30,PRS,P005793,P012613,0.0,0,0,0
30,PRS,P005793,P012640,12.784,-1,38,39
30,PRS,P005793,P013373,9.15,4,32,28
30,PRS,P010390,P012608,15.767,-8,32,40
30,PRS,P010390,P012609,2.1,3,5,2
30,PRS,P010390,P012610,15.3,-8,30,38
30,PRS,P010390,P012611,0.467,0,2,2
30,PRS,P010390,P012612,0.0,0,0,0
30,PRS,P010390,P012613,15.767,-8,32,40
30,PRS,P010390,P012640,0.3,-1,2,3
30,PRS,P012608,P012609,10.482,9,31,22
30,PRS,P012608,P012610,24.365,-3,62,65
30,PRS,P012608,P012611,0.467,0,2,2
30,PRS,P012608,P012612,2.383,2,5,3
30,PRS,P012608,P012613,26.482,-3,67,70
30,PRS,P012608,P012640,4.016,2,19,17
30,PRS,P012608,P013373,7.082,2,21,19
30,PRS,P012609,P012610,9.149,7,31,24
30,PRS,P012609,P012611,11.384,-4,30,34
30,PRS,P012609,P012612,6.75,-1,13,14
30,PRS,P012609,P012613,9.749,7,29,22
30,PRS,P012609,P012640,14.417,-1,46,47
30,PRS,P012609,P013373,12.083,0,37,37
30,PRS,P012610,P012611,0.35,3,3,0
30,PRS,P012610,P012613,23.632,-5,60,65
30,PRS,P012610,P012640,5.883,5,29,24
30,PRS,P012610,P013373,8.949,5,31,26
30,PRS,P012611,P012612,4.367,-3,8,11
30,PRS,P012611,P012613,0.467,0,2,2
30,PRS,P012611,P012640,11.267,-1,31,32
30,PRS,P012611,P013373,6.9,2,23,21
30,PRS,P012612,P012613,2.383,2,5,3
30,PRS,P012612,P012640,4.367,-3,8,11
30,PRS,P012613,P012640,4.016,2,19,17
30,PRS,P012613,P013373,6.349,0,19,19
30,PRS,P012640,P013373,10.15,2,36,34
31,MAD,P003108,P003583,9.317,-5,14,19
31,MAD,P003108,P003733,0.05,1,1,0
31,MAD,P003108,P005791,11.45,-9,22,31
31,MAD,P003108,P005928,12.5,-8,24,32
31,MAD,P003108,P006540,3.867,-4,7,11
31,MAD,P003108,P009005,18.25,-10,32,42
31,MAD,P003108,P009213,2.267,0,6,6
31,MAD,P003108,P011649,2.667,0,5,5
31,MAD,P003108,P013378,7.733,-3,12,15
31,MAD,P003108,PTGB,15.167,-14,25,39
31,MAD,P003583,P005928,8.55,-1,17,18
31,MAD,P003583,P006540,1.333,1,3,2
31,MAD,P003583,P009005,10.65,-4,17,21
31,MAD,P003583,P011649,2.617,0,5,5
31,MAD,P003583,P013378,3.95,-1,4,5
31,MAD,P003583,PTGB,6.183,-6,8,14
31,MAD,P003733,P005791,13.934,18,41,23
31,MAD,P003733,P005928,13.984,19,42,23
31,MAD,P003733,P006540,13.934,18,41,23
31,MAD,P003733,P009005,2.667,-2,7,9
31,MAD,P003733,P009213,11.367,22,36,14
31,MAD,P005791,P005928,23.084,9,59,50
31,MAD,P005791,P006540,21.718,12,57,45
31,MAD,P005791,P009005,12.767,-9,25,34
31,MAD,P005791,P009213,16.184,18,47,29
31,MAD,P005791,P011649,3.967,-2,9,11
31,MAD,P005791,P013378,3.783,-2,8,10
31,MAD,P005791,PTGB,10.317,-7,20,27
31,MAD,P005928,P006540,20.617,13,55,42
31,MAD,P005928,P009005,16.967,-7,35,42
31,MAD,P005928,P009213,14.417,19,43,24
31,MAD,P005928,P011649,6.584,-2,14,16
31,MAD,P005928,P013378,1.85,2,4,2
31,MAD,P005928,PTGB,8.183,-8,15,23
31,MAD,P006540,P009005,6.917,-4,13,17
31,MAD,P006540,P009213,15.784,19,47,28
31,MAD,P006540,P011649,3.917,-2,9,11
31,MAD,P006540,PTGB,4.117,-1,8,9
31,MAD,P009005,P009213,0.05,1,1,0
31,MAD,P009005,P011649,3.934,0,7,7
31,MAD,P009005,P013378,7.733,-3,12,15
31,MAD,P009005,PTGB,13.933,-10,23,33
31,MAD,P009213,P011649,2.65,-2,7,9
31,MAD,P009213,PTGB,2.217,-1,5,6
31,MAD,P013378,PTGB,5.883,-5,8,13
31,PAN,P001926,P003842,9.333,1,23,22
31,PAN,P001926,P004088,8.933,4,25,21
31,PAN,P001926,P005161,15.4,-4,29,33
31,PAN,P001926,P005353,15.0,-1,31,32
31,PAN,P001926,P007866,6.933,8,22,14
31,PAN,P001926,P011204,11.2,-6,18,24
31,PAN,P001926,P012712,17.4,-8,32,40
31,PAN,P001926,P012774,13.133,6,36,30
31,PAN,P002328,P003842,1.3,3,3,0
31,PAN,P002328,P007866,1.1,2,4,2
31,PAN,P002328,P011204,2.4,5,7,2
31,PAN,P002328,P012712,2.4,5,7,2
31,PAN,P002328,P012774,2.4,5,7,2
31,PAN,P003842,P004088,7.333,-4,15,19
31,PAN,P003842,P005161,15.133,-3,33,36
31,PAN,P003842,P007866,3.65,-11,3,14
31,PAN,P003842,P009622,3.65,-11,3,14
31,PAN,P003842,P011204,15.916,5,37,32
31,PAN,P003842,P012712,20.116,7,48,41
31,PAN,P003842,P012774,18.633,-3,39,42
31,PAN,P004088,P005353,8.933,4,25,21
31,PAN,P004088,P007866,10.583,-3,25,28
31,PAN,P004088,P009622,3.65,-11,3,14
31,PAN,P004088,P011204,3.683,7,12,5
31,PAN,P004088,P012712,5.683,3,15,12
31,PAN,P004088,P012774,16.266,0,40,40
31,PAN,P005161,P005353,6.067,-5,6,11
31,PAN,P005161,P007866,0.133,-1,0,1
31,PAN,P005161,P011204,17.133,-11,28,39
31,PAN,P005161,P012712,21.333,-9,39,48
31,PAN,P005161,P012774,10.133,-3,21,24
31,PAN,P005353,P007866,6.933,8,22,14
31,PAN,P005353,P011204,6.067,-5,6,11
31,PAN,P005353,P012712,8.067,-9,9,18
31,PAN,P005353,P012774,8.933,4,25,21
31,PAN,P007866,P009622,3.65,-11,3,14
31,PAN,P007866,P011204,1.233,1,4,3
31,PAN,P007866,P012712,1.233,1,4,3
31,PAN,P007866,P012774,11.816,-2,29,31
31,PAN,P009622,P012774,3.65,-11,3,14
31,PAN,P011204,P012712,23.216,1,47,46
31,PAN,P011204,P012774,12.016,7,29,22
31,PAN,P012712,P012774,18.216,5,43,38
32,PAR,P004761,P006591,5.2,4,13,9
32,PAR,P004761,P006760,9.933,-2,25,27
32,PAR,P004761,P007870,3.8,-2,12,14
32,PAR,P004761,P010781,9.933,-2,25,27
32,PAR,P004761,P011981,6.133,0,13,13
32,PAR,P004761,P012720,4.733,-6,12,18
32,PAR,P006591,P006760,13.65,4,26,22
32,PAR,P006591,P007632,2.767,-2,2,4
32,PAR,P006591,P007870,8.134,-2,13,15
32,PAR,P006591,P008232,8.867,8,19,11
32,PAR,P006591,P010781,14.367,9,33,24
32,PAR,P006591,P011981,19.733,6,42,36
32,PAR,P006591,P012720,12.133,0,20,20
32,PAR,P006591,P013369,16.617,9,36,27
32,PAR,P006760,P007870,14.134,3,36,33
32,PAR,P006760,P010781,19.25,1,46,45
32,PAR,P006760,P011981,10.066,-2,18,20
32,PAR,P006760,P012720,16.283,-5,36,41
32,PAR,P006760,P013369,13.484,5,29,24
32,PAR,P007632,P007870,1.0,-4,0,4
32,PAR,P007632,P008232,1.767,2,2,0
32,PAR,P007632,P010781,2.767,-2,2,4
32,PAR,P007632,P011981,2.767,-2,2,4
32,PAR,P007870,P008232,3.117,4,6,2
32,PAR,P007870,P010781,12.617,0,33,33
32,PAR,P007870,P011981,2.5,-5,4,9
32,PAR,P007870,P012720,18.751,6,46,40
32,PAR,P007870,P013369,14.951,8,34,26
32,PAR,P008232,P010781,8.4,13,25,12
32,PAR,P008232,P011981,9.833,10,25,15
32,PAR,P008232,P012720,8.633,7,18,11
32,PAR,P008232,P013369,11.183,12,29,17
32,PAR,P010781,P011981,17.383,8,40,32
32,PAR,P010781,P012720,15.766,3,42,39
32,PAR,P010781,P013369,15.517,18,46,28
32,PAR,P011981,P012720,9.515,-4,18,22
32,PAR,P011981,P013369,13.066,9,34,25
32,PAR,P012720,P013369,21.25,11,48,37
32,TEL,P004233,P005145,1.633,4,4,0
32,TEL,P004233,P011193,0.433,2,2,0
32,TEL,P004233,P011214,1.633,4,4,0
32,TEL,P004233,P013381,1.2,2,2,0
32,TEL,P004233,P013389,1.633,4,4,0
32,TEL,P005145,P006835,5.016,-3,11,14
32,TEL,P005145,P007990,5.216,4,13,9
32,TEL,P005145,P011193,5.199,3,8,5
32,TEL,P005145,P011214,6.849,8,17,9
32,TEL,P005145,P011219,2.283,-3,2,5
32,TEL,P005145,P013381,1.2,2,2,0
32,TEL,P005145,P013382,2.483,4,4,0
32,TEL,P005145,P013389,6.649,1,15,14
32,TEL,P006835,P007855,0.183,2,2,0
32,TEL,P006835,P007990,14.282,-5,31,36
32,TEL,P006835,P011193,22.733,-7,45,52
32,TEL,P006835,P011214,10.666,0,28,28
32,TEL,P006835,P011219,19.883,0,41,41
32,TEL,P006835,P013381,0.6,0,2,2
32,TEL,P006835,P013382,20.699,-4,44,48
32,TEL,P006835,P013389,14.466,-11,28,39
32,TEL,P007855,P007990,2.367,-5,4,9
32,TEL,P007855,P011214,2.367,-5,4,9
32,TEL,P007855,P013381,0.183,2,2,0
32,TEL,P007855,P013382,2.55,-3,6,9
32,TEL,P007855,P013389,2.55,-3,6,9
32,TEL,P007990,P011193,15.982,-5,26,31
32,TEL,P007990,P011214,12.499,-9,21,30
32,TEL,P007990,P011219,12.166,-6,20,26
32,TEL,P007990,P013382,19.832,-12,32,44
32,TEL,P007990,P013389,7.916,-10,17,27
32,TEL,P011193,P011214,15.749,0,32,32
32,TEL,P011193,P011219,26.266,-8,50,58
32,TEL,P011193,P013381,0.417,-2,0,2
32,TEL,P011193,P013382,27.899,-8,53,61
32,TEL,P011193,P013389,13.45,-11,24,35
32,TEL,P011214,P011219,11.733,-4,24,28
32,TEL,P011214,P013381,1.2,2,2,0
32,TEL,P011214,P013382,17.749,-9,33,42
32,TEL,P011214,P013389,13.683,-7,31,38
32,TEL,P011219,P013382,22.566,-5,45,50
32,TEL,P011219,P013389,10.167,-6,18,24
32,TEL,P013381,P013382,0.6,0,2,2
32,TEL,P013381,P013389,1.8,2,4,2
32,TEL,P013382,P013389,13.35,-15,25,40
33,MCO,P002581,P005844,0.017,2,2,0
33,MCO,P002581,P005985,18.883,19,52,33
33,MCO,P002581,P008099,18.667,15,49,34
33,MCO,P002581,P008161,2.517,-4,7,11
33,MCO,P002581,P009754,7.617,5,23,18
33,MCO,P002581,P011212,9.533,8,31,23
33,MCO,P002581,P011226,16.532,23,42,19
33,MCO,P002581,P013365,4.666,3,9,6
33,MCO,P002581,PLCZ,19.9,17,57,40
33,MCO,P005844,P005985,7.333,-1,18,19
33,MCO,P005844,P008099,1.65,1,7,6
33,MCO,P005844,P009754,13.8,-3,30,33
33,MCO,P005844,P011212,13.783,-5,28,33
33,MCO,P005844,P011226,9.733,-4,22,26
33,MCO,P005844,P013365,12.316,0,31,31
33,MCO,P005844,PLCZ,3.1,-6,2,8
33,MCO,P005985,P008099,15.033,11,38,27
33,MCO,P005985,P009754,11.217,1,30,29
33,MCO,P005985,P011212,11.166,5,30,25
33,MCO,P005985,P011226,14.982,15,38,23
33,MCO,P005985,P013365,8.049,8,23,15
33,MCO,P005985,PLCZ,18.133,6,43,37
33,MCO,P008099,P008161,2.517,-4,7,11
33,MCO,P008099,P009754,3.934,4,13,9
33,MCO,P008099,P011212,3.617,1,12,11
33,MCO,P008099,P011226,15.499,16,38,22
33,MCO,P008099,P013365,5.166,6,14,8
33,MCO,P008099,PLCZ,15.117,6,38,32
33,MCO,P008161,P011212,2.517,-4,7,11
33,MCO,P008161,P013365,0.4,-2,0,2
33,MCO,P008161,PLCZ,2.117,-2,7,9
33,MCO,P009754,P011212,17.466,-4,38,42
33,MCO,P009754,P011226,10.183,-1,21,22
33,MCO,P009754,P013365,11.816,-3,26,29
33,MCO,P009754,PLCZ,9.567,1,23,22
33,MCO,P011212,P011226,11.866,8,31,23
33,MCO,P011212,P013365,12.216,-5,26,31
33,MCO,P011212,PLCZ,11.1,8,33,25
33,MCO,P011226,P013365,13.299,5,31,26
33,MCO,P011226,PLCZ,12.966,14,33,19
33,VIR,P001133,P001844,12.55,-6,29,35
33,VIR,P001133,P002084,5.05,2,13,11
33,VIR,P001133,P004554,12.867,-7,30,37
33,VIR,P001133,P004888,21.718,-10,48,58
33,VIR,P001133,P006739,15.801,-12,29,41
33,VIR,P001133,P009549,18.884,-1,44,45
33,VIR,P001133,P012585,10.683,-12,21,33
33,VIR,P001133,P012591,0.184,-1,1,2
33,VIR,P001133,P013374,11.134,-11,19,30
33,VIR,P001133,PBCN,7.333,-6,14,20
33,VIR,P001844,P002084,9.216,8,21,13
33,VIR,P001844,P004554,5.8,-7,12,19
33,VIR,P001844,P004888,9.934,1,22,21
33,VIR,P001844,P009549,8.65,1,22,21
33,VIR,P001844,P012585,9.883,-2,18,20
33,VIR,P001844,P013374,7.85,5,16,11
33,VIR,P001844,PBCN,10.249,-4,20,24
33,VIR,P002084,P004554,2.667,-2,8,10
33,VIR,P002084,P004888,2.717,6,6,0
33,VIR,P002084,P006739,2.834,-1,9,10
33,VIR,P002084,P009549,6.717,-4,14,18
33,VIR,P002084,P012585,6.3,8,19,11
33,VIR,P002084,P012591,0.167,1,1,0
33,VIR,P002084,P013374,4.9,6,11,5
33,VIR,P002084,PBCN,9.9,0,26,26
33,VIR,P004554,P004888,10.417,0,28,28
33,VIR,P004554,P006739,9.034,-4,22,26
33,VIR,P004554,P009549,11.434,-7,25,32
33,VIR,P004554,P012585,4.8,0,17,17
33,VIR,P004554,PBCN,5.117,-9,10,19
33,VIR,P004888,P006739,15.284,-10,29,39
33,VIR,P004888,P009549,13.284,3,32,29
33,VIR,P004888,P012585,16.616,-11,30,41
33,VIR,P004888,P012591,0.184,-1,1,2
33,VIR,P004888,P013374,17.067,-10,28,38
33,VIR,P004888,PBCN,3.383,-4,4,8
33,VIR,P006739,P009549,10.801,-8,18,26
33,VIR,P006739,P012585,7.483,-5,18,23
33,VIR,P006739,P012591,0.184,-1,1,2
33,VIR,P006739,P013374,9.267,-11,14,25
33,VIR,P006739,PBCN,3.184,-4,8,12
33,VIR,P009549,P012585,3.0,-1,8,9
33,VIR,P009549,P013374,6.134,-2,11,13
33,VIR,P009549,PBCN,10.9,-13,18,31
33,VIR,P012585,P013374,15.566,-8,27,35
33,VIR,P012585,PBCN,7.133,-1,18,19
33,VIR,P012591,P013374,0.017,-2,0,2
33,VIR,P013374,PBCN,5.733,-3,10,13
34,IST,P004887,P006372,3.45,-2,5,7
34,IST,P004887,P006590,1.716,2,5,3
34,IST,P004887,P007109,3.216,1,6,5
34,IST,P004887,P007200,20.416,8,42,34
34,IST,P004887,P009664,11.583,6,28,22
34,IST,P004887,P009846,26.416,-6,54,60
34,IST,P004887,P011078,20.733,-13,40,53
34,IST,P004887,P012710,15.0,-13,25,38
34,IST,P004887,P013363,16.666,-7,31,38
34,IST,P006372,P007109,1.483,5,7,2
34,IST,P006372,P007200,4.866,5,12,7
34,IST,P006372,P009664,4.933,3,12,9
34,IST,P006372,P009846,0.067,-2,0,2
34,IST,P006372,P011078,4.933,3,12,9
34,IST,P006590,P007109,8.916,5,25,20
34,IST,P006590,P007200,4.583,7,14,7
34,IST,P006590,P009664,6.533,4,18,14
34,IST,P006590,P009846,5.616,2,16,14
34,IST,P006590,P011078,5.016,-3,13,16
34,IST,P006590,P012710,2.033,-3,6,9
34,IST,P006590,P013363,3.983,2,11,9
34,IST,P007109,P007200,9.082,11,27,16
34,IST,P007109,P009664,8.849,10,28,18
34,IST,P007109,P009846,7.949,2,20,18
34,IST,P007109,P011078,6.649,4,21,17
34,IST,P007109,P012710,1.35,-2,4,6
34,IST,P007109,P013363,6.166,0,14,14
34,IST,P007200,P009664,15.099,16,39,23
34,IST,P007200,P009846,20.416,11,47,36
34,IST,P007200,P011078,13.666,7,33,26
34,IST,P007200,P012710,7.967,1,18,17
34,IST,P007200,P013363,9.033,6,20,14
34,IST,P009664,P009846,11.583,9,33,24
34,IST,P009664,P011078,11.032,6,32,26
34,IST,P009664,P013363,12.116,10,34,24
34,IST,P009846,P011078,19.533,-14,42,56
34,IST,P009846,P012710,16.35,-15,29,44
34,IST,P009846,P013363,16.666,-7,31,38
34,IST,P011078,P012710,16.35,-15,29,44
34,IST,P011078,P013363,11.616,-11,22,33
34,IST,P012710,P013363,6.35,-13,5,18
34,OLY,P001255,P003469,16.499,13,39,26
34,OLY,P001255,P008811,15.116,10,35,25
34,OLY,P001255,P008829,1.467,-2,1,3
34,OLY,P001255,P008855,17.966,11,40,29
34,OLY,P001255,P009849,7.633,9,18,9
34,OLY,P001255,P011194,2.85,1,5,4
34,OLY,P001255,P013380,10.333,2,22,20
34,OLY,P003469,P007853,13.583,-4,34,38
34,OLY,P003469,P007947,8.4,-1,24,25
34,OLY,P003469,P008811,18.699,11,42,31
34,OLY,P003469,P008829,7.467,-4,21,25
34,OLY,P003469,P008855,21.682,10,49,39
34,OLY,P003469,P009849,6.233,13,19,6
34,OLY,P003469,P011194,1.383,3,4,1
34,OLY,P003469,P012878,9.766,-8,22,30
34,OLY,P003469,P013380,16.616,3,38,35
34,OLY,P007853,P007947,16.85,-10,39,49
34,OLY,P007853,P008811,3.583,1,7,6
34,OLY,P007853,P008829,15.917,-13,36,49
34,OLY,P007853,P008855,5.183,-3,10,13
34,OLY,P007853,P009849,8.517,-7,17,24
34,OLY,P007853,P011194,4.433,-8,9,17
34,OLY,P007853,P012878,13.783,-9,28,37
34,OLY,P007853,P013380,6.283,1,16,15
34,OLY,P007947,P008829,15.75,-14,33,47
34,OLY,P007947,P009849,8.517,-7,17,24
34,OLY,P007947,P011194,4.433,-8,9,17
34,OLY,P007947,P012878,12.35,-4,28,32
34,OLY,P007947,P013380,1.1,4,6,2
34,OLY,P008811,P008855,18.699,11,42,31
34,OLY,P008811,P009849,4.783,8,13,5
34,OLY,P008811,P013380,13.916,3,29,26
34,OLY,P008829,P008855,1.634,-1,4,5
34,OLY,P008829,P009849,9.984,-9,18,27
34,OLY,P008829,P011194,5.9,-10,10,20
34,OLY,P008829,P012878,11.25,-8,22,30
34,OLY,P008829,P013380,0.167,1,3,2
34,OLY,P008855,P009849,7.633,9,18,9
34,OLY,P008855,P011194,2.85,1,5,4
34,OLY,P008855,P012878,1.433,-5,0,5
34,OLY,P008855,P013380,15.516,-1,32,33
34,OLY,P009849,P011194,7.283,-7,14,21
34,OLY,P009849,P012878,4.017,-1,6,7
34,OLY,P012878,P013380,2.533,-1,6,7
35,BAR,P000925,P002939,26.366,-6,51,57
35,BAR,P000925,P003478,8.534,3,21,18
35,BAR,P000925,P006435,24.1,-1,51,52
35,BAR,P000925,P009862,8.784,5,22,17
35,BAR,P000925,P009992,5.567,0,12,12
35,BAR,P000925,P010106,0.017,-3,0,3
35,BAR,P000925,P012745,17.767,-1,38,39
35,BAR,P000925,P012795,7.533,-10,11,21
35,BAR,P000925,P013379,9.2,-3,18,21
35,BAR,P002939,P003478,8.0,1,16,15
35,BAR,P002939,P006435,23.516,-6,46,52
35,BAR,P002939,P009862,8.55,2,19,17
35,BAR,P002939,P009992,5.15,-2,10,12
35,BAR,P002939,P012745,17.516,-1,35,36
35,BAR,P002939,P012795,7.516,-7,11,18
35,BAR,P002939,P013379,8.85,-5,16,21
35,BAR,P003196,P003478,3.767,6,11,5
35,BAR,P003196,P006435,5.733,7,13,6
35,BAR,P003196,P009862,17.483,10,42,32
35,BAR,P003196,P009992,8.183,6,17,11
35,BAR,P003196,P010106,11.75,3,29,26
35,BAR,P003196,P012745,10.15,6,26,20
35,BAR,P003196,P012795,5.533,-2,14,16
35,BAR,P003196,P013379,7.333,4,16,12
35,BAR,P003478,P006435,6.45,6,16,10
35,BAR,P003478,P009862,4.384,10,16,6
35,BAR,P003478,P009992,1.967,1,5,4
35,BAR,P003478,P010106,3.784,3,11,8
35,BAR,P003478,P012745,11.334,9,30,21
35,BAR,P003478,P012795,0.017,-3,0,3
35,BAR,P003478,P013379,0.967,0,2,2
35,BAR,P006435,P009862,13.284,11,33,22
35,BAR,P006435,P009992,9.683,8,22,14
35,BAR,P006435,P012745,15.517,0,33,33
35,BAR,P006435,P012795,6.733,-7,11,18
35,BAR,P006435,P013379,14.316,6,31,25
35,BAR,P009862,P009992,8.8,4,17,13
35,BAR,P009862,P010106,12.3,1,29,28
35,BAR,P009862,P012745,19.484,9,48,39
35,BAR,P009862,P012795,6.316,-2,14,16
35,BAR,P009862,P013379,7.883,2,16,14
35,BAR,P009992,P010106,3.0,-3,4,7
35,BAR,P009992,P012745,4.067,-2,7,9
35,BAR,P009992,P013379,10.783,4,22,18
35,BAR,P010106,P012745,10.717,1,26,25
35,BAR,P010106,P012795,5.55,-5,14,19
35,BAR,P010106,P013379,2.15,-5,3,8
35,BAR,P012745,P012795,6.766,-7,13,20
35,BAR,P012745,P013379,0.55,-2,0,2
35,BAR,P012795,P013379,6.3,-5,12,17
35,RED,P000848,P002553,7.1,-3,11,14
35,RED,P000848,P004007,5.067,1,10,9
35,RED,P000848,P004866,2.884,8,10,2
35,RED,P000848,P006436,7.1,-3,11,14
35,RED,P000848,P009035,3.767,7,10,3
35,RED,P000848,P009048,2.584,8,10,2
35,RED,P000848,P010612,0.317,3,3,0
35,RED,P000848,P012044,8.6,-1,14,15
35,RED,P000848,P012786,4.067,7,10,3
35,RED,P000848,PJDR,0.017,3,3,0
35,RED,P000848,PLUO,3.233,-2,4,6
35,RED,P002553,P004007,7.434,2,14,12
35,RED,P002553,P004866,6.784,-13,10,23
35,RED,P002553,P006436,14.55,-6,26,32
35,RED,P002553,P009048,5.634,-11,4,15
35,RED,P002553,P010612,7.134,-7,8,15
35,RED,P002553,P012044,13.516,2,26,24
35,RED,P002553,P012786,4.867,-6,4,10
35,RED,P002553,PJDR,4.916,1,11,10
35,RED,P002553,PLUO,5.733,-7,6,13
35,RED,P004007,P004866,0.967,-6,0,6
35,RED,P004007,P006436,9.451,-2,17,19
35,RED,P004007,P009035,2.117,-4,3,7
35,RED,P004007,P009048,2.017,-1,3,4
35,RED,P004007,P010612,3.617,3,7,4
35,RED,P004007,P012044,6.567,5,14,9
35,RED,P004007,P012786,0.7,-3,0,3
35,RED,P004007,PLUO,0.267,-3,0,3
35,RED,P004866,P006436,7.651,-8,16,24
35,RED,P004866,P009035,22.551,2,53,51
35,RED,P004866,P009048,16.102,0,36,36
35,RED,P004866,P010612,15.618,-9,30,39
35,RED,P004866,P012044,12.616,0,32,32
35,RED,P004866,P012786,22.751,-4,49,53
35,RED,P004866,PJDR,8.617,12,33,21
35,RED,P004866,PLUO,2.467,-6,3,9
35,RED,P006436,P009035,5.751,-4,11,15
35,RED,P006436,P009048,6.084,-5,10,15
35,RED,P006436,P010612,5.601,-2,9,11
35,RED,P006436,P012044,13.283,1,27,26
35,RED,P006436,P012786,0.667,-3,0,3
35,RED,P006436,PJDR,6.666,1,17,16
35,RED,P006436,PLUO,4.4,-9,4,13
35,RED,P009035,P009048,12.468,7,32,25
35,RED,P009035,P010612,11.584,-4,24,28
35,RED,P009035,P012044,11.933,-1,27,28
35,RED,P009035,P012786,20.084,4,48,44
35,RED,P009035,PJDR,7.017,6,22,16
35,RED,P009035,PLUO,3.4,-1,6,7
35,RED,P009048,P010612,12.652,-11,21,32
35,RED,P009048,P012786,12.018,1,26,25
35,RED,P009048,PJDR,2.917,8,14,6
35,RED,P010612,P012044,6.383,5,16,11
35,RED,P010612,P012786,13.517,-7,25,32
35,RED,P010612,PJDR,0.117,5,5,0
35,RED,P012044,P012786,12.566,2,28,26
35,RED,P012044,PJDR,9.133,4,24,20
35,RED,P012044,PLUO,8.799,-5,12,17
35,RED,P012786,PJDR,5.367,8,18,10
35,RED,P012786,PLUO,4.8,1,8,7
35,RED,PJDR,PLUO,3.433,0,5,5
36,ASV,P000229,P002100,13.083,4,27,23
36,ASV,P000229,P003526,5.433,15,20,5
36,ASV,P000229,P004194,10.383,-10,12,22
36,ASV,P000229,P007027,11.166,16,28,12
36,ASV,P000229,P010545,12.333,13,27,14
36,ASV,P000229,P011225,6.033,2,10,8
36,ASV,P000229,P012731,4.633,-10,5,15
36,ASV,P000229,P013371,9.45,-14,9,23
36,ASV,P000229,P013372,1.283,2,3,1
36,ASV,P000229,PKIR,5.667,-2,7,9
36,ASV,P002100,P003526,8.017,19,27,8
36,ASV,P002100,P004194,7.3,-9,7,16
36,ASV,P002100,P007027,6.933,14,22,8
36,ASV,P002100,P010545,14.284,17,35,18
36,ASV,P002100,P011225,7.234,-1,13,14
36,ASV,P002100,P012731,4.633,-10,5,15
36,ASV,P002100,P013371,7.65,-10,9,19
36,ASV,P002100,P013372,2.717,3,9,6
36,ASV,P002100,PKIR,5.217,-7,6,13
36,ASV,P003526,P004194,1.584,2,2,0
36,ASV,P003526,P007027,19.384,17,46,29
36,ASV,P003526,P010545,23.018,20,55,35
36,ASV,P003526,P011225,17.051,2,35,33
36,ASV,P003526,P013371,1.584,2,2,0
36,ASV,P003526,P013372,15.084,6,33,27
36,ASV,P003526,PKIR,0.917,-3,0,3
36,ASV,P004194,P007027,4.667,1,7,6
36,ASV,P004194,P010545,4.784,0,6,6
36,ASV,P004194,P011225,1.283,3,5,2
36,ASV,P004194,P012731,4.283,-9,3,12
36,ASV,P004194,P013371,10.684,-11,9,20
36,ASV,P004194,PKIR,2.9,1,5,4
36,ASV,P007027,P010545,25.117,13,53,40
36,ASV,P007027,P011225,19.9,2,38,36
36,ASV,P007027,P013371,3.384,-2,2,4
36,ASV,P007027,P013372,13.65,5,27,22
36,ASV,P007027,PKIR,6.467,-2,9,11
36,ASV,P010545,P011225,23.301,0,42,42
36,ASV,P010545,P013371,4.784,0,6,6
36,ASV,P010545,P013372,16.367,8,36,28
36,ASV,P010545,PKIR,5.884,-7,4,11
36,ASV,P011225,P013372,16.367,8,36,28
36,ASV,P011225,PKIR,7.167,-4,9,13
36,ASV,P012731,P013371,4.633,-10,5,15
36,ASV,P012731,PKIR,0.35,-1,2,3
36,ASV,P013371,PKIR,1.967,-3,2,5
36,BAS,P008072,P011948,5.567,10,16,6
36,BAS,P008072,P012058,4.783,1,6,5
36,BAS,P008072,P012080,10.717,11,22,11
36,BAS,P008072,P012201,5.867,10,16,6
36,BAS,P008072,P012597,5.684,4,9,5
36,BAS,P008072,P013367,10.25,8,19,11
36,BAS,P011196,P011948,29.283,-18,47,65
36,BAS,P011196,P012058,10.033,-14,12,26
36,BAS,P011196,P012080,16.466,-14,23,37
36,BAS,P011196,P012201,24.267,-16,38,54
36,BAS,P011196,P012597,24.616,-8,43,51
36,BAS,P011196,P013367,12.467,-2,25,27
36,BAS,P011948,P012058,10.033,-14,12,26
36,BAS,P011948,P012080,22.033,-4,39,43
36,BAS,P011948,P012201,29.767,-6,54,60
36,BAS,P011948,P012597,25.15,-5,46,51
36,BAS,P011948,P013367,17.567,5,38,33
36,BAS,P012058,P012080,9.166,-2,12,14
36,BAS,P012058,P012201,5.65,-11,6,17
36,BAS,P012058,P012597,14.816,-13,18,31
36,BAS,P012058,P013367,4.783,1,6,5
36,BAS,P012080,P012201,17.317,-2,30,32
36,BAS,P012080,P012597,17.483,0,28,28
36,BAS,P012080,P013367,15.55,-1,26,27
36,BAS,P012201,P012597,20.434,-3,37,40
36,BAS,P012201,P013367,17.234,4,35,31
36,BAS,P012597,P013367,13.017,9,27,18
37,PAR,P004761,P006591,6.316,-5,4,9
37,PAR,P004761,P006760,19.616,0,39,39
37,PAR,P004761,P007870,10.883,3,20,17
37,PAR,P004761,P010781,16.133,0,35,35
37,PAR,P004761,P011981,8.733,-3,19,22
37,PAR,P004761,P012720,13.3,5,35,30
37,PAR,P004761,P013369,3.483,0,4,4
37,PAR,P006591,P006760,15.533,-10,13,23
37,PAR,P006591,P007632,4.567,3,9,6
37,PAR,P006591,P007870,5.25,-5,4,9
37,PAR,P006591,P008232,6.167,1,9,8
37,PAR,P006591,P010781,8.733,-9,6,15
37,PAR,P006591,P011981,16.45,-4,18,22
37,PAR,P006591,P012720,10.817,-7,9,16
37,PAR,P006591,P013369,12.967,0,16,16
37,PAR,P006760,P007870,14.9,5,27,22
37,PAR,P006760,P010781,27.033,-1,53,54
37,PAR,P006760,P011981,22.233,-3,40,43
37,PAR,P006760,P012720,27.517,3,56,53
37,PAR,P006760,P013369,8.5,-2,12,14
37,PAR,P007632,P008232,4.567,3,9,6
37,PAR,P007632,P011981,4.567,3,9,6
37,PAR,P007632,P013369,4.567,3,9,6
37,PAR,P007870,P010781,13.2,3,23,20
37,PAR,P007870,P011981,3.3,4,7,3
37,PAR,P007870,P012720,10.367,8,23,15
37,PAR,P007870,P013369,1.7,2,4,2
37,PAR,P008232,P011981,6.167,1,9,8
37,PAR,P008232,P012720,1.6,-2,0,2
37,PAR,P008232,P013369,6.167,1,9,8
37,PAR,P010781,P011981,17.133,0,37,37
37,PAR,P010781,P012720,24.2,4,53,49
37,PAR,P010781,P013369,1.7,-1,5,6
37,PAR,P011981,P012720,22.05,-3,40,43
37,PAR,P011981,P013369,12.967,-3,17,20
37,PAR,P012720,P013369,6.617,-4,8,12
37,VIR,P001133,P001844,10.45,10,15,5
37,VIR,P001133,P004554,16.45,-4,29,33
37,VIR,P001133,P004888,27.433,4,57,53
37,VIR,P001133,P009549,29.667,2,54,52
37,VIR,P001133,P012585,24.05,1,53,52
37,VIR,P001133,P012591,12.884,7,21,14
37,VIR,P001133,P013374,18.2,12,37,25
37,VIR,P001133,PBCN,4.066,4,6,2
37,VIR,P001844,P002084,3.367,-5,2,7
37,VIR,P001844,P004888,5.266,5,8,3
37,VIR,P001844,P009549,6.1,4,7,3
37,VIR,P001844,P012585,0.083,0,0,0
37,VIR,P001844,P012591,10.734,4,13,9
37,VIR,P001844,P013374,13.1,3,15,12
37,VIR,P001844,PBCN,6.5,-1,8,9
37,VIR,P002084,P012591,3.367,-5,2,7
37,VIR,P002084,P013374,3.367,-5,2,7
37,VIR,P002084,PBCN,3.367,-5,2,7
37,VIR,P004554,P004888,13.35,-4,25,29
37,VIR,P004554,P009549,16.45,-4,29,33
37,VIR,P004554,P012585,15.15,-2,29,31
37,VIR,P004554,P012591,3.467,-2,4,6
37,VIR,P004554,PBCN,0.933,0,0,0
37,VIR,P004888,P009549,24.183,-4,47,51
37,VIR,P004888,P012585,21.783,-2,49,51
37,VIR,P004888,P012591,5.35,-1,10,11
37,VIR,P004888,P013374,13.683,4,30,26
37,VIR,P004888,PBCN,2.016,2,2,0
37,VIR,P009549,P012585,23.183,-3,47,50
37,VIR,P009549,P012591,8.667,-1,9,10
37,VIR,P009549,P013374,12.817,2,23,21
37,VIR,P009549,PBCN,0.933,0,0,0
37,VIR,P012585,P012591,6.066,-3,10,13
37,VIR,P012585,P013374,9.217,1,24,23
37,VIR,P012591,P013374,12.384,0,17,17
37,VIR,P012591,PBCN,5.417,-3,6,9
37,VIR,P013374,PBCN,6.5,-1,8,9
39,TEL,P004233,P005145,0.8,-2,0,2
39,TEL,P004233,P006835,3.583,-3,8,11
39,TEL,P004233,P007990,4.383,-5,8,13
39,TEL,P004233,P011214,6.6,-7,10,17
39,TEL,P004233,P011433,0.8,-2,0,2
39,TEL,P004233,P013381,2.217,-2,2,4
39,TEL,P004233,P013382,2.217,-2,2,4
39,TEL,P004233,P013389,5.8,-5,10,15
39,TEL,P005145,P006835,4.484,-7,2,9
39,TEL,P005145,P007990,3.817,-2,5,7
39,TEL,P005145,P011214,8.267,-5,8,13
39,TEL,P005145,P011433,6.767,-3,6,9
39,TEL,P005145,P013381,1.25,1,1,0
39,TEL,P005145,P013382,5.134,-1,7,8
39,TEL,P005145,P013389,2.817,-1,3,4
39,TEL,P006835,P007990,13.367,-13,17,30
39,TEL,P006835,P011214,18.517,-9,27,36
39,TEL,P006835,P011219,18.234,-7,31,38
39,TEL,P006835,P011433,14.084,-3,19,22
39,TEL,P006835,P013381,11.017,7,22,15
39,TEL,P006835,P013382,27.535,-8,47,55
39,TEL,P006835,P013389,24.651,-13,47,60
39,TEL,P007990,P011214,9.3,-4,15,19
39,TEL,P007990,P011219,7.234,-9,7,16
39,TEL,P007990,P011433,6.95,0,9,9
39,TEL,P007990,P013382,9.934,-5,14,19
39,TEL,P007990,P013389,9.151,-14,13,27
39,TEL,P011214,P011219,2.95,-2,3,5
39,TEL,P011214,P011433,14.034,-2,19,21
39,TEL,P011214,P013381,6.367,-1,4,5
39,TEL,P011214,P013382,16.268,-3,26,29
39,TEL,P011214,P013389,16.301,-7,28,35
39,TEL,P011219,P011433,4.267,0,6,6
39,TEL,P011219,P013381,9.15,7,21,14
39,TEL,P011219,P013382,16.634,-7,31,38
39,TEL,P011219,P013389,14.467,-10,25,35
39,TEL,P011433,P013381,4.417,2,5,3
39,TEL,P011433,P013382,14.501,2,24,22
39,TEL,P011433,P013389,6.184,-2,12,14
39,TEL,P013381,P013382,12.201,5,24,19
39,TEL,P013381,P013389,11.317,5,21,16
39,TEL,P013382,P013389,22.052,-13,41,54
39,ZAL,P002329,P002676,8.284,3,17,14
39,ZAL,P002329,P003048,13.684,9,34,25
39,ZAL,P002329,P003210,3.317,-2,3,5
39,ZAL,P002329,P005504,5.0,6,14,8
39,ZAL,P002329,P007029,5.233,7,17,10
39,ZAL,P002329,P007513,21.367,9,48,39
39,ZAL,P002329,P007975,9.866,5,28,23
39,ZAL,P002329,P011051,9.65,-5,14,19
39,ZAL,P002329,P011983,13.451,1,27,26
39,ZAL,P002329,P012622,23.484,7,46,39
39,ZAL,P002676,P003048,9.8,1,13,12
39,ZAL,P002676,P003210,0.55,-1,0,1
39,ZAL,P002676,P005504,5.133,11,13,2
39,ZAL,P002676,P007029,12.432,13,26,13
39,ZAL,P002676,P007513,4.634,0,6,6
39,ZAL,P002676,P007975,13.532,9,25,16
39,ZAL,P002676,P011051,3.9,-4,5,9
39,ZAL,P002676,P011983,4.017,-5,4,9
39,ZAL,P002676,P012622,9.284,-2,8,10
39,ZAL,P002676,P012715,3.566,7,7,0
39,ZAL,P003048,P007029,5.516,3,8,5
39,ZAL,P003048,P007513,14.784,9,36,27
39,ZAL,P003048,P007975,9.432,0,16,16
39,ZAL,P003048,P011983,11.517,5,25,20
39,ZAL,P003048,P012622,18.617,9,38,29
39,ZAL,P003048,P012715,1.45,0,2,2
39,ZAL,P003210,P005504,0.05,0,0,0
39,ZAL,P003210,P007029,0.05,0,0,0
39,ZAL,P003210,P011051,3.867,-3,3,6
39,ZAL,P003210,P011983,3.817,-3,3,6
39,ZAL,P003210,P012622,3.817,-3,3,6
39,ZAL,P005504,P007029,5.133,11,13,2
39,ZAL,P005504,P007513,3.2,2,8,6
39,ZAL,P005504,P007975,8.283,13,21,8
39,ZAL,P005504,P011051,0.05,0,0,0
39,ZAL,P005504,P012622,3.2,2,8,6
39,ZAL,P005504,P012715,3.283,7,7,0
39,ZAL,P007029,P007513,1.583,4,6,2
39,ZAL,P007029,P007975,12.065,10,23,13
39,ZAL,P007029,P011051,3.166,0,8,8
39,ZAL,P007029,P011983,1.033,0,0,0
39,ZAL,P007029,P012622,5.283,1,8,7
39,ZAL,P007029,P012715,3.566,7,7,0
39,ZAL,P007513,P007975,6.283,2,17,15
39,ZAL,P007513,P011051,4.55,-2,6,8
39,ZAL,P007513,P011983,11.301,3,26,23
39,ZAL,P007513,P012622,21.267,9,45,36
39,ZAL,P007513,P012715,1.167,0,2,2
39,ZAL,P007975,P011051,2.1,-2,5,7
39,ZAL,P007975,P011983,2.5,-1,2,3
39,ZAL,P007975,P012622,11.633,1,24,23
39,ZAL,P007975,P012715,3.566,7,7,0
39,ZAL,P011051,P011983,6.101,-6,6,12
39,ZAL,P011051,P012622,8.684,-6,9,15
39,ZAL,P011983,P012622,15.568,2,29,27
39,ZAL,P011983,P012715,1.167,0,2,2
39,ZAL,P012622,P012715,1.167,0,2,2
38,MCO,P002581,P005985,12.234,-18,13,31
38,MCO,P002581,P008099,9.384,-11,10,21
38,MCO,P002581,P009754,9.434,-2,20,22
38,MCO,P002581,P011212,9.434,-2,20,22
38,MCO,P002581,P011226,18.051,-10,28,38
38,MCO,P002581,P011231,5.201,-2,13,15
38,MCO,P002581,P013365,3.117,-1,6,7
38,MCO,P002581,PLCZ,8.417,-6,10,16
38,MCO,P005844,P005985,9.65,9,29,20
38,MCO,P005844,P008099,0.767,0,2,2
38,MCO,P005844,P009754,14.3,8,35,27
38,MCO,P005844,P011212,11.317,6,26,20
38,MCO,P005844,P011226,8.4,1,17,16
38,MCO,P005844,P011231,15.067,8,37,29
38,MCO,P005844,P013365,0.767,0,2,2
38,MCO,P005985,P008099,13.701,-12,17,29
38,MCO,P005985,P009754,11.733,2,30,28
38,MCO,P005985,P011212,8.75,0,21,21
38,MCO,P005985,P011226,18.0,-14,25,39
38,MCO,P005985,P011231,11.384,1,31,30
38,MCO,P005985,P013365,4.317,-1,7,8
38,MCO,P005985,PLCZ,11.967,-7,15,22
38,MCO,P008099,P011226,12.934,-12,15,27
38,MCO,P008099,P011231,1.734,-5,2,7
38,MCO,P008099,P013365,4.317,-1,7,8
38,MCO,P008099,PLCZ,11.967,-7,15,22
38,MCO,P009754,P011212,23.318,3,54,51
38,MCO,P009754,P011226,19.634,1,43,42
38,MCO,P009754,P011231,18.534,11,48,37
38,MCO,P009754,P013365,5.684,-2,14,16
38,MCO,P009754,PLCZ,2.567,-1,8,9
38,MCO,P011212,P011226,16.651,-1,34,35
38,MCO,P011212,P011231,15.551,9,39,30
38,MCO,P011212,P013365,5.684,-2,14,16
38,MCO,P011212,PLCZ,2.567,-1,8,9
38,MCO,P011226,P011231,12.834,2,28,26
38,MCO,P011226,P013365,9.234,-3,19,22
38,MCO,P011226,PLCZ,14.534,-8,23,31
38,MCO,P011231,P013365,0.767,0,2,2
38,MCO,P013365,PLCZ,6.117,-2,13,15
38,PRS,P004197,P010390,13.95,13,36,23
38,PRS,P004197,P012608,16.034,10,38,28
38,PRS,P004197,P012610,16.034,10,38,28
38,PRS,P004197,P012612,1.167,-2,0,2
38,PRS,P004197,P012613,16.034,10,38,28
38,PRS,P004197,P013373,0.917,-1,2,3
38,PRS,P005793,P007032,10.883,-8,14,22
38,PRS,P005793,P012608,0.8,-4,3,7
38,PRS,P005793,P012609,11.683,-12,17,29
38,PRS,P005793,P012610,0.8,-4,3,7
38,PRS,P005793,P012612,2.25,3,5,2
38,PRS,P005793,P012640,10.883,-8,14,22
38,PRS,P005793,P013373,9.433,-15,12,27
38,PRS,P007032,P010390,1.8,2,4,2
38,PRS,P007032,P012608,3.283,6,11,5
38,PRS,P007032,P012609,10.883,-8,14,22
38,PRS,P007032,P012610,3.283,6,11,5
38,PRS,P007032,P012612,2.25,3,5,2
38,PRS,P007032,P012613,3.283,6,11,5
38,PRS,P007032,P012640,12.366,-4,21,25
38,PRS,P007032,P013373,8.633,-11,9,20
38,PRS,P010390,P012608,19.734,17,48,31
38,PRS,P010390,P012609,3.167,0,6,6
38,PRS,P010390,P012610,19.734,17,48,31
38,PRS,P010390,P012613,19.734,17,48,31
38,PRS,P010390,P012640,0.817,2,2,0
38,PRS,P012608,P012609,8.984,-3,22,25
38,PRS,P012608,P012610,26.551,13,63,50
38,PRS,P012608,P012612,6.184,-1,13,14
38,PRS,P012608,P012613,28.318,19,70,51
38,PRS,P012608,P012640,4.867,8,19,11
38,PRS,P012608,P013373,1.717,-5,5,10
38,PRS,P012609,P012610,6.417,-5,12,17
38,PRS,P012609,P012612,7.267,4,18,14
38,PRS,P012609,P012613,8.184,1,19,18
38,PRS,P012609,P012640,13.45,-6,24,30
38,PRS,P012609,P013373,9.433,-15,12,27
38,PRS,P012610,P012612,3.617,-3,3,6
38,PRS,P012610,P012613,25.751,17,60,43
38,PRS,P012610,P012640,2.3,6,9,3
38,PRS,P012610,P013373,1.717,-5,5,10
38,PRS,P012612,P012613,6.184,-1,13,14
38,PRS,P012612,P012640,4.817,5,15,10
38,PRS,P012613,P012640,4.867,8,19,11
38,PRS,P012613,P013373,0.917,-1,2,3
38,PRS,P012640,P013373,8.633,-11,9,20
40,IST,P004887,P006590,6.416,6,22,16
40,IST,P004887,P007109,5.9,11,22,11
40,IST,P004887,P007200,4.882,6,12,6
40,IST,P004887,P009846,23.848,4,57,53
40,IST,P004887,P011078,18.333,12,49,37
40,IST,P004887,P012710,19.165,-2,43,45
40,IST,P004887,P013363,21.716,-1,55,56
40,IST,P006590,P007109,16.251,13,42,29
40,IST,P006590,P007200,9.35,9,19,10
40,IST,P006590,P009846,12.199,-1,27,28
40,IST,P006590,P011078,11.884,7,32,25
40,IST,P006590,P012710,5.099,-4,11,15
40,IST,P006590,P012788,14.934,3,31,28
40,IST,P006590,P013363,9.267,3,28,25
40,IST,P007109,P007200,8.567,7,17,10
40,IST,P007109,P009846,10.85,6,27,21
40,IST,P007109,P011078,14.801,12,43,31
40,IST,P007109,P012788,14.101,5,31,26
40,IST,P007109,P013363,9.534,10,30,20
40,IST,P007200,P009846,9.149,7,19,12
40,IST,P007200,P011078,5.0,8,12,4
40,IST,P007200,P012710,3.949,3,9,6
40,IST,P007200,P012788,7.634,4,14,10
40,IST,P007200,P013363,1.533,-4,2,6
40,IST,P009846,P011078,19.849,4,47,43
40,IST,P009846,P012710,19.998,-4,43,47
40,IST,P009846,P012788,7.0,-2,13,15
40,IST,P009846,P013363,20.499,-6,47,53
40,IST,P011078,P012710,14.199,2,30,28
40,IST,P011078,P012788,10.667,2,24,22
40,IST,P011078,P013363,21.267,9,55,46
40,IST,P012710,P012788,0.833,-2,0,2
40,IST,P012710,P013363,16.749,-9,36,45
40,IST,P012788,P013363,4.567,2,11,9
40,MIL,P000796,P001518,3.967,-9,5,14
40,MIL,P000796,P005670,2.5,5,11,6
40,MIL,P000796,P006085,11.617,-14,19,33
40,MIL,P000796,P006509,8.751,-11,19,30
40,MIL,P000796,P006721,12.7,-20,18,38
40,MIL,P000796,P007831,27.318,-8,65,73
40,MIL,P000796,P008985,19.133,4,45,41
40,MIL,P000796,P008987,15.601,12,47,35
40,MIL,P000796,P013384,16.417,5,43,38
40,MIL,P001518,P005670,5.333,-1,11,12
40,MIL,P001518,P006085,2.767,-8,2,10
40,MIL,P001518,P006509,3.317,-2,4,6
40,MIL,P001518,P006721,2.767,-8,2,10
40,MIL,P001518,P007831,5.634,-12,7,19
40,MIL,P001518,P008985,6.733,-3,10,13
40,MIL,P001518,P008987,7.45,-2,12,14
40,MIL,P001518,P013384,7.7,1,15,14
40,MIL,P005670,P006509,1.617,4,8,4
40,MIL,P005670,P006721,1.167,-1,3,4
40,MIL,P005670,P007831,3.534,4,13,9
40,MIL,P005670,P008985,3.416,-1,6,7
40,MIL,P005670,P008987,4.9,3,13,10
40,MIL,P005670,P013384,5.333,-1,11,12
40,MIL,P006085,P006509,2.45,-5,2,7
40,MIL,P006085,P006721,11.933,-16,14,30
40,MIL,P006085,P007831,13.2,-14,21,35
40,MIL,P006085,P008985,4.933,-1,6,7
40,MIL,P006085,P008987,2.85,2,9,7
40,MIL,P006085,P013384,3.05,0,11,11
40,MIL,P006509,P006721,6.267,-10,10,20
40,MIL,P006509,P007831,11.134,-12,23,35
40,MIL,P006509,P008985,8.667,-7,15,22
40,MIL,P006509,P008987,11.267,-1,21,22
40,MIL,P006509,P013384,5.734,-4,6,10
40,MIL,P006721,P007831,15.75,-21,22,43
40,MIL,P006721,P008985,7.583,-5,11,16
40,MIL,P006721,P008987,3.05,-1,4,5
40,MIL,P006721,P013384,1.783,-2,4,6
40,MIL,P007831,P008985,19.05,2,44,42
40,MIL,P007831,P008987,19.901,11,56,45
40,MIL,P007831,P013384,16.151,6,45,39
40,MIL,P008985,P008987,18.817,6,42,36
40,MIL,P008985,P013384,16.2,9,37,28
40,MIL,P008987,P013384,20.568,6,48,42
41,BAS,P004058,P008072,9.817,9,18,9
41,BAS,P004058,P010784,1.867,3,6,3
41,BAS,P004058,P011085,3.25,2,4,2
41,BAS,P004058,P011196,3.45,3,7,4
41,BAS,P004058,P011948,3.2,4,6,2
41,BAS,P004058,P012058,7.734,10,19,9
41,BAS,P004058,P012080,10.017,10,21,11
41,BAS,P004058,P012201,5.533,2,6,4
41,BAS,P004058,P012597,4.317,5,9,4
41,BAS,P004058,P013367,3.883,0,4,4
41,BAS,P008072,P010784,1.867,3,6,3
41,BAS,P008072,P011085,10.584,11,23,12
41,BAS,P008072,P011948,9.5,4,18,14
41,BAS,P008072,P012058,4.284,7,12,5
41,BAS,P008072,P012080,11.65,0,18,18
41,BAS,P008072,P012201,17.95,4,29,25
41,BAS,P008072,P012597,12.101,9,25,16
41,BAS,P008072,P013367,11.183,-3,15,18
41,BAS,P010784,P012058,1.867,3,6,3
41,BAS,P010784,P012080,1.867,3,6,3
41,BAS,P011085,P011196,4.233,7,11,4
41,BAS,P011085,P011948,9.35,12,23,11
41,BAS,P011085,P012058,0.9,3,3,0
41,BAS,P011085,P012201,13.917,15,31,16
41,BAS,P011085,P012597,11.567,16,30,14
41,BAS,P011085,P013367,5.467,6,11,5
41,BAS,P011196,P011948,14.316,9,32,23
41,BAS,P011196,P012058,14.433,8,31,23
41,BAS,P011196,P012080,13.533,5,28,23
41,BAS,P011196,P012201,3.333,4,8,4
41,BAS,P011196,P012597,13.366,16,33,17
41,BAS,P011196,P013367,4.4,-4,6,10
41,BAS,P011948,P012058,13.4,9,30,21
41,BAS,P011948,P012080,14.466,1,27,26
41,BAS,P011948,P012201,10.416,4,20,16
41,BAS,P011948,P012597,15.033,18,38,20
41,BAS,P011948,P013367,5.583,-9,6,15
41,BAS,P012058,P012080,17.817,12,40,28
41,BAS,P012058,P012597,10.033,12,25,13
41,BAS,P012058,P013367,4.4,-4,6,10
41,BAS,P012080,P012201,7.366,-7,6,13
41,BAS,P012080,P012597,13.9,9,28,19
41,BAS,P012080,P013367,10.116,-13,10,23
41,BAS,P012201,P012597,15.434,13,33,20
41,BAS,P012201,P013367,11.183,-3,15,18
41,BAS,P012597,P013367,6.117,2,11,9
41,BER,P006251,P006919,4.434,2,8,6
41,BER,P006251,P007025,10.351,-16,9,25
41,BER,P006251,P007550,3.167,-3,3,6
41,BER,P006251,P008062,8.884,-4,12,16
41,BER,P006251,P008173,1.85,5,5,0
41,BER,P006251,P008384,14.068,-14,17,31
41,BER,P006251,P008780,7.151,3,12,9
41,BER,P006251,P010791,10.601,-4,12,16
41,BER,P006251,P011934,4.167,-2,7,9
41,BER,P006251,P012721,1.867,-3,3,6
41,BER,P006919,P007550,4.984,-7,5,12
41,BER,P006919,P008062,4.717,2,9,7
41,BER,P006919,P008173,14.433,-8,23,31
41,BER,P006919,P008384,3.684,-7,5,12
41,BER,P006919,P008780,13.55,0,24,24
41,BER,P006919,P010791,7.834,-2,11,13
41,BER,P006919,P011934,10.983,-5,19,24
41,BER,P006919,P012721,18.117,-15,28,43
41,BER,P007025,P008062,7.617,-9,7,16
41,BER,P007025,P008384,10.351,-16,9,25
41,BER,P007025,P008780,2.734,-7,2,9
41,BER,P007025,P010791,8.034,-9,7,16
41,BER,P007025,P011934,2.317,-7,2,9
41,BER,P007550,P008384,3.684,-7,5,12
41,BER,P007550,P008780,1.3,0,0,0
41,BER,P007550,P010791,3.117,-4,2,6
41,BER,P007550,P012721,3.684,-7,5,12
41,BER,P008062,P008173,7.95,-7,10,17
41,BER,P008062,P008384,9.417,-17,7,24
41,BER,P008062,P008780,3.967,9,11,2
41,BER,P008062,P010791,14.467,-3,22,25
41,BER,P008062,P011934,2.367,-8,0,8
41,BER,P008062,P012721,7.95,-7,10,17
41,BER,P008173,P008384,6.267,-1,9,10
41,BER,P008173,P008780,18.15,6,34,28
41,BER,P008173,P010791,5.583,1,10,9
41,BER,P008173,P011934,17.817,-6,28,34
41,BER,P008173,P012721,21.55,-10,33,43
41,BER,P008384,P008780,7.201,0,11,11
41,BER,P008384,P010791,9.851,-13,9,22
41,BER,P008384,P011934,8.584,-8,11,19
41,BER,P008384,P012721,8.101,-13,9,22
41,BER,P008780,P010791,5.117,9,11,2
41,BER,P008780,P011934,18.334,-5,30,35
41,BER,P008780,P012721,16.3,1,29,28
41,BER,P010791,P012721,7.4,-3,12,15
41,BER,P011934,P012721,15.967,-11,23,34
42,MAD,P003108,P003583,8.267,2,13,11
42,MAD,P003108,P003733,15.367,12,38,26
42,MAD,P003108,P005791,11.75,10,32,22
42,MAD,P003108,P005928,16.317,20,45,25
42,MAD,P003108,P006540,0.65,0,2,2
42,MAD,P003108,P009005,4.517,3,10,7
42,MAD,P003108,P009213,19.084,11,45,34
42,MAD,P003108,P011649,0.067,0,0,0
42,MAD,P003108,P013378,5.417,0,9,9
42,MAD,P003108,PTGB,7.1,-6,10,16
42,MAD,P003583,P003733,3.617,2,6,4
42,MAD,P003583,P005928,3.167,9,9,0
42,MAD,P003583,P006540,5.533,2,13,11
42,MAD,P003583,P009005,7.933,4,17,13
42,MAD,P003583,P009213,5.867,0,9,9
42,MAD,P003583,P013378,10.183,2,20,18
42,MAD,P003583,PTGB,10.633,-5,17,22
42,MAD,P003733,P005791,11.75,10,32,22
42,MAD,P003733,P005928,13.65,16,38,22
42,MAD,P003733,P006540,1.983,-3,4,7
42,MAD,P003733,P009213,17.35,9,42,33
42,MAD,P003733,P011649,1.983,-3,4,7
42,MAD,P003733,P012168,1.983,-3,4,7
42,MAD,P003733,PTGB,1.717,-4,0,4
42,MAD,P005791,P005928,11.75,10,32,22
42,MAD,P005791,P006540,7.35,8,18,10
42,MAD,P005791,P009005,4.817,5,10,5
42,MAD,P005791,P009213,14.283,13,40,27
42,MAD,P005791,P011649,2.7,3,8,5
42,MAD,P005791,P013378,4.65,5,10,5
42,MAD,P005791,PTGB,7.35,8,18,10
42,MAD,P005928,P006540,1.667,0,4,4
42,MAD,P005928,P009005,4.4,4,13,9
42,MAD,P005928,P009213,19.317,23,54,31
42,MAD,P005928,P013378,4.317,6,12,6
42,MAD,P005928,PTGB,2.683,4,9,5
42,MAD,P006540,P009005,12.667,7,29,22
42,MAD,P006540,P009213,6.183,0,16,16
42,MAD,P006540,P011649,4.683,0,12,12
42,MAD,P006540,P012168,1.983,-3,4,7
42,MAD,P006540,P013378,12.5,7,29,22
42,MAD,P006540,PTGB,13.533,10,33,23
42,MAD,P009005,P009213,4.467,4,13,9
42,MAD,P009005,P011649,0.234,0,0,0
42,MAD,P009005,P013378,16.35,12,38,26
42,MAD,P009005,PTGB,16.083,13,38,25
42,MAD,P009213,P011649,4.583,0,12,12
42,MAD,P009213,P012168,1.983,-3,4,7
42,MAD,P009213,P013378,5.367,1,12,11
42,MAD,P009213,PTGB,7.916,-2,17,19
42,MAD,P011649,P012168,1.983,-3,4,7
42,MAD,P011649,P013378,0.067,0,0,0
42,MAD,P011649,PTGB,2.7,3,8,5
42,MAD,P013378,PTGB,15.549,7,34,27
42,RED,P002553,P004007,1.333,-4,0,4
42,RED,P002553,P004866,5.85,-6,15,21
42,RED,P002553,P006436,6.116,-2,10,12
42,RED,P002553,P007960,8.449,-4,13,17
42,RED,P002553,P009048,6.65,-8,14,22
42,RED,P002553,P010612,4.967,-1,14,15
42,RED,P002553,P012044,8.533,-2,14,16
42,RED,P002553,P012786,1.717,-1,1,2
42,RED,P002553,PJDR,15.316,-10,28,38
42,RED,P002553,PLUO,2.333,-2,3,5
42,RED,P004007,P004866,5.383,1,11,10
42,RED,P004007,P006240,5.783,3,14,11
42,RED,P004007,P006436,2.633,5,9,4
42,RED,P004007,P007960,3.733,-2,3,5
42,RED,P004007,P009048,1.2,-4,0,4
42,RED,P004007,P012044,6.433,3,14,11
42,RED,P004007,P012786,0.65,0,0,0
42,RED,P004007,PJDR,2.366,-4,2,6
42,RED,P004007,PLUO,2.95,-2,3,5
42,RED,P004866,P006240,14.332,-4,26,30
42,RED,P004866,P006436,3.617,4,12,8
42,RED,P004866,P007960,2.9,-1,5,6
42,RED,P004866,P009048,15.133,-16,25,41
42,RED,P004866,P010612,15.816,-11,32,43
42,RED,P004866,P012044,6.816,5,19,14
42,RED,P004866,P012786,11.716,-10,14,24
42,RED,P004866,PJDR,7.283,-6,17,23
42,RED,P004866,PLUO,0.35,0,0,0
42,RED,P006240,P006436,2.15,5,9,4
42,RED,P006240,P007960,5.233,-8,8,16
42,RED,P006240,P009048,11.45,-15,14,29
42,RED,P006240,P010612,11.316,-13,15,28
42,RED,P006240,P012044,7.332,3,18,15
42,RED,P006240,P012786,10.366,-9,13,22
42,RED,P006240,PJDR,3.283,-6,5,11
42,RED,P006240,PLUO,3.883,-4,6,10
42,RED,P006436,P007960,7.583,-3,13,16
42,RED,P006436,P009048,0.483,-3,0,3
42,RED,P006436,P010612,1.117,-1,3,4
42,RED,P006436,P012044,8.767,5,22,17
42,RED,P006436,PJDR,6.116,-2,10,12
42,RED,P006436,PLUO,0.35,0,0,0
42,RED,P007960,P009048,5.733,-7,12,19
42,RED,P007960,P010612,6.25,-5,14,19
42,RED,P007960,P012044,13.366,-6,21,27
42,RED,P007960,P012786,4.433,0,9,9
42,RED,P007960,PJDR,10.299,-10,16,26
42,RED,P007960,PLUO,10.349,-6,18,24
42,RED,P009048,P010612,18.9,-16,34,50
42,RED,P009048,P012786,14.783,-11,20,31
42,RED,P009048,PJDR,8.517,-12,17,29
42,RED,P009048,PLUO,4.683,0,12,12
42,RED,P010612,P012044,2.283,1,7,6
42,RED,P010612,P012786,14.766,-9,22,31
42,RED,P010612,PJDR,5.534,-5,14,19
42,RED,P010612,PLUO,3.783,0,9,9
42,RED,P012044,P012786,1.733,1,3,2
42,RED,P012044,PJDR,9.949,-4,16,20
42,RED,P012044,PLUO,5.316,-6,6,12
42,RED,P012786,PJDR,2.117,-1,1,2
42,RED,P012786,PLUO,3.783,0,9,9
42,RED,PJDR,PLUO,3.616,-4,6,10
43,PAN,P001926,P003842,9.5,4,25,21
43,PAN,P001926,P004088,9.433,-1,21,22
43,PAN,P001926,P005353,10.349,-6,20,26
43,PAN,P001926,P009622,10.933,-8,18,26
43,PAN,P001926,P011204,12.483,8,34,26
43,PAN,P001926,P012712,11.016,-4,23,27
43,PAN,P001926,P012774,15.682,-1,39,40
43,PAN,P003842,P004088,11.684,9,27,18
43,PAN,P003842,P009622,10.667,9,24,15
43,PAN,P003842,P011204,24.317,15,56,41
43,PAN,P003842,P012712,18.6,6,36,30
43,PAN,P003842,P012774,22.5,17,56,39
43,PAN,P004088,P005353,8.416,-4,15,19
43,PAN,P004088,P009622,7.217,-2,13,15
43,PAN,P004088,P011204,15.817,11,36,25
43,PAN,P004088,P012712,10.083,3,20,17
43,PAN,P004088,P012774,17.75,4,36,32
43,PAN,P005353,P009622,12.516,-13,16,29
43,PAN,P005353,P011204,8.316,0,14,14
43,PAN,P005353,P012712,9.799,-6,16,22
43,PAN,P005353,P012774,13.332,-11,19,30
43,PAN,P009622,P011204,18.0,6,35,29
43,PAN,P009622,P012712,14.383,-5,20,25
43,PAN,P009622,P012774,19.016,-3,34,37
43,PAN,P011204,P012712,23.133,4,41,37
43,PAN,P011204,P012774,28.466,16,64,48
43,PAN,P012712,P012774,26.582,2,52,50
43,ULK,P002849,P004004,14.3,-5,23,28
43,ULK,P002849,P006961,10.234,-9,18,27
43,ULK,P002849,P008962,13.433,-2,23,25
43,ULK,P002849,P009783,18.45,-6,32,38
43,ULK,P002849,P009863,22.4,-7,41,48
43,ULK,P002849,P011205,9.917,-9,18,27
43,ULK,P002849,P013396,1.267,-4,0,4
43,ULK,P002849,PLMG,4.667,-2,9,11
43,ULK,P004004,P006961,0.867,-3,0,3
43,ULK,P004004,P007182,6.283,-1,9,10
43,ULK,P004004,P008962,19.716,-3,32,35
43,ULK,P004004,P009783,19.716,-3,32,35
43,ULK,P004004,P009863,20.583,-6,32,38
43,ULK,P004004,P011205,0.55,-3,0,3
43,ULK,P004004,PLMG,0.317,0,0,0
43,ULK,P006961,P007182,7.134,13,22,9
43,ULK,P006961,P008962,3.717,-5,6,11
43,ULK,P006961,P009783,10.884,11,29,18
43,ULK,P006961,P009863,14.834,10,38,28
43,ULK,P006961,P011205,19.501,1,44,43
43,ULK,P006961,P013396,4.984,-9,6,15
43,ULK,P006961,PLMG,7.117,-5,13,18
43,ULK,P007182,P008962,8.017,-6,11,17
43,ULK,P007182,P009783,12.617,11,29,18
43,ULK,P007182,P009863,12.617,11,29,18
43,ULK,P007182,P011205,7.601,10,22,12
43,ULK,P007182,P013396,1.267,-2,2,4
43,ULK,P008962,P009783,20.183,-6,32,38
43,ULK,P008962,P009863,20.183,-6,32,38
43,ULK,P008962,P011205,4.184,-8,6,14
43,ULK,P008962,P013396,3.717,-5,6,11
43,ULK,P008962,PLMG,2.45,-3,4,7
43,ULK,P009783,P009863,31.067,5,61,56
43,ULK,P009783,P011205,11.351,8,29,21
43,ULK,P009863,P011205,14.984,7,38,31
43,ULK,P009863,PLMG,3.4,2,9,7
43,ULK,P011205,P013396,4.984,-9,6,15
43,ULK,P011205,PLMG,6.8,-5,13,18
43,ULK,P013396,PLMG,3.717,-7,4,11
44,ASV,P000229,P002100,8.783,0,26,26
44,ASV,P000229,P003526,12.034,0,19,19
44,ASV,P000229,P007027,17.817,-2,37,39
44,ASV,P000229,P010316,1.501,-3,1,4
44,ASV,P000229,P010545,19.284,0,42,42
44,ASV,P000229,P013371,6.318,-4,14,18
44,ASV,P000229,P013372,11.434,-2,21,23
44,ASV,P000229,PKIR,10.833,-1,28,29
44,ASV,P002100,P003526,4.267,-3,4,7
44,ASV,P002100,P007027,10.217,-5,21,26
44,ASV,P002100,P010316,6.166,0,12,12
44,ASV,P002100,P010545,16.55,-3,34,37
44,ASV,P002100,P013371,8.849,2,21,19
44,ASV,P002100,P013372,5.3,-2,9,11
44,ASV,P002100,P013377,1.633,-1,5,6
44,ASV,P002100,PKIR,14.499,0,36,36
44,ASV,P003526,P007027,20.667,-2,33,35
44,ASV,P003526,P010316,5.217,-4,8,12
44,ASV,P003526,P010545,17.334,0,30,30
44,ASV,P003526,P013371,6.434,-4,10,14
44,ASV,P003526,P013372,16.151,-4,23,27
44,ASV,P003526,PKIR,6.1,-3,9,12
44,ASV,P007027,P010316,5.766,0,16,16
44,ASV,P007027,P010545,25.85,-5,57,62
44,ASV,P007027,P013371,6.15,-4,11,15
44,ASV,P007027,P013372,18.067,-1,34,35
44,ASV,P007027,PKIR,14.066,-5,35,40
44,ASV,P010316,P010545,8.3,3,22,19
44,ASV,P010316,P013371,11.65,-4,20,24
44,ASV,P010316,P013372,6.866,-4,14,18
44,ASV,P010316,P013377,1.633,-1,5,6
44,ASV,P010316,PKIR,6.633,1,18,17
44,ASV,P010545,P013371,9.417,0,21,21
44,ASV,P010545,P013372,15.85,0,33,33
44,ASV,P010545,PKIR,19.083,-3,45,48
44,ASV,P013371,P013372,7.066,-4,10,14
44,ASV,P013371,P013377,1.633,-1,5,6
44,ASV,P013371,PKIR,8.483,-1,20,21
44,ASV,P013372,PKIR,4.466,1,16,15
44,ASV,P013377,PKIR,1.633,-1,5,6
44,BAR,P000925,P002939,19.468,13,50,37
44,BAR,P000925,P003196,0.033,0,0,0
44,BAR,P000925,P003478,18.551,12,46,34
44,BAR,P000925,P009862,12.301,15,36,21
44,BAR,P000925,P009992,9.734,3,27,24
44,BAR,P000925,P010106,3.317,3,10,7
44,BAR,P000925,P011666,3.05,1,9,8
44,BAR,P000925,P012745,12.984,15,39,24
44,BAR,P000925,P012795,2.134,1,4,3
44,BAR,P000925,P013379,9.568,1,19,18
44,BAR,P002939,P003196,2.3,2,4,2
44,BAR,P002939,P003478,17.534,9,38,29
44,BAR,P002939,P009862,14.568,14,37,23
44,BAR,P002939,P009992,9.55,3,22,19
44,BAR,P002939,P011666,4.333,1,9,8
44,BAR,P002939,P012745,16.084,14,40,26
44,BAR,P002939,P012795,3.951,3,8,5
44,BAR,P002939,P013379,11.684,1,16,15
44,BAR,P003196,P009862,12.084,-9,26,35
44,BAR,P003196,P009992,5.766,-4,11,15
44,BAR,P003196,P010106,11.817,-11,24,35
44,BAR,P003196,P011666,3.5,-1,8,9
44,BAR,P003196,P012745,9.518,-8,19,27
44,BAR,P003196,P012795,6.884,-4,11,15
44,BAR,P003196,P013379,4.566,-1,9,10
44,BAR,P003478,P009862,11.617,11,29,18
44,BAR,P003478,P009992,7.634,0,17,17
44,BAR,P003478,P010106,3.317,3,10,7
44,BAR,P003478,P011666,1.483,1,2,1
44,BAR,P003478,P012745,13.217,12,31,19
44,BAR,P003478,P013379,10.051,0,19,19
44,BAR,P009862,P009992,4.55,-1,14,15
44,BAR,P009862,P010106,12.084,-8,27,35
44,BAR,P009862,P011666,1.784,-1,8,9
44,BAR,P009862,P012745,21.952,6,53,47
44,BAR,P009862,P012795,9.018,-3,15,18
44,BAR,P009862,P013379,6.65,0,11,11
44,BAR,P009992,P010106,6.75,-4,16,20
44,BAR,P009992,P011666,4.116,0,7,7
44,BAR,P009992,P012745,4.067,0,12,12
44,BAR,P009992,P013379,13.033,-1,26,27
44,BAR,P010106,P011666,3.05,-1,8,9
44,BAR,P010106,P012745,9.551,-7,20,27
44,BAR,P010106,P012795,5.067,-6,7,13
44,BAR,P010106,P013379,5.583,-1,14,15
44,BAR,P011666,P012745,5.033,0,13,13
44,BAR,P011666,P012795,0.317,0,2,2
44,BAR,P011666,P013379,2.866,0,2,2
44,BAR,P012745,P012795,6.884,-4,11,15
44,BAR,P012745,P013379,3.25,0,2,2
44,BAR,P012795,P013379,1.817,1,2,1
45,MUN,P004508,P007056,18.384,7,42,35
45,MUN,P004508,P007201,16.951,3,38,35
45,MUN,P004508,P007639,2.75,-1,5,6
45,MUN,P004508,P010391,14.284,16,38,22
45,MUN,P004508,P011224,6.85,-10,9,19
45,MUN,P004508,P011244,4.183,3,9,6
45,MUN,P004508,P011987,21.134,6,47,41
45,MUN,P007056,P007201,28.167,6,65,59
45,MUN,P007056,P010391,24.567,21,65,44
45,MUN,P007056,P011224,15.35,-6,31,37
45,MUN,P007056,P011244,2.383,2,4,2
45,MUN,P007056,P011987,29.617,10,69,59
45,MUN,P007201,P007639,0.017,0,0,0
45,MUN,P007201,P010391,24.584,21,65,44
45,MUN,P007201,P011224,13.9,-10,27,37
45,MUN,P007201,P011244,0.933,-2,0,2
45,MUN,P007201,P011987,28.184,6,65,59
45,MUN,P007639,P010391,6.234,-5,10,15
45,MUN,P007639,P011224,10.367,-6,15,21
45,MUN,P007639,P011244,10.367,-6,15,21
45,MUN,P007639,P011987,6.334,-5,7,12
45,MUN,P007639,P012123,5.467,-1,8,9
45,MUN,P010391,P011224,16.517,0,37,37
45,MUN,P010391,P011244,6.217,-5,10,15
45,MUN,P010391,P011987,26.751,17,67,50
45,MUN,P010391,P012123,4.05,-1,8,9
45,MUN,P011224,P011244,12.75,-4,19,23
45,MUN,P011224,P011987,21.667,-11,38,49
45,MUN,P011224,P012123,5.467,-1,8,9
45,MUN,P011244,P011987,8.7,-3,11,14
45,MUN,P011244,P012123,5.467,-1,8,9
45,MUN,P011987,P012123,1.417,0,0,0
45,OLY,P001255,P003469,17.916,-8,37,45
45,OLY,P001255,P008811,12.983,-5,25,30
45,OLY,P001255,P008855,17.916,-8,37,45
45,OLY,P001255,P012878,4.933,-3,12,15
45,OLY,P001255,P013380,17.916,-8,37,45
45,OLY,P003469,P007853,4.067,0,8,8
45,OLY,P003469,P007947,7.417,-1,16,17
45,OLY,P003469,P008811,17.317,-8,34,42
45,OLY,P003469,P008829,0.183,0,0,0
45,OLY,P003469,P008855,23.349,-11,45,56
45,OLY,P003469,P009849,9.5,-3,16,19
45,OLY,P003469,P012878,9.916,-3,19,22
45,OLY,P003469,P013380,19.999,-10,37,47
45,OLY,P007853,P007947,16.65,7,35,28
45,OLY,P007853,P008811,1.167,-2,1,3
45,OLY,P007853,P008829,12.583,7,27,20
45,OLY,P007853,P009849,16.65,7,35,28
45,OLY,P007853,P012878,15.483,9,34,25
45,OLY,P007947,P008811,4.334,-3,9,12
45,OLY,P007947,P008829,12.766,7,27,20
45,OLY,P007947,P008855,3.35,-1,8,9
45,OLY,P007947,P009849,20.0,6,43,37
45,OLY,P007947,P012878,15.483,9,34,25
45,OLY,P008811,P008855,16.15,-6,33,39
45,OLY,P008811,P009849,4.334,-3,9,12
45,OLY,P008811,P013380,12.983,-5,25,30
45,OLY,P008829,P008855,0.183,0,0,0
45,OLY,P008829,P009849,12.766,7,27,20
45,OLY,P008829,P012878,12.583,7,27,20
45,OLY,P008855,P009849,5.433,-3,8,11
45,OLY,P008855,P012878,7.016,-5,12,17
45,OLY,P008855,P013380,19.999,-10,37,47
45,OLY,P009849,P012878,17.566,7,34,27
45,OLY,P009849,P013380,2.083,-2,0,2
45,OLY,P012878,P013380,7.016,-5,12,17
46,BAR,P000925,P002939,12.15,3,32,29
46,BAR,P000925,P003478,3.2,6,9,3
46,BAR,P000925,P009862,4.5,3,12,9
46,BAR,P000925,P009992,10.85,6,29,23
46,BAR,P000925,P010106,3.2,6,9,3
46,BAR,P000925,P012745,3.333,3,9,6
46,BAR,P000925,P012795,12.15,3,32,29
46,BAR,P000925,P013379,12.017,6,32,26
46,BAR,P002939,P003196,1.783,1,4,3
46,BAR,P002939,P003478,0.233,-1,0,1
46,BAR,P002939,P006568,3.75,-1,8,9
46,BAR,P002939,P009862,3.083,-2,7,9
46,BAR,P002939,P009992,14.6,5,37,32
46,BAR,P002939,P012745,2.666,1,7,6
46,BAR,P002939,P012795,17.45,4,44,40
46,BAR,P002939,P013379,15.017,2,37,35
46,BAR,P003196,P003478,12.7,5,29,24
46,BAR,P003196,P009862,16.483,10,40,30
46,BAR,P003196,P010106,14.7,9,36,27
46,BAR,P003196,P012745,16.483,10,40,30
46,BAR,P003196,P012795,3.783,5,11,6
46,BAR,P003478,P009862,17.083,11,40,29
46,BAR,P003478,P010106,16.85,12,40,28
46,BAR,P003478,P012745,16.333,8,37,29
46,BAR,P003478,P013379,1.933,3,5,2
46,BAR,P006568,P009992,3.75,-1,8,9
46,BAR,P006568,P012795,3.75,-1,8,9
46,BAR,P006568,P013379,3.75,-1,8,9
46,BAR,P009862,P009992,1.167,-6,0,6
46,BAR,P009862,P010106,21.867,7,52,45
46,BAR,P009862,P012745,23.783,5,56,51
46,BAR,P009862,P012795,6.7,0,19,19
46,BAR,P009862,P013379,5.134,-8,10,18
46,BAR,P009992,P010106,1.617,-7,1,8
46,BAR,P009992,P012745,1.617,-7,1,8
46,BAR,P009992,P012795,15.05,4,38,34
46,BAR,P009992,P013379,16.217,-2,38,40
46,BAR,P010106,P012745,21.567,3,50,47
46,BAR,P010106,P012795,4.3,0,13,13
46,BAR,P010106,P013379,5.167,-6,11,17
46,BAR,P012745,P012795,6.733,2,20,18
46,BAR,P012745,P013379,4.417,-9,8,17
46,BAR,P012795,P013379,17.084,-1,43,44
46,IST,P004887,P006590,6.55,1,11,10
46,IST,P004887,P007109,0.967,-2,0,2
46,IST,P004887,P009846,18.634,-10,35,45
46,IST,P004887,P011078,19.817,-8,37,45
46,IST,P004887,P012710,16.7,-8,31,39
46,IST,P004887,P013363,15.034,-4,32,36
46,IST,P004887,P013364,1.566,-1,2,3
46,IST,P006590,P006640,3.233,-3,4,7
46,IST,P006590,P007109,12.783,-2,31,33
46,IST,P006590,P009846,11.184,-2,24,26
46,IST,P006590,P011078,14.967,10,39,29
46,IST,P006590,P012710,5.8,0,9,9
46,IST,P006590,P012788,15.0,0,38,38
46,IST,P006590,P013363,10.0,-5,21,26
46,IST,P006590,P013364,6.683,5,19,14
46,IST,P006640,P007109,5.2,-2,11,13
46,IST,P006640,P009846,3.8,1,9,8
46,IST,P006640,P011078,1.833,0,2,2
46,IST,P006640,P012788,7.033,-2,13,15
46,IST,P006640,P013363,7.033,-2,13,15
46,IST,P007109,P009846,7.95,-7,19,26
46,IST,P007109,P011078,8.55,3,25,22
46,IST,P007109,P012788,16.133,-3,42,45
46,IST,P007109,P013363,11.35,-11,23,34
46,IST,P007109,P013364,5.467,4,17,13
46,IST,P009846,P011078,23.967,-5,50,55
46,IST,P009846,P012710,16.534,-6,33,39
46,IST,P009846,P012788,10.65,0,28,28
46,IST,P009846,P013363,24.034,-8,54,62
46,IST,P009846,P013364,0.383,-3,0,3
46,IST,P011078,P012710,18.1,-7,35,42
46,IST,P011078,P012788,11.633,7,34,27
46,IST,P011078,P013363,19.517,-4,43,47
46,IST,P011078,P013364,7.416,0,19,19
46,IST,P012710,P012788,1.4,1,4,3
46,IST,P012710,P013363,11.917,-4,26,30
46,IST,P012710,P013364,1.949,-4,2,6
46,IST,P012788,P013363,13.033,-8,28,36
46,IST,P012788,P013364,5.85,1,17,16
46,IST,P013363,P013364,0.35,-2,0,2
47,TEL,P004233,P005145,0.133,-2,0,2
47,TEL,P004233,P006835,0.133,-2,0,2
47,TEL,P004233,P007855,0.133,-2,0,2
47,TEL,P004233,P013381,0.133,-2,0,2
47,TEL,P005145,P006835,2.266,0,6,6
47,TEL,P005145,P007855,0.133,-2,0,2
47,TEL,P005145,P013381,2.266,0,6,6
47,TEL,P005145,P013382,2.133,2,6,4
47,TEL,P005145,P013389,2.133,2,6,4
47,TEL,P006835,P007519,23.6,-6,48,54
47,TEL,P006835,P007855,0.133,-2,0,2
47,TEL,P006835,P007990,15.666,-9,30,39
47,TEL,P006835,P011214,16.784,-5,33,38
47,TEL,P006835,P011219,17.283,-1,38,39
47,TEL,P006835,P013381,12.433,6,31,25
47,TEL,P006835,P013382,29.849,-4,63,67
47,TEL,P006835,P013389,18.717,3,43,40
47,TEL,P007519,P007990,12.316,-11,21,32
47,TEL,P007519,P011214,17.983,-3,29,32
47,TEL,P007519,P011219,15.75,-1,29,30
47,TEL,P007519,P013381,9.884,9,19,10
47,TEL,P007519,P013382,22.966,-9,43,52
47,TEL,P007519,P013389,12.501,1,23,22
47,TEL,P007855,P013381,0.133,-2,0,2
47,TEL,P007990,P011214,11.65,-8,19,27
47,TEL,P007990,P011219,8.6,-2,19,21
47,TEL,P007990,P013382,14.866,-8,28,36
47,TEL,P007990,P013389,4.834,2,11,9
47,TEL,P011214,P011219,7.734,2,13,11
47,TEL,P011214,P013381,5.701,4,11,7
47,TEL,P011214,P013382,16.617,-3,34,37
47,TEL,P011214,P013389,13.135,5,29,24
47,TEL,P011219,P013381,12.534,10,26,16
47,TEL,P011219,P013382,15.166,-1,33,34
47,TEL,P011219,P013389,15.201,1,30,29
47,TEL,P013381,P013382,10.55,8,27,19
47,TEL,P013381,P013389,12.234,7,28,21
47,TEL,P013382,P013389,15.717,3,38,35
47,ULK,P002849,P004004,2.633,-1,4,5
47,ULK,P002849,P006961,18.416,7,44,37
47,ULK,P002849,P007182,9.899,-2,16,18
47,ULK,P002849,P008962,11.817,13,36,23
47,ULK,P002849,P009783,6.834,1,17,16
47,ULK,P002849,P009863,8.833,-5,14,19
47,ULK,P002849,P010560,7.016,15,23,8
47,ULK,P002849,P011205,16.3,12,42,30
47,ULK,P002849,P013396,15.616,13,36,23
47,ULK,P002849,PLMG,3.5,3,8,5
47,ULK,P004004,P006961,1.45,-2,2,4
47,ULK,P004004,P008962,5.3,-1,12,13
47,ULK,P004004,P009783,6.483,0,14,14
47,ULK,P004004,P009863,7.933,-2,16,18
47,ULK,P004004,PLMG,7.933,-2,16,18
47,ULK,P006961,P007182,12.266,-6,18,24
47,ULK,P006961,P008962,18.151,-2,40,42
47,ULK,P006961,P009783,2.467,0,9,9
47,ULK,P006961,P009863,14.3,-18,16,34
47,ULK,P006961,P010560,8.65,6,21,15
47,ULK,P006961,P011205,19.65,-4,38,42
47,ULK,P006961,P013396,12.983,8,30,22
47,ULK,P006961,PLMG,3.867,-5,6,11
47,ULK,P007182,P008962,3.667,-6,4,10
47,ULK,P007182,P009783,1.3,-2,2,4
47,ULK,P007182,P009863,6.866,-13,4,17
47,ULK,P007182,P010560,0.667,-1,2,3
47,ULK,P007182,P011205,10.616,-4,16,20
47,ULK,P007182,P013396,8.983,2,18,16
47,ULK,P008962,P009783,8.484,-3,21,24
47,ULK,P008962,P009863,15.584,-11,26,37
47,ULK,P008962,P010560,11.083,12,29,17
47,ULK,P008962,P011205,16.634,-3,34,37
47,ULK,P008962,P013396,7.967,9,22,13
47,ULK,P008962,PLMG,7.717,-4,16,20
47,ULK,P009783,P009863,8.65,2,20,18
47,ULK,P009783,P011205,5.501,0,15,15
47,ULK,P009783,P013396,0.867,-2,0,2
47,ULK,P009783,PLMG,7.35,4,18,14
47,ULK,P009863,P010560,3.4,-2,4,6
47,ULK,P009863,P011205,12.734,-11,18,29
47,ULK,P009863,P013396,2.283,-3,2,5
47,ULK,P009863,PLMG,11.217,-1,24,25
47,ULK,P010560,P011205,6.416,7,15,8
47,ULK,P010560,P013396,7.1,11,22,11
47,ULK,P011205,P013396,9.333,10,22,12
47,ULK,P011205,PLMG,3.284,1,8,7
49,BER,P006251,P006919,3.467,0,7,7
49,BER,P006251,P008062,12.55,-12,25,37
49,BER,P006251,P008173,12.833,-2,29,31
49,BER,P006251,P008384,13.433,-8,24,32
49,BER,P006251,P008780,10.05,-8,15,23
49,BER,P006251,P011631,6.783,-1,14,15
49,BER,P006251,P012604,15.45,-12,28,40
49,BER,P006251,P012721,11.966,-1,22,23
49,BER,P006919,P008062,7.0,-3,14,17
49,BER,P006919,P008173,3.317,2,7,5
49,BER,P006919,P008384,16.884,3,39,36
49,BER,P006919,P008780,18.517,0,42,42
49,BER,P006919,P012604,16.317,4,38,34
49,BER,P006919,P012721,21.834,2,49,47
49,BER,P008062,P008173,9.533,-5,22,27
49,BER,P008062,P008384,6.4,-11,12,23
49,BER,P008062,P008780,8.6,-8,14,22
49,BER,P008062,P011631,6.783,-1,14,15
49,BER,P008062,P012604,11.95,-10,23,33
49,BER,P008062,P012721,9.716,-2,20,22
49,BER,P008173,P008384,7.317,-1,18,19
49,BER,P008173,P008780,1.25,1,3,2
49,BER,P008173,P011631,6.783,-1,14,15
49,BER,P008173,P012604,9.567,-5,22,27
49,BER,P008173,P012721,5.8,3,13,10
49,BER,P008384,P008780,22.2,-5,44,49
49,BER,P008384,P012604,23.934,-7,51,58
49,BER,P008384,P012721,22.9,1,48,47
49,BER,P008780,P012604,23.45,-2,47,49
49,BER,P008780,P012721,24.533,-2,51,53
49,BER,P011631,P012604,4.3,-2,8,10
49,BER,P011631,P012721,2.483,1,6,5
49,BER,P012604,P012721,22.1,2,47,45
49,PRS,P004197,P010390,12.583,10,36,26
49,PRS,P004197,P012608,12.583,10,36,26
49,PRS,P004197,P012609,0.133,0,0,0
49,PRS,P004197,P012610,12.45,10,36,26
49,PRS,P004197,P012613,12.583,10,36,26
49,PRS,P004512,P007032,8.983,-5,13,18
49,PRS,P004512,P012608,3.333,-7,6,13
49,PRS,P004512,P012609,12.316,-12,19,31
49,PRS,P004512,P012610,3.333,-7,6,13
49,PRS,P004512,P012613,3.333,-7,6,13
49,PRS,P004512,P012640,8.983,-5,13,18
49,PRS,P004512,P013373,8.983,-5,13,18
49,PRS,P007032,P010390,3.5,1,7,6
49,PRS,P007032,P012609,12.483,-4,20,24
49,PRS,P007032,P012640,12.483,-4,20,24
49,PRS,P007032,P013373,12.483,-4,20,24
49,PRS,P010390,P012608,21.666,23,61,38
49,PRS,P010390,P012609,3.633,1,7,6
49,PRS,P010390,P012610,21.533,23,61,38
49,PRS,P010390,P012613,21.666,23,61,38
49,PRS,P010390,P012640,12.583,14,32,18
49,PRS,P010390,P013373,3.5,1,7,6
49,PRS,P012608,P012609,5.983,-10,11,21
49,PRS,P012608,P012610,27.383,13,72,59
49,PRS,P012608,P012613,27.516,13,72,59
49,PRS,P012608,P012640,9.083,13,25,12
49,PRS,P012608,P013373,2.517,-3,5,8
49,PRS,P012609,P012610,5.85,-10,11,21
49,PRS,P012609,P012613,5.983,-10,11,21
49,PRS,P012609,P012640,12.483,-4,20,24
49,PRS,P012609,P013373,15.0,-7,25,32
49,PRS,P012610,P012613,27.383,13,72,59
49,PRS,P012610,P012640,9.083,13,25,12
49,PRS,P012610,P013373,2.517,-3,5,8
49,PRS,P012613,P012640,9.083,13,25,12
49,PRS,P012613,P013373,2.517,-3,5,8
49,PRS,P012640,P013373,12.483,-4,20,24
50,MAD,P003108,P003583,8.233,-10,12,22
50,MAD,P003108,P003733,10.883,-3,18,21
50,MAD,P003108,P005791,27.632,-1,51,52
50,MAD,P003108,P005928,21.549,-5,44,49
50,MAD,P003108,P006540,25.299,-4,47,51
50,MAD,P003108,P009005,28.515,0,56,56
50,MAD,P003108,P009213,8.183,-13,7,20
50,MAD,P003108,PTGB,13.166,-8,17,25
50,MAD,P003583,P003733,0.883,-5,0,5
50,MAD,P003583,P005928,5.183,1,12,11
50,MAD,P003583,P006540,8.233,-10,12,22
50,MAD,P003583,P009005,6.133,-3,12,15
50,MAD,P003583,P009213,2.1,-7,0,7
50,MAD,P003583,PTGB,2.167,-6,0,6
50,MAD,P003733,P005791,12.517,0,21,21
50,MAD,P003733,P005928,2.817,-2,4,6
50,MAD,P003733,P006540,3.833,-1,7,8
50,MAD,P003733,P009005,7.55,1,14,13
50,MAD,P003733,P009213,8.45,-8,10,18
50,MAD,P003733,PTGB,6.667,-2,10,12
50,MAD,P005791,P005928,17.983,-3,35,38
50,MAD,P005791,P006540,17.066,6,35,29
50,MAD,P005791,P009005,26.516,4,50,46
50,MAD,P005791,P009213,10.217,-5,13,18
50,MAD,P005791,PTGB,15.133,-1,23,24
50,MAD,P005928,P006540,15.216,2,35,33
50,MAD,P005928,P009005,22.883,1,47,46
50,MAD,P005928,P009213,2.65,-2,3,5
50,MAD,P005928,PTGB,4.383,0,8,8
50,MAD,P006540,P009005,20.249,-1,40,41
50,MAD,P006540,P009213,5.05,-3,7,10
50,MAD,P006540,PTGB,6.25,-5,5,10
50,MAD,P009005,P009213,4.967,-1,6,7
50,MAD,P009005,PTGB,13.783,3,23,20
50,MAD,P009213,PTGB,7.651,-9,6,15
50,OLY,P001255,P003469,15.166,-5,31,36
50,OLY,P001255,P007947,1.65,-1,2,3
50,OLY,P001255,P008811,10.633,-10,21,31
50,OLY,P001255,P008855,13.516,-4,29,33
50,OLY,P001255,P012878,4.533,5,10,5
50,OLY,P001255,P013380,15.166,-5,31,36
50,OLY,P003469,P003941,7.684,-7,10,17
50,OLY,P003469,P007853,14.184,-2,25,27
50,OLY,P003469,P007947,7.434,-6,9,15
50,OLY,P003469,P007982,2.95,-4,3,7
50,OLY,P003469,P008811,13.266,-5,30,35
50,OLY,P003469,P008829,6.717,-3,10,13
50,OLY,P003469,P008855,18.966,3,44,41
50,OLY,P003469,P012878,8.4,5,16,11
50,OLY,P003469,P013380,22.633,-4,46,50
50,OLY,P003941,P007853,7.684,-7,10,17
50,OLY,P003941,P007947,4.734,-3,7,10
50,OLY,P003941,P007982,2.95,-4,3,7
50,OLY,P003941,P008829,6.717,-3,10,13
50,OLY,P003941,P013380,0.967,-4,0,4
50,OLY,P007853,P007947,5.784,-5,7,12
50,OLY,P007853,P007982,13.299,13,26,13
50,OLY,P007853,P008811,9.366,17,24,7
50,OLY,P007853,P008829,17.366,14,33,19
50,OLY,P007853,P008855,10.316,19,27,8
50,OLY,P007853,P012878,7.783,5,14,9
50,OLY,P007853,P013380,13.55,6,26,20
50,OLY,P007947,P008829,3.767,1,7,6
50,OLY,P007947,P012878,2.7,-3,2,5
50,OLY,P007947,P013380,3.667,-7,2,9
50,OLY,P007982,P008811,6.433,12,15,3
50,OLY,P007982,P008829,13.299,13,26,13
50,OLY,P007982,P008855,4.566,12,12,0
50,OLY,P007982,P012878,3.916,5,8,3
50,OLY,P007982,P013380,5.783,5,11,6
50,OLY,P008811,P008829,6.733,12,15,3
50,OLY,P008811,P008855,16.849,4,39,35
50,OLY,P008811,P013380,16.716,-2,36,38
50,OLY,P008829,P008855,4.866,12,12,0
50,OLY,P008829,P012878,3.916,5,8,3
50,OLY,P008829,P013380,6.083,5,11,6
50,OLY,P008855,P012878,6.983,11,17,6
50,OLY,P008855,P013380,19.266,3,44,41
50,OLY,P012878,P013380,11.033,7,21,14
52,BAS,P008072,P010784,1.2,0,0,0
52,BAS,P008072,P011085,10.767,-1,28,29
52,BAS,P008072,P011948,24.3,7,62,55
52,BAS,P008072,P012058,15.25,9,34,25
52,BAS,P008072,P012080,14.733,8,34,26
52,BAS,P008072,P012201,10.25,-2,28,30
52,BAS,P008072,P012597,15.067,10,42,32
52,BAS,P008072,P013367,10.433,-3,20,23
52,BAS,P010784,P011196,8.666,-4,15,19
52,BAS,P010784,P012058,1.433,-1,0,1
52,BAS,P010784,P012080,9.866,-4,15,19
52,BAS,P010784,P012201,8.433,-3,15,18
52,BAS,P010784,P013367,9.866,-4,15,19
52,BAS,P011085,P011196,0.217,2,2,0
52,BAS,P011085,P011948,11.117,-1,28,29
52,BAS,P011085,P012058,5.8,2,13,11
52,BAS,P011085,P012080,0.401,2,2,0
52,BAS,P011085,P012201,6.051,-1,17,18
52,BAS,P011085,P012597,6.267,3,18,15
52,BAS,P011085,P013367,5.184,-2,12,14
52,BAS,P011196,P011948,5.15,0,9,9
52,BAS,P011196,P012058,0.233,-1,0,1
52,BAS,P011196,P012080,14.033,-2,26,28
52,BAS,P011196,P012201,13.8,-1,26,27
52,BAS,P011196,P013367,14.033,-2,26,28
52,BAS,P011948,P012058,14.333,9,34,25
52,BAS,P011948,P012080,18.75,8,43,35
52,BAS,P011948,P012201,15.75,-2,37,39
52,BAS,P011948,P012597,15.067,10,42,32
52,BAS,P011948,P013367,14.733,-3,29,32
52,BAS,P012058,P012080,10.2,6,21,15
52,BAS,P012058,P012201,0.4,0,0,0
52,BAS,P012058,P012597,8.634,9,23,14
52,BAS,P012058,P013367,7.249,-1,11,12
52,BAS,P012080,P012201,18.867,0,39,39
52,BAS,P012080,P012597,8.8,7,24,17
52,BAS,P012080,P013367,20.15,-1,36,37
52,BAS,P012201,P012597,6.433,1,19,18
52,BAS,P012201,P013367,18.084,-4,35,39
52,MIL,P000796,P001392,16.767,8,38,30
52,MIL,P000796,P001518,4.283,-4,9,13
52,MIL,P000796,P006085,5.4,6,13,7
52,MIL,P000796,P006509,4.183,0,12,12
52,MIL,P000796,P006721,4.467,0,7,7
52,MIL,P000796,P008985,23.5,-4,51,55
52,MIL,P000796,P008987,3.433,5,15,10
52,MIL,P000796,P011199,18.55,-2,38,40
52,MIL,P000796,P013384,25.217,3,57,54
52,MIL,P001392,P001518,0.283,0,0,0
52,MIL,P001392,P006085,7.5,7,18,11
52,MIL,P001392,P006509,3.55,-1,6,7
52,MIL,P001392,P006721,9.017,0,16,16
52,MIL,P001392,P008985,14.1,1,29,28
52,MIL,P001392,P008987,8.266,5,24,19
52,MIL,P001392,P011199,8.867,3,16,13
52,MIL,P001392,P013384,18.05,9,41,32
52,MIL,P001518,P006085,4.717,-8,7,15
52,MIL,P001518,P006509,6.966,-11,10,21
52,MIL,P001518,P008985,8.749,-9,16,25
52,MIL,P001518,P008987,5.733,-11,7,18
52,MIL,P001518,P011199,6.283,-13,9,22
52,MIL,P001518,P013384,3.05,-4,6,10
52,MIL,P006085,P006509,11.251,-6,20,26
52,MIL,P006085,P006721,9.017,3,16,13
52,MIL,P006085,P008985,6.9,0,14,14
52,MIL,P006085,P008987,13.517,-1,29,30
52,MIL,P006085,P011199,4.484,-4,7,11
52,MIL,P006085,P013384,8.95,7,20,13
52,MIL,P006509,P006721,6.534,2,13,11
52,MIL,P006509,P008985,9.649,-2,22,24
52,MIL,P006509,P008987,12.267,-9,20,29
52,MIL,P006509,P011199,6.183,-9,12,21
52,MIL,P006509,P013384,5.217,0,13,13
52,MIL,P006721,P008985,4.267,3,10,7
52,MIL,P006721,P008987,7.817,3,16,13
52,MIL,P006721,P013384,8.017,1,14,13
52,MIL,P008985,P008987,7.916,-1,19,20
52,MIL,P008985,P011199,18.516,-8,35,43
52,MIL,P008985,P013384,22.267,-4,48,52
52,MIL,P008987,P011199,2.0,-9,0,9
52,MIL,P008987,P013384,6.983,6,22,16
52,MIL,P011199,P013384,17.317,-2,35,37
54,MUN,P004508,P005460,4.283,2,9,7
54,MUN,P004508,P007056,9.55,-10,17,27
54,MUN,P004508,P007201,8.0,-13,12,25
54,MUN,P004508,P010391,9.95,-11,14,25
54,MUN,P004508,P011224,8.15,1,18,17
54,MUN,P004508,P011244,5.833,5,14,9
54,MUN,P004508,P011987,9.566,-6,20,26
54,MUN,P005460,P007056,3.85,5,12,7
54,MUN,P005460,P007201,0.05,0,2,2
54,MUN,P005460,P010391,15.616,8,33,25
54,MUN,P005460,P011224,16.132,11,34,23
54,MUN,P005460,P011244,14.699,1,28,27
54,MUN,P005460,P011987,11.283,-7,23,30
54,MUN,P005460,P012123,8.283,4,19,15
54,MUN,P007056,P007201,19.95,-6,44,50
54,MUN,P007056,P010391,23.75,-1,54,55
54,MUN,P007056,P011224,19.95,11,49,38
54,MUN,P007056,P011244,1.55,3,5,2
54,MUN,P007056,P011987,22.6,6,55,49
54,MUN,P007201,P010391,19.95,-6,44,50
54,MUN,P007201,P011224,14.6,3,34,31
54,MUN,P007201,P011987,17.25,-2,40,42
54,MUN,P010391,P011224,27.766,16,61,45
54,MUN,P010391,P011244,11.766,3,21,18
54,MUN,P010391,P011987,25.583,-7,54,61
54,MUN,P010391,P012123,7.683,6,19,13
54,MUN,P011224,P011244,13.849,9,29,20
54,MUN,P011224,P011987,22.316,8,52,44
54,MUN,P011224,P012123,6.233,9,15,6
54,MUN,P011244,P011987,9.016,-9,16,25
54,MUN,P011244,P012123,8.283,4,19,15
54,MUN,P011987,P012123,2.65,-7,4,11
54,VIR,P001133,P001844,5.249,-11,4,15
54,VIR,P001133,P002084,12.433,-6,28,34
54,VIR,P001133,P004888,23.716,-6,50,56
54,VIR,P001133,P005738,2.1,-3,4,7
54,VIR,P001133,P009549,26.433,-1,60,61
54,VIR,P001133,P012585,27.916,-1,62,63
54,VIR,P001133,P012591,3.766,-11,2,13
54,VIR,P001133,P013374,17.082,-3,32,35
54,VIR,P001133,PBCN,8.033,-6,14,20
54,VIR,P001844,P002084,9.566,-1,18,19
54,VIR,P001844,P004888,6.883,3,14,11
54,VIR,P001844,P005738,1.666,4,4,0
54,VIR,P001844,P009549,4.333,10,14,4
54,VIR,P001844,P012585,3.4,-3,4,7
54,VIR,P001844,P012591,4.249,-11,2,13
54,VIR,P001844,P013374,4.333,-6,4,10
54,VIR,P001844,PBCN,8.249,-1,16,17
54,VIR,P002084,P004888,12.566,2,30,28
54,VIR,P002084,P005738,1.666,4,4,0
54,VIR,P002084,P009549,15.516,14,44,30
54,VIR,P002084,P012585,13.1,1,32,31
54,VIR,P002084,P012591,3.316,-8,2,10
54,VIR,P002084,P013374,1.917,-3,2,5
54,VIR,P002084,PBCN,12.916,9,32,23
54,VIR,P004888,P005738,2.433,-3,4,7
54,VIR,P004888,P009549,27.299,2,62,60
54,VIR,P004888,P012585,27.216,-7,56,63
54,VIR,P004888,P013374,17.883,-3,34,37
54,VIR,P004888,PBCN,4.8,8,14,6
54,VIR,P005738,P009549,3.283,1,8,7
54,VIR,P005738,P012585,2.1,-3,4,7
54,VIR,P005738,P012591,0.483,0,0,0
54,VIR,P005738,PBCN,1.333,4,4,0
54,VIR,P009549,P012585,28.016,1,64,63
54,VIR,P009549,P013374,14.666,0,30,30
54,VIR,P009549,PBCN,9.85,17,30,13
54,VIR,P012585,P013374,18.066,-3,34,37
54,VIR,P012585,PBCN,5.85,7,16,9
54,VIR,P012591,P013374,0.933,-3,0,3
54,VIR,P012591,PBCN,4.249,-11,2,13
54,VIR,P013374,PBCN,1.116,-3,0,3
48,RED,P000848,P002553,9.317,-5,20,25
48,RED,P000848,P004007,10.216,5,24,19
48,RED,P000848,P004866,21.716,5,46,41
48,RED,P000848,P006240,18.682,19,42,23
48,RED,P000848,P009048,22.466,5,49,44
48,RED,P000848,P010612,11.916,14,28,14
48,RED,P000848,P012044,5.533,9,13,4
48,RED,P000848,P012786,12.15,4,26,22
48,RED,P002553,P004007,3.1,-2,8,10
48,RED,P002553,P004866,9.317,-5,20,25
48,RED,P002553,P009048,9.317,-5,20,25
48,RED,P002553,P012786,6.217,-3,12,15
48,RED,P004007,P004866,5.916,-12,10,22
48,RED,P004007,P006240,9.099,-1,18,19
48,RED,P004007,P009048,11.166,0,23,23
48,RED,P004007,P010612,2.316,-4,4,8
48,RED,P004007,P012044,1.033,-3,3,6
48,RED,P004007,P012786,5.95,5,14,9
48,RED,P004866,P006240,16.165,0,36,36
48,RED,P004866,P006436,1.15,-2,0,2
48,RED,P004866,P009048,20.649,-7,46,53
48,RED,P004866,P010612,17.165,2,38,36
48,RED,P004866,P011194,1.85,-2,2,4
48,RED,P004866,P012044,8.133,-2,20,22
48,RED,P004866,P012786,7.267,-5,14,19
48,RED,P006240,P006436,0.333,0,0,0
48,RED,P006240,P009048,16.232,5,38,33
48,RED,P006240,P010612,15.665,6,38,32
48,RED,P006240,P012044,7.666,2,22,20
48,RED,P006240,P012786,5.95,5,14,9
48,RED,P006436,P007960,5.267,-3,8,11
48,RED,P006436,P009048,0.333,0,0,0
48,RED,P006436,P010612,7.534,-6,10,16
48,RED,P006436,P011194,7.201,-6,10,16
48,RED,P006436,P012044,7.201,-6,10,16
48,RED,P006436,P012786,1.117,-1,2,3
48,RED,P007960,P010612,5.267,-3,8,11
48,RED,P007960,P011194,5.267,-3,8,11
48,RED,P007960,P012044,5.267,-3,8,11
48,RED,P009048,P010612,10.482,2,26,24
48,RED,P009048,P011194,1.033,0,2,2
48,RED,P009048,P012044,1.45,-2,8,10
48,RED,P009048,P012786,13.2,2,28,26
48,RED,P010612,P011194,8.234,-6,12,18
48,RED,P010612,P012044,14.867,-4,32,36
48,RED,P010612,P012786,2.15,-1,4,5
48,RED,P011194,P012044,7.201,-6,10,16
48,RED,P011194,P012786,2.15,-1,4,5
48,RED,P012044,P012786,1.117,-1,2,3
48,ZAL,P002329,P002676,5.966,1,12,11
48,ZAL,P002329,P003048,10.667,-4,18,22
48,ZAL,P002329,P005504,2.133,1,6,5
48,ZAL,P002329,P007029,5.933,-5,5,10
48,ZAL,P002329,P007513,15.483,2,34,32
48,ZAL,P002329,P007975,8.516,3,18,15
48,ZAL,P002329,P011051,5.216,2,10,8
48,ZAL,P002329,P011983,2.75,0,8,8
48,ZAL,P002329,P012622,7.583,-4,7,11
48,ZAL,P002329,P012715,7.817,0,18,18
48,ZAL,P002676,P003048,8.467,0,21,21
48,ZAL,P002676,P005504,5.849,5,18,13
48,ZAL,P002676,P007029,18.966,5,47,42
48,ZAL,P002676,P007513,19.617,2,45,43
48,ZAL,P002676,P007975,20.781,12,51,39
48,ZAL,P002676,P011051,14.15,-6,25,31
48,ZAL,P002676,P011983,3.067,-7,2,9
48,ZAL,P002676,P012622,14.933,4,35,31
48,ZAL,P003048,P007029,7.55,0,16,16
48,ZAL,P003048,P007513,16.251,-4,34,38
48,ZAL,P003048,P007975,5.333,3,11,8
48,ZAL,P003048,P011051,0.517,-5,0,5
48,ZAL,P003048,P011983,2.75,0,8,8
48,ZAL,P003048,P012622,13.534,-1,25,26
48,ZAL,P003048,P012715,5.067,-1,11,12
48,ZAL,P005504,P007029,4.316,4,12,8
48,ZAL,P005504,P007513,2.216,6,12,6
48,ZAL,P005504,P007975,5.849,5,18,13
48,ZAL,P005504,P012622,3.033,-1,6,7
48,ZAL,P007029,P007513,15.9,0,32,32
48,ZAL,P007029,P007975,12.865,8,34,26
48,ZAL,P007029,P011051,12.583,-5,23,28
48,ZAL,P007029,P011983,3.067,-7,2,9
48,ZAL,P007029,P012622,14.316,6,33,27
48,ZAL,P007029,P012715,0.9,-2,0,2
48,ZAL,P007513,P007975,14.299,13,39,26
48,ZAL,P007513,P011051,12.817,-5,21,26
48,ZAL,P007513,P011983,5.717,-4,10,14
48,ZAL,P007513,P012622,13.851,-4,23,27
48,ZAL,P007513,P012715,6.917,2,18,16
48,ZAL,P007975,P011051,12.349,5,29,24
48,ZAL,P007975,P011983,0.1,-3,0,3
48,ZAL,P007975,P012622,11.282,5,25,20
48,ZAL,P007975,P012715,2.75,1,7,6
48,ZAL,P011051,P011983,3.067,-7,2,9
48,ZAL,P011051,P012622,5.083,0,11,11
48,ZAL,P011051,P012715,2.75,1,7,6
48,ZAL,P011983,P012715,2.75,0,8,8
48,ZAL,P012622,P012715,2.317,-1,3,4
51,ASV,P000229,P002100,4.567,-1,9,10
51,ASV,P000229,P003526,5.217,-3,9,12
51,ASV,P000229,P007027,7.717,-8,9,17
51,ASV,P000229,P008991,7.901,-6,12,18
51,ASV,P000229,P010316,9.55,-2,18,20
51,ASV,P000229,P010545,1.133,-3,0,3
51,ASV,P000229,P012731,7.166,-2,10,12
51,ASV,P000229,P013371,2.183,0,2,2
51,ASV,P000229,P013372,10.0,-3,18,21
51,ASV,P000229,P013377,2.467,-2,5,7
51,ASV,P000229,PKIR,9.499,-2,16,18
51,ASV,P002100,P003526,5.833,1,13,12
51,ASV,P002100,P007027,0.467,-1,0,1
51,ASV,P002100,P008991,7.75,-1,19,20
51,ASV,P002100,P010316,9.766,2,18,16
51,ASV,P002100,P010545,4.666,2,6,4
51,ASV,P002100,P012731,1.9,-1,4,5
51,ASV,P002100,P013371,9.749,1,20,19
51,ASV,P002100,P013372,12.383,0,27,27
51,ASV,P002100,PKIR,0.183,-2,0,2
51,ASV,P003526,P007027,9.184,-15,11,26
51,ASV,P003526,P008991,6.267,-2,13,15
51,ASV,P003526,P010316,4.6,2,9,7
51,ASV,P003526,P010545,8.75,-12,11,23
51,ASV,P003526,P012731,4.25,-9,7,16
51,ASV,P003526,P013371,12.65,-11,22,33
51,ASV,P003526,P013372,6.267,-2,13,15
51,ASV,P003526,P013377,2.467,-2,5,7
51,ASV,P003526,PKIR,5.983,-3,11,14
51,ASV,P007027,P008991,5.234,-6,7,13
51,ASV,P007027,P010316,5.667,-5,9,14
51,ASV,P007027,P010545,14.533,-20,21,41
51,ASV,P007027,P012731,13.617,-20,19,39
51,ASV,P007027,P013371,13.4,-17,21,38
51,ASV,P007027,P013372,5.9,-3,9,12
51,ASV,P007027,PKIR,8.749,-5,14,19
51,ASV,P008991,P010316,4.267,-4,8,12
51,ASV,P008991,P012731,0.684,-2,0,2
51,ASV,P008991,P013371,5.083,-1,14,15
51,ASV,P008991,P013372,12.3,-5,26,31
51,ASV,P008991,PKIR,2.45,-1,5,6
51,ASV,P010316,P010545,9.733,1,15,14
51,ASV,P010316,P012731,9.666,-3,17,20
51,ASV,P010316,P013371,13.099,-1,20,21
51,ASV,P010316,P013372,8.016,0,16,16
51,ASV,P010316,P013377,2.467,-2,5,7
51,ASV,P010316,PKIR,5.033,0,9,9
51,ASV,P010545,P012731,11.583,-19,17,36
51,ASV,P010545,P013371,18.066,-15,27,42
51,ASV,P010545,P013372,2.733,2,4,2
51,ASV,P010545,PKIR,5.599,-8,7,15
51,ASV,P012731,P013371,12.633,-16,19,35
51,ASV,P012731,P013372,2.783,1,6,5
51,ASV,P012731,PKIR,6.182,-1,9,10
51,ASV,P013371,P013372,7.816,1,18,17
51,ASV,P013371,PKIR,6.649,-5,9,14
51,ASV,P013372,PKIR,3.066,1,7,6
51,ASV,P013377,PKIR,2.467,-2,5,7
51,PAN,P001926,P003842,12.3,6,28,22
51,PAN,P001926,P004088,6.0,2,15,13
51,PAN,P001926,P005161,10.983,9,27,18
51,PAN,P001926,P007866,7.717,3,19,16
51,PAN,P001926,P009622,6.3,4,13,9
51,PAN,P001926,P011204,1.317,-3,1,4
51,PAN,P001926,P012712,4.583,3,9,6
51,PAN,P003842,P004088,6.267,2,15,13
51,PAN,P003842,P005161,11.717,7,27,20
51,PAN,P003842,P007866,14.017,4,34,30
51,PAN,P003842,P009622,12.6,5,28,23
51,PAN,P003842,P011204,7.15,0,16,16
51,PAN,P003842,P011209,0.267,0,0,0
51,PAN,P003842,P012712,4.85,3,9,6
51,PAN,P003842,P012774,6.3,1,15,14
51,PAN,P004088,P005161,7.133,6,20,14
51,PAN,P004088,P005353,14.834,14,38,24
51,PAN,P004088,P007866,10.35,3,24,21
51,PAN,P004088,P009622,5.6,6,18,12
51,PAN,P004088,P011204,12.984,8,33,25
51,PAN,P004088,P011209,4.867,-2,7,9
51,PAN,P004088,P011221,2.85,0,7,7
51,PAN,P004088,P012712,13.367,15,36,21
51,PAN,P004088,P012774,11.084,14,27,13
51,PAN,P005161,P005353,5.75,3,10,7
51,PAN,P005161,P007866,7.567,4,18,14
51,PAN,P005161,P009622,9.65,3,19,16
51,PAN,P005161,P011204,2.867,2,4,2
51,PAN,P005161,P011209,3.134,2,4,2
51,PAN,P005161,P011221,1.8,0,2,2
51,PAN,P005161,P012712,8.1,6,17,11
51,PAN,P005161,P012774,1.167,-2,0,2
51,PAN,P005353,P007866,4.417,3,7,4
51,PAN,P005353,P009622,6.3,6,18,12
51,PAN,P005353,P011204,11.801,12,29,17
51,PAN,P005353,P011209,4.734,-1,4,5
51,PAN,P005353,P011221,1.917,-1,2,3
51,PAN,P005353,P012712,12.067,14,33,19
51,PAN,P005353,P012774,11.784,14,27,13
51,PAN,P007866,P009622,12.784,10,31,21
51,PAN,P007866,P011204,9.883,1,23,22
51,PAN,P007866,P011209,4.483,-1,7,8
51,PAN,P007866,P011221,2.733,1,7,6
51,PAN,P007866,P012774,10.717,4,22,18
51,PAN,P009622,P011204,7.283,3,20,17
51,PAN,P009622,P012712,6.116,1,15,14
51,PAN,P009622,P012774,8.967,6,22,16
51,PAN,P011204,P011209,5.717,2,11,9
51,PAN,P011204,P011221,4.65,0,9,9
51,PAN,P011204,P012712,9.884,13,27,14
51,PAN,P011204,P012774,13.2,14,35,21
51,PAN,P011209,P011221,4.65,0,9,9
51,PAN,P011209,P012712,1.334,2,2,0
51,PAN,P011209,P012774,1.75,-2,0,2
51,PAN,P012712,P012774,7.367,11,20,9
53,MCO,P002581,P005985,11.8,-7,21,28
53,MCO,P002581,P009754,10.9,-9,17,26
53,MCO,P002581,P011212,1.483,4,6,2
53,MCO,P002581,P011226,4.65,1,10,9
53,MCO,P002581,P011231,10.317,-11,15,26
53,MCO,P002581,P013365,0.9,2,4,2
53,MCO,P002581,PLCZ,7.15,-8,11,19
53,MCO,P005844,P005985,10.5,-5,16,21
53,MCO,P005844,P008099,13.716,10,30,20
53,MCO,P005844,P009754,4.166,0,7,7
53,MCO,P005844,P011212,21.35,7,41,34
53,MCO,P005844,P011226,23.249,5,46,41
53,MCO,P005844,P011231,3.35,-1,7,8
53,MCO,P005844,P013365,15.9,2,28,26
53,MCO,P005844,PLCZ,4.633,2,9,7
53,MCO,P005985,P009754,19.049,-2,36,38
53,MCO,P005985,P011212,11.2,3,22,19
53,MCO,P005985,P011226,16.083,1,33,32
53,MCO,P005985,P011231,17.65,-5,34,39
53,MCO,P005985,P013365,5.917,0,11,11
53,MCO,P005985,PLCZ,12.933,-5,23,28
53,MCO,P008099,P011212,13.716,10,30,20
53,MCO,P008099,P011226,13.716,10,30,20
53,MCO,P008099,P013365,10.883,4,21,17
53,MCO,P008099,PLCZ,2.833,6,9,3
53,MCO,P009754,P011212,3.966,6,9,3
53,MCO,P009754,P011226,8.849,4,20,16
53,MCO,P009754,P011231,16.533,-4,32,36
53,MCO,P009754,PLCZ,12.733,-3,23,26
53,MCO,P011212,P011226,21.866,11,47,36
53,MCO,P011212,P011231,3.2,1,7,6
53,MCO,P011212,P013365,16.8,4,32,28
53,MCO,P011212,PLCZ,6.083,6,14,8
53,MCO,P011226,P011231,8.417,1,18,17
53,MCO,P011226,P013365,16.8,4,32,28
53,MCO,P011226,PLCZ,5.566,7,16,9
53,MCO,P011231,PLCZ,11.133,-1,23,24
53,PAR,P004761,P006760,16.966,13,38,25
53,PAR,P004761,P007632,8.583,-1,14,15
53,PAR,P004761,P007870,11.35,-4,16,20
53,PAR,P004761,P008232,2.517,-5,3,8
53,PAR,P004761,P010781,13.1,12,31,19
53,PAR,P004761,P011836,3.383,-4,2,6
53,PAR,P004761,P011981,11.516,8,27,19
53,PAR,P004761,P012720,5.883,4,14,10
53,PAR,P004761,P013369,12.733,-5,20,25
53,PAR,P004761,P013370,5.433,-2,7,9
53,PAR,P006760,P007632,8.733,4,16,12
53,PAR,P006760,P007870,12.0,0,23,23
53,PAR,P006760,P008232,6.467,1,14,13
53,PAR,P006760,P010781,26.801,4,55,51
53,PAR,P006760,P011836,3.2,-1,7,8
53,PAR,P006760,P011981,21.867,4,46,42
53,PAR,P006760,P012720,19.784,-3,40,43
53,PAR,P006760,P013369,17.267,-6,32,38
53,PAR,P006760,P013370,2.383,0,5,5
53,PAR,P007632,P007870,9.45,-2,15,17
53,PAR,P007632,P008232,2.75,-5,3,8
53,PAR,P007632,P010781,7.483,3,14,11
53,PAR,P007632,P011981,2.033,1,4,3
53,PAR,P007632,P013369,6.9,-4,10,14
53,PAR,P007870,P008232,3.65,-7,5,12
53,PAR,P007870,P010781,7.833,1,14,13
53,PAR,P007870,P011836,6.583,-5,9,14
53,PAR,P007870,P012720,4.433,-5,9,14
53,PAR,P007870,P013369,12.983,-12,17,29
53,PAR,P007870,P013370,4.25,-2,4,6
53,PAR,P008232,P010781,6.7,1,14,13
53,PAR,P008232,P011981,5.567,3,12,9
53,PAR,P008232,P012720,6.467,1,14,13
53,PAR,P008232,P013369,2.75,-5,3,8
53,PAR,P010781,P011981,19.201,3,41,38
53,PAR,P010781,P012720,16.584,-2,33,35
53,PAR,P010781,P013369,10.434,-6,18,24
53,PAR,P011836,P012720,3.533,-3,7,10
53,PAR,P011836,P013369,6.583,-5,9,14
53,PAR,P011836,P013370,3.05,-2,2,4
53,PAR,P011981,P012720,15.684,0,31,31
53,PAR,P011981,P013369,10.417,-3,20,23
53,PAR,P011981,P013370,1.183,0,3,3
53,PAR,P012720,P013369,8.1,-12,12,24
53,PAR,P013369,P013370,5.433,-2,7,9
55,BER,P006251,P006919,8.517,1,20,19
55,BER,P006251,P007550,13.467,-5,24,29
55,BER,P006251,P008062,17.567,-14,30,44
55,BER,P006251,P008384,9.783,-9,15,24
55,BER,P006251,P008780,10.116,-3,23,26
55,BER,P006251,P011631,11.516,-13,17,30
55,BER,P006251,P012100,1.55,1,4,3
55,BER,P006251,P012604,10.601,-14,17,31
55,BER,P006251,P012721,12.283,0,26,26
55,BER,P006919,P007550,6.367,3,15,12
55,BER,P006919,P008062,4.851,-5,10,15
55,BER,P006919,P008384,17.0,0,28,28
55,BER,P006919,P008780,18.183,-4,31,35
55,BER,P006919,P011631,5.267,1,11,10
55,BER,P006919,P012100,1.55,1,4,3
55,BER,P006919,P012604,20.834,-6,33,39
55,BER,P006919,P012721,16.099,5,32,27
55,BER,P007550,P008062,11.4,-6,20,26
55,BER,P007550,P008384,5.233,1,9,8
55,BER,P007550,P008780,1.117,1,3,2
55,BER,P007550,P011631,7.816,-5,13,18
55,BER,P007550,P012100,1.55,1,4,3
55,BER,P007550,P012604,4.267,1,7,6
55,BER,P007550,P012721,7.783,1,13,12
55,BER,P008062,P008384,5.5,-9,6,15
55,BER,P008062,P008780,6.967,-3,15,18
55,BER,P008062,P011631,10.116,-10,15,25
55,BER,P008062,P012604,8.668,-11,14,25
55,BER,P008062,P012721,9.467,-2,18,20
55,BER,P008384,P008780,16.483,-9,25,34
55,BER,P008384,P011631,7.35,-13,6,19
55,BER,P008384,P012100,1.55,1,4,3
55,BER,P008384,P012604,16.784,-14,21,35
55,BER,P008384,P012721,12.249,0,22,22
55,BER,P008780,P011631,7.15,-3,11,14
55,BER,P008780,P012604,21.1,-12,36,48
55,BER,P008780,P012721,18.816,1,40,39
55,BER,P011631,P012604,7.384,-8,9,17
55,BER,P011631,P012721,8.333,-1,14,15
55,BER,P012604,P012721,17.366,0,35,35
55,IST,P004887,P006590,4.75,1,12,11
55,IST,P004887,P006640,1.067,2,4,2
55,IST,P004887,P007109,4.75,1,12,11
55,IST,P004887,P009513,3.683,-1,8,9
55,IST,P004887,P009664,4.75,1,12,11
55,IST,P004887,P009846,12.15,4,24,20
55,IST,P004887,P011078,12.15,4,24,20
55,IST,P004887,P012710,12.15,4,24,20
55,IST,P004887,P013363,12.15,4,24,20
55,IST,P006590,P006640,11.75,10,29,19
55,IST,P006590,P007109,17.766,4,35,31
55,IST,P006590,P009513,5.483,-4,8,12
55,IST,P006590,P009664,10.683,2,20,18
55,IST,P006590,P011078,1.283,-2,0,2
55,IST,P006590,P012710,0.75,0,2,2
55,IST,P006590,P012788,11.966,6,25,19
55,IST,P006590,P013363,7.833,2,17,15
55,IST,P006590,P013364,1.8,-3,0,3
55,IST,P006640,P007109,13.517,8,32,24
55,IST,P006640,P009513,1.55,-1,3,4
55,IST,P006640,P009664,5.467,7,15,8
55,IST,P006640,P009846,2.434,0,5,5
55,IST,P006640,P012710,2.217,1,5,4
55,IST,P006640,P012788,13.117,8,30,22
55,IST,P006640,P013363,10.267,2,22,20
55,IST,P006640,P013364,1.55,-1,3,4
55,IST,P007109,P009513,7.033,-5,11,16
55,IST,P007109,P009664,12.816,-3,23,26
55,IST,P007109,P009846,1.55,-5,2,7
55,IST,P007109,P011078,1.866,-6,0,6
55,IST,P007109,P012788,12.766,1,25,24
55,IST,P007109,P013363,8.05,1,17,16
55,IST,P007109,P013364,3.35,-4,3,7
55,IST,P009513,P009664,7.033,-5,11,16
55,IST,P009513,P013364,3.35,-4,3,7
55,IST,P009664,P009846,4.533,6,14,8
55,IST,P009664,P011078,5.816,4,14,10
55,IST,P009664,P012710,2.183,7,9,2
55,IST,P009664,P012788,8.666,10,22,12
55,IST,P009664,P013364,5.117,-1,8,9
55,IST,P009846,P011078,17.5,13,41,28
55,IST,P009846,P012710,16.617,15,39,24
55,IST,P009846,P012788,7.784,9,22,13
55,IST,P009846,P013363,15.401,7,32,25
55,IST,P009846,P013364,1.767,3,5,2
55,IST,P011078,P012710,15.15,14,36,22
55,IST,P011078,P012788,6.633,7,17,10
55,IST,P011078,P013363,12.967,7,27,20
55,IST,P011078,P013364,1.767,3,5,2
55,IST,P012710,P012788,5.217,11,17,6
55,IST,P012710,P013363,15.184,8,32,24
55,IST,P012788,P013363,11.084,5,25,20
55,IST,P012788,P013364,1.767,3,5,2
56,BAR,P000925,P002939,13.518,-9,17,26
56,BAR,P000925,P003478,0.617,2,2,0
56,BAR,P000925,P009862,13.084,-3,26,29
56,BAR,P000925,P009992,5.967,-10,7,17
56,BAR,P000925,P010106,6.45,0,20,20
56,BAR,P000925,P011666,6.0,-2,18,20
56,BAR,P000925,P012745,10.784,-3,16,19
56,BAR,P000925,P012795,7.934,-6,11,17
56,BAR,P000925,P013379,15.518,-5,31,36
56,BAR,P002939,P003196,5.334,-4,8,12
56,BAR,P002939,P003478,1.167,0,2,2
56,BAR,P002939,P009862,8.868,-5,11,16
56,BAR,P002939,P009992,9.067,-12,10,22
56,BAR,P002939,P011666,1.984,-2,3,5
56,BAR,P002939,P012745,11.551,-3,16,19
56,BAR,P002939,P012795,10.284,-8,14,22
56,BAR,P002939,P013379,13.635,-9,19,28
56,BAR,P003196,P003478,10.167,-6,20,26
56,BAR,P003196,P009862,6.134,-1,15,16
56,BAR,P003196,P009992,7.683,-6,11,17
56,BAR,P003196,P010106,9.0,-6,18,24
56,BAR,P003196,P011666,2.334,-5,3,8
56,BAR,P003196,P012745,8.067,-3,16,19
56,BAR,P003196,P012795,2.35,-2,3,5
56,BAR,P003196,P013379,6.267,-7,10,17
56,BAR,P003478,P006568,5.7,-2,11,13
56,BAR,P003478,P009862,11.384,1,25,24
56,BAR,P003478,P009992,4.583,-4,8,12
56,BAR,P003478,P010106,15.317,-6,31,37
56,BAR,P003478,P011666,0.517,-3,0,3
56,BAR,P003478,P012745,10.217,1,23,22
56,BAR,P003478,P013379,6.267,-7,10,17
56,BAR,P006568,P009862,5.7,-2,11,13
56,BAR,P006568,P010106,5.7,-2,11,13
56,BAR,P006568,P012745,5.7,-2,11,13
56,BAR,P009862,P010106,16.05,-1,41,42
56,BAR,P009862,P011666,7.067,-4,21,25
56,BAR,P009862,P012745,20.534,-10,36,46
56,BAR,P009862,P012795,1.05,0,0,0
56,BAR,P009862,P013379,9.801,1,22,21
56,BAR,P009992,P010106,4.583,-4,8,12
56,BAR,P009992,P011666,0.75,0,0,0
56,BAR,P009992,P012745,3.1,-2,3,5
56,BAR,P009992,P012795,8.317,-12,10,22
56,BAR,P009992,P013379,10.55,-14,15,29
56,BAR,P010106,P011666,6.35,-5,18,23
56,BAR,P010106,P012745,13.0,-5,27,32
56,BAR,P010106,P013379,8.15,-3,22,25
56,BAR,P011666,P012745,4.6,-8,7,15
56,BAR,P011666,P013379,3.734,1,14,13
56,BAR,P012745,P012795,4.317,2,7,5
56,BAR,P012745,P013379,6.334,1,10,9
56,BAR,P012795,P013379,6.884,-6,11,17
56,OLY,P001255,P003469,17.334,7,34,27
56,OLY,P001255,P003941,10.884,4,22,18
56,OLY,P001255,P007853,7.167,4,15,11
56,OLY,P001255,P007982,2.4,-2,2,4
56,OLY,P001255,P008811,4.183,1,8,7
56,OLY,P001255,P008855,14.934,9,32,23
56,OLY,P001255,P012878,2.267,2,4,2
56,OLY,P001255,P013380,10.167,3,19,16
56,OLY,P003469,P003941,10.884,4,22,18
56,OLY,P003469,P007853,9.833,8,23,15
56,OLY,P003469,P007947,3.133,2,5,3
56,OLY,P003469,P007982,8.333,2,15,13
56,OLY,P003469,P008811,8.383,5,18,13
56,OLY,P003469,P008829,4.167,4,10,6
56,OLY,P003469,P008855,15.834,13,37,24
56,OLY,P003469,P009849,3.7,6,13,7
56,OLY,P003469,P012878,4.9,6,12,6
56,OLY,P003469,P013380,10.167,3,19,16
56,OLY,P003941,P007853,2.567,-1,5,6
56,OLY,P003941,P007947,9.834,-2,26,28
56,OLY,P003941,P007982,2.667,-3,7,10
56,OLY,P003941,P008829,11.201,2,32,30
56,OLY,P003941,P008855,14.918,13,35,22
56,OLY,P003941,P009849,11.201,2,32,30
56,OLY,P003941,P013380,14.184,5,35,30
56,OLY,P007853,P007947,2.55,2,5,3
56,OLY,P007853,P007982,7.216,2,14,12
56,OLY,P007853,P008811,3.816,3,8,5
56,OLY,P007853,P008829,4.667,2,9,7
56,OLY,P007853,P008855,4.767,6,13,7
56,OLY,P007853,P009849,7.3,6,17,11
56,OLY,P007853,P012878,8.117,8,19,11
56,OLY,P007947,P007982,5.8,-1,12,13
56,OLY,P007947,P008811,3.133,2,5,3
56,OLY,P007947,P008829,14.001,2,34,32
56,OLY,P007947,P008855,2.667,5,7,2
56,OLY,P007947,P009849,10.901,0,29,29
56,OLY,P007947,P012878,1.067,2,3,1
56,OLY,P007947,P013380,3.05,-4,10,14
56,OLY,P007982,P008811,4.033,0,7,7
56,OLY,P007982,P008829,8.084,-3,16,19
56,OLY,P007982,P009849,7.617,-1,19,20
56,OLY,P007982,P012878,6.45,2,12,10
56,OLY,P008811,P008829,5.584,6,14,8
56,OLY,P008811,P008855,5.767,7,15,8
56,OLY,P008811,P009849,2.484,4,9,5
56,OLY,P008811,P013380,1.817,0,4,4
56,OLY,P008829,P008855,6.351,15,22,7
56,OLY,P008829,P009849,16.902,8,48,40
56,OLY,P008829,P012878,3.217,2,7,5
56,OLY,P008829,P013380,5.834,2,20,18
56,OLY,P008855,P009849,6.351,15,22,7
56,OLY,P008855,P012878,0.6,4,4,0
56,OLY,P008855,P013380,12.951,9,29,20
56,OLY,P009849,P012878,5.85,6,15,9
56,OLY,P009849,P013380,5.834,2,20,18
57,MIL,P000796,P001392,15.951,10,48,38
57,MIL,P000796,P001518,11.584,-8,14,22
57,MIL,P000796,P006085,11.784,9,38,29
57,MIL,P000796,P006509,13.234,7,42,35
57,MIL,P000796,P006721,2.1,5,5,0
57,MIL,P000796,P008985,13.034,-10,18,28
57,MIL,P000796,P008987,10.167,9,34,25
57,MIL,P000796,P011199,12.551,-15,17,32
57,MIL,P000796,P013384,8.867,-11,8,19
57,MIL,P001392,P001518,10.367,1,26,25
57,MIL,P001392,P006085,21.401,21,72,51
57,MIL,P001392,P006509,20.584,19,72,53
57,MIL,P001392,P006721,7.35,8,24,16
57,MIL,P001392,P008985,4.9,-3,12,15
57,MIL,P001392,P008987,19.267,20,69,49
57,MIL,P001392,P011199,5.384,-4,13,17
57,MIL,P001518,P006085,6.884,5,17,12
57,MIL,P001518,P006509,9.484,4,21,17
57,MIL,P001518,P006721,3.85,4,10,6
57,MIL,P001518,P008985,15.934,-10,23,33
57,MIL,P001518,P008987,11.234,3,26,23
57,MIL,P001518,P011199,14.318,-11,16,27
57,MIL,P001518,P013384,7.617,-8,7,15
57,MIL,P006085,P006509,20.868,22,67,45
57,MIL,P006085,P006721,5.25,3,19,16
57,MIL,P006085,P008987,19.751,24,67,43
57,MIL,P006085,P011199,4.534,0,8,8
57,MIL,P006509,P006721,3.5,4,14,10
57,MIL,P006509,P008985,5.8,-4,13,17
57,MIL,P006509,P008987,23.601,20,72,52
57,MIL,P006509,P011199,8.351,3,18,15
57,MIL,P006509,P013384,1.25,-3,1,4
57,MIL,P006721,P008985,2.1,5,5,0
57,MIL,P006721,P008987,5.25,3,19,16
57,MIL,P008985,P008987,5.6,-5,10,15
57,MIL,P008985,P011199,13.301,-10,19,29
57,MIL,P008985,P013384,8.867,-11,8,19
57,MIL,P008987,P011199,5.284,5,10,5
57,MIL,P008987,P013384,1.25,-3,1,4
57,MIL,P011199,P013384,7.617,-8,7,15
57,VIR,P001133,P002084,13.983,-13,28,41
57,VIR,P001133,P004888,20.916,-13,39,52
57,VIR,P001133,P009549,33.083,5,77,72
57,VIR,P001133,P011816,0.333,1,2,1
57,VIR,P001133,P012585,16.101,9,52,43
57,VIR,P001133,P012591,16.082,-8,23,31
57,VIR,P001133,P013374,15.85,9,33,24
57,VIR,P001133,PBCN,18.384,14,54,40
57,VIR,P002084,P004554,4.5,-7,7,14
57,VIR,P002084,P004888,13.666,-23,25,48
57,VIR,P002084,P005738,0.5,-3,0,3
57,VIR,P002084,P009549,16.15,-12,34,46
57,VIR,P002084,P011816,0.5,-2,0,2
57,VIR,P002084,P012585,14.117,-12,35,47
57,VIR,P002084,P012591,4.833,-9,6,15
57,VIR,P002084,P013374,0.267,0,0,0
57,VIR,P002084,PBCN,12.684,-11,29,40
57,VIR,P004554,P004888,3.05,-5,7,12
57,VIR,P004554,P009549,0.95,0,0,0
57,VIR,P004554,P011816,0.5,-2,0,2
57,VIR,P004554,P012585,4.5,-7,7,14
57,VIR,P004554,PBCN,4.5,-7,7,14
57,VIR,P004888,P005738,0.5,-3,0,3
57,VIR,P004888,P009549,21.866,-12,45,57
57,VIR,P004888,P011816,0.333,1,2,1
57,VIR,P004888,P012585,11.017,-6,35,41
57,VIR,P004888,P012591,12.999,-15,15,30
57,VIR,P004888,P013374,8.0,-3,11,14
57,VIR,P004888,PBCN,9.717,-5,29,34
57,VIR,P005738,P009549,0.5,-3,0,3
57,VIR,P005738,P012591,0.5,-3,0,3
57,VIR,P009549,P011816,0.333,1,2,1
57,VIR,P009549,P012585,17.768,13,58,45
57,VIR,P009549,P012591,16.582,-11,23,34
57,VIR,P009549,P013374,16.117,9,33,24
57,VIR,P009549,PBCN,20.051,18,60,42
57,VIR,P011816,P012585,0.5,-2,0,2
57,VIR,P011816,P012591,0.183,-1,0,1
57,VIR,P011816,PBCN,0.65,0,2,2
57,VIR,P012585,P013374,4.551,10,16,6
57,VIR,P012585,PBCN,19.118,3,57,54
57,VIR,P012591,P013374,11.566,-1,17,18
57,VIR,P012591,PBCN,3.583,4,8,4
57,VIR,P013374,PBCN,8.117,12,22,10
58,MAD,P003108,P003733,16.933,-7,35,42
58,MAD,P003108,P005791,29.651,10,67,57
58,MAD,P003108,P005928,23.583,2,51,49
58,MAD,P003108,P009005,23.083,8,56,48
58,MAD,P003108,P009213,10.816,-9,13,22
58,MAD,P003108,P011649,0.25,0,0,0
58,MAD,P003108,P012168,1.733,-3,2,5
58,MAD,P003108,P013378,9.9,1,20,19
58,MAD,P003108,PTGB,14.183,10,32,22
58,MAD,P003733,P005791,18.317,-6,38,44
58,MAD,P003733,P005928,20.117,-6,40,46
58,MAD,P003733,P009005,10.7,-1,27,28
58,MAD,P003733,P009213,11.283,-5,15,20
58,MAD,P003733,P011649,3.25,1,5,4
58,MAD,P005791,P005928,25.517,6,56,50
58,MAD,P005791,P009005,24.368,13,59,46
58,MAD,P005791,P009213,9.667,-5,13,18
58,MAD,P005791,P011649,4.384,-2,5,7
58,MAD,P005791,P013378,9.284,2,18,16
58,MAD,P005791,PTGB,14.084,14,32,18
58,MAD,P005928,P009005,19.883,6,45,39
58,MAD,P005928,P009213,13.266,-10,15,25
58,MAD,P005928,P011649,5.75,-1,7,8
58,MAD,P005928,P013378,1.2,0,2,2
58,MAD,P005928,PTGB,8.016,7,16,9
58,MAD,P009005,P009213,4.066,-5,2,7
58,MAD,P009005,P011649,7.717,-4,9,13
58,MAD,P009005,P012168,2.333,-4,4,8
58,MAD,P009005,P013378,11.617,-2,22,24
58,MAD,P009005,PTGB,18.433,5,36,31
58,MAD,P009213,P011649,2.95,-1,2,3
58,MAD,P009213,PTGB,2.016,-5,0,5
58,MAD,P011649,P012168,0.6,-1,2,3
58,MAD,P011649,P013378,1.717,-3,2,5
58,MAD,P011649,PTGB,4.25,-5,4,9
58,MAD,P012168,P013378,2.333,-4,4,8
58,MAD,P012168,PTGB,2.333,-4,4,8
58,MAD,P013378,PTGB,10.417,-2,20,22
58,TEL,P005145,P006835,4.683,-9,5,14
58,TEL,P005145,P007519,1.466,2,4,2
58,TEL,P005145,P007990,11.083,-3,21,24
58,TEL,P005145,P011214,9.333,-6,16,22
58,TEL,P005145,P011219,2.267,2,7,5
58,TEL,P005145,P013381,3.866,5,10,5
58,TEL,P005145,P013382,2.383,1,4,3
58,TEL,P005145,P013389,9.583,-4,17,21
58,TEL,P006835,P007519,27.133,8,54,46
58,TEL,P006835,P007990,6.717,-15,9,24
58,TEL,P006835,P011214,19.834,-15,32,47
58,TEL,P006835,P011219,13.567,10,31,21
58,TEL,P006835,P013381,21.701,5,43,38
58,TEL,P006835,P013382,26.083,4,48,44
58,TEL,P006835,P013389,14.35,-8,30,38
58,TEL,P007519,P007990,1.883,0,4,4
58,TEL,P007519,P011214,14.25,-2,25,27
58,TEL,P007519,P011219,14.117,12,33,21
58,TEL,P007519,P013381,19.884,9,39,30
58,TEL,P007519,P013382,27.233,6,52,46
58,TEL,P007519,P013389,7.966,5,21,16
58,TEL,P007990,P011214,10.95,-10,20,30
58,TEL,P007990,P011219,2.767,0,7,7
58,TEL,P007990,P013381,5.483,1,14,13
58,TEL,P007990,P013382,2.8,-1,4,5
58,TEL,P007990,P013389,11.117,-8,21,29
58,TEL,P011214,P011219,0.55,-1,2,3
58,TEL,P011214,P013381,11.9,-3,19,22
58,TEL,P011214,P013382,14.266,-3,23,26
58,TEL,P011214,P013389,17.317,-8,35,43
58,TEL,P011219,P013381,13.9,12,34,22
58,TEL,P011219,P013382,14.034,8,29,21
58,TEL,P011219,P013389,2.134,5,9,4
58,TEL,P013381,P013382,18.867,5,33,28
58,TEL,P013381,P013389,6.667,6,20,14
58,TEL,P013382,P013389,7.866,0,15,15
59,PAR,P004761,P006591,10.866,2,27,25
59,PAR,P004761,P006760,6.15,-4,12,16
59,PAR,P004761,P007632,5.3,-4,6,10
59,PAR,P004761,P007870,12.067,-5,23,28
59,PAR,P004761,P008232,7.0,1,12,11
59,PAR,P004761,P010781,7.317,-5,8,13
59,PAR,P004761,P011836,9.349,5,25,20
59,PAR,P004761,P011981,8.6,-3,14,17
59,PAR,P004761,P012720,5.417,-1,10,11
59,PAR,P004761,P013369,2.65,0,8,8
59,PAR,P004761,P013370,11.616,2,27,25
59,PAR,P006591,P006760,7.5,-4,10,14
59,PAR,P006591,P007632,1.734,-3,2,5
59,PAR,P006591,P007870,4.616,-6,9,15
59,PAR,P006591,P008232,15.017,-6,22,28
59,PAR,P006591,P010781,0.6,-3,0,3
59,PAR,P006591,P011836,12.116,1,27,26
59,PAR,P006591,P011981,8.217,1,16,15
59,PAR,P006591,P012720,3.3,-3,4,7
59,PAR,P006591,P013369,6.933,-1,10,11
59,PAR,P006591,P013370,13.633,-2,29,31
59,PAR,P006760,P007632,2.95,-4,4,8
59,PAR,P006760,P007870,9.333,-8,19,27
59,PAR,P006760,P008232,9.233,-7,13,20
59,PAR,P006760,P010781,6.983,-11,9,20
59,PAR,P006760,P011981,6.05,-3,6,9
59,PAR,P006760,P012720,8.35,-6,17,23
59,PAR,P006760,P013369,9.583,-1,18,19
59,PAR,P007632,P007870,4.367,-1,6,7
59,PAR,P007632,P008232,5.884,-4,12,16
59,PAR,P007632,P010781,11.134,-9,18,27
59,PAR,P007632,P011836,0.617,-2,0,2
59,PAR,P007632,P011981,9.667,-6,16,22
59,PAR,P007632,P012720,1.117,-1,2,3
59,PAR,P007632,P013369,5.817,0,14,14
59,PAR,P007632,P013370,0.617,-2,0,2
59,PAR,P007870,P008232,4.116,-7,7,14
59,PAR,P007870,P010781,8.917,-6,13,19
59,PAR,P007870,P011836,3.383,-3,7,10
59,PAR,P007870,P011981,3.467,-1,4,5
59,PAR,P007870,P012720,7.2,-5,15,20
59,PAR,P007870,P013369,3.883,-3,10,13
59,PAR,P007870,P013370,3.383,-3,7,10
59,PAR,P008232,P010781,8.5,-6,17,23
59,PAR,P008232,P011836,7.15,0,12,12
59,PAR,P008232,P011981,13.001,-5,20,25
59,PAR,P008232,P012720,6.133,-6,7,13
59,PAR,P008232,P013369,11.617,-5,20,25
59,PAR,P008232,P013370,9.417,-3,14,17
59,PAR,P010781,P011981,10.017,-6,16,22
59,PAR,P010781,P012720,5.5,-8,7,15
59,PAR,P010781,P013369,5.3,-2,12,14
59,PAR,P011836,P011981,1.583,4,8,4
59,PAR,P011836,P012720,2.15,-2,2,4
59,PAR,P011836,P013370,12.116,1,27,26
59,PAR,P011981,P012720,1.1,0,0,0
59,PAR,P011981,P013369,10.384,-2,18,20
59,PAR,P011981,P013370,3.85,1,10,9
59,PAR,P012720,P013369,3.233,2,10,8
59,PAR,P012720,P013370,2.9,-2,2,4
59,ULK,P002849,P004004,11.099,11,29,18
59,ULK,P002849,P006961,11.6,12,30,18
59,ULK,P002849,P008962,13.266,12,28,16
59,ULK,P002849,P009783,7.982,4,17,13
59,ULK,P002849,P009863,15.382,17,42,25
59,ULK,P002849,P010560,6.316,4,19,15
59,ULK,P002849,P011205,8.716,5,18,13
59,ULK,P002849,P013396,3.967,-1,5,6
59,ULK,P004004,P006961,14.266,9,36,27
59,ULK,P004004,P007182,3.85,4,8,4
59,ULK,P004004,P008962,7.099,3,17,14
59,ULK,P004004,P009783,2.266,3,5,2
59,ULK,P004004,P009863,8.566,13,27,14
59,ULK,P004004,P010560,11.016,6,28,22
59,ULK,P004004,P011205,1.083,-2,0,2
59,ULK,P004004,P013396,6.883,1,14,13
59,ULK,P006961,P007182,7.15,2,14,12
59,ULK,P006961,P008962,13.716,5,30,25
59,ULK,P006961,P009783,5.7,0,12,12
59,ULK,P006961,P009863,11.467,16,34,18
59,ULK,P006961,P010560,10.6,5,28,23
59,ULK,P006961,P011205,9.55,2,18,16
59,ULK,P006961,P013396,6.883,1,14,13
59,ULK,P007182,P008962,11.1,-2,19,21
59,ULK,P007182,P009783,11.917,-2,22,24
59,ULK,P007182,P009863,10.284,1,19,18
59,ULK,P007182,P010560,4.667,4,11,7
59,ULK,P007182,P011205,12.767,-4,22,26
59,ULK,P007182,P013396,1.333,5,5,0
59,ULK,P008962,P009783,20.183,4,38,34
59,ULK,P008962,P009863,22.25,16,50,34
59,ULK,P008962,P010560,2.25,-3,6,9
59,ULK,P008962,P011205,21.917,6,42,36
59,ULK,P008962,P013396,4.283,-5,6,11
59,ULK,P009783,P009863,19.666,6,41,35
59,ULK,P009783,P010560,3.45,0,11,11
59,ULK,P009783,P011205,20.7,1,42,41
59,ULK,P009863,P010560,7.15,4,21,17
59,ULK,P009863,P011205,20.167,7,42,35
59,ULK,P010560,P011205,3.3,-3,8,11
59,ULK,P010560,P013396,4.183,3,12,9
60,MCO,P002581,P005985,4.033,-5,2,7
60,MCO,P002581,P011212,4.033,-5,2,7
60,MCO,P002581,P011226,4.033,-5,2,7
60,MCO,P002581,P011231,1.283,-1,0,1
60,MCO,P002581,P013365,2.75,-4,2,6
60,MCO,P005844,P005985,10.466,-2,19,21
60,MCO,P005844,P008099,13.401,-5,16,21
60,MCO,P005844,P009754,10.483,1,21,20
60,MCO,P005844,P011212,12.017,-6,16,22
60,MCO,P005844,P011226,8.333,3,17,14
60,MCO,P005844,P011231,13.6,3,23,20
60,MCO,P005844,P013365,6.983,-5,8,13
60,MCO,P005844,PLCZ,3.117,-1,4,5
60,MCO,P005985,P008099,4.267,-4,4,8
60,MCO,P005985,P009754,25.682,8,48,40
60,MCO,P005985,P011212,6.916,-10,6,16
60,MCO,P005985,P011226,17.899,10,33,23
60,MCO,P005985,P011231,20.832,8,38,30
60,MCO,P005985,P013365,13.882,-11,17,28
60,MCO,P005985,PLCZ,19.483,6,33,27
60,MCO,P008099,P009754,4.284,-1,6,7
60,MCO,P008099,P011212,10.284,-4,12,16
60,MCO,P008099,P011226,4.15,-1,6,7
60,MCO,P008099,P011231,9.134,-1,12,13
60,MCO,P008099,P013365,4.967,-3,4,7
60,MCO,P008099,PLCZ,3.117,-1,4,5
60,MCO,P009754,P011212,2.9,-2,6,8
60,MCO,P009754,P011226,13.866,15,31,16
60,MCO,P009754,P011231,20.716,9,40,31
60,MCO,P009754,P013365,9.982,-4,15,19
60,MCO,P009754,PLCZ,19.483,6,33,27
60,MCO,P011212,P011226,8.183,-6,8,14
60,MCO,P011212,P011231,10.417,-2,12,14
60,MCO,P011212,P013365,9.45,-9,10,19
60,MCO,P011226,P011231,18.016,11,35,24
60,MCO,P011226,P013365,4.033,-2,4,6
60,MCO,P011226,PLCZ,9.683,11,20,9
60,MCO,P011231,P013365,10.783,-4,13,17
60,MCO,P011231,PLCZ,15.083,5,27,22
60,MCO,P013365,PLCZ,7.966,-2,11,13
60,ZAL,P002329,P002676,19.166,5,36,31
60,ZAL,P002329,P003048,3.483,-7,3,10
60,ZAL,P002329,P005504,10.867,-5,11,16
60,ZAL,P002329,P007029,4.2,-4,4,8
60,ZAL,P002329,P007513,14.7,1,28,27
60,ZAL,P002329,P007975,15.066,-7,15,22
60,ZAL,P002329,P011051,11.333,6,25,19
60,ZAL,P002329,P011983,9.983,-8,10,18
60,ZAL,P002329,P012622,7.617,-4,8,12
60,ZAL,P002329,P012715,7.649,-1,16,17
60,ZAL,P002676,P003048,5.0,-5,7,12
60,ZAL,P002676,P005504,10.418,5,15,10
60,ZAL,P002676,P007029,6.584,0,8,8
60,ZAL,P002676,P007513,12.967,4,27,23
60,ZAL,P002676,P007975,17.967,4,24,20
60,ZAL,P002676,P011051,11.45,8,25,17
60,ZAL,P002676,P011983,10.95,1,17,16
60,ZAL,P002676,P012622,5.517,6,10,4
60,ZAL,P002676,P012715,8.717,4,19,15
60,ZAL,P003048,P007029,0.083,0,0,0
60,ZAL,P003048,P007513,7.884,1,16,15
60,ZAL,P003048,P007975,4.116,-4,4,8
60,ZAL,P003048,P011983,11.917,-3,20,23
60,ZAL,P003048,P012622,7.6,4,15,11
60,ZAL,P003048,P012715,7.917,2,15,13
60,ZAL,P005504,P007029,7.468,-2,8,10
60,ZAL,P005504,P007513,2.534,-2,2,4
60,ZAL,P005504,P007975,11.734,-1,13,14
60,ZAL,P005504,P011051,0.017,0,0,0
60,ZAL,P005504,P011983,6.55,-1,7,8
60,ZAL,P005504,P012622,3.867,-8,0,8
60,ZAL,P005504,P012715,3.617,2,4,2
60,ZAL,P007029,P007513,2.284,-2,2,4
60,ZAL,P007029,P007975,5.267,0,6,6
60,ZAL,P007029,P011051,0.033,0,0,0
60,ZAL,P007029,P011983,0.033,0,0,0
60,ZAL,P007029,P012622,0.917,-2,0,2
60,ZAL,P007029,P012715,3.467,2,4,2
60,ZAL,P007513,P007975,3.783,0,4,4
60,ZAL,P007513,P011051,11.317,6,25,19
60,ZAL,P007513,P011983,7.884,1,16,15
60,ZAL,P007513,P012622,10.901,6,21,15
60,ZAL,P007513,P012715,13.95,5,31,26
60,ZAL,P007975,P011051,5.517,1,7,6
60,ZAL,P007975,P011983,12.65,-4,14,18
60,ZAL,P007975,P012622,6.4,-5,5,10
60,ZAL,P007975,P012715,4.3,0,4,4
60,ZAL,P011051,P011983,2.1,1,3,2
60,ZAL,P011051,P012622,5.851,5,11,6
60,ZAL,P011051,P012715,6.05,1,16,15
60,ZAL,P011983,P012622,12.367,-1,18,19
60,ZAL,P011983,P012715,7.834,2,15,13
60,ZAL,P012622,P012715,8.167,3,16,13
61,PAN,P001926,P003842,16.617,15,36,21
61,PAN,P001926,P004088,3.833,6,8,2
61,PAN,P001926,P005161,5.75,10,14,4
61,PAN,P001926,P005353,3.95,-1,4,5
61,PAN,P001926,P007866,5.65,4,18,14
61,PAN,P001926,P009622,16.184,10,32,22
61,PAN,P001926,P011204,18.75,8,43,35
61,PAN,P001926,P012712,20.467,8,44,36
61,PAN,P001926,P012774,13.667,12,33,21
61,PAN,P003842,P004088,3.966,6,8,2
61,PAN,P003842,P005161,13.733,0,21,21
61,PAN,P003842,P009622,21.733,0,39,39
61,PAN,P003842,P011204,16.6,5,35,30
61,PAN,P003842,P012712,19.617,1,36,35
61,PAN,P003842,P012774,10.934,9,25,16
61,PAN,P004088,P005161,3.783,6,8,2
61,PAN,P004088,P005353,4.2,-12,5,17
61,PAN,P004088,P009622,5.883,-5,8,13
61,PAN,P004088,P011204,2.416,-1,5,6
61,PAN,P004088,P012712,4.383,-12,5,17
61,PAN,P004088,P012774,4.2,-12,5,17
61,PAN,P005161,P009622,11.633,-4,15,19
61,PAN,P005161,P011204,4.716,-4,6,10
61,PAN,P005161,P012712,7.55,-8,7,15
61,PAN,P005161,P012774,7.767,0,13,13
61,PAN,P005353,P009622,4.084,-9,2,11
61,PAN,P005353,P011204,4.066,-4,7,11
61,PAN,P005353,P012712,8.15,-13,9,22
61,PAN,P005353,P012774,8.15,-13,9,22
61,PAN,P007866,P009622,1.867,6,9,3
61,PAN,P007866,P011204,4.583,6,17,11
61,PAN,P007866,P012712,6.05,8,22,14
61,PAN,P007866,P012774,6.05,8,22,14
61,PAN,P009622,P011204,12.933,0,28,28
61,PAN,P009622,P012712,23.601,-7,42,49
61,PAN,P009622,P012774,12.818,-3,25,28
61,PAN,P011204,P012712,22.716,5,53,48
61,PAN,P011204,P012774,14.216,13,42,29
61,PAN,P012712,P012774,22.734,2,50,48
61,RED,P000848,P002553,2.417,-6,2,8
61,RED,P000848,P004866,18.884,-13,26,39
61,RED,P000848,P006240,12.734,6,23,17
61,RED,P000848,P006436,6.2,-4,8,12
61,RED,P000848,P009048,16.635,-5,23,28
61,RED,P000848,P010612,6.751,-2,12,14
61,RED,P000848,P011194,7.217,-11,9,20
61,RED,P000848,P012044,5.65,-2,11,13
61,RED,P000848,P012786,8.5,1,17,16
61,RED,P000848,PJDR,4.484,-8,5,13
61,RED,P002553,P004007,2.883,1,5,4
61,RED,P002553,P004866,3.167,-5,3,8
61,RED,P002553,P006436,4.633,-1,12,13
61,RED,P002553,P009048,1.567,-6,0,6
61,RED,P002553,P010612,3.883,1,12,11
61,RED,P002553,P012044,7.616,2,19,17
61,RED,P002553,P012786,4.55,-3,7,10
61,RED,P002553,PJDR,6.016,1,16,15
61,RED,P004007,P004866,4.933,-5,8,13
61,RED,P004007,P006240,5.35,-3,10,13
61,RED,P004007,P010612,4.933,-5,8,13
61,RED,P004007,P012044,8.233,-2,15,17
61,RED,P004007,P012786,3.3,3,7,4
61,RED,P004007,PJDR,3.3,3,7,4
61,RED,P004866,P006240,17.6,1,31,30
61,RED,P004866,P006436,6.45,-9,5,14
61,RED,P004866,P009048,18.835,-8,25,33
61,RED,P004866,P010612,14.05,-10,22,32
61,RED,P004866,P011194,6.917,-16,5,21
61,RED,P004866,P012044,8.766,-8,14,22
61,RED,P004866,P012786,7.2,3,15,12
61,RED,P004866,PJDR,3.934,-10,2,12
61,RED,P006240,P006436,1.95,-2,2,4
61,RED,P006240,P009048,12.734,6,23,17
61,RED,P006240,P010612,8.817,-2,14,16
61,RED,P006240,P012044,5.35,-3,10,13
61,RED,P006240,P012786,7.25,7,17,10
61,RED,P006240,PJDR,0.551,2,2,0
61,RED,P006436,P009048,3.967,-8,2,10
61,RED,P006436,P010612,8.7,11,29,18
61,RED,P006436,P011194,7.2,9,20,11
61,RED,P006436,P012044,9.816,14,32,18
61,RED,P006436,PJDR,6.216,14,26,12
61,RED,P009048,P010612,6.151,0,8,8
61,RED,P009048,P011194,4.601,-8,2,10
61,RED,P009048,P012786,7.2,3,15,12
61,RED,P009048,PJDR,3.918,-6,2,8
61,RED,P010612,P011194,8.384,3,22,19
61,RED,P010612,P012044,14.85,6,40,34
61,RED,P010612,PJDR,7.817,6,25,19
61,RED,P011194,P012044,8.05,9,23,14
61,RED,P011194,PJDR,8.567,2,19,17
61,RED,P012044,P012786,4.6,1,9,8
61,RED,P012044,PJDR,11.133,15,35,20
61,RED,P012786,PJDR,4.6,1,9,8
62,ASV,P000229,P002100,4.65,0,12,12
62,ASV,P000229,P003526,5.883,0,11,11
62,ASV,P000229,P007027,9.883,-4,19,23
62,ASV,P000229,P010545,11.783,-5,23,28
62,ASV,P000229,P012731,5.4,-3,12,15
62,ASV,P000229,P013371,3.15,-6,4,10
62,ASV,P000229,P013372,5.883,0,11,11
62,ASV,P000229,PKIR,0.5,-2,0,2
62,ASV,P002100,P003526,10.284,8,26,18
62,ASV,P002100,P007027,16.267,2,30,28
62,ASV,P002100,P008991,5.384,-11,4,15
62,ASV,P002100,P010316,9.701,-11,16,27
62,ASV,P002100,P010545,16.933,3,34,31
62,ASV,P002100,P012731,11.75,-1,24,25
62,ASV,P002100,P013371,11.784,-5,25,30
62,ASV,P002100,P013372,14.051,6,33,27
62,ASV,P002100,PKIR,11.4,-3,16,19
62,ASV,P003526,P007027,14.5,5,28,23
62,ASV,P003526,P010316,2.0,1,9,8
62,ASV,P003526,P010545,14.5,5,28,23
62,ASV,P003526,P012731,1.35,0,4,4
62,ASV,P003526,P013371,2.0,1,9,8
62,ASV,P003526,P013372,13.7,2,31,29
62,ASV,P003526,PKIR,1.783,2,2,0
62,ASV,P007027,P008991,3.35,-3,3,6
62,ASV,P007027,P010316,6.4,-4,8,12
62,ASV,P007027,P010545,23.433,-1,43,44
62,ASV,P007027,P012731,9.517,-7,15,22
62,ASV,P007027,P013371,1.25,-5,0,5
62,ASV,P007027,P013372,15.883,1,29,28
62,ASV,P007027,PKIR,11.049,-8,9,17
62,ASV,P008991,P010316,8.267,-14,7,21
62,ASV,P008991,P012731,4.733,-8,3,11
62,ASV,P008991,P013371,4.917,-11,4,15
62,ASV,P008991,PKIR,6.417,-9,7,16
62,ASV,P010316,P010545,3.383,-1,5,6
62,ASV,P010316,P012731,7.283,-14,3,17
62,ASV,P010316,P013371,8.117,-12,13,25
62,ASV,P010316,P013372,4.067,2,14,12
62,ASV,P010316,PKIR,8.85,-11,9,20
62,ASV,P010545,P012731,7.767,-3,16,19
62,ASV,P010545,P013371,3.483,-6,4,10
62,ASV,P010545,P013372,14.783,3,29,26
62,ASV,P010545,PKIR,6.599,-3,6,9
62,ASV,P012731,P013371,8.3,-7,12,19
62,ASV,P012731,P013372,4.4,0,8,8
62,ASV,P012731,PKIR,7.1,-1,11,12
62,ASV,P013371,P013372,4.967,5,17,12
62,ASV,P013371,PKIR,5.5,-2,12,14
62,ASV,P013372,PKIR,5.666,5,12,7
62,MUN,P004508,P005460,3.567,7,9,2
62,MUN,P004508,P007056,18.75,5,42,37
62,MUN,P004508,P007201,22.583,-1,46,47
62,MUN,P004508,P010391,17.033,5,35,30
62,MUN,P004508,P011052,2.617,-6,4,10
62,MUN,P004508,P011224,8.4,8,21,13
62,MUN,P004508,P011244,11.2,3,23,20
62,MUN,P004508,P011987,24.483,0,51,51
62,MUN,P004508,P012123,3.567,7,9,2
62,MUN,P005460,P010391,1.3,2,2,0
62,MUN,P005460,P011052,3.067,7,11,4
62,MUN,P005460,P011224,11.317,20,27,7
62,MUN,P005460,P011244,11.317,20,27,7
62,MUN,P005460,P011987,3.383,4,5,1
62,MUN,P005460,P012123,11.317,20,27,7
62,MUN,P007056,P007201,19.566,-2,37,39
62,MUN,P007056,P010391,15.216,3,28,25
62,MUN,P007056,P011052,2.617,-6,4,10
62,MUN,P007056,P011224,5.416,0,10,10
62,MUN,P007056,P011244,1.9,1,5,4
62,MUN,P007056,P011987,19.683,1,42,41
62,MUN,P007056,P012123,2.716,-6,0,6
62,MUN,P007201,P010391,19.749,-1,35,36
62,MUN,P007201,P011052,2.617,-6,4,10
62,MUN,P007201,P011224,4.716,-2,7,9
62,MUN,P007201,P011244,5.733,-5,9,14
62,MUN,P007201,P011987,23.516,-5,46,51
62,MUN,P007201,P012123,2.716,-6,0,6
62,MUN,P007639,P011052,1.483,-1,6,7
62,MUN,P007639,P011987,1.483,-1,6,7
62,MUN,P007639,P012123,1.483,-1,6,7
62,MUN,P007639,P013368,1.483,-1,6,7
62,MUN,P010391,P011224,3.083,0,2,2
62,MUN,P010391,P011244,5.833,-2,9,11
62,MUN,P010391,P011987,17.966,1,35,34
62,MUN,P010391,P012123,4.016,-4,2,6
62,MUN,P011052,P011224,3.067,7,11,4
62,MUN,P011052,P011244,3.067,7,11,4
62,MUN,P011052,P011987,4.1,-7,10,17
62,MUN,P011052,P012123,4.55,6,17,11
62,MUN,P011052,P013368,1.483,-1,6,7
62,MUN,P011224,P011244,14.417,20,34,14
62,MUN,P011224,P011987,8.216,5,17,12
62,MUN,P011224,P012123,13.1,18,27,9
62,MUN,P011244,P011987,11.016,0,19,19
62,MUN,P011244,P012123,11.317,20,27,7
62,MUN,P011987,P012123,5.799,-1,11,12
62,MUN,P011987,P013368,1.483,-1,6,7
62,MUN,P012123,P013368,1.483,-1,6,7
63,BAS,P004058,P008072,12.934,0,20,20
63,BAS,P004058,P011085,10.383,3,14,11
63,BAS,P004058,P011196,6.549,2,11,9
63,BAS,P004058,P011948,12.333,-5,16,21
63,BAS,P004058,P012058,4.084,-7,4,11
63,BAS,P004058,P012080,13.65,3,25,22
63,BAS,P004058,P012201,10.9,5,19,14
63,BAS,P004058,P012597,2.65,-1,2,3
63,BAS,P004058,P013367,4.517,8,13,5
63,BAS,P008072,P011085,11.633,-3,14,17
63,BAS,P008072,P011948,9.317,-7,12,19
63,BAS,P008072,P012058,4.751,-7,6,13
63,BAS,P008072,P012080,10.0,3,18,15
63,BAS,P008072,P012201,7.483,3,12,9
63,BAS,P008072,P012597,4.583,-5,4,9
63,BAS,P008072,P013367,3.567,8,10,2
63,BAS,P011085,P011196,4.283,2,10,8
63,BAS,P011085,P011948,11.1,0,20,20
63,BAS,P011085,P012058,3.884,0,6,6
63,BAS,P011085,P012080,6.716,4,10,6
63,BAS,P011085,P012201,7.533,-5,10,15
63,BAS,P011085,P012597,7.2,-4,8,12
63,BAS,P011085,P013367,1.0,-1,4,5
63,BAS,P011196,P011948,21.333,-2,36,38
63,BAS,P011196,P012080,20.766,0,33,33
63,BAS,P011196,P012201,23.233,-2,39,41
63,BAS,P011196,P012597,3.067,-1,4,5
63,BAS,P011196,P013367,16.433,1,31,30
63,BAS,P011948,P012058,4.751,-7,6,13
63,BAS,P011948,P012080,24.066,-5,36,41
63,BAS,P011948,P012201,21.383,-6,34,40
63,BAS,P011948,P012597,2.834,-5,4,9
63,BAS,P011948,P013367,15.483,1,28,27
63,BAS,P012058,P012080,0.867,-7,0,7
63,BAS,P012058,P012597,0.667,0,2,2
63,BAS,P012080,P012201,25.4,6,43,37
63,BAS,P012080,P012597,2.667,-2,2,4
63,BAS,P012080,P013367,19.0,10,37,27
63,BAS,P012201,P012597,7.0,-6,6,12
63,BAS,P012201,P013367,20.0,9,41,32
63,PRS,P004197,P004512,0.433,-2,0,2
63,PRS,P004197,P010390,12.2,5,23,18
63,PRS,P004197,P012608,12.716,3,23,20
63,PRS,P004197,P012610,12.716,3,23,20
63,PRS,P004197,P012613,12.716,3,23,20
63,PRS,P004197,P012640,0.083,0,0,0
63,PRS,P004512,P005793,3.65,5,7,2
63,PRS,P004512,P007032,4.55,4,6,2
63,PRS,P004512,P012608,8.45,1,13,12
63,PRS,P004512,P012609,10.217,5,17,12
63,PRS,P004512,P012610,8.45,1,13,12
63,PRS,P004512,P012613,9.0,5,17,12
63,PRS,P004512,P012640,3.65,5,7,2
63,PRS,P005793,P007032,14.1,-2,23,25
63,PRS,P005793,P012608,1.75,-5,0,5
63,PRS,P005793,P012609,12.9,7,27,20
63,PRS,P005793,P012610,1.75,-5,0,5
63,PRS,P005793,P012613,2.3,-1,4,5
63,PRS,P005793,P012640,12.9,7,27,20
63,PRS,P005793,P013373,9.25,2,20,18
63,PRS,P007032,P012608,5.467,-2,7,9
63,PRS,P007032,P012609,12.35,3,23,20
63,PRS,P007032,P012610,5.467,-2,7,9
63,PRS,P007032,P012613,5.467,-2,7,9
63,PRS,P007032,P012640,12.367,3,23,20
63,PRS,P007032,P013373,11.5,2,24,22
63,PRS,P010390,P012608,14.55,-1,23,24
63,PRS,P010390,P012610,14.55,-1,23,24
63,PRS,P010390,P012613,14.55,-1,23,24
63,PRS,P010390,P012640,2.35,-6,0,6
63,PRS,P012608,P012609,6.567,0,10,10
63,PRS,P012608,P012610,27.1,-5,40,45
63,PRS,P012608,P012613,27.1,-5,40,45
63,PRS,P012608,P012640,2.45,-6,0,6
63,PRS,P012608,P013373,2.25,0,4,4
63,PRS,P012609,P012610,6.567,0,10,10
63,PRS,P012609,P012613,7.117,4,14,10
63,PRS,P012609,P012640,12.9,7,27,20
63,PRS,P012609,P013373,9.25,2,20,18
63,PRS,P012610,P012613,27.1,-5,40,45
63,PRS,P012610,P012640,2.45,-6,0,6
63,PRS,P012610,P013373,2.25,0,4,4
63,PRS,P012613,P012640,3.0,-2,4,6
63,PRS,P012613,P013373,2.25,0,4,4
63,PRS,P012640,P013373,9.25,2,20,18
65,BER,P006251,P006919,10.399,-12,14,26
65,BER,P006251,P007025,3.251,4,7,3
65,BER,P006251,P007550,10.45,-3,16,19
65,BER,P006251,P008062,11.633,4,22,18
65,BER,P006251,P008211,6.1,-2,7,9
65,BER,P006251,P008384,15.851,-3,35,38
65,BER,P006251,P008780,12.084,0,27,27
65,BER,P006251,P011631,11.035,0,24,24
65,BER,P006251,P012099,0.0,0,0,0
65,BER,P006251,P012100,1.25,0,3,3
65,BER,P006251,P012604,8.083,0,17,17
65,BER,P006919,P007025,2.95,2,4,2
65,BER,P006919,P007550,4.999,-3,5,8
65,BER,P006919,P008062,14.55,-10,24,34
65,BER,P006919,P008211,6.766,0,7,7
65,BER,P006919,P008384,12.75,-20,22,42
65,BER,P006919,P008780,17.134,-13,32,45
65,BER,P006919,P011631,3.234,1,10,9
65,BER,P006919,P012604,15.75,-9,30,39
65,BER,P007025,P007550,5.634,-6,3,9
65,BER,P007025,P008211,5.8,-7,2,9
65,BER,P007025,P008384,8.184,-9,14,23
65,BER,P007025,P008780,6.3,-2,13,15
65,BER,P007025,P011631,6.934,-2,12,14
65,BER,P007025,P012604,8.683,-12,9,21
65,BER,P007550,P008062,3.033,-1,3,4
65,BER,P007550,P008211,8.55,-10,7,17
65,BER,P007550,P008384,8.967,-12,11,23
65,BER,P007550,P011631,3.851,-3,3,6
65,BER,P007550,P012099,0.0,0,0,0
65,BER,P007550,P012100,1.25,0,3,3
65,BER,P007550,P012604,8.066,-6,13,19
65,BER,P008062,P008211,2.133,-2,0,2
65,BER,P008062,P008384,14.667,-4,33,37
65,BER,P008062,P008780,17.384,-1,38,39
65,BER,P008062,P011631,6.967,9,20,11
65,BER,P008062,P012604,11.301,-3,24,27
65,BER,P008211,P008384,3.817,-11,2,13
65,BER,P008211,P008780,3.05,-1,2,3
65,BER,P008211,P011631,1.734,-5,0,5
65,BER,P008211,P012604,8.45,-6,9,15
65,BER,P008384,P008780,19.634,-13,45,58
65,BER,P008384,P011631,11.351,-5,26,31
65,BER,P008384,P012100,1.25,0,3,3
65,BER,P008384,P012604,17.933,-23,33,56
65,BER,P008780,P011631,12.134,2,31,29
65,BER,P008780,P012604,17.484,-12,32,44
65,BER,P011631,P012099,0.0,0,0,0
65,BER,P011631,P012100,0.75,0,0,0
65,BER,P011631,P012604,5.95,-1,10,11
65,BER,P012099,P012100,0.0,0,0,0
65,BER,P012100,P012604,0.5,0,3,3
65,RED,P000848,P002553,2.433,3,5,2
65,RED,P000848,P004866,16.633,13,39,26
65,RED,P000848,P006240,10.867,8,30,22
65,RED,P000848,P006436,10.15,7,22,15
65,RED,P000848,P009048,14.983,16,40,24
65,RED,P000848,P010612,1.95,2,4,2
65,RED,P000848,P011194,4.233,4,6,2
65,RED,P000848,P012044,2.55,-1,1,2
65,RED,P000848,P012786,6.333,8,17,9
65,RED,P002553,P004866,2.416,4,6,2
65,RED,P002553,P007960,3.283,1,6,5
65,RED,P002553,P009048,5.083,6,8,2
65,RED,P002553,P010612,8.133,4,12,8
65,RED,P002553,P012044,4.75,-1,7,8
65,RED,P002553,P012786,5.333,1,6,5
65,RED,P002553,PJDR,7.233,2,10,8
65,RED,P004866,P006240,12.117,8,33,25
65,RED,P004866,P006436,13.567,8,31,23
65,RED,P004866,P009048,24.716,28,70,42
65,RED,P004866,P010612,11.683,14,34,20
65,RED,P004866,P011194,12.733,15,32,17
65,RED,P004866,P012044,2.55,-1,1,2
65,RED,P004866,P012786,11.766,16,35,19
65,RED,P004866,PJDR,0.883,3,3,0
65,RED,P006240,P006436,5.917,3,16,13
65,RED,P006240,P009048,12.117,8,33,25
65,RED,P006240,P010612,2.3,0,5,5
65,RED,P006240,P012786,5.15,5,15,10
65,RED,P006436,P009048,11.017,9,30,21
65,RED,P006436,P010612,3.417,1,9,8
65,RED,P006436,P011194,7.65,5,15,10
65,RED,P006436,P012044,2.55,-1,1,2
65,RED,P007960,P010612,5.1,-4,9,13
65,RED,P007960,P011194,1.817,-5,3,8
65,RED,P007960,P012044,5.1,-4,9,13
65,RED,P007960,PJDR,5.1,-4,9,13
65,RED,P009048,P010612,17.2,14,43,29
65,RED,P009048,P011194,13.033,14,38,24
65,RED,P009048,P012044,0.167,0,0,0
65,RED,P009048,P012786,17.116,16,44,28
65,RED,P009048,PJDR,5.5,1,10,9
65,RED,P010612,P011194,13.984,4,38,34
65,RED,P010612,P012044,7.384,-6,12,18
65,RED,P010612,P012786,13.8,8,32,24
65,RED,P010612,PJDR,12.717,-5,22,27
65,RED,P011194,P012044,5.184,-6,6,12
65,RED,P011194,P012786,8.75,8,26,18
65,RED,P011194,PJDR,5.484,-7,12,19
65,RED,P012044,P012786,2.117,-2,3,5
65,RED,P012044,PJDR,7.384,-6,12,18
65,RED,P012786,PJDR,6.567,-4,10,14
66,MAD,P003108,P003583,9.516,-8,15,23
66,MAD,P003108,P003733,4.1,1,6,5
66,MAD,P003108,P005791,16.333,12,38,26
66,MAD,P003108,P005928,23.815,0,46,46
66,MAD,P003108,P009005,19.099,3,43,40
66,MAD,P003108,P009213,10.216,-1,18,19
66,MAD,P003108,P011649,3.883,-8,6,14
66,MAD,P003108,P013378,13.183,2,27,25
66,MAD,P003108,PTGB,10.183,11,29,18
66,MAD,P003583,P003733,7.65,-5,12,17
66,MAD,P003583,P005928,11.032,-13,15,28
66,MAD,P003583,P009005,15.116,-13,27,40
66,MAD,P003583,P009213,0.25,0,0,0
66,MAD,P003583,P011649,3.883,-8,6,14
66,MAD,P003583,P013378,4.867,0,12,12
66,MAD,P003583,PTGB,9.15,-5,21,26
66,MAD,P003733,P005791,7.65,1,13,12
66,MAD,P003733,P005928,8.483,-1,15,16
66,MAD,P003733,P009005,16.334,-11,25,36
66,MAD,P003733,P009213,6.75,-7,7,14
66,MAD,P003733,P013378,2.684,-10,3,13
66,MAD,P003733,PTGB,12.417,-12,19,31
66,MAD,P005791,P005928,16.333,12,38,26
66,MAD,P005791,P009005,13.45,12,31,19
66,MAD,P005791,P009213,13.583,0,21,21
66,MAD,P005791,P013378,8.05,0,14,14
66,MAD,P005791,PTGB,11.333,11,25,14
66,MAD,P005928,P009005,19.715,-2,41,43
66,MAD,P005928,P009213,9.316,-1,16,17
66,MAD,P005928,P011649,3.883,-8,6,14
66,MAD,P005928,P013378,9.416,-1,16,17
66,MAD,P005928,PTGB,10.799,6,27,21
66,MAD,P009005,P009213,8.3,-8,11,19
66,MAD,P009005,P011649,3.883,-8,6,14
66,MAD,P009005,P013378,7.567,-8,16,24
66,MAD,P009005,PTGB,22.6,-1,48,49
66,MAD,P009213,P013378,11.25,-8,18,26
66,MAD,P009213,PTGB,7.467,-7,9,16
66,MAD,P013378,PTGB,6.451,-7,14,21
66,MIL,P000796,P001392,21.167,15,59,44
66,MIL,P000796,P001518,8.1,-5,7,12
66,MIL,P000796,P006085,22.233,-8,41,49
66,MIL,P000796,P006509,6.4,-3,14,17
66,MIL,P000796,P006721,1.683,6,8,2
66,MIL,P000796,P008985,15.45,1,30,29
66,MIL,P000796,P008987,29.767,3,63,60
66,MIL,P000796,P011064,10.35,12,32,20
66,MIL,P000796,P013384,10.65,15,30,15
66,MIL,P001392,P001518,1.4,-3,0,3
66,MIL,P001392,P006085,15.766,-7,29,36
66,MIL,P001392,P006509,4.6,-2,11,13
66,MIL,P001392,P006721,8.832,9,22,13
66,MIL,P001392,P008985,9.75,1,21,20
66,MIL,P001392,P008987,28.033,9,65,56
66,MIL,P001392,P011064,14.7,17,44,27
66,MIL,P001392,P013384,14.616,21,41,20
66,MIL,P001518,P006085,9.5,-8,7,15
66,MIL,P001518,P008985,9.5,-8,7,15
66,MIL,P001518,P008987,9.5,-8,7,15
66,MIL,P006085,P006509,6.4,-3,14,17
66,MIL,P006085,P006721,3.499,-1,3,4
66,MIL,P006085,P008985,17.216,-3,27,30
66,MIL,P006085,P008987,24.966,-14,38,52
66,MIL,P006085,P011064,1.133,-5,2,7
66,MIL,P006085,P013384,3.483,-3,3,6
66,MIL,P006509,P008987,6.4,-3,14,17
66,MIL,P006509,P013384,1.8,-1,3,4
66,MIL,P006721,P008985,1.816,1,3,2
66,MIL,P006721,P008987,7.149,3,14,11
66,MIL,P006721,P011064,5.333,10,19,9
66,MIL,P006721,P013384,7.016,8,19,11
66,MIL,P008985,P008987,17.8,-7,27,34
66,MIL,P008985,P011064,1.4,-1,5,6
66,MIL,P008987,P011064,14.483,12,41,29
66,MIL,P008987,P013384,15.166,17,39,22
66,MIL,P011064,P013384,12.933,23,41,18
67,MUN,P004508,P007056,20.683,-4,32,36
67,MUN,P004508,P007201,23.649,10,38,28
67,MUN,P004508,P007639,0.917,0,0,0
67,MUN,P004508,P010391,23.716,7,43,36
67,MUN,P004508,P011224,8.933,5,17,12
67,MUN,P004508,P011244,12.183,2,24,22
67,MUN,P004508,P011987,20.6,-1,27,28
67,MUN,P004508,P012123,4.383,-3,7,10
67,MUN,P005460,P010391,0.083,0,0,0
67,MUN,P005460,P011224,2.616,5,7,2
67,MUN,P005460,P011244,2.616,5,7,2
67,MUN,P005460,P011987,2.566,5,7,2
67,MUN,P005460,P012123,2.583,5,7,2
67,MUN,P007056,P007201,16.483,2,23,21
67,MUN,P007056,P007639,0.067,0,0,0
67,MUN,P007056,P010391,18.983,-2,39,41
67,MUN,P007056,P011224,11.167,-3,27,30
67,MUN,P007056,P011244,8.517,-7,26,33
67,MUN,P007056,P011987,21.75,-3,39,42
67,MUN,P007056,P012123,2.75,-3,10,13
67,MUN,P007201,P010391,20.349,10,38,28
67,MUN,P007201,P011224,7.083,8,13,5
67,MUN,P007201,P011244,7.166,8,15,7
67,MUN,P007201,P011987,17.233,2,22,20
67,MUN,P007201,P012123,2.633,0,3,3
67,MUN,P007639,P010391,1.234,0,0,0
67,MUN,P007639,P011224,3.051,-1,4,5
67,MUN,P007639,P011244,3.968,-1,4,5
67,MUN,P007639,P011987,3.651,-1,4,5
67,MUN,P007639,P012123,2.984,-1,4,5
67,MUN,P010391,P011224,8.85,3,26,23
67,MUN,P010391,P011244,15.4,0,33,33
67,MUN,P010391,P011987,21.9,-6,40,46
67,MUN,P010391,P012123,3.0,0,3,3
67,MUN,P010391,P013368,1.217,-4,2,6
67,MUN,P011224,P011244,15.167,3,41,38
67,MUN,P011224,P011987,14.267,-1,30,31
67,MUN,P011224,P012123,8.317,1,21,20
67,MUN,P011224,P013368,1.217,-4,2,6
67,MUN,P011244,P011987,16.484,-3,40,43
67,MUN,P011244,P012123,10.95,1,24,23
67,MUN,P011244,P013368,1.217,-4,2,6
67,MUN,P011987,P012123,6.2,4,17,13
67,MUN,P011987,P013368,1.217,-4,2,6
67,ZAL,P002329,P002676,14.582,13,36,23
67,ZAL,P002329,P003048,12.916,5,35,30
67,ZAL,P002329,P003210,4.183,3,14,11
67,ZAL,P002329,P005504,5.666,-5,7,12
67,ZAL,P002329,P007029,2.733,-3,9,12
67,ZAL,P002329,P007513,23.716,3,47,44
67,ZAL,P002329,P007975,20.683,-4,42,46
67,ZAL,P002329,P012181,0.683,1,2,1
67,ZAL,P002329,P012622,17.867,-6,36,42
67,ZAL,P002329,P012715,3.584,-3,4,7
67,ZAL,P002329,P013403,6.383,-4,8,12
67,ZAL,P002676,P003048,16.116,1,23,22
67,ZAL,P002676,P003210,6.7,3,16,13
67,ZAL,P002676,P005504,2.666,1,5,4
67,ZAL,P002676,P007029,4.683,0,11,11
67,ZAL,P002676,P007513,16.449,8,27,19
67,ZAL,P002676,P007975,9.033,6,19,13
67,ZAL,P002676,P012181,0.683,1,2,1
67,ZAL,P002676,P012622,6.3,7,14,7
67,ZAL,P002676,P012715,6.3,-4,2,6
67,ZAL,P002676,P013403,8.416,0,5,5
67,ZAL,P003048,P003210,6.7,3,16,13
67,ZAL,P003048,P007029,6.467,4,19,15
67,ZAL,P003048,P007513,14.4,4,27,23
67,ZAL,P003048,P007975,9.817,2,26,24
67,ZAL,P003048,P012181,0.683,1,2,1
67,ZAL,P003048,P012622,9.084,4,26,22
67,ZAL,P003048,P012715,6.967,-1,5,6
67,ZAL,P003048,P013403,9.25,-3,9,12
67,ZAL,P003210,P007029,4.2,2,11,9
67,ZAL,P003210,P007513,1.817,0,3,3
67,ZAL,P003210,P012181,0.683,1,2,1
67,ZAL,P003210,P012622,0.317,0,0,0
67,ZAL,P003210,P012715,2.2,0,2,2
67,ZAL,P005504,P007029,2.3,-6,2,8
67,ZAL,P005504,P007513,6.433,-5,9,14
67,ZAL,P005504,P007975,4.333,-8,4,12
67,ZAL,P005504,P012622,4.567,-9,4,13
67,ZAL,P005504,P012715,1.634,-3,2,5
67,ZAL,P005504,P013403,1.333,3,3,0
67,ZAL,P007029,P007513,2.234,0,5,5
67,ZAL,P007029,P007975,2.65,-6,5,11
67,ZAL,P007029,P012622,5.201,-6,10,16
67,ZAL,P007029,P012715,4.434,0,7,7
67,ZAL,P007029,P013403,1.434,-1,5,6
67,ZAL,P007513,P007975,18.516,2,40,38
67,ZAL,P007513,P012622,18.067,2,41,39
67,ZAL,P007513,P012715,9.851,-7,9,16
67,ZAL,P007513,P013403,9.249,-3,8,11
67,ZAL,P007975,P012622,20.267,-6,40,46
67,ZAL,P007975,P012715,3.217,-2,3,5
67,ZAL,P007975,P013403,5.284,-4,9,13
67,ZAL,P012622,P012715,5.818,-3,9,12
67,ZAL,P012622,P013403,5.784,-3,12,15
67,ZAL,P012715,P013403,4.467,-5,1,6
68,PAR,P004761,P006591,26.85,4,58,54
68,PAR,P004761,P006760,6.55,-6,10,16
68,PAR,P004761,P007870,4.367,0,10,10
68,PAR,P004761,P010781,23.083,8,50,42
68,PAR,P004761,P011050,6.55,-6,10,16
68,PAR,P004761,P011981,18.716,8,40,32
68,PAR,P004761,P012720,8.5,-6,10,16
68,PAR,P004761,P013369,23.916,6,52,46
68,PAR,P006591,P006760,7.633,-8,10,18
68,PAR,P006591,P007870,6.25,-6,10,16
68,PAR,P006591,P008232,0.8,-4,0,4
68,PAR,P006591,P010781,24.15,2,48,46
68,PAR,P006591,P011050,6.55,-6,10,16
68,PAR,P006591,P011981,17.9,8,38,30
68,PAR,P006591,P012720,7.684,-6,8,14
68,PAR,P006591,P013369,24.983,0,50,50
68,PAR,P006760,P007870,1.083,-2,0,2
68,PAR,P006760,P010781,1.75,-3,2,5
68,PAR,P006760,P011050,6.55,-6,10,16
68,PAR,P006760,P011981,0.667,-1,2,3
68,PAR,P006760,P012720,4.5,-2,7,9
68,PAR,P006760,P013369,3.8,-7,5,12
68,PAR,P006760,P013370,0.667,-1,2,3
68,PAR,P007870,P008232,1.683,-7,0,7
68,PAR,P007870,P010781,7.133,-9,10,19
68,PAR,P007870,P012720,1.217,-2,1,3
68,PAR,P007870,P013369,5.916,-7,9,16
68,PAR,P007870,P013370,0.883,-3,0,3
68,PAR,P008232,P010781,6.65,0,9,9
68,PAR,P008232,P011981,4.967,7,9,2
68,PAR,P008232,P013369,6.65,0,9,9
68,PAR,P008232,P013370,5.85,4,9,5
68,PAR,P010781,P011981,26.317,12,51,39
68,PAR,P010781,P012720,5.967,-6,3,9
68,PAR,P010781,P013369,32.233,5,60,55
68,PAR,P010781,P013370,6.517,3,11,8
68,PAR,P011050,P012720,4.5,-2,7,9
68,PAR,P011050,P013369,2.05,-4,3,7
68,PAR,P011981,P012720,4.75,-4,2,6
68,PAR,P011981,P013369,26.317,12,51,39
68,PAR,P011981,P013370,5.634,6,11,5
68,PAR,P012720,P013369,4.75,-4,2,6
68,PAR,P013369,P013370,6.517,3,11,8
68,PRS,P004197,P004512,0.867,0,0,0
68,PRS,P004197,P010390,13.567,7,22,15
68,PRS,P004197,P012608,15.534,6,24,18
68,PRS,P004197,P012609,1.1,-1,2,3
68,PRS,P004197,P012610,15.534,6,24,18
68,PRS,P004197,P012613,15.534,6,24,18
68,PRS,P004512,P005793,6.483,2,14,12
68,PRS,P004512,P007032,6.433,1,13,12
68,PRS,P004512,P012608,4.6,7,9,2
68,PRS,P004512,P012609,10.166,8,22,14
68,PRS,P004512,P012610,4.55,6,8,2
68,PRS,P004512,P012613,4.55,6,8,2
68,PRS,P004512,P012640,6.483,2,14,12
68,PRS,P005793,P007032,12.683,-8,25,33
68,PRS,P005793,P012608,1.367,3,5,2
68,PRS,P005793,P012609,11.416,-9,22,31
68,PRS,P005793,P012610,1.317,2,4,2
68,PRS,P005793,P012613,1.317,2,4,2
68,PRS,P005793,P012640,11.416,-9,22,31
68,PRS,P005793,P013373,4.933,-11,8,19
68,PRS,P007032,P010390,1.183,0,2,2
68,PRS,P007032,P012608,2.5,2,6,4
68,PRS,P007032,P012609,11.366,-10,21,31
68,PRS,P007032,P012610,2.5,2,6,4
68,PRS,P007032,P012613,2.5,2,6,4
68,PRS,P007032,P012640,11.366,-10,21,31
68,PRS,P007032,P013373,4.933,-11,8,19
68,PRS,P010390,P012608,21.617,5,38,33
68,PRS,P010390,P012609,1.25,2,5,3
68,PRS,P010390,P012610,21.617,5,38,33
68,PRS,P010390,P012613,21.617,5,38,33
68,PRS,P010390,P012640,5.617,-4,9,13
68,PRS,P012608,P012609,6.083,8,16,8
68,PRS,P012608,P012610,28.584,12,52,40
68,PRS,P012608,P012613,28.584,12,52,40
68,PRS,P012608,P012640,5.667,-3,10,13
68,PRS,P012609,P012610,6.033,7,15,8
68,PRS,P012609,P012613,6.033,7,15,8
68,PRS,P012609,P012640,11.416,-9,22,31
68,PRS,P012609,P013373,4.933,-11,8,19
68,PRS,P012610,P012613,28.584,12,52,40
68,PRS,P012610,P012640,5.617,-4,9,13
68,PRS,P012613,P012640,5.617,-4,9,13
68,PRS,P012640,P013373,4.933,-11,8,19
64,IST,P004887,P006590,17.466,-4,26,30
64,IST,P004887,P006640,1.333,-2,0,2
64,IST,P004887,P007109,6.049,-4,7,11
64,IST,P004887,P009513,1.816,-1,3,4
64,IST,P004887,P009664,2.766,-7,4,11
64,IST,P004887,P009846,12.117,-6,27,33
64,IST,P004887,P011078,24.75,-8,48,56
64,IST,P004887,P012710,20.067,0,42,42
64,IST,P004887,P013363,23.5,-4,47,51
64,IST,P006590,P006640,4.5,-2,4,6
64,IST,P006590,P007109,12.699,-3,18,21
64,IST,P006590,P009513,1.383,1,3,2
64,IST,P006590,P009664,6.7,-3,12,15
64,IST,P006590,P009846,2.55,-3,2,5
64,IST,P006590,P011078,18.233,-2,30,32
64,IST,P006590,P012710,10.5,3,17,14
64,IST,P006590,P012788,6.65,1,11,10
64,IST,P006590,P013363,15.783,0,25,25
64,IST,P006640,P007109,4.5,-2,4,6
64,IST,P006640,P009513,0.433,-2,0,2
64,IST,P006640,P009664,1.75,-3,1,4
64,IST,P006640,P012788,3.6,-2,4,6
64,IST,P006640,P013363,3.616,-3,3,6
64,IST,P007109,P009513,2.1,-4,0,4
64,IST,P007109,P009664,10.283,-7,12,19
64,IST,P007109,P009846,6.816,-10,4,14
64,IST,P007109,P011078,10.482,-4,16,20
64,IST,P007109,P012788,11.033,-6,13,19
64,IST,P007109,P013363,4.366,0,6,6
64,IST,P009513,P009664,2.55,-6,0,6
64,IST,P009513,P009846,2.1,-4,0,4
64,IST,P009513,P011078,0.017,0,0,0
64,IST,P009513,P012710,1.383,1,3,2
64,IST,P009513,P012788,2.117,-4,0,4
64,IST,P009513,P013363,1.833,-1,3,4
64,IST,P009664,P009846,5.866,-4,7,11
64,IST,P009664,P011078,9.166,-2,18,20
64,IST,P009664,P012788,10.25,-2,15,17
64,IST,P009664,P013363,2.733,-2,7,9
64,IST,P009846,P011078,15.883,-6,34,40
64,IST,P009846,P012710,9.567,-3,25,28
64,IST,P009846,P012788,5.866,-4,7,11
64,IST,P009846,P013363,11.167,0,30,30
64,IST,P011078,P012710,18.684,-1,39,40
64,IST,P011078,P012788,6.833,3,14,11
64,IST,P011078,P013363,22.284,0,49,49
64,IST,P012710,P013363,20.067,0,42,42
64,IST,P012788,P013363,3.783,2,8,6
64,MCO,P005763,P005844,5.75,-4,6,10
64,MCO,P005763,P008099,5.75,-4,6,10
64,MCO,P005763,P011212,5.75,-4,6,10
64,MCO,P005763,P013365,5.75,-4,6,10
64,MCO,P005844,P005985,17.867,10,38,28
64,MCO,P005844,P008099,11.55,1,17,16
64,MCO,P005844,P009754,11.667,3,26,23
64,MCO,P005844,P011212,18.333,3,34,31
64,MCO,P005844,P011226,12.866,11,28,17
64,MCO,P005844,P011231,7.299,-5,10,15
64,MCO,P005844,P012515,0.617,-3,0,3
64,MCO,P005844,P013365,12.567,7,23,16
64,MCO,P005844,PLCZ,5.284,1,10,9
64,MCO,P005985,P008099,3.9,7,9,2
64,MCO,P005985,P009754,19.367,3,45,42
64,MCO,P005985,P011212,11.999,9,26,17
64,MCO,P005985,P011226,18.05,11,43,32
64,MCO,P005985,P011231,13.799,-5,25,30
64,MCO,P005985,P012515,0.617,-3,0,3
64,MCO,P005985,P013365,8.383,13,19,6
64,MCO,P005985,PLCZ,14.55,3,31,28
64,MCO,P008099,P011212,16.766,7,31,24
64,MCO,P008099,P011226,5.366,7,13,6
64,MCO,P008099,P011231,4.083,-3,7,10
64,MCO,P008099,P013365,14.433,7,27,20
64,MCO,P008099,PLCZ,5.216,6,14,8
64,MCO,P009754,P011212,4.233,0,12,12
64,MCO,P009754,P011226,15.317,9,38,29
64,MCO,P009754,P011231,10.583,-5,22,27
64,MCO,P009754,P012515,0.617,-3,0,3
64,MCO,P009754,P013365,2.7,4,8,4
64,MCO,P009754,PLCZ,12.984,1,29,28
64,MCO,P011212,P011226,8.899,12,23,11
64,MCO,P011212,P011231,8.732,-8,11,19
64,MCO,P011212,P013365,18.216,11,35,24
64,MCO,P011212,PLCZ,6.532,6,14,8
64,MCO,P011226,P011231,13.566,0,28,28
64,MCO,P011226,P013365,4.383,11,13,2
64,MCO,P011226,PLCZ,15.217,11,38,27
64,MCO,P011231,P013365,2.883,-3,3,6
64,MCO,P011231,PLCZ,10.583,-3,22,25
64,MCO,P012515,PLCZ,0.617,-3,0,3
64,MCO,P013365,PLCZ,6.349,6,14,8
69,ASV,P002100,P003526,10.734,0,26,26
69,ASV,P002100,P004194,11.351,5,31,26
69,ASV,P002100,P007027,11.683,5,31,26
69,ASV,P002100,P008991,18.234,13,43,30
69,ASV,P002100,P010545,3.267,-5,3,8
69,ASV,P002100,P012731,17.367,15,41,26
69,ASV,P002100,P013371,16.667,12,40,28
69,ASV,P002100,PKIR,11.901,15,25,10
69,ASV,P003526,P004194,19.017,-19,25,44
69,ASV,P003526,P007027,18.9,-23,22,45
69,ASV,P003526,P008991,5.884,1,14,13
69,ASV,P003526,P010316,4.767,0,6,6
69,ASV,P003526,P010545,8.034,-11,8,19
69,ASV,P003526,P012731,14.75,-13,23,36
69,ASV,P003526,P013371,13.95,-15,20,35
69,ASV,P003526,PKIR,0.1,0,0,0
69,ASV,P004194,P007027,19.833,-21,26,47
69,ASV,P004194,P008991,5.567,2,15,13
69,ASV,P004194,P010316,4.767,0,6,6
69,ASV,P004194,P010545,10.051,-8,13,21
69,ASV,P004194,P012731,10.15,-10,14,24
69,ASV,P004194,P013371,19.167,-10,36,46
69,ASV,P004194,PKIR,4.301,5,10,5
69,ASV,P007027,P008991,9.483,8,28,20
69,ASV,P007027,P010316,4.767,0,6,6
69,ASV,P007027,P010545,9.434,-10,11,21
69,ASV,P007027,P012731,13.733,-7,21,28
69,ASV,P007027,P013371,12.982,-17,18,35
69,ASV,P007027,PKIR,4.717,9,13,4
69,ASV,P008991,P012731,12.667,11,28,17
69,ASV,P008991,P013371,11.517,5,24,19
69,ASV,P008991,PKIR,9.584,12,20,8
69,ASV,P010316,P010545,4.767,0,6,6
69,ASV,P010545,P012731,1.183,-1,1,2
69,ASV,P010545,P013371,5.0,-3,8,11
69,ASV,P010545,PKIR,3.2,2,6,4
69,ASV,P012731,P013371,17.133,-8,24,32
69,ASV,P012731,PKIR,9.417,13,20,7
69,ASV,P013371,PKIR,9.984,8,18,10
69,ULK,P002849,P002968,3.2,-1,4,5
69,ULK,P002849,P004004,11.683,0,25,25
69,ULK,P002849,P006961,17.85,0,32,32
69,ULK,P002849,P007182,0.15,-2,0,2
69,ULK,P002849,P008104,7.817,-3,9,12
69,ULK,P002849,P008962,9.916,11,28,17
69,ULK,P002849,P009783,7.033,2,13,11
69,ULK,P002849,P010560,5.017,-7,3,10
69,ULK,P002849,P011205,8.199,9,25,16
69,ULK,P002849,P013396,2.267,-5,1,6
69,ULK,P002968,P004004,11.3,6,25,19
69,ULK,P002968,P006961,5.983,-8,8,16
69,ULK,P002968,P008104,5.266,-8,6,14
69,ULK,P002968,P008962,11.3,6,25,19
69,ULK,P002968,P009783,12.85,8,25,17
69,ULK,P002968,P010560,1.133,-4,0,4
69,ULK,P002968,P011205,11.5,5,23,18
69,ULK,P004004,P006961,14.133,-8,26,34
69,ULK,P004004,P007182,1.017,-1,3,4
69,ULK,P004004,P008104,3.883,-6,4,10
69,ULK,P004004,P008962,18.783,16,50,34
69,ULK,P004004,P009783,9.917,15,27,12
69,ULK,P004004,P010560,5.017,-7,3,10
69,ULK,P004004,P011205,17.8,18,48,30
69,ULK,P004004,P013396,2.267,-5,1,6
69,ULK,P006961,P007182,0.583,-1,0,1
69,ULK,P006961,P008104,8.75,-6,11,17
69,ULK,P006961,P008962,13.099,0,29,29
69,ULK,P006961,P009783,7.283,0,10,10
69,ULK,P006961,P010560,5.017,-7,3,10
69,ULK,P006961,P011205,10.299,3,24,21
69,ULK,P006961,P013396,2.267,-5,1,6
69,ULK,P007182,P008962,9.183,1,17,16
69,ULK,P007182,P009783,9.333,-1,17,18
69,ULK,P007182,P009863,2.65,-2,2,4
69,ULK,P007182,P011205,9.333,-1,17,18
69,ULK,P007182,P013396,5.083,3,12,9
69,ULK,P008104,P008962,2.8,-3,5,8
69,ULK,P008104,P009783,6.0,-4,7,11
69,ULK,P008104,P010560,3.883,-6,2,8
69,ULK,P008104,P011205,1.133,-4,0,4
69,ULK,P008962,P009783,21.483,19,47,28
69,ULK,P008962,P009863,2.65,-2,2,4
69,ULK,P008962,P011205,27.699,21,65,44
69,ULK,P008962,P013396,5.083,3,12,9
69,ULK,P009783,P009863,2.65,-2,2,4
69,ULK,P009783,P010560,1.133,-4,0,4
69,ULK,P009783,P011205,21.099,12,44,32
69,ULK,P009783,P013396,5.083,3,12,9
69,ULK,P009863,P011205,2.65,-2,2,4
69,ULK,P010560,P011205,1.133,-4,0,4
69,ULK,P010560,P013396,2.267,-5,1,6
69,ULK,P011205,P013396,5.083,3,12,9
70,OLY,P001255,P003469,1.5,1,5,4
70,OLY,P001255,P003941,6.817,9,18,9
70,OLY,P001255,P007853,8.417,6,18,12
70,OLY,P001255,P007947,1.5,1,5,4
70,OLY,P001255,P007982,9.317,9,23,14
70,OLY,P001255,P008829,8.417,6,18,12
70,OLY,P001255,P008855,0.6,-2,0,2
70,OLY,P001255,P012878,3.1,-2,5,7
70,OLY,P003469,P003941,12.034,-2,29,31
70,OLY,P003469,P007853,7.583,-4,16,20
70,OLY,P003469,P007947,20.0,2,50,48
70,OLY,P003469,P007982,5.601,-6,9,15
70,OLY,P003469,P008811,15.833,1,39,38
70,OLY,P003469,P008855,23.316,4,61,57
70,OLY,P003469,P009849,1.583,-3,3,6
70,OLY,P003469,P012878,0.383,-1,0,1
70,OLY,P003469,P013380,25.167,0,60,60
70,OLY,P003941,P007853,14.65,8,34,26
70,OLY,P003941,P007947,5.367,-1,14,15
70,OLY,P003941,P007982,14.251,3,30,27
70,OLY,P003941,P008829,8.65,9,21,12
70,OLY,P003941,P008855,7.1,4,22,18
70,OLY,P003941,P013380,13.867,-2,32,34
70,OLY,P007853,P007982,13.217,5,28,23
70,OLY,P007853,P008811,1.2,-2,3,5
70,OLY,P007853,P008829,11.75,7,26,19
70,OLY,P007853,P008855,6.116,-2,14,16
70,OLY,P007853,P009849,1.583,-3,3,6
70,OLY,P007853,P012878,3.483,-3,5,8
70,OLY,P007853,P013380,9.333,0,21,21
70,OLY,P007947,P007982,2.867,-2,5,7
70,OLY,P007947,P008811,14.633,3,36,33
70,OLY,P007947,P008855,17.133,4,45,41
70,OLY,P007947,P013380,18.5,1,45,44
70,OLY,P007982,P008829,11.15,9,26,17
70,OLY,P007982,P008855,0.667,0,2,2
70,OLY,P007982,P012878,2.5,0,5,5
70,OLY,P007982,P013380,7.434,-6,12,18
70,OLY,P008811,P008855,15.833,1,39,38
70,OLY,P008811,P009849,1.2,-2,3,5
70,OLY,P008811,P013380,14.633,3,36,33
70,OLY,P008829,P008855,0.6,-2,0,2
70,OLY,P008829,P012878,3.1,-2,5,7
70,OLY,P008829,P013380,3.333,1,8,7
70,OLY,P008855,P009849,1.583,-3,3,6
70,OLY,P008855,P012878,0.983,-3,0,3
70,OLY,P008855,P013380,21.733,7,58,51
70,OLY,P009849,P012878,0.383,-1,0,1
70,PAN,P001926,P003842,22.484,3,58,55
70,PAN,P001926,P004088,12.217,-5,24,29
70,PAN,P001926,P005161,5.817,3,12,9
70,PAN,P001926,P005353,2.15,-3,2,5
70,PAN,P001926,P007866,8.017,3,17,14
70,PAN,P001926,P009622,3.767,1,10,9
70,PAN,P001926,P011204,15.067,2,39,37
70,PAN,P001926,P012712,28.351,9,73,64
70,PAN,P001926,P012774,24.134,11,65,54
70,PAN,P003842,P004088,12.883,-3,28,31
70,PAN,P003842,P005161,3.884,-2,6,8
70,PAN,P003842,P009622,4.4,-6,5,11
70,PAN,P003842,P011204,15.633,-1,39,40
70,PAN,P003842,P011209,0.666,2,4,2
70,PAN,P003842,P012712,26.967,-3,63,66
70,PAN,P003842,P012774,20.951,-2,49,51
70,PAN,P004088,P005353,1.45,-3,0,3
70,PAN,P004088,P007866,4.65,-5,7,12
70,PAN,P004088,P009622,1.316,0,6,6
70,PAN,P004088,P011204,9.35,-6,15,21
70,PAN,P004088,P011209,0.666,2,4,2
70,PAN,P004088,P012712,16.083,-5,35,40
70,PAN,P004088,P012774,11.517,-7,21,28
70,PAN,P005161,P005353,1.133,-1,2,3
70,PAN,P005161,P007866,4.25,2,7,5
70,PAN,P005161,P009622,2.317,-3,1,4
70,PAN,P005161,P012712,7.001,1,11,10
70,PAN,P005161,P012774,8.134,0,13,13
70,PAN,P005353,P007866,3.967,-6,4,10
70,PAN,P005353,P009622,1.384,-2,2,4
70,PAN,P005353,P011204,2.834,-5,2,7
70,PAN,P005353,P012774,2.95,-4,4,8
70,PAN,P007866,P009622,4.867,-1,14,15
70,PAN,P007866,P011204,5.301,-5,7,12
70,PAN,P007866,P012712,9.067,4,22,18
70,PAN,P007866,P012774,12.017,0,26,26
70,PAN,P009622,P011204,2.884,-7,2,9
70,PAN,P009622,P011209,0.583,2,4,2
70,PAN,P009622,P012712,7.883,-5,17,22
70,PAN,P009622,P012774,7.667,-7,15,22
70,PAN,P011204,P011209,0.083,0,0,0
70,PAN,P011204,P012712,18.1,-1,44,45
70,PAN,P011204,P012774,14.484,-1,36,37
70,PAN,P011209,P012712,0.666,2,4,2
70,PAN,P012712,P012774,30.018,2,71,69
71,BAR,P000925,P002939,16.717,18,34,16
71,BAR,P000925,P003478,14.917,14,30,16
71,BAR,P000925,P009862,16.717,18,34,16
71,BAR,P000925,P009992,7.567,11,25,14
71,BAR,P000925,P010106,7.567,11,25,14
71,BAR,P000925,P012745,19.434,22,43,21
71,BAR,P000925,P012795,9.367,15,29,14
71,BAR,P000925,P013379,4.85,7,16,9
71,BAR,P002939,P003478,14.917,14,30,16
71,BAR,P002939,P006568,1.033,-1,3,4
71,BAR,P002939,P009862,16.717,18,34,16
71,BAR,P002939,P009992,1.033,-1,3,4
71,BAR,P002939,P012745,16.717,18,34,16
71,BAR,P002939,P012795,2.833,3,7,4
71,BAR,P002939,P013379,1.033,-1,3,4
71,BAR,P003478,P006568,0.233,0,0,0
71,BAR,P003478,P009862,16.85,11,35,24
71,BAR,P003478,P010106,2.166,-3,5,8
71,BAR,P003478,P012745,16.85,11,35,24
71,BAR,P003478,P012795,0.233,0,0,0
71,BAR,P003478,P013379,2.166,-3,5,8
71,BAR,P006568,P007464,2.433,1,4,3
71,BAR,P006568,P009862,2.667,-1,3,4
71,BAR,P006568,P009992,8.849,2,19,17
71,BAR,P006568,P010106,8.283,1,15,14
71,BAR,P006568,P011666,2.433,1,4,3
71,BAR,P006568,P012745,2.433,1,4,3
71,BAR,P006568,P012795,9.316,0,18,18
71,BAR,P006568,P013379,9.316,0,18,18
71,BAR,P007464,P009992,2.433,1,4,3
71,BAR,P007464,P011666,2.433,1,4,3
71,BAR,P007464,P012745,2.433,1,4,3
71,BAR,P009862,P010106,6.633,-8,13,21
71,BAR,P009862,P012745,20.683,11,44,33
71,BAR,P009862,P012795,6.5,-1,12,13
71,BAR,P009862,P013379,6.633,-8,13,21
71,BAR,P009992,P010106,12.95,13,37,24
71,BAR,P009992,P011666,2.433,1,4,3
71,BAR,P009992,P012745,5.15,5,13,8
71,BAR,P009992,P012795,13.983,12,40,28
71,BAR,P009992,P013379,11.266,8,31,23
71,BAR,P010106,P012745,6.683,-3,19,22
71,BAR,P010106,P012795,17.883,8,45,37
71,BAR,P010106,P013379,17.099,1,41,40
71,BAR,P011666,P012745,2.433,1,4,3
71,BAR,P012745,P012795,6.55,4,18,14
71,BAR,P012745,P013379,3.966,-7,10,17
71,BAR,P012795,P013379,16.199,3,39,36
71,BAS,P007230,P008072,11.366,-1,23,24
71,BAS,P007230,P008850,2.433,-1,3,4
71,BAS,P007230,P011085,5.15,-5,8,13
71,BAS,P007230,P011196,7.266,1,21,20
71,BAS,P007230,P011948,9.433,0,26,26
71,BAS,P007230,P012058,6.567,-4,12,16
71,BAS,P007230,P012080,4.85,-2,8,10
71,BAS,P007230,P012201,18.666,-5,43,48
71,BAS,P007230,P012597,14.316,-2,30,32
71,BAS,P007230,P013367,14.749,-1,34,35
71,BAS,P008072,P011196,0.083,0,0,0
71,BAS,P008072,P011948,5.633,4,17,13
71,BAS,P008072,P012080,3.4,-4,4,8
71,BAS,P008072,P012201,10.183,-1,21,22
71,BAS,P008072,P012597,7.033,-1,12,13
71,BAS,P008072,P013367,7.766,-1,15,16
71,BAS,P008850,P011085,2.433,-1,3,4
71,BAS,P008850,P012058,2.433,-1,3,4
71,BAS,P008850,P012597,2.433,-1,3,4
71,BAS,P011085,P011196,4.666,-5,4,9
71,BAS,P011085,P011948,2.783,-5,2,7
71,BAS,P011085,P012058,8.2,-3,12,15
71,BAS,P011085,P012080,1.883,0,2,2
71,BAS,P011085,P012201,4.333,-11,5,16
71,BAS,P011085,P012597,3.816,-5,3,8
71,BAS,P011085,P013367,6.0,-5,9,14
71,BAS,P011196,P011948,18.216,-22,23,45
71,BAS,P011196,P012058,4.467,3,8,5
71,BAS,P011196,P012080,14.966,-11,18,29
71,BAS,P011196,P012201,19.015,-20,29,49
71,BAS,P011196,P012597,6.316,-4,15,19
71,BAS,P011196,P013367,19.265,-10,30,40
71,BAS,P011948,P012058,2.584,3,6,3
71,BAS,P011948,P012080,12.733,-13,14,27
71,BAS,P011948,P012201,20.165,-21,32,53
71,BAS,P011948,P012597,7.9,-7,15,22
71,BAS,P011948,P013367,15.949,-11,25,36
71,BAS,P012058,P012080,1.883,0,2,2
71,BAS,P012058,P012201,2.717,-4,5,9
71,BAS,P012058,P012597,3.85,0,7,7
71,BAS,P012058,P013367,5.767,-2,9,11
71,BAS,P012080,P012201,15.383,-15,18,33
71,BAS,P012080,P012597,1.1,0,2,2
71,BAS,P012080,P013367,17.266,-15,20,35
71,BAS,P012201,P012597,10.666,-6,21,27
71,BAS,P012201,P013367,26.532,-17,46,63
71,BAS,P012597,P013367,5.366,2,12,10
72,TEL,P006835,P007519,27.401,8,63,55
72,TEL,P006835,P007990,12.885,-3,25,28
72,TEL,P006835,P011214,19.851,-3,42,45
72,TEL,P006835,P011219,18.384,0,35,35
72,TEL,P006835,P013250,9.166,1,18,17
72,TEL,P006835,P013381,12.034,2,25,23
72,TEL,P006835,P013382,21.851,-3,48,51
72,TEL,P006835,P013383,6.967,1,10,9
72,TEL,P006835,P013389,5.801,-7,10,17
72,TEL,P007519,P007990,7.801,4,19,15
72,TEL,P007519,P011214,17.884,5,40,35
72,TEL,P007519,P011219,16.584,1,33,32
72,TEL,P007519,P013250,6.999,-2,15,17
72,TEL,P007519,P013381,11.651,4,25,21
72,TEL,P007519,P013382,22.601,3,48,45
72,TEL,P007519,P013383,5.25,2,8,6
72,TEL,P007519,P013389,3.101,7,9,2
72,TEL,P007990,P011214,8.067,-4,18,22
72,TEL,P007990,P011219,12.518,-9,17,26
72,TEL,P007990,P013250,2.167,3,3,0
72,TEL,P007990,P013381,0.383,-2,0,2
72,TEL,P007990,P013382,10.601,-9,20,29
72,TEL,P007990,P013383,9.234,-9,10,19
72,TEL,P007990,P013389,8.284,-15,12,27
72,TEL,P011214,P011219,4.917,1,11,10
72,TEL,P011214,P013250,0.583,-3,0,3
72,TEL,P011214,P013381,9.617,2,20,18
72,TEL,P011214,P013382,15.167,-4,31,35
72,TEL,P011214,P013383,0.083,0,0,0
72,TEL,P011214,P013389,3.567,-6,6,12
72,TEL,P011219,P013250,8.583,4,18,14
72,TEL,P011219,P013381,2.417,0,5,5
72,TEL,P011219,P013382,14.884,-8,26,34
72,TEL,P011219,P013383,13.301,-5,18,23
72,TEL,P011219,P013389,7.284,-8,9,17
72,TEL,P013250,P013382,4.166,-4,9,13
72,TEL,P013250,P013383,5.0,5,9,4
72,TEL,P013381,P013382,10.134,2,21,19
72,TEL,P013381,P013389,1.9,0,4,4
72,TEL,P013382,P013383,6.417,-6,8,14
72,TEL,P013382,P013389,7.251,-7,13,20
72,TEL,P013383,P013389,7.284,-8,9,17
72,VIR,P001133,P002084,0.667,-3,0,3
72,VIR,P001133,P004554,18.966,12,44,32
72,VIR,P001133,P004888,20.016,4,37,33
72,VIR,P001133,P006739,11.817,-2,22,24
72,VIR,P001133,P009549,21.166,6,41,35
72,VIR,P001133,P011816,0.267,-3,0,3
72,VIR,P001133,P012585,11.616,9,24,15
72,VIR,P001133,P012591,3.567,-3,7,10
72,VIR,P001133,P013374,2.733,-3,0,3
72,VIR,P001133,PBCN,6.717,7,17,10
72,VIR,P002084,P004554,9.85,-1,24,25
72,VIR,P002084,P004888,8.067,-5,17,22
72,VIR,P002084,P006739,11.917,-3,27,30
72,VIR,P002084,P009549,7.117,4,21,17
72,VIR,P002084,P012585,5.766,2,12,10
72,VIR,P002084,P012591,6.466,-1,12,13
72,VIR,P002084,P013374,5.766,2,12,10
72,VIR,P002084,PBCN,9.516,-3,19,22
72,VIR,P004554,P004888,18.983,3,39,36
72,VIR,P004554,P006739,18.383,1,42,41
72,VIR,P004554,P009549,20.816,10,49,39
72,VIR,P004554,P012585,8.8,12,24,12
72,VIR,P004554,P012591,7.65,3,19,16
72,VIR,P004554,PBCN,11.816,4,31,27
72,VIR,P004888,P006739,16.884,-9,30,39
72,VIR,P004888,P009549,25.216,8,52,44
72,VIR,P004888,P011816,0.267,-3,0,3
72,VIR,P004888,P012585,10.916,12,24,12
72,VIR,P004888,P012591,0.35,-3,0,3
72,VIR,P004888,P013374,6.183,2,11,9
72,VIR,P004888,PBCN,3.65,-1,6,7
72,VIR,P006739,P009549,15.934,0,34,34
72,VIR,P006739,P012585,2.35,-3,3,6
72,VIR,P006739,P012591,4.433,3,12,9
72,VIR,P006739,P013374,2.35,-3,3,6
72,VIR,P006739,PBCN,8.2,8,23,15
72,VIR,P009549,P011816,0.267,-3,0,3
72,VIR,P009549,P012585,9.782,18,26,8
72,VIR,P009549,P012591,0.35,-3,0,3
72,VIR,P009549,P013374,4.116,6,9,3
72,VIR,P009549,PBCN,5.7,6,16,10
72,VIR,P011816,P012591,0.267,-3,0,3
72,VIR,P012585,P012591,5.333,-4,7,11
72,VIR,P012585,P013374,8.499,-1,12,13
72,VIR,P012585,PBCN,6.466,-1,12,13
72,VIR,P012591,P013374,2.033,-4,0,4
72,VIR,P012591,PBCN,9.683,-1,19,20
72,VIR,P013374,PBCN,2.316,-3,1,4
73,MUN,P004508,P005460,8.5,-21,5,26
73,MUN,P004508,P007056,15.45,1,28,27
73,MUN,P004508,P007201,18.416,-6,30,36
73,MUN,P004508,P010391,18.833,-11,28,39
73,MUN,P004508,P011224,8.984,-14,9,23
73,MUN,P004508,P011244,10.317,-15,12,27
73,MUN,P004508,P011987,20.167,-12,31,43
73,MUN,P004508,P012123,4.333,-2,5,7
73,MUN,P005460,P007201,1.716,-4,3,7
73,MUN,P005460,P010391,3.266,-10,3,13
73,MUN,P005460,P011224,7.934,-17,4,21
73,MUN,P005460,P011244,8.1,-19,5,24
73,MUN,P005460,P011987,2.9,-10,2,12
73,MUN,P005460,P012123,4.983,-6,4,10
73,MUN,P005460,P013368,1.133,-1,2,3
73,MUN,P007056,P007201,22.417,2,42,40
73,MUN,P007056,P010391,27.017,8,60,52
73,MUN,P007056,P011224,6.367,9,26,17
73,MUN,P007056,P011244,12.95,13,39,26
73,MUN,P007056,P011987,27.584,8,62,54
73,MUN,P007056,P012123,0.483,3,3,0
73,MUN,P007201,P010391,24.9,1,47,46
73,MUN,P007201,P011224,2.25,-3,5,8
73,MUN,P007201,P011244,9.783,3,21,18
73,MUN,P007201,P011987,26.25,-1,48,49
73,MUN,P010391,P011224,6.884,1,21,20
73,MUN,P010391,P011244,17.466,0,41,41
73,MUN,P010391,P011987,29.317,8,64,56
73,MUN,P010391,P012123,1.516,-4,2,6
73,MUN,P010391,P013368,1.133,-1,2,3
73,MUN,P011224,P011244,12.051,-5,25,30
73,MUN,P011224,P011987,8.784,-4,25,29
73,MUN,P011224,P012123,3.95,1,5,4
73,MUN,P011244,P011987,16.134,3,40,37
73,MUN,P011244,P012123,5.466,-3,7,10
73,MUN,P011244,P013368,1.133,-1,2,3
73,MUN,P012123,P013368,1.133,-1,2,3
73,ULK,P002849,P002968,9.15,2,15,13
73,ULK,P002849,P004004,17.2,4,44,40
73,ULK,P002849,P006961,19.95,9,48,39
73,ULK,P002849,P007182,1.8,9,9,0
73,ULK,P002849,P008104,4.033,4,9,5
73,ULK,P002849,P008962,12.283,2,36,34
73,ULK,P002849,P009783,3.283,4,12,8
73,ULK,P002849,P011205,16.5,16,50,34
73,ULK,P002849,P013396,8.733,2,17,15
73,ULK,P002968,P004004,10.917,-2,17,19
73,ULK,P002968,P006961,12.267,5,20,15
73,ULK,P002968,P008104,4.734,0,7,7
73,ULK,P002968,P008962,7.451,1,14,13
73,ULK,P002968,P009783,4.334,-2,9,11
73,ULK,P002968,P011205,6.751,3,14,11
73,ULK,P002968,P013396,10.8,5,20,15
73,ULK,P004004,P006961,19.6,7,46,39
73,ULK,P004004,P007182,0.217,2,2,0
73,ULK,P004004,P008962,14.434,6,39,33
73,ULK,P004004,P009783,1.784,-2,5,7
73,ULK,P004004,P011205,11.534,5,36,31
73,ULK,P004004,P013396,9.85,0,15,15
73,ULK,P006961,P007182,0.217,2,2,0
73,ULK,P006961,P008104,1.467,0,0,0
73,ULK,P006961,P008962,13.7,8,36,28
73,ULK,P006961,P011205,13.217,12,38,26
73,ULK,P006961,P013396,11.85,5,22,17
73,ULK,P007182,P008104,10.9,4,20,16
73,ULK,P007182,P008962,9.317,-3,13,16
73,ULK,P007182,P009783,10.9,4,20,16
73,ULK,P007182,P011205,11.117,6,22,16
73,ULK,P008104,P008962,13.567,-6,22,28
73,ULK,P008104,P009783,15.15,1,29,28
73,ULK,P008104,P011205,16.617,1,29,28
73,ULK,P008962,P009783,15.351,-8,27,35
73,ULK,P008962,P011205,25.934,-3,58,61
73,ULK,P008962,P013396,4.167,3,7,4
73,ULK,P009783,P011205,16.934,-1,34,35
73,ULK,P011205,P013396,2.0,5,7,2
74,MCO,P004790,P005844,10.8,8,32,24
74,MCO,P004790,P005985,3.867,3,11,8
74,MCO,P004790,P008099,10.216,7,28,21
74,MCO,P004790,P009754,5.05,2,15,13
74,MCO,P004790,P011212,13.383,5,34,29
74,MCO,P004790,P011226,7.633,-2,14,16
74,MCO,P004790,PLCZ,2.583,-3,2,5
74,MCO,P005844,P005985,12.784,-1,29,30
74,MCO,P005844,P008099,10.283,8,32,24
74,MCO,P005844,P009754,10.85,0,27,27
74,MCO,P005844,P011212,22.367,2,56,54
74,MCO,P005844,P011226,16.617,-5,36,41
74,MCO,P005844,P011231,5.767,-4,12,16
74,MCO,P005985,P008099,0.7,5,5,0
74,MCO,P005985,P009754,16.266,-5,36,41
74,MCO,P005985,P011212,15.751,-2,35,37
74,MCO,P005985,P011226,13.367,-6,26,32
74,MCO,P005985,P011231,16.55,-6,36,42
74,MCO,P005985,P013365,12.15,-4,28,32
74,MCO,P005985,PLCZ,13.433,-4,30,34
74,MCO,P008099,P009754,6.667,-1,17,18
74,MCO,P008099,P011212,12.866,5,34,29
74,MCO,P008099,P011226,8.733,-5,16,21
74,MCO,P008099,P011231,4.267,-5,8,13
74,MCO,P008099,PLCZ,4.2,-6,4,10
74,MCO,P009754,P011212,10.85,0,27,27
74,MCO,P009754,P011226,8.7,-5,16,21
74,MCO,P009754,P011231,12.083,-6,26,32
74,MCO,P009754,P013365,9.183,-3,22,25
74,MCO,P009754,PLCZ,12.083,-6,26,32
74,MCO,P011212,P011226,19.2,-8,38,46
74,MCO,P011212,P011231,8.734,-5,18,23
74,MCO,P011212,P013365,2.967,-1,6,7
74,MCO,P011212,PLCZ,5.55,-4,8,12
74,MCO,P011226,P011231,8.667,-7,16,23
74,MCO,P011226,PLCZ,5.483,-6,6,12
74,MCO,P011231,P013365,12.15,-4,28,32
74,MCO,P011231,PLCZ,15.05,-7,32,39
74,MCO,P013365,PLCZ,12.15,-4,28,32
74,RED,P000848,P004866,12.4,1,31,30
74,RED,P000848,P006240,6.083,-4,13,17
74,RED,P000848,P006436,8.45,9,27,18
74,RED,P000848,P009048,9.75,-1,23,24
74,RED,P000848,P010612,1.283,0,2,2
74,RED,P000848,P011194,6.317,5,18,13
74,RED,P000848,P012044,2.65,2,8,6
74,RED,P000848,P012786,2.667,-8,2,10
74,RED,P002553,P004007,0.133,-2,0,2
74,RED,P002553,P004866,6.233,5,13,8
74,RED,P002553,P006436,6.383,-1,13,14
74,RED,P002553,P009048,5.733,1,15,14
74,RED,P002553,P010612,7.983,1,15,14
74,RED,P002553,P012044,4.083,4,6,2
74,RED,P002553,P012786,2.733,-3,5,8
74,RED,P002553,PJDR,2.583,3,5,2
74,RED,P004007,P004866,3.667,-4,7,11
74,RED,P004007,P006240,2.617,-2,4,6
74,RED,P004007,P006436,0.133,-2,0,2
74,RED,P004007,P009048,3.134,1,7,6
74,RED,P004007,P010612,3.8,-6,7,13
74,RED,P004007,P011194,1.05,-2,3,5
74,RED,P004007,P012044,0.533,-5,0,5
74,RED,P004007,P012786,0.133,-2,0,2
74,RED,P004866,P006240,8.7,-6,17,23
74,RED,P004866,P006436,16.583,18,49,31
74,RED,P004866,P009048,26.4,13,66,53
74,RED,P004866,P010612,16.716,9,41,32
74,RED,P004866,P011194,17.283,14,50,36
74,RED,P004866,P012044,10.199,3,24,21
74,RED,P004866,P012786,2.667,-8,2,10
74,RED,P004866,PJDR,8.016,7,20,13
74,RED,P006240,P006436,2.133,4,9,5
74,RED,P006240,P009048,8.7,-6,17,23
74,RED,P006240,P010612,3.9,-2,6,8
74,RED,P006240,P012786,2.667,-8,2,10
74,RED,P006436,P009048,15.033,14,45,31
74,RED,P006436,P010612,12.083,4,30,26
74,RED,P006436,P011194,12.017,10,35,25
74,RED,P006436,P012044,5.367,1,12,11
74,RED,P006436,P012786,2.733,-3,5,8
74,RED,P006436,PJDR,1.217,-2,3,5
74,RED,P009048,P010612,15.1,9,39,30
74,RED,P009048,P011194,13.517,16,38,22
74,RED,P009048,P012044,4.383,3,10,7
74,RED,P009048,P012786,4.217,-10,6,16
74,RED,P009048,PJDR,5.833,4,14,10
74,RED,P010612,P011194,12.616,5,38,33
74,RED,P010612,P012044,9.266,-3,20,23
74,RED,P010612,P012786,6.566,-3,15,18
74,RED,P010612,PJDR,8.683,2,23,21
74,RED,P011194,P012044,12.216,-2,32,34
74,RED,P011194,P012786,3.833,0,10,10
74,RED,P011194,PJDR,10.483,2,28,26
74,RED,P012044,P012786,4.883,1,11,10
74,RED,P012044,PJDR,11.616,4,29,25
74,RED,P012786,PJDR,3.833,0,10,10
75,BER,P006251,P007025,25.567,6,64,58
75,BER,P006251,P007550,10.383,-12,19,31
75,BER,P006251,P008173,27.15,10,71,61
75,BER,P006251,P008384,25.184,4,58,54
75,BER,P006251,P011626,3.567,-2,6,8
75,BER,P006251,P011631,15.25,-4,36,40
75,BER,P006251,P012099,3.533,-6,5,11
75,BER,P006251,P012100,5.916,0,13,13
75,BER,P006251,P012604,19.45,16,56,40
75,BER,P007025,P007550,11.233,-6,22,28
75,BER,P007025,P008173,24.834,12,67,55
75,BER,P007025,P008384,23.718,12,57,45
75,BER,P007025,P011626,4.934,-1,9,10
75,BER,P007025,P011631,12.417,3,32,29
75,BER,P007025,P012100,2.233,-1,4,5
75,BER,P007025,P012604,25.2,19,69,50
75,BER,P007550,P008173,7.567,-9,14,23
75,BER,P007550,P008384,15.634,-13,25,38
75,BER,P007550,P011626,2.767,-2,4,6
75,BER,P007550,P011631,12.583,-12,21,33
75,BER,P007550,P012099,3.533,-6,5,11
75,BER,P007550,P012604,11.5,-4,22,26
75,BER,P008173,P008384,24.952,12,62,50
75,BER,P008173,P011626,5.201,-7,9,16
75,BER,P008173,P011631,14.434,7,37,30
75,BER,P008173,P012100,5.916,0,13,13
75,BER,P008173,P012604,25.018,19,71,52
75,BER,P008384,P011626,6.451,-5,11,16
75,BER,P008384,P011631,18.817,2,42,40
75,BER,P008384,P012099,3.533,-6,5,11
75,BER,P008384,P012100,3.683,1,9,8
75,BER,P008384,P012604,22.768,13,55,42
75,BER,P011626,P012604,2.884,-3,5,8
75,BER,P011631,P012099,3.533,-6,5,11
75,BER,P011631,P012100,3.683,1,9,8
75,BER,P011631,P012604,12.751,9,34,25
75,BER,P012100,P012604,2.233,-1,4,5
75,MIL,P000796,P001392,18.984,-13,43,56
75,MIL,P000796,P001518,11.417,-8,17,25
75,MIL,P000796,P006085,27.1,-3,65,68
75,MIL,P000796,P006509,11.751,7,26,19
75,MIL,P000796,P006721,2.55,0,8,8
75,MIL,P000796,P008985,26.633,-3,64,67
75,MIL,P000796,P008987,24.667,7,65,58
75,MIL,P000796,P011064,7.884,0,14,14
75,MIL,P000796,P013384,5.4,3,12,9
75,MIL,P000796,P013386,2.15,-2,2,4
75,MIL,P001392,P001518,2.367,-8,0,8
75,MIL,P001392,P006085,17.617,-16,38,54
75,MIL,P001392,P006509,2.251,-3,3,6
75,MIL,P001392,P006721,5.333,-1,13,14
75,MIL,P001392,P008985,15.917,-18,30,48
75,MIL,P001392,P008987,19.117,-10,40,50
75,MIL,P001392,P011064,5.55,-2,10,12
75,MIL,P001392,P013384,5.633,3,15,12
75,MIL,P001392,P013386,1.167,-4,0,4
75,MIL,P001518,P006085,10.117,1,25,24
75,MIL,P001518,P006509,10.484,0,21,21
75,MIL,P001518,P008985,13.884,-8,27,35
75,MIL,P001518,P008987,13.734,0,30,30
75,MIL,P001518,P011064,8.884,-9,9,18
75,MIL,P001518,P013384,5.117,0,7,7
75,MIL,P006085,P006509,9.234,11,29,18
75,MIL,P006085,P006721,2.55,0,8,8
75,MIL,P006085,P008985,26.683,2,69,67
75,MIL,P006085,P008987,26.367,0,67,67
75,MIL,P006085,P011064,0.667,0,0,0
75,MIL,P006085,P013384,1.783,-1,5,6
75,MIL,P006085,P013386,2.15,-2,2,4
75,MIL,P006509,P006721,0.767,1,3,2
75,MIL,P006509,P008985,9.9,14,33,19
75,MIL,P006509,P008987,10.084,16,34,18
75,MIL,P006509,P011064,8.734,0,14,14
75,MIL,P006509,P013384,5.117,0,7,7
75,MIL,P006509,P013386,2.15,-2,2,4
75,MIL,P006721,P008987,2.783,-1,5,6
75,MIL,P006721,P011064,2.783,-1,5,6
75,MIL,P006721,P013384,4.566,-2,10,12
75,MIL,P008985,P008987,27.95,1,72,71
75,MIL,P008985,P011064,4.65,-6,7,13
75,MIL,P008985,P013386,0.983,2,2,0
75,MIL,P008987,P011064,9.017,6,20,14
75,MIL,P008987,P013384,6.417,5,15,10
75,MIL,P011064,P013384,8.967,4,17,13
76,ASV,P003526,P004194,25.434,9,73,64
76,ASV,P003526,P007027,22.717,6,64,58
76,ASV,P003526,P008991,4.883,-1,7,8
76,ASV,P003526,P012263,0.017,0,0,0
76,ASV,P003526,P012731,21.233,5,61,56
76,ASV,P003526,P013371,27.1,4,67,63
76,ASV,P003526,P013405,10.517,4,25,21
76,ASV,P003526,PKIR,9.767,5,23,18
76,ASV,P004194,P007027,24.017,2,66,64
76,ASV,P004194,P012731,21.9,3,61,58
76,ASV,P004194,P013371,24.717,3,64,61
76,ASV,P004194,P013405,6.784,4,21,17
76,ASV,P004194,PKIR,6.884,3,19,16
76,ASV,P007027,P008991,7.183,-8,8,16
76,ASV,P007027,P012263,4.55,-7,5,12
76,ASV,P007027,P012731,20.0,-1,53,54
76,ASV,P007027,P013371,23.45,-3,56,59
76,ASV,P007027,P013405,12.633,-4,27,31
76,ASV,P007027,PKIR,10.65,-9,17,26
76,ASV,P008991,P012263,5.55,-5,7,12
76,ASV,P008991,P013371,7.333,-2,10,12
76,ASV,P008991,P013405,12.449,-8,16,24
76,ASV,P008991,PKIR,12.466,-8,16,24
76,ASV,P012263,P013371,1.0,2,2,0
76,ASV,P012263,P013405,5.533,-5,7,12
76,ASV,P012263,PKIR,5.55,-5,7,12
76,ASV,P012731,P013371,20.75,2,55,53
76,ASV,P012731,P013405,1.35,1,6,5
76,ASV,P012731,PKIR,2.767,2,8,6
76,ASV,P013371,P013405,11.5,-1,19,20
76,ASV,P013371,PKIR,12.75,-1,23,24
76,ASV,P013405,PKIR,16.566,-7,27,34
76,OLY,P001255,P003469,10.001,-5,24,29
76,OLY,P001255,P003941,6.717,-7,18,25
76,OLY,P001255,P008811,1.167,-2,0,2
76,OLY,P001255,P008855,10.001,-5,24,29
76,OLY,P001255,P012878,2.117,4,6,2
76,OLY,P001255,P013380,10.001,-5,24,29
76,OLY,P003469,P003941,18.517,-2,48,50
76,OLY,P003469,P007853,5.75,-2,9,11
76,OLY,P003469,P007947,8.833,5,26,21
76,OLY,P003469,P007982,12.217,6,32,26
76,OLY,P003469,P008811,9.267,3,22,19
76,OLY,P003469,P008829,0.1,0,0,0
76,OLY,P003469,P008855,24.668,4,65,61
76,OLY,P003469,P012878,2.117,4,6,2
76,OLY,P003469,P013380,28.534,7,72,65
76,OLY,P003941,P007853,10.333,-2,21,23
76,OLY,P003941,P007947,5.316,0,16,16
76,OLY,P003941,P007982,13.6,1,34,33
76,OLY,P003941,P008829,4.583,0,12,12
76,OLY,P003941,P008855,16.284,2,47,45
76,OLY,P003941,P013380,17.05,0,44,44
76,OLY,P007853,P007947,4.9,-2,13,15
76,OLY,P007853,P007982,12.65,-7,18,25
76,OLY,P007853,P008829,10.0,-3,18,21
76,OLY,P007853,P008855,4.567,0,13,13
76,OLY,P007853,P009849,5.1,-1,5,6
76,OLY,P007853,P012878,5.417,-3,6,9
76,OLY,P007853,P013380,4.283,0,5,5
76,OLY,P007947,P007982,2.85,-3,10,13
76,OLY,P007947,P008811,8.1,5,22,17
76,OLY,P007947,P008829,4.9,-2,13,15
76,OLY,P007947,P008855,10.883,6,29,23
76,OLY,P007947,P012878,0.317,-2,1,3
76,OLY,P007947,P013380,8.833,5,26,21
76,OLY,P007982,P008811,0.317,1,2,1
76,OLY,P007982,P008829,7.0,-5,9,14
76,OLY,P007982,P008855,6.884,5,21,16
76,OLY,P007982,P009849,5.1,-1,5,6
76,OLY,P007982,P012878,5.1,-1,5,6
76,OLY,P007982,P013380,10.75,8,28,20
76,OLY,P008811,P008855,8.95,2,20,18
76,OLY,P008811,P013380,9.267,3,22,19
76,OLY,P008829,P008855,3.2,2,9,7
76,OLY,P008829,P009849,5.1,-1,5,6
76,OLY,P008829,P012878,5.417,-3,6,9
76,OLY,P008829,P013380,0.1,0,0,0
76,OLY,P008855,P012878,2.434,2,7,5
76,OLY,P008855,P013380,23.201,6,61,55
76,OLY,P009849,P012878,5.1,-1,5,6
76,OLY,P012878,P013380,2.117,4,6,2
77,PAN,P001926,P003842,7.099,-4,12,16
77,PAN,P001926,P004088,6.883,-4,12,16
77,PAN,P001926,P005161,1.583,2,4,2
77,PAN,P001926,P005353,5.3,-6,8,14
77,PAN,P001926,P007866,7.816,-6,12,18
77,PAN,P001926,P011204,5.516,-6,8,14
77,PAN,P001926,P012712,4.583,-4,8,12
77,PAN,P001926,P012774,10.816,-12,16,28
77,PAN,P003842,P004088,10.217,19,35,16
77,PAN,P003842,P005161,6.567,-5,12,17
77,PAN,P003842,P007866,5.7,-6,7,13
77,PAN,P003842,P009622,10.05,2,22,20
77,PAN,P003842,P011204,28.2,18,73,55
77,PAN,P003842,P011209,3.134,6,10,4
77,PAN,P003842,P012712,25.25,22,71,49
77,PAN,P003842,P012774,27.583,12,70,58
77,PAN,P004088,P005161,2.017,2,5,3
77,PAN,P004088,P005353,5.3,-6,8,14
77,PAN,P004088,P007866,7.317,-4,13,17
77,PAN,P004088,P009622,0.017,0,0,0
77,PAN,P004088,P011204,8.3,14,30,16
77,PAN,P004088,P011209,1.867,-1,4,5
77,PAN,P004088,P012712,8.3,14,30,16
77,PAN,P004088,P012774,12.25,6,35,29
77,PAN,P005161,P007866,4.167,-4,7,11
77,PAN,P005161,P009622,0.75,-4,0,4
77,PAN,P005161,P011204,3.817,-3,7,10
77,PAN,P005161,P011209,0.417,0,1,1
77,PAN,P005161,P012712,2.4,-1,5,6
77,PAN,P005161,P012774,4.55,-7,7,14
77,PAN,P005353,P007866,5.3,-6,8,14
77,PAN,P005353,P009622,3.65,-1,7,8
77,PAN,P005353,P011209,3.65,-1,7,8
77,PAN,P005353,P012712,3.65,-1,7,8
77,PAN,P005353,P012774,8.95,-7,15,22
77,PAN,P007866,P009622,1.35,-4,0,4
77,PAN,P007866,P011204,2.95,-4,2,6
77,PAN,P007866,P011209,0.417,0,1,1
77,PAN,P007866,P012774,8.983,-14,10,24
77,PAN,P009622,P011204,9.3,6,22,16
77,PAN,P009622,P011209,3.65,-1,7,8
77,PAN,P009622,P012712,12.35,5,29,24
77,PAN,P009622,P012774,13.683,1,29,28
77,PAN,P011204,P011209,2.817,3,9,6
77,PAN,P011204,P012712,25.35,19,71,52
77,PAN,P011204,P012774,26.95,13,70,57
77,PAN,P011209,P012712,6.467,2,16,14
77,PAN,P011209,P012774,5.117,0,13,13
77,PAN,P012712,P012774,27.65,16,75,59
77,TEL,P006835,P007519,26.984,-12,56,68
77,TEL,P006835,P011193,21.7,-7,48,55
77,TEL,P006835,P011219,24.417,-5,53,58
77,TEL,P006835,P013250,6.8,4,19,15
77,TEL,P006835,P013381,10.85,7,23,16
77,TEL,P006835,P013382,27.283,-9,61,70
77,TEL,P006835,P013383,9.3,2,22,20
77,TEL,P006835,P013389,12.066,4,30,26
77,TEL,P007519,P011193,18.917,-9,38,47
77,TEL,P007519,P011219,17.501,-13,31,44
77,TEL,P007519,P013250,1.567,-5,5,10
77,TEL,P007519,P013381,5.85,1,11,10
77,TEL,P007519,P013382,21.134,-13,45,58
77,TEL,P007519,P013383,9.283,2,22,20
77,TEL,P007519,P013389,6.7,1,16,15
77,TEL,P011193,P011219,14.183,-11,28,39
77,TEL,P011193,P013250,2.5,5,9,4
77,TEL,P011193,P013381,0.484,1,1,0
77,TEL,P011193,P013382,21.65,-8,48,56
77,TEL,P011193,P013383,7.934,4,21,17
77,TEL,P011193,P013389,1.1,-3,3,6
77,TEL,P011219,P013250,10.15,3,24,21
77,TEL,P011219,P013381,12.75,9,29,20
77,TEL,P011219,P013382,21.366,-15,42,57
77,TEL,P011219,P013383,2.35,-1,4,5
77,TEL,P011219,P013389,13.883,5,33,28
77,TEL,P013250,P013381,7.633,0,14,14
77,TEL,P013250,P013382,7.783,1,18,17
77,TEL,P013250,P013383,2.517,-1,5,6
77,TEL,P013250,P013389,7.85,1,18,17
77,TEL,P013381,P013382,5.916,1,10,9
77,TEL,P013381,P013383,4.15,-3,6,9
77,TEL,P013381,P013389,14.699,4,30,26
77,TEL,P013382,P013383,8.184,4,21,17
77,TEL,P013382,P013389,8.016,-1,19,20
77,TEL,P013383,P013389,4.55,-3,7,10
78,BAS,P004058,P007230,5.516,-2,8,10
78,BAS,P004058,P008072,5.683,-2,7,9
78,BAS,P004058,P011085,5.65,-9,5,14
78,BAS,P004058,P011196,2.25,-7,3,10
78,BAS,P004058,P011948,6.349,-6,8,14
78,BAS,P004058,P012058,2.283,0,5,5
78,BAS,P004058,P012080,2.417,-7,2,9
78,BAS,P004058,P012201,1.584,-3,2,5
78,BAS,P007230,P008072,16.016,10,31,21
78,BAS,P007230,P011085,3.416,1,6,5
78,BAS,P007230,P011196,9.05,-5,19,24
78,BAS,P007230,P011948,12.016,-9,18,27
78,BAS,P007230,P012058,7.833,0,19,19
78,BAS,P007230,P012080,6.999,10,19,9
78,BAS,P007230,P012201,14.533,6,31,25
78,BAS,P007230,P012597,13.117,9,30,21
78,BAS,P007230,P013367,13.9,-4,31,35
78,BAS,P008072,P011085,12.599,-2,23,25
78,BAS,P008072,P011948,17.966,-8,33,41
78,BAS,P008072,P012058,0.95,2,2,0
78,BAS,P008072,P012080,14.849,4,32,28
78,BAS,P008072,P012201,23.666,9,53,44
78,BAS,P008072,P012597,6.183,10,14,4
78,BAS,P008072,P013367,16.816,-3,37,40
78,BAS,P011085,P011196,1.5,-3,3,6
78,BAS,P011085,P011948,8.349,-4,14,18
78,BAS,P011085,P012080,6.766,-2,15,17
78,BAS,P011085,P012201,10.216,4,26,22
78,BAS,P011085,P013367,8.632,7,24,17
78,BAS,P011196,P011948,2.349,-5,4,9
78,BAS,P011196,P012058,6.883,-2,17,19
78,BAS,P011196,P012080,1.733,-4,4,8
78,BAS,P011196,P012201,3.9,-7,6,13
78,BAS,P011196,P012597,6.934,-1,16,17
78,BAS,P011196,P013367,8.533,-2,20,22
78,BAS,P011948,P012058,3.066,-2,5,7
78,BAS,P011948,P012080,4.716,-14,8,22
78,BAS,P011948,P012201,13.533,-9,29,38
78,BAS,P011948,P013367,14.316,-11,29,40
78,BAS,P012058,P012597,4.767,2,14,12
78,BAS,P012058,P013367,5.55,0,14,14
78,BAS,P012080,P012201,16.282,3,39,36
78,BAS,P012080,P012597,6.183,10,14,4
78,BAS,P012080,P013367,8.515,-4,23,27
78,BAS,P012201,P012597,8.35,7,16,9
78,BAS,P012201,P013367,20.332,-6,46,52
78,BAS,P012597,P013367,6.934,-1,16,17
78,IST,P004887,P006590,9.416,10,34,24
78,IST,P004887,P006640,8.05,8,20,12
78,IST,P004887,P007109,9.633,7,27,20
78,IST,P004887,P009664,12.233,9,32,23
78,IST,P004887,P009846,21.866,16,59,43
78,IST,P004887,P011078,13.816,8,39,31
78,IST,P004887,P013363,2.467,4,5,1
78,IST,P004887,P013364,9.983,2,20,18
78,IST,P006590,P006640,1.767,-1,2,3
78,IST,P006590,P007109,5.4,-6,13,19
78,IST,P006590,P009513,0.183,-3,0,3
78,IST,P006590,P009664,8.716,8,27,19
78,IST,P006590,P009846,15.033,11,45,34
78,IST,P006590,P011078,22.533,1,55,54
78,IST,P006590,P012710,13.617,-6,24,30
78,IST,P006590,P012788,17.951,-8,30,38
78,IST,P006590,P013363,13.634,-6,24,30
78,IST,P006590,P013364,1.95,-4,2,6
78,IST,P006640,P007109,9.117,7,22,15
78,IST,P006640,P009664,0.7,0,0,0
78,IST,P006640,P009846,8.05,8,20,12
78,IST,P006640,P012788,1.767,-1,2,3
78,IST,P006640,P013363,2.467,4,5,1
78,IST,P006640,P013364,7.35,3,17,14
78,IST,P007109,P009513,0.183,-3,0,3
78,IST,P007109,P009664,0.183,-3,0,3
78,IST,P007109,P009846,12.2,6,31,25
78,IST,P007109,P011078,3.2,1,11,10
78,IST,P007109,P012788,3.634,-2,6,8
78,IST,P007109,P013363,3.417,1,5,4
78,IST,P007109,P013364,6.833,0,17,17
78,IST,P009513,P009664,0.183,-3,0,3
78,IST,P009513,P013364,0.183,-3,0,3
78,IST,P009664,P009846,12.233,9,32,23
78,IST,P009664,P011078,12.233,9,32,23
78,IST,P009664,P012788,0.7,0,0,0
78,IST,P009664,P013364,5.283,-5,5,10
78,IST,P009846,P011078,16.366,7,43,36
78,IST,P009846,P012710,3.05,2,7,5
78,IST,P009846,P012788,5.617,1,11,10
78,IST,P009846,P013363,5.534,6,12,6
78,IST,P009846,P013364,9.983,2,20,18
78,IST,P011078,P012710,11.5,-11,17,28
78,IST,P011078,P012788,13.117,-9,21,30
78,IST,P011078,P013363,10.567,-8,17,25
78,IST,P011078,P013364,4.4,-2,5,7
78,IST,P012710,P012788,13.617,-6,24,30
78,IST,P012710,P013363,12.684,-3,24,27
78,IST,P012788,P013363,13.634,-6,24,30
78,IST,P012788,P013364,1.767,-1,2,3
79,MAD,P003108,P003583,11.817,-3,20,23
79,MAD,P003108,P003733,14.167,6,34,28
79,MAD,P003108,P005791,18.434,9,51,42
79,MAD,P003108,P005928,19.951,10,56,46
79,MAD,P003108,P009005,13.617,0,30,30
79,MAD,P003108,P009213,15.584,8,41,33
79,MAD,P003108,P011649,1.05,-2,0,2
79,MAD,P003108,P013378,15.967,0,34,34
79,MAD,P003108,PTGB,10.417,-4,18,22
79,MAD,P003583,P003733,1.567,-2,0,2
79,MAD,P003583,P005928,2.15,4,8,4
79,MAD,P003583,P009005,14.95,3,33,30
79,MAD,P003583,P009213,2.316,1,6,5
79,MAD,P003583,P011649,3.434,1,7,6
79,MAD,P003583,P012199,0.517,0,0,0
79,MAD,P003583,P013378,16.517,1,33,32
79,MAD,P003583,PTGB,12.8,-1,25,26
79,MAD,P003733,P005791,14.334,8,36,28
79,MAD,P003733,P005928,14.334,8,36,28
79,MAD,P003733,P009005,1.217,0,2,2
79,MAD,P003733,P009213,14.334,8,36,28
79,MAD,P003733,P011649,2.0,-6,0,6
79,MAD,P003733,P012168,0.433,-4,0,4
79,MAD,P003733,P012199,0.95,-4,0,4
79,MAD,P003733,P013378,2.0,-6,0,6
79,MAD,P005791,P005928,21.784,15,62,47
79,MAD,P005791,P009005,7.467,7,24,17
79,MAD,P005791,P009213,16.801,8,43,35
79,MAD,P005791,P011649,3.4,6,12,6
79,MAD,P005791,P013378,5.417,3,17,14
79,MAD,P005791,PTGB,4.567,4,15,11
79,MAD,P005928,P009005,8.35,11,29,18
79,MAD,P005928,P009213,17.434,11,46,35
79,MAD,P005928,P011649,2.133,6,9,3
79,MAD,P005928,P013378,6.3,7,22,15
79,MAD,P005928,PTGB,3.3,4,12,8
79,MAD,P009005,P009213,3.533,1,8,7
79,MAD,P009005,P011649,5.267,9,19,10
79,MAD,P009005,P013378,17.9,6,43,37
79,MAD,P009005,PTGB,17.367,3,40,37
79,MAD,P009213,P013378,4.783,1,13,12
79,MAD,P009213,PTGB,1.683,-2,3,5
79,MAD,P011649,P012168,0.433,-4,0,4
79,MAD,P011649,P012199,0.95,-4,0,4
79,MAD,P011649,P013378,5.134,-3,10,13
79,MAD,P011649,PTGB,5.267,9,19,10
79,MAD,P012168,P012199,0.433,-4,0,4
79,MAD,P012168,P013378,0.433,-4,0,4
79,MAD,P012199,P013378,0.95,-4,0,4
79,MAD,P013378,PTGB,14.067,-1,28,29
79,VIR,P001133,P001844,7.984,-10,18,28
79,VIR,P001133,P004554,11.284,-2,29,31
79,VIR,P001133,P004888,21.601,-6,50,56
79,VIR,P001133,P006739,11.016,-2,23,25
79,VIR,P001133,P009549,14.983,-12,34,46
79,VIR,P001133,P012585,5.434,3,13,10
79,VIR,P001133,P012591,10.385,-1,22,23
79,VIR,P001133,P013374,13.617,-9,26,35
79,VIR,P001133,PBCN,3.3,-5,5,10
79,VIR,P001844,P002084,0.6,3,3,0
79,VIR,P001844,P004554,5.084,0,15,15
79,VIR,P001844,P004888,8.584,-7,21,28
79,VIR,P001844,P009549,5.85,-5,14,19
79,VIR,P001844,P012591,2.734,-2,7,9
79,VIR,P001844,P013374,3.5,-7,6,13
79,VIR,P002084,P004554,12.266,-5,25,30
79,VIR,P002084,P004888,4.384,8,13,5
79,VIR,P002084,P006739,10.4,0,20,20
79,VIR,P002084,P009549,9.766,0,22,22
79,VIR,P002084,P012585,6.783,-6,12,18
79,VIR,P002084,P012591,6.534,-3,11,14
79,VIR,P002084,P013374,2.834,4,6,2
79,VIR,P002084,PBCN,6.833,-5,12,17
79,VIR,P004554,P004888,12.834,2,36,34
79,VIR,P004554,P006739,15.983,1,35,34
79,VIR,P004554,P009549,18.266,-5,43,48
79,VIR,P004554,P012585,5.166,-10,8,18
79,VIR,P004554,P012591,6.484,-4,13,17
79,VIR,P004554,PBCN,6.833,-5,12,17
79,VIR,P004888,P006739,11.55,0,24,24
79,VIR,P004888,P009549,16.117,-1,40,41
79,VIR,P004888,P012585,5.384,11,17,6
79,VIR,P004888,P012591,10.335,1,24,23
79,VIR,P004888,P013374,13.151,0,27,27
79,VIR,P006739,P009549,12.982,0,29,29
79,VIR,P006739,P012585,2.683,-2,4,6
79,VIR,P006739,P012591,9.634,-4,16,20
79,VIR,P006739,P013374,5.433,-3,8,11
79,VIR,P006739,PBCN,5.983,2,13,11
79,VIR,P009549,P012585,8.133,-7,16,23
79,VIR,P009549,P012591,1.667,-4,3,7
79,VIR,P009549,P013374,6.483,-7,13,20
79,VIR,P009549,PBCN,4.749,-7,10,17
79,VIR,P012585,P012591,4.084,4,9,5
79,VIR,P012585,P013374,7.051,7,17,10
79,VIR,P012585,PBCN,4.15,-12,4,16
79,VIR,P012591,P013374,10.435,0,20,20
79,VIR,P012591,PBCN,5.384,-3,7,10
79,VIR,P013374,PBCN,3.3,-5,5,10
80,BAR,P000925,P002939,10.768,10,28,18
80,BAR,P000925,P003478,12.701,8,32,24
80,BAR,P000925,P009862,18.535,0,42,42
80,BAR,P000925,P009992,7.367,0,16,16
80,BAR,P000925,P010106,13.834,-8,22,30
80,BAR,P000925,P012745,15.752,3,36,33
80,BAR,P000925,P012795,14.051,-10,19,29
80,BAR,P000925,P013379,10.0,-3,17,20
80,BAR,P002939,P003478,11.167,0,26,26
80,BAR,P002939,P006568,1.883,-9,2,11
80,BAR,P002939,P009862,20.167,13,52,39
80,BAR,P002939,P009992,1.334,3,5,2
80,BAR,P002939,P012745,22.501,14,55,41
80,BAR,P002939,P012795,12.334,12,27,15
80,BAR,P002939,P013379,9.85,13,25,12
80,BAR,P003478,P006568,1.883,-9,2,11
80,BAR,P003478,P009862,13.567,-1,34,35
80,BAR,P003478,P010106,3.417,-1,8,9
80,BAR,P003478,P012745,14.584,-1,34,35
80,BAR,P003478,P012795,1.017,0,0,0
80,BAR,P006568,P009862,3.066,-4,7,11
80,BAR,P006568,P010106,1.183,5,5,0
80,BAR,P006568,P012745,3.066,-4,7,11
80,BAR,P006568,P012795,1.183,5,5,0
80,BAR,P007464,P009862,0.733,-3,0,3
80,BAR,P007464,P009992,0.733,-3,0,3
80,BAR,P007464,P012795,0.733,-3,0,3
80,BAR,P007464,P013379,0.733,-3,0,3
80,BAR,P009862,P009992,2.083,-1,7,8
80,BAR,P009862,P010106,9.234,-3,16,19
80,BAR,P009862,P012745,26.934,13,67,54
80,BAR,P009862,P012795,17.883,6,37,31
80,BAR,P009862,P013379,13.666,8,30,22
80,BAR,P009992,P010106,6.2,0,11,11
80,BAR,P009992,P012745,1.517,5,7,2
80,BAR,P009992,P012795,9.583,-2,19,21
80,BAR,P009992,P013379,9.583,-2,19,21
80,BAR,P010106,P012745,6.584,-2,13,15
80,BAR,P010106,P012795,12.017,-2,19,21
80,BAR,P010106,P013379,9.267,-1,14,15
80,BAR,P012745,P012795,15.684,13,34,21
80,BAR,P012745,P013379,10.45,15,27,12
80,BAR,P012795,P013379,21.183,9,44,35
80,PAR,P006591,P006760,7.332,-11,6,17
80,PAR,P006591,P007870,8.199,-8,11,19
80,PAR,P006591,P008232,10.116,-1,23,24
80,PAR,P006591,P010781,13.998,-5,25,30
80,PAR,P006591,P011981,9.149,-4,16,20
80,PAR,P006591,P012167,0.633,-5,0,5
80,PAR,P006591,P012720,4.483,-5,4,9
80,PAR,P006591,P013369,10.316,-17,9,26
80,PAR,P006591,P013370,5.166,8,14,6
80,PAR,P006760,P007870,4.399,-7,4,11
80,PAR,P006760,P008232,1.133,-2,2,4
80,PAR,P006760,P010781,8.398,-19,10,29
80,PAR,P006760,P011981,15.066,-12,29,41
80,PAR,P006760,P012167,8.583,-1,22,23
80,PAR,P006760,P012720,16.616,-13,31,44
80,PAR,P006760,P013369,16.333,-11,28,39
80,PAR,P007870,P008232,10.566,-4,24,28
80,PAR,P007870,P010781,9.166,-13,11,24
80,PAR,P007870,P011981,3.0,4,6,2
80,PAR,P007870,P012167,8.216,3,21,18
80,PAR,P007870,P012720,1.683,-3,2,5
80,PAR,P007870,P013369,14.016,0,28,28
80,PAR,P007870,P013370,8.083,8,21,13
80,PAR,P008232,P010781,10.116,-1,23,24
80,PAR,P008232,P011981,7.066,11,18,7
80,PAR,P008232,P012167,8.016,5,19,14
80,PAR,P008232,P013369,11.866,2,26,24
80,PAR,P008232,P013370,11.649,18,33,15
80,PAR,P010781,P011981,10.082,-7,20,27
80,PAR,P010781,P012167,1.366,-11,1,12
80,PAR,P010781,P012720,5.549,-13,8,21
80,PAR,P010781,P013369,11.066,-19,12,31
80,PAR,P010781,P013370,5.583,8,14,6
80,PAR,P011981,P012167,13.549,9,32,23
80,PAR,P011981,P012720,14.933,-10,29,39
80,PAR,P011981,P013369,21.216,-3,38,41
80,PAR,P011981,P013370,10.599,16,24,8
80,PAR,P012167,P012720,8.45,1,22,21
80,PAR,P012167,P013369,17.816,19,46,27
80,PAR,P012167,P013370,10.099,12,25,13
80,PAR,P012720,P013369,14.75,-9,28,37
80,PAR,P013369,P013370,11.549,10,25,15
81,PRS,P004197,P004512,0.567,1,2,1
81,PRS,P004197,P010390,10.617,1,16,15
81,PRS,P004197,P012608,14.351,5,26,21
81,PRS,P004197,P012609,2.183,1,6,5
81,PRS,P004197,P012610,14.351,5,26,21
81,PRS,P004197,P012613,13.951,9,25,16
81,PRS,P004197,P012640,0.617,-3,2,5
81,PRS,P004197,P013373,0.767,1,1,0
81,PRS,P004512,P005793,2.05,1,3,2
81,PRS,P004512,P007032,2.05,1,3,2
81,PRS,P004512,P012608,7.284,0,15,15
81,PRS,P004512,P012609,8.467,0,16,16
81,PRS,P004512,P012610,7.284,0,15,15
81,PRS,P004512,P012613,7.284,0,15,15
81,PRS,P004512,P012640,2.35,1,3,2
81,PRS,P005793,P007032,12.733,-3,31,34
81,PRS,P005793,P012608,1.683,3,5,2
81,PRS,P005793,P012609,11.05,-6,26,32
81,PRS,P005793,P012610,1.683,3,5,2
81,PRS,P005793,P012613,1.683,3,5,2
81,PRS,P005793,P012640,11.05,-6,26,32
81,PRS,P005793,P013373,9.0,-7,23,30
81,PRS,P007032,P010390,1.783,-2,0,2
81,PRS,P007032,P012608,3.466,1,5,4
81,PRS,P007032,P012609,11.05,-6,26,32
81,PRS,P007032,P012610,3.466,1,5,4
81,PRS,P007032,P012613,3.466,1,5,4
81,PRS,P007032,P012640,11.05,-6,26,32
81,PRS,P007032,P013373,9.0,-7,23,30
81,PRS,P010390,P012608,16.267,6,29,23
81,PRS,P010390,P012610,16.267,6,29,23
81,PRS,P010390,P012613,15.867,10,28,18
81,PRS,P010390,P012640,4.267,3,14,11
81,PRS,P012608,P012609,8.767,0,19,19
81,PRS,P012608,P012610,28.951,12,57,45
81,PRS,P012608,P012613,28.551,16,56,40
81,PRS,P012608,P012640,5.334,4,15,11
81,PRS,P012608,P013373,1.15,1,1,0
81,PRS,P012609,P012610,8.767,0,19,19
81,PRS,P012609,P012613,8.767,0,19,19
81,PRS,P012609,P012640,11.217,-6,26,32
81,PRS,P012609,P013373,9.0,-7,23,30
81,PRS,P012610,P012613,28.551,16,56,40
81,PRS,P012610,P012640,5.334,4,15,11
81,PRS,P012610,P013373,1.15,1,1,0
81,PRS,P012613,P012640,4.934,8,14,6
81,PRS,P012613,P013373,1.15,1,1,0
81,PRS,P012640,P013373,9.383,-7,23,30
81,ZAL,P002329,P002676,16.449,0,27,27
81,ZAL,P002329,P003048,2.916,-5,4,9
81,ZAL,P002329,P005504,12.666,3,18,15
81,ZAL,P002329,P007029,6.933,-1,10,11
81,ZAL,P002329,P007513,5.466,-6,9,15
81,ZAL,P002329,P007975,14.9,1,24,23
81,ZAL,P002329,P011983,3.116,0,6,6
81,ZAL,P002329,P012622,6.084,-7,13,20
81,ZAL,P002329,P013403,8.666,-5,13,18
81,ZAL,P002676,P003048,4.283,-5,11,16
81,ZAL,P002676,P005504,11.849,4,16,12
81,ZAL,P002676,P007029,8.849,-6,11,17
81,ZAL,P002676,P007513,15.932,-1,37,38
81,ZAL,P002676,P007975,24.0,9,52,43
81,ZAL,P002676,P011983,13.483,10,39,29
81,ZAL,P002676,P012622,18.583,-3,47,50
81,ZAL,P002676,P013403,9.632,-4,12,16
81,ZAL,P003048,P007029,2.933,-6,5,11
81,ZAL,P003048,P007513,10.632,-11,17,28
81,ZAL,P003048,P007975,4.6,-1,11,12
81,ZAL,P003048,P011983,5.033,-3,11,14
81,ZAL,P003048,P012622,11.333,-9,21,30
81,ZAL,P003048,P012715,3.85,-1,5,6
81,ZAL,P003048,P013403,5.216,-3,7,10
81,ZAL,P005504,P007029,4.533,1,5,4
81,ZAL,P005504,P007513,1.5,-1,2,3
81,ZAL,P005504,P007975,12.233,4,18,14
81,ZAL,P005504,P011983,2.433,2,6,4
81,ZAL,P005504,P012622,0.817,-1,2,3
81,ZAL,P005504,P013403,4.633,0,5,5
81,ZAL,P007029,P007513,5.666,-9,8,17
81,ZAL,P007029,P007975,4.533,1,5,4
81,ZAL,P007029,P012622,4.633,-7,6,13
81,ZAL,P007029,P013403,2.716,-5,2,7
81,ZAL,P007513,P007975,11.7,6,31,25
81,ZAL,P007513,P011983,12.449,5,32,27
81,ZAL,P007513,P012622,21.232,-4,45,49
81,ZAL,P007513,P012715,3.6,-1,5,6
81,ZAL,P007513,P013403,8.215,-6,10,16
81,ZAL,P007975,P011983,14.883,8,41,33
81,ZAL,P007975,P012622,16.184,2,43,41
81,ZAL,P007975,P012715,0.25,0,0,0
81,ZAL,P007975,P013403,7.117,-2,11,13
81,ZAL,P011983,P012622,14.266,5,38,33
81,ZAL,P011983,P013403,1.133,1,3,2
81,ZAL,P012622,P012715,3.85,-1,5,6
81,ZAL,P012622,P013403,10.15,-7,16,23
81,ZAL,P012715,P013403,3.85,-1,5,6
82,ASV,P002100,P003526,9.767,-2,23,25
82,ASV,P002100,P004194,7.634,10,23,13
82,ASV,P002100,P007027,17.25,1,42,41
82,ASV,P002100,P008991,1.8,-2,2,4
82,ASV,P002100,P010545,11.766,-4,22,26
82,ASV,P002100,P012731,9.217,2,21,19
82,ASV,P002100,P013371,5.833,5,9,4
82,ASV,P002100,P013405,15.449,0,28,28
82,ASV,P002100,PKIR,13.216,6,26,20
82,ASV,P003526,P004194,20.067,1,38,37
82,ASV,P003526,P007027,26.767,-3,51,54
82,ASV,P003526,P008991,0.617,0,0,0
82,ASV,P003526,P010545,3.75,-6,9,15
82,ASV,P003526,P012731,20.066,-3,35,38
82,ASV,P003526,P013371,14.6,-2,26,28
82,ASV,P003526,P013405,9.017,2,20,18
82,ASV,P003526,PKIR,2.417,1,2,1
82,ASV,P004194,P007027,23.384,5,47,42
82,ASV,P004194,P012731,19.2,4,38,34
82,ASV,P004194,P013371,13.95,-6,22,28
82,ASV,P004194,P013405,4.184,1,9,8
82,ASV,P004194,PKIR,5.117,5,11,6
82,ASV,P007027,P008991,1.667,-2,2,4
82,ASV,P007027,P010545,6.8,-7,15,22
82,ASV,P007027,P012731,23.4,1,44,43
82,ASV,P007027,P013371,14.7,0,28,28
82,ASV,P007027,P013405,13.2,1,30,29
82,ASV,P007027,PKIR,9.9,4,21,17
82,ASV,P008991,P013371,0.75,0,0,0
82,ASV,P008991,P013405,2.417,-2,2,4
82,ASV,P008991,PKIR,2.417,-2,2,4
82,ASV,P010545,P012731,1.884,-5,2,7
82,ASV,P010545,P013371,5.0,3,7,4
82,ASV,P010545,P013405,9.916,1,20,19
82,ASV,P010545,PKIR,8.016,2,13,11
82,ASV,P012731,P013371,12.9,0,23,23
82,ASV,P012731,P013405,2.333,2,4,2
82,ASV,P012731,PKIR,4.6,3,9,6
82,ASV,P013371,P013405,8.183,7,16,9
82,ASV,P013371,PKIR,5.816,5,9,4
82,ASV,P013405,PKIR,11.033,4,19,15
82,RED,P002553,P004866,2.733,-4,5,9
82,RED,P002553,P006436,2.65,-5,0,5
82,RED,P002553,P007960,2.65,-5,0,5
82,RED,P002553,P009048,4.3,-1,11,12
82,RED,P002553,P010612,2.25,3,5,2
82,RED,P002553,P012044,9.2,-3,16,19
82,RED,P002553,P012786,3.817,6,11,5
82,RED,P002553,PJDR,9.1,-1,16,17
82,RED,P002553,PLUO,0.1,-2,0,2
82,RED,P004866,P006240,4.134,-9,2,11
82,RED,P004866,P006436,6.066,2,16,14
82,RED,P004866,P009048,25.217,-7,44,51
82,RED,P004866,P010612,24.4,-5,42,47
82,RED,P004866,P011194,22.616,7,50,43
82,RED,P004866,P012044,12.433,-5,25,30
82,RED,P004866,P012786,5.35,-4,7,11
82,RED,P004866,PJDR,7.433,-3,20,23
82,RED,P004866,PLUO,7.95,4,17,13
82,RED,P006240,P009048,4.134,-9,2,11
82,RED,P006240,P010612,4.134,-9,2,11
82,RED,P006240,P012044,0.817,-4,0,4
82,RED,P006240,P012786,3.317,-5,2,7
82,RED,P006436,P007960,5.6,-5,4,9
82,RED,P006436,P009048,1.7,1,3,2
82,RED,P006436,P010612,5.183,1,8,7
82,RED,P006436,P011194,9.016,2,20,18
82,RED,P006436,P012044,10.966,-2,19,21
82,RED,P006436,P012786,1.0,2,2,0
82,RED,P006436,PJDR,8.483,0,16,16
82,RED,P007960,P011194,2.95,0,4,4
82,RED,P007960,P012044,5.6,-5,4,9
82,RED,P007960,PJDR,5.6,-5,4,9
82,RED,P009048,P010612,21.917,-3,39,42
82,RED,P009048,P011194,18.25,6,37,31
82,RED,P009048,P012044,9.634,-3,18,21
82,RED,P009048,P012786,6.917,-1,13,14
82,RED,P009048,PJDR,7.117,-3,16,19
82,RED,P009048,PLUO,7.95,4,17,13
82,RED,P010612,P011194,20.166,4,40,36
82,RED,P010612,P012044,10.5,1,17,16
82,RED,P010612,P012786,8.6,1,14,13
82,RED,P010612,PJDR,5.6,1,12,11
82,RED,P010612,PLUO,7.85,6,17,11
82,RED,P011194,P012044,11.733,3,24,21
82,RED,P011194,P012786,2.033,1,5,4
82,RED,P011194,PJDR,7.65,-1,19,20
82,RED,P011194,PLUO,7.85,6,17,11
82,RED,P012044,P012786,4.817,8,13,5
82,RED,P012044,PJDR,15.6,4,32,28
82,RED,P012044,PLUO,0.1,-2,0,2
82,RED,P012786,PJDR,4.817,8,13,5
83,BAS,P004058,P007230,2.649,-2,4,6
83,BAS,P004058,P011085,5.949,-7,11,18
83,BAS,P004058,P011196,5.749,-7,9,16
83,BAS,P004058,P011948,5.749,-7,9,16
83,BAS,P004058,P012058,0.783,0,2,2
83,BAS,P004058,P012201,4.466,-5,7,12
83,BAS,P004058,P012597,0.783,0,2,2
83,BAS,P007230,P008072,7.267,-14,5,19
83,BAS,P007230,P011085,6.766,0,15,15
83,BAS,P007230,P011196,19.949,-4,35,39
83,BAS,P007230,P011948,7.566,-6,10,16
83,BAS,P007230,P012058,6.716,-8,10,18
83,BAS,P007230,P012080,21.333,-8,37,45
83,BAS,P007230,P012201,18.666,-2,33,35
83,BAS,P007230,P012597,22.416,-5,42,47
83,BAS,P007230,P013367,5.4,-7,5,12
83,BAS,P008072,P011085,3.017,-2,4,6
83,BAS,P008072,P011948,3.017,-2,4,6
83,BAS,P008072,P012058,4.25,-12,1,13
83,BAS,P008072,P012080,4.25,-12,1,13
83,BAS,P008072,P012597,1.867,-7,0,7
83,BAS,P008072,P013367,5.4,-7,5,12
83,BAS,P011085,P011196,11.599,0,28,28
83,BAS,P011085,P011948,11.683,-11,21,32
83,BAS,P011085,P012058,2.466,4,9,5
83,BAS,P011085,P012080,4.616,13,18,5
83,BAS,P011085,P012201,10.316,2,26,24
83,BAS,P011085,P012597,3.166,5,12,7
83,BAS,P011085,P013367,8.75,4,20,16
83,BAS,P011196,P011948,11.932,-11,21,32
83,BAS,P011196,P012080,18.333,9,40,31
83,BAS,P011196,P012201,28.982,0,59,59
83,BAS,P011196,P012597,18.783,-1,36,37
83,BAS,P011196,P013367,5.733,6,16,10
83,BAS,P011948,P012201,10.649,-9,19,28
83,BAS,P011948,P012597,3.083,-2,6,8
83,BAS,P011948,P013367,6.117,-4,10,14
83,BAS,P012058,P012080,5.933,-8,8,16
83,BAS,P012058,P012597,4.333,-3,9,12
83,BAS,P012058,P013367,2.383,-5,1,6
83,BAS,P012080,P012201,18.333,9,40,31
83,BAS,P012080,P012597,19.25,-2,37,39
83,BAS,P012080,P013367,5.016,3,11,8
83,BAS,P012201,P012597,18.783,-1,36,37
83,BAS,P012201,P013367,5.733,6,16,10
83,MCO,P004790,P005844,10.333,2,22,20
83,MCO,P004790,P005985,5.801,7,16,9
83,MCO,P004790,P008099,3.484,-7,5,12
83,MCO,P004790,P009754,15.184,10,36,26
83,MCO,P004790,P011212,17.484,3,41,38
83,MCO,P004790,P011226,14.267,-1,32,33
83,MCO,P004790,P011231,6.451,-2,12,14
83,MCO,P005844,P005985,7.083,7,14,7
83,MCO,P005844,P008099,3.633,5,6,1
83,MCO,P005844,P009754,14.85,4,36,32
83,MCO,P005844,P011212,14.5,4,36,32
83,MCO,P005844,P011226,18.483,9,42,33
83,MCO,P005844,P011231,5.05,5,12,7
83,MCO,P005985,P008099,15.267,6,29,23
83,MCO,P005985,P009754,11.284,10,27,17
83,MCO,P005985,P011212,8.134,9,24,15
83,MCO,P005985,P011226,12.2,10,28,18
83,MCO,P005985,P011231,21.217,11,41,30
83,MCO,P005985,P013365,9.95,2,19,17
83,MCO,P005985,PLCZ,13.6,2,26,24
83,MCO,P008099,P009754,0.417,0,0,0
83,MCO,P008099,P011212,3.067,-7,5,12
83,MCO,P008099,P011226,6.767,-1,11,12
83,MCO,P008099,P011231,17.734,0,32,32
83,MCO,P008099,P013365,9.95,2,19,17
83,MCO,P008099,PLCZ,10.617,2,21,19
83,MCO,P009754,P011212,18.934,12,50,38
83,MCO,P009754,P011226,19.3,7,48,41
83,MCO,P009754,P011231,7.784,5,18,13
83,MCO,P009754,PLCZ,2.983,0,5,5
83,MCO,P011212,P011226,18.434,1,46,45
83,MCO,P011212,P011231,7.451,-2,18,20
83,MCO,P011226,P011231,11.167,-1,22,23
83,MCO,P011226,PLCZ,3.65,0,7,7
83,MCO,P011231,P013365,9.95,2,19,17
83,MCO,P011231,PLCZ,13.6,2,26,24
83,MCO,P013365,PLCZ,9.95,2,19,17
84,BER,P006251,P007025,10.166,-17,17,34
84,BER,P006251,P007550,12.183,-7,23,30
84,BER,P006251,P008173,12.016,-22,26,48
84,BER,P006251,P008384,12.233,-14,28,42
84,BER,P006251,P011626,0.25,-3,0,3
84,BER,P006251,P011631,6.8,-7,11,18
84,BER,P006251,P011934,8.816,-16,18,34
84,BER,P006251,P012100,11.366,-15,23,38
84,BER,P006251,P012604,18.566,-23,34,57
84,BER,P007025,P007550,7.816,-2,16,18
84,BER,P007025,P008173,13.65,-18,25,43
84,BER,P007025,P008384,12.017,-9,25,34
84,BER,P007025,P011626,6.717,-8,13,21
84,BER,P007025,P011631,15.667,-9,31,40
84,BER,P007025,P011934,12.65,-4,31,35
84,BER,P007025,P012099,2.367,0,8,8
84,BER,P007025,P012100,2.616,-5,4,9
84,BER,P007025,P012604,11.666,-8,26,34
84,BER,P007550,P008173,3.467,6,12,6
84,BER,P007550,P008384,5.567,4,16,12
84,BER,P007550,P011626,2.367,4,8,4
84,BER,P007550,P011631,7.75,-2,16,18
84,BER,P007550,P011934,4.0,0,12,12
84,BER,P007550,P012100,5.45,-3,10,13
84,BER,P007550,P012604,14.4,-4,31,35
84,BER,P008173,P008384,21.833,-11,50,61
84,BER,P008173,P011626,7.0,-3,14,17
84,BER,P008173,P011631,10.666,-11,16,27
84,BER,P008173,P011934,16.932,-9,37,46
84,BER,P008173,P012100,5.916,-12,13,25
84,BER,P008173,P012604,9.916,-8,23,31
84,BER,P008384,P011626,5.117,1,12,11
84,BER,P008384,P011631,8.783,-7,14,21
84,BER,P008384,P011934,15.299,-8,35,43
84,BER,P008384,P012100,4.5,-5,11,16
84,BER,P008384,P012604,10.383,-3,25,28
84,BER,P011626,P011631,7.0,-7,14,21
84,BER,P011626,P011934,5.35,2,15,13
84,BER,P011626,P012099,2.367,0,8,8
84,BER,P011626,P012604,1.3,2,4,2
84,BER,P011631,P011934,11.233,-3,25,28
84,BER,P011631,P012099,2.367,0,8,8
84,BER,P011631,P012100,4.25,-5,8,13
84,BER,P011631,P012604,8.616,-1,17,18
84,BER,P011934,P012099,2.367,0,8,8
84,BER,P011934,P012100,4.283,-5,11,16
84,BER,P011934,P012604,6.866,-5,16,21
84,BER,P012100,P012604,7.083,-10,12,22
84,MUN,P004508,P007056,18.4,25,61,36
84,MUN,P004508,P007201,17.283,28,60,32
84,MUN,P004508,P007639,1.667,3,7,4
84,MUN,P004508,P010391,19.15,34,70,36
84,MUN,P004508,P011052,1.933,11,11,0
84,MUN,P004508,P011224,3.799,7,11,4
84,MUN,P004508,P011244,4.549,16,20,4
84,MUN,P004508,P011987,19.349,27,63,36
84,MUN,P004508,P012123,1.667,3,7,4
84,MUN,P004508,P013368,3.999,10,14,4
84,MUN,P005460,P011052,5.3,5,12,7
84,MUN,P005460,P011224,5.3,5,12,7
84,MUN,P005460,P011244,5.3,5,12,7
84,MUN,P005460,P011987,3.0,6,10,4
84,MUN,P005460,P012123,2.3,-1,2,3
84,MUN,P007056,P007201,15.65,21,51,30
84,MUN,P007056,P007639,3.417,-3,10,13
84,MUN,P007056,P010391,19.267,21,64,43
84,MUN,P007056,P011224,2.633,-8,3,11
84,MUN,P007056,P011987,16.733,22,54,32
84,MUN,P007056,P012123,3.417,-3,10,13
84,MUN,P007056,P013368,1.083,1,3,2
84,MUN,P007201,P010391,16.4,30,60,30
84,MUN,P007201,P011224,0.883,-2,0,2
84,MUN,P007201,P011244,1.633,7,9,2
84,MUN,P007201,P011987,17.283,28,60,32
84,MUN,P007639,P010391,3.417,-3,10,13
84,MUN,P007639,P011052,6.367,-3,15,18
84,MUN,P007639,P011224,8.117,-9,18,27
84,MUN,P007639,P012123,9.784,-6,25,31
84,MUN,P007639,P013368,6.367,-3,15,18
84,MUN,P010391,P011224,1.75,-6,3,9
84,MUN,P010391,P011244,1.633,7,9,2
84,MUN,P010391,P011987,17.483,31,63,32
84,MUN,P010391,P012123,3.417,-3,10,13
84,MUN,P010391,P013368,1.083,1,3,2
84,MUN,P011052,P011224,17.233,5,42,37
84,MUN,P011052,P011244,10.866,8,27,19
84,MUN,P011052,P011987,3.0,6,10,4
84,MUN,P011052,P012123,12.3,-12,21,33
84,MUN,P011052,P013368,11.933,0,30,30
84,MUN,P011224,P011244,11.849,6,27,21
84,MUN,P011224,P011987,4.866,2,10,8
84,MUN,P011224,P012123,14.05,-18,24,42
84,MUN,P011224,P013368,12.916,-2,30,32
84,MUN,P011244,P011987,5.616,11,19,8
84,MUN,P011244,P012123,5.933,-9,6,15
84,MUN,P011244,P013368,6.549,1,15,14
84,MUN,P011987,P013368,2.066,-1,3,4
84,MUN,P012123,P013368,10.0,-11,19,30
85,IST,P004887,P006590,19.183,7,33,26
85,IST,P004887,P006640,1.299,0,2,2
85,IST,P004887,P007109,5.815,-2,10,12
85,IST,P004887,P009664,3.534,9,11,2
85,IST,P004887,P009846,11.883,6,23,17
85,IST,P004887,P011078,22.484,11,41,30
85,IST,P004887,P012710,15.517,4,24,20
85,IST,P004887,P013363,4.883,2,12,10
85,IST,P004887,P013364,14.866,7,24,17
85,IST,P006590,P006640,2.399,-5,0,5
85,IST,P006590,P007109,7.832,-5,11,16
85,IST,P006590,P009664,6.617,0,10,10
85,IST,P006590,P009846,11.017,-1,16,17
85,IST,P006590,P011078,25.034,4,43,39
85,IST,P006590,P012710,14.067,4,24,20
85,IST,P006590,P012788,9.333,-8,12,20
85,IST,P006590,P013363,6.149,-7,9,16
85,IST,P006590,P013364,12.433,7,22,15
85,IST,P006640,P007109,7.282,3,17,14
85,IST,P006640,P009846,4.883,8,17,9
85,IST,P006640,P012788,5.983,3,15,12
85,IST,P006640,P013363,6.949,3,17,14
85,IST,P006640,P013364,0.333,0,0,0
85,IST,P007109,P009846,11.916,9,29,20
85,IST,P007109,P011078,9.033,-1,17,18
85,IST,P007109,P012788,11.583,4,26,22
85,IST,P007109,P013363,14.732,0,32,32
85,IST,P007109,P013364,1.399,0,2,2
85,IST,P009664,P009846,7.084,4,14,10
85,IST,P009664,P011078,7.084,4,14,10
85,IST,P009664,P012788,3.55,-5,3,8
85,IST,P009664,P013363,0.467,4,4,0
85,IST,P009846,P011078,16.534,2,26,24
85,IST,P009846,P012710,3.5,-3,2,5
85,IST,P009846,P012788,10.617,4,22,18
85,IST,P009846,P013363,10.05,11,29,18
85,IST,P009846,P013364,2.516,0,2,2
85,IST,P011078,P012710,15.517,4,24,20
85,IST,P011078,P012788,9.15,-4,14,18
85,IST,P011078,P013363,7.25,1,17,16
85,IST,P011078,P013364,14.45,7,24,17
85,IST,P012710,P013364,13.467,7,22,15
85,IST,P012788,P013363,10.316,2,24,22
85,MAD,P003108,P003583,7.867,-3,17,20
85,MAD,P003108,P003733,24.15,3,43,40
85,MAD,P003108,P005791,28.617,-7,43,50
85,MAD,P003108,P005928,34.9,-6,58,64
85,MAD,P003108,P009005,21.934,-4,39,43
85,MAD,P003108,P009213,10.967,-12,13,25
85,MAD,P003108,P011649,1.517,-2,2,4
85,MAD,P003108,P013378,2.483,-8,0,8
85,MAD,P003108,PTGB,13.501,-1,25,26
85,MAD,P003583,P003733,4.466,0,9,9
85,MAD,P003583,P005928,6.35,-1,15,16
85,MAD,P003583,P009005,4.484,-3,10,13
85,MAD,P003583,P009213,4.383,0,9,9
85,MAD,P003583,P011247,0.083,0,0,0
85,MAD,P003583,P011649,2.6,-2,4,6
85,MAD,P003583,P013378,1.083,0,2,2
85,MAD,P003583,PTGB,4.484,-3,10,13
85,MAD,P003733,P005791,19.767,3,34,31
85,MAD,P003733,P005928,24.083,5,43,38
85,MAD,P003733,P009005,10.717,6,22,16
85,MAD,P003733,P009213,9.45,-7,13,20
85,MAD,P003733,P011247,0.083,0,0,0
85,MAD,P003733,P011649,0.083,0,0,0
85,MAD,P003733,P013378,0.083,0,0,0
85,MAD,P003733,PTGB,4.05,2,8,6
85,MAD,P005791,P005928,28.55,-5,43,48
85,MAD,P005791,P009005,20.883,-1,33,34
85,MAD,P005791,P009213,6.584,-12,4,16
85,MAD,P005791,P011649,2.433,0,2,2
85,MAD,P005791,P013378,4.916,-8,2,10
85,MAD,P005791,PTGB,12.45,2,19,17
85,MAD,P005928,P009005,20.35,0,37,37
85,MAD,P005928,P009213,10.9,-10,13,23
85,MAD,P005928,P013378,2.483,-8,0,8
85,MAD,P005928,PTGB,11.984,1,23,22
85,MAD,P009005,P009213,0.467,-4,0,4
85,MAD,P009005,P011649,4.95,-2,6,8
85,MAD,P009005,P013378,5.916,-8,4,12
85,MAD,P009005,PTGB,11.767,0,21,21
85,MAD,P009213,PTGB,1.117,-3,0,3
85,MAD,P011247,P011649,0.083,0,0,0
85,MAD,P011247,P013378,0.083,0,0,0
85,MAD,P011649,P013378,3.516,0,4,4
85,MAD,P011649,PTGB,4.95,-2,6,8
85,MAD,P013378,PTGB,3.433,0,4,4
86,OLY,P001255,P003469,1.567,-2,3,5
86,OLY,P001255,P003941,6.0,-1,11,12
86,OLY,P001255,P007853,0.667,-1,1,2
86,OLY,P001255,P007947,5.167,-4,11,15
86,OLY,P001255,P007982,6.967,-2,11,13
86,OLY,P001255,P008811,0.667,-1,1,2
86,OLY,P001255,P008829,7.734,-3,13,16
86,OLY,P001255,P008855,0.9,-1,2,3
86,OLY,P001255,P009849,4.234,-1,6,7
86,OLY,P001255,P012878,2.634,-3,4,7
86,OLY,P001255,P013380,0.667,-1,1,2
86,OLY,P003469,P003941,12.7,12,39,27
86,OLY,P003469,P007853,3.434,-10,4,14
86,OLY,P003469,P007947,23.967,14,65,51
86,OLY,P003469,P007982,10.917,12,33,21
86,OLY,P003469,P008811,12.534,9,31,22
86,OLY,P003469,P008829,0.184,2,2,0
86,OLY,P003469,P008855,18.267,11,48,37
86,OLY,P003469,P009849,2.333,-5,3,8
86,OLY,P003469,P012878,3.4,-10,5,15
86,OLY,P003469,P013380,25.301,11,67,56
86,OLY,P003941,P007947,17.5,3,44,41
86,OLY,P003941,P007982,19.617,7,48,41
86,OLY,P003941,P008829,8.884,-3,17,20
86,OLY,P003941,P008855,6.4,1,18,17
86,OLY,P003941,P009849,1.6,2,2,0
86,OLY,P003941,P013380,12.967,7,37,30
86,OLY,P007853,P007947,1.067,-5,2,7
86,OLY,P007853,P008811,2.367,-5,2,7
86,OLY,P007853,P008855,1.7,-4,1,5
86,OLY,P007853,P012878,1.067,-5,2,7
86,OLY,P007853,P013380,3.434,-10,4,14
86,OLY,P007947,P007982,15.717,3,38,35
86,OLY,P007947,P008811,10.167,14,29,15
86,OLY,P007947,P008829,8.068,-6,17,23
86,OLY,P007947,P008855,14.25,13,39,26
86,OLY,P007947,P009849,3.1,-6,5,11
86,OLY,P007947,P012878,4.167,-11,7,18
86,OLY,P007947,P013380,24.234,9,63,54
86,OLY,P007982,P008829,10.768,-5,19,24
86,OLY,P007982,P008855,4.6,1,12,11
86,OLY,P007982,P009849,3.467,0,4,4
86,OLY,P007982,P012878,1.867,-2,2,4
86,OLY,P007982,P013380,12.084,6,33,27
86,OLY,P008811,P008855,11.867,10,30,20
86,OLY,P008811,P013380,12.534,9,31,22
86,OLY,P008829,P009849,4.234,-1,6,7
86,OLY,P008829,P012878,2.634,-3,4,7
86,OLY,P008829,P013380,3.634,-5,6,11
86,OLY,P008855,P013380,15.084,13,42,29
86,OLY,P009849,P012878,4.967,-8,7,15
86,OLY,P009849,P013380,2.333,-5,3,8
86,OLY,P012878,P013380,3.4,-10,5,15
86,TEL,P005145,P011219,6.0,1,12,11
86,TEL,P005145,P013250,6.0,1,12,11
86,TEL,P005145,P013381,5.1,0,9,9
86,TEL,P005145,P013382,0.9,1,3,2
86,TEL,P005145,P013389,6.0,1,12,11
86,TEL,P006835,P007519,19.417,-3,47,50
86,TEL,P006835,P007990,5.65,0,16,16
86,TEL,P006835,P011193,23.601,8,61,53
86,TEL,P006835,P011219,12.567,-2,32,34
86,TEL,P006835,P013250,8.0,-12,12,24
86,TEL,P006835,P013381,6.333,-15,9,24
86,TEL,P006835,P013382,23.668,6,61,55
86,TEL,P006835,P013383,17.367,-5,38,43
86,TEL,P006835,P013389,3.133,-5,4,9
86,TEL,P007519,P007990,1.667,-8,0,8
86,TEL,P007519,P011193,16.451,5,44,39
86,TEL,P007519,P011219,7.667,-9,15,24
86,TEL,P007519,P013250,2.5,0,5,5
86,TEL,P007519,P013381,4.2,-8,7,15
86,TEL,P007519,P013382,17.418,5,44,39
86,TEL,P007519,P013383,12.767,6,34,28
86,TEL,P007519,P013389,0.117,0,0,0
86,TEL,P007990,P011193,5.134,8,16,8
86,TEL,P007990,P011219,6.417,2,16,14
86,TEL,P007990,P013381,1.55,-8,0,8
86,TEL,P007990,P013382,6.051,8,16,8
86,TEL,P007990,P013383,0.15,-2,0,2
86,TEL,P007990,P013389,0.117,0,0,0
86,TEL,P011193,P011219,12.751,2,34,32
86,TEL,P011193,P013250,2.917,-7,3,10
86,TEL,P011193,P013381,0.667,-2,2,4
86,TEL,P011193,P013382,23.818,8,63,55
86,TEL,P011193,P013383,12.084,2,29,27
86,TEL,P011193,P013389,0.117,0,0,0
86,TEL,P011219,P013250,9.834,3,22,19
86,TEL,P011219,P013381,9.534,-3,18,21
86,TEL,P011219,P013382,16.368,10,44,34
86,TEL,P011219,P013383,0.567,-2,0,2
86,TEL,P011219,P013389,8.367,6,19,13
86,TEL,P013250,P013381,13.684,-4,25,29
86,TEL,P013250,P013382,5.634,-1,13,14
86,TEL,P013250,P013383,7.667,-13,9,22
86,TEL,P013250,P013389,11.5,1,23,22
86,TEL,P013381,P013382,3.451,3,9,6
86,TEL,P013381,P013383,6.417,-11,9,20
86,TEL,P013381,P013389,10.6,0,20,20
86,TEL,P013382,P013383,11.584,2,29,27
86,TEL,P013382,P013389,3.384,6,10,4
86,TEL,P013383,P013389,3.133,-5,4,9
87,ULK,P002849,P002968,5.117,6,13,7
87,ULK,P002849,P002969,0.333,1,1,0
87,ULK,P002849,P004004,13.567,6,25,19
87,ULK,P002849,P006961,7.384,10,15,5
87,ULK,P002849,P007182,0.5,0,2,2
87,ULK,P002849,P008104,9.416,7,15,8
87,ULK,P002849,P008962,12.833,6,21,15
87,ULK,P002849,P009783,8.7,3,14,11
87,ULK,P002849,P010560,12.05,8,30,22
87,ULK,P002849,P013396,3.9,1,8,7
87,ULK,P002968,P004004,13.267,5,30,25
87,ULK,P002968,P006961,5.634,-4,7,11
87,ULK,P002968,P008104,6.067,5,12,7
87,ULK,P002968,P008962,10.567,1,19,18
87,ULK,P002968,P009783,8.867,2,17,15
87,ULK,P002968,P010560,9.25,12,22,10
87,ULK,P002968,P013396,3.967,1,8,7
87,ULK,P002969,P004004,0.333,1,1,0
87,ULK,P002969,P008962,0.333,1,1,0
87,ULK,P002969,P010560,0.333,1,1,0
87,ULK,P004004,P006961,7.151,-7,8,15
87,ULK,P004004,P007182,5.317,-5,9,14
87,ULK,P004004,P008104,13.65,2,24,22
87,ULK,P004004,P008962,24.15,-5,40,45
87,ULK,P004004,P009783,17.6,-2,33,35
87,ULK,P004004,P010560,17.966,8,39,31
87,ULK,P004004,P013396,6.067,1,11,10
87,ULK,P006961,P007182,2.933,-2,4,6
87,ULK,P006961,P008104,8.55,6,13,7
87,ULK,P006961,P008962,13.517,-6,16,22
87,ULK,P006961,P009783,8.95,-7,8,15
87,ULK,P006961,P010560,4.817,6,13,7
87,ULK,P007182,P008104,5.6,-5,10,15
87,ULK,P007182,P008962,7.75,-7,11,18
87,ULK,P007182,P009783,5.583,-7,8,15
87,ULK,P007182,P010560,3.15,-2,5,7
87,ULK,P007182,P013396,2.167,0,3,3
87,ULK,P008104,P008962,23.316,8,39,31
87,ULK,P008104,P009783,19.966,3,34,31
87,ULK,P008104,P010560,8.699,6,17,11
87,ULK,P008962,P009783,26.383,-1,45,46
87,ULK,P008962,P010560,16.449,7,33,26
87,ULK,P008962,P013396,2.234,0,3,3
87,ULK,P009783,P010560,9.416,5,21,16
87,ULK,P009783,P013396,0.067,0,0,0
87,ULK,P010560,P013396,6.134,1,11,10
87,ZAL,P002329,P002676,14.516,-12,21,33
87,ZAL,P002329,P003048,4.266,-7,4,11
87,ZAL,P002329,P003210,8.683,2,17,15
87,ZAL,P002329,P005504,10.517,0,17,17
87,ZAL,P002329,P007029,3.633,-7,2,9
87,ZAL,P002329,P007513,10.299,-5,12,17
87,ZAL,P002329,P007975,10.783,-9,15,24
87,ZAL,P002329,P011983,8.25,7,20,13
87,ZAL,P002329,P012622,10.267,-1,16,17
87,ZAL,P002329,P013403,13.85,0,28,28
87,ZAL,P002676,P003048,15.266,-3,22,25
87,ZAL,P002676,P003210,4.049,-12,1,13
87,ZAL,P002676,P005504,3.983,-8,1,9
87,ZAL,P002676,P007029,5.466,-9,4,13
87,ZAL,P002676,P007513,11.516,4,18,14
87,ZAL,P002676,P007975,19.417,-2,36,38
87,ZAL,P002676,P011983,4.799,-6,8,14
87,ZAL,P002676,P012622,15.784,12,32,20
87,ZAL,P002676,P013403,18.6,-8,29,37
87,ZAL,P003048,P003210,1.95,-3,0,3
87,ZAL,P003048,P007029,6.816,-7,9,16
87,ZAL,P003048,P007513,7.233,1,11,10
87,ZAL,P003048,P007975,13.733,-1,25,26
87,ZAL,P003048,P011983,1.933,-7,0,7
87,ZAL,P003048,P012622,11.867,8,21,13
87,ZAL,P003048,P012715,2.4,0,5,5
87,ZAL,P003048,P013403,9.0,-1,11,12
87,ZAL,P003210,P005504,9.333,3,17,14
87,ZAL,P003210,P007029,0.917,-1,0,1
87,ZAL,P003210,P007513,1.433,-1,1,2
87,ZAL,P003210,P007975,0.083,-4,0,4
87,ZAL,P003210,P011983,8.166,4,16,12
87,ZAL,P003210,P012622,3.084,-1,3,4
87,ZAL,P003210,P012715,0.917,-1,0,1
87,ZAL,P003210,P013403,6.849,-2,13,15
87,ZAL,P005504,P007029,1.05,-2,0,2
87,ZAL,P005504,P007513,3.35,-7,1,8
87,ZAL,P005504,P011983,8.0,2,16,14
87,ZAL,P005504,P012622,2.167,0,3,3
87,ZAL,P005504,P013403,6.6,0,13,13
87,ZAL,P007029,P007513,2.533,-3,2,5
87,ZAL,P007029,P007975,4.416,-5,7,12
87,ZAL,P007029,P012622,2.733,-1,5,6
87,ZAL,P007029,P012715,2.4,0,5,5
87,ZAL,P007029,P013403,1.5,-1,2,3
87,ZAL,P007513,P007975,7.1,5,12,7
87,ZAL,P007513,P011983,1.85,-2,4,6
87,ZAL,P007513,P012622,7.05,5,10,5
87,ZAL,P007513,P013403,5.1,-1,5,6
87,ZAL,P007975,P011983,2.05,-3,4,7
87,ZAL,P007975,P012622,17.8,12,38,26
87,ZAL,P007975,P012715,1.483,1,5,4
87,ZAL,P007975,P013403,14.667,-2,26,28
87,ZAL,P011983,P012622,3.317,2,7,5
87,ZAL,P011983,P013403,9.899,-1,21,22
87,ZAL,P012622,P012715,2.4,0,5,5
87,ZAL,P012622,P013403,12.867,8,24,16
88,BAR,P000925,P002939,7.934,-1,15,16
88,BAR,P000925,P003478,9.35,-1,17,18
88,BAR,P000925,P007464,10.05,-1,27,28
88,BAR,P000925,P009862,19.4,-2,44,46
88,BAR,P000925,P010106,11.466,-1,29,30
88,BAR,P000925,P012745,19.4,-2,44,46
88,BAR,P002939,P003196,3.367,-4,8,12
88,BAR,P002939,P003478,10.484,-5,19,24
88,BAR,P002939,P007464,5.384,-5,11,16
88,BAR,P002939,P009862,8.334,-1,15,16
88,BAR,P002939,P009992,3.367,-4,8,12
88,BAR,P002939,P011666,4.167,-5,7,12
88,BAR,P002939,P012745,13.418,-7,25,32
88,BAR,P002939,P013379,7.017,-8,12,20
88,BAR,P003196,P003478,7.25,0,14,14
88,BAR,P003196,P007464,6.5,-5,16,21
88,BAR,P003196,P009862,5.466,1,14,13
88,BAR,P003196,P009992,8.284,-6,16,22
88,BAR,P003196,P010106,10.383,-1,22,23
88,BAR,P003196,P012745,7.8,6,24,18
88,BAR,P003196,P013379,5.95,-11,6,17
88,BAR,P003478,P009862,11.933,5,25,20
88,BAR,P003478,P009992,5.2,-8,6,14
88,BAR,P003478,P010106,10.683,-1,19,20
88,BAR,P003478,P011666,4.3,-7,7,14
88,BAR,P003478,P012745,16.233,-2,32,34
88,BAR,P003478,P013379,9.767,-13,13,26
88,BAR,P007464,P009862,14.05,-10,33,43
88,BAR,P007464,P009992,4.65,2,16,14
88,BAR,P007464,P010106,13.316,-3,38,41
88,BAR,P007464,P011666,1.433,2,6,4
88,BAR,P007464,P012745,16.384,-5,43,48
88,BAR,P007464,P013379,3.033,-7,6,13
88,BAR,P009862,P010106,17.649,-4,43,47
88,BAR,P009862,P012745,25.4,0,58,58
88,BAR,P009862,P013379,1.7,-9,0,9
88,BAR,P009992,P010106,6.35,0,14,14
88,BAR,P009992,P011666,1.566,0,6,6
88,BAR,P009992,P012745,3.05,-2,10,12
88,BAR,P009992,P013379,6.933,-6,12,18
88,BAR,P010106,P011666,1.433,2,6,4
88,BAR,P010106,P012745,19.066,2,50,48
88,BAR,P010106,P013379,5.65,-10,7,17
88,BAR,P011666,P012745,4.3,-7,7,14
88,BAR,P011666,P013379,5.733,-5,13,18
88,BAR,P012745,P013379,5.417,-11,7,18
88,PRS,P004197,P004512,1.65,3,5,2
88,PRS,P004197,P005793,1.45,3,5,2
88,PRS,P004197,P010390,10.383,0,22,22
88,PRS,P004197,P012608,12.95,4,29,25
88,PRS,P004197,P012609,2.567,4,7,3
88,PRS,P004197,P012610,11.3,1,24,23
88,PRS,P004197,P012613,11.5,1,24,23
88,PRS,P004512,P005793,4.55,-9,8,17
88,PRS,P004512,P007032,6.55,-2,15,17
88,PRS,P004512,P012608,6.217,9,20,11
88,PRS,P004512,P012609,9.533,-3,25,28
88,PRS,P004512,P012610,4.567,6,15,9
88,PRS,P004512,P012613,6.6,11,22,11
88,PRS,P004512,P012640,4.933,-7,10,17
88,PRS,P005793,P007032,14.233,-4,35,39
88,PRS,P005793,P010390,2.333,0,5,5
88,PRS,P005793,P012608,1.45,3,5,2
88,PRS,P005793,P012609,14.233,-4,35,39
88,PRS,P005793,P012610,1.783,1,5,4
88,PRS,P005793,P012611,1.1,-2,2,4
88,PRS,P005793,P012640,14.233,-4,35,39
88,PRS,P005793,P013373,7.367,12,25,13
88,PRS,P007032,P010390,2.216,-4,2,6
88,PRS,P007032,P012608,4.45,12,15,3
88,PRS,P007032,P012609,16.116,6,45,39
88,PRS,P007032,P012610,4.783,10,15,5
88,PRS,P007032,P012611,1.1,-2,2,4
88,PRS,P007032,P012613,4.833,14,17,3
88,PRS,P007032,P012640,14.616,-2,37,39
88,PRS,P007032,P013373,7.367,12,25,13
88,PRS,P010390,P012608,15.449,3,32,29
88,PRS,P010390,P012609,0.883,-3,0,3
88,PRS,P010390,P012610,15.449,3,32,29
88,PRS,P010390,P012613,13.999,0,27,27
88,PRS,P010390,P012640,4.616,1,8,7
88,PRS,P012608,P012609,8.317,10,29,19
88,PRS,P012608,P012610,23.733,15,61,46
88,PRS,P012608,P012613,23.933,15,61,46
88,PRS,P012608,P012640,5.033,1,12,11
88,PRS,P012609,P012610,7.0,5,24,19
88,PRS,P012609,P012611,1.1,-2,2,4
88,PRS,P012609,P012613,8.7,12,31,19
88,PRS,P012609,P012640,15.916,-5,41,46
88,PRS,P012609,P013373,7.367,12,25,13
88,PRS,P012610,P012613,22.283,12,56,44
88,PRS,P012610,P012640,5.366,-1,12,13
88,PRS,P012611,P012640,1.1,-2,2,4
88,PRS,P012613,P012640,5.416,3,14,11
88,PRS,P012640,P013373,7.367,12,25,13
89,MIL,P000796,P001392,12.65,5,34,29
89,MIL,P000796,P001518,18.267,9,42,33
89,MIL,P000796,P006085,7.517,-1,14,15
89,MIL,P000796,P006721,2.35,-4,2,6
89,MIL,P000796,P008985,18.2,-4,33,37
89,MIL,P000796,P008987,18.084,10,43,33
89,MIL,P000796,P011064,20.75,2,49,47
89,MIL,P000796,P013384,12.9,-2,29,31
89,MIL,P000796,P013385,6.567,-2,19,21
89,MIL,P000796,P013386,1.583,-1,3,4
89,MIL,P001392,P001518,11.017,13,29,16
89,MIL,P001392,P006085,4.95,-8,8,16
89,MIL,P001392,P006721,2.35,-4,2,6
89,MIL,P001392,P008985,8.9,-3,14,17
89,MIL,P001392,P008987,13.667,9,34,25
89,MIL,P001392,P011064,11.317,9,32,23
89,MIL,P001392,P013384,13.85,2,31,29
89,MIL,P001392,P013385,4.117,1,12,11
89,MIL,P001392,P013386,4.05,-4,8,12
89,MIL,P001518,P006085,4.567,2,9,7
89,MIL,P001518,P008985,21.667,6,41,35
89,MIL,P001518,P008987,22.968,19,54,35
89,MIL,P001518,P011064,17.2,8,38,30
89,MIL,P001518,P013384,6.667,10,15,5
89,MIL,P001518,P013385,1.983,-3,4,7
89,MIL,P006085,P006721,1.217,-2,2,4
89,MIL,P006085,P008985,5.267,-4,9,13
89,MIL,P006085,P008987,6.717,-3,12,15
89,MIL,P006085,P013384,4.25,-2,8,10
89,MIL,P006085,P013386,3.583,-6,6,12
89,MIL,P006721,P008985,1.133,-2,0,2
89,MIL,P006721,P013384,2.35,-4,2,6
89,MIL,P008985,P008987,21.968,4,44,40
89,MIL,P008985,P011064,16.784,3,35,32
89,MIL,P008985,P013384,10.7,3,19,16
89,MIL,P008985,P013385,2.95,-3,7,10
89,MIL,P008985,P013386,1.167,-4,2,6
89,MIL,P008987,P011064,17.334,11,41,30
89,MIL,P008987,P013384,9.267,9,23,14
89,MIL,P008987,P013386,2.467,-3,5,8
89,MIL,P011064,P013384,9.717,3,24,21
89,MIL,P011064,P013385,6.567,-2,19,21
89,MIL,P011064,P013386,0.467,2,2,0
89,MIL,P013384,P013385,5.084,1,15,14
89,MIL,P013384,P013386,2.883,0,6,6
89,PAR,P006591,P006760,13.883,5,30,25
89,PAR,P006591,P007870,16.8,-7,30,37
89,PAR,P006591,P008232,7.5,-7,14,21
89,PAR,P006591,P010781,14.416,-4,27,31
89,PAR,P006591,P011981,4.45,3,12,9
89,PAR,P006591,P012167,5.883,-3,9,12
89,PAR,P006591,P012720,15.5,1,35,34
89,PAR,P006591,P013369,6.4,8,19,11
89,PAR,P006591,P013370,0.7,-4,0,4
89,PAR,P006760,P007870,16.433,-3,34,37
89,PAR,P006760,P008232,5.6,1,9,8
89,PAR,P006760,P010781,15.066,-4,31,35
89,PAR,P006760,P011981,5.6,1,9,8
89,PAR,P006760,P012167,8.333,-5,15,20
89,PAR,P006760,P012720,16.283,3,36,33
89,PAR,P006760,P013369,7.466,2,16,14
89,PAR,P007870,P008232,7.7,-14,10,24
89,PAR,P007870,P010781,18.766,-11,34,45
89,PAR,P007870,P012167,9.966,-6,20,26
89,PAR,P007870,P012720,18.25,-14,35,49
89,PAR,P007870,P013369,6.7,-5,13,18
89,PAR,P007870,P013370,1.917,-8,0,8
89,PAR,P008232,P010781,4.916,-6,7,13
89,PAR,P008232,P011981,15.733,8,35,27
89,PAR,P008232,P012167,1.633,-1,5,6
89,PAR,P008232,P012720,23.433,-6,45,51
89,PAR,P008232,P013369,20.7,4,43,39
89,PAR,P008232,P013370,6.517,-3,12,15
89,PAR,P010781,P011981,1.083,-1,2,3
89,PAR,P010781,P012167,8.333,-5,15,20
89,PAR,P010781,P012720,14.099,-7,29,36
89,PAR,P010781,P013369,3.249,-2,7,9
89,PAR,P011981,P012720,15.733,8,35,27
89,PAR,P011981,P013369,15.733,8,35,27
89,PAR,P011981,P013370,4.6,5,12,7
89,PAR,P012167,P012720,4.083,-3,11,14
89,PAR,P012167,P013369,1.633,-1,5,6
89,PAR,P012720,P013369,22.566,5,50,45
89,PAR,P012720,P013370,6.517,-3,12,15
89,PAR,P013369,P013370,5.817,1,12,11
90,PAN,P001926,P003842,17.15,-2,28,30
90,PAN,P001926,P004088,6.067,-1,7,8
90,PAN,P001926,P005161,13.184,-3,19,22
90,PAN,P001926,P005353,10.667,5,30,25
90,PAN,P001926,P007866,9.1,-3,14,17
90,PAN,P001926,P011204,16.633,4,43,39
90,PAN,P001926,P011209,4.217,4,7,3
90,PAN,P001926,P012712,20.117,-2,44,46
90,PAN,P001926,P012774,16.933,-6,40,46
90,PAN,P003842,P004088,4.6,-1,4,5
90,PAN,P003842,P005161,17.733,-1,30,31
90,PAN,P003842,P007866,16.033,6,30,24
90,PAN,P003842,P011204,22.016,10,45,35
90,PAN,P003842,P011209,6.167,6,12,6
90,PAN,P003842,P012712,12.6,-2,22,24
90,PAN,P003842,P012774,18.233,0,37,37
90,PAN,P004088,P005161,3.484,1,5,4
90,PAN,P004088,P005353,2.617,3,5,2
90,PAN,P004088,P007866,1.167,-4,0,4
90,PAN,P004088,P011204,4.15,-2,4,6
90,PAN,P004088,P011209,1.85,-1,2,3
90,PAN,P004088,P012712,7.45,-2,9,11
90,PAN,P004088,P012774,0.283,-1,0,1
90,PAN,P005161,P005353,4.984,2,8,6
90,PAN,P005161,P007866,17.933,5,33,28
90,PAN,P005161,P011204,11.116,5,23,18
90,PAN,P005161,P012712,4.784,-4,5,9
90,PAN,P005161,P012774,17.65,-1,29,30
90,PAN,P005353,P007866,2.367,-1,3,4
90,PAN,P005353,P011204,5.683,3,22,19
90,PAN,P005353,P012712,8.3,6,27,21
90,PAN,P005353,P012774,8.05,2,25,23
90,PAN,P007866,P011204,12.0,2,23,21
90,PAN,P007866,P011209,0.467,0,0,0
90,PAN,P007866,P012712,0.7,-4,0,4
90,PAN,P007866,P012774,16.633,3,29,26
90,PAN,P011204,P011209,6.167,6,12,6
90,PAN,P011204,P012712,16.533,5,44,39
90,PAN,P011204,P012774,18.166,7,52,45
90,PAN,P011209,P012712,5.7,6,12,6
90,PAN,P011209,P012774,0.1,3,3,0
90,PAN,P012712,P012774,10.216,-3,33,36
90,VIR,P001133,P001844,3.8,4,11,7
90,VIR,P001133,P002084,11.35,-3,24,27
90,VIR,P001133,P004554,6.25,3,13,10
90,VIR,P001133,P004888,28.334,-1,59,60
90,VIR,P001133,P006739,26.718,0,57,57
90,VIR,P001133,P009549,28.834,-9,50,59
90,VIR,P001133,P012585,2.05,-1,3,4
90,VIR,P001133,P013374,12.034,-1,26,27
90,VIR,P001133,PBCN,6.034,-4,9,13
90,VIR,P001844,P002084,7.966,5,18,13
90,VIR,P001844,P004554,5.833,4,12,8
90,VIR,P001844,P004888,7.033,7,17,10
90,VIR,P001844,P006739,0.167,5,5,0
90,VIR,P001844,P009549,6.849,6,16,10
90,VIR,P001844,P012591,2.617,-3,2,5
90,VIR,P001844,P013374,0.167,5,5,0
90,VIR,P001844,PBCN,4.1,-1,6,7
90,VIR,P002084,P004554,6.766,0,14,14
90,VIR,P002084,P004888,13.449,0,26,26
90,VIR,P002084,P006739,11.033,-8,20,28
90,VIR,P002084,P009549,15.032,-3,28,31
90,VIR,P002084,P012585,2.05,-1,3,4
90,VIR,P002084,P012591,2.617,-3,2,5
90,VIR,P002084,P013374,1.883,-2,0,2
90,VIR,P002084,PBCN,7.85,-5,17,22
90,VIR,P004554,P004888,9.483,6,19,13
90,VIR,P004554,P006739,7.183,-1,15,16
90,VIR,P004554,P009549,10.399,6,25,19
90,VIR,P004554,P012591,2.617,-3,2,5
90,VIR,P004554,PBCN,3.533,-3,8,11
90,VIR,P004888,P006739,25.584,0,53,53
90,VIR,P004888,P009549,29.833,-3,52,55
90,VIR,P004888,P012585,2.05,-1,3,4
90,VIR,P004888,P012591,1.1,-3,0,3
90,VIR,P004888,P013374,13.917,-3,26,29
90,VIR,P004888,PBCN,3.017,-2,5,7
90,VIR,P006739,P009549,27.017,-12,46,58
90,VIR,P006739,P012585,1.05,1,3,2
90,VIR,P006739,P013374,13.917,-3,26,29
90,VIR,P006739,PBCN,5.467,-6,11,17
90,VIR,P009549,P012585,1.0,-2,0,2
90,VIR,P009549,P013374,13.75,-8,21,29
90,VIR,P009549,PBCN,6.75,-7,10,17
90,VIR,P012591,PBCN,1.517,0,2,2
91,ULK,P002849,P002968,2.85,-3,5,8
91,ULK,P002849,P004004,5.684,-4,7,11
91,ULK,P002849,P006961,2.634,-2,0,2
91,ULK,P002849,P007182,2.834,-1,2,3
91,ULK,P002849,P008104,2.767,-5,2,7
91,ULK,P002849,P008962,2.767,-5,2,7
91,ULK,P002849,P009783,5.6,-6,4,10
91,ULK,P002849,P010560,2.851,-3,5,8
91,ULK,P002849,P013396,5.817,-7,9,16
91,ULK,P002968,P004004,11.867,5,29,24
91,ULK,P002968,P006961,13.917,6,32,26
91,ULK,P002968,P008104,7.75,4,16,12
91,ULK,P002968,P008962,16.767,12,40,28
91,ULK,P002968,P009783,18.5,11,42,31
91,ULK,P002968,P010560,1.117,-2,3,5
91,ULK,P002968,P013396,5.7,3,13,10
91,ULK,P004004,P006961,12.6,7,32,25
91,ULK,P004004,P007182,11.417,4,25,21
91,ULK,P004004,P008104,4.749,6,16,10
91,ULK,P004004,P008962,14.083,15,39,24
91,ULK,P004004,P009783,18.683,15,49,34
91,ULK,P004004,P010560,6.901,-2,16,18
91,ULK,P004004,P013396,7.484,2,15,13
91,ULK,P006961,P007182,11.167,-3,20,23
91,ULK,P006961,P008104,15.05,0,29,29
91,ULK,P006961,P008962,23.184,4,52,48
91,ULK,P006961,P009783,20.517,11,50,39
91,ULK,P006961,P010560,5.667,-7,5,12
91,ULK,P007182,P008104,10.783,-4,24,28
91,ULK,P007182,P008962,11.1,-3,23,26
91,ULK,P007182,P009783,10.617,5,29,24
91,ULK,P007182,P010560,9.134,-7,15,22
91,ULK,P007182,P013396,3.084,-3,6,9
91,ULK,P008104,P008962,17.783,-3,34,37
91,ULK,P008104,P009783,16.617,5,40,35
91,ULK,P008104,P010560,6.983,-6,13,19
91,ULK,P008104,P013396,3.05,-5,6,11
91,ULK,P008962,P009783,26.917,14,66,52
91,ULK,P008962,P010560,3.8,-7,2,9
91,ULK,P008962,P013396,6.467,1,14,13
91,ULK,P009783,P010560,2.217,1,8,7
91,ULK,P009783,P013396,8.2,0,16,16
91,ULK,P010560,P013396,2.334,-3,5,8
91,VIR,P001133,P001844,13.716,-9,22,31
91,VIR,P001133,P002084,5.434,2,11,9
91,VIR,P001133,P004554,26.85,-5,53,58
91,VIR,P001133,P004888,25.451,-6,56,62
91,VIR,P001133,P006739,15.934,-5,29,34
91,VIR,P001133,P009549,26.133,-9,50,59
91,VIR,P001133,P012585,13.385,3,35,32
91,VIR,P001133,PBCN,6.433,1,8,7
91,VIR,P001844,P002084,8.317,5,19,14
91,VIR,P001844,P004554,10.65,-6,18,24
91,VIR,P001844,P004888,13.35,-10,21,31
91,VIR,P001844,P006739,0.083,-3,0,3
91,VIR,P001844,P009549,7.282,-13,6,19
91,VIR,P001844,P012585,10.651,7,26,19
91,VIR,P001844,P013374,3.1,1,5,4
91,VIR,P001844,PBCN,4.583,4,11,7
91,VIR,P002084,P004554,1.117,2,5,3
91,VIR,P002084,P004888,9.251,2,19,17
91,VIR,P002084,P006739,1.734,0,2,2
91,VIR,P002084,P009549,3.083,-1,7,8
91,VIR,P002084,P012585,11.068,6,26,20
91,VIR,P002084,P013374,5.55,1,11,10
91,VIR,P002084,PBCN,2.85,3,8,5
91,VIR,P004554,P004888,18.967,-4,43,47
91,VIR,P004554,P006739,14.117,1,27,26
91,VIR,P004554,P009549,23.483,-6,45,51
91,VIR,P004554,P012585,9.134,3,28,25
91,VIR,P004554,PBCN,7.55,3,13,10
91,VIR,P004888,P006739,10.751,-1,24,25
91,VIR,P004888,P009549,21.183,-10,46,56
91,VIR,P004888,P012585,14.302,5,39,34
91,VIR,P004888,P013374,3.817,0,8,8
91,VIR,P006739,P009549,15.167,-3,29,32
91,VIR,P006739,P012585,4.151,-3,6,9
91,VIR,P006739,P013374,0.967,2,2,0
91,VIR,P006739,PBCN,4.7,0,5,5
91,VIR,P009549,P012585,7.667,-1,23,24
91,VIR,P009549,P013374,1.483,-2,4,6
91,VIR,P009549,PBCN,4.983,1,6,5
91,VIR,P012585,P013374,5.55,1,11,10
91,VIR,P012585,PBCN,4.3,3,10,7
91,VIR,P013374,PBCN,1.733,1,3,2
92,ASV,P002100,P003526,9.284,14,37,23
92,ASV,P002100,P004194,10.434,-3,31,34
92,ASV,P002100,P007027,16.134,5,52,47
92,ASV,P002100,P008991,2.984,0,9,9
92,ASV,P002100,P010545,15.517,-1,41,42
92,ASV,P002100,P012731,8.667,6,33,27
92,ASV,P002100,P013371,7.05,-7,11,18
92,ASV,P002100,P013405,11.466,-14,17,31
92,ASV,P002100,PKIR,11.2,-8,21,29
92,ASV,P003526,P004194,19.833,-4,41,45
92,ASV,P003526,P007027,25.517,6,64,58
92,ASV,P003526,P008991,2.65,-1,7,8
92,ASV,P003526,P010545,6.9,8,23,15
92,ASV,P003526,P012731,21.05,8,55,47
92,ASV,P003526,P013371,15.133,-9,25,34
92,ASV,P003526,P013405,1.833,2,4,2
92,ASV,P004194,P007027,26.717,-14,58,72
92,ASV,P004194,P008991,3.617,-1,9,10
92,ASV,P004194,P010545,4.5,-5,11,16
92,ASV,P004194,P012731,18.683,-7,38,45
92,ASV,P004194,P013371,15.683,-10,27,37
92,ASV,P004194,P013405,2.666,-7,4,11
92,ASV,P004194,PKIR,4.867,-5,13,18
92,ASV,P007027,P008991,3.617,-1,9,10
92,ASV,P007027,P010545,10.7,5,34,29
92,ASV,P007027,P012731,23.067,3,59,56
92,ASV,P007027,P013371,15.65,-10,27,37
92,ASV,P007027,P013405,4.916,-5,8,13
92,ASV,P007027,PKIR,5.35,-5,13,18
92,ASV,P008991,P012731,0.633,-1,0,1
92,ASV,P008991,PKIR,0.967,0,2,2
92,ASV,P010545,P012731,5.067,7,22,15
92,ASV,P010545,P013371,8.783,-10,13,23
92,ASV,P010545,P013405,9.333,-5,15,20
92,ASV,P010545,PKIR,10.2,-7,21,28
92,ASV,P012731,P013371,14.6,-10,26,36
92,ASV,P012731,P013405,3.233,-6,7,13
92,ASV,P013371,P013405,7.083,-7,11,18
92,ASV,P013371,PKIR,6.95,-5,12,17
92,ASV,P013405,PKIR,7.466,-6,10,16
92,MCO,P005844,P005985,11.133,2,33,31
92,MCO,P005844,P008099,13.133,9,38,29
92,MCO,P005844,P009754,9.884,5,28,23
92,MCO,P005844,P011212,18.551,23,57,34
92,MCO,P005844,P011226,6.417,-4,19,23
92,MCO,P005844,P011231,17.25,11,51,40
92,MCO,P005844,P013365,7.5,10,18,8
92,MCO,P005985,P008099,9.833,6,32,26
92,MCO,P005985,P009754,11.534,-7,19,26
92,MCO,P005985,P011212,13.918,4,33,29
92,MCO,P005985,P011226,20.001,-8,48,56
92,MCO,P005985,P011231,24.368,-2,60,62
92,MCO,P005985,P013365,3.767,1,9,8
92,MCO,P005985,PLCZ,16.118,-4,34,38
92,MCO,P008099,P009754,5.417,6,19,13
92,MCO,P008099,P011212,13.634,19,42,23
92,MCO,P008099,P011226,11.867,4,37,33
92,MCO,P008099,P011231,19.25,18,58,40
92,MCO,P008099,P013365,6.917,4,16,12
92,MCO,P008099,PLCZ,8.617,10,30,20
92,MCO,P009754,P011212,10.768,9,30,21
92,MCO,P009754,P011226,8.934,-3,18,21
92,MCO,P009754,P011231,12.751,-2,28,30
92,MCO,P009754,PLCZ,6.584,-4,10,14
92,MCO,P011212,P011226,9.168,2,25,23
92,MCO,P011212,P011231,21.001,12,52,40
92,MCO,P011212,P013365,10.684,5,25,20
92,MCO,P011212,PLCZ,7.284,-6,12,18
92,MCO,P011226,P011231,17.184,-7,42,49
92,MCO,P011226,P013365,2.017,0,7,7
92,MCO,P011226,PLCZ,16.084,0,40,40
92,MCO,P011231,P013365,8.667,5,18,13
92,MCO,P011231,PLCZ,16.601,-3,35,38
92,MCO,P013365,PLCZ,3.184,-5,7,12
93,PAR,P006591,P006760,14.7,6,29,23
93,PAR,P006591,P007870,13.716,4,26,22
93,PAR,P006591,P010781,17.483,19,42,23
93,PAR,P006591,P011836,22.016,18,49,31
93,PAR,P006591,P011981,11.817,15,32,17
93,PAR,P006591,P012720,9.4,2,20,18
93,PAR,P006591,P013369,13.0,12,34,22
93,PAR,P006760,P007870,16.233,6,32,26
93,PAR,P006760,P008232,2.033,-2,3,5
93,PAR,P006760,P010781,13.0,8,28,20
93,PAR,P006760,P011836,16.783,7,33,26
93,PAR,P006760,P011981,6.85,0,15,15
93,PAR,P006760,P012720,12.1,2,26,24
93,PAR,P006760,P013369,10.633,-3,22,25
93,PAR,P007870,P010781,8.766,5,16,11
93,PAR,P007870,P011836,16.816,5,32,27
93,PAR,P007870,P012720,7.117,3,14,11
93,PAR,P007870,P013369,4.616,-3,8,11
93,PAR,P008232,P010781,3.817,-4,8,12
93,PAR,P008232,P011981,5.85,-6,11,17
93,PAR,P008232,P012720,5.85,-6,11,17
93,PAR,P008232,P013369,5.85,-6,11,17
93,PAR,P010781,P011836,19.883,17,45,28
93,PAR,P010781,P011981,21.151,9,54,45
93,PAR,P010781,P012720,11.317,-7,28,35
93,PAR,P010781,P013369,24.251,9,59,50
93,PAR,P011836,P011981,11.117,12,29,17
93,PAR,P011836,P012720,9.967,0,20,20
93,PAR,P011836,P013369,15.15,9,36,27
93,PAR,P011981,P012720,13.35,-9,31,40
93,PAR,P011981,P013369,22.601,7,56,49
93,PAR,P012720,P013369,12.767,-9,30,39
93,RED,P000848,P002553,3.8,-8,2,10
93,RED,P000848,P004866,14.649,-12,24,36
93,RED,P000848,P006240,5.333,0,14,14
93,RED,P000848,P006436,7.9,0,20,20
93,RED,P000848,P009048,20.649,-11,39,50
93,RED,P000848,P011194,11.733,-3,23,26
93,RED,P000848,P012044,5.5,5,19,14
93,RED,P000848,P012786,11.133,-11,13,24
93,RED,P000848,PJDR,2.767,-4,2,6
93,RED,P002553,P004866,6.85,-9,6,15
93,RED,P002553,P006436,2.683,3,7,4
93,RED,P002553,P009048,5.7,-10,3,13
93,RED,P002553,P010612,5.583,-3,8,11
93,RED,P002553,P012044,5.583,-3,8,11
93,RED,P002553,P012786,6.333,-10,6,16
93,RED,P002553,PJDR,1.0,-4,0,4
93,RED,P004866,P006240,4.766,-2,11,13
93,RED,P004866,P006436,6.383,8,20,12
93,RED,P004866,P009048,18.549,-14,33,47
93,RED,P004866,P010612,11.001,5,24,19
93,RED,P004866,P011194,14.034,4,31,27
93,RED,P004866,P012044,6.667,0,14,14
93,RED,P004866,P012786,15.017,-10,21,31
93,RED,P004866,PJDR,4.684,2,8,6
93,RED,P006240,P006436,0.567,2,3,1
93,RED,P006240,P009048,5.333,0,14,14
93,RED,P006240,P012044,2.4,2,9,7
93,RED,P006240,P012786,2.933,-2,5,7
93,RED,P006436,P009048,12.167,0,28,28
93,RED,P006436,P010612,11.033,4,26,22
93,RED,P006436,P011194,16.35,-1,36,37
93,RED,P006436,P012044,10.767,6,30,24
93,RED,P006436,P012786,2.2,2,4,2
93,RED,P006436,PJDR,6.033,-7,9,16
93,RED,P006436,PLUO,2.317,-1,1,2
93,RED,P009048,P010612,6.784,-5,12,17
93,RED,P009048,P011194,17.067,-6,34,40
93,RED,P009048,P012044,8.934,-2,22,24
93,RED,P009048,P012786,12.35,-11,16,27
93,RED,P009048,PJDR,2.55,-4,2,6
93,RED,P009048,PLUO,2.317,-1,1,2
93,RED,P010612,P011194,12.884,2,30,28
93,RED,P010612,P012044,10.65,-5,21,26
93,RED,P010612,P012786,6.55,2,15,13
93,RED,P010612,PJDR,7.733,-3,15,18
93,RED,P010612,PLUO,1.65,-1,1,2
93,RED,P011194,P012044,8.167,1,23,22
93,RED,P011194,P012786,9.084,3,17,14
93,RED,P011194,PJDR,9.5,-3,17,20
93,RED,P011194,PLUO,2.317,-1,1,2
93,RED,P012044,P012786,2.666,1,7,6
93,RED,P012044,PJDR,3.266,-5,7,12
93,RED,P012786,PJDR,4.467,0,8,8
93,RED,P012786,PLUO,0.667,0,0,0
94,BAS,P004058,P007230,3.033,-4,4,8
94,BAS,P004058,P008072,4.616,-4,8,12
94,BAS,P004058,P008850,1.65,-3,3,6
94,BAS,P004058,P011085,2.45,-2,4,6
94,BAS,P004058,P011948,1.433,-1,1,2
94,BAS,P004058,P012080,4.616,-4,8,12
94,BAS,P004058,P012201,3.666,-6,4,10
94,BAS,P007230,P008072,4.167,-8,5,13
94,BAS,P007230,P008850,10.217,-7,12,19
94,BAS,P007230,P011085,21.684,0,42,42
94,BAS,P007230,P011196,15.433,-2,29,31
94,BAS,P007230,P011948,18.851,-11,36,47
94,BAS,P007230,P012058,5.667,-7,11,18
94,BAS,P007230,P012080,20.751,-15,34,49
94,BAS,P007230,P012201,10.084,-4,14,18
94,BAS,P007230,P013367,29.185,-18,49,67
94,BAS,P008072,P008850,0.9,-1,3,4
94,BAS,P008072,P011085,3.584,-6,5,11
94,BAS,P008072,P011948,4.867,-11,4,15
94,BAS,P008072,P012080,7.0,-8,10,18
94,BAS,P008072,P012201,4.883,-8,6,14
94,BAS,P008072,P013367,3.851,-10,3,13
94,BAS,P008850,P011085,8.266,-1,16,17
94,BAS,P008850,P011196,5.6,-8,6,14
94,BAS,P008850,P011948,5.567,1,10,9
94,BAS,P008850,P012080,0.9,-1,3,4
94,BAS,P008850,P012201,6.05,2,13,11
94,BAS,P008850,P013367,7.45,-6,10,16
94,BAS,P011085,P011196,10.033,8,23,15
94,BAS,P011085,P011948,6.883,8,23,15
94,BAS,P011085,P012080,10.151,0,17,17
94,BAS,P011085,P012201,8.6,0,18,18
94,BAS,P011085,P013367,17.217,1,36,35
94,BAS,P011196,P011948,8.133,-1,18,19
94,BAS,P011196,P012080,7.9,-3,11,14
94,BAS,P011196,P012201,0.4,0,0,0
94,BAS,P011196,P013367,15.833,-2,29,31
94,BAS,P011948,P012058,5.667,-7,11,18
94,BAS,P011948,P012080,13.817,-18,20,38
94,BAS,P011948,P012201,8.317,0,13,13
94,BAS,P011948,P013367,19.201,-16,36,52
94,BAS,P012058,P012080,5.667,-7,11,18
94,BAS,P012058,P013367,5.667,-7,11,18
94,BAS,P012080,P012201,10.167,-11,14,25
94,BAS,P012080,P013367,20.835,-17,32,49
94,BAS,P012201,P013367,9.101,-5,14,19
94,OLY,P001255,P003941,10.15,5,22,17
94,OLY,P001255,P007853,15.15,11,34,23
94,OLY,P001255,P007947,6.2,7,18,11
94,OLY,P001255,P007982,9.367,4,17,13
94,OLY,P001255,P008811,6.45,8,14,6
94,OLY,P001255,P008829,10.317,13,22,9
94,OLY,P001255,P008855,4.433,4,10,6
94,OLY,P001255,P010392,8.05,9,20,11
94,OLY,P001255,P012878,3.4,2,9,7
94,OLY,P001255,P013380,6.483,-3,14,17
94,OLY,P003941,P007853,13.333,8,32,24
94,OLY,P003941,P007947,9.55,10,24,14
94,OLY,P003941,P007982,17.283,8,38,30
94,OLY,P003941,P008829,13.8,13,33,20
94,OLY,P003941,P010392,3.2,5,9,4
94,OLY,P003941,P013380,13.016,3,30,27
94,OLY,P007853,P007947,2.8,5,9,4
94,OLY,P007853,P007982,13.633,14,34,20
94,OLY,P007853,P008811,6.083,13,19,6
94,OLY,P007853,P008829,13.133,21,37,16
94,OLY,P007853,P008855,2.983,2,8,6
94,OLY,P007853,P010392,3.2,5,9,4
94,OLY,P007853,P013380,7.349,5,22,17
94,OLY,P007947,P007982,9.617,2,17,15
94,OLY,P007947,P008811,8.984,-7,15,22
94,OLY,P007947,P008829,15.734,-2,30,32
94,OLY,P007947,P008855,6.117,-4,13,17
94,OLY,P007947,P010392,6.2,7,18,11
94,OLY,P007947,P012878,3.4,2,9,7
94,OLY,P007947,P013380,19.134,0,39,39
94,OLY,P007982,P008811,5.967,8,13,5
94,OLY,P007982,P008829,19.767,21,46,25
94,OLY,P007982,P010392,0.4,0,0,0
94,OLY,P007982,P013380,16.966,7,39,32
94,OLY,P008811,P008829,16.517,8,36,28
94,OLY,P008811,P008855,10.55,0,23,23
94,OLY,P008811,P010392,1.45,2,2,0
94,OLY,P008811,P013380,10.067,0,22,22
94,OLY,P008829,P008855,10.55,0,23,23
94,OLY,P008829,P010392,1.45,2,2,0
94,OLY,P008829,P013380,20.0,8,47,39
94,OLY,P008855,P010392,1.45,2,2,0
94,OLY,P008855,P013380,6.117,-4,13,17
94,OLY,P010392,P012878,3.4,2,9,7
94,OLY,P010392,P013380,3.4,2,9,7
94,OLY,P012878,P013380,3.4,2,9,7
95,MIL,P000796,P001392,14.699,0,32,32
95,MIL,P000796,P001518,3.866,2,11,9
95,MIL,P000796,P006085,4.283,-4,8,12
95,MIL,P000796,P006721,2.616,0,4,4
95,MIL,P000796,P007831,25.8,21,71,50
95,MIL,P000796,P008987,28.567,17,75,58
95,MIL,P000796,P011064,28.266,19,74,55
95,MIL,P000796,P013384,23.133,7,59,52
95,MIL,P000796,P013385,2.166,-2,6,8
95,MIL,P001392,P001518,8.449,-2,18,20
95,MIL,P001392,P006085,10.933,-7,21,28
95,MIL,P001392,P006509,1.583,-2,2,4
95,MIL,P001392,P006721,2.616,0,4,4
95,MIL,P001392,P007831,7.15,6,18,12
95,MIL,P001392,P008987,14.984,1,33,32
95,MIL,P001392,P011064,9.616,4,21,17
95,MIL,P001392,P013384,6.55,-7,12,19
95,MIL,P001392,P013385,8.816,-5,19,24
95,MIL,P001518,P006085,6.466,-3,11,14
95,MIL,P001518,P006509,1.583,-2,2,4
95,MIL,P001518,P006721,1.883,1,4,3
95,MIL,P001518,P007831,0.8,0,3,3
95,MIL,P001518,P008987,3.8,-2,8,10
95,MIL,P001518,P011064,1.183,1,4,3
95,MIL,P001518,P013385,5.766,-3,11,14
95,MIL,P006085,P006509,1.583,-2,2,4
95,MIL,P006085,P006721,0.7,0,0,0
95,MIL,P006085,P008987,6.484,-3,13,16
95,MIL,P006085,P013384,4.467,-4,10,14
95,MIL,P006085,P013385,8.816,-5,19,24
95,MIL,P006509,P013385,1.583,-2,2,4
95,MIL,P006721,P007831,0.733,-1,0,1
95,MIL,P006721,P011064,1.916,0,4,4
95,MIL,P007831,P008987,25.067,22,71,49
95,MIL,P007831,P011064,25.0,21,68,47
95,MIL,P007831,P013384,18.65,15,53,38
95,MIL,P008987,P011064,26.35,19,70,51
95,MIL,P008987,P013384,24.217,11,63,52
95,MIL,P008987,P013385,5.067,-1,11,12
95,MIL,P011064,P013384,20.733,12,55,43
95,MIL,P013384,P013385,3.05,-2,8,10
95,TEL,P005145,P006835,2.466,0,6,6
95,TEL,P005145,P007519,1.833,2,6,4
95,TEL,P005145,P011202,2.216,0,4,4
95,TEL,P005145,P011219,4.049,2,10,8
95,TEL,P005145,P013250,2.216,0,4,4
95,TEL,P005145,P013381,1.583,2,4,2
95,TEL,P005145,P013382,1.833,2,6,4
95,TEL,P006835,P007519,25.017,-7,49,56
95,TEL,P006835,P007990,13.666,-1,26,27
95,TEL,P006835,P011202,7.383,-6,14,20
95,TEL,P006835,P011219,14.799,-3,32,35
95,TEL,P006835,P013250,10.833,-9,21,30
95,TEL,P006835,P013381,8.733,-4,20,24
95,TEL,P006835,P013382,27.95,-12,56,68
95,TEL,P006835,P013383,17.217,-10,32,42
95,TEL,P007519,P007990,11.05,-4,17,21
95,TEL,P007519,P011202,2.017,-2,3,5
95,TEL,P007519,P011219,7.8,3,17,14
95,TEL,P007519,P013250,4.601,-6,6,12
95,TEL,P007519,P013381,7.817,-6,17,23
95,TEL,P007519,P013382,25.017,-7,49,56
95,TEL,P007519,P013383,17.984,-13,32,45
95,TEL,P007990,P011202,4.817,8,15,7
95,TEL,P007990,P011219,11.199,2,29,27
95,TEL,P007990,P013250,9.783,-1,27,28
95,TEL,P007990,P013381,4.267,1,11,10
95,TEL,P007990,P013382,14.049,-5,28,33
95,TEL,P007990,P013383,11.433,-8,23,31
95,TEL,P011202,P011219,10.616,3,26,23
95,TEL,P011202,P013250,10.016,4,25,21
95,TEL,P011202,P013381,6.333,7,17,10
95,TEL,P011202,P013382,3.317,-5,6,11
95,TEL,P011202,P013383,1.417,-1,2,3
95,TEL,P011219,P013250,15.982,-2,41,43
95,TEL,P011219,P013381,8.183,7,22,15
95,TEL,P011219,P013382,12.866,-4,31,35
95,TEL,P011219,P013383,2.566,-4,8,12
95,TEL,P013250,P013381,7.533,2,18,16
95,TEL,P013250,P013382,8.9,-10,20,30
95,TEL,P013250,P013383,5.4,-10,10,20
95,TEL,P013381,P013382,7.05,-3,17,20
95,TEL,P013381,P013383,6.833,-10,14,24
95,TEL,P013382,P013383,19.35,-12,39,51
97,IST,P004887,P006372,4.567,-1,8,9
97,IST,P004887,P006590,15.783,-5,39,44
97,IST,P004887,P007109,7.0,-6,10,16
97,IST,P004887,P009513,4.634,-5,7,12
97,IST,P004887,P009664,13.934,2,38,36
97,IST,P004887,P009846,23.301,-4,55,59
97,IST,P004887,P011078,20.55,-1,51,52
97,IST,P004887,P012710,4.25,-2,10,12
97,IST,P004887,P013363,6.717,-2,14,16
97,IST,P006372,P006590,0.816,-2,0,2
97,IST,P006372,P007109,3.45,-3,5,8
97,IST,P006372,P009513,3.15,-4,3,7
97,IST,P006372,P009664,1.933,0,3,3
97,IST,P006372,P009846,4.65,-1,8,9
97,IST,P006372,P011078,2.233,1,5,4
97,IST,P006372,P012788,0.733,-2,0,2
97,IST,P006590,P007109,9.85,-8,15,23
97,IST,P006590,P009513,0.083,0,0,0
97,IST,P006590,P009664,14.632,-3,33,36
97,IST,P006590,P009846,18.149,2,45,43
97,IST,P006590,P011078,27.232,-11,56,67
97,IST,P006590,P012710,2.833,0,8,8
97,IST,P006590,P012788,10.566,-7,16,23
97,IST,P006590,P013363,8.433,-11,11,22
97,IST,P006590,P013364,0.883,1,1,0
97,IST,P007109,P009513,1.95,-6,0,6
97,IST,P007109,P009846,8.683,0,16,16
97,IST,P007109,P011078,11.35,-5,20,25
97,IST,P007109,P012788,6.3,-5,10,15
97,IST,P007109,P013363,4.617,-11,4,15
97,IST,P009513,P009664,2.767,1,7,6
97,IST,P009513,P009846,4.717,-5,7,12
97,IST,P009513,P013363,1.567,-1,4,5
97,IST,P009664,P009846,14.617,3,38,35
97,IST,P009664,P011078,16.399,0,38,38
97,IST,P009664,P012788,4.266,-2,6,8
97,IST,P009664,P013363,7.233,2,16,14
97,IST,P009664,P013364,0.883,1,1,0
97,IST,P009846,P011078,26.116,9,66,57
97,IST,P009846,P012710,7.533,1,19,18
97,IST,P009846,P012788,6.566,7,17,10
97,IST,P009846,P013363,8.117,3,20,17
97,IST,P009846,P013364,0.883,1,1,0
97,IST,P011078,P012710,7.533,1,19,18
97,IST,P011078,P012788,13.849,-4,25,29
97,IST,P011078,P013363,14.983,-7,27,34
97,IST,P011078,P013364,0.883,1,1,0
97,IST,P012710,P012788,3.283,3,9,6
97,IST,P012710,P013363,4.7,1,11,10
97,IST,P012788,P013363,9.833,-6,17,23
97,PRS,P004197,P007032,0.083,0,0,0
97,PRS,P004197,P010390,13.683,19,32,13
97,PRS,P004197,P012608,13.683,19,32,13
97,PRS,P004197,P012610,13.683,19,32,13
97,PRS,P004197,P012613,13.6,19,32,13
97,PRS,P004512,P005793,3.083,-2,7,9
97,PRS,P004512,P007032,3.083,-2,7,9
97,PRS,P004512,P012608,5.6,3,16,13
97,PRS,P004512,P012609,8.683,1,23,22
97,PRS,P004512,P012610,5.6,3,16,13
97,PRS,P004512,P012613,5.6,3,16,13
97,PRS,P004512,P012640,3.083,-2,7,9
97,PRS,P005793,P007032,12.45,-8,25,33
97,PRS,P005793,P012609,12.45,-8,25,33
97,PRS,P005793,P012640,12.45,-8,25,33
97,PRS,P005793,P013373,9.367,-6,18,24
97,PRS,P007032,P010390,1.483,1,4,3
97,PRS,P007032,P012608,1.483,1,4,3
97,PRS,P007032,P012609,12.45,-8,25,33
97,PRS,P007032,P012610,1.483,1,4,3
97,PRS,P007032,P012613,1.4,1,4,3
97,PRS,P007032,P012640,12.45,-8,25,33
97,PRS,P007032,P013373,9.367,-6,18,24
97,PRS,P010390,P012608,21.95,14,52,38
97,PRS,P010390,P012609,5.1,-1,14,15
97,PRS,P010390,P012610,21.95,14,52,38
97,PRS,P010390,P012613,21.867,14,52,38
97,PRS,P010390,P012640,1.767,-5,2,7
97,PRS,P012608,P012609,10.7,2,30,28
97,PRS,P012608,P012610,27.55,17,68,51
97,PRS,P012608,P012613,27.467,17,68,51
97,PRS,P012608,P012640,1.767,-5,2,7
97,PRS,P012609,P012610,10.7,2,30,28
97,PRS,P012609,P012613,10.7,2,30,28
97,PRS,P012609,P012640,12.45,-8,25,33
97,PRS,P012609,P013373,9.367,-6,18,24
97,PRS,P012610,P012613,27.467,17,68,51
97,PRS,P012610,P012640,1.767,-5,2,7
97,PRS,P012613,P012640,1.767,-5,2,7
97,PRS,P012640,P013373,9.367,-6,18,24
96,BER,P006251,P007025,10.666,-8,22,30
96,BER,P006251,P007550,7.033,2,18,16
96,BER,P006251,P008173,13.567,-8,33,41
96,BER,P006251,P008211,12.517,1,33,32
96,BER,P006251,P008384,16.6,-7,42,49
96,BER,P006251,P011626,0.85,2,3,1
96,BER,P006251,P011631,1.967,4,8,4
96,BER,P006251,P011934,9.183,-1,18,19
96,BER,P006251,P012604,10.017,-9,27,36
96,BER,P007025,P007550,14.017,1,29,28
96,BER,P007025,P008173,7.05,-12,13,25
96,BER,P007025,P008211,5.184,-2,10,12
96,BER,P007025,P008384,8.383,-13,15,28
96,BER,P007025,P011626,5.767,0,9,9
96,BER,P007025,P011631,7.134,-5,13,18
96,BER,P007025,P011934,12.467,6,23,17
96,BER,P007025,P012100,2.317,1,3,2
96,BER,P007025,P012604,7.483,-16,15,31
96,BER,P007550,P008173,2.65,-1,8,9
96,BER,P007550,P008211,8.951,2,19,17
96,BER,P007550,P008384,7.75,2,19,17
96,BER,P007550,P011626,5.767,0,9,9
96,BER,P007550,P011631,10.684,2,24,22
96,BER,P007550,P011934,16.167,9,33,24
96,BER,P007550,P012100,2.317,1,3,2
96,BER,P007550,P012604,2.6,-6,6,12
96,BER,P008173,P008211,11.134,-9,25,34
96,BER,P008173,P008384,22.217,-19,46,65
96,BER,P008173,P011626,2.883,3,6,3
96,BER,P008173,P011631,11.017,-8,22,30
96,BER,P008173,P011934,9.066,0,20,20
96,BER,P008173,P012604,13.084,-18,27,45
96,BER,P008211,P008384,14.734,-3,34,37
96,BER,P008211,P011631,7.951,-4,14,18
96,BER,P008211,P011934,11.567,3,25,22
96,BER,P008211,P012604,7.634,-8,16,24
96,BER,P008384,P011626,2.883,3,6,3
96,BER,P008384,P011631,13.634,-4,27,31
96,BER,P008384,P011934,11.766,1,22,21
96,BER,P008384,P012604,15.101,-20,33,53
96,BER,P011626,P011631,6.333,2,12,10
96,BER,P011626,P011934,7.217,5,12,7
96,BER,P011626,P012100,2.317,1,3,2
96,BER,P011626,P012604,0.583,-4,0,4
96,BER,P011631,P011934,11.25,8,24,16
96,BER,P011631,P012604,6.234,-15,8,23
96,BER,P011934,P012100,2.317,1,3,2
96,MAD,P003108,P003583,7.1,3,19,16
96,MAD,P003108,P003733,7.55,15,27,12
96,MAD,P003108,P005791,16.7,28,51,23
96,MAD,P003108,P005928,16.749,27,55,28
96,MAD,P003108,P006540,5.034,9,17,8
96,MAD,P003108,P009005,10.6,20,31,11
96,MAD,P003108,P011247,7.051,4,15,11
96,MAD,P003108,P011649,8.417,-3,16,19
96,MAD,P003108,P013378,14.633,12,40,28
96,MAD,P003108,PTGB,1.366,9,9,0
96,MAD,P003583,P003733,12.199,7,36,29
96,MAD,P003583,P005928,5.766,5,23,18
96,MAD,P003583,P006540,11.584,-6,21,27
96,MAD,P003583,P009005,10.184,-15,17,32
96,MAD,P003583,P009213,9.317,-3,16,19
96,MAD,P003583,P011247,10.317,2,20,18
96,MAD,P003583,P011649,2.05,-3,0,3
96,MAD,P003583,P013378,4.983,2,20,18
96,MAD,P003583,PTGB,4.1,-8,4,12
96,MAD,P003733,P005791,6.066,1,15,14
96,MAD,P003733,P005928,6.882,8,29,21
96,MAD,P003733,P006540,8.616,-1,18,19
96,MAD,P003733,P009005,4.299,-8,11,19
96,MAD,P003733,P009213,6.416,1,13,12
96,MAD,P003733,P011247,10.05,3,19,16
96,MAD,P003733,P011649,2.767,1,4,3
96,MAD,P003733,P013378,4.983,2,20,18
96,MAD,P003733,PTGB,3.232,3,12,9
96,MAD,P005791,P005928,13.949,17,40,23
96,MAD,P005791,P006540,6.683,3,16,13
96,MAD,P005791,P009005,10.199,17,29,12
96,MAD,P005791,P009213,2.583,-6,1,7
96,MAD,P005791,P011247,5.867,2,12,10
96,MAD,P005791,P011649,6.367,0,16,16
96,MAD,P005791,P013378,12.083,8,28,20
96,MAD,P005791,PTGB,1.899,2,8,6
96,MAD,P005928,P006540,1.183,6,6,0
96,MAD,P005928,P009005,10.149,13,30,17
96,MAD,P005928,P011649,5.65,-4,12,16
96,MAD,P005928,P013378,16.633,10,48,38
96,MAD,P005928,PTGB,1.899,6,9,3
96,MAD,P006540,P009005,10.984,-5,22,27
96,MAD,P006540,P009213,11.9,-9,17,26
96,MAD,P006540,P011247,12.984,3,28,25
96,MAD,P006540,PTGB,4.1,-12,3,15
96,MAD,P009005,P009213,5.484,-10,4,14
96,MAD,P009005,P011247,6.134,1,13,12
96,MAD,P009005,P013378,8.866,10,24,14
96,MAD,P009005,PTGB,4.633,-15,3,18
96,MAD,P009213,P011247,9.133,0,17,17
96,MAD,P009213,PTGB,2.767,-9,0,9
96,MAD,P011247,P011649,2.767,1,4,3
96,MAD,P011247,P013378,0.433,0,0,0
96,MAD,P011649,P013378,5.65,-4,12,16
98,PAN,P001926,P003842,8.5,-4,9,13
98,PAN,P001926,P005161,3.551,-5,6,11
98,PAN,P001926,P005353,13.801,-10,28,38
98,PAN,P001926,P007866,6.718,-10,12,22
98,PAN,P001926,P009622,16.168,-13,25,38
98,PAN,P001926,P011204,14.05,-11,27,38
98,PAN,P001926,P011209,2.817,1,6,5
98,PAN,P001926,P012712,11.483,0,18,18
98,PAN,P001926,P012774,12.916,4,25,21
98,PAN,P003842,P005161,16.7,-7,31,38
98,PAN,P003842,P007866,1.35,-2,2,4
98,PAN,P003842,P009622,16.933,2,28,26
98,PAN,P003842,P011204,14.982,-12,24,36
98,PAN,P003842,P012712,15.733,0,28,28
98,PAN,P003842,P012774,20.866,-1,38,39
98,PAN,P005161,P005353,3.517,5,11,6
98,PAN,P005161,P007866,2.817,-2,6,8
98,PAN,P005161,P009622,12.667,1,25,24
98,PAN,P005161,P011204,13.766,-6,26,32
98,PAN,P005161,P011209,0.7,2,2,0
98,PAN,P005161,P012712,12.65,3,29,26
98,PAN,P005161,P012774,14.5,1,32,31
98,PAN,P005353,P007866,6.151,-8,12,20
98,PAN,P005353,P009622,8.984,-9,16,25
98,PAN,P005353,P011204,11.95,-2,27,29
98,PAN,P005353,P011209,4.15,3,8,5
98,PAN,P005353,P012712,9.233,5,21,16
98,PAN,P005353,P012774,6.35,4,17,13
98,PAN,P007866,P009622,7.501,-10,14,24
98,PAN,P007866,P011204,3.2,-7,6,13
98,PAN,P007866,P011209,2.267,-1,4,5
98,PAN,P009622,P011204,13.249,-10,22,32
98,PAN,P009622,P011209,3.65,3,8,5
98,PAN,P009622,P012712,11.083,7,18,11
98,PAN,P009622,P012774,14.233,9,28,19
98,PAN,P011204,P011209,1.733,6,6,0
98,PAN,P011204,P012712,16.399,-3,33,36
98,PAN,P011204,P012774,19.199,-3,41,44
98,PAN,P011209,P012712,1.883,4,4,0
98,PAN,P011209,P012774,0.2,2,2,0
98,PAN,P012712,P012774,21.4,4,45,41
98,ZAL,P002329,P002676,6.666,-4,13,17
98,ZAL,P002329,P003048,6.534,-10,8,18
98,ZAL,P002329,P005504,4.549,2,13,11
98,ZAL,P002329,P007029,7.767,-4,16,20
98,ZAL,P002329,P007513,5.0,-8,7,15
98,ZAL,P002329,P007975,9.7,-8,16,24
98,ZAL,P002329,P011051,3.35,0,8,8
98,ZAL,P002329,P012622,7.166,1,17,16
98,ZAL,P002329,P013403,7.0,-1,18,19
98,ZAL,P002676,P003048,6.499,-4,12,16
98,ZAL,P002676,P005504,9.733,6,21,15
98,ZAL,P002676,P007029,2.35,1,5,4
98,ZAL,P002676,P007513,6.0,-2,13,15
98,ZAL,P002676,P007975,14.633,-6,26,32
98,ZAL,P002676,P011051,4.084,-3,9,12
98,ZAL,P002676,P012622,13.699,2,27,25
98,ZAL,P002676,P012715,8.983,5,20,15
98,ZAL,P002676,P013403,8.617,1,22,21
98,ZAL,P003048,P007029,10.367,1,21,20
98,ZAL,P003048,P007513,14.399,1,28,27
98,ZAL,P003048,P007975,7.733,-4,12,16
98,ZAL,P003048,P012622,4.883,-2,10,12
98,ZAL,P003048,P012715,7.916,5,20,15
98,ZAL,P003048,P013403,9.133,1,21,20
98,ZAL,P005504,P007029,4.816,2,13,11
98,ZAL,P005504,P007513,0.483,0,2,2
98,ZAL,P005504,P007975,6.75,-1,10,11
98,ZAL,P005504,P012622,11.716,7,27,20
98,ZAL,P005504,P012715,5.3,4,11,7
98,ZAL,P005504,P013403,5.449,8,19,11
98,ZAL,P007029,P007513,16.466,6,31,25
98,ZAL,P007029,P007975,6.217,-1,10,11
98,ZAL,P007029,P011051,6.85,6,13,7
98,ZAL,P007029,P012622,13.25,11,31,20
98,ZAL,P007029,P012715,4.233,4,11,7
98,ZAL,P007029,P013403,15.816,10,37,27
98,ZAL,P007513,P007975,7.0,-2,13,15
98,ZAL,P007513,P011051,7.584,3,14,11
98,ZAL,P007513,P012622,9.333,8,18,10
98,ZAL,P007513,P012715,7.466,7,18,11
98,ZAL,P007513,P013403,16.133,3,32,29
98,ZAL,P007975,P011051,4.017,-3,9,12
98,ZAL,P007975,P012622,11.499,-3,17,20
98,ZAL,P007975,P012715,3.517,0,5,5
98,ZAL,P007975,P013403,2.934,-4,6,10
98,ZAL,P011051,P012622,8.0,7,16,9
98,ZAL,P011051,P013403,9.851,2,19,17
98,ZAL,P012622,P012715,5.75,2,13,11
98,ZAL,P012622,P013403,13.1,15,36,21
98,ZAL,P012715,P013403,9.699,9,26,17
99,BAR,P000925,P002939,15.033,-6,28,34
99,BAR,P000925,P003478,11.9,-5,22,27
99,BAR,P000925,P007464,1.75,0,4,4
99,BAR,P000925,P009862,17.517,-8,32,40
99,BAR,P000925,P009992,0.666,-1,2,3
99,BAR,P000925,P010106,3.15,-3,6,9
99,BAR,P000925,P012745,18.183,-9,34,43
99,BAR,P000925,P012795,4.533,-4,8,12
99,BAR,P002939,P003478,10.7,-2,22,24
99,BAR,P002939,P006568,4.167,-3,6,9
99,BAR,P002939,P007464,5.917,-3,10,13
99,BAR,P002939,P009862,15.467,-9,26,35
99,BAR,P002939,P009992,3.733,0,8,8
99,BAR,P002939,P012745,15.033,-6,28,34
99,BAR,P002939,P012795,6.75,-7,8,15
99,BAR,P003196,P007464,8.784,-5,16,21
99,BAR,P003196,P009862,1.117,-3,3,6
99,BAR,P003196,P009992,7.867,-3,17,20
99,BAR,P003196,P010106,13.418,-12,26,38
99,BAR,P003196,P011666,4.434,-6,6,12
99,BAR,P003196,P012745,4.634,-7,10,17
99,BAR,P003196,P012795,13.418,-12,26,38
99,BAR,P003478,P009862,11.9,-5,22,27
99,BAR,P003478,P010106,1.2,-3,0,3
99,BAR,P003478,P012745,11.9,-5,22,27
99,BAR,P006568,P007464,8.4,-1,18,19
99,BAR,P006568,P009862,1.1,-4,0,4
99,BAR,P006568,P009992,7.3,3,18,15
99,BAR,P006568,P010106,3.85,4,12,8
99,BAR,P006568,P012745,4.233,2,12,10
99,BAR,P006568,P012795,4.55,-5,6,11
99,BAR,P007464,P009862,2.767,-4,4,8
99,BAR,P007464,P009992,13.7,1,30,29
99,BAR,P007464,P010106,12.634,-1,28,29
99,BAR,P007464,P011666,2.467,-3,4,7
99,BAR,P007464,P012745,5.983,2,16,14
99,BAR,P007464,P012795,13.334,-10,22,32
99,BAR,P009862,P010106,4.267,-6,9,15
99,BAR,P009862,P012745,18.634,-11,35,46
99,BAR,P009862,P012795,6.167,-10,9,19
99,BAR,P009992,P010106,11.717,1,29,28
99,BAR,P009992,P012745,6.449,0,19,19
99,BAR,P009992,P012795,11.9,-5,25,30
99,BAR,P010106,P011666,4.434,-6,6,12
99,BAR,P010106,P012745,11.634,-6,28,34
99,BAR,P010106,P012795,15.368,-12,32,44
99,BAR,P011666,P012745,1.967,-3,2,5
99,BAR,P011666,P012795,4.434,-6,6,12
99,BAR,P012745,P012795,9.55,-13,18,31
99,MUN,P004508,P005460,2.5,3,7,4
99,MUN,P004508,P007056,20.0,16,52,36
99,MUN,P004508,P007201,19.117,12,51,39
99,MUN,P004508,P007639,3.85,-2,10,12
99,MUN,P004508,P007929,4.55,0,16,16
99,MUN,P004508,P010391,22.217,11,51,40
99,MUN,P004508,P011224,8.784,7,26,19
99,MUN,P004508,P011244,8.884,8,22,14
99,MUN,P004508,P011987,18.267,20,49,29
99,MUN,P004508,P012123,3.15,-4,8,12
99,MUN,P004508,P013368,2.617,-3,8,11
99,MUN,P005460,P007201,5.467,-1,11,12
99,MUN,P005460,P007929,10.317,2,20,18
99,MUN,P005460,P010391,2.5,3,7,4
99,MUN,P005460,P011224,12.067,2,24,22
99,MUN,P005460,P011244,7.35,6,16,10
99,MUN,P005460,P011987,11.067,5,23,18
99,MUN,P007056,P007201,13.25,8,36,28
99,MUN,P007056,P007639,1.233,1,2,1
99,MUN,P007056,P007929,1.2,3,5,2
99,MUN,P007056,P010391,18.283,10,44,34
99,MUN,P007056,P011224,4.867,9,19,10
99,MUN,P007056,P011244,6.717,10,19,9
99,MUN,P007056,P011987,18.717,20,51,31
99,MUN,P007056,P012123,0.533,-1,0,1
99,MUN,P007201,P007929,5.467,-1,12,13
99,MUN,P007201,P010391,14.9,3,35,32
99,MUN,P007201,P011224,11.751,3,30,27
99,MUN,P007201,P011244,3.367,1,8,7
99,MUN,P007201,P011987,15.017,7,37,30
99,MUN,P007639,P007929,2.05,-3,8,11
99,MUN,P007639,P010391,1.8,1,2,1
99,MUN,P007639,P011987,0.7,2,2,0
99,MUN,P007639,P012123,3.15,-4,8,12
99,MUN,P007639,P013368,2.617,-3,8,11
99,MUN,P007929,P011224,14.017,8,33,25
99,MUN,P007929,P011244,11.05,12,29,17
99,MUN,P007929,P011987,11.517,5,25,20
99,MUN,P007929,P012123,2.05,-3,8,11
99,MUN,P007929,P013368,2.05,-3,8,11
99,MUN,P010391,P011224,4.567,-2,10,12
99,MUN,P010391,P011244,6.384,5,14,9
99,MUN,P010391,P011987,16.55,14,41,27
99,MUN,P010391,P012123,1.1,-1,0,1
99,MUN,P010391,P013368,0.567,0,0,0
99,MUN,P011224,P011244,11.917,10,29,19
99,MUN,P011224,P011987,13.234,11,33,22
99,MUN,P011244,P011987,14.067,16,35,19
99,MUN,P012123,P013368,2.617,-3,8,11
100,BAS,P004058,P007230,2.767,-4,0,4
100,BAS,P004058,P008072,2.767,-4,0,4
100,BAS,P004058,P011085,2.767,-4,0,4
100,BAS,P004058,P012597,2.767,-4,0,4
100,BAS,P007230,P008072,3.584,-2,2,4
100,BAS,P007230,P011085,9.017,5,15,10
100,BAS,P007230,P011196,15.551,-6,30,36
100,BAS,P007230,P011948,18.951,-3,36,39
100,BAS,P007230,P012058,4.05,-5,6,11
100,BAS,P007230,P012201,11.234,-6,19,25
100,BAS,P007230,P012597,7.501,-5,9,14
100,BAS,P007230,P013367,14.217,-2,27,29
100,BAS,P008072,P011085,3.901,-4,2,6
100,BAS,P008072,P011948,0.817,2,2,0
100,BAS,P008072,P012201,0.317,-2,0,2
100,BAS,P008072,P012597,3.901,-4,2,6
100,BAS,P008072,P013367,0.317,-2,0,2
100,BAS,P011085,P011196,20.816,28,56,28
100,BAS,P011085,P011948,8.433,3,20,17
100,BAS,P011085,P012058,2.583,1,4,3
100,BAS,P011085,P012201,18.283,20,47,27
100,BAS,P011085,P012597,19.684,24,44,20
100,BAS,P011085,P013367,23.716,27,60,33
100,BAS,P011196,P011948,17.734,-12,35,47
100,BAS,P011196,P012058,1.467,-6,2,8
100,BAS,P011196,P012201,29.2,16,66,50
100,BAS,P011196,P012597,19.7,25,49,24
100,BAS,P011196,P013367,29.6,19,70,51
100,BAS,P011948,P012058,4.05,-5,6,11
100,BAS,P011948,P012201,13.417,-12,24,36
100,BAS,P011948,P012597,4.734,-1,9,10
100,BAS,P011948,P013367,16.4,-8,32,40
100,BAS,P012058,P013367,4.05,-5,6,11
100,BAS,P012201,P012597,20.017,23,49,26
100,BAS,P012201,P013367,25.6,17,59,42
100,BAS,P012597,P013367,16.1,26,42,16
100,ZAL,P002329,P002676,4.051,4,6,2
100,ZAL,P002329,P003048,3.766,-8,2,10
100,ZAL,P002329,P003210,0.683,-2,0,2
100,ZAL,P002329,P005504,3.584,3,6,3
100,ZAL,P002329,P007029,5.55,-4,9,13
100,ZAL,P002329,P007513,5.517,-8,5,13
100,ZAL,P002329,P007975,7.918,-5,10,15
100,ZAL,P002329,P011051,6.268,-7,7,14
100,ZAL,P002329,P012622,10.618,-9,9,18
100,ZAL,P002329,P013403,6.517,-12,6,18
100,ZAL,P002676,P003210,2.067,-4,0,4
100,ZAL,P002676,P005504,11.117,8,21,13
100,ZAL,P002676,P007029,14.717,7,34,27
100,ZAL,P002676,P007513,18.684,11,45,34
100,ZAL,P002676,P007975,11.117,10,22,12
100,ZAL,P002676,P011051,14.785,3,31,28
100,ZAL,P002676,P012622,12.652,10,26,16
100,ZAL,P002676,P013403,14.418,-5,23,28
100,ZAL,P003048,P003210,0.683,-2,0,2
100,ZAL,P003048,P007029,6.099,-5,11,16
100,ZAL,P003048,P007513,6.099,-5,11,16
100,ZAL,P003048,P007975,0.967,-2,0,2
100,ZAL,P003048,P012622,2.583,-6,0,6
100,ZAL,P003048,P012715,3.983,-1,9,10
100,ZAL,P003048,P013403,6.816,-7,11,18
100,ZAL,P003210,P005504,2.067,-4,0,4
100,ZAL,P003210,P007029,0.7,-4,0,4
100,ZAL,P003210,P012622,2.05,-2,0,2
100,ZAL,P003210,P013403,2.75,-6,0,6
100,ZAL,P005504,P007029,6.983,2,15,13
100,ZAL,P005504,P007513,7.1,3,15,12
100,ZAL,P005504,P007975,9.867,9,21,12
100,ZAL,P005504,P012622,4.951,3,6,3
100,ZAL,P005504,P013403,2.067,-4,0,4
100,ZAL,P007029,P007513,21.733,7,48,41
100,ZAL,P007029,P007975,8.1,5,19,14
100,ZAL,P007029,P011051,11.168,5,26,21
100,ZAL,P007029,P012622,4.017,5,11,6
100,ZAL,P007029,P012715,3.983,-1,9,10
100,ZAL,P007029,P013403,13.95,-9,26,35
100,ZAL,P007513,P007975,7.65,-4,15,19
100,ZAL,P007513,P011051,14.568,-1,33,34
100,ZAL,P007513,P012622,10.051,-5,22,27
100,ZAL,P007513,P012715,3.983,-1,9,10
100,ZAL,P007513,P013403,15.683,-9,33,42
100,ZAL,P007975,P011051,5.984,-15,5,20
100,ZAL,P007975,P012622,8.718,-13,7,20
100,ZAL,P007975,P013403,6.951,-17,5,22
100,ZAL,P011051,P012622,12.235,-7,23,30
100,ZAL,P011051,P013403,16.268,-14,27,41
100,ZAL,P012622,P013403,11.201,-16,12,28
100,ZAL,P012715,P013403,3.983,-1,9,10
101,BER,P006251,P007025,3.499,-7,7,14
101,BER,P006251,P007550,13.166,-7,27,34
101,BER,P006251,P008173,4.416,-9,9,18
101,BER,P006251,P008211,14.249,-15,29,44
101,BER,P006251,P008384,6.416,-13,9,22
101,BER,P006251,P011631,11.249,-6,27,33
101,BER,P006251,P011934,2.416,-6,2,8
101,BER,P006251,P012604,7.716,-11,18,29
101,BER,P006251,P013386,7.533,-2,16,18
101,BER,P007025,P007550,2.116,-2,2,4
101,BER,P007025,P008173,22.251,-4,47,51
101,BER,P007025,P008211,3.567,3,10,7
101,BER,P007025,P008384,19.75,-13,35,48
101,BER,P007025,P011631,4.583,2,12,10
101,BER,P007025,P011934,21.134,-2,42,44
101,BER,P007025,P012604,18.3,-12,35,47
101,BER,P007025,P013386,2.6,-1,6,7
101,BER,P007550,P008211,13.383,-5,29,34
101,BER,P007550,P008384,5.466,-3,8,11
101,BER,P007550,P011631,10.033,-4,23,27
101,BER,P007550,P011934,4.749,-6,6,12
101,BER,P007550,P012604,5.633,-2,13,15
101,BER,P007550,P013386,7.45,1,16,15
101,BER,P008173,P008211,4.667,1,12,11
101,BER,P008173,P008384,19.8,-15,40,55
101,BER,P008173,P011631,5.483,6,17,11
101,BER,P008173,P011934,20.001,1,45,44
101,BER,P008173,P012604,18.533,-14,40,54
101,BER,P008173,P013386,2.517,2,6,4
101,BER,P008211,P008384,4.533,-6,8,14
101,BER,P008211,P011631,10.116,-7,23,30
101,BER,P008211,P011934,6.117,2,14,12
101,BER,P008211,P012604,5.85,-1,17,18
101,BER,P008211,P013386,10.05,0,22,22
101,BER,P008384,P011631,4.35,5,13,8
101,BER,P008384,P011934,19.433,-5,41,46
101,BER,P008384,P012604,19.116,-21,36,57
101,BER,P008384,P013386,2.2,-1,2,3
101,BER,P011631,P011934,6.183,-1,13,14
101,BER,P011631,P012604,5.066,2,18,16
101,BER,P011631,P013386,5.333,-1,14,15
101,BER,P011934,P012604,16.45,-5,35,40
101,BER,P011934,P013386,2.517,2,6,4
101,TEL,P006835,P007519,23.367,12,59,47
101,TEL,P006835,P007990,21.083,20,59,39
101,TEL,P006835,P011202,4.233,1,9,8
101,TEL,P006835,P011214,6.382,1,13,12
101,TEL,P006835,P011219,5.55,3,15,12
101,TEL,P006835,P013250,12.048,17,38,21
101,TEL,P006835,P013381,7.199,9,15,6
101,TEL,P006835,P013382,18.266,15,55,40
101,TEL,P006835,P013383,17.4,22,49,27
101,TEL,P007519,P007990,17.934,15,48,33
101,TEL,P007519,P011202,4.067,-5,8,13
101,TEL,P007519,P011214,5.583,-3,11,14
101,TEL,P007519,P011219,5.918,-10,9,19
101,TEL,P007519,P013250,8.567,2,24,22
101,TEL,P007519,P013381,4.167,1,7,6
101,TEL,P007519,P013382,16.95,4,44,40
101,TEL,P007519,P013383,16.651,16,46,30
101,TEL,P007990,P011202,0.4,-2,0,2
101,TEL,P007990,P011214,4.983,-1,7,8
101,TEL,P007990,P011219,2.5,3,9,6
101,TEL,P007990,P011433,0.283,0,0,0
101,TEL,P007990,P013250,4.965,12,21,9
101,TEL,P007990,P013381,5.116,1,7,6
101,TEL,P007990,P013382,14.4,15,45,30
101,TEL,P007990,P013383,13.8,17,40,23
101,TEL,P011202,P011214,8.383,-3,20,23
101,TEL,P011202,P011219,9.617,-3,23,26
101,TEL,P011202,P011433,0.85,-2,2,4
101,TEL,P011202,P013250,13.867,-2,32,34
101,TEL,P011202,P013381,10.233,3,26,23
101,TEL,P011202,P013382,0.833,-2,2,4
101,TEL,P011202,P013383,6.317,-1,14,15
101,TEL,P011214,P011219,8.85,-3,20,23
101,TEL,P011214,P013250,9.916,-3,22,25
101,TEL,P011214,P013381,11.516,0,23,23
101,TEL,P011214,P013382,3.183,-4,8,12
101,TEL,P011219,P013250,14.167,4,38,34
101,TEL,P011219,P013381,8.45,-1,20,21
101,TEL,P011219,P013382,5.417,-1,13,14
101,TEL,P011219,P013383,1.667,0,5,5
101,TEL,P011433,P013250,1.133,-2,2,4
101,TEL,P011433,P013381,1.133,-2,2,4
101,TEL,P011433,P013383,1.133,-2,2,4
101,TEL,P013250,P013381,12.449,1,28,27
101,TEL,P013250,P013382,5.232,10,22,12
101,TEL,P013250,P013383,8.716,9,25,16
101,TEL,P013381,P013383,4.733,4,12,8
101,TEL,P013382,P013383,10.383,15,31,16
102,PRS,P004197,P004512,1.416,-3,1,4
102,PRS,P004197,P007032,0.083,0,0,0
102,PRS,P004197,P010390,12.1,-3,20,23
102,PRS,P004197,P012608,13.433,-6,21,27
102,PRS,P004197,P012610,13.516,-6,21,27
102,PRS,P004197,P012613,13.516,-6,21,27
102,PRS,P004512,P005793,4.367,-4,4,8
102,PRS,P004512,P007032,4.45,-4,4,8
102,PRS,P004512,P012608,6.183,7,18,11
102,PRS,P004512,P012609,7.6,1,16,15
102,PRS,P004512,P012610,6.266,7,18,11
102,PRS,P004512,P012613,6.266,7,18,11
102,PRS,P004512,P012640,5.984,1,9,8
102,PRS,P005793,P007032,12.784,2,26,24
102,PRS,P005793,P012609,12.784,2,26,24
102,PRS,P005793,P012640,12.784,2,26,24
102,PRS,P005793,P013373,8.417,6,22,16
102,PRS,P007032,P010390,4.783,-8,5,13
102,PRS,P007032,P012608,4.8,-8,5,13
102,PRS,P007032,P012609,12.784,2,26,24
102,PRS,P007032,P012610,4.883,-8,5,13
102,PRS,P007032,P012613,4.883,-8,5,13
102,PRS,P007032,P012640,12.801,2,26,24
102,PRS,P007032,P013373,8.417,6,22,16
102,PRS,P010390,P012608,20.933,-6,37,43
102,PRS,P010390,P012610,20.933,-6,37,43
102,PRS,P010390,P012613,20.933,-6,37,43
102,PRS,P010390,P012640,4.05,5,12,7
102,PRS,P012608,P012609,3.233,5,12,7
102,PRS,P012608,P012610,27.133,1,55,54
102,PRS,P012608,P012613,27.133,1,55,54
102,PRS,P012608,P012640,5.684,10,17,7
102,PRS,P012609,P012610,3.233,5,12,7
102,PRS,P012609,P012613,3.233,5,12,7
102,PRS,P012609,P012640,12.784,2,26,24
102,PRS,P012609,P013373,8.417,6,22,16
102,PRS,P012610,P012613,27.216,1,55,54
102,PRS,P012610,P012640,5.684,10,17,7
102,PRS,P012613,P012640,5.684,10,17,7
102,PRS,P012640,P013373,8.417,6,22,16
102,VIR,P001133,P001844,3.434,-2,4,6
102,VIR,P001133,P002084,3.8,-6,4,10
102,VIR,P001133,P004554,3.416,-2,3,5
102,VIR,P001133,P004888,16.4,6,35,29
102,VIR,P001133,P005738,0.75,1,2,1
102,VIR,P001133,P006739,12.466,5,23,18
102,VIR,P001133,P009549,15.2,4,33,29
102,VIR,P001133,P012585,10.334,0,18,18
102,VIR,P001133,P012591,1.85,0,2,2
102,VIR,P001133,P013374,13.35,7,25,18
102,VIR,P001133,PBCN,5.4,-1,7,8
102,VIR,P001844,P002084,8.833,-13,8,21
102,VIR,P001844,P004554,8.583,-9,11,20
102,VIR,P001844,P004888,5.25,0,13,13
102,VIR,P001844,P005738,2.133,1,5,4
102,VIR,P001844,P006739,2.15,1,5,4
102,VIR,P001844,P009549,0.067,1,2,1
102,VIR,P001844,P012585,10.234,-10,12,22
102,VIR,P001844,P013374,1.667,4,4,0
102,VIR,P001844,PBCN,7.117,-9,4,13
102,VIR,P002084,P004554,8.733,-4,16,20
102,VIR,P002084,P004888,6.733,1,18,17
102,VIR,P002084,P009549,3.7,3,12,9
102,VIR,P002084,P012585,12.533,-10,20,30
102,VIR,P002084,PBCN,5.8,-11,2,13
102,VIR,P004554,P004888,17.048,-1,38,39
102,VIR,P004554,P005738,8.666,-1,21,22
102,VIR,P004554,P006739,9.082,-1,21,22
102,VIR,P004554,P009549,12.049,2,29,27
102,VIR,P004554,P012585,11.916,-6,19,25
102,VIR,P004554,PBCN,3.767,-6,2,8
102,VIR,P004888,P005738,10.416,-1,25,26
102,VIR,P004888,P006739,20.282,3,44,41
102,VIR,P004888,P009549,24.016,8,59,51
102,VIR,P004888,P012585,11.95,5,30,25
102,VIR,P004888,P012591,0.65,-3,0,3
102,VIR,P004888,P013374,11.183,4,23,19
102,VIR,P004888,PBCN,0.2,2,3,1
102,VIR,P005738,P006739,9.666,-2,23,25
102,VIR,P005738,P009549,7.633,1,20,19
102,VIR,P005738,P012585,0.75,1,2,1
102,VIR,P005738,P012591,0.65,-3,0,3
102,VIR,P005738,P013374,1.0,-1,2,3
102,VIR,P006739,P009549,16.299,3,37,34
102,VIR,P006739,P012585,1.2,2,2,0
102,VIR,P006739,P012591,2.5,-3,2,5
102,VIR,P006739,P013374,13.033,4,25,21
102,VIR,P006739,PBCN,1.85,0,2,2
102,VIR,P009549,P012585,7.717,5,22,17
102,VIR,P009549,P013374,9.183,3,19,16
102,VIR,P009549,PBCN,0.2,2,3,1
102,VIR,P012585,P013374,2.317,4,4,0
102,VIR,P012585,PBCN,7.317,-7,7,14
102,VIR,P012591,P013374,2.5,-3,2,5
102,VIR,P012591,PBCN,1.85,0,2,2
102,VIR,P013374,PBCN,3.167,2,4,2
103,OLY,P001255,P003941,11.334,-22,12,34
103,OLY,P001255,P007853,9.617,-13,16,29
103,OLY,P001255,P007947,6.95,-19,4,23
103,OLY,P001255,P007982,9.417,-13,14,27
103,OLY,P001255,P008811,4.55,-8,4,12
103,OLY,P001255,P008829,0.15,0,2,2
103,OLY,P001255,P008855,11.284,-22,12,34
103,OLY,P001255,P009849,4.417,-6,6,12
103,OLY,P001255,P013380,6.417,-17,2,19
103,OLY,P003941,P007853,13.7,-10,15,25
103,OLY,P003941,P007947,16.017,-7,26,33
103,OLY,P003941,P007982,13.884,-10,13,23
103,OLY,P003941,P008829,14.6,5,23,18
103,OLY,P003941,P008855,17.233,-11,25,36
103,OLY,P003941,P009849,4.734,-6,6,12
103,OLY,P003941,P013380,12.234,-7,20,27
103,OLY,P007853,P007947,3.833,0,6,6
103,OLY,P007853,P007982,12.867,-9,14,23
103,OLY,P007853,P008811,0.95,1,3,2
103,OLY,P007853,P008829,5.283,4,6,2
103,OLY,P007853,P008855,8.166,-3,14,17
103,OLY,P007853,P009849,4.734,-6,6,12
103,OLY,P007853,P013380,0.05,0,0,0
103,OLY,P007947,P007982,4.35,-2,4,6
103,OLY,P007947,P008811,12.4,10,30,20
103,OLY,P007947,P008829,21.417,22,52,30
103,OLY,P007947,P008855,24.067,5,52,47
103,OLY,P007947,P013380,24.634,3,50,47
103,OLY,P007982,P008811,1.9,-3,3,6
103,OLY,P007982,P008829,6.617,0,6,6
103,OLY,P007982,P008855,6.85,-5,8,13
103,OLY,P007982,P009849,4.734,-6,6,12
103,OLY,P007982,P013380,3.117,-4,4,8
103,OLY,P008811,P008829,9.317,17,29,12
103,OLY,P008811,P008855,13.534,11,33,22
103,OLY,P008811,P013380,13.017,8,30,22
103,OLY,P008829,P008855,19.783,22,50,28
103,OLY,P008829,P009849,0.317,0,0,0
103,OLY,P008829,P013380,18.784,18,48,30
103,OLY,P008855,P013380,22.751,3,46,43
103,PAR,P004761,P006591,15.317,24,39,15
103,PAR,P004761,P006760,7.084,6,15,9
103,PAR,P004761,P007870,10.15,17,30,13
103,PAR,P004761,P008232,2.617,2,5,3
103,PAR,P004761,P010781,26.267,24,62,38
103,PAR,P004761,P011050,10.05,12,22,10
103,PAR,P004761,P011836,4.267,-7,5,12
103,PAR,P004761,P011981,13.517,2,28,26
103,PAR,P004761,P013369,26.267,24,62,38
103,PAR,P006591,P006760,8.834,-15,13,28
103,PAR,P006591,P007870,13.3,-6,25,31
103,PAR,P006591,P008232,5.284,-3,5,8
103,PAR,P006591,P010781,15.233,19,34,15
103,PAR,P006591,P011050,10.417,11,22,11
103,PAR,P006591,P011836,5.75,-14,8,22
103,PAR,P006591,P012720,5.383,-13,8,21
103,PAR,P006591,P013369,15.35,17,34,17
103,PAR,P006760,P007870,5.85,-16,8,24
103,PAR,P006760,P008232,3.101,-1,5,6
103,PAR,P006760,P010781,6.984,3,12,9
103,PAR,P006760,P011050,2.984,1,5,4
103,PAR,P006760,P011836,8.517,-13,11,24
103,PAR,P006760,P011981,7.134,5,13,8
103,PAR,P006760,P012720,5.933,-12,9,21
103,PAR,P006760,P013369,7.651,2,13,11
103,PAR,P007870,P008232,2.65,-5,0,5
103,PAR,P007870,P010781,12.333,15,30,15
103,PAR,P007870,P011836,5.383,-13,8,21
103,PAR,P007870,P011981,4.883,5,13,8
103,PAR,P007870,P012720,5.383,-13,8,21
103,PAR,P007870,P013369,12.8,12,30,18
103,PAR,P008232,P010781,2.183,-2,0,2
103,PAR,P008232,P011050,2.634,2,5,3
103,PAR,P008232,P011836,0.017,0,0,0
103,PAR,P008232,P013369,2.65,-5,0,5
103,PAR,P010781,P011050,7.783,9,17,8
103,PAR,P010781,P011836,6.784,-8,7,15
103,PAR,P010781,P011981,15.684,2,30,28
103,PAR,P010781,P013369,30.617,22,64,42
103,PAR,P011050,P011836,0.367,-1,0,1
103,PAR,P011050,P013369,7.433,10,17,7
103,PAR,P011836,P011981,6.934,-6,8,14
103,PAR,P011836,P012720,5.933,-12,9,21
103,PAR,P011836,P013369,6.984,-6,8,14
103,PAR,P011981,P012720,0.55,1,1,0
103,PAR,P011981,P013369,16.234,3,31,28
103,PAR,P012720,P013369,0.55,1,1,0
107,BAR,P000925,P002939,26.5,-7,42,49
107,BAR,P000925,P003478,24.867,-7,37,44
107,BAR,P000925,P007464,5.717,-1,9,10
107,BAR,P000925,P009862,33.166,-1,57,58
107,BAR,P000925,P009992,9.2,-9,14,23
107,BAR,P000925,P010106,3.484,5,9,4
107,BAR,P000925,P012745,32.45,-8,55,63
107,BAR,P000925,P012795,16.817,-5,33,38
107,BAR,P000925,P013505,0.467,-3,0,3
107,BAR,P002939,P003478,20.0,-5,31,36
107,BAR,P002939,P007464,5.133,2,9,7
107,BAR,P002939,P009862,22.6,-2,35,37
107,BAR,P002939,P009992,3.333,-1,4,5
107,BAR,P002939,P010106,0.25,-1,1,2
107,BAR,P002939,P012745,21.367,-9,33,42
107,BAR,P002939,P012795,6.817,-5,13,18
107,BAR,P003196,P007464,2.633,-2,5,7
107,BAR,P003196,P009862,0.717,0,2,2
107,BAR,P003196,P009992,2.633,-2,5,7
107,BAR,P003196,P012745,0.717,0,2,2
107,BAR,P003196,P012795,3.35,-2,7,9
107,BAR,P003196,P013505,3.35,-2,7,9
107,BAR,P003478,P006568,0.967,1,3,2
107,BAR,P003478,P007464,6.684,0,12,12
107,BAR,P003478,P009862,20.633,0,31,31
107,BAR,P003478,P009992,5.967,-2,9,11
107,BAR,P003478,P010106,1.084,1,3,2
107,BAR,P003478,P012745,19.15,-6,28,34
107,BAR,P003478,P012795,3.517,-3,6,9
107,BAR,P003478,P013505,0.467,-3,0,3
107,BAR,P006568,P007464,6.067,7,17,10
107,BAR,P006568,P009862,0.633,-2,0,2
107,BAR,P006568,P009992,7.85,6,19,13
107,BAR,P006568,P010106,8.483,4,19,15
107,BAR,P006568,P012745,2.416,-3,2,5
107,BAR,P006568,P012795,7.516,3,16,13
107,BAR,P007464,P009862,1.8,3,5,2
107,BAR,P007464,P009992,12.617,1,26,25
107,BAR,P007464,P010106,6.184,7,17,10
107,BAR,P007464,P012795,7.733,4,19,15
107,BAR,P007464,P013505,3.1,-5,5,10
107,BAR,P009862,P009992,4.766,-5,10,15
107,BAR,P009862,P010106,3.233,4,8,4
107,BAR,P009862,P012745,32.716,-6,54,60
107,BAR,P009862,P012795,17.083,-3,32,35
107,BAR,P009862,P013505,0.717,0,2,2
107,BAR,P009992,P010106,8.484,6,19,13
107,BAR,P009992,P012745,7.066,-6,12,18
107,BAR,P009992,P012795,13.716,-3,29,32
107,BAR,P009992,P013505,3.1,-5,5,10
107,BAR,P010106,P012745,5.783,2,11,9
107,BAR,P010106,P012795,10.883,8,25,17
107,BAR,P012745,P012795,19.95,-8,37,45
107,BAR,P012745,P013505,0.717,0,2,2
107,BAR,P012795,P013505,3.35,-2,7,9
107,MAD,P003108,P003583,6.317,-4,5,9
107,MAD,P003108,P003733,18.083,1,29,28
107,MAD,P003108,P005791,29.166,10,60,50
107,MAD,P003108,P005928,35.616,9,68,59
107,MAD,P003108,P006540,21.866,10,48,38
107,MAD,P003108,P009005,13.066,4,29,25
107,MAD,P003108,P013378,15.816,4,25,21
107,MAD,P003108,PTGB,3.066,2,8,6
107,MAD,P003583,P003733,2.167,-4,0,4
107,MAD,P003583,P005928,8.25,-9,5,14
107,MAD,P003583,P006540,10.666,-15,10,25
107,MAD,P003583,P009005,6.966,-12,8,20
107,MAD,P003583,P011247,5.033,-7,8,15
107,MAD,P003583,P013378,4.916,0,7,7
107,MAD,P003583,PTGB,8.817,-13,9,22
107,MAD,P003733,P005791,20.5,10,41,31
107,MAD,P003733,P005928,22.667,6,41,35
107,MAD,P003733,P006540,4.65,5,12,7
107,MAD,P003733,P009005,6.233,2,12,10
107,MAD,P003733,P013378,9.883,3,17,14
107,MAD,P003733,PTGB,7.017,1,12,11
107,MAD,P005791,P005928,36.45,20,81,61
107,MAD,P005791,P006540,20.6,15,52,37
107,MAD,P005791,P009005,20.084,11,47,36
107,MAD,P005791,P013378,11.533,4,20,16
107,MAD,P005791,PTGB,7.467,10,23,13
107,MAD,P005928,P006540,26.366,10,57,47
107,MAD,P005928,P009005,22.15,9,50,41
107,MAD,P005928,P013378,16.016,4,25,21
107,MAD,P005928,PTGB,11.817,7,29,22
107,MAD,P006540,P009005,21.083,0,46,46
107,MAD,P006540,P011247,5.033,-7,8,15
107,MAD,P006540,P013378,6.249,-2,7,9
107,MAD,P006540,PTGB,9.083,-4,20,24
107,MAD,P009005,P011247,5.033,-7,8,15
107,MAD,P009005,P013378,0.899,0,2,2
107,MAD,P009005,PTGB,13.75,1,30,29
107,MAD,P011247,P013378,0.433,0,2,2
107,MAD,P011247,PTGB,4.6,-7,6,13
107,MAD,P013378,PTGB,0.583,3,3,0
104,MIL,P000796,P001392,14.315,7,34,27
104,MIL,P000796,P001518,14.7,11,42,31
104,MIL,P000796,P006085,9.782,12,29,17
104,MIL,P000796,P007831,21.583,6,56,50
104,MIL,P000796,P008987,20.633,3,55,52
104,MIL,P000796,P011064,19.016,-1,43,44
104,MIL,P000796,P011941,3.316,2,5,3
104,MIL,P000796,P013384,10.232,6,22,16
104,MIL,P000796,P013385,3.283,-2,2,4
104,MIL,P001392,P001518,7.717,5,20,15
104,MIL,P001392,P006085,16.599,15,45,30
104,MIL,P001392,P006721,0.05,0,0,0
104,MIL,P001392,P007831,7.466,-2,19,21
104,MIL,P001392,P008987,11.116,1,30,29
104,MIL,P001392,P011064,4.899,-9,6,15
104,MIL,P001392,P011941,3.316,2,5,3
104,MIL,P001392,P013384,14.499,8,32,24
104,MIL,P001392,P013385,7.883,-3,13,16
104,MIL,P001518,P006085,8.85,6,19,13
104,MIL,P001518,P006721,0.05,0,0,0
104,MIL,P001518,P007831,16.633,-5,35,40
104,MIL,P001518,P008987,18.9,-1,40,41
104,MIL,P001518,P011064,13.833,-2,35,37
104,MIL,P001518,P011941,1.05,-3,0,3
104,MIL,P001518,P013384,6.517,9,19,10
104,MIL,P001518,P013385,4.35,-4,6,10
104,MIL,P006085,P007831,5.566,0,13,13
104,MIL,P006085,P008987,10.749,3,24,21
104,MIL,P006085,P011941,3.483,0,5,5
104,MIL,P006085,P013384,13.416,12,32,20
104,MIL,P006085,P013385,7.483,0,13,13
104,MIL,P006721,P008987,0.05,0,0,0
104,MIL,P006721,P013384,0.05,0,0,0
104,MIL,P007831,P008987,22.366,-3,57,60
104,MIL,P007831,P011064,19.516,-2,46,48
104,MIL,P007831,P011941,1.05,-3,0,3
104,MIL,P007831,P013384,2.6,1,6,5
104,MIL,P007831,P013385,5.216,0,4,4
104,MIL,P008987,P011064,17.933,-2,46,48
104,MIL,P008987,P011941,1.05,-3,0,3
104,MIL,P008987,P013384,9.383,5,19,14
104,MIL,P008987,P013385,4.416,1,9,8
104,MIL,P011064,P011941,0.883,-1,0,1
104,MIL,P011064,P013384,3.633,-3,6,9
104,MIL,P011064,P013385,2.483,-4,2,6
104,MIL,P011941,P013384,3.316,2,5,3
104,MIL,P013384,P013385,4.75,-4,11,15
104,ULK,P002849,P002968,4.333,-5,6,11
104,ULK,P002849,P004004,7.449,1,17,16
104,ULK,P002849,P006961,12.066,5,26,21
104,ULK,P002849,P007182,2.033,8,15,7
104,ULK,P002849,P008104,9.75,10,32,22
104,ULK,P002849,P008962,7.583,8,19,11
104,ULK,P002849,P009783,2.233,11,17,6
104,ULK,P002849,P009863,5.2,7,13,6
104,ULK,P002849,P010560,0.2,1,1,0
104,ULK,P002849,P013396,5.549,6,18,12
104,ULK,P002968,P004004,8.633,-4,15,19
104,ULK,P002968,P006961,8.583,-3,15,18
104,ULK,P002968,P007182,0.05,-1,0,1
104,ULK,P002968,P008104,3.666,-2,5,7
104,ULK,P002968,P008962,4.383,-2,4,6
104,ULK,P002968,P009783,2.583,3,5,2
104,ULK,P002968,P009863,5.15,2,8,6
104,ULK,P002968,P013396,2.483,-4,2,6
104,ULK,P004004,P006961,17.065,-14,30,44
104,ULK,P004004,P007182,0.567,-1,2,3
104,ULK,P004004,P008104,5.433,-5,13,18
104,ULK,P004004,P008962,9.732,-10,16,26
104,ULK,P004004,P009783,5.016,-10,7,17
104,ULK,P004004,P009863,9.066,-9,14,23
104,ULK,P004004,P010560,1.416,-5,1,6
104,ULK,P004004,P013396,4.083,-3,5,8
104,ULK,P006961,P007182,5.817,-1,17,18
104,ULK,P006961,P008104,17.917,-3,35,38
104,ULK,P006961,P008962,23.216,-7,43,50
104,ULK,P006961,P009783,6.016,-9,12,21
104,ULK,P006961,P009863,22.55,-6,41,47
104,ULK,P006961,P010560,4.933,-4,4,8
104,ULK,P006961,P013396,4.033,-2,5,7
104,ULK,P007182,P008104,13.133,6,42,36
104,ULK,P007182,P008962,11.383,-4,28,32
104,ULK,P007182,P009783,8.816,5,31,26
104,ULK,P007182,P009863,11.383,-4,28,32
104,ULK,P007182,P013396,2.55,8,17,9
104,ULK,P008104,P008962,21.883,-1,42,43
104,ULK,P008104,P009783,9.399,6,28,22
104,ULK,P008104,P009863,20.983,-5,35,40
104,ULK,P008104,P010560,4.6,-3,3,6
104,ULK,P008104,P013396,2.5,9,17,8
104,ULK,P008962,P009783,12.182,-15,20,35
104,ULK,P008962,P009863,27.633,-8,49,57
104,ULK,P008962,P010560,3.65,-1,3,4
104,ULK,P008962,P013396,0.883,0,0,0
104,ULK,P009783,P009863,13.299,-10,25,35
104,ULK,P009783,P010560,0.133,-2,0,2
104,ULK,P009783,P013396,1.983,9,15,6
104,ULK,P009863,P010560,4.6,-3,3,6
104,ULK,P010560,P013396,0.2,1,1,0
105,MUN,P004508,P005460,4.617,2,12,10
105,MUN,P004508,P007056,16.833,-16,33,49
105,MUN,P004508,P007201,14.567,-10,29,39
105,MUN,P004508,P007929,5.6,-1,14,15
105,MUN,P004508,P010391,10.8,-11,19,30
105,MUN,P004508,P011224,10.65,-3,26,29
105,MUN,P004508,P011244,6.883,-4,16,20
105,MUN,P004508,P011987,15.85,-13,31,44
105,MUN,P005460,P007056,2.333,-2,2,4
105,MUN,P005460,P007639,4.667,2,8,6
105,MUN,P005460,P007929,11.617,2,22,20
105,MUN,P005460,P011224,11.617,2,22,20
105,MUN,P005460,P011244,11.617,2,22,20
105,MUN,P007056,P007201,15.717,-15,29,44
105,MUN,P007056,P007929,8.166,-15,8,23
105,MUN,P007056,P010391,13.417,-20,19,39
105,MUN,P007056,P011224,12.066,-12,20,32
105,MUN,P007056,P011244,8.299,-13,10,23
105,MUN,P007056,P011987,19.233,-19,35,54
105,MUN,P007201,P007929,1.15,-5,0,5
105,MUN,P007201,P010391,10.667,-13,17,30
105,MUN,P007201,P011224,5.05,-2,12,14
105,MUN,P007201,P011987,15.717,-15,29,44
105,MUN,P007639,P007929,11.367,2,26,24
105,MUN,P007639,P011224,4.667,2,8,6
105,MUN,P007639,P011244,11.367,2,26,24
105,MUN,P007639,P012123,6.7,0,18,18
105,MUN,P007639,P013368,6.7,0,18,18
105,MUN,P007929,P010391,2.617,-9,0,9
105,MUN,P007929,P011224,16.3,-6,28,34
105,MUN,P007929,P011244,23.0,-6,46,52
105,MUN,P007929,P011987,3.383,-6,4,10
105,MUN,P007929,P012123,6.7,0,18,18
105,MUN,P007929,P013368,6.7,0,18,18
105,MUN,P010391,P011224,1.467,-4,0,4
105,MUN,P010391,P011244,2.75,-7,2,9
105,MUN,P010391,P011987,11.95,-16,19,35
105,MUN,P011224,P011244,16.3,-6,28,34
105,MUN,P011224,P011987,7.283,-3,16,19
105,MUN,P011244,P011987,3.516,-4,6,10
105,MUN,P011244,P012123,6.7,0,18,18
105,MUN,P011244,P013368,6.7,0,18,18
105,MUN,P012123,P013368,6.7,0,18,18
105,RED,P002553,P004007,1.617,-2,3,5
105,RED,P002553,P004866,6.4,1,16,15
105,RED,P002553,P006436,7.6,-8,15,23
105,RED,P002553,P009048,2.067,-4,3,7
105,RED,P002553,P010612,13.717,-2,34,36
105,RED,P002553,P011194,1.617,-2,3,5
105,RED,P002553,P012044,11.65,2,31,29
105,RED,P002553,PJDR,4.5,8,16,8
105,RED,P002553,PLUO,5.7,-1,15,16
105,RED,P004007,P004866,16.767,22,45,23
105,RED,P004007,P009048,19.101,25,53,28
105,RED,P004007,P010612,2.334,3,8,5
105,RED,P004007,P011194,19.101,25,53,28
105,RED,P004007,P012786,17.484,27,50,23
105,RED,P004866,P006240,1.366,1,2,1
105,RED,P004866,P006436,3.05,-11,2,13
105,RED,P004866,P009048,19.167,18,49,31
105,RED,P004866,P010612,7.933,2,18,16
105,RED,P004866,P011194,19.901,22,53,31
105,RED,P004866,P012044,8.5,6,22,16
105,RED,P004866,P012786,21.267,23,55,32
105,RED,P004866,PJDR,6.317,12,22,10
105,RED,P006240,P006436,4.3,-2,7,9
105,RED,P006240,P009048,0.633,2,2,0
105,RED,P006240,P010612,5.666,-1,9,10
105,RED,P006240,P012044,5.033,-3,7,10
105,RED,P006240,P012786,5.666,-1,9,10
105,RED,P006436,P009048,1.6,-6,2,8
105,RED,P006436,P010612,11.9,-10,22,32
105,RED,P006436,P011194,1.15,-4,2,6
105,RED,P006436,P012044,11.45,-8,22,30
105,RED,P006436,P012786,5.45,-6,9,15
105,RED,P006436,PLUO,5.7,-1,15,16
105,RED,P009048,P010612,3.584,3,10,7
105,RED,P009048,P011194,20.418,21,55,34
105,RED,P009048,P012786,19.434,25,54,29
105,RED,P010612,P011194,2.501,3,8,5
105,RED,P010612,P012044,16.683,-1,38,39
105,RED,P010612,P012786,6.55,4,14,10
105,RED,P010612,PJDR,4.5,8,16,8
105,RED,P010612,PLUO,5.7,-1,15,16
105,RED,P011194,P012044,1.817,4,6,2
105,RED,P011194,P012786,20.618,27,58,31
105,RED,P011194,PJDR,1.817,4,6,2
105,RED,P012044,P012786,6.85,1,13,12
105,RED,P012044,PJDR,6.317,12,22,10
105,RED,P012044,PLUO,5.7,-1,15,16
105,RED,P012786,PJDR,1.817,4,6,2
106,MCO,P005844,P005985,12.966,-4,20,24
106,MCO,P005844,P008099,10.499,6,25,19
106,MCO,P005844,P008161,0.133,3,3,0
106,MCO,P005844,P009754,6.133,-5,9,14
106,MCO,P005844,P011212,14.033,1,30,29
106,MCO,P005844,P011226,12.498,10,31,21
106,MCO,P005844,P011231,12.266,6,30,24
106,MCO,P005844,P013365,1.0,-1,0,1
106,MCO,P005985,P008099,8.85,-10,8,18
106,MCO,P005985,P009754,24.233,6,63,57
106,MCO,P005985,P011212,19.483,3,46,43
106,MCO,P005985,P011226,25.799,9,61,52
106,MCO,P005985,P011231,12.483,-1,25,26
106,MCO,P005985,P013365,16.517,4,42,38
106,MCO,P005985,PLCZ,12.133,1,31,30
106,MCO,P008099,P008161,0.133,3,3,0
106,MCO,P008099,P009754,6.067,-9,3,12
106,MCO,P008099,P011212,9.617,-4,18,22
106,MCO,P008099,P011226,9.999,-1,21,22
106,MCO,P008099,P011231,10.05,0,22,22
106,MCO,P008099,P013365,3.6,-9,0,9
106,MCO,P008099,PLCZ,4.117,-12,0,12
106,MCO,P008161,P011226,0.133,3,3,0
106,MCO,P008161,P011231,0.133,3,3,0
106,MCO,P009754,P011212,15.15,-2,36,38
106,MCO,P009754,P011226,19.683,11,54,43
106,MCO,P009754,P011231,6.95,-7,14,21
106,MCO,P009754,P013365,15.434,9,42,33
106,MCO,P009754,PLCZ,12.35,1,31,30
106,MCO,P011212,P011226,17.249,12,47,35
106,MCO,P011212,P011231,16.8,-6,33,39
106,MCO,P011212,P013365,7.3,8,23,15
106,MCO,P011212,PLCZ,5.3,-8,7,15
106,MCO,P011226,P011231,10.482,11,29,18
106,MCO,P011226,P013365,15.917,5,42,37
106,MCO,P011226,PLCZ,9.9,0,24,24
106,MCO,P011231,PLCZ,6.7,-6,12,18
106,MCO,P013365,PLCZ,7.9,0,19,19
106,PAN,P001926,P003842,22.851,0,53,53
106,PAN,P001926,P004088,6.35,-4,15,19
106,PAN,P001926,P005161,4.883,-5,12,17
106,PAN,P001926,P005353,3.383,-5,7,12
106,PAN,P001926,P007866,5.717,-1,11,12
106,PAN,P001926,P009622,13.167,-2,27,29
106,PAN,P001926,P011204,21.584,0,50,50
106,PAN,P001926,P012712,11.134,3,29,26
106,PAN,P001926,P012774,15.867,-6,36,42
106,PAN,P003842,P004088,18.383,-2,40,42
106,PAN,P003842,P005161,1.5,0,5,5
106,PAN,P003842,P007866,10.833,-7,20,27
106,PAN,P003842,P009622,14.967,8,30,22
106,PAN,P003842,P011204,29.717,-8,65,73
106,PAN,P003842,P012712,18.051,11,45,34
106,PAN,P003842,P012774,23.234,6,54,48
106,PAN,P004088,P005353,1.733,0,3,3
106,PAN,P004088,P007866,5.566,-6,11,17
106,PAN,P004088,P009622,6.916,5,13,8
106,PAN,P004088,P011204,16.216,-12,33,45
106,PAN,P004088,P012712,10.05,6,24,18
106,PAN,P004088,P012774,15.25,5,33,28
106,PAN,P005161,P005353,3.383,-5,7,12
106,PAN,P005161,P009622,3.383,-5,7,12
106,PAN,P005161,P011204,1.5,0,5,5
106,PAN,P005161,P012774,4.883,-5,12,17
106,PAN,P005353,P009622,5.116,-5,10,15
106,PAN,P005353,P011204,1.733,0,3,3
106,PAN,P005353,P012712,1.733,0,3,3
106,PAN,P005353,P012774,3.383,-5,7,12
106,PAN,P007866,P009622,6.25,-6,9,15
106,PAN,P007866,P011204,10.833,-7,20,27
106,PAN,P007866,P012774,4.133,-1,9,10
106,PAN,P009622,P011204,11.533,-2,20,22
106,PAN,P009622,P012712,10.45,14,24,10
106,PAN,P009622,P012774,8.55,5,20,15
106,PAN,P011204,P012712,14.617,1,35,34
106,PAN,P011204,P012774,18.067,-4,41,45
106,PAN,P012712,P012774,13.101,9,32,23
108,ASV,P002100,P003526,8.15,2,18,16
108,ASV,P002100,P004194,9.033,15,25,10
108,ASV,P002100,P007027,2.433,-7,2,9
108,ASV,P002100,P010545,7.4,6,16,10
108,ASV,P002100,P011225,13.567,28,39,11
108,ASV,P002100,P012731,7.25,8,18,10
108,ASV,P002100,P013371,0.433,0,0,0
108,ASV,P002100,P013405,9.183,13,23,10
108,ASV,P002100,PKIR,8.283,19,23,4
108,ASV,P003526,P004194,2.216,-6,4,10
108,ASV,P003526,P007027,12.283,-2,23,25
108,ASV,P003526,P010545,15.784,13,35,22
108,ASV,P003526,P011225,8.5,12,21,9
108,ASV,P003526,P012731,5.566,-4,9,13
108,ASV,P003526,P013371,6.9,2,16,14
108,ASV,P003526,P013405,12.601,11,30,19
108,ASV,P004194,P007027,11.433,-8,30,38
108,ASV,P004194,P008991,2.55,0,7,7
108,ASV,P004194,P010316,2.55,0,7,7
108,ASV,P004194,P011225,8.817,23,29,6
108,ASV,P004194,P012731,12.55,6,34,28
108,ASV,P004194,P013371,9.283,-8,22,30
108,ASV,P004194,P013405,4.183,5,12,7
108,ASV,P004194,PKIR,14.517,17,42,25
108,ASV,P007027,P008991,4.8,-3,12,15
108,ASV,P007027,P010316,7.05,-9,16,25
108,ASV,P007027,P010545,12.317,-2,23,25
108,ASV,P007027,P011225,5.267,5,14,9
108,ASV,P007027,P012731,10.233,-5,23,28
108,ASV,P007027,P013371,18.133,-11,42,53
108,ASV,P007027,P013405,13.384,-8,28,36
108,ASV,P007027,PKIR,6.667,-2,19,21
108,ASV,P008991,P010316,4.8,-3,12,15
108,ASV,P008991,P011225,1.367,-3,1,4
108,ASV,P008991,P013371,3.433,0,11,11
108,ASV,P008991,P013405,2.25,-3,5,8
108,ASV,P010316,P010545,2.25,-6,4,10
108,ASV,P010316,P011225,1.517,-2,3,5
108,ASV,P010316,P013371,5.533,-7,13,20
108,ASV,P010316,P013405,4.5,-9,9,18
108,ASV,P010545,P011225,8.65,13,23,10
108,ASV,P010545,P012731,3.35,2,5,3
108,ASV,P010545,P013371,8.4,-3,16,19
108,ASV,P010545,P013405,15.284,5,34,29
108,ASV,P010545,PKIR,0.433,0,0,0
108,ASV,P011225,P012731,9.417,20,27,7
108,ASV,P011225,P013405,9.417,13,26,13
108,ASV,P011225,PKIR,8.817,23,29,6
108,ASV,P012731,P013371,4.733,-7,10,17
108,ASV,P012731,P013405,0.167,0,0,0
108,ASV,P012731,PKIR,10.334,12,30,18
108,ASV,P013371,P013405,11.283,-4,25,29
108,ASV,P013371,PKIR,6.133,-6,13,19
108,ASV,P013405,PKIR,4.616,5,12,7
108,IST,P004887,P006590,7.983,-2,15,17
108,IST,P004887,P007109,9.183,-7,16,23
108,IST,P004887,P009513,3.883,5,12,7
108,IST,P004887,P009664,1.367,-2,1,3
108,IST,P004887,P009846,21.05,-15,37,52
108,IST,P004887,P011078,20.15,-13,37,50
108,IST,P004887,P012710,14.383,-1,32,33
108,IST,P004887,P013363,7.7,-7,13,20
108,IST,P004887,P013364,14.033,2,33,31
108,IST,P006590,P007109,10.8,5,31,26
108,IST,P006590,P009513,6.25,4,18,14
108,IST,P006590,P009664,8.001,-10,8,18
108,IST,P006590,P009846,7.034,-12,4,16
108,IST,P006590,P011078,12.267,-11,22,33
108,IST,P006590,P012710,2.133,-5,2,7
108,IST,P006590,P012788,12.784,-8,26,34
108,IST,P006590,P013363,14.701,1,35,34
108,IST,P006590,P013364,1.783,-2,3,5
108,IST,P007109,P009513,6.25,4,18,14
108,IST,P007109,P009846,5.833,-14,4,18
108,IST,P007109,P011078,9.183,-13,17,30
108,IST,P007109,P012788,6.85,-2,19,21
108,IST,P007109,P013363,14.55,-9,32,41
108,IST,P007109,P013364,1.483,0,3,3
108,IST,P009513,P009664,0.85,3,3,0
108,IST,P009513,P009846,0.85,3,3,0
108,IST,P009513,P012788,3.217,2,9,7
108,IST,P009513,P013363,6.217,7,18,11
108,IST,P009513,P013364,0.883,0,3,3
108,IST,P009664,P009846,5.884,-2,9,11
108,IST,P009664,P011078,7.217,-7,11,18
108,IST,P009664,P012788,8.05,-3,14,17
108,IST,P009664,P013363,6.967,1,14,13
108,IST,P009846,P011078,22.833,-17,41,58
108,IST,P009846,P012710,14.383,-1,32,33
108,IST,P009846,P012788,4.883,-2,8,10
108,IST,P009846,P013363,8.5,-10,12,22
108,IST,P009846,P013364,13.15,2,30,28
108,IST,P011078,P012710,14.083,1,32,31
108,IST,P011078,P012788,10.166,-6,23,29
108,IST,P011078,P013363,13.783,-14,27,41
108,IST,P011078,P013364,12.25,4,30,26
108,IST,P012710,P013364,12.55,2,30,28
108,IST,P012788,P013363,13.65,-1,33,34
109,IST,P004887,P006590,10.183,4,26,22
109,IST,P004887,P007109,12.033,-3,27,30
109,IST,P004887,P009513,7.183,6,20,14
109,IST,P004887,P009846,14.466,4,33,29
109,IST,P004887,P010400,2.783,-11,2,13
109,IST,P004887,P011078,18.833,15,49,34
109,IST,P004887,P012710,9.583,7,24,17
109,IST,P004887,P013363,11.4,-6,23,29
109,IST,P006590,P007109,8.216,4,22,18
109,IST,P006590,P009513,9.883,9,29,20
109,IST,P006590,P009846,3.2,7,11,4
109,IST,P006590,P010400,4.783,-2,12,14
109,IST,P006590,P011078,13.316,15,39,24
109,IST,P006590,P012710,10.4,14,34,20
109,IST,P006590,P012788,7.583,10,26,16
109,IST,P006590,P013363,5.3,3,17,14
109,IST,P007109,P009846,14.0,4,38,34
109,IST,P007109,P010400,7.933,-7,21,28
109,IST,P007109,P011078,11.2,11,31,20
109,IST,P007109,P012710,0.4,2,2,0
109,IST,P007109,P012788,6.65,5,23,18
109,IST,P007109,P013363,16.1,0,44,44
109,IST,P009513,P009846,5.966,-10,9,19
109,IST,P009513,P011078,15.849,-1,38,39
109,IST,P009513,P012710,15.849,-1,38,39
109,IST,P009513,P012788,8.666,-7,18,25
109,IST,P009846,P010400,3.95,-3,11,14
109,IST,P009846,P011078,20.916,2,44,42
109,IST,P009846,P012710,10.983,-2,20,22
109,IST,P009846,P012788,10.467,-2,25,27
109,IST,P009846,P013363,15.984,8,41,33
109,IST,P010400,P012710,0.75,2,2,0
109,IST,P010400,P012788,5.85,6,21,15
109,IST,P010400,P013363,8.683,-5,23,28
109,IST,P011078,P012710,20.399,4,46,42
109,IST,P011078,P012788,11.966,-4,24,28
109,IST,P011078,P013363,12.317,10,29,19
109,IST,P012710,P012788,11.283,0,25,25
109,IST,P012710,P013363,5.417,10,13,3
109,IST,P012788,P013363,9.267,12,30,18
109,MUN,P001557,P005460,4.05,-1,12,13
109,MUN,P001557,P007056,1.766,-10,0,10
109,MUN,P001557,P007201,0.833,-5,0,5
109,MUN,P001557,P007639,0.05,0,0,0
109,MUN,P001557,P007929,1.866,-7,0,7
109,MUN,P001557,P010391,0.883,-5,0,5
109,MUN,P001557,P011224,5.033,-6,12,18
109,MUN,P001557,P011244,4.983,-6,12,18
109,MUN,P001557,P011987,3.95,-4,12,16
109,MUN,P001557,P013368,0.05,0,0,0
109,MUN,P004508,P007056,25.266,-4,56,60
109,MUN,P004508,P007201,22.75,-3,50,53
109,MUN,P004508,P007639,1.517,-4,0,4
109,MUN,P004508,P010391,24.716,-8,51,59
109,MUN,P004508,P011224,7.333,-5,13,18
109,MUN,P004508,P011987,21.517,-3,48,51
109,MUN,P004508,P013368,4.033,-5,6,11
109,MUN,P005460,P007929,0.933,-2,0,2
109,MUN,P005460,P011224,4.05,-1,12,13
109,MUN,P005460,P011244,4.05,-1,12,13
109,MUN,P005460,P011987,3.117,1,12,11
109,MUN,P007056,P007201,28.866,-6,64,70
109,MUN,P007056,P007929,3.633,-1,8,9
109,MUN,P007056,P010391,29.332,-7,65,72
109,MUN,P007056,P011224,12.066,-4,27,31
109,MUN,P007056,P011244,0.933,-5,0,5
109,MUN,P007056,P011987,24.933,-10,54,64
109,MUN,P007056,P013368,2.533,-1,6,7
109,MUN,P007201,P007639,0.017,0,0,0
109,MUN,P007201,P007929,2.7,4,8,4
109,MUN,P007201,P010391,26.816,-6,59,65
109,MUN,P007201,P011224,8.6,2,21,19
109,MUN,P007201,P011987,24.95,-10,54,64
109,MUN,P007639,P010391,3.617,2,8,6
109,MUN,P007639,P011224,3.6,2,8,6
109,MUN,P007639,P011987,2.067,6,8,2
109,MUN,P007639,P013368,3.6,2,8,6
109,MUN,P007929,P010391,2.7,4,8,4
109,MUN,P007929,P011224,4.566,-3,8,11
109,MUN,P007929,P011244,1.866,-7,0,7
109,MUN,P010391,P011224,12.666,3,30,27
109,MUN,P010391,P011987,24.933,-4,57,61
109,MUN,P010391,P013368,6.133,1,14,13
109,MUN,P011224,P011244,4.983,-6,12,18
109,MUN,P011224,P011987,9.834,5,31,26
109,MUN,P011224,P013368,6.133,1,14,13
109,MUN,P011244,P011987,3.117,1,12,11
109,MUN,P011987,P013368,2.05,6,8,2
110,ASV,P002100,P003526,14.05,-7,22,29
110,ASV,P002100,P004194,10.05,-8,18,26
110,ASV,P002100,P007027,11.867,15,28,13
110,ASV,P002100,P008991,6.699,2,10,8
110,ASV,P002100,P010545,2.2,0,2,2
110,ASV,P002100,P011225,8.083,8,17,9
110,ASV,P002100,P012731,16.2,-4,28,32
110,ASV,P002100,P013371,7.816,-11,11,22
110,ASV,P002100,P013405,9.167,5,20,15
110,ASV,P003526,P004194,10.267,-5,20,25
110,ASV,P003526,P007027,11.884,4,24,20
110,ASV,P003526,P008991,5.333,0,8,8
110,ASV,P003526,P010545,4.216,-1,7,8
110,ASV,P003526,P011225,7.25,-1,13,14
110,ASV,P003526,P012731,13.55,-1,23,24
110,ASV,P003526,P013371,7.283,-8,11,19
110,ASV,P003526,P013405,7.367,-5,12,17
110,ASV,P004194,P007027,5.651,-1,11,12
110,ASV,P004194,P011225,4.001,-7,4,11
110,ASV,P004194,P012731,10.167,-7,17,24
110,ASV,P004194,P013371,5.966,-6,11,17
110,ASV,P004194,P013405,5.234,-10,7,17
110,ASV,P007027,P008991,8.883,10,22,12
110,ASV,P007027,P010316,3.517,0,11,11
110,ASV,P007027,P010545,13.233,2,27,25
110,ASV,P007027,P011225,24.567,14,58,44
110,ASV,P007027,P012731,16.434,14,38,24
110,ASV,P007027,P013405,25.3,10,57,47
110,ASV,P008991,P011225,7.216,9,18,9
110,ASV,P008991,P012731,9.416,-1,16,17
110,ASV,P008991,P013371,1.833,-5,0,5
110,ASV,P008991,P013405,6.016,5,14,9
110,ASV,P010316,P010545,3.517,0,11,11
110,ASV,P010316,P011225,3.517,0,11,11
110,ASV,P010316,P013405,3.517,0,11,11
110,ASV,P010545,P011225,13.1,2,27,25
110,ASV,P010545,P012731,3.433,3,7,4
110,ASV,P010545,P013405,13.233,2,27,25
110,ASV,P011225,P012731,12.717,9,30,21
110,ASV,P011225,P013405,25.217,6,54,48
110,ASV,P012731,P013371,7.816,-11,11,22
110,ASV,P012731,P013405,12.667,2,26,24
110,ASV,P013371,P013405,0.55,-3,0,3
110,MAD,P003108,P003733,11.251,-10,15,25
110,MAD,P003108,P005791,17.567,14,41,27
110,MAD,P003108,P005928,26.601,7,56,49
110,MAD,P003108,P006540,6.317,-13,6,19
110,MAD,P003108,P007630,11.95,-12,18,30
110,MAD,P003108,P009005,20.751,10,44,34
110,MAD,P003108,P009213,4.634,-1,9,10
110,MAD,P003108,P011247,4.467,-7,3,10
110,MAD,P003108,P011649,1.15,-2,0,2
110,MAD,P003108,P013378,6.684,-3,12,15
110,MAD,P003108,PTGB,12.9,17,32,15
110,MAD,P003733,P005791,1.117,-4,0,4
110,MAD,P003733,P005928,6.784,-3,12,15
110,MAD,P003733,P006540,2.95,-5,3,8
110,MAD,P003733,P007630,8.583,-4,15,19
110,MAD,P003733,P009005,6.551,-1,12,13
110,MAD,P003733,P009213,1.067,-2,0,2
110,MAD,P003733,P011247,4.467,-7,3,10
110,MAD,P003733,P011649,1.15,-2,0,2
110,MAD,P003733,P013378,1.067,-2,0,2
110,MAD,P003733,PTGB,0.017,0,0,0
110,MAD,P005791,P005928,19.083,16,41,25
110,MAD,P005791,P006540,7.817,-5,17,22
110,MAD,P005791,P009005,21.367,12,49,37
110,MAD,P005791,P009213,11.617,-2,26,28
110,MAD,P005791,P011247,6.534,-5,17,22
110,MAD,P005791,P013378,3.55,3,9,6
110,MAD,P005791,PTGB,13.816,15,32,17
110,MAD,P005928,P006540,5.067,-8,3,11
110,MAD,P005928,P007630,9.067,-9,15,24
110,MAD,P005928,P009005,22.55,8,44,36
110,MAD,P005928,P009213,7.267,-3,9,12
110,MAD,P005928,P013378,6.684,-3,12,15
110,MAD,P005928,PTGB,13.833,15,32,17
110,MAD,P006540,P007630,6.033,-8,8,16
110,MAD,P006540,P009005,9.3,-4,19,23
110,MAD,P006540,P009213,8.0,0,19,19
110,MAD,P006540,P011247,9.25,-5,22,27
110,MAD,P006540,P011649,0.467,0,0,0
110,MAD,P006540,P013378,2.067,-4,3,7
110,MAD,P007630,P009005,8.3,-4,14,18
110,MAD,P007630,P009213,0.883,1,2,1
110,MAD,P007630,P011247,3.766,-2,5,7
110,MAD,P007630,P011649,0.683,-2,0,2
110,MAD,P007630,P013378,2.067,-4,3,7
110,MAD,P009005,P009213,8.95,-4,19,23
110,MAD,P009005,P011247,7.134,0,19,19
110,MAD,P009005,PTGB,13.833,15,32,17
110,MAD,P009213,P011247,6.3,0,19,19
110,MAD,P009213,P013378,4.617,1,9,8
110,MAD,P009213,PTGB,0.933,-2,0,2
110,MAD,P011247,P011649,1.15,-2,0,2
114,PRS,P004512,P005793,3.317,0,8,8
114,PRS,P004512,P007032,5.934,1,10,9
114,PRS,P004512,P012608,9.05,11,23,12
114,PRS,P004512,P012609,11.767,11,29,18
114,PRS,P004512,P012610,5.633,10,18,8
114,PRS,P004512,P012611,0.8,0,3,3
114,PRS,P004512,P012613,9.05,11,23,12
114,PRS,P004512,P012640,3.917,0,10,10
114,PRS,P005793,P007032,13.85,0,35,35
114,PRS,P005793,P010390,0.483,-3,0,3
114,PRS,P005793,P012608,0.583,-3,0,3
114,PRS,P005793,P012609,14.067,3,38,35
114,PRS,P005793,P012611,1.383,-3,3,6
114,PRS,P005793,P012640,14.067,3,38,35
114,PRS,P005793,P013373,10.85,3,30,27
114,PRS,P007032,P010390,4.783,-5,6,11
114,PRS,P007032,P012608,8.3,-4,11,15
114,PRS,P007032,P012609,16.684,4,40,36
114,PRS,P007032,P012610,4.3,-2,6,8
114,PRS,P007032,P012611,0.583,-3,0,3
114,PRS,P007032,P012613,7.717,-1,11,12
114,PRS,P007032,P012640,13.267,3,35,32
114,PRS,P007032,P013373,10.85,3,30,27
114,PRS,P010390,P012608,16.783,-2,32,34
114,PRS,P010390,P012610,16.3,1,32,31
114,PRS,P010390,P012611,11.083,5,26,21
114,PRS,P010390,P012613,16.3,1,32,31
114,PRS,P010390,P012640,1.4,-5,0,5
114,PRS,P012608,P012609,8.45,11,21,10
114,PRS,P012608,P012610,21.933,11,50,39
114,PRS,P012608,P012611,11.183,5,26,21
114,PRS,P012608,P012613,25.35,12,55,43
114,PRS,P012608,P012640,2.0,-5,2,7
114,PRS,P012608,P013373,0.1,0,0,0
114,PRS,P012609,P012610,5.033,10,16,6
114,PRS,P012609,P012611,0.8,0,3,3
114,PRS,P012609,P012613,8.45,11,21,10
114,PRS,P012609,P012640,14.067,3,38,35
114,PRS,P012609,P013373,10.75,3,30,27
114,PRS,P012610,P012611,10.6,8,26,18
114,PRS,P012610,P012613,21.933,11,50,39
114,PRS,P012610,P012640,2.0,-5,2,7
114,PRS,P012611,P012613,10.6,8,26,18
114,PRS,P012611,P012640,0.8,0,3,3
114,PRS,P012611,P013373,0.1,0,0,0
114,PRS,P012613,P012640,2.0,-5,2,7
114,PRS,P012640,P013373,10.75,3,30,27
114,TEL,P006835,P007519,20.284,-12,35,47
114,TEL,P006835,P007990,15.168,-9,26,35
114,TEL,P006835,P011193,11.767,-11,23,34
114,TEL,P006835,P011202,14.101,-7,24,31
114,TEL,P006835,P011214,11.067,-2,23,25
114,TEL,P006835,P011219,4.35,-2,10,12
114,TEL,P006835,P013250,0.85,0,2,2
114,TEL,P006835,P013381,4.05,-3,11,14
114,TEL,P006835,P013382,28.668,-20,54,74
114,TEL,P006835,P013383,11.167,-14,16,30
114,TEL,P007519,P007990,15.617,-9,28,37
114,TEL,P007519,P011193,1.683,-3,2,5
114,TEL,P007519,P011202,12.75,4,30,26
114,TEL,P007519,P011214,3.883,5,8,3
114,TEL,P007519,P011219,7.283,1,18,17
114,TEL,P007519,P013381,6.966,6,21,15
114,TEL,P007519,P013382,20.567,-10,38,48
114,TEL,P007519,P013383,11.167,-14,16,30
114,TEL,P007990,P011193,4.8,6,15,9
114,TEL,P007990,P011202,6.317,0,14,14
114,TEL,P007990,P011214,3.017,5,12,7
114,TEL,P007990,P011219,5.482,7,17,10
114,TEL,P007990,P013381,5.383,4,14,10
114,TEL,P007990,P013382,16.167,-5,32,37
114,TEL,P007990,P013383,9.717,-11,14,25
114,TEL,P011193,P011202,10.083,-5,16,21
114,TEL,P011193,P011214,12.5,-5,26,31
114,TEL,P011193,P011219,5.899,5,14,9
114,TEL,P011193,P013250,2.983,1,6,5
114,TEL,P011193,P013381,4.1,-4,8,12
114,TEL,P011193,P013382,11.267,-9,24,33
114,TEL,P011193,P013383,1.45,-3,2,5
114,TEL,P011202,P011214,12.083,0,21,21
114,TEL,P011202,P011219,11.016,3,26,23
114,TEL,P011202,P013250,2.983,1,6,5
114,TEL,P011202,P013381,8.083,5,22,17
114,TEL,P011202,P013382,12.984,-5,25,30
114,TEL,P011214,P011219,4.283,2,8,6
114,TEL,P011214,P013250,2.883,1,6,5
114,TEL,P011214,P013381,4.9,-4,11,15
114,TEL,P011214,P013382,9.984,-2,21,23
114,TEL,P011219,P013250,2.133,1,4,3
114,TEL,P011219,P013381,6.216,5,15,10
114,TEL,P011219,P013382,6.066,2,16,14
114,TEL,P013250,P013382,0.1,0,0,0
114,TEL,P013381,P013382,4.566,-1,14,15
114,TEL,P013382,P013383,11.167,-14,16,30
111,BAR,P000925,P002939,15.05,-4,26,30
111,BAR,P000925,P003478,15.2,10,39,29
111,BAR,P000925,P007464,2.217,-1,4,5
111,BAR,P000925,P009862,25.567,12,60,48
111,BAR,P000925,P010106,16.017,13,46,33
111,BAR,P000925,P012745,28.967,9,67,58
111,BAR,P000925,P012795,12.85,-3,26,29
111,BAR,P002939,P003196,1.983,3,5,2
111,BAR,P002939,P003478,10.65,2,22,20
111,BAR,P002939,P009862,13.833,-4,23,27
111,BAR,P002939,P010106,2.15,0,5,5
111,BAR,P002939,P012745,17.083,-1,31,32
111,BAR,P002939,P012795,7.583,0,12,12
111,BAR,P003196,P003478,2.717,-2,3,5
111,BAR,P003196,P007464,4.05,-1,13,14
111,BAR,P003196,P009862,6.767,-8,16,24
111,BAR,P003196,P010106,8.434,-10,17,27
111,BAR,P003196,P011666,2.067,-3,3,6
111,BAR,P003196,P012745,6.934,-9,9,18
111,BAR,P003196,P012795,10.984,-10,22,32
111,BAR,P003478,P009862,13.15,10,34,24
111,BAR,P003478,P010106,9.467,6,25,19
111,BAR,P003478,P012745,17.967,8,42,34
111,BAR,P003478,P012795,2.717,-2,3,5
111,BAR,P007464,P009862,3.467,1,12,11
111,BAR,P007464,P010106,6.267,-2,17,19
111,BAR,P007464,P011666,1.5,0,3,3
111,BAR,P007464,P012745,2.217,-1,4,5
111,BAR,P007464,P012795,5.35,-4,15,19
111,BAR,P009862,P010106,18.034,11,53,42
111,BAR,P009862,P011666,0.567,-3,0,3
111,BAR,P009862,P012745,29.834,5,66,61
111,BAR,P009862,P012795,18.317,-8,40,48
111,BAR,P010106,P011666,1.5,0,3,3
111,BAR,P010106,P012745,20.451,4,50,46
111,BAR,P010106,P012795,15.684,-10,36,46
111,BAR,P011666,P012745,0.567,-3,0,3
111,BAR,P011666,P012795,2.067,-3,3,6
111,BAR,P012745,P012795,19.784,-12,35,47
111,PAN,P001926,P003842,6.016,-5,11,16
111,PAN,P001926,P004088,2.583,-1,5,6
111,PAN,P001926,P005353,2.133,0,6,6
111,PAN,P001926,P007866,15.415,6,39,33
111,PAN,P001926,P009622,4.849,1,13,12
111,PAN,P001926,P011204,12.615,11,34,23
111,PAN,P001926,P011209,3.2,-8,2,10
111,PAN,P001926,P012712,9.849,8,25,17
111,PAN,P001926,P012774,15.332,4,37,33
111,PAN,P003842,P004088,1.3,3,5,2
111,PAN,P003842,P007866,4.983,-5,12,17
111,PAN,P003842,P009622,18.966,-3,37,40
111,PAN,P003842,P011204,22.199,-9,44,53
111,PAN,P003842,P011209,10.551,1,25,24
111,PAN,P003842,P012712,20.883,-3,41,44
111,PAN,P003842,P012774,18.566,-11,37,48
111,PAN,P004088,P005353,0.05,0,0,0
111,PAN,P004088,P007866,2.633,-1,5,6
111,PAN,P004088,P009622,2.583,-1,5,6
111,PAN,P004088,P011204,2.633,-1,5,6
111,PAN,P004088,P011209,1.35,3,5,2
111,PAN,P004088,P012712,1.3,3,5,2
111,PAN,P004088,P012774,1.3,3,5,2
111,PAN,P005353,P007866,1.883,2,6,4
111,PAN,P005353,P009622,1.233,-1,3,4
111,PAN,P005353,P011204,0.65,3,3,0
111,PAN,P005353,P011209,0.35,-2,0,2
111,PAN,P005353,P012712,0.3,-2,0,2
111,PAN,P005353,P012774,2.133,0,6,6
111,PAN,P007866,P009622,6.899,-3,14,17
111,PAN,P007866,P011204,15.832,11,44,33
111,PAN,P007866,P011209,2.15,-2,7,9
111,PAN,P007866,P012712,9.366,10,26,16
111,PAN,P007866,P012774,16.099,6,43,37
111,PAN,P009622,P011204,22.699,-6,43,49
111,PAN,P009622,P011209,7.217,2,15,13
111,PAN,P009622,P012712,20.083,-2,41,43
111,PAN,P009622,P012774,14.999,-7,29,36
111,PAN,P011204,P011209,7.884,2,20,18
111,PAN,P011204,P012712,25.366,6,56,50
111,PAN,P011204,P012774,23.382,3,55,52
111,PAN,P011209,P012712,11.717,-3,22,25
111,PAN,P011209,P012774,5.117,-5,12,17
111,PAN,P012712,P012774,23.332,3,52,49
112,BAS,P007230,P008072,9.866,0,21,21
112,BAS,P007230,P008850,5.75,4,17,13
112,BAS,P007230,P011085,11.749,2,30,28
112,BAS,P007230,P011196,16.016,7,36,29
112,BAS,P007230,P011948,13.833,2,27,25
112,BAS,P007230,P012201,14.133,5,27,22
112,BAS,P007230,P012597,14.182,0,30,30
112,BAS,P007230,P013367,17.999,8,40,32
112,BAS,P008072,P008850,7.117,1,19,18
112,BAS,P008072,P011085,13.883,3,29,26
112,BAS,P008072,P011948,2.183,0,3,3
112,BAS,P008072,P012201,4.017,3,8,5
112,BAS,P008072,P012597,12.933,3,29,26
112,BAS,P008072,P013367,5.533,2,7,5
112,BAS,P008850,P011085,7.117,1,19,18
112,BAS,P008850,P011196,3.45,5,7,2
112,BAS,P008850,P012201,4.817,2,9,7
112,BAS,P008850,P012597,10.567,6,26,20
112,BAS,P008850,P013367,3.45,5,7,2
112,BAS,P011085,P011196,8.533,-1,25,26
112,BAS,P011085,P011948,5.766,-3,13,16
112,BAS,P011085,P012201,10.667,0,24,24
112,BAS,P011085,P012597,21.466,2,54,52
112,BAS,P011085,P013367,10.483,4,22,18
112,BAS,P011196,P011948,16.733,2,37,35
112,BAS,P011196,P012201,24.233,7,50,43
112,BAS,P011196,P012597,14.416,2,32,30
112,BAS,P011196,P013367,21.083,14,49,35
112,BAS,P011948,P012201,18.233,5,40,35
112,BAS,P011948,P012597,6.266,-5,13,18
112,BAS,P011948,P013367,12.65,7,27,20
112,BAS,P012201,P012597,15.6,3,31,28
112,BAS,P012201,P013367,21.3,15,43,28
112,BAS,P012597,P013367,13.966,9,29,20
112,ULK,P002849,P002968,3.2,1,5,4
112,ULK,P002849,P004004,8.2,-1,18,19
112,ULK,P002849,P006961,8.467,0,18,18
112,ULK,P002849,P007182,5.3,1,18,17
112,ULK,P002849,P008104,11.867,0,31,31
112,ULK,P002849,P008174,1.0,0,2,2
112,ULK,P002849,P008962,10.067,-3,26,29
112,ULK,P002849,P009863,2.05,-4,0,4
112,ULK,P002849,P013396,2.917,-2,6,8
112,ULK,P002968,P004004,13.683,-7,19,26
112,ULK,P002968,P006961,10.0,-5,12,17
112,ULK,P002968,P008104,8.117,-5,12,17
112,ULK,P002968,P008174,0.667,0,2,2
112,ULK,P002968,P008962,14.8,-11,21,32
112,ULK,P002968,P009783,8.0,-5,14,19
112,ULK,P002968,P009863,11.65,-3,19,22
112,ULK,P002968,P013396,1.883,-5,0,5
112,ULK,P004004,P006961,9.866,1,10,9
112,ULK,P004004,P007182,13.0,-2,24,26
112,ULK,P004004,P008104,10.733,3,23,20
112,ULK,P004004,P008962,25.1,-12,38,50
112,ULK,P004004,P009783,14.4,-12,20,32
112,ULK,P004004,P009863,17.35,-14,20,34
112,ULK,P006961,P007182,6.366,11,23,12
112,ULK,P006961,P008104,17.85,4,43,39
112,ULK,P006961,P008174,4.75,3,17,14
112,ULK,P006961,P008962,14.517,-2,25,27
112,ULK,P006961,P009783,3.416,3,13,10
112,ULK,P006961,P009863,5.05,0,5,5
112,ULK,P006961,P013396,4.25,-7,6,13
112,ULK,P007182,P008104,11.166,9,36,27
112,ULK,P007182,P008174,3.083,3,13,10
112,ULK,P007182,P008962,13.817,-1,29,30
112,ULK,P007182,P009783,9.483,-4,19,23
112,ULK,P007182,P009863,6.717,-9,6,15
112,ULK,P008104,P008174,4.75,3,17,14
112,ULK,P008104,P008962,16.034,-2,38,40
112,ULK,P008104,P009783,3.416,3,13,10
112,ULK,P008104,P009863,2.417,0,5,5
112,ULK,P008104,P013396,4.25,-7,6,13
112,ULK,P008174,P008962,1.667,0,4,4
112,ULK,P008174,P009783,3.083,3,13,10
112,ULK,P008962,P009783,14.067,-12,20,32
112,ULK,P008962,P009863,19.767,-14,25,39
112,ULK,P008962,P013396,3.7,-7,6,13
112,ULK,P009783,P009863,14.067,-12,20,32
113,PAR,P004761,P006591,8.533,-14,11,25
113,PAR,P004761,P006760,7.25,-12,11,23
113,PAR,P004761,P011050,1.083,-2,0,2
113,PAR,P004761,P011836,11.45,-2,22,24
113,PAR,P004761,P011981,14.783,-4,30,34
113,PAR,P004761,P012720,9.633,4,21,17
113,PAR,P004761,P013369,14.049,0,29,29
113,PAR,P004761,P013370,1.283,-2,0,2
113,PAR,P006591,P006760,17.383,-4,37,41
113,PAR,P006591,P007870,2.9,1,6,5
113,PAR,P006591,P011050,2.95,-3,4,7
113,PAR,P006591,P011836,4.484,-11,4,15
113,PAR,P006591,P011981,18.85,-4,44,48
113,PAR,P006591,P012720,14.6,4,35,31
113,PAR,P006591,P013369,15.232,1,38,37
113,PAR,P006591,P013370,11.0,2,25,23
113,PAR,P006760,P007870,2.35,9,9,0
113,PAR,P006760,P011050,1.867,-1,4,5
113,PAR,P006760,P011836,2.167,-6,2,8
113,PAR,P006760,P011981,17.083,-4,37,41
113,PAR,P006760,P012720,12.483,12,31,19
113,PAR,P006760,P013369,12.632,9,34,25
113,PAR,P006760,P013370,9.117,9,23,14
113,PAR,P007870,P011836,1.517,-3,2,5
113,PAR,P007870,P011981,4.333,0,3,3
113,PAR,P007870,P012720,8.2,6,14,8
113,PAR,P007870,P013369,8.2,6,14,8
113,PAR,P007870,P013370,5.3,5,8,3
113,PAR,P011050,P011836,0.8,-2,0,2
113,PAR,P011050,P011981,1.867,-1,4,5
113,PAR,P011050,P013369,0.283,0,0,0
113,PAR,P011050,P013370,2.95,-3,4,7
113,PAR,P011836,P011981,10.65,0,22,22
113,PAR,P011836,P012720,10.0,3,22,19
113,PAR,P011836,P013369,10.0,3,22,19
113,PAR,P011836,P013370,0.8,-2,0,2
113,PAR,P011981,P012720,25.599,13,56,43
113,PAR,P011981,P013369,25.948,10,59,49
113,PAR,P011981,P013370,16.483,6,33,27
113,PAR,P012720,P013369,26.699,16,61,45
113,PAR,P012720,P013370,15.25,10,32,22
113,PAR,P013369,P013370,11.949,11,27,16
113,ZAL,P002329,P002676,2.984,-1,3,4
113,ZAL,P002329,P003048,15.167,-5,31,36
113,ZAL,P002329,P005504,7.283,8,22,14
113,ZAL,P002329,P007029,8.734,-6,17,23
113,ZAL,P002329,P007513,21.099,1,48,47
113,ZAL,P002329,P007975,14.501,-10,24,34
113,ZAL,P002329,P011051,7.184,-7,10,17
113,ZAL,P002329,P012622,6.001,-11,5,16
113,ZAL,P002329,P012715,15.45,3,37,34
113,ZAL,P002329,P013403,20.933,12,55,43
113,ZAL,P002676,P003048,2.267,-2,0,2
113,ZAL,P002676,P007029,2.267,0,3,3
113,ZAL,P002676,P007513,0.2,0,0,0
113,ZAL,P002676,P007975,7.718,0,8,8
113,ZAL,P002676,P011051,5.451,2,8,6
113,ZAL,P002676,P012622,3.084,2,5,3
113,ZAL,P002676,P012715,2.567,-2,0,2
113,ZAL,P002676,P013403,5.134,1,5,4
113,ZAL,P003048,P007029,4.3,-5,9,14
113,ZAL,P003048,P007513,10.233,-5,21,26
113,ZAL,P003048,P007975,11.834,-4,21,25
113,ZAL,P003048,P012622,2.0,-7,0,7
113,ZAL,P003048,P012715,10.151,-3,17,20
113,ZAL,P003048,P013403,15.984,-1,33,34
113,ZAL,P005504,P007513,7.283,8,22,14
113,ZAL,P005504,P012715,7.283,8,22,14
113,ZAL,P005504,P013403,7.283,8,22,14
113,ZAL,P007029,P007513,6.0,-3,14,17
113,ZAL,P007029,P007975,2.734,-3,3,6
113,ZAL,P007029,P011051,4.434,-1,8,9
113,ZAL,P007029,P012622,3.0,-4,5,9
113,ZAL,P007029,P013403,3.467,-2,9,11
113,ZAL,P007513,P007975,6.316,-6,11,17
113,ZAL,P007513,P011051,5.566,-4,10,14
113,ZAL,P007513,P012622,5.483,-4,8,12
113,ZAL,P007513,P012715,12.149,2,30,28
113,ZAL,P007513,P013403,18.799,7,48,41
113,ZAL,P007975,P011051,11.201,-7,15,22
113,ZAL,P007975,P012622,8.685,-8,10,18
113,ZAL,P007975,P012715,12.484,-10,19,29
113,ZAL,P007975,P013403,16.667,4,33,29
113,ZAL,P011051,P012622,10.851,-3,18,21
113,ZAL,P011051,P012715,5.816,-7,8,15
113,ZAL,P011051,P013403,7.633,3,15,12
113,ZAL,P012622,P012715,5.85,-6,8,14
113,ZAL,P012622,P013403,7.25,1,13,12
113,ZAL,P012715,P013403,21.25,7,47,40
115,MCO,P005844,P005985,7.816,-9,10,19
115,MCO,P005844,P008099,11.282,3,22,19
115,MCO,P005844,P009754,13.365,2,29,27
115,MCO,P005844,P011212,13.282,0,26,26
115,MCO,P005844,P011226,8.666,-6,15,21
115,MCO,P005844,P011231,4.516,-6,4,10
115,MCO,P005844,P013365,4.133,4,10,6
115,MCO,P005985,P008099,9.734,-5,23,28
115,MCO,P005985,P009754,14.933,-5,28,33
115,MCO,P005985,P011212,11.75,-10,19,29
115,MCO,P005985,P011226,26.8,-10,53,63
115,MCO,P005985,P011231,16.333,-6,31,37
115,MCO,P005985,P013365,6.601,3,20,17
115,MCO,P005985,PLCZ,20.901,-2,48,50
115,MCO,P008099,P009754,11.299,3,25,22
115,MCO,P008099,P011212,12.932,0,22,22
115,MCO,P008099,P011226,10.683,-6,23,29
115,MCO,P008099,P011231,6.0,0,13,13
115,MCO,P008099,P013365,12.4,-1,29,30
115,MCO,P008099,PLCZ,9.734,-6,23,29
115,MCO,P009754,P011212,13.649,2,31,29
115,MCO,P009754,P011226,15.783,-2,33,35
115,MCO,P009754,P011231,10.182,-3,16,19
115,MCO,P009754,P013365,7.3,8,17,9
115,MCO,P009754,PLCZ,11.017,-1,21,22
115,MCO,P011212,P011226,14.449,-10,24,34
115,MCO,P011212,P011231,8.683,-4,14,18
115,MCO,P011212,P013365,7.633,-2,13,15
115,MCO,P011212,PLCZ,9.75,-8,15,23
115,MCO,P011226,P011231,14.583,-7,26,33
115,MCO,P011226,P013365,6.7,-1,15,16
115,MCO,P011226,PLCZ,21.0,-6,43,49
115,MCO,P011231,P013365,1.567,2,5,3
115,MCO,P011231,PLCZ,14.6,0,31,31
115,MCO,P013365,PLCZ,9.934,-1,23,24
115,OLY,P001255,P003941,4.133,-4,6,10
115,OLY,P001255,P007853,7.366,-4,14,18
115,OLY,P001255,P007982,7.366,-4,14,18
115,OLY,P001255,P008811,3.233,0,8,8
115,OLY,P001255,P008829,7.366,-4,14,18
115,OLY,P003469,P003941,16.433,12,41,29
115,OLY,P003469,P007853,11.75,9,36,27
115,OLY,P003469,P007947,15.333,6,33,27
115,OLY,P003469,P007982,10.266,4,25,21
115,OLY,P003469,P008811,11.333,3,28,25
115,OLY,P003469,P008829,5.834,3,22,19
115,OLY,P003469,P008855,22.666,19,55,36
115,OLY,P003469,P013380,17.449,4,36,32
115,OLY,P003941,P007853,14.116,1,29,28
115,OLY,P003941,P007947,8.75,4,19,15
115,OLY,P003941,P007982,14.116,1,29,28
115,OLY,P003941,P008829,9.633,-7,18,25
115,OLY,P003941,P008855,13.233,12,30,18
115,OLY,P003941,P013380,11.05,1,20,19
115,OLY,P007853,P007982,21.816,-2,45,47
115,OLY,P007853,P008811,9.867,2,27,25
115,OLY,P007853,P008829,18.067,-3,42,45
115,OLY,P007853,P008855,6.65,13,22,9
115,OLY,P007853,P013380,6.3,-4,9,13
115,OLY,P007947,P008811,6.583,2,14,12
115,OLY,P007947,P008855,15.333,6,33,27
115,OLY,P007947,P013380,15.333,6,33,27
115,OLY,P007982,P008811,8.383,-3,16,19
115,OLY,P007982,P008829,15.9,-8,31,39
115,OLY,P007982,P008855,5.166,8,11,3
115,OLY,P007982,P013380,6.983,-4,9,13
115,OLY,P008811,P008829,8.434,4,24,20
115,OLY,P008811,P008855,9.433,7,25,18
115,OLY,P008811,P013380,11.266,1,22,21
115,OLY,P008829,P008855,2.167,5,11,6
115,OLY,P008829,P013380,4.867,-2,6,8
115,OLY,P008855,P013380,16.016,6,33,27
116,MIL,P000796,P001392,14.116,7,42,35
116,MIL,P000796,P001518,11.15,18,33,15
116,MIL,P000796,P006085,5.6,-5,16,21
116,MIL,P000796,P007831,21.333,29,61,32
116,MIL,P000796,P008987,21.966,29,63,34
116,MIL,P000796,P011064,24.183,23,70,47
116,MIL,P000796,P011941,5.6,-5,16,21
116,MIL,P000796,P013384,6.316,0,15,15
116,MIL,P001392,P001518,6.117,3,16,13
116,MIL,P001392,P006085,11.567,-9,26,35
116,MIL,P001392,P007831,12.517,14,33,19
116,MIL,P001392,P008987,15.433,8,35,27
116,MIL,P001392,P011064,14.75,8,42,34
116,MIL,P001392,P011941,12.534,-8,29,37
116,MIL,P001392,P013384,9.366,-3,21,24
116,MIL,P001518,P006085,4.517,0,13,13
116,MIL,P001518,P007831,14.2,19,39,20
116,MIL,P001518,P008987,15.65,17,42,25
116,MIL,P001518,P011064,14.2,19,39,20
116,MIL,P001518,P011941,4.517,0,13,13
116,MIL,P001518,P013384,4.517,0,13,13
116,MIL,P006085,P007831,1.617,-5,0,5
116,MIL,P006085,P008987,5.35,-13,3,16
116,MIL,P006085,P011064,2.217,-6,7,13
116,MIL,P006085,P011941,14.017,-16,29,45
116,MIL,P006085,P013384,11.183,-10,22,32
116,MIL,P007831,P008987,26.967,26,70,44
116,MIL,P007831,P011064,25.35,31,70,39
116,MIL,P007831,P011941,2.584,-4,3,7
116,MIL,P007831,P013384,3.3,-6,4,10
116,MIL,P008987,P011064,25.983,31,72,41
116,MIL,P008987,P011941,6.317,-12,6,18
116,MIL,P008987,P013384,7.666,-14,9,23
116,MIL,P011064,P011941,3.184,-5,10,15
116,MIL,P011064,P013384,2.933,-1,6,7
116,MIL,P011941,P013384,11.183,-10,22,32
116,RED,P002553,P004007,2.684,-5,4,9
116,RED,P002553,P004866,11.766,-3,23,26
116,RED,P002553,P006436,7.934,-4,15,19
116,RED,P002553,P007960,10.516,-1,32,33
116,RED,P002553,P009048,1.483,-3,3,6
116,RED,P002553,P010612,12.933,3,36,33
116,RED,P002553,P012044,21.166,10,56,46
116,RED,P002553,P012786,3.25,3,9,6
116,RED,P002553,PJDR,13.166,15,41,26
116,RED,P002553,PLUO,5.966,1,17,16
116,RED,P004007,P004866,10.717,-16,13,29
116,RED,P004007,P006436,5.517,-6,10,16
116,RED,P004007,P007960,0.35,2,2,0
116,RED,P004007,P009048,8.383,-9,11,20
116,RED,P004007,P011194,8.383,-9,11,20
116,RED,P004007,P012044,2.617,-2,4,6
116,RED,P004007,P012786,5.55,-8,5,13
116,RED,P004007,PLUO,0.067,-3,0,3
116,RED,P004866,P006436,9.584,-6,20,26
116,RED,P004866,P007960,4.149,-10,7,17
116,RED,P004866,P009048,13.366,-25,18,43
116,RED,P004866,P010612,9.483,-14,16,30
116,RED,P004866,P011194,11.883,-22,15,37
116,RED,P004866,P012044,13.866,4,30,26
116,RED,P004866,P012786,9.2,-7,15,22
116,RED,P004866,PJDR,9.216,2,18,16
116,RED,P004866,PLUO,5.966,1,17,16
116,RED,P006436,P007960,0.35,2,2,0
116,RED,P006436,P009048,2.833,-1,6,7
116,RED,P006436,P010612,6.467,3,19,16
116,RED,P006436,P011194,2.833,-1,6,7
116,RED,P006436,P012044,10.284,3,25,22
116,RED,P006436,P012786,5.667,7,19,12
116,RED,P006436,PJDR,1.2,2,2,0
116,RED,P006436,PLUO,0.067,-3,0,3
116,RED,P007960,P009048,3.949,-6,7,13
116,RED,P007960,P010612,10.433,-1,29,30
116,RED,P007960,P011194,3.083,-3,4,7
116,RED,P007960,P012044,9.65,2,29,27
116,RED,P007960,PJDR,9.1,4,27,23
116,RED,P007960,PLUO,2.816,-5,5,10
116,RED,P009048,P010612,4.633,-11,6,17
116,RED,P009048,P011194,13.016,-20,17,37
116,RED,P009048,P012786,5.55,-8,5,13
116,RED,P009048,PJDR,3.3,-6,4,10
116,RED,P009048,PLUO,1.483,-3,3,6
116,RED,P010612,P011194,5.25,-11,6,17
116,RED,P010612,P012044,17.2,4,46,42
116,RED,P010612,P012786,6.9,4,19,15
116,RED,P010612,PJDR,14.033,-5,31,36
116,RED,P011194,P012044,0.617,0,0,0
116,RED,P011194,P012786,5.55,-8,5,13
116,RED,P011194,PJDR,3.917,-6,4,10
116,RED,P012044,P012786,6.9,4,19,15
116,RED,P012044,PJDR,15.016,12,41,29
116,RED,P012044,PLUO,4.416,7,14,7
116,RED,P012786,PJDR,1.233,-3,0,3
116,RED,PJDR,PLUO,3.083,9,12,3
117,BER,P006251,P007550,11.2,0,28,28
117,BER,P006251,P008173,4.733,-2,20,22
117,BER,P006251,P008211,12.416,-1,27,28
117,BER,P006251,P008384,10.633,1,27,26
117,BER,P006251,P008780,5.883,0,11,11
117,BER,P006251,P008967,24.116,0,47,47
117,BER,P006251,P011934,0.133,2,2,0
117,BER,P006251,P012604,18.183,-8,39,47
117,BER,P006251,P013386,4.567,4,11,7
117,BER,P007550,P008173,0.5,1,2,1
117,BER,P007550,P008211,8.466,-4,15,19
117,BER,P007550,P008384,4.95,1,17,16
117,BER,P007550,P008967,12.916,-4,30,34
117,BER,P007550,P011934,2.349,-1,6,7
117,BER,P007550,P012604,10.85,-2,26,28
117,BER,P007550,P013386,2.433,-3,4,7
117,BER,P008173,P008211,5.883,-1,14,15
117,BER,P008173,P008384,19.032,7,42,35
117,BER,P008173,P008780,17.716,7,39,32
117,BER,P008173,P008967,6.616,-3,14,17
117,BER,P008173,P011934,20.099,7,35,28
117,BER,P008173,P012604,0.833,-9,10,19
117,BER,P008173,P013386,23.916,13,44,31
117,BER,P008211,P008384,0.083,1,1,0
117,BER,P008211,P008967,14.349,-5,29,34
117,BER,P008211,P011934,1.933,-4,2,6
117,BER,P008211,P012604,10.016,-3,20,23
117,BER,P008211,P013386,4.25,-3,8,11
117,BER,P008384,P008780,24.966,8,44,36
117,BER,P008384,P008967,12.516,0,21,21
117,BER,P008384,P011934,20.232,9,37,28
117,BER,P008384,P012604,8.917,-7,21,28
117,BER,P008384,P013386,21.599,12,38,26
117,BER,P008780,P008967,7.25,1,5,4
117,BER,P008780,P011934,19.083,8,33,25
117,BER,P008780,P012604,4.6,-5,8,13
117,BER,P008780,P013386,20.366,13,36,23
117,BER,P008967,P011934,2.799,-4,4,8
117,BER,P008967,P012604,21.583,-4,38,42
117,BER,P008967,P013386,4.983,-5,8,13
117,BER,P011934,P012604,0.75,-2,2,4
117,BER,P011934,P013386,21.282,5,35,30
117,VIR,P001133,P001844,2.866,-4,4,8
117,VIR,P001133,P004554,5.25,-7,7,14
117,VIR,P001133,P004888,12.65,-13,13,26
117,VIR,P001133,P005738,2.75,-6,0,6
117,VIR,P001133,P006739,11.967,-11,13,24
117,VIR,P001133,P009549,18.05,-6,31,37
117,VIR,P001133,P012585,10.083,1,22,21
117,VIR,P001133,P013374,13.483,3,28,25
117,VIR,P001133,PBCN,8.833,3,22,19
117,VIR,P001844,P002084,12.45,1,23,22
117,VIR,P001844,P004554,6.85,-1,11,12
117,VIR,P001844,P004888,5.551,-3,16,19
117,VIR,P001844,P005738,0.833,-4,0,4
117,VIR,P001844,P006739,-0.6,2,5,3
117,VIR,P001844,P009549,0.384,0,11,11
117,VIR,P001844,P012585,7.965,-1,16,17
117,VIR,P001844,P013374,3.95,5,21,16
117,VIR,P001844,PBCN,6.883,5,21,16
117,VIR,P002084,P004554,9.6,2,22,20
117,VIR,P002084,P004888,11.334,-1,22,23
117,VIR,P002084,P006739,6.25,5,16,11
117,VIR,P002084,P009549,4.767,-5,8,13
117,VIR,P002084,P012585,5.099,3,12,9
117,VIR,P002084,P012591,1.9,5,9,4
117,VIR,P002084,P013374,5.45,2,12,10
117,VIR,P002084,PBCN,3.95,4,12,8
117,VIR,P004554,P004888,16.65,-4,33,37
117,VIR,P004554,P005738,0.4,-3,0,3
117,VIR,P004554,P006739,13.3,-1,27,28
117,VIR,P004554,P009549,10.85,-8,19,27
117,VIR,P004554,P012591,2.3,2,9,7
117,VIR,P004554,PBCN,1.4,4,4,0
117,VIR,P004888,P005738,2.817,-7,0,7
117,VIR,P004888,P006739,25.967,-5,43,48
117,VIR,P004888,P009549,24.184,-9,40,49
117,VIR,P004888,P012585,2.483,-4,0,4
117,VIR,P004888,P012591,2.3,2,9,7
117,VIR,P004888,P013374,13.167,-2,21,23
117,VIR,P004888,PBCN,12.101,6,19,13
117,VIR,P005738,P006739,2.317,-5,0,5
117,VIR,P005738,P009549,1.917,-2,0,2
117,VIR,P005738,P012585,0.833,-4,0,4
117,VIR,P005738,P012591,0.4,-3,0,3
117,VIR,P005738,PBCN,0.333,-2,0,2
117,VIR,P006739,P009549,19.6,-9,29,38
117,VIR,P006739,P012585,0.567,0,0,0
117,VIR,P006739,P012591,2.3,2,9,7
117,VIR,P006739,P013374,10.75,-2,16,18
117,VIR,P006739,PBCN,11.45,4,14,10
117,VIR,P009549,P012585,6.733,5,18,13
117,VIR,P009549,P013374,17.817,6,39,33
117,VIR,P009549,PBCN,18.634,12,37,25
117,VIR,P012585,P013374,14.266,8,34,26
117,VIR,P012585,PBCN,12.699,8,34,26
117,VIR,P013374,PBCN,22.917,12,49,37
118,IST,P004887,P006590,5.75,-2,8,10
118,IST,P004887,P009513,10.45,-11,18,29
118,IST,P004887,P009664,5.35,-5,7,12
118,IST,P004887,P009846,13.517,-10,22,32
118,IST,P004887,P011078,10.834,-7,18,25
118,IST,P004887,P012710,8.167,-5,15,20
118,IST,P006590,P007109,6.967,-3,9,12
118,IST,P006590,P009513,8.983,-3,18,21
118,IST,P006590,P009664,16.501,-3,31,34
118,IST,P006590,P009846,22.184,3,45,42
118,IST,P006590,P010400,3.45,0,4,4
118,IST,P006590,P011078,13.084,6,25,19
118,IST,P006590,P012710,2.25,4,4,0
118,IST,P006590,P012788,16.016,10,32,22
118,IST,P006590,P013363,3.55,2,4,2
118,IST,P006590,P013364,3.333,-2,8,10
118,IST,P007109,P009513,2.167,-3,5,8
118,IST,P007109,P009664,6.984,1,15,14
118,IST,P007109,P009846,8.201,-6,15,21
118,IST,P007109,P010400,4.733,-5,2,7
118,IST,P007109,P011078,7.484,-8,10,18
118,IST,P007109,P012788,9.25,-8,10,18
118,IST,P007109,P013363,5.95,-12,2,14
118,IST,P009513,P009664,11.5,-2,24,26
118,IST,P009513,P009846,17.45,-11,35,46
118,IST,P009513,P011078,7.767,-8,14,22
118,IST,P009513,P012710,5.917,-9,11,20
118,IST,P009513,P012788,4.816,5,12,7
118,IST,P009513,P013363,0.05,0,0,0
118,IST,P009513,P013364,0.9,-2,3,5
118,IST,P009664,P009846,22.351,2,45,43
118,IST,P009664,P010400,0.167,0,2,2
118,IST,P009664,P011078,12.584,5,22,17
118,IST,P009664,P012788,13.3,12,31,19
118,IST,P009664,P013363,0.05,0,0,0
118,IST,P009664,P013364,0.817,-2,3,5
118,IST,P009846,P010400,0.167,0,2,2
118,IST,P009846,P011078,25.368,-5,47,52
118,IST,P009846,P012710,8.167,-5,15,20
118,IST,P009846,P012788,17.95,7,41,34
118,IST,P009846,P013363,1.434,-5,2,7
118,IST,P009846,P013364,4.083,-2,11,13
118,IST,P010400,P011078,1.45,-5,0,5
118,IST,P010400,P012788,4.9,-5,4,9
118,IST,P010400,P013363,4.733,-5,2,7
118,IST,P011078,P012710,8.167,-5,15,20
118,IST,P011078,P012788,14.467,-3,27,30
118,IST,P011078,P013363,2.884,-10,2,12
118,IST,P011078,P013364,3.183,0,8,8
118,IST,P012788,P013363,6.217,-10,4,14
118,IST,P012788,P013364,4.016,0,11,11
118,ZAL,P002329,P002676,11.65,2,24,22
118,ZAL,P002329,P003048,2.016,5,7,2
118,ZAL,P002329,P005504,11.717,10,32,22
118,ZAL,P002329,P007029,11.834,9,33,24
118,ZAL,P002329,P007513,23.167,13,59,46
118,ZAL,P002329,P007975,9.3,5,23,18
118,ZAL,P002329,P011051,11.734,-2,24,26
118,ZAL,P002329,P011983,2.533,3,7,4
118,ZAL,P002329,P012622,2.733,2,9,7
118,ZAL,P002329,P012715,0.75,0,3,3
118,ZAL,P002329,P013403,17.434,5,43,38
118,ZAL,P002676,P003048,8.567,2,12,10
118,ZAL,P002676,P005504,7.383,-2,9,11
118,ZAL,P002676,P007029,1.667,1,3,2
118,ZAL,P002676,P007513,20.117,3,34,31
118,ZAL,P002676,P007975,17.867,3,33,30
118,ZAL,P002676,P011051,9.234,2,20,18
118,ZAL,P002676,P011983,1.0,-2,0,2
118,ZAL,P002676,P012622,7.484,-4,9,13
118,ZAL,P002676,P012715,4.717,7,9,2
118,ZAL,P002676,P013403,11.718,4,19,15
118,ZAL,P003048,P007513,4.317,1,5,4
118,ZAL,P003048,P007975,10.1,7,19,12
118,ZAL,P003048,P011983,1.716,5,7,2
118,ZAL,P003048,P012622,7.267,4,14,10
118,ZAL,P003048,P012715,2.35,3,5,2
118,ZAL,P003048,P013403,4.067,1,7,6
118,ZAL,P005504,P007029,11.067,9,29,20
118,ZAL,P005504,P007513,16.95,8,37,29
118,ZAL,P005504,P007975,4.566,-4,7,11
118,ZAL,P005504,P012622,1.533,-3,2,5
118,ZAL,P005504,P012715,2.2,2,2,0
118,ZAL,P005504,P013403,12.384,12,30,18
118,ZAL,P007029,P007513,13.334,8,34,26
118,ZAL,P007029,P007975,1.1,1,3,2
118,ZAL,P007029,P011051,1.517,-1,2,3
118,ZAL,P007029,P012715,0.917,2,5,3
118,ZAL,P007029,P013403,12.568,11,35,24
118,ZAL,P007513,P007975,12.766,0,24,24
118,ZAL,P007513,P011051,10.7,1,24,23
118,ZAL,P007513,P012622,4.183,-7,4,11
118,ZAL,P007513,P012715,5.3,5,10,5
118,ZAL,P007513,P013403,20.034,8,45,37
118,ZAL,P007975,P011051,5.217,-2,12,14
118,ZAL,P007975,P011983,2.533,3,7,4
118,ZAL,P007975,P012622,9.4,-4,16,20
118,ZAL,P007975,P012715,2.517,5,7,2
118,ZAL,P007975,P013403,4.834,-2,9,11
118,ZAL,P011051,P011983,0.817,-2,0,2
118,ZAL,P011051,P012622,1.5,-5,2,7
118,ZAL,P011051,P013403,7.417,-7,12,19
118,ZAL,P011983,P012622,1.533,5,7,2
118,ZAL,P012622,P013403,5.567,-4,9,13
118,ZAL,P012715,P013403,3.117,4,7,3
119,BAS,P007230,P008072,4.617,5,12,7
119,BAS,P007230,P008850,4.301,1,10,9
119,BAS,P007230,P011085,7.551,-3,15,18
119,BAS,P007230,P011196,24.435,-19,46,65
119,BAS,P007230,P011948,26.401,-17,50,67
119,BAS,P007230,P012201,19.634,-17,36,53
119,BAS,P007230,P012597,10.435,2,24,22
119,BAS,P007230,P013367,18.834,-8,39,47
119,BAS,P008072,P008850,5.267,-1,8,9
119,BAS,P008072,P011085,10.984,3,25,22
119,BAS,P008072,P011948,5.717,4,17,13
119,BAS,P008072,P012201,6.367,-2,13,15
119,BAS,P008072,P012597,10.984,3,25,22
119,BAS,P008850,P011085,5.934,-4,8,12
119,BAS,P008850,P011196,5.418,0,12,12
119,BAS,P008850,P011948,2.317,0,4,4
119,BAS,P008850,P012201,6.484,-2,10,12
119,BAS,P008850,P012597,8.268,-1,16,17
119,BAS,P008850,P013367,4.751,3,12,9
119,BAS,P011085,P011196,6.751,-8,10,18
119,BAS,P011085,P011948,11.801,-1,27,28
119,BAS,P011085,P012201,12.301,-7,23,30
119,BAS,P011085,P012597,13.901,-1,30,31
119,BAS,P011085,P013367,1.717,1,2,1
119,BAS,P011196,P011948,25.251,-19,45,64
119,BAS,P011196,P012201,24.218,-15,45,60
119,BAS,P011196,P012597,8.685,-2,19,21
119,BAS,P011196,P013367,21.318,-5,43,48
119,BAS,P011948,P012201,23.434,-17,46,63
119,BAS,P011948,P012597,10.734,0,26,26
119,BAS,P011948,P013367,18.217,-10,33,43
119,BAS,P012201,P012597,12.568,-2,26,28
119,BAS,P012201,P013367,17.334,-6,33,39
119,BAS,P012597,P013367,3.101,5,10,5
119,MUN,P001557,P004508,6.483,2,16,14
119,MUN,P001557,P007056,7.483,-1,16,17
119,MUN,P001557,P007201,5.05,6,16,10
119,MUN,P001557,P010391,7.483,-1,16,17
119,MUN,P001557,P011224,4.7,9,15,6
119,MUN,P001557,P011244,7.133,2,15,13
119,MUN,P001557,P011987,5.7,6,15,9
119,MUN,P001557,P013368,4.7,9,15,6
119,MUN,P004508,P005460,0.833,-1,0,1
119,MUN,P004508,P007056,25.533,19,69,50
119,MUN,P004508,P007201,18.917,11,49,38
119,MUN,P004508,P010391,26.366,18,69,51
119,MUN,P004508,P011224,7.367,10,21,11
119,MUN,P004508,P011244,9.549,3,20,17
119,MUN,P004508,P011987,14.616,2,32,30
119,MUN,P005460,P007929,3.067,-5,2,7
119,MUN,P005460,P010391,3.683,-4,2,6
119,MUN,P005460,P011224,0.217,-2,0,2
119,MUN,P005460,P011244,3.9,-6,2,8
119,MUN,P005460,P011987,3.9,-6,2,8
119,MUN,P007056,P007201,17.867,13,49,36
119,MUN,P007056,P010391,28.45,14,72,58
119,MUN,P007056,P011224,8.234,10,24,14
119,MUN,P007056,P011244,8.666,3,20,17
119,MUN,P007056,P011987,15.65,0,35,35
119,MUN,P007056,P013368,1.917,-2,3,5
119,MUN,P007201,P007929,1.9,-1,5,6
119,MUN,P007201,P010391,17.867,13,49,36
119,MUN,P007201,P011224,9.167,9,26,17
119,MUN,P007201,P011244,2.95,-3,5,8
119,MUN,P007201,P011987,9.55,-8,17,25
119,MUN,P007929,P010391,2.85,-3,2,5
119,MUN,P007929,P011224,2.117,-3,5,8
119,MUN,P007929,P011244,4.967,-6,7,13
119,MUN,P007929,P011987,4.967,-6,7,13
119,MUN,P010391,P011224,8.234,10,24,14
119,MUN,P010391,P011244,12.349,-1,22,23
119,MUN,P010391,P011987,19.333,-4,37,41
119,MUN,P010391,P013368,1.917,-2,3,5
119,MUN,P011224,P011244,7.967,4,20,16
119,MUN,P011224,P011987,9.784,2,23,21
119,MUN,P011224,P013368,6.617,7,18,11
119,MUN,P011244,P011987,18.683,7,42,35
119,MUN,P011244,P013368,4.7,9,15,6
119,MUN,P011987,P013368,6.617,7,18,11
120,PAN,P001926,P003842,22.366,-6,44,50
120,PAN,P001926,P004088,1.35,-1,3,4
120,PAN,P001926,P005161,4.15,1,9,8
120,PAN,P001926,P007866,0.95,1,3,2
120,PAN,P001926,P009622,7.833,-1,17,18
120,PAN,P001926,P011204,15.483,-4,30,34
120,PAN,P001926,P012712,19.166,-6,38,44
120,PAN,P001926,P012774,21.966,-4,44,48
120,PAN,P003842,P004088,6.05,-4,8,12
120,PAN,P003842,P005161,4.15,1,9,8
120,PAN,P003842,P007866,2.917,-3,5,8
120,PAN,P003842,P009622,18.633,-5,32,37
120,PAN,P003842,P011204,23.9,-9,42,51
120,PAN,P003842,P011209,2.066,2,2,0
120,PAN,P003842,P012712,25.266,-8,45,53
120,PAN,P003842,P012774,27.316,-8,49,57
120,PAN,P004088,P005161,1.033,-5,0,5
120,PAN,P004088,P007866,4.8,-4,8,12
120,PAN,P004088,P009622,6.983,-6,8,14
120,PAN,P004088,P011204,6.2,-6,11,17
120,PAN,P004088,P011209,1.533,-3,0,3
120,PAN,P004088,P012712,3.35,-3,6,9
120,PAN,P004088,P012774,0.833,0,0,0
120,PAN,P005161,P007866,5.783,-6,11,17
120,PAN,P005161,P009622,8.383,3,20,17
120,PAN,P005161,P011204,4.133,-18,0,18
120,PAN,P005161,P011209,4.95,-7,11,18
120,PAN,P005161,P012712,0.1,-3,0,3
120,PAN,P005161,P012774,7.45,2,20,18
120,PAN,P007866,P009622,8.7,-9,16,25
120,PAN,P007866,P011204,5.75,-9,8,17
120,PAN,P007866,P011209,5.45,-4,11,15
120,PAN,P007866,P012712,0.95,1,3,2
120,PAN,P007866,P012774,3.3,1,11,10
120,PAN,P009622,P011204,11.85,-11,15,26
120,PAN,P009622,P011209,6.916,-2,13,15
120,PAN,P009622,P012712,12.283,-11,18,29
120,PAN,P009622,P012774,16.083,-2,33,35
120,PAN,P011204,P011209,2.283,-6,2,8
120,PAN,P011204,P012712,21.083,0,40,40
120,PAN,P011204,P012774,19.05,-9,32,41
120,PAN,P011209,P012712,0.733,-1,2,3
120,PAN,P011209,P012774,4.133,1,11,10
120,PAN,P012712,P012774,22.333,-9,40,49
120,PAR,P004761,P006591,5.617,-12,0,12
120,PAR,P004761,P006760,19.5,12,44,32
120,PAR,P004761,P007870,8.884,-15,12,27
120,PAR,P004761,P011050,5.717,2,11,9
120,PAR,P004761,P011836,5.717,2,11,9
120,PAR,P004761,P011981,16.084,13,36,23
120,PAR,P004761,P012720,24.801,8,54,46
120,PAR,P004761,P013369,15.517,3,33,30
120,PAR,P004761,P013370,9.967,15,27,12
120,PAR,P006591,P006760,10.933,3,22,19
120,PAR,P006591,P007870,12.4,-3,22,25
120,PAR,P006591,P011981,10.517,-5,20,25
120,PAR,P006591,P012720,3.6,-6,2,8
120,PAR,P006591,P013369,10.933,3,22,19
120,PAR,P006760,P007870,14.033,-1,32,33
120,PAR,P006760,P011981,24.367,29,66,37
120,PAR,P006760,P012720,21.55,19,55,36
120,PAR,P006760,P013369,21.683,11,54,43
120,PAR,P006760,P013370,14.134,19,39,20
120,PAR,P007870,P011981,9.584,-2,22,24
120,PAR,P007870,P012720,7.967,-11,14,25
120,PAR,P007870,P013369,14.2,0,34,34
120,PAR,P011050,P011836,5.717,2,11,9
120,PAR,P011050,P012720,5.717,2,11,9
120,PAR,P011050,P013369,5.717,2,11,9
120,PAR,P011836,P012720,5.717,2,11,9
120,PAR,P011836,P013369,5.717,2,11,9
120,PAR,P011981,P012720,19.051,16,45,29
120,PAR,P011981,P013369,14.667,18,44,26
120,PAR,P011981,P013370,14.134,19,39,20
120,PAR,P012720,P013369,17.567,10,44,34
120,PAR,P012720,P013370,14.034,16,36,20
120,PAR,P013369,P013370,4.267,7,15,8
121,MAD,P003108,P003583,5.701,-10,4,14
121,MAD,P003108,P005791,22.9,5,41,36
121,MAD,P003108,P005928,21.751,1,35,34
121,MAD,P003108,P006540,12.95,5,23,18
121,MAD,P003108,P007630,11.551,-10,15,25
121,MAD,P003108,P009005,15.717,3,28,25
121,MAD,P003108,P009213,1.567,3,3,0
121,MAD,P003108,P011247,4.55,-5,6,11
121,MAD,P003108,P013378,5.316,-6,6,12
121,MAD,P003108,PTGB,12.401,-6,19,25
121,MAD,P003583,P005928,0.917,-3,0,3
121,MAD,P003583,P007630,5.701,-10,4,14
121,MAD,P003583,P009213,4.883,-8,6,14
121,MAD,P003583,P011247,8.75,-12,10,22
121,MAD,P003583,P011649,4.883,-8,6,14
121,MAD,P003583,P013378,0.917,-3,0,3
121,MAD,P003583,PTGB,10.584,-18,10,28
121,MAD,P005791,P005928,26.784,8,51,43
121,MAD,P005791,P006540,18.9,9,39,30
121,MAD,P005791,P007630,5.85,0,11,11
121,MAD,P005791,P009005,21.667,7,44,37
121,MAD,P005791,P009213,7.517,7,19,12
121,MAD,P005791,P011247,0.683,-1,2,3
121,MAD,P005791,P013378,4.399,-3,6,9
121,MAD,P005791,PTGB,6.7,4,15,11
121,MAD,P005928,P006540,19.467,6,42,36
121,MAD,P005928,P007630,5.951,-8,10,18
121,MAD,P005928,P009005,21.551,5,45,40
121,MAD,P005928,P009213,8.084,4,22,18
121,MAD,P005928,P013378,3.016,-5,2,7
121,MAD,P005928,PTGB,5.551,0,9,9
121,MAD,P006540,P007630,2.384,-1,7,8
121,MAD,P006540,P009005,16.317,2,36,34
121,MAD,P006540,P009213,6.517,1,19,18
121,MAD,P006540,P013378,1.333,2,2,0
121,MAD,P007630,P009005,0.567,-3,3,6
121,MAD,P007630,P009213,0.567,-3,3,6
121,MAD,P007630,P011247,3.867,-4,4,8
121,MAD,P007630,P013378,3.983,-8,4,12
121,MAD,P007630,PTGB,8.051,-5,11,16
121,MAD,P009005,P009213,8.084,4,22,18
121,MAD,P009005,P011247,0.683,-1,2,3
121,MAD,P009005,PTGB,4.35,-1,8,9
121,MAD,P009213,P011247,4.883,-8,6,14
121,MAD,P009213,P011649,4.883,-8,6,14
121,MAD,P009213,PTGB,4.883,-8,6,14
121,MAD,P011247,P011649,4.883,-8,6,14
121,MAD,P011247,PTGB,9.433,-13,12,25
121,MAD,P011649,PTGB,4.883,-8,6,14
121,MAD,P013378,PTGB,2.3,-1,4,5
121,ULK,P002849,P002968,1.05,-2,0,2
121,ULK,P002849,P004004,3.817,3,7,4
121,ULK,P002849,P006961,8.383,12,20,8
121,ULK,P002849,P007182,15.4,17,34,17
121,ULK,P002849,P008104,8.5,2,13,11
121,ULK,P002849,P008962,14.0,7,26,19
121,ULK,P002849,P009783,2.45,8,8,0
121,ULK,P002849,P009863,12.2,13,28,15
121,ULK,P002968,P004004,13.6,5,28,23
121,ULK,P002968,P008104,6.183,7,17,10
121,ULK,P002968,P008962,14.65,3,28,25
121,ULK,P002968,P009783,12.25,7,24,17
121,ULK,P002968,P009863,10.867,-8,15,23
121,ULK,P004004,P006961,0.566,3,6,3
121,ULK,P004004,P007182,5.15,3,14,11
121,ULK,P004004,P008104,10.8,5,22,17
121,ULK,P004004,P008962,21.75,6,45,39
121,ULK,P004004,P009783,16.583,5,34,29
121,ULK,P004004,P009863,11.917,-3,22,25
121,ULK,P004004,PLMG,2.817,-3,2,5
121,ULK,P006961,P007182,13.416,10,33,23
121,ULK,P006961,P008104,4.2,4,11,7
121,ULK,P006961,P008962,12.116,1,28,27
121,ULK,P006961,P009783,8.633,5,24,19
121,ULK,P006961,P009863,9.983,3,20,17
121,ULK,P006961,PLMG,0.967,-2,2,4
121,ULK,P007182,P008104,8.917,5,17,12
121,ULK,P007182,P008962,18.933,5,41,36
121,ULK,P007182,P009783,8.433,4,23,19
121,ULK,P007182,P009863,15.283,8,34,26
121,ULK,P008104,P008962,17.484,4,35,31
121,ULK,P008104,P009783,10.8,12,26,14
121,ULK,P008104,P009863,5.6,-2,11,13
121,ULK,P008104,PLMG,3.784,-5,4,9
121,ULK,P008962,P009783,22.2,-1,44,45
121,ULK,P008962,P009863,25.283,-4,45,49
121,ULK,P008962,PLMG,3.784,-5,4,9
121,ULK,P009783,P009863,13.467,-7,21,28
121,ULK,P009783,PLMG,3.784,-5,4,9
122,BAR,P000925,P002939,13.516,-1,32,33
122,BAR,P000925,P003478,7.333,-3,18,21
122,BAR,P000925,P009862,17.65,-5,38,43
122,BAR,P000925,P010106,9.034,-6,17,23
122,BAR,P000925,P012745,22.55,-7,49,56
122,BAR,P000925,P012795,20.117,-6,42,48
122,BAR,P002939,P003196,9.6,11,28,17
122,BAR,P002939,P003478,11.849,11,35,24
122,BAR,P002939,P006568,2.917,0,5,5
122,BAR,P002939,P007464,1.233,-3,1,4
122,BAR,P002939,P009862,20.4,10,54,44
122,BAR,P002939,P012745,26.033,10,65,55
122,BAR,P002939,P012795,18.584,2,40,38
122,BAR,P003196,P003478,13.616,11,32,21
122,BAR,P003196,P007464,6.099,-5,7,12
122,BAR,P003196,P009862,10.15,8,27,19
122,BAR,P003196,P010106,4.933,-2,6,8
122,BAR,P003196,P012745,9.667,11,28,17
122,BAR,P003196,P012795,4.067,2,8,6
122,BAR,P003478,P007464,5.849,-3,7,10
122,BAR,P003478,P009862,11.916,7,32,25
122,BAR,P003478,P010106,9.1,-3,15,18
122,BAR,P003478,P012745,16.083,10,44,34
122,BAR,P003478,P012795,8.05,2,17,15
122,BAR,P006568,P009862,2.917,0,5,5
122,BAR,P006568,P012745,2.917,0,5,5
122,BAR,P006568,P012795,2.917,0,5,5
122,BAR,P007464,P009862,4.033,-2,6,8
122,BAR,P007464,P010106,4.866,-2,6,8
122,BAR,P007464,P012745,1.233,-3,1,4
122,BAR,P007464,P012795,1.083,-2,0,2
122,BAR,P009862,P010106,10.317,-7,16,23
122,BAR,P009862,P012745,26.684,5,64,59
122,BAR,P009862,P012795,18.801,-4,38,42
122,BAR,P010106,P012745,9.101,-6,17,23
122,BAR,P010106,P012795,8.517,-6,15,21
122,BAR,P012745,P012795,26.268,-4,55,59
122,TEL,P005145,P007519,7.8,-4,12,16
122,TEL,P005145,P007990,5.65,-5,9,14
122,TEL,P005145,P011202,7.083,-4,12,16
122,TEL,P005145,P011214,1.7,1,3,2
122,TEL,P005145,P013250,2.033,1,3,2
122,TEL,P005145,P013381,0.117,0,0,0
122,TEL,P005145,P013382,0.717,0,0,0
122,TEL,P005145,P013383,6.1,-5,9,14
122,TEL,P006835,P007519,11.116,-12,21,33
122,TEL,P006835,P007990,6.766,3,19,16
122,TEL,P006835,P011193,26.516,7,64,57
122,TEL,P006835,P011202,5.833,0,10,10
122,TEL,P006835,P011214,20.966,9,51,42
122,TEL,P006835,P011219,8.766,-13,15,28
122,TEL,P006835,P013250,6.917,2,15,13
122,TEL,P006835,P013381,11.216,2,25,23
122,TEL,P006835,P013382,28.2,7,70,63
122,TEL,P006835,P013383,2.5,3,6,3
122,TEL,P007519,P007990,8.349,-13,11,24
122,TEL,P007519,P011193,5.45,-7,11,18
122,TEL,P007519,P011202,11.499,-5,20,25
122,TEL,P007519,P011214,3.55,-3,5,8
122,TEL,P007519,P011219,6.766,-11,13,24
122,TEL,P007519,P013250,3.55,-1,5,6
122,TEL,P007519,P013381,1.15,1,2,1
122,TEL,P007519,P013382,7.834,-7,17,24
122,TEL,P007519,P013383,8.6,-2,15,17
122,TEL,P007990,P011193,4.067,11,17,6
122,TEL,P007990,P011202,6.499,-11,9,20
122,TEL,P007990,P011214,6.9,10,22,12
122,TEL,P007990,P011219,0.833,-4,0,4
122,TEL,P007990,P013382,5.917,9,19,10
122,TEL,P007990,P013383,4.683,-8,6,14
122,TEL,P011193,P011202,1.65,1,2,1
122,TEL,P011193,P011214,19.366,13,49,36
122,TEL,P011193,P011219,7.183,-9,13,22
122,TEL,P011193,P013250,5.383,4,13,9
122,TEL,P011193,P013381,10.183,1,23,22
122,TEL,P011193,P013382,26.266,7,64,57
122,TEL,P011202,P011214,1.883,1,3,2
122,TEL,P011202,P011219,1.583,-4,2,6
122,TEL,P011202,P013250,4.05,2,7,5
122,TEL,P011202,P013381,1.15,1,2,1
122,TEL,P011202,P013382,1.834,5,6,1
122,TEL,P011202,P013383,8.6,-2,15,17
122,TEL,P011214,P011219,0.883,-2,0,2
122,TEL,P011214,P013250,4.9,1,11,10
122,TEL,P011214,P013381,9.183,1,21,20
122,TEL,P011214,P013382,21.333,9,51,42
122,TEL,P011219,P013250,0.75,0,2,2
122,TEL,P011219,P013381,1.1,0,2,2
122,TEL,P011219,P013382,7.2,-9,13,22
122,TEL,P013250,P013382,5.767,2,13,11
122,TEL,P013250,P013383,2.45,1,3,2
122,TEL,P013381,P013382,10.183,1,23,22
122,TEL,P013381,P013383,1.05,1,2,1
122,TEL,P013382,P013383,0.417,4,4,0
123,BER,P006251,P007025,9.234,-2,17,19
123,BER,P006251,P007550,8.251,0,15,15
123,BER,P006251,P008173,8.217,-2,16,18
123,BER,P006251,P008211,15.434,-2,31,33
123,BER,P006251,P008384,1.551,0,2,2
123,BER,P006251,P008967,6.3,0,12,12
123,BER,P006251,P011934,0.417,0,0,0
123,BER,P006251,P012604,11.134,-4,16,20
123,BER,P006251,P013386,5.334,2,15,13
123,BER,P007025,P007550,14.551,-9,26,35
123,BER,P007025,P008173,1.4,-2,2,4
123,BER,P007025,P008211,8.617,-2,17,19
123,BER,P007025,P008384,6.6,-6,11,17
123,BER,P007025,P011631,2.917,-7,2,9
123,BER,P007025,P011934,4.534,-5,9,14
123,BER,P007025,P012604,4.934,-7,4,11
123,BER,P007025,P013386,11.017,-4,24,28
123,BER,P007550,P008211,9.4,-5,17,22
123,BER,P007550,P008384,7.8,-6,13,19
123,BER,P007550,P011631,4.317,-12,2,14
123,BER,P007550,P011934,7.134,-10,11,21
123,BER,P007550,P012604,5.351,-10,2,12
123,BER,P007550,P013386,11.8,-4,26,30
123,BER,P008173,P008211,13.383,-3,26,29
123,BER,P008173,P008384,9.267,-3,25,28
123,BER,P008173,P008967,18.4,-7,43,50
123,BER,P008173,P011631,7.234,7,17,10
123,BER,P008173,P011934,12.366,-6,32,38
123,BER,P008173,P012604,14.566,-3,31,34
123,BER,P008173,P013386,6.567,-5,16,21
123,BER,P008211,P008384,1.3,0,4,4
123,BER,P008211,P008967,8.933,-4,17,21
123,BER,P008211,P011631,3.933,-2,5,7
123,BER,P008211,P011934,7.349,-6,12,18
123,BER,P008211,P012604,16.666,-10,26,36
123,BER,P008211,P013386,6.117,2,17,15
123,BER,P008384,P008967,8.75,-3,23,26
123,BER,P008384,P011631,6.167,0,11,11
123,BER,P008384,P011934,11.483,-7,30,37
123,BER,P008384,P012604,2.017,0,4,4
123,BER,P008384,P013386,13.333,-11,29,40
123,BER,P008967,P011631,4.701,4,12,8
123,BER,P008967,P011934,9.833,-9,27,36
123,BER,P008967,P012604,10.633,-4,24,28
123,BER,P008967,P013386,6.05,-5,14,19
123,BER,P011631,P011934,7.101,-3,13,16
123,BER,P011631,P012604,5.167,-5,8,13
123,BER,P011631,P013386,4.667,-2,6,8
123,BER,P011934,P012604,9.2,-9,17,26
123,BER,P011934,P013386,8.583,-9,21,30
123,MCO,P004790,P005844,4.383,-2,7,9
123,MCO,P004790,P005985,8.167,2,17,15
123,MCO,P004790,P008099,2.8,4,6,2
123,MCO,P004790,P008161,2.134,2,2,0
123,MCO,P004790,P009754,9.5,6,21,15
123,MCO,P004790,P011212,6.034,4,8,4
123,MCO,P004790,P011226,0.767,-2,2,4
123,MCO,P004790,P011231,9.884,12,23,11
123,MCO,P004790,P012515,3.184,2,4,2
123,MCO,P004790,P013365,5.551,4,10,6
123,MCO,P005844,P005985,9.516,3,17,14
123,MCO,P005844,P008099,6.517,0,12,12
123,MCO,P005844,P008161,3.717,-3,10,13
123,MCO,P005844,P009754,8.666,4,16,12
123,MCO,P005844,P011212,10.234,-4,23,27
123,MCO,P005844,P011226,4.05,8,10,2
123,MCO,P005844,P011231,16.35,-3,31,34
123,MCO,P005844,P012515,9.617,-6,22,28
123,MCO,P005844,P013365,2.55,3,8,5
123,MCO,P005985,P008099,0.85,0,0,0
123,MCO,P005985,P009754,19.95,15,55,40
123,MCO,P005985,P011212,2.25,-2,2,4
123,MCO,P005985,P011226,12.617,14,42,28
123,MCO,P005985,P011231,9.7,9,20,11
123,MCO,P005985,P012515,0.233,-3,0,3
123,MCO,P005985,P013365,13.317,14,45,31
123,MCO,P005985,PLCZ,7.8,8,30,22
123,MCO,P008099,P009754,2.183,4,4,0
123,MCO,P008099,P011212,13.05,6,31,25
123,MCO,P008099,P011231,8.8,4,16,12
123,MCO,P008099,P012515,11.717,2,27,25
123,MCO,P008099,P013365,5.1,2,15,13
123,MCO,P008099,PLCZ,4.583,2,13,11
123,MCO,P008161,P009754,0.3,1,1,0
123,MCO,P008161,P011212,5.551,-2,11,13
123,MCO,P008161,P011231,4.201,-2,11,13
123,MCO,P008161,P012515,5.434,-1,12,13
123,MCO,P008161,P013365,2.067,1,1,0
123,MCO,P009754,P011212,2.433,2,4,2
123,MCO,P009754,P011226,11.467,14,40,26
123,MCO,P009754,P011231,9.883,13,22,9
123,MCO,P009754,P012515,0.533,-2,1,3
123,MCO,P009754,P013365,13.617,15,46,31
123,MCO,P009754,PLCZ,7.8,8,30,22
123,MCO,P011212,P011226,1.15,0,2,2
123,MCO,P011212,P011231,13.301,2,29,27
123,MCO,P011212,P012515,16.851,0,38,38
123,MCO,P011212,P013365,7.967,0,15,15
123,MCO,P011212,PLCZ,4.583,2,13,11
123,MCO,P011226,P011231,2.55,3,5,2
123,MCO,P011226,P013365,10.067,11,37,26
123,MCO,P011226,PLCZ,7.8,8,30,22
123,MCO,P011231,P012515,10.401,-2,23,25
123,MCO,P011231,P013365,2.334,8,8,0
123,MCO,P012515,P013365,6.983,0,16,16
123,MCO,P012515,PLCZ,4.583,2,13,11
123,MCO,P013365,PLCZ,12.383,10,43,33
124,OLY,P001255,P007853,5.567,-3,10,13
124,OLY,P001255,P007947,2.217,3,8,5
124,OLY,P001255,P007982,5.567,-3,10,13
124,OLY,P001255,P008829,5.517,-3,10,13
124,OLY,P001255,P008855,1.733,-4,2,6
124,OLY,P001255,P009849,1.617,-2,0,2
124,OLY,P001255,P013380,0.05,0,0,0
124,OLY,P003469,P003941,21.783,-8,44,52
124,OLY,P003469,P007853,11.283,-3,26,29
124,OLY,P003469,P007947,19.117,-2,42,44
124,OLY,P003469,P007982,13.616,13,42,29
124,OLY,P003469,P008829,10.0,7,30,23
124,OLY,P003469,P008855,24.1,-13,44,57
124,OLY,P003469,P009849,3.933,-4,8,12
124,OLY,P003469,P013380,23.3,6,60,54
124,OLY,P003941,P007853,13.083,-5,32,37
124,OLY,P003941,P007947,9.967,-9,12,21
124,OLY,P003941,P007982,5.899,4,16,12
124,OLY,P003941,P008829,2.65,-2,6,8
124,OLY,P003941,P008855,24.433,-10,50,60
124,OLY,P003941,P009849,4.3,-4,10,14
124,OLY,P003941,P013380,15.617,-6,30,36
124,OLY,P007853,P007947,2.217,3,8,5
124,OLY,P007853,P007982,10.933,-3,20,23
124,OLY,P007853,P008829,9.017,-5,16,21
124,OLY,P007853,P008855,15.666,-9,34,43
124,OLY,P007853,P009849,5.917,-6,10,16
124,OLY,P007853,P013380,4.317,-1,12,13
124,OLY,P007947,P007982,11.367,10,38,28
124,OLY,P007947,P008829,11.367,10,38,28
124,OLY,P007947,P008855,11.434,-14,12,26
124,OLY,P007947,P013380,17.65,3,42,39
124,OLY,P007982,P008829,17.8,2,44,42
124,OLY,P007982,P008855,9.949,-5,18,23
124,OLY,P007982,P009849,1.617,-2,0,2
124,OLY,P007982,P013380,9.116,16,36,20
124,OLY,P008829,P008855,6.65,-11,8,19
124,OLY,P008829,P009849,1.984,-2,2,4
124,OLY,P008829,P013380,7.683,12,30,18
124,OLY,P008855,P009849,4.3,-4,10,14
124,OLY,P008855,P013380,15.667,-6,30,36
124,PRS,P004197,P004512,0.6,2,2,0
124,PRS,P004197,P005793,0.166,-3,0,3
124,PRS,P004197,P007032,0.133,-3,0,3
124,PRS,P004197,P010390,13.899,18,37,19
124,PRS,P004197,P012608,14.366,23,39,16
124,PRS,P004197,P012609,0.6,2,2,0
124,PRS,P004197,P012610,14.499,20,39,19
124,PRS,P004197,P012613,13.733,21,37,16
124,PRS,P004512,P005793,5.75,10,21,11
124,PRS,P004512,P007032,5.75,10,21,11
124,PRS,P004512,P012608,2.767,0,5,5
124,PRS,P004512,P012609,8.517,10,26,16
124,PRS,P004512,P012610,2.767,0,5,5
124,PRS,P004512,P012613,2.167,-2,3,5
124,PRS,P004512,P012640,5.75,10,21,11
124,PRS,P005793,P007032,12.816,-8,27,35
124,PRS,P005793,P010390,1.699,-5,2,7
124,PRS,P005793,P012608,1.616,-2,2,4
124,PRS,P005793,P012609,12.683,-5,27,32
124,PRS,P005793,P012610,1.749,-5,2,7
124,PRS,P005793,P012613,0.05,0,0,0
124,PRS,P005793,P012640,14.266,-7,29,36
124,PRS,P005793,P013373,6.933,-15,6,21
124,PRS,P007032,P010390,0.133,-3,0,3
124,PRS,P007032,P012608,3.183,6,16,10
124,PRS,P007032,P012609,12.683,-5,27,32
124,PRS,P007032,P012610,3.316,3,16,13
124,PRS,P007032,P012613,3.183,6,16,10
124,PRS,P007032,P012640,15.866,1,43,42
124,PRS,P007032,P013373,6.933,-15,6,21
124,PRS,P010390,P012608,21.182,8,48,40
124,PRS,P010390,P012609,1.333,-1,2,3
124,PRS,P010390,P012610,21.315,5,48,43
124,PRS,P010390,P012613,19.616,10,46,36
124,PRS,P010390,P012640,6.083,-12,9,21
124,PRS,P012608,P012609,4.1,-1,7,8
124,PRS,P012608,P012610,27.182,14,69,55
124,PRS,P012608,P012613,25.016,14,65,51
124,PRS,P012608,P012640,9.316,-6,25,31
124,PRS,P012609,P012610,4.1,-1,7,8
124,PRS,P012609,P012613,3.5,-3,5,8
124,PRS,P012609,P012640,12.683,-5,27,32
124,PRS,P012609,P013373,6.933,-15,6,21
124,PRS,P012610,P012613,25.016,14,65,51
124,PRS,P012610,P012640,9.316,-6,25,31
124,PRS,P012613,P012640,7.783,-4,23,27
124,PRS,P012640,P013373,6.933,-15,6,21
125,RED,P002553,P004007,5.8,-2,8,10
125,RED,P002553,P004866,15.816,-4,29,33
125,RED,P002553,P006436,10.8,11,29,18
125,RED,P002553,P007960,11.95,13,33,20
125,RED,P002553,P009048,18.583,-4,32,36
125,RED,P002553,P010612,21.166,14,52,38
125,RED,P002553,P011194,12.399,-9,17,26
125,RED,P002553,P012044,11.633,15,36,21
125,RED,P002553,P012786,3.267,-5,2,7
125,RED,P002553,PJDR,4.25,-9,2,11
125,RED,P004007,P004866,9.767,-2,19,21
125,RED,P004007,P009048,9.767,-2,19,21
125,RED,P004007,P011194,9.767,-2,19,21
125,RED,P004007,P012786,3.967,0,11,11
125,RED,P004866,P007960,3.033,3,8,5
125,RED,P004866,P009048,20.7,-3,44,47
125,RED,P004866,P010612,10.766,7,29,22
125,RED,P004866,P011194,18.383,-6,36,42
125,RED,P004866,P012044,3.566,9,14,5
125,RED,P004866,P012786,5.951,-5,13,18
125,RED,P004866,PJDR,1.95,-7,0,7
125,RED,P006436,P007960,12.4,9,35,26
125,RED,P006436,P009048,2.25,3,5,2
125,RED,P006436,P010612,15.216,11,44,33
125,RED,P006436,P011194,4.916,1,15,14
125,RED,P006436,P012044,12.966,8,39,31
125,RED,P006436,P012786,2.316,1,9,8
125,RED,P007960,P009048,2.817,6,9,3
125,RED,P007960,P010612,15.433,12,43,31
125,RED,P007960,P011194,3.3,1,10,9
125,RED,P007960,P012044,12.616,6,34,28
125,RED,P007960,P012786,0.183,-2,0,2
125,RED,P009048,P010612,13.533,7,32,25
125,RED,P009048,P011194,19.066,-7,36,43
125,RED,P009048,P012044,1.783,8,10,2
125,RED,P009048,P012786,8.251,-7,15,22
125,RED,P009048,PJDR,4.25,-9,2,11
125,RED,P010612,P011194,12.549,1,32,31
125,RED,P010612,P012044,16.532,17,53,36
125,RED,P010612,P012786,5.633,-3,13,16
125,RED,P010612,PJDR,2.3,-2,2,4
125,RED,P011194,P012044,4.716,4,17,13
125,RED,P011194,P012786,7.117,1,22,21
125,RED,P011194,PJDR,0.983,-4,0,4
125,RED,P012044,P012786,2.316,1,9,8
125,RED,P012786,PJDR,3.267,-5,2,7
125,VIR,P001133,P001844,18.466,0,45,45
125,VIR,P001133,P002084,18.167,-9,44,53
125,VIR,P001133,P004554,12.749,1,26,25
125,VIR,P001133,P004888,26.316,-6,59,65
125,VIR,P001133,P006739,17.915,-5,45,50
125,VIR,P001133,P009549,27.783,-5,62,67
125,VIR,P001133,P012585,1.616,-1,4,5
125,VIR,P001133,P013374,1.766,1,6,5
125,VIR,P001133,PBCN,6.682,0,21,21
125,VIR,P001844,P002084,7.5,4,22,18
125,VIR,P001844,P004554,10.0,-2,19,21
125,VIR,P001844,P004888,14.9,-1,33,34
125,VIR,P001844,P006739,3.566,1,12,11
125,VIR,P001844,P009549,14.9,-1,33,34
125,VIR,P001844,P012585,0.683,-1,2,3
125,VIR,P001844,P013374,0.783,-3,2,5
125,VIR,P001844,PBCN,3.066,3,12,9
125,VIR,P002084,P004554,1.15,0,0,0
125,VIR,P002084,P004888,17.95,-1,40,41
125,VIR,P002084,P006739,21.133,-14,41,55
125,VIR,P002084,P009549,17.284,-2,37,39
125,VIR,P002084,P012585,4.55,-8,4,12
125,VIR,P002084,P013374,5.983,-1,9,10
125,VIR,P002084,PBCN,7.483,-9,15,24
125,VIR,P004554,P004888,11.783,0,21,21
125,VIR,P004554,P006739,3.899,3,7,4
125,VIR,P004554,P009549,13.716,1,26,25
125,VIR,P004554,P012585,0.183,0,0,0
125,VIR,P004554,PBCN,2.116,1,5,4
125,VIR,P004888,P006739,15.399,1,34,33
125,VIR,P004888,P009549,29.516,1,64,63
125,VIR,P004888,P012585,0.25,1,1,0
125,VIR,P004888,P013374,4.649,7,14,7
125,VIR,P004888,PBCN,0.633,-2,2,4
125,VIR,P006739,P009549,16.666,1,36,35
125,VIR,P006739,P012585,4.866,-7,6,13
125,VIR,P006739,P013374,6.966,3,13,10
125,VIR,P006739,PBCN,9.782,-7,22,29
125,VIR,P009549,P012585,0.05,0,0,0
125,VIR,P009549,P013374,4.449,6,13,7
125,VIR,P009549,PBCN,2.1,-1,5,6
125,VIR,P012585,P013374,3.3,-6,2,8
125,VIR,P012585,PBCN,4.166,-6,5,11
125,VIR,P013374,PBCN,3.1,-7,1,8
126,ASV,P003526,P004194,5.749,-3,11,14
126,ASV,P003526,P007027,11.816,3,29,26
126,ASV,P003526,P010545,7.867,2,21,19
126,ASV,P003526,P011225,5.816,-8,9,17
126,ASV,P003526,P012731,3.733,-9,5,14
126,ASV,P003526,P013371,7.8,7,23,16
126,ASV,P003526,P013405,9.883,8,27,19
126,ASV,P003526,PKIR,1.8,-4,3,7
126,ASV,P004194,P007027,21.482,2,48,46
126,ASV,P004194,P008991,5.283,1,11,10
126,ASV,P004194,P010316,2.916,0,6,6
126,ASV,P004194,P010545,5.183,-3,7,10
126,ASV,P004194,P011225,23.098,1,49,48
126,ASV,P004194,P012731,22.332,-1,48,49
126,ASV,P004194,P013371,3.8,3,9,6
126,ASV,P004194,P013405,14.099,10,35,25
126,ASV,P004194,PKIR,4.65,2,12,10
126,ASV,P007027,P010316,6.016,-9,10,19
126,ASV,P007027,P010545,15.85,-10,29,39
126,ASV,P007027,P011225,19.432,-9,38,47
126,ASV,P007027,P012731,20.766,-15,41,56
126,ASV,P007027,P013371,12.85,5,31,26
126,ASV,P007027,P013405,21.049,16,53,37
126,ASV,P007027,PKIR,0.867,-3,1,4
126,ASV,P008991,P010316,1.383,-2,0,2
126,ASV,P008991,P011225,5.283,1,11,10
126,ASV,P008991,P012731,5.283,1,11,10
126,ASV,P008991,PKIR,3.9,3,11,8
126,ASV,P010316,P010545,4.483,-11,4,15
126,ASV,P010316,P011225,4.216,-7,6,13
126,ASV,P010316,P012731,6.316,-11,10,21
126,ASV,P010316,P013371,3.183,-4,4,8
126,ASV,P010316,P013405,1.083,0,0,0
126,ASV,P010545,P011225,6.866,-17,5,22
126,ASV,P010545,P012731,10.283,-22,12,34
126,ASV,P010545,P013371,10.917,4,26,22
126,ASV,P010545,P013405,7.75,8,20,12
126,ASV,P010545,PKIR,2.933,-7,4,11
126,ASV,P011225,P012731,24.815,-13,48,61
126,ASV,P011225,P013405,11.366,7,28,21
126,ASV,P011225,PKIR,6.7,-3,14,17
126,ASV,P012731,P013371,3.167,-4,6,10
126,ASV,P012731,P013405,9.283,6,24,18
126,ASV,P012731,PKIR,6.95,-4,15,19
126,ASV,P013371,P013405,9.683,9,25,16
126,MIL,P000796,P001392,21.334,19,57,38
126,MIL,P000796,P001518,4.716,-4,6,10
126,MIL,P000796,P006085,12.682,0,30,30
126,MIL,P000796,P007831,26.066,7,66,59
126,MIL,P000796,P008987,21.55,5,53,48
126,MIL,P000796,P011064,19.868,7,45,38
126,MIL,P000796,P011941,3.716,1,10,9
126,MIL,P000796,P013384,14.133,4,33,29
126,MIL,P000796,P013385,7.667,5,16,11
126,MIL,P001392,P001518,0.5,4,4,0
126,MIL,P001392,P006085,9.983,8,26,18
126,MIL,P001392,P007831,15.35,13,44,31
126,MIL,P001392,P008987,17.084,11,46,35
126,MIL,P001392,P011064,14.035,9,35,26
126,MIL,P001392,P011941,3.75,6,12,6
126,MIL,P001392,P013384,8.934,8,21,13
126,MIL,P001392,P013385,6.634,6,15,9
126,MIL,P001518,P006085,4.65,-5,5,10
126,MIL,P001518,P007831,5.199,-8,6,14
126,MIL,P001518,P008987,7.833,-7,11,18
126,MIL,P001518,P011064,3.45,-6,2,8
126,MIL,P001518,P011941,1.25,-4,0,4
126,MIL,P001518,P013384,3.633,-3,5,8
126,MIL,P001518,P013385,3.633,-3,5,8
126,MIL,P006085,P007831,8.416,-8,19,27
126,MIL,P006085,P008987,10.517,-7,21,28
126,MIL,P006085,P011941,8.033,-1,18,19
126,MIL,P006085,P013384,15.983,3,36,33
126,MIL,P006085,P013385,7.8,6,17,11
126,MIL,P007831,P008987,21.816,1,53,52
126,MIL,P007831,P011064,18.517,7,43,36
126,MIL,P007831,P011941,4.966,-3,10,13
126,MIL,P007831,P013384,7.616,-2,20,22
126,MIL,P007831,P013385,2.25,-3,3,6
126,MIL,P008987,P011064,17.484,7,41,34
126,MIL,P008987,P011941,4.317,-2,8,10
126,MIL,P008987,P013384,11.117,1,26,25
126,MIL,P008987,P013385,2.75,-1,5,6
126,MIL,P011064,P013384,3.734,4,10,6
126,MIL,P011064,P013385,2.384,0,4,4
126,MIL,P011941,P013384,6.1,-1,14,15
126,MIL,P013384,P013385,8.55,6,19,13
127,MCO,P002581,P005985,0.9,-4,0,4
127,MCO,P002581,P008099,3.601,0,6,6
127,MCO,P002581,P008161,0.967,0,2,2
127,MCO,P002581,P011212,2.701,4,6,2
127,MCO,P002581,P011231,2.701,4,6,2
127,MCO,P002581,P012515,2.217,0,4,4
127,MCO,P002581,P013365,1.317,-4,0,4
127,MCO,P005844,P005985,8.333,4,19,15
127,MCO,P005844,P008099,4.85,-3,9,12
127,MCO,P005844,P008161,1.75,-2,2,4
127,MCO,P005844,P009754,3.85,-1,9,10
127,MCO,P005844,P011212,10.883,-2,21,23
127,MCO,P005844,P011231,4.683,0,9,9
127,MCO,P005844,P012515,6.583,6,17,11
127,MCO,P005844,P013365,11.8,2,26,24
127,MCO,P005985,P008099,2.267,-2,4,6
127,MCO,P005985,P008161,1.75,-2,2,4
127,MCO,P005985,P009754,14.699,17,40,23
127,MCO,P005985,P011212,16.433,14,40,26
127,MCO,P005985,P011231,15.166,11,34,23
127,MCO,P005985,P012515,24.083,19,54,35
127,MCO,P005985,P013365,14.45,12,36,24
127,MCO,P005985,PLCZ,20.383,23,51,28
127,MCO,P008099,P008161,1.167,-3,2,5
127,MCO,P008099,P009754,3.15,0,9,9
127,MCO,P008099,P011212,9.901,2,24,22
127,MCO,P008099,P011231,6.051,5,13,8
127,MCO,P008099,P012515,4.284,-1,10,11
127,MCO,P008099,P013365,9.884,-4,22,26
127,MCO,P008099,PLCZ,3.517,6,13,7
127,MCO,P008161,P009754,0.483,5,5,0
127,MCO,P008161,P011212,3.4,0,9,9
127,MCO,P008161,P011231,2.1,5,7,2
127,MCO,P008161,P012515,0.15,-3,0,3
127,MCO,P008161,P013365,1.833,0,7,7
127,MCO,P009754,P011212,7.416,11,28,17
127,MCO,P009754,P011231,7.649,10,23,13
127,MCO,P009754,P012515,10.916,11,26,15
127,MCO,P009754,P013365,11.166,17,36,19
127,MCO,P009754,PLCZ,13.999,18,40,22
127,MCO,P011212,P011231,18.317,22,48,26
127,MCO,P011212,P012515,12.917,11,30,19
127,MCO,P011212,P013365,12.75,5,33,28
127,MCO,P011212,PLCZ,12.55,17,37,20
127,MCO,P011231,P012515,12.1,9,24,15
127,MCO,P011231,P013365,4.25,6,12,6
127,MCO,P011231,PLCZ,13.783,12,32,20
127,MCO,P012515,P013365,14.0,11,36,25
127,MCO,P012515,PLCZ,17.15,17,39,22
127,MCO,P013365,PLCZ,8.75,15,28,13
127,ULK,P002849,P002968,3.683,2,10,8
127,ULK,P002849,P004004,9.466,0,22,22
127,ULK,P002849,P006961,7.566,-8,17,25
127,ULK,P002849,P007182,6.366,1,14,13
127,ULK,P002849,P008962,12.799,-8,25,33
127,ULK,P002849,P009783,6.949,-5,13,18
127,ULK,P002849,P009863,10.416,-7,23,30
127,ULK,P002849,P013396,5.215,-3,8,11
127,ULK,P002968,P002969,2.283,-4,2,6
127,ULK,P002968,P004004,4.0,0,12,12
127,ULK,P002968,P006961,15.417,-12,26,38
127,ULK,P002968,P008174,2.283,-4,2,6
127,ULK,P002968,P008962,15.2,-10,24,34
127,ULK,P002968,P009783,9.483,-2,14,16
127,ULK,P002968,P009863,13.267,-6,26,32
127,ULK,P002968,P013396,1.316,4,4,0
127,ULK,P002969,P006961,2.283,-4,2,6
127,ULK,P002969,P008174,2.283,-4,2,6
127,ULK,P002969,P008962,2.283,-4,2,6
127,ULK,P004004,P006961,7.551,-6,19,25
127,ULK,P004004,P007182,10.533,-4,19,23
127,ULK,P004004,P008962,14.217,-5,30,35
127,ULK,P004004,P009783,7.399,2,16,14
127,ULK,P004004,P009863,11.517,-4,28,32
127,ULK,P004004,P013396,3.449,1,6,5
127,ULK,P006961,P007182,6.917,-12,8,20
127,ULK,P006961,P008174,2.283,-4,2,6
127,ULK,P006961,P008962,26.417,-29,40,69
127,ULK,P006961,P009783,15.234,-13,24,37
127,ULK,P006961,P009863,21.584,-24,36,60
127,ULK,P006961,P013396,1.816,-4,2,6
127,ULK,P007182,P008174,1.45,-2,2,4
127,ULK,P007182,P008962,16.267,-14,25,39
127,ULK,P007182,P009783,10.0,-11,13,24
127,ULK,P007182,P009863,12.001,-12,17,29
127,ULK,P007182,P013396,6.666,-6,10,16
127,ULK,P008174,P008962,3.733,-6,4,10
127,ULK,P008174,P009783,1.45,-2,2,4
127,ULK,P008174,P013396,1.45,-2,2,4
127,ULK,P008962,P009783,21.65,-17,35,52
127,ULK,P008962,P009863,29.617,-24,49,73
127,ULK,P008962,P013396,6.549,-7,10,17
127,ULK,P009783,P009863,18.083,-14,29,43
127,ULK,P009783,P013396,6.216,-2,10,12
127,ULK,P009863,P013396,3.383,-5,4,9
128,BER,P006251,P006919,2.633,0,5,5
128,BER,P006251,P007025,6.767,-7,11,18
128,BER,P006251,P007550,6.617,-6,10,16
128,BER,P006251,P008173,12.383,0,28,28
128,BER,P006251,P008211,12.384,-4,26,30
128,BER,P006251,P008967,12.55,-1,29,30
128,BER,P006251,P011631,4.167,-3,8,11
128,BER,P006251,P011934,0.617,0,0,0
128,BER,P006251,P012604,2.0,-5,3,8
128,BER,P006251,P013386,16.55,-2,36,38
128,BER,P006919,P007025,8.383,1,16,15
128,BER,P006919,P007550,6.816,3,14,11
128,BER,P006919,P008173,5.617,4,12,8
128,BER,P006919,P008211,0.017,0,0,0
128,BER,P006919,P008967,4.067,6,10,4
128,BER,P006919,P011631,7.617,8,18,10
128,BER,P006919,P011934,8.55,3,17,14
128,BER,P006919,P013386,6.1,3,12,9
128,BER,P007025,P007550,11.4,0,22,22
128,BER,P007025,P008173,1.567,-2,2,4
128,BER,P007025,P008211,0.767,-1,1,2
128,BER,P007025,P008967,0.15,-1,1,2
128,BER,P007025,P011631,10.317,1,22,21
128,BER,P007025,P011934,6.967,4,14,10
128,BER,P007025,P012604,1.8,-5,3,8
128,BER,P007025,P013386,4.35,-2,8,10
128,BER,P007550,P008211,0.617,0,0,0
128,BER,P007550,P011631,8.75,3,20,17
128,BER,P007550,P011934,5.4,6,12,6
128,BER,P007550,P012604,1.8,-5,3,8
128,BER,P007550,P013386,4.2,-1,7,8
128,BER,P008173,P008211,22.617,-4,55,59
128,BER,P008173,P008967,26.867,2,65,63
128,BER,P008173,P011631,3.034,2,6,4
128,BER,P008173,P011934,14.784,-4,35,39
128,BER,P008173,P012604,6.1,-4,16,20
128,BER,P008173,P013386,20.767,6,49,43
128,BER,P008211,P008967,22.784,-5,56,61
128,BER,P008211,P011934,11.634,-1,30,31
128,BER,P008211,P012604,5.9,-4,16,20
128,BER,P008211,P013386,16.884,-1,40,41
128,BER,P008967,P011631,1.467,4,4,0
128,BER,P008967,P011934,13.217,-2,33,35
128,BER,P008967,P012604,6.1,-4,16,20
128,BER,P008967,P013386,20.934,5,50,45
128,BER,P011631,P011934,6.35,4,14,10
128,BER,P011631,P012604,2.0,-5,3,8
128,BER,P011631,P013386,3.434,6,9,3
128,BER,P011934,P012604,5.9,-4,16,20
128,BER,P011934,P013386,7.317,2,17,15
128,PAR,P004761,P006591,0.2,0,0,0
128,PAR,P004761,P006760,13.367,4,34,30
128,PAR,P004761,P007870,8.534,4,26,22
128,PAR,P004761,P011836,11.15,-4,26,30
128,PAR,P004761,P011981,16.4,-6,34,40
128,PAR,P004761,P012167,0.517,0,0,0
128,PAR,P004761,P012720,21.167,-3,53,56
128,PAR,P004761,P013369,23.583,2,60,58
128,PAR,P004761,P013370,3.15,3,7,4
128,PAR,P006591,P006760,5.384,-2,8,10
128,PAR,P006591,P007870,3.017,0,5,5
128,PAR,P006591,P011981,3.984,-5,3,8
128,PAR,P006591,P012720,4.784,-2,8,10
128,PAR,P006591,P013369,0.6,0,0,0
128,PAR,P006591,P013370,3.567,1,8,7
128,PAR,P006760,P007870,15.284,8,41,33
128,PAR,P006760,P011981,19.333,-4,34,38
128,PAR,P006760,P012167,2.0,-5,0,5
128,PAR,P006760,P012720,21.367,-2,48,50
128,PAR,P006760,P013369,21.649,14,57,43
128,PAR,P006760,P013370,17.016,7,38,31
128,PAR,P007870,P011981,5.767,-1,10,11
128,PAR,P007870,P012167,0.517,0,0,0
128,PAR,P007870,P012720,10.551,-1,26,27
128,PAR,P007870,P013369,11.733,10,36,26
128,PAR,P007870,P013370,5.733,12,20,8
128,PAR,P011836,P011981,11.15,-4,26,30
128,PAR,P011836,P012720,11.15,-4,26,30
128,PAR,P011836,P013369,11.15,-4,26,30
128,PAR,P011981,P012167,1.483,-5,0,5
128,PAR,P011981,P012720,23.6,-10,48,58
128,PAR,P011981,P013369,25.199,4,57,53
128,PAR,P011981,P013370,15.016,-1,28,29
128,PAR,P012167,P012720,2.0,-5,0,5
128,PAR,P012167,P013370,1.483,-5,0,5
128,PAR,P012720,P013369,25.316,3,66,63
128,PAR,P012720,P013370,10.133,0,21,21
128,PAR,P013369,P013370,11.966,11,30,19
129,BAS,P007230,P008072,12.433,11,33,22
129,BAS,P007230,P008850,0.2,0,0,0
129,BAS,P007230,P011085,10.966,8,30,22
129,BAS,P007230,P011196,18.7,-6,28,34
129,BAS,P007230,P011948,24.516,3,49,46
129,BAS,P007230,P012201,20.167,-3,31,34
129,BAS,P007230,P012597,14.9,4,33,29
129,BAS,P007230,P013367,22.65,3,40,37
129,BAS,P008072,P011085,16.149,3,37,34
129,BAS,P008072,P011948,12.616,7,35,28
129,BAS,P008072,P012201,6.984,2,14,12
129,BAS,P008072,P012597,15.55,3,34,31
129,BAS,P008072,P013367,7.4,6,15,9
129,BAS,P008850,P011196,0.2,0,0,0
129,BAS,P008850,P012201,0.2,0,0,0
129,BAS,P008850,P013367,0.2,0,0,0
129,BAS,P011085,P011196,3.667,-1,13,14
129,BAS,P011085,P011948,14.383,7,40,33
129,BAS,P011085,P012201,8.867,-6,20,26
129,BAS,P011085,P012597,18.367,0,45,45
129,BAS,P011085,P013367,6.933,-3,15,18
129,BAS,P011196,P011948,16.8,-3,28,31
129,BAS,P011196,P012201,22.033,-11,37,48
129,BAS,P011196,P012597,7.717,-3,19,22
129,BAS,P011196,P013367,19.683,-12,31,43
129,BAS,P011948,P012201,19.967,-2,37,39
129,BAS,P011948,P012597,12.917,5,35,30
129,BAS,P011948,P013367,16.533,-1,28,29
129,BAS,P012201,P012597,13.301,-4,28,32
129,BAS,P012201,P013367,24.617,-12,37,49
129,BAS,P012597,P013367,10.384,-5,18,23
129,VIR,P001133,P001844,14.65,-4,22,26
129,VIR,P001133,P004554,11.251,4,23,19
129,VIR,P001133,P004888,31.051,-1,63,64
129,VIR,P001133,P005738,15.834,2,35,33
129,VIR,P001133,P006739,17.735,-4,36,40
129,VIR,P001133,P009549,17.284,8,42,34
129,VIR,P001133,P012585,6.317,0,17,17
129,VIR,P001133,P012591,6.716,-2,9,11
129,VIR,P001133,P013374,4.566,-7,5,12
129,VIR,P001844,P002084,4.434,0,9,9
129,VIR,P001844,P004554,8.501,0,16,16
129,VIR,P001844,P004888,17.917,-4,31,35
129,VIR,P001844,P005738,14.101,7,26,19
129,VIR,P001844,P006739,8.718,-2,19,21
129,VIR,P001844,P009549,11.984,4,20,16
129,VIR,P001844,P012585,0.2,0,0,0
129,VIR,P001844,P012591,4.566,-2,7,9
129,VIR,P001844,P013374,8.133,-7,14,21
129,VIR,P002084,P004554,2.917,0,5,5
129,VIR,P002084,P004888,1.517,0,4,4
129,VIR,P002084,P005738,2.917,0,5,5
129,VIR,P002084,P006739,1.517,0,4,4
129,VIR,P002084,P009549,1.017,0,0,0
129,VIR,P002084,P012591,1.9,0,5,5
129,VIR,P002084,P013374,1.517,0,4,4
129,VIR,P004554,P004888,11.251,4,23,19
129,VIR,P004554,P005738,5.084,2,10,8
129,VIR,P004554,P006739,11.918,7,27,20
129,VIR,P004554,P009549,8.151,6,15,9
129,VIR,P004554,P012585,0.317,1,1,0
129,VIR,P004554,P012591,5.95,0,12,12
129,VIR,P004888,P005738,17.584,2,40,38
129,VIR,P004888,P006739,21.302,-4,45,49
129,VIR,P004888,P009549,17.284,8,42,34
129,VIR,P004888,P012585,6.317,0,17,17
129,VIR,P004888,P012591,6.416,-2,9,11
129,VIR,P004888,P013374,7.833,-7,14,21
129,VIR,P005738,P006739,12.201,-7,24,31
129,VIR,P005738,P009549,13.268,11,34,23
129,VIR,P005738,P012585,6.0,-1,16,17
129,VIR,P005738,P012591,2.533,0,5,5
129,VIR,P005738,P013374,2.35,0,5,5
129,VIR,P006739,P009549,8.701,5,22,17
129,VIR,P006739,P012585,4.167,-3,7,10
129,VIR,P006739,P012591,4.05,0,7,7
129,VIR,P006739,P013374,3.567,0,9,9
129,VIR,P009549,P012585,1.95,3,10,7
129,VIR,P009549,P013374,2.233,-5,3,8
129,VIR,P012591,P013374,2.333,-2,2,4
130,MUN,P001557,P004508,7.384,3,17,14
130,MUN,P001557,P007056,6.167,8,19,11
130,MUN,P001557,P007201,1.917,0,5,5
130,MUN,P001557,P007639,3.35,-1,7,8
130,MUN,P001557,P010391,4.467,2,13,11
130,MUN,P001557,P011224,7.317,5,18,13
130,MUN,P001557,P011244,3.7,-1,7,8
130,MUN,P001557,P011987,6.1,4,20,16
130,MUN,P001557,P013368,6.734,8,18,10
130,MUN,P004508,P007056,26.101,0,66,66
130,MUN,P004508,P007201,17.517,1,46,45
130,MUN,P004508,P007639,1.717,-3,0,3
130,MUN,P004508,P010391,22.984,-8,55,63
130,MUN,P004508,P011224,10.501,2,21,19
130,MUN,P004508,P011244,2.567,-5,0,5
130,MUN,P004508,P011987,18.167,-7,45,52
130,MUN,P004508,P013368,7.734,-3,14,17
130,MUN,P007056,P007201,17.517,1,46,45
130,MUN,P007056,P007639,0.85,2,3,1
130,MUN,P007056,P007929,1.617,-2,2,4
130,MUN,P007056,P010391,23.784,-2,60,62
130,MUN,P007056,P011224,10.401,7,26,19
130,MUN,P007056,P011244,1.617,-2,2,4
130,MUN,P007056,P011987,21.284,-5,52,57
130,MUN,P007056,P013368,7.534,1,16,15
130,MUN,P007201,P010391,19.434,1,51,50
130,MUN,P007201,P011224,4.117,1,10,9
130,MUN,P007201,P011987,15.317,0,41,41
130,MUN,P007201,P013368,1.917,0,5,5
130,MUN,P007639,P007929,2.917,3,8,5
130,MUN,P007639,P010391,0.85,2,3,1
130,MUN,P007639,P011224,7.117,4,18,14
130,MUN,P007639,P011244,6.267,2,15,13
130,MUN,P007639,P011987,5.4,7,18,11
130,MUN,P007929,P011224,4.534,1,10,9
130,MUN,P007929,P011244,4.534,1,10,9
130,MUN,P007929,P011987,4.534,1,10,9
130,MUN,P010391,P011224,7.217,4,18,14
130,MUN,P010391,P011244,2.45,1,5,4
130,MUN,P010391,P011987,23.334,0,60,60
130,MUN,P010391,P013368,8.084,-4,15,19
130,MUN,P011224,P011244,10.284,1,22,21
130,MUN,P011224,P011987,8.567,8,25,17
130,MUN,P011224,P013368,6.217,7,16,9
130,MUN,P011244,P011987,7.917,6,22,16
130,MUN,P011244,P013368,2.6,1,5,4
130,MUN,P011987,P013368,7.384,-2,15,17
130,TEL,P005145,P006835,5.966,-1,10,11
130,TEL,P005145,P007519,5.0,6,11,5
130,TEL,P005145,P007990,11.016,-4,20,24
130,TEL,P005145,P011202,9.833,-10,14,24
130,TEL,P005145,P013250,6.416,-10,9,19
130,TEL,P005145,P013382,1.583,6,6,0
130,TEL,P005145,P013383,5.05,-3,10,13
130,TEL,P006835,P007519,28.616,6,76,70
130,TEL,P006835,P007990,7.966,-9,10,19
130,TEL,P006835,P011193,24.583,11,68,57
130,TEL,P006835,P011202,6.933,-7,12,19
130,TEL,P006835,P013250,4.766,-4,4,8
130,TEL,P006835,P013381,6.032,7,14,7
130,TEL,P006835,P013382,27.033,8,73,65
130,TEL,P006835,P013383,21.633,-3,53,56
130,TEL,P007519,P007990,7.767,-6,14,20
130,TEL,P007519,P011193,23.25,11,66,55
130,TEL,P007519,P011202,6.067,-5,13,18
130,TEL,P007519,P013250,0.2,0,0,0
130,TEL,P007519,P013381,5.666,3,15,12
130,TEL,P007519,P013382,28.1,9,76,67
130,TEL,P007519,P013383,23.534,-4,57,61
130,TEL,P007990,P011202,10.533,-15,14,29
130,TEL,P007990,P013250,6.616,-10,9,19
130,TEL,P007990,P013381,1.767,-4,3,7
130,TEL,P007990,P013382,3.85,-1,9,10
130,TEL,P007990,P013383,8.017,-15,13,28
130,TEL,P011193,P011202,1.117,0,6,6
130,TEL,P011193,P013250,1.333,0,2,2
130,TEL,P011193,P013381,4.799,7,12,5
130,TEL,P011193,P013382,23.217,10,65,55
130,TEL,P011193,P013383,20.033,5,53,48
130,TEL,P011202,P013250,6.816,-10,9,19
130,TEL,P011202,P013381,1.733,-5,2,7
130,TEL,P011202,P013382,2.15,0,8,8
130,TEL,P011202,P013383,5.55,-8,10,18
130,TEL,P013250,P013381,1.733,0,2,2
130,TEL,P013250,P013382,0.2,0,0,0
130,TEL,P013250,P013383,4.516,-6,9,15
130,TEL,P013381,P013382,5.133,7,14,7
130,TEL,P013381,P013383,2.733,-3,6,9
130,TEL,P013382,P013383,21.134,-3,53,56
131,MAD,P003108,P003583,5.933,-7,11,18
131,MAD,P003108,P003733,9.05,12,23,11
131,MAD,P003108,P005791,15.95,2,32,30
131,MAD,P003108,P005928,12.833,-3,24,27
131,MAD,P003108,P006540,13.032,1,32,31
131,MAD,P003108,P009005,12.767,-2,23,25
131,MAD,P003108,P009213,8.166,9,29,20
131,MAD,P003108,P011247,6.483,-1,11,12
131,MAD,P003108,P013378,10.833,4,24,20
131,MAD,P003108,PTGB,6.017,-11,11,22
131,MAD,P003583,P003733,2.733,-8,2,10
131,MAD,P003583,P005928,1.633,-6,3,9
131,MAD,P003583,P006540,8.666,-15,13,28
131,MAD,P003583,P009213,3.616,-7,5,12
131,MAD,P003583,P011247,4.3,-1,8,9
131,MAD,P003583,P013378,2.95,-4,5,9
131,MAD,P003583,PTGB,4.833,-12,5,17
131,MAD,P003733,P005791,13.55,2,26,24
131,MAD,P003733,P005928,13.033,-1,23,24
131,MAD,P003733,P006540,6.033,-1,14,15
131,MAD,P003733,P009005,13.1,3,26,23
131,MAD,P003733,P009213,12.433,0,29,29
131,MAD,P003733,P013378,2.85,8,12,4
131,MAD,P003733,PTGB,3.75,-7,5,12
131,MAD,P005791,P005928,22.682,-2,44,46
131,MAD,P005791,P006540,3.716,2,9,7
131,MAD,P005791,P009005,24.233,-2,49,51
131,MAD,P005791,P009213,11.666,1,31,30
131,MAD,P005791,P011247,2.183,0,3,3
131,MAD,P005791,P013378,8.766,1,17,16
131,MAD,P005791,PTGB,9.05,-4,21,25
131,MAD,P005928,P006540,3.416,-4,9,13
131,MAD,P005928,P009005,20.899,-4,38,42
131,MAD,P005928,P009213,9.465,0,23,23
131,MAD,P005928,P013378,6.583,1,14,13
131,MAD,P005928,PTGB,6.716,-13,10,23
131,MAD,P006540,P009005,0.533,-2,0,2
131,MAD,P006540,P009213,8.332,2,23,21
131,MAD,P006540,P011247,6.233,-1,11,12
131,MAD,P006540,P013378,8.266,2,20,18
131,MAD,P006540,PTGB,4.833,-12,5,17
131,MAD,P009005,P009213,10.866,-4,25,29
131,MAD,P009005,P011247,0.25,0,0,0
131,MAD,P009005,P013378,7.366,-1,14,15
131,MAD,P009005,PTGB,9.05,-4,21,25
131,MAD,P009213,P013378,3.916,4,13,9
131,MAD,P009213,PTGB,6.2,-5,14,19
131,MAD,P011247,P013378,5.133,-4,8,12
131,MAD,P011247,PTGB,1.35,3,3,0
131,MAD,P013378,PTGB,3.733,1,9,8
131,ZAL,P002329,P003048,5.151,4,13,9
131,ZAL,P002329,P003210,0.45,1,1,0
131,ZAL,P002329,P005504,11.75,-6,21,27
131,ZAL,P002329,P007029,14.951,-15,22,37
131,ZAL,P002329,P007975,23.368,5,54,49
131,ZAL,P002329,P011051,8.101,5,21,16
131,ZAL,P002329,P011983,5.685,7,17,10
131,ZAL,P002329,P012622,0.517,-3,0,3
131,ZAL,P002329,P012715,13.801,11,37,26
131,ZAL,P002329,P013403,16.234,3,34,31
131,ZAL,P002676,P003210,0.933,-3,0,3
131,ZAL,P002676,P005504,0.933,-3,0,3
131,ZAL,P002676,P011983,0.683,-2,0,2
131,ZAL,P002676,P012622,0.683,-2,0,2
131,ZAL,P002676,P012715,0.25,-1,0,1
131,ZAL,P002676,P013403,0.25,-1,0,1
131,ZAL,P003048,P003210,2.667,-2,6,8
131,ZAL,P003048,P007029,1.684,0,4,4
131,ZAL,P003048,P007975,4.184,6,12,6
131,ZAL,P003048,P011983,4.201,-2,10,12
131,ZAL,P003048,P012622,0.517,-3,0,3
131,ZAL,P003048,P012715,5.684,1,14,13
131,ZAL,P003048,P013403,5.384,0,13,13
131,ZAL,P003210,P005504,2.683,4,8,4
131,ZAL,P003210,P007029,1.75,7,8,1
131,ZAL,P003210,P011983,5.1,3,14,11
131,ZAL,P003210,P012622,2.433,5,8,3
131,ZAL,P003210,P012715,2.917,-3,6,9
131,ZAL,P003210,P013403,2.467,-4,5,9
131,ZAL,P005504,P007029,11.267,-1,22,23
131,ZAL,P005504,P007975,11.75,-6,21,27
131,ZAL,P005504,P011983,4.6,12,18,6
131,ZAL,P005504,P012622,2.433,5,8,3
131,ZAL,P005504,P012715,2.483,1,7,6
131,ZAL,P005504,P013403,9.833,-14,11,25
131,ZAL,P007029,P007975,16.717,-9,28,37
131,ZAL,P007029,P011051,8.483,-4,14,18
131,ZAL,P007029,P011983,8.834,20,32,12
131,ZAL,P007029,P012622,5.067,1,12,11
131,ZAL,P007029,P012715,5.683,-1,10,11
131,ZAL,P007029,P013403,11.3,-18,8,26
131,ZAL,P007975,P011051,15.084,10,41,31
131,ZAL,P007975,P011983,10.351,17,36,19
131,ZAL,P007975,P012622,0.35,-3,0,3
131,ZAL,P007975,P012715,19.984,18,56,38
131,ZAL,P007975,P013403,22.284,2,48,46
131,ZAL,P011051,P011983,10.284,7,26,19
131,ZAL,P011051,P012622,2.8,-3,4,7
131,ZAL,P011051,P012715,15.401,13,41,28
131,ZAL,P011051,P013403,12.651,12,33,21
131,ZAL,P011983,P012622,5.4,2,12,10
131,ZAL,P011983,P012715,10.501,5,28,23
131,ZAL,P011983,P013403,10.701,-1,23,24
131,ZAL,P012622,P013403,2.8,-3,4,7
131,ZAL,P012715,P013403,17.568,16,49,33
132,IST,P004887,P007200,1.317,3,3,0
132,IST,P004887,P009846,12.6,12,26,14
132,IST,P004887,P011078,13.917,15,29,14
132,IST,P004887,P012710,13.917,15,29,14
132,IST,P004887,P013363,13.917,15,29,14
132,IST,P006590,P007109,13.55,9,36,27
132,IST,P006590,P007200,12.917,7,33,26
132,IST,P006590,P009513,0.633,3,3,0
132,IST,P006590,P009846,8.8,19,29,10
132,IST,P006590,P011078,5.05,4,13,9
132,IST,P006590,P012710,6.05,3,13,10
132,IST,P006590,P012788,17.6,16,49,33
132,IST,P006590,P013363,9.8,-5,20,25
132,IST,P007109,P007200,8.934,2,22,20
132,IST,P007109,P009513,4.116,0,9,9
132,IST,P007109,P009664,3.483,-3,6,9
132,IST,P007109,P009846,13.05,12,35,23
132,IST,P007109,P011078,6.884,0,15,15
132,IST,P007109,P012710,1.767,-6,0,6
132,IST,P007109,P012788,13.617,11,38,27
132,IST,P007109,P013363,6.584,-14,9,23
132,IST,P007109,P013364,3.483,-3,6,9
132,IST,P007200,P009846,5.4,11,17,6
132,IST,P007200,P011078,4.551,7,12,5
132,IST,P007200,P012710,8.534,12,23,11
132,IST,P007200,P012788,15.551,9,40,31
132,IST,P007200,P013363,12.668,5,30,25
132,IST,P009513,P009664,3.483,-3,6,9
132,IST,P009513,P009846,4.116,0,9,9
132,IST,P009513,P012788,0.633,3,3,0
132,IST,P009513,P013364,3.483,-3,6,9
132,IST,P009664,P009846,3.483,-3,6,9
132,IST,P009664,P013364,3.483,-3,6,9
132,IST,P009846,P011078,17.334,17,39,22
132,IST,P009846,P012710,14.967,8,28,20
132,IST,P009846,P012788,7.8,21,29,8
132,IST,P009846,P013363,13.967,10,28,18
132,IST,P009846,P013364,3.483,-3,6,9
132,IST,P011078,P012710,17.851,13,36,23
132,IST,P011078,P012788,6.684,8,20,12
132,IST,P011078,P013363,19.601,12,40,28
132,IST,P012710,P012788,6.617,7,18,11
132,IST,P012710,P013363,21.901,20,49,29
132,IST,P012788,P013363,12.434,-3,27,30
132,PAN,P001926,P003842,17.95,-14,28,42
132,PAN,P001926,P004088,19.833,-10,33,43
132,PAN,P001926,P005161,6.917,0,14,14
132,PAN,P001926,P005353,7.783,3,19,16
132,PAN,P001926,P007866,9.483,2,21,19
132,PAN,P001926,P009622,12.2,-3,27,30
132,PAN,P001926,P011204,13.533,-8,20,28
132,PAN,P001926,P011209,0.3,-4,0,4
132,PAN,P001926,P011221,2.95,-1,7,8
132,PAN,P001926,P012712,11.983,-9,19,28
132,PAN,P003842,P004088,22.1,-14,33,47
132,PAN,P003842,P005161,7.05,-14,4,18
132,PAN,P003842,P007866,10.683,-12,16,28
132,PAN,P003842,P009622,9.4,-16,11,27
132,PAN,P003842,P011204,22.033,-21,29,50
132,PAN,P003842,P011209,3.817,-7,6,13
132,PAN,P003842,P011221,2.95,-1,7,8
132,PAN,P003842,P012712,9.817,-9,14,23
132,PAN,P004088,P005161,4.15,-9,0,9
132,PAN,P004088,P005353,3.483,-3,6,9
132,PAN,P004088,P007866,7.233,-5,12,17
132,PAN,P004088,P009622,9.133,-8,13,21
132,PAN,P004088,P011204,19.883,-17,26,43
132,PAN,P004088,P011209,3.517,-3,6,9
132,PAN,P004088,P011221,2.65,3,7,4
132,PAN,P004088,P012712,12.75,-10,20,30
132,PAN,P005161,P005353,5.9,3,15,12
132,PAN,P005161,P007866,10.0,-6,19,25
132,PAN,P005161,P009622,13.55,-13,19,32
132,PAN,P005161,P011204,6.633,-13,5,18
132,PAN,P005353,P007866,5.35,5,15,10
132,PAN,P005353,P009622,8.833,2,21,19
132,PAN,P005353,P011204,1.05,-1,2,3
132,PAN,P005353,P012712,2.933,-1,6,7
132,PAN,P006544,P007866,4.117,1,9,8
132,PAN,P006544,P009622,0.717,-2,0,2
132,PAN,P006544,P011204,3.4,3,9,6
132,PAN,P006544,P011209,4.117,1,9,8
132,PAN,P006544,P011221,4.117,1,9,8
132,PAN,P007866,P009622,12.05,-6,24,30
132,PAN,P007866,P011204,13.1,-11,21,32
132,PAN,P007866,P011209,6.867,-1,14,15
132,PAN,P007866,P011221,4.117,1,9,8
132,PAN,P009622,P011204,6.633,-13,5,18
132,PAN,P009622,P011209,1.017,-6,0,6
132,PAN,P009622,P011221,1.734,-6,2,8
132,PAN,P009622,P012712,2.933,-1,6,7
132,PAN,P011204,P011209,6.917,0,15,15
132,PAN,P011204,P011221,5.333,6,14,8
132,PAN,P011204,P012712,9.817,-9,14,23
132,PAN,P011209,P011221,4.417,-3,9,12
132,PAN,P011209,P012712,0.767,-1,1,2
133,OLY,P001255,P003469,10.0,0,20,20
133,OLY,P001255,P003941,1.2,0,2,2
133,OLY,P001255,P007853,5.649,-4,11,15
133,OLY,P001255,P007947,0.983,-3,0,3
133,OLY,P001255,P007982,16.266,-4,31,35
133,OLY,P001255,P008829,16.266,-4,31,35
133,OLY,P001255,P008855,4.834,1,9,8
133,OLY,P001255,P009849,4.083,-1,9,10
133,OLY,P001255,P013380,5.783,-1,11,12
133,OLY,P003469,P003941,20.767,-5,38,43
133,OLY,P003469,P007853,6.717,7,20,13
133,OLY,P003469,P007947,14.85,-7,26,33
133,OLY,P003469,P007982,20.767,2,45,43
133,OLY,P003469,P008829,10.0,0,20,20
133,OLY,P003469,P008855,14.217,-6,22,28
133,OLY,P003469,P009849,5.917,2,12,10
133,OLY,P003469,P013380,19.833,-13,29,42
133,OLY,P003941,P007853,10.267,2,26,24
133,OLY,P003941,P007947,17.817,-12,30,42
133,OLY,P003941,P007982,14.934,-3,31,34
133,OLY,P003941,P008829,4.167,-5,6,11
133,OLY,P003941,P008855,10.617,-7,13,20
133,OLY,P003941,P009849,5.917,2,12,10
133,OLY,P003941,P013380,14.05,-12,18,30
133,OLY,P007853,P007947,10.667,-1,24,25
133,OLY,P007853,P007982,13.466,-9,28,37
133,OLY,P007853,P008829,8.616,-9,15,24
133,OLY,P007853,P008855,1.867,7,7,0
133,OLY,P007853,P009849,4.083,-1,9,10
133,OLY,P007947,P007982,8.8,-8,17,25
133,OLY,P007947,P008829,3.95,-8,4,12
133,OLY,P007947,P008855,10.0,-7,13,20
133,OLY,P007947,P013380,8.133,-14,6,20
133,OLY,P007982,P008829,19.233,-9,35,44
133,OLY,P007982,P008855,4.834,1,9,8
133,OLY,P007982,P009849,10.0,1,21,20
133,OLY,P007982,P013380,11.7,1,23,22
133,OLY,P008829,P008855,4.834,1,9,8
133,OLY,P008829,P009849,4.083,-1,9,10
133,OLY,P008829,P013380,5.783,-1,11,12
133,OLY,P008855,P013380,8.133,-14,6,20
133,OLY,P009849,P013380,5.917,2,12,10
133,RED,P000848,P002553,8.567,6,24,18
133,RED,P000848,P004007,7.917,17,26,9
133,RED,P000848,P004866,12.017,12,34,22
133,RED,P000848,P006240,5.867,8,16,8
133,RED,P000848,P007960,9.501,6,25,19
133,RED,P000848,P009048,16.084,16,47,31
133,RED,P000848,P010612,6.117,1,15,14
133,RED,P000848,P012044,7.584,0,16,16
133,RED,P000848,P012786,1.75,2,5,3
133,RED,P002553,P004007,7.017,7,14,7
133,RED,P002553,P004866,6.017,2,15,13
133,RED,P002553,P007960,6.667,6,14,8
133,RED,P002553,P009048,8.6,5,23,18
133,RED,P002553,P010612,7.7,4,16,12
133,RED,P002553,P012044,8.901,8,21,13
133,RED,P002553,P012786,2.517,2,7,5
133,RED,P002553,PLUO,1.75,0,2,2
133,RED,P004007,P004866,21.433,12,49,37
133,RED,P004007,P006240,11.233,5,24,19
133,RED,P004007,P007960,9.883,8,23,15
133,RED,P004007,P009048,18.883,13,41,28
133,RED,P004007,P010612,8.333,-4,14,18
133,RED,P004007,P012044,9.333,1,18,17
133,RED,P004007,PLUO,5.1,5,11,6
133,RED,P004866,P006240,14.75,3,28,25
133,RED,P004866,P007960,9.05,0,20,20
133,RED,P004866,P009048,26.984,6,55,49
133,RED,P004866,P010612,6.566,-9,13,22
133,RED,P004866,P012044,13.067,-9,21,30
133,RED,P004866,P012786,4.284,-2,6,8
133,RED,P004866,PLUO,5.1,5,11,6
133,RED,P006240,P007960,1.767,1,5,4
133,RED,P006240,P009048,16.517,4,33,29
133,RED,P006240,P010612,3.917,-6,5,11
133,RED,P006240,P012044,5.15,-2,8,10
133,RED,P006240,P012786,3.517,-2,4,6
133,RED,P006240,PLUO,3.35,5,9,4
133,RED,P007960,P009048,8.817,3,20,17
133,RED,P007960,P010612,10.717,5,24,19
133,RED,P007960,P012044,13.534,-1,25,26
133,RED,P009048,P010612,5.783,-7,10,17
133,RED,P009048,P012044,12.534,-5,21,26
133,RED,P009048,P012786,6.034,0,11,11
133,RED,P009048,PLUO,5.1,5,11,6
133,RED,P010612,P012044,8.667,4,19,15
133,RED,P012044,P012786,6.034,0,11,11
134,BAR,P000925,P002939,20.5,-4,39,43
134,BAR,P000925,P007464,10.283,-10,19,29
134,BAR,P000925,P009862,19.567,4,45,41
134,BAR,P000925,P009992,5.383,-10,7,17
134,BAR,P000925,P010106,6.367,0,18,18
134,BAR,P000925,P012745,19.251,4,43,39
134,BAR,P000925,P012795,26.117,0,57,57
134,BAR,P002939,P003196,2.167,-2,0,2
134,BAR,P002939,P007464,6.883,-10,9,19
134,BAR,P002939,P009862,14.967,6,32,26
134,BAR,P002939,P009992,7.55,-12,7,19
134,BAR,P002939,P012745,16.684,0,30,30
134,BAR,P002939,P012795,21.917,-2,39,41
134,BAR,P003196,P007464,5.901,0,12,12
134,BAR,P003196,P009862,1.967,-4,8,12
134,BAR,P003196,P009992,8.985,-7,12,19
134,BAR,P003196,P010106,8.468,-10,17,27
134,BAR,P003196,P011666,1.2,-2,0,2
134,BAR,P003196,P012745,6.901,-9,9,18
134,BAR,P003196,P012795,6.951,-14,10,24
134,BAR,P007464,P009862,5.8,2,17,15
134,BAR,P007464,P009992,13.784,-7,26,33
134,BAR,P007464,P010106,11.801,3,29,26
134,BAR,P007464,P011666,1.2,-2,0,2
134,BAR,P007464,P012745,4.834,1,9,8
134,BAR,P007464,P012795,14.25,-5,31,36
134,BAR,P009862,P009992,2.817,4,10,6
134,BAR,P009862,P010106,9.067,-3,28,31
134,BAR,P009862,P012745,18.234,1,43,42
134,BAR,P009862,P012795,23.717,2,57,55
134,BAR,P009992,P010106,9.318,-2,19,21
134,BAR,P009992,P011666,1.2,-2,0,2
134,BAR,P009992,P012745,6.001,-8,4,12
134,BAR,P009992,P012795,12.434,-12,19,31
134,BAR,P010106,P011666,1.2,-2,0,2
134,BAR,P010106,P012745,9.468,-5,22,27
134,BAR,P010106,P012795,13.651,-9,35,44
134,BAR,P012745,P012795,23.235,-4,48,52
134,MIL,P000796,P001392,16.334,2,36,34
134,MIL,P000796,P001518,5.8,5,11,6
134,MIL,P000796,P006085,4.066,14,22,8
134,MIL,P000796,P007831,24.267,5,58,53
134,MIL,P000796,P008985,13.867,11,41,30
134,MIL,P000796,P008987,22.5,3,54,51
134,MIL,P000796,P011064,21.634,-5,41,46
134,MIL,P000796,P011941,2.683,3,7,4
134,MIL,P000796,P013384,7.35,6,17,11
134,MIL,P000796,P013385,3.567,4,9,5
134,MIL,P001392,P001518,2.284,-1,4,5
134,MIL,P001392,P006085,7.066,-3,8,11
134,MIL,P001392,P007831,18.167,-7,32,39
134,MIL,P001392,P008985,6.151,0,15,15
134,MIL,P001392,P008987,18.917,-11,30,41
134,MIL,P001392,P011064,12.051,-4,22,26
134,MIL,P001392,P011941,1.933,-1,1,2
134,MIL,P001392,P013384,2.217,4,9,5
134,MIL,P001392,P013385,6.484,1,15,14
134,MIL,P001518,P007831,2.134,-1,4,5
134,MIL,P001518,P008985,1.35,0,0,0
134,MIL,P001518,P008987,0.517,-3,0,3
134,MIL,P001518,P011064,4.967,2,11,9
134,MIL,P001518,P011941,2.683,3,7,4
134,MIL,P001518,P013384,4.033,3,7,4
134,MIL,P001518,P013385,1.5,0,0,0
134,MIL,P006085,P007831,8.949,21,33,12
134,MIL,P006085,P008985,6.617,20,29,9
134,MIL,P006085,P008987,11.316,19,35,16
134,MIL,P006085,P011941,1.933,-1,1,2
134,MIL,P006085,P013385,5.317,6,12,6
134,MIL,P007831,P008985,12.134,14,42,28
134,MIL,P007831,P008987,29.467,6,72,66
134,MIL,P007831,P011064,20.718,-11,39,50
134,MIL,P007831,P011941,3.333,-1,6,7
134,MIL,P007831,P013384,2.5,-1,6,7
134,MIL,P007831,P013385,3.267,7,12,5
134,MIL,P008985,P008987,14.501,12,44,32
134,MIL,P008985,P011064,6.317,-6,11,17
134,MIL,P008985,P013384,3.567,4,9,5
134,MIL,P008985,P013385,7.768,9,21,12
134,MIL,P008987,P011064,19.101,-13,35,48
134,MIL,P008987,P011941,3.333,-1,6,7
134,MIL,P008987,P013384,2.5,-1,6,7
134,MIL,P008987,P013385,5.784,5,14,9
134,MIL,P011064,P011941,4.083,3,12,9
134,MIL,P011064,P013384,5.183,2,13,11
134,MIL,P011064,P013385,0.15,0,0,0
134,MIL,P011941,P013384,4.083,3,12,9
134,MIL,P013384,P013385,3.567,4,9,5
135,ASV,P002100,P003526,3.067,1,12,11
135,ASV,P002100,P004194,2.317,-7,4,11
135,ASV,P002100,P007027,10.517,7,37,30
135,ASV,P002100,P010316,9.333,1,25,24
135,ASV,P002100,P010545,4.467,-4,13,17
135,ASV,P002100,P011225,2.9,-2,6,8
135,ASV,P002100,P012731,15.75,15,52,37
135,ASV,P002100,P013371,10.317,9,32,23
135,ASV,P002100,P013405,13.6,12,43,31
135,ASV,P003526,P004194,12.35,-7,26,33
135,ASV,P003526,P007027,20.101,-5,45,50
135,ASV,P003526,P010316,0.25,0,0,0
135,ASV,P003526,P010545,11.217,-9,21,30
135,ASV,P003526,P011225,11.817,-9,23,32
135,ASV,P003526,P012731,10.951,2,26,24
135,ASV,P003526,P013371,4.967,3,10,7
135,ASV,P003526,P013405,5.684,4,17,13
135,ASV,P004194,P007027,14.417,-8,30,38
135,ASV,P004194,P010316,3.251,-5,6,11
135,ASV,P004194,P010545,11.517,-12,23,35
135,ASV,P004194,P011225,10.684,-9,21,30
135,ASV,P004194,P012731,3.2,0,7,7
135,ASV,P004194,P013371,4.684,0,9,9
135,ASV,P004194,P013405,1.184,0,2,2
135,ASV,P007027,P010316,6.067,1,13,12
135,ASV,P007027,P010545,15.751,-9,34,43
135,ASV,P007027,P011225,14.151,-9,27,36
135,ASV,P007027,P012731,20.368,10,54,44
135,ASV,P007027,P013371,12.334,10,32,22
135,ASV,P007027,P013405,12.634,11,36,25
135,ASV,P010316,P010545,2.067,-5,4,9
135,ASV,P010316,P011225,6.101,0,12,12
135,ASV,P010316,P012731,11.233,9,28,19
135,ASV,P010316,P013371,7.217,6,18,12
135,ASV,P010316,P013405,12.417,9,30,21
135,ASV,P010545,P011225,11.384,-13,21,34
135,ASV,P010545,P012731,4.534,-1,11,12
135,ASV,P010545,P013371,3.267,1,9,8
135,ASV,P011225,P012731,7.234,0,14,14
135,ASV,P011225,P013371,0.867,2,2,0
135,ASV,P011225,P013405,6.534,4,14,10
135,ASV,P012731,P013371,16.367,15,45,30
135,ASV,P012731,P013405,19.567,18,55,37
135,ASV,P013371,P013405,11.384,14,31,17
135,PRS,P004197,P004512,1.233,1,3,2
135,PRS,P004197,P005793,0.35,0,0,0
135,PRS,P004197,P010390,8.133,3,21,18
135,PRS,P004197,P012608,15.449,2,34,32
135,PRS,P004197,P012609,1.833,-2,2,4
135,PRS,P004197,P012610,15.449,2,34,32
135,PRS,P004197,P012613,15.199,2,34,32
135,PRS,P004197,P013373,4.15,0,8,8
135,PRS,P004512,P005793,3.783,-6,8,14
135,PRS,P004512,P007032,3.783,-6,8,14
135,PRS,P004512,P012608,2.916,2,7,5
135,PRS,P004512,P012609,4.283,-6,8,14
135,PRS,P004512,P012610,2.916,2,7,5
135,PRS,P004512,P012613,2.916,2,7,5
135,PRS,P004512,P012640,4.966,-5,12,17
135,PRS,P005793,P007032,12.5,-14,27,41
135,PRS,P005793,P012608,4.217,-3,11,14
135,PRS,P005793,P012609,12.75,-14,27,41
135,PRS,P005793,P012610,4.217,-3,11,14
135,PRS,P005793,P012613,3.967,-3,11,14
135,PRS,P005793,P012640,16.367,-17,38,55
135,PRS,P005793,P013373,8.717,-8,19,27
135,PRS,P007032,P010390,0.2,0,0,0
135,PRS,P007032,P012608,1.7,-1,2,3
135,PRS,P007032,P012609,12.5,-14,27,41
135,PRS,P007032,P012610,1.7,-1,2,3
135,PRS,P007032,P012613,1.7,-1,2,3
135,PRS,P007032,P012640,12.5,-14,27,41
135,PRS,P007032,P013373,10.217,-9,21,30
135,PRS,P010390,P012608,12.083,12,34,22
135,PRS,P010390,P012609,0.65,2,2,0
135,PRS,P010390,P012610,12.083,12,34,22
135,PRS,P010390,P012613,12.083,12,34,22
135,PRS,P010390,P012640,3.1,7,11,4
135,PRS,P012608,P012609,4.033,1,6,5
135,PRS,P012608,P012610,27.499,9,66,57
135,PRS,P012608,P012613,27.249,9,66,57
135,PRS,P012608,P012640,8.15,5,26,21
135,PRS,P012608,P013373,6.7,0,12,12
135,PRS,P012609,P012610,4.033,1,6,5
135,PRS,P012609,P012613,3.783,1,6,5
135,PRS,P012609,P012640,12.5,-14,27,41
135,PRS,P012609,P013373,9.767,-7,21,28
135,PRS,P012610,P012613,27.249,9,66,57
135,PRS,P012610,P012640,8.15,5,26,21
135,PRS,P012610,P013373,6.7,0,12,12
135,PRS,P012613,P012640,8.15,5,26,21
135,PRS,P012613,P013373,6.7,0,12,12
135,PRS,P012640,P013373,8.717,-8,19,27
136,MCO,P002581,P005985,8.783,17,27,10
136,MCO,P002581,P008099,8.716,17,28,11
136,MCO,P002581,P009754,4.45,8,14,6
136,MCO,P002581,P011212,6.766,10,20,10
136,MCO,P002581,P011231,11.216,18,34,16
136,MCO,P002581,P012515,4.933,2,13,11
136,MCO,P004790,P005985,2.4,-2,1,3
136,MCO,P004790,P008099,2.783,-5,1,6
136,MCO,P004790,P008161,5.3,-7,2,9
136,MCO,P004790,P009754,0.117,0,0,0
136,MCO,P004790,P011212,2.467,-3,0,3
136,MCO,P004790,P012515,2.833,-4,2,6
136,MCO,P004790,P013365,5.3,-7,2,9
136,MCO,P005844,P005985,3.617,-4,4,8
136,MCO,P005844,P008099,10.401,13,31,18
136,MCO,P005844,P008161,0.15,0,0,0
136,MCO,P005844,P009754,4.25,-1,8,9
136,MCO,P005844,P011212,12.434,7,31,24
136,MCO,P005844,P011231,7.967,8,23,15
136,MCO,P005844,P012515,6.45,6,19,13
136,MCO,P005844,P013365,4.25,-1,8,9
136,MCO,P005844,PLCZ,0.217,0,0,0
136,MCO,P005985,P008099,8.017,18,25,7
136,MCO,P005985,P008161,2.517,-2,1,3
136,MCO,P005985,P009754,16.683,5,38,33
136,MCO,P005985,P011212,11.417,0,19,19
136,MCO,P005985,P011231,11.417,17,33,16
136,MCO,P005985,P012515,13.066,3,33,30
136,MCO,P005985,P013365,14.75,-5,25,30
136,MCO,P005985,PLCZ,10.733,1,26,25
136,MCO,P008099,P008161,2.783,-5,1,6
136,MCO,P008099,P009754,5.617,12,18,6
136,MCO,P008099,P011212,15.717,23,49,26
136,MCO,P008099,P011231,16.683,25,51,26
136,MCO,P008099,P012515,11.666,2,27,25
136,MCO,P008099,P013365,5.0,0,9,9
136,MCO,P008099,PLCZ,0.217,0,0,0
136,MCO,P008161,P009754,0.267,0,0,0
136,MCO,P008161,P011212,2.734,-3,0,3
136,MCO,P008161,P011231,0.117,0,0,0
136,MCO,P008161,P012515,2.833,-4,2,6
136,MCO,P008161,P013365,5.567,-7,2,9
136,MCO,P009754,P011212,4.784,-1,8,9
136,MCO,P009754,P011231,4.867,8,14,6
136,MCO,P009754,P012515,10.983,4,28,24
136,MCO,P009754,P013365,14.717,2,32,30
136,MCO,P009754,PLCZ,9.933,3,24,21
136,MCO,P011212,P011231,15.85,16,45,29
136,MCO,P011212,P012515,10.916,5,30,25
136,MCO,P011212,P013365,7.251,-4,8,12
136,MCO,P011212,PLCZ,0.8,-2,2,4
136,MCO,P011231,P012515,11.966,6,34,28
136,MCO,P011231,P013365,0.534,0,0,0
136,MCO,P011231,PLCZ,0.583,-2,2,4
136,MCO,P012515,P013365,12.766,-1,26,27
136,MCO,P012515,PLCZ,10.516,1,26,25
136,MCO,P013365,PLCZ,9.933,3,24,21
136,MUN,P001557,P004508,2.767,-4,6,10
136,MUN,P001557,P005460,2.717,-7,4,11
136,MUN,P001557,P007056,0.933,2,2,0
136,MUN,P001557,P007201,10.5,-10,21,31
136,MUN,P001557,P007639,1.5,1,1,0
136,MUN,P001557,P007929,1.5,1,1,0
136,MUN,P001557,P010391,4.3,-3,8,11
136,MUN,P001557,P011224,10.5,-10,21,31
136,MUN,P001557,P011987,4.9,-6,9,15
136,MUN,P001557,P012123,1.5,1,1,0
136,MUN,P001557,P013368,6.883,-1,14,15
136,MUN,P004508,P005460,6.017,-7,11,18
136,MUN,P004508,P007056,18.384,-7,37,44
136,MUN,P004508,P007201,13.151,-9,25,34
136,MUN,P004508,P007639,13.817,-11,25,36
136,MUN,P004508,P007929,4.7,-9,5,14
136,MUN,P004508,P010391,16.501,-14,31,45
136,MUN,P004508,P011224,11.134,-10,19,29
136,MUN,P004508,P011987,20.301,-6,41,47
136,MUN,P004508,P013368,1.1,-3,0,3
136,MUN,P005460,P007201,7.434,-13,11,24
136,MUN,P005460,P007929,3.6,-6,5,11
136,MUN,P005460,P011224,7.434,-13,11,24
136,MUN,P005460,P011987,2.534,-6,2,8
136,MUN,P007056,P007201,6.6,3,14,11
136,MUN,P007056,P007639,12.717,-8,25,33
136,MUN,P007056,P010391,15.401,-11,31,42
136,MUN,P007056,P011224,4.583,2,8,6
136,MUN,P007056,P011987,18.65,-1,39,40
136,MUN,P007201,P007929,3.6,-6,5,11
136,MUN,P007201,P010391,8.434,-4,18,22
136,MUN,P007201,P011224,17.417,-18,30,48
136,MUN,P007201,P011987,11.017,-1,23,24
136,MUN,P007201,P013368,5.383,-2,13,15
136,MUN,P007639,P007929,6.4,4,9,5
136,MUN,P007639,P010391,16.167,-7,29,36
136,MUN,P007639,P011224,1.45,2,4,2
136,MUN,P007639,P011987,12.717,-8,25,33
136,MUN,P007639,P012123,5.3,7,9,2
136,MUN,P007639,P013368,6.4,4,9,5
136,MUN,P007929,P010391,4.9,3,8,5
136,MUN,P007929,P011224,3.6,-6,5,11
136,MUN,P007929,P012123,5.3,7,9,2
136,MUN,P007929,P013368,6.4,4,9,5
136,MUN,P010391,P011224,4.967,-7,8,15
136,MUN,P010391,P011987,14.734,-7,31,38
136,MUN,P010391,P012123,3.8,6,8,2
136,MUN,P010391,P013368,9.2,0,16,16
136,MUN,P011224,P011987,9.0,-2,17,19
136,MUN,P011224,P013368,5.383,-2,13,15
136,MUN,P011987,P013368,1.083,1,5,4
136,MUN,P012123,P013368,5.3,7,9,2
137,MIL,P000796,P001392,17.965,-6,41,47
137,MIL,P000796,P001518,3.416,-4,4,8
137,MIL,P000796,P005670,3.183,0,4,4
137,MIL,P000796,P006085,6.982,-6,14,20
137,MIL,P000796,P007831,21.631,-9,41,50
137,MIL,P000796,P008987,13.016,-6,26,32
137,MIL,P000796,P011064,17.482,-5,35,40
137,MIL,P000796,P011941,2.416,-4,7,11
137,MIL,P000796,P013384,3.616,-1,10,11
137,MIL,P000796,P013385,8.149,-3,14,17
137,MIL,P001392,P005670,1.817,-4,2,6
137,MIL,P001392,P006085,12.066,-17,18,35
137,MIL,P001392,P007831,15.132,-4,33,37
137,MIL,P001392,P008987,18.167,-14,32,46
137,MIL,P001392,P011064,13.583,-3,31,34
137,MIL,P001392,P011941,5.516,-10,9,19
137,MIL,P001392,P013384,8.7,-12,14,26
137,MIL,P001392,P013385,9.65,-10,16,26
137,MIL,P001518,P005670,3.867,4,10,6
137,MIL,P001518,P006085,2.667,4,8,4
137,MIL,P001518,P007831,4.399,-3,7,10
137,MIL,P001518,P008987,3.516,-5,5,10
137,MIL,P001518,P011064,4.716,-5,7,12
137,MIL,P001518,P011941,3.25,5,11,6
137,MIL,P001518,P013384,2.984,2,8,6
137,MIL,P001518,P013385,0.717,-2,0,2
137,MIL,P005670,P006085,2.667,4,8,4
137,MIL,P005670,P007831,3.183,0,4,4
137,MIL,P005670,P008987,1.817,-4,2,6
137,MIL,P005670,P011064,5.317,-6,6,12
137,MIL,P005670,P011941,2.267,4,8,4
137,MIL,P005670,P013384,2.984,2,8,6
137,MIL,P005670,P013385,4.834,-8,4,12
137,MIL,P006085,P007831,6.966,-9,10,19
137,MIL,P006085,P008987,8.684,-15,10,25
137,MIL,P006085,P011941,8.45,-10,16,26
137,MIL,P006085,P013384,14.967,-12,28,40
137,MIL,P006085,P013385,9.883,-7,16,23
137,MIL,P007831,P008987,17.883,-12,35,47
137,MIL,P007831,P011064,19.532,-6,40,46
137,MIL,P007831,P011941,6.116,-10,14,24
137,MIL,P007831,P013384,4.667,-6,8,14
137,MIL,P007831,P013385,6.483,-1,8,9
137,MIL,P008987,P011064,16.883,-11,33,44
137,MIL,P008987,P011941,7.1,-10,11,21
137,MIL,P008987,P013384,9.751,-17,12,29
137,MIL,P008987,P013385,5.451,-10,6,16
137,MIL,P011064,P011941,3.333,0,10,10
137,MIL,P011064,P013384,1.384,-4,2,6
137,MIL,P011064,P013385,4.434,-8,4,12
137,MIL,P011941,P013384,8.684,-5,18,23
137,MIL,P013384,P013385,7.667,-11,12,23
137,PAN,P001926,P003842,8.216,7,23,16
137,PAN,P001926,P004088,9.649,16,26,10
137,PAN,P001926,P005353,11.666,19,31,12
137,PAN,P001926,P007866,14.566,21,39,18
137,PAN,P001926,P009622,3.1,6,10,4
137,PAN,P001926,P011204,10.233,10,28,18
137,PAN,P001926,P011442,0.683,4,4,0
137,PAN,P001926,P012712,4.633,1,11,10
137,PAN,P001926,P012774,16.782,20,44,24
137,PAN,P003842,P004088,4.699,-6,6,12
137,PAN,P003842,P007866,5.299,-2,14,16
137,PAN,P003842,P009622,5.732,-11,5,16
137,PAN,P003842,P011204,22.649,17,64,47
137,PAN,P003842,P011209,13.4,15,42,27
137,PAN,P003842,P011442,2.266,-4,4,8
137,PAN,P003842,P012712,19.783,17,52,35
137,PAN,P003842,P012774,27.348,11,70,59
137,PAN,P004088,P005353,8.349,11,22,11
137,PAN,P004088,P007866,10.782,9,24,15
137,PAN,P004088,P009622,5.932,-7,10,17
137,PAN,P004088,P011442,2.266,-4,4,8
137,PAN,P004088,P012774,10.515,1,20,19
137,PAN,P005353,P007866,12.649,18,33,15
137,PAN,P005353,P009622,4.083,5,12,7
137,PAN,P005353,P011204,4.3,7,11,4
137,PAN,P005353,P012774,9.549,12,23,11
137,PAN,P007866,P009622,5.699,4,15,11
137,PAN,P007866,P011204,7.166,7,23,16
137,PAN,P007866,P011209,0.783,-3,3,6
137,PAN,P007866,P012774,14.848,10,37,27
137,PAN,P009622,P011204,3.883,1,7,6
137,PAN,P009622,P011442,1.583,-8,0,8
137,PAN,P009622,P012712,2.533,-2,2,4
137,PAN,P009622,P012774,6.715,-12,7,19
137,PAN,P011204,P011209,13.4,15,42,27
137,PAN,P011204,P012712,19.783,17,52,35
137,PAN,P011204,P012774,26.382,22,73,51
137,PAN,P011209,P012712,12.617,18,39,21
137,PAN,P011209,P012774,13.4,15,42,27
137,PAN,P011442,P012774,2.266,-4,4,8
137,PAN,P012712,P012774,19.783,17,52,35
138,BAR,P000925,P002939,22.967,19,55,36
138,BAR,P000925,P003478,7.45,4,18,14
138,BAR,P000925,P007464,0.683,-2,0,2
138,BAR,P000925,P009862,21.95,23,53,30
138,BAR,P000925,P009992,0.733,-2,0,2
138,BAR,P000925,P010106,0.683,-2,0,2
138,BAR,P000925,P012745,22.967,19,55,36
138,BAR,P000925,P012795,17.167,9,39,30
138,BAR,P002939,P003478,6.767,6,18,12
138,BAR,P002939,P009862,21.95,23,53,30
138,BAR,P002939,P009992,0.05,0,0,0
138,BAR,P002939,P012745,22.967,19,55,36
138,BAR,P002939,P012795,17.167,9,39,30
138,BAR,P003196,P003478,10.567,-1,18,19
138,BAR,P003196,P007464,8.3,6,19,13
138,BAR,P003196,P009862,5.9,4,12,8
138,BAR,P003196,P009992,10.417,6,23,17
138,BAR,P003196,P010106,16.35,10,35,25
138,BAR,P003196,P011666,1.316,9,9,0
138,BAR,P003196,P012745,8.05,4,16,12
138,BAR,P003196,P012795,4.5,2,8,6
138,BAR,P003478,P007464,7.183,-2,10,12
138,BAR,P003478,P009862,7.717,9,20,11
138,BAR,P003478,P009992,9.3,-2,14,16
138,BAR,P003478,P010106,11.25,-3,18,21
138,BAR,P003478,P011666,0.033,0,0,0
138,BAR,P003478,P012745,10.834,5,26,21
138,BAR,P003478,P012795,0.967,-4,2,6
138,BAR,P007464,P009992,8.95,4,19,15
138,BAR,P007464,P010106,8.983,4,19,15
138,BAR,P007464,P011666,1.316,9,9,0
138,BAR,P007464,P012795,0.517,-3,0,3
138,BAR,P009862,P010106,5.9,4,12,8
138,BAR,P009862,P012745,27.85,27,65,38
138,BAR,P009862,P012795,20.133,18,45,27
138,BAR,P009992,P010106,11.1,4,23,19
138,BAR,P009992,P011666,1.283,9,9,0
138,BAR,P009992,P012745,2.2,0,4,4
138,BAR,P009992,P012795,0.567,-3,0,3
138,BAR,P010106,P011666,1.316,9,9,0
138,BAR,P010106,P012745,8.05,4,16,12
138,BAR,P010106,P012795,4.5,2,8,6
138,BAR,P012745,P012795,21.15,14,47,33
138,ULK,P002849,P002968,5.683,-8,7,15
138,ULK,P002849,P004004,12.9,-8,14,22
138,ULK,P002849,P006961,12.9,-10,15,25
138,ULK,P002849,P008174,1.233,-6,0,6
138,ULK,P002849,P008962,9.867,-5,14,19
138,ULK,P002849,P009783,6.5,-11,6,17
138,ULK,P002849,P009863,4.8,4,10,6
138,ULK,P002849,P011205,3.217,-3,9,12
138,ULK,P002849,P013396,5.1,-5,9,14
138,ULK,P002968,P004004,4.899,-8,4,12
138,ULK,P002968,P006961,7.183,-14,7,21
138,ULK,P002968,P008174,1.233,-6,0,6
138,ULK,P002968,P008962,5.333,-5,9,14
138,ULK,P002968,P009783,4.466,-3,9,12
138,ULK,P002968,P009863,1.433,-2,2,4
138,ULK,P002968,P011205,5.017,-1,12,13
138,ULK,P002968,P013396,8.817,-5,14,19
138,ULK,P004004,P006961,16.8,-3,25,28
138,ULK,P004004,P007182,8.634,2,18,16
138,ULK,P004004,P008962,18.667,-10,28,38
138,ULK,P004004,P009783,12.7,-16,18,34
138,ULK,P004004,P009863,4.8,4,10,6
138,ULK,P004004,P011205,5.85,-5,7,12
138,ULK,P004004,P013396,4.95,-4,4,8
138,ULK,P006961,P007182,8.183,0,18,18
138,ULK,P006961,P008174,1.233,-6,0,6
138,ULK,P006961,P008962,16.9,-8,26,34
138,ULK,P006961,P009783,10.066,-12,16,28
138,ULK,P006961,P009863,4.8,4,10,6
138,ULK,P006961,P011205,5.217,-1,8,9
138,ULK,P006961,P013396,7.05,-14,7,21
138,ULK,P007182,P008962,19.117,-9,33,42
138,ULK,P007182,P009783,16.517,-9,31,40
138,ULK,P007182,P009863,7.417,-6,10,16
138,ULK,P007182,P011205,12.767,-4,18,22
138,ULK,P007182,P013396,3.833,-10,4,14
138,ULK,P008174,P013396,1.233,-6,0,6
138,ULK,P008962,P009783,27.483,-23,46,69
138,ULK,P008962,P009863,10.784,0,18,18
138,ULK,P008962,P011205,19.867,-8,33,41
138,ULK,P008962,P013396,9.25,-8,17,25
138,ULK,P009783,P009863,7.417,-6,10,16
138,ULK,P009783,P011205,16.7,-6,31,37
138,ULK,P009783,P013396,8.083,-6,17,23
138,ULK,P009863,P011205,7.417,-6,10,16
138,ULK,P011205,P013396,5.684,2,16,14
139,MAD,P003108,P003733,9.733,10,30,20
139,MAD,P003108,P005791,17.983,14,53,39
139,MAD,P003108,P005928,19.55,17,58,41
139,MAD,P003108,P006540,5.517,3,18,15
139,MAD,P003108,P007630,9.167,-2,22,24
139,MAD,P003108,P009005,18.899,11,53,42
139,MAD,P003108,P011247,8.117,-3,19,22
139,MAD,P003108,P011649,6.734,3,16,13
139,MAD,P003108,PTGB,12.9,-5,31,36
139,MAD,P003733,P005791,14.249,13,35,22
139,MAD,P003733,P005928,17.716,14,46,32
139,MAD,P003733,P006540,8.433,7,19,12
139,MAD,P003733,P007630,3.467,1,11,10
139,MAD,P003733,P009005,13.316,10,32,22
139,MAD,P003733,P011649,3.95,1,11,10
139,MAD,P005791,P005928,21.199,17,54,37
139,MAD,P005791,P006540,17.317,2,37,35
139,MAD,P005791,P009005,27.566,16,68,52
139,MAD,P005791,P009213,4.867,-5,5,10
139,MAD,P005791,P011247,9.634,-4,20,24
139,MAD,P005791,P011649,1.75,-1,0,1
139,MAD,P005791,PTGB,8.767,0,24,24
139,MAD,P005928,P006540,11.633,3,28,25
139,MAD,P005928,P007630,6.334,4,20,16
139,MAD,P005928,P009005,19.282,20,52,32
139,MAD,P005928,P011247,0.517,2,2,0
139,MAD,P005928,P011649,6.734,3,16,13
139,MAD,P005928,PTGB,7.167,4,20,16
139,MAD,P006540,P007630,1.05,0,2,2
139,MAD,P006540,P009005,16.85,4,33,29
139,MAD,P006540,P009213,4.867,-5,5,10
139,MAD,P006540,P011247,6.734,-1,11,12
139,MAD,P006540,PTGB,1.067,-5,3,8
139,MAD,P007630,P009005,4.183,-6,6,12
139,MAD,P007630,P011247,3.35,-4,4,8
139,MAD,P007630,P011649,4.984,4,16,12
139,MAD,P007630,PTGB,4.133,-5,7,12
139,MAD,P009005,P009213,4.867,-5,5,10
139,MAD,P009005,P011247,12.467,-10,22,32
139,MAD,P009005,PTGB,9.566,0,25,25
139,MAD,P009213,P011247,4.867,-5,5,10
139,MAD,P011247,P011649,0.517,2,2,0
139,MAD,P011247,PTGB,5.733,-9,11,20
139,MAD,P011649,PTGB,2.267,0,3,3
139,PRS,P004512,P005793,11.217,-6,12,18
139,PRS,P004512,P007032,1.817,-1,2,3
139,PRS,P004512,P012609,11.217,-6,12,18
139,PRS,P004512,P012611,9.4,-5,10,15
139,PRS,P004512,P012640,11.217,-6,12,18
139,PRS,P005793,P007032,7.684,-5,15,20
139,PRS,P005793,P010390,3.433,-3,6,9
139,PRS,P005793,P012609,16.167,-16,25,41
139,PRS,P005793,P012610,5.867,-4,13,17
139,PRS,P005793,P012611,12.6,-12,18,30
139,PRS,P005793,P012613,1.467,3,5,2
139,PRS,P005793,P012640,20.284,-17,33,50
139,PRS,P005793,P013373,2.417,-8,5,13
139,PRS,P007032,P010390,22.367,2,55,53
139,PRS,P007032,P012609,14.734,2,37,35
139,PRS,P007032,P012610,25.584,2,65,63
139,PRS,P007032,P012613,7.734,3,20,17
139,PRS,P007032,P012640,17.651,-9,39,48
139,PRS,P007032,P013373,12.033,10,35,25
139,PRS,P010390,P012609,11.95,7,33,26
139,PRS,P010390,P012610,22.367,2,55,53
139,PRS,P010390,P012611,0.783,1,3,2
139,PRS,P010390,P012613,6.267,0,15,15
139,PRS,P010390,P012640,13.4,-7,30,37
139,PRS,P010390,P013373,12.033,10,35,25
139,PRS,P012609,P012610,12.917,3,35,32
139,PRS,P012609,P012611,12.6,-12,18,30
139,PRS,P012609,P012613,5.017,6,13,7
139,PRS,P012609,P012640,17.584,-20,27,47
139,PRS,P012609,P013373,7.15,-4,20,24
139,PRS,P012610,P012613,7.734,3,20,17
139,PRS,P012610,P012640,15.834,-8,37,45
139,PRS,P012610,P013373,12.033,10,35,25
139,PRS,P012611,P012640,12.6,-12,18,30
139,PRS,P012611,P013373,2.417,-8,5,13
139,PRS,P012613,P012640,2.717,-3,7,10
139,PRS,P012640,P013373,9.717,-2,25,27
140,BER,P006251,P006919,5.983,-17,2,19
140,BER,P006251,P007025,5.25,-13,2,15
140,BER,P006251,P008173,2.65,-4,2,6
140,BER,P006251,P008780,5.25,-13,2,15
140,BER,P006251,P008967,2.65,-4,2,6
140,BER,P006251,P011631,1.917,0,2,2
140,BER,P006251,P012604,5.983,-17,2,19
140,BER,P006251,P013386,1.917,0,2,2
140,BER,P006919,P007025,12.017,-17,11,28
140,BER,P006919,P008173,1.433,-7,0,7
140,BER,P006919,P008780,12.7,-14,13,27
140,BER,P006919,P008967,2.116,-4,2,6
140,BER,P006919,P011631,3.767,-4,4,8
140,BER,P006919,P011934,4.383,0,7,7
140,BER,P006919,P012604,12.75,-21,11,32
140,BER,P006919,P013386,1.383,0,2,2
140,BER,P007025,P008173,1.583,-6,0,6
140,BER,P007025,P008211,4.717,-1,9,10
140,BER,P007025,P008780,15.151,-12,20,32
140,BER,P007025,P011631,8.484,-5,13,18
140,BER,P007025,P011934,3.0,0,5,5
140,BER,P007025,P012604,13.534,-19,12,31
140,BER,P007025,P013386,3.2,1,8,7
140,BER,P008173,P008211,16.45,-5,31,36
140,BER,P008173,P008967,21.717,-2,44,46
140,BER,P008173,P011631,6.3,1,13,12
140,BER,P008173,P011934,19.767,-1,42,43
140,BER,P008173,P012604,1.433,-7,0,7
140,BER,P008173,P013386,21.867,-1,44,45
140,BER,P008211,P008780,3.834,2,9,7
140,BER,P008211,P008967,15.567,-2,31,33
140,BER,P008211,P011631,4.717,-1,9,10
140,BER,P008211,P011934,15.567,-2,31,33
140,BER,P008211,P012604,1.517,-2,1,3
140,BER,P008211,P013386,18.767,-1,39,40
140,BER,P008780,P008967,1.55,0,2,2
140,BER,P008780,P011631,7.768,-2,13,15
140,BER,P008780,P011934,3.85,3,7,4
140,BER,P008780,P012604,12.834,-16,12,28
140,BER,P008780,P013386,3.867,4,10,6
140,BER,P008967,P011631,5.584,4,13,9
140,BER,P008967,P011934,20.617,2,44,42
140,BER,P008967,P012604,0.733,-4,0,4
140,BER,P008967,P013386,22.534,2,46,44
140,BER,P011631,P011934,3.667,4,11,7
140,BER,P011631,P012604,5.284,-6,5,11
140,BER,P011631,P013386,8.784,5,21,16
140,BER,P011934,P012604,3.0,0,5,5
140,BER,P011934,P013386,20.617,2,44,42
140,ZAL,P002329,P002676,4.167,-1,8,9
140,ZAL,P002329,P003048,8.783,1,22,21
140,ZAL,P002329,P005504,13.7,9,25,16
140,ZAL,P002329,P007029,18.534,3,38,35
140,ZAL,P002329,P007513,6.384,-13,8,21
140,ZAL,P002329,P007975,21.766,14,49,35
140,ZAL,P002329,P011051,2.017,-4,5,9
140,ZAL,P002329,P011983,6.033,7,16,9
140,ZAL,P002329,P012715,0.733,4,4,0
140,ZAL,P002329,P013403,15.883,4,33,29
140,ZAL,P002676,P003048,6.8,14,21,7
140,ZAL,P002676,P005504,9.45,1,16,15
140,ZAL,P002676,P007029,0.167,0,0,0
140,ZAL,P002676,P007513,10.0,12,24,12
140,ZAL,P002676,P007975,6.25,3,13,10
140,ZAL,P002676,P011983,5.85,7,13,6
140,ZAL,P002676,P012715,12.083,16,29,13
140,ZAL,P002676,P013403,10.233,8,24,16
140,ZAL,P003048,P007029,5.267,-4,10,14
140,ZAL,P003048,P007513,8.217,8,20,12
140,ZAL,P003048,P007975,7.049,6,19,13
140,ZAL,P003048,P011983,6.183,10,16,6
140,ZAL,P003048,P012715,5.983,17,19,2
140,ZAL,P003048,P013403,7.85,4,21,17
140,ZAL,P005504,P007029,14.666,9,28,19
140,ZAL,P005504,P007513,6.883,0,12,12
140,ZAL,P005504,P007975,17.933,8,32,24
140,ZAL,P005504,P011983,8.649,3,16,13
140,ZAL,P005504,P012715,10.249,1,19,18
140,ZAL,P005504,P013403,14.266,9,28,19
140,ZAL,P007029,P007513,5.417,-7,9,16
140,ZAL,P007029,P007975,18.95,3,37,34
140,ZAL,P007029,P011051,2.017,-4,5,9
140,ZAL,P007029,P011983,8.716,1,17,16
140,ZAL,P007029,P012715,3.416,-2,5,7
140,ZAL,P007029,P013403,10.65,5,23,18
140,ZAL,P007513,P007975,3.65,-5,5,10
140,ZAL,P007513,P011051,1.55,-3,3,6
140,ZAL,P007513,P011983,4.033,9,11,2
140,ZAL,P007513,P012715,10.266,18,27,9
140,ZAL,P007513,P013403,10.2,1,21,20
140,ZAL,P007975,P011051,2.017,-4,5,9
140,ZAL,P007975,P011983,11.266,3,23,20
140,ZAL,P007975,P012715,5.966,0,11,11
140,ZAL,P007975,P013403,13.149,12,30,18
140,ZAL,P011051,P011983,0.467,-1,2,3
140,ZAL,P011983,P012715,9.999,9,22,13
140,ZAL,P012715,P013403,6.233,9,16,7
141,BAS,P004058,P007230,4.35,-1,5,6
141,BAS,P004058,P008072,2.35,-1,3,4
141,BAS,P004058,P011085,6.0,-3,8,11
141,BAS,P004058,P011196,1.65,-2,3,5
141,BAS,P004058,P012201,3.65,-2,5,7
141,BAS,P004058,P012597,6.0,-3,8,11
141,BAS,P007230,P008072,13.634,21,40,19
141,BAS,P007230,P008850,1.85,1,5,4
141,BAS,P007230,P011085,16.734,13,42,29
141,BAS,P007230,P011196,11.283,-8,23,31
141,BAS,P007230,P011948,28.184,14,74,60
141,BAS,P007230,P012201,21.567,-1,48,49
141,BAS,P007230,P012597,17.234,16,45,29
141,BAS,P007230,P013367,15.3,-3,34,37
141,BAS,P008072,P011085,14.934,12,39,27
141,BAS,P008072,P011948,17.101,21,50,29
141,BAS,P008072,P012201,10.334,7,27,20
141,BAS,P008072,P012597,17.951,18,51,33
141,BAS,P008072,P013367,1.5,2,2,0
141,BAS,P008850,P011085,1.817,2,5,3
141,BAS,P008850,P011196,0.033,-1,0,1
141,BAS,P008850,P011948,1.85,1,5,4
141,BAS,P008850,P013367,1.85,1,5,4
141,BAS,P011085,P011196,1.65,-2,3,5
141,BAS,P011085,P011948,18.201,13,50,37
141,BAS,P011085,P012201,13.267,-5,27,32
141,BAS,P011085,P012597,21.684,7,49,42
141,BAS,P011085,P013367,2.517,3,9,6
141,BAS,P011196,P011948,11.283,-8,23,31
141,BAS,P011196,P012201,12.9,-9,26,35
141,BAS,P011196,P012597,1.65,-2,3,5
141,BAS,P011196,P013367,11.283,-8,23,31
141,BAS,P011948,P012201,25.384,-2,59,61
141,BAS,P011948,P012597,18.701,16,53,37
141,BAS,P011948,P013367,15.3,-3,34,37
141,BAS,P012201,P012597,15.584,0,35,35
141,BAS,P012201,P013367,13.45,-4,29,33
141,TEL,P005145,P006835,7.8,-6,14,20
141,TEL,P005145,P007519,7.65,-17,11,28
141,TEL,P005145,P007990,7.101,-12,10,22
141,TEL,P005145,P011193,7.667,-1,15,16
141,TEL,P005145,P011202,12.0,-18,18,36
141,TEL,P005145,P011219,7.517,-12,12,24
141,TEL,P005145,P013250,4.966,-3,9,12
141,TEL,P005145,P013381,3.317,0,8,8
141,TEL,P005145,P013382,3.25,-3,7,10
141,TEL,P006835,P007519,16.201,10,40,30
141,TEL,P006835,P007990,6.418,-1,10,11
141,TEL,P006835,P011193,20.617,8,51,43
141,TEL,P006835,P011202,9.184,-7,13,20
141,TEL,P006835,P011219,17.318,11,41,30
141,TEL,P006835,P013250,3.383,0,7,7
141,TEL,P006835,P013381,11.367,9,36,27
141,TEL,P006835,P013382,20.184,11,53,42
141,TEL,P006835,P013383,4.0,5,15,10
141,TEL,P007519,P007990,6.251,-14,4,18
141,TEL,P007519,P011193,7.7,8,21,13
141,TEL,P007519,P011202,11.034,-19,15,34
141,TEL,P007519,P011219,22.451,-1,47,48
141,TEL,P007519,P013250,1.583,-3,2,5
141,TEL,P007519,P013381,4.3,6,13,7
141,TEL,P007519,P013382,18.434,10,43,33
141,TEL,P007990,P011193,7.668,-5,14,19
141,TEL,P007990,P011202,6.718,-19,7,26
141,TEL,P007990,P011219,10.952,-17,13,30
141,TEL,P007990,P013381,8.201,-6,14,20
141,TEL,P007990,P013382,2.367,-2,0,2
141,TEL,P011193,P011202,6.217,-7,10,17
141,TEL,P011193,P011219,13.451,0,30,30
141,TEL,P011193,P013250,3.383,0,7,7
141,TEL,P011193,P013381,11.751,-4,29,33
141,TEL,P011193,P013382,12.75,8,36,28
141,TEL,P011193,P013383,4.0,5,15,10
141,TEL,P011202,P011219,11.451,-21,16,37
141,TEL,P011202,P013250,4.966,-3,9,12
141,TEL,P011202,P013381,1.867,-6,3,9
141,TEL,P011202,P013382,5.567,-4,9,13
141,TEL,P011219,P013250,1.583,-3,2,5
141,TEL,P011219,P013381,10.051,-2,22,24
141,TEL,P011219,P013382,18.034,9,41,32
141,TEL,P013381,P013382,9.35,6,28,22
141,TEL,P013381,P013383,4.0,5,15,10
141,TEL,P013382,P013383,4.0,5,15,10
144,ASV,P002100,P003526,6.733,2,14,12
144,ASV,P002100,P004194,7.833,-2,13,15
144,ASV,P002100,P007027,7.151,-2,11,13
144,ASV,P002100,P008991,7.583,-1,14,15
144,ASV,P002100,P010316,18.799,3,34,31
144,ASV,P002100,P010545,9.084,4,13,9
144,ASV,P002100,P011225,2.883,-4,5,9
144,ASV,P002100,P012731,11.366,-9,14,23
144,ASV,P002100,P013371,10.432,5,18,13
144,ASV,P003526,P004194,13.75,1,30,29
144,ASV,P003526,P007027,16.9,2,40,38
144,ASV,P003526,P008991,6.217,4,18,14
144,ASV,P003526,P010316,7.316,7,20,13
144,ASV,P003526,P010545,14.2,3,29,26
144,ASV,P003526,P011225,13.75,1,30,29
144,ASV,P003526,P012263,0.467,1,3,2
144,ASV,P003526,P012731,1.883,-3,3,6
144,ASV,P003526,P013371,5.516,6,13,7
144,ASV,P004194,P007027,18.117,4,42,38
144,ASV,P004194,P008991,2.367,5,9,4
144,ASV,P004194,P010316,10.683,-1,23,24
144,ASV,P004194,P010545,17.784,-2,34,36
144,ASV,P004194,P011225,16.516,0,40,40
144,ASV,P004194,P012731,4.282,-3,10,13
144,ASV,P004194,P013371,6.4,-2,11,13
144,ASV,P007027,P008991,4.784,4,16,12
144,ASV,P007027,P010316,12.901,0,26,26
144,ASV,P007027,P010545,20.951,-4,37,41
144,ASV,P007027,P011225,14.3,5,37,32
144,ASV,P007027,P012731,5.001,-3,7,10
144,ASV,P007027,P013371,4.767,-2,8,10
144,ASV,P008991,P010316,6.966,1,14,13
144,ASV,P008991,P011225,2.367,5,9,4
144,ASV,P008991,P012731,4.35,-2,5,7
144,ASV,P008991,P013371,5.166,0,7,7
144,ASV,P010316,P010545,15.651,5,31,26
144,ASV,P010316,P011225,3.433,0,12,12
144,ASV,P010316,P012263,0.467,1,3,2
144,ASV,P010316,P012731,10.65,-4,16,20
144,ASV,P010316,P013371,15.666,4,29,25
144,ASV,P010545,P011225,11.717,-1,25,26
144,ASV,P010545,P012263,0.467,1,3,2
144,ASV,P010545,P012731,3.901,-2,4,6
144,ASV,P010545,P013371,9.317,4,20,16
144,ASV,P011225,P012731,3.766,-2,10,12
144,ASV,P012263,P013371,0.467,1,3,2
144,ASV,P012731,P013371,4.933,0,7,7
144,PAR,P004761,P006760,9.884,-1,21,22
144,PAR,P004761,P008232,1.017,2,4,2
144,PAR,P004761,P011050,5.367,1,12,11
144,PAR,P004761,P011981,4.5,-2,9,11
144,PAR,P004761,P012720,8.867,-3,17,20
144,PAR,P004761,P013369,5.384,1,12,11
144,PAR,P004761,P013370,4.517,-2,9,11
144,PAR,P006760,P008232,8.167,14,24,10
144,PAR,P006760,P011050,8.767,4,21,17
144,PAR,P006760,P011836,16.9,6,30,24
144,PAR,P006760,P011981,23.25,6,47,41
144,PAR,P006760,P012167,1.15,3,5,2
144,PAR,P006760,P012720,25.517,-3,49,52
144,PAR,P006760,P013369,14.017,7,32,25
144,PAR,P006760,P013370,20.484,4,43,39
144,PAR,P008232,P011050,3.733,-6,4,10
144,PAR,P008232,P011836,5.5,11,15,4
144,PAR,P008232,P011981,8.934,14,27,13
144,PAR,P008232,P012720,6.15,-5,12,17
144,PAR,P008232,P013369,6.15,-5,12,17
144,PAR,P008232,P013370,11.017,7,26,19
144,PAR,P011050,P011836,1.4,-3,2,5
144,PAR,P011050,P012167,2.55,0,7,7
144,PAR,P011050,P012720,13.9,-5,27,32
144,PAR,P011050,P013369,13.9,-5,27,32
144,PAR,P011050,P013370,5.983,-6,8,14
144,PAR,P011836,P011981,18.967,2,32,30
144,PAR,P011836,P012167,3.467,-7,4,11
144,PAR,P011836,P012720,14.867,-12,19,31
144,PAR,P011836,P013369,6.85,-6,7,13
144,PAR,P011836,P013370,13.517,5,27,22
144,PAR,P011981,P012167,2.067,-4,2,6
144,PAR,P011981,P012720,19.567,-11,33,44
144,PAR,P011981,P013369,8.067,-1,16,17
144,PAR,P011981,P013370,18.984,4,42,38
144,PAR,P012167,P012720,4.617,-4,9,13
144,PAR,P012167,P013369,4.617,-4,9,13
144,PAR,P012720,P013369,21.984,-6,43,49
144,PAR,P012720,P013370,18.467,-15,31,46
144,PAR,P013369,P013370,6.967,-5,14,19
142,IST,P004887,P006590,6.8,14,17,3
142,IST,P004887,P007109,6.133,12,17,5
142,IST,P004887,P007200,10.6,12,24,12
142,IST,P004887,P009846,19.55,10,39,29
142,IST,P004887,P011078,14.767,-2,26,28
142,IST,P004887,P012710,14.967,-2,24,26
142,IST,P004887,P013363,10.5,-2,17,19
142,IST,P004887,P013364,1.083,-2,0,2
142,IST,P006590,P007109,16.083,25,50,25
142,IST,P006590,P007200,17.833,25,50,25
142,IST,P006590,P009846,5.25,14,15,1
142,IST,P006590,P011078,6.333,7,20,13
142,IST,P006590,P012710,1.75,0,0,0
142,IST,P006590,P012788,11.033,11,33,22
142,IST,P006590,P013364,6.25,4,15,11
142,IST,P007109,P007200,18.249,25,52,27
142,IST,P007109,P009846,5.666,14,17,3
142,IST,P007109,P011078,7.416,9,22,13
142,IST,P007109,P012788,12.116,13,35,22
142,IST,P007109,P013364,7.333,2,15,13
142,IST,P007200,P009846,11.95,11,28,17
142,IST,P007200,P011078,11.95,6,33,27
142,IST,P007200,P012710,6.284,-3,11,14
142,IST,P007200,P012788,13.933,10,39,29
142,IST,P007200,P013364,7.333,2,15,13
142,IST,P009846,P011078,21.084,-1,39,40
142,IST,P009846,P012710,21.751,-3,37,40
142,IST,P009846,P012788,7.867,1,15,14
142,IST,P009846,P013363,15.467,0,26,26
142,IST,P009846,P013364,1.083,-2,0,2
142,IST,P011078,P012710,20.001,-3,37,40
142,IST,P011078,P012788,12.65,8,33,25
142,IST,P011078,P013363,15.467,0,26,26
142,IST,P012710,P012788,6.784,-1,13,14
142,IST,P012710,P013363,15.467,0,26,26
142,IST,P012788,P013363,4.967,2,9,7
142,IST,P012788,P013364,6.25,4,15,11
142,RED,P000848,P002553,9.3,-13,19,32
142,RED,P000848,P004007,3.567,-3,6,9
142,RED,P000848,P004866,5.083,-9,11,20
142,RED,P000848,P006436,2.833,-5,6,11
142,RED,P000848,P009035,7.3,-6,5,11
142,RED,P000848,P009048,4.434,-3,4,7
142,RED,P000848,P010612,7.95,-7,7,14
142,RED,P000848,P011194,10.267,-6,14,20
142,RED,P000848,P012044,12.166,-16,20,36
142,RED,P000848,P012786,3.5,-8,4,12
142,RED,P002553,P004007,4.634,-4,8,12
142,RED,P002553,P004866,11.817,-10,25,35
142,RED,P002553,P006436,2.833,-5,6,11
142,RED,P002553,P009048,8.451,-2,18,20
142,RED,P002553,P010612,6.317,-1,14,15
142,RED,P002553,P011194,5.834,-3,13,16
142,RED,P002553,P012044,7.583,-12,15,27
142,RED,P002553,P012786,7.367,-6,14,20
142,RED,P004007,P004866,12.501,2,22,20
142,RED,P004007,P006436,0.15,0,0,0
142,RED,P004007,P009035,14.384,6,27,21
142,RED,P004007,P009048,15.301,5,29,24
142,RED,P004007,P010612,0.367,-3,0,3
142,RED,P004007,P011194,18.651,5,35,30
142,RED,P004007,P012044,6.517,0,13,13
142,RED,P004866,P006436,7.067,-15,10,25
142,RED,P004866,P009035,10.101,0,18,18
142,RED,P004866,P009048,20.452,-6,36,42
142,RED,P004866,P010612,4.701,-6,10,16
142,RED,P004866,P011194,16.951,1,31,30
142,RED,P004866,P012044,8.55,-14,15,29
142,RED,P004866,P012786,4.917,-3,10,13
142,RED,P006436,P009035,0.617,-5,0,5
142,RED,P006436,P009048,4.084,-10,4,14
142,RED,P006436,P010612,0.467,-5,0,5
142,RED,P006436,P011194,3.767,-5,4,9
142,RED,P006436,P012044,6.45,-10,10,20
142,RED,P009035,P009048,15.618,1,25,24
142,RED,P009035,P010612,6.334,-12,3,15
142,RED,P009035,P011194,19.517,5,30,25
142,RED,P009035,P012044,7.533,-1,12,13
142,RED,P009048,P010612,8.985,-9,14,23
142,RED,P009048,P011194,21.268,1,33,32
142,RED,P009048,P012044,6.567,-2,11,13
142,RED,P009048,P012786,5.584,1,14,13
142,RED,P010612,P011194,5.5,-4,3,7
142,RED,P010612,P012044,3.666,-4,3,7
142,RED,P010612,P012786,6.317,-1,14,15
142,RED,P011194,P012044,14.117,-6,25,31
142,RED,P012044,P012786,1.783,-7,0,7
143,OLY,P001255,P003469,19.233,28,50,22
143,OLY,P001255,P003941,14.349,12,30,18
143,OLY,P001255,P007853,1.8,-2,4,6
143,OLY,P001255,P007982,6.8,-5,11,16
143,OLY,P001255,P008811,9.217,12,25,13
143,OLY,P001255,P008829,4.333,-4,5,9
143,OLY,P001255,P008855,16.766,29,44,15
143,OLY,P001255,P013380,21.766,26,51,25
143,OLY,P003469,P003941,17.582,23,46,23
143,OLY,P003469,P007853,1.1,0,4,4
143,OLY,P003469,P007947,7.166,-9,15,24
143,OLY,P003469,P007982,6.6,-11,10,21
143,OLY,P003469,P008811,11.8,2,29,27
143,OLY,P003469,P008829,7.466,-4,17,21
143,OLY,P003469,P008855,20.699,38,60,22
143,OLY,P003469,P010392,2.566,1,9,8
143,OLY,P003469,P013380,23.316,32,60,28
143,OLY,P003941,P007853,3.434,-10,4,14
143,OLY,P003941,P007947,3.45,-5,8,13
143,OLY,P003941,P007982,4.45,-6,6,12
143,OLY,P003941,P008829,6.283,0,12,12
143,OLY,P003941,P008855,17.199,17,42,25
143,OLY,P003941,P010392,2.117,-5,4,9
143,OLY,P003941,P013380,17.732,18,40,22
143,OLY,P007853,P007947,4.667,-9,7,16
143,OLY,P007853,P007982,3.417,-4,4,8
143,OLY,P007853,P008811,4.65,-3,7,10
143,OLY,P007853,P008829,6.217,-7,7,14
143,OLY,P007853,P008855,0.767,-6,0,6
143,OLY,P007853,P010392,6.284,-11,7,18
143,OLY,P007947,P007982,2.4,-8,2,10
143,OLY,P007947,P008811,8.383,-13,14,27
143,OLY,P007947,P008829,8.383,-13,14,27
143,OLY,P007947,P008855,3.45,-5,8,13
143,OLY,P007947,P010392,7.233,-8,16,24
143,OLY,P007947,P013380,2.2,-2,4,6
143,OLY,P007982,P008811,6.367,-9,7,16
143,OLY,P007982,P008829,6.617,-12,5,17
143,OLY,P007982,P010392,1.617,-2,0,2
143,OLY,P007982,P013380,5.0,-3,7,10
143,OLY,P008811,P008829,11.033,-13,17,30
143,OLY,P008811,P008855,6.0,13,20,7
143,OLY,P008811,P010392,6.733,-5,12,17
143,OLY,P008811,P013380,9.217,12,25,13
143,OLY,P008829,P008855,4.716,4,12,8
143,OLY,P008829,P010392,7.6,-7,12,19
143,OLY,P008829,P013380,6.616,4,15,11
143,OLY,P008855,P010392,1.25,-3,4,7
143,OLY,P008855,P013380,21.949,33,58,25
143,VIR,P001844,P002084,0.35,0,0,0
143,VIR,P001844,P004554,7.733,-10,13,23
143,VIR,P001844,P004888,7.95,-12,8,20
143,VIR,P001844,P005738,8.383,-5,16,21
143,VIR,P001844,P006739,0.067,0,0,0
143,VIR,P001844,P009549,10.899,0,22,22
143,VIR,P001844,P011816,5.233,4,12,8
143,VIR,P001844,P012585,8.55,-1,16,17
143,VIR,P001844,P013374,11.65,7,23,16
143,VIR,P001844,PBCN,16.717,5,34,29
143,VIR,P002084,P004554,11.166,-12,13,25
143,VIR,P002084,P004888,10.183,-15,9,24
143,VIR,P002084,P006739,10.816,-12,13,25
143,VIR,P002084,P009549,6.366,-4,6,10
143,VIR,P002084,P012585,4.8,-8,7,15
143,VIR,P002084,PBCN,0.983,3,4,1
143,VIR,P004554,P004888,20.916,-26,28,54
143,VIR,P004554,P005738,8.717,-7,19,26
143,VIR,P004554,P006739,20.616,-7,41,48
143,VIR,P004554,P009549,19.882,-2,43,45
143,VIR,P004554,P011816,1.0,0,3,3
143,VIR,P004554,P012585,12.133,-10,23,33
143,VIR,P004554,PBCN,11.233,6,33,27
143,VIR,P004888,P005738,3.267,-13,0,13
143,VIR,P004888,P006739,16.533,-15,24,39
143,VIR,P004888,P009549,13.732,-12,19,31
143,VIR,P004888,P012585,14.417,-10,25,35
143,VIR,P004888,P013374,3.567,-1,4,5
143,VIR,P004888,PBCN,7.367,-4,11,15
143,VIR,P005738,P006739,4.117,2,13,11
143,VIR,P005738,P009549,7.283,4,21,17
143,VIR,P005738,P012585,3.8,-2,8,10
143,VIR,P005738,P013374,3.783,4,10,6
143,VIR,P005738,PBCN,10.65,5,29,24
143,VIR,P006739,P009549,15.149,4,34,30
143,VIR,P006739,P012585,9.134,-8,17,25
143,VIR,P006739,P013374,0.067,0,0,0
143,VIR,P006739,PBCN,6.233,8,22,14
143,VIR,P009549,P011816,5.233,4,12,8
143,VIR,P009549,P012585,5.083,0,12,12
143,VIR,P009549,P013374,6.166,6,13,7
143,VIR,P009549,PBCN,14.399,16,42,26
143,VIR,P011816,P013374,4.233,4,9,5
143,VIR,P011816,PBCN,5.233,4,12,8
143,VIR,P012585,P013374,5.484,1,10,9
143,VIR,P012585,PBCN,7.067,2,14,12
143,VIR,P013374,PBCN,11.65,7,23,16
145,BAS,P007230,P008072,13.449,-4,29,33
145,BAS,P007230,P008850,12.616,-2,29,31
145,BAS,P007230,P011085,6.133,-6,8,14
145,BAS,P007230,P011196,10.2,-14,16,30
145,BAS,P007230,P011948,12.067,-16,18,34
145,BAS,P007230,P012058,3.766,-7,2,9
145,BAS,P007230,P012201,20.583,-17,39,56
145,BAS,P007230,P012597,15.232,-7,31,38
145,BAS,P007230,P013367,12.35,-19,16,35
145,BAS,P008072,P008850,14.633,6,38,32
145,BAS,P008072,P010784,1.417,0,3,3
145,BAS,P008072,P011085,7.483,2,16,14
145,BAS,P008072,P011948,4.333,-1,8,9
145,BAS,P008072,P012058,2.35,-2,3,5
145,BAS,P008072,P012201,18.799,2,44,42
145,BAS,P008072,P012597,19.982,2,47,45
145,BAS,P008072,P013367,2.15,-5,0,5
145,BAS,P008850,P011085,6.533,-2,11,13
145,BAS,P008850,P011196,1.317,-8,0,8
145,BAS,P008850,P011948,2.467,-8,2,10
145,BAS,P008850,P012058,2.833,-5,2,7
145,BAS,P008850,P012201,15.95,-2,38,40
145,BAS,P008850,P012597,18.233,-4,40,44
145,BAS,P008850,P013367,0.55,-3,0,3
145,BAS,P010784,P011085,1.417,0,3,3
145,BAS,P010784,P012058,1.417,0,3,3
145,BAS,P010784,P012597,1.417,0,3,3
145,BAS,P011085,P011196,6.634,-7,10,17
145,BAS,P011085,P011948,8.184,-6,14,20
145,BAS,P011085,P012058,5.183,-7,5,12
145,BAS,P011085,P012201,9.634,-4,17,21
145,BAS,P011085,P012597,12.35,-5,20,25
145,BAS,P011085,P013367,4.717,-5,8,13
145,BAS,P011196,P011948,15.901,-30,20,50
145,BAS,P011196,P012201,13.651,-31,14,45
145,BAS,P011196,P012597,2.684,-7,2,9
145,BAS,P011196,P013367,13.217,-23,18,41
145,BAS,P011948,P012201,18.101,-32,22,54
145,BAS,P011948,P012597,5.967,-6,10,16
145,BAS,P011948,P013367,14.384,-25,18,43
145,BAS,P012058,P012597,5.183,-7,5,12
145,BAS,P012201,P012597,20.433,-3,46,49
145,BAS,P012201,P013367,13.117,-29,12,41
145,BAS,P012597,P013367,0.983,-3,0,3
145,PAN,P001926,P003842,4.117,0,10,10
145,PAN,P001926,P004088,7.934,-13,14,27
145,PAN,P001926,P005353,7.234,-12,11,23
145,PAN,P001926,P007866,9.451,-10,19,29
145,PAN,P001926,P009622,7.934,-13,14,27
145,PAN,P001926,P011204,4.067,-7,5,12
145,PAN,P001926,P011209,1.867,1,5,4
145,PAN,P001926,P011221,2.167,-5,3,8
145,PAN,P001926,P012712,3.717,-5,5,10
145,PAN,P001926,P012774,5.584,-4,10,14
145,PAN,P003842,P007866,1.867,1,5,4
145,PAN,P003842,P009622,0.45,-2,0,2
145,PAN,P003842,P011204,14.617,23,43,20
145,PAN,P003842,P011209,13.784,27,43,16
145,PAN,P003842,P012712,14.617,23,43,20
145,PAN,P003842,P012774,16.484,24,48,24
145,PAN,P004088,P005353,8.817,-4,18,22
145,PAN,P004088,P007866,13.884,5,37,32
145,PAN,P004088,P009622,16.634,7,43,36
145,PAN,P004088,P011204,1.05,0,2,2
145,PAN,P004088,P011209,1.417,-2,1,3
145,PAN,P004088,P011221,11.584,11,31,20
145,PAN,P004088,P011442,3.117,0,5,5
145,PAN,P004088,P012774,7.767,16,25,9
145,PAN,P005353,P007866,5.417,-6,11,17
145,PAN,P005353,P009622,7.4,-2,17,19
145,PAN,P005353,P011204,6.517,6,14,8
145,PAN,P005353,P011209,5.417,8,13,5
145,PAN,P005353,P011221,2.35,2,5,3
145,PAN,P005353,P011442,2.35,2,5,3
145,PAN,P005353,P012712,5.467,6,12,6
145,PAN,P005353,P012774,6.167,8,14,6
145,PAN,P007866,P009622,13.884,5,37,32
145,PAN,P007866,P011209,1.867,1,5,4
145,PAN,P007866,P011221,8.467,11,26,15
145,PAN,P007866,P012774,8.167,17,28,11
145,PAN,P009622,P011204,1.5,-2,2,4
145,PAN,P009622,P011221,10.167,13,30,17
145,PAN,P009622,P011442,1.7,2,4,2
145,PAN,P009622,P012712,0.45,-2,0,2
145,PAN,P009622,P012774,8.217,14,25,11
145,PAN,P011204,P011209,15.917,36,50,14
145,PAN,P011204,P012712,20.084,29,55,26
145,PAN,P011204,P012774,20.784,31,57,26
145,PAN,P011209,P011221,1.417,-2,1,3
145,PAN,P011209,P011442,1.417,-2,1,3
145,PAN,P011209,P012712,15.917,36,50,14
145,PAN,P011209,P012774,17.784,37,55,18
145,PAN,P011221,P011442,3.117,0,5,5
145,PAN,P011221,P012774,7.067,14,23,9
145,PAN,P011442,P012774,0.767,-2,0,2
145,PAN,P012712,P012774,20.084,29,55,26
147,MAD,P003108,P003583,5.766,-5,13,18
147,MAD,P003108,P003733,13.499,5,31,26
147,MAD,P003108,P005791,0.917,2,2,0
147,MAD,P003108,P005928,6.467,8,18,10
147,MAD,P003108,P006540,8.65,19,34,15
147,MAD,P003108,P007630,12.833,21,37,16
147,MAD,P003108,P009213,6.434,15,23,8
147,MAD,P003108,P011247,13.049,10,34,24
147,MAD,P003108,P011649,10.449,-3,16,19
147,MAD,P003583,P003733,11.233,-6,25,31
147,MAD,P003583,P005928,2.483,-2,7,9
147,MAD,P003583,P006540,7.467,5,19,14
147,MAD,P003583,P009005,6.184,3,16,13
147,MAD,P003583,P009213,3.317,-1,6,7
147,MAD,P003583,P011247,10.433,-9,20,29
147,MAD,P003583,P011649,5.133,-16,2,18
147,MAD,P003583,PTGB,6.184,3,16,13
147,MAD,P003733,P005791,0.367,2,2,0
147,MAD,P003733,P005928,8.167,4,19,15
147,MAD,P003733,P006540,4.15,6,13,7
147,MAD,P003733,P007630,8.8,10,18,8
147,MAD,P003733,P009005,6.901,1,14,13
147,MAD,P003733,P009213,0.417,2,2,0
147,MAD,P003733,P011247,11.316,2,26,24
147,MAD,P003733,P011649,10.849,-3,16,19
147,MAD,P003733,PTGB,5.901,1,14,13
147,MAD,P005791,P005928,5.267,4,12,8
147,MAD,P005791,P006540,10.067,6,24,18
147,MAD,P005791,P009005,9.517,6,24,18
147,MAD,P005791,P009213,10.067,6,24,18
147,MAD,P005791,P011247,5.167,4,14,10
147,MAD,P005791,PTGB,0.367,2,2,0
147,MAD,P005928,P006540,7.717,6,18,12
147,MAD,P005928,P007630,8.134,8,18,10
147,MAD,P005928,P009005,9.417,2,19,17
147,MAD,P005928,P009213,8.134,8,20,12
147,MAD,P005928,P011649,4.833,2,8,6
147,MAD,P005928,PTGB,2.917,0,9,9
147,MAD,P006540,P007630,5.617,11,19,8
147,MAD,P006540,P009005,11.901,8,26,18
147,MAD,P006540,P009213,19.001,16,49,33
147,MAD,P006540,P011247,13.8,12,40,28
147,MAD,P006540,P011649,2.6,-5,2,7
147,MAD,P006540,PTGB,1.634,4,4,0
147,MAD,P007630,P009005,2.184,0,0,0
147,MAD,P007630,P009213,6.634,13,21,8
147,MAD,P007630,P011247,6.883,13,19,6
147,MAD,P007630,P011649,8.916,8,16,8
147,MAD,P007630,PTGB,0.067,0,0,0
147,MAD,P009005,P009213,10.984,8,26,18
147,MAD,P009005,P011247,6.834,3,17,14
147,MAD,P009005,P011649,1.0,0,0,0
147,MAD,P009005,PTGB,6.618,5,18,13
147,MAD,P009213,P011247,11.167,6,27,21
147,MAD,P009213,P011649,3.2,-5,2,7
147,MAD,P009213,PTGB,0.717,4,4,0
147,MAD,P011247,P011649,9.216,-10,10,20
147,MAD,P011247,PTGB,2.067,1,5,4
147,MCO,P002581,P004790,8.45,2,20,18
147,MCO,P002581,P005763,8.483,2,20,18
147,MCO,P002581,P005985,11.033,-2,24,26
147,MCO,P002581,P008099,7.883,4,17,13
147,MCO,P002581,P008161,1.683,-1,2,3
147,MCO,P002581,P009754,1.0,-1,2,3
147,MCO,P002581,P011231,4.716,-6,8,14
147,MCO,P002581,P012515,5.216,-10,11,21
147,MCO,P004790,P005763,10.566,0,24,24
147,MCO,P004790,P005985,10.166,1,22,21
147,MCO,P004790,P008099,8.9,11,20,9
147,MCO,P004790,P009754,4.283,5,11,6
147,MCO,P004790,P011231,1.7,-1,2,3
147,MCO,P004790,P012515,5.833,-1,14,15
147,MCO,P004790,P013365,2.6,5,7,2
147,MCO,P004790,PLCZ,2.766,-2,4,6
147,MCO,P005763,P005844,1.484,-7,0,7
147,MCO,P005763,P005985,13.3,2,31,29
147,MCO,P005763,P008099,8.634,-2,14,16
147,MCO,P005763,P008161,0.8,-3,0,3
147,MCO,P005763,P009754,4.717,-2,12,14
147,MCO,P005763,P011231,1.85,-4,2,6
147,MCO,P005763,P012515,3.233,-6,7,13
147,MCO,P005763,P013365,4.501,-3,9,12
147,MCO,P005763,PLCZ,5.9,-1,13,14
147,MCO,P005844,P005985,1.85,-3,0,3
147,MCO,P005844,P008099,8.567,-17,8,25
147,MCO,P005844,P008161,3.617,-4,8,12
147,MCO,P005844,P009754,7.8,-14,8,22
147,MCO,P005844,P011231,7.85,-13,8,21
147,MCO,P005844,P012515,2.383,-6,0,6
147,MCO,P005844,P013365,0.717,-4,0,4
147,MCO,P005985,P008099,12.517,-1,18,19
147,MCO,P005985,P008161,1.65,-1,2,3
147,MCO,P005985,P009754,16.667,-8,32,40
147,MCO,P005985,P011231,9.1,-6,12,18
147,MCO,P005985,P012515,14.416,-16,27,43
147,MCO,P005985,P013365,10.984,-7,21,28
147,MCO,P005985,PLCZ,16.717,-7,31,38
147,MCO,P008099,P008161,5.3,-5,10,15
147,MCO,P008099,P009754,11.367,-9,17,26
147,MCO,P008099,P011231,13.533,-18,16,34
147,MCO,P008099,P012515,6.316,-4,9,13
147,MCO,P008099,P013365,4.784,0,8,8
147,MCO,P008099,PLCZ,3.867,-3,3,6
147,MCO,P008161,P009754,2.85,-1,8,9
147,MCO,P008161,P011231,5.3,-5,10,15
147,MCO,P009754,P011231,10.7,-9,16,25
147,MCO,P009754,P012515,14.833,-8,25,33
147,MCO,P009754,P013365,12.834,-5,27,32
147,MCO,P009754,PLCZ,13.817,-4,30,34
147,MCO,P011231,P012515,6.366,-8,8,16
147,MCO,P011231,PLCZ,3.617,2,6,4
147,MCO,P012515,P013365,9.8,-3,19,22
147,MCO,P012515,PLCZ,9.2,-6,16,22
147,MCO,P013365,PLCZ,10.984,-7,21,28
148,IST,P004887,P007200,6.367,0,13,13
148,IST,P004887,P009846,8.667,-4,18,22
148,IST,P004887,P011078,15.034,-4,31,35
148,IST,P004887,P012710,15.034,-4,31,35
148,IST,P004887,P013363,15.034,-4,31,35
148,IST,P006590,P007109,5.867,-3,4,7
148,IST,P006590,P007200,16.416,16,36,20
148,IST,P006590,P009846,7.5,2,15,13
148,IST,P006590,P011078,7.133,2,18,16
148,IST,P006590,P012710,13.766,17,37,20
148,IST,P006590,P012788,17.999,14,41,27
148,IST,P006590,P013363,2.85,9,9,0
148,IST,P006590,P013364,3.733,-1,4,5
148,IST,P007109,P007200,6.784,-5,4,9
148,IST,P007109,P009846,2.584,-4,0,4
148,IST,P007109,P011078,0.917,-2,0,2
148,IST,P007109,P012710,1.734,-2,0,2
148,IST,P007109,P012788,5.05,-3,4,7
148,IST,P007109,P013363,0.467,0,0,0
148,IST,P007109,P013364,3.733,-1,4,5
148,IST,P007200,P009846,7.15,5,14,9
148,IST,P007200,P011078,17.25,3,40,37
148,IST,P007200,P012710,23.883,18,59,41
148,IST,P007200,P012788,20.832,17,50,33
148,IST,P007200,P013363,13.317,7,32,25
148,IST,P007200,P013364,3.733,-1,4,5
148,IST,P009846,P011078,13.117,-5,27,32
148,IST,P009846,P012710,17.367,1,37,36
148,IST,P009846,P012788,7.816,5,19,14
148,IST,P009846,P013363,8.667,-4,18,22
148,IST,P011078,P012710,28.317,-3,63,66
148,IST,P011078,P012788,12.366,3,32,29
148,IST,P011078,P013363,19.134,-6,41,47
148,IST,P012710,P012788,18.182,18,51,33
148,IST,P012710,P013363,21.517,3,50,47
148,IST,P012788,P013363,6.95,7,19,12
148,IST,P012788,P013364,3.733,-1,4,5
148,PAR,P006760,P007632,5.983,-4,11,15
148,PAR,P006760,P007870,12.834,-14,18,32
148,PAR,P006760,P008232,14.801,1,34,33
148,PAR,P006760,P011836,8.55,-3,12,15
148,PAR,P006760,P011981,21.016,0,46,46
148,PAR,P006760,P012720,21.367,2,43,41
148,PAR,P006760,P013369,23.217,-12,45,57
148,PAR,P006760,P013370,8.7,-10,11,21
148,PAR,P007632,P007870,1.05,-4,0,4
148,PAR,P007632,P008232,0.4,4,4,0
148,PAR,P007632,P011836,4.55,-4,7,11
148,PAR,P007632,P011981,4.933,0,11,11
148,PAR,P007632,P012720,1.433,0,4,4
148,PAR,P007632,P013369,5.583,-8,7,15
148,PAR,P007870,P008232,7.951,2,13,11
148,PAR,P007870,P011836,2.617,-2,2,4
148,PAR,P007870,P011981,4.733,-4,9,13
148,PAR,P007870,P012720,13.134,0,19,19
148,PAR,P007870,P013369,13.5,-6,22,28
148,PAR,P007870,P013370,9.517,-4,13,17
148,PAR,P008232,P011981,17.733,0,43,43
148,PAR,P008232,P012720,23.517,7,53,46
148,PAR,P008232,P013369,23.784,1,51,50
148,PAR,P008232,P013370,14.55,-7,26,33
148,PAR,P011836,P011981,5.933,-1,10,11
148,PAR,P011836,P012720,4.0,1,5,4
148,PAR,P011836,P013369,4.55,-4,7,11
148,PAR,P011836,P013370,4.0,1,5,4
148,PAR,P011981,P012720,22.816,2,53,51
148,PAR,P011981,P013369,25.333,-9,54,63
148,PAR,P011981,P013370,11.099,-8,22,30
148,PAR,P012720,P013369,26.35,1,55,54
148,PAR,P012720,P013370,16.383,-1,28,29
148,PAR,P013369,P013370,14.083,-7,27,34
149,ASV,P002100,P003526,12.867,1,24,23
149,ASV,P002100,P007027,13.967,-8,25,33
149,ASV,P002100,P008991,18.316,3,36,33
149,ASV,P002100,P010316,9.884,1,20,19
149,ASV,P002100,P010545,3.967,-7,5,12
149,ASV,P002100,P011225,8.383,-1,14,15
149,ASV,P002100,P013371,11.933,2,23,21
149,ASV,P002100,P013405,11.483,1,25,24
149,ASV,P003526,P007027,5.734,-7,6,13
149,ASV,P003526,P008991,9.833,5,20,15
149,ASV,P003526,P010316,8.35,3,17,14
149,ASV,P003526,P010545,3.05,-6,2,8
149,ASV,P003526,P011225,3.0,-2,5,7
149,ASV,P003526,P013371,8.716,6,16,10
149,ASV,P003526,P013405,1.65,4,6,2
149,ASV,P007027,P008991,12.533,6,27,21
149,ASV,P007027,P010316,19.784,5,41,36
149,ASV,P007027,P010545,18.317,-8,31,39
149,ASV,P007027,P011225,21.7,-1,39,40
149,ASV,P007027,P013371,7.183,4,15,11
149,ASV,P007027,P013405,25.85,9,56,47
149,ASV,P008991,P010316,10.35,13,23,10
149,ASV,P008991,P011225,9.433,10,22,12
149,ASV,P008991,P013371,11.833,2,23,21
149,ASV,P008991,P013405,12.766,9,29,20
149,ASV,P010316,P010545,16.417,-6,30,36
149,ASV,P010316,P011225,15.583,8,33,25
149,ASV,P010316,P013371,9.217,4,16,12
149,ASV,P010316,P013405,19.151,8,40,32
149,ASV,P010545,P011225,13.4,-7,21,28
149,ASV,P010545,P013371,2.85,4,6,2
149,ASV,P010545,P013405,15.267,-2,29,31
149,ASV,P011225,P013405,19.833,5,38,33
149,ASV,P013371,P013405,7.4,2,17,15
149,ZAL,P002329,P002676,8.934,6,21,15
149,ZAL,P002329,P003048,5.417,0,12,12
149,ZAL,P002329,P005504,12.233,9,26,17
149,ZAL,P002329,P007029,11.299,2,22,20
149,ZAL,P002329,P007513,7.266,-3,11,14
149,ZAL,P002329,P007975,22.067,3,45,42
149,ZAL,P002329,P011051,4.417,-6,7,13
149,ZAL,P002329,P011983,2.267,-3,4,7
149,ZAL,P002329,P012622,3.234,3,9,6
149,ZAL,P002329,P013403,11.134,1,23,22
149,ZAL,P002676,P003048,11.617,4,29,25
149,ZAL,P002676,P005504,6.55,7,11,4
149,ZAL,P002676,P007029,6.967,2,13,11
149,ZAL,P002676,P007513,10.149,-6,15,21
149,ZAL,P002676,P007975,19.317,3,41,38
149,ZAL,P002676,P011051,4.983,-9,4,13
149,ZAL,P002676,P011983,3.133,-1,2,3
149,ZAL,P002676,P012622,4.45,0,8,8
149,ZAL,P002676,P012715,11.083,-3,21,24
149,ZAL,P002676,P013403,5.417,5,11,6
149,ZAL,P003048,P007029,8.417,-2,14,16
149,ZAL,P003048,P007513,11.116,-5,20,25
149,ZAL,P003048,P007975,13.184,1,30,29
149,ZAL,P003048,P011983,4.517,-6,5,11
149,ZAL,P003048,P012622,4.617,-1,9,10
149,ZAL,P003048,P012715,10.367,-3,22,25
149,ZAL,P003048,P013403,3.084,-4,3,7
149,ZAL,P005504,P007029,9.999,2,19,17
149,ZAL,P005504,P007513,3.483,4,6,2
149,ZAL,P005504,P007975,13.916,8,27,19
149,ZAL,P005504,P012715,1.683,-1,1,2
149,ZAL,P005504,P013403,7.8,3,18,15
149,ZAL,P007029,P007513,8.016,4,13,9
149,ZAL,P007029,P007975,17.033,-1,30,31
149,ZAL,P007029,P011051,0.167,0,0,0
149,ZAL,P007029,P012715,7.284,-2,11,13
149,ZAL,P007029,P013403,5.15,-5,10,15
149,ZAL,P007513,P007975,12.782,-2,22,24
149,ZAL,P007513,P011051,3.916,-6,2,8
149,ZAL,P007513,P011983,5.033,-5,5,10
149,ZAL,P007513,P012622,4.183,-6,3,9
149,ZAL,P007513,P012715,8.116,-3,15,18
149,ZAL,P007975,P011051,7.167,-10,9,19
149,ZAL,P007975,P011983,3.117,-2,6,8
149,ZAL,P007975,P012622,3.234,3,9,6
149,ZAL,P007975,P012715,11.35,-5,19,24
149,ZAL,P007975,P013403,13.901,-2,26,28
149,ZAL,P011051,P011983,2.783,-2,4,6
149,ZAL,P011051,P012622,2.8,-2,3,5
149,ZAL,P011051,P012715,2.75,-4,2,6
149,ZAL,P011051,P013403,3.017,-1,5,6
149,ZAL,P011983,P012622,4.183,-6,3,9
149,ZAL,P011983,P012715,1.9,-4,3,7
149,ZAL,P011983,P013403,2.267,-3,4,7
149,ZAL,P012622,P012715,1.9,-4,3,7
149,ZAL,P012622,P013403,1.067,1,1,0
149,ZAL,P012715,P013403,2.767,-3,3,6
150,BAR,P000925,P002939,18.333,-5,32,37
150,BAR,P000925,P003478,8.75,-7,16,23
150,BAR,P000925,P009862,21.283,-9,38,47
150,BAR,P000925,P009992,0.316,-1,0,1
150,BAR,P000925,P010106,2.867,-4,6,10
150,BAR,P000925,P012745,21.283,-9,38,47
150,BAR,P000925,P012795,12.3,-1,22,23
150,BAR,P002939,P003196,10.751,11,33,22
150,BAR,P002939,P003478,8.634,-2,18,20
150,BAR,P002939,P006568,0.717,0,2,2
150,BAR,P002939,P007464,4.417,1,11,10
150,BAR,P002939,P009862,25.867,2,53,51
150,BAR,P002939,P009992,4.184,3,14,11
150,BAR,P002939,P012745,25.401,5,56,51
150,BAR,P002939,P012795,20.968,9,49,40
150,BAR,P003196,P003478,2.017,1,6,5
150,BAR,P003196,P007464,5.333,1,11,10
150,BAR,P003196,P009862,9.15,7,23,16
150,BAR,P003196,P009992,7.067,1,18,17
150,BAR,P003196,P010106,2.2,-3,4,7
150,BAR,P003196,P012745,9.251,7,28,21
150,BAR,P003196,P012795,12.567,7,33,26
150,BAR,P003478,P006568,4.117,-4,4,8
150,BAR,P003478,P007464,3.334,-2,4,6
150,BAR,P003478,P009862,10.784,-6,22,28
150,BAR,P003478,P009992,4.117,-4,4,8
150,BAR,P003478,P010106,6.267,-8,8,16
150,BAR,P003478,P012745,11.567,-8,22,30
150,BAR,P003478,P012795,0.017,0,0,0
150,BAR,P006568,P007464,3.334,-2,4,6
150,BAR,P006568,P009992,4.117,-4,4,8
150,BAR,P006568,P010106,3.4,-4,2,6
150,BAR,P006568,P012745,0.783,-2,0,2
150,BAR,P007464,P009862,3.216,-1,4,5
150,BAR,P007464,P009992,7.084,0,13,13
150,BAR,P007464,P010106,2.617,-2,2,4
150,BAR,P007464,P012795,5.333,1,11,10
150,BAR,P009862,P009992,1.949,-1,2,3
150,BAR,P009862,P010106,2.867,-4,6,10
150,BAR,P009862,P012745,27.234,-1,57,58
150,BAR,P009862,P012795,19.45,5,39,34
150,BAR,P009992,P010106,5.6,-7,6,13
150,BAR,P009992,P012745,4.416,-4,9,13
150,BAR,P009992,P012795,7.15,1,18,17
150,BAR,P010106,P012745,5.85,-9,10,19
150,BAR,P010106,P012795,2.2,-3,4,7
150,BAR,P012745,P012795,19.551,5,44,39
150,VIR,P001844,P002084,7.566,-6,16,22
150,VIR,P001844,P004554,11.316,-3,17,20
150,VIR,P001844,P004888,10.567,0,18,18
150,VIR,P001844,P005738,7.6,-1,12,13
150,VIR,P001844,P006739,0.718,4,4,0
150,VIR,P001844,P009549,12.767,-2,23,25
150,VIR,P001844,P012585,4.983,-5,12,17
150,VIR,P001844,P013374,4.284,0,15,15
150,VIR,P001844,PBCN,2.667,1,11,10
150,VIR,P002084,P004554,8.033,-4,13,17
150,VIR,P002084,P004888,9.116,-3,16,19
150,VIR,P002084,P006739,11.717,2,20,18
150,VIR,P002084,P009549,12.899,-7,21,28
150,VIR,P002084,P012585,9.683,1,22,21
150,VIR,P002084,P013374,11.566,0,25,25
150,VIR,P002084,PBCN,7.816,1,19,18
150,VIR,P004554,P004888,21.267,-3,41,44
150,VIR,P004554,P005738,14.5,2,31,29
150,VIR,P004554,P006739,11.217,1,27,26
150,VIR,P004554,P009549,22.533,-2,44,46
150,VIR,P004554,P012585,1.266,1,3,2
150,VIR,P004888,P005738,14.367,0,29,29
150,VIR,P004888,P006739,15.884,5,37,32
150,VIR,P004888,P009549,26.65,3,55,52
150,VIR,P004888,P012585,2.783,4,8,4
150,VIR,P004888,P013374,5.366,6,14,8
150,VIR,P004888,PBCN,0.6,0,2,2
150,VIR,P005738,P006739,9.567,2,24,22
150,VIR,P005738,P009549,17.167,1,36,35
150,VIR,P005738,P012585,2.183,-1,5,6
150,VIR,P005738,P013374,2.667,-1,5,6
150,VIR,P005738,PBCN,0.617,2,2,0
150,VIR,P006739,P009549,20.401,8,48,40
150,VIR,P006739,P012585,9.933,9,23,14
150,VIR,P006739,P013374,13.284,11,29,18
150,VIR,P006739,PBCN,5.351,6,12,6
150,VIR,P009549,P012585,7.949,1,18,17
150,VIR,P009549,P013374,10.75,4,25,21
150,VIR,P009549,PBCN,2.084,2,6,4
150,VIR,P012585,P013374,13.383,3,32,29
150,VIR,P012585,PBCN,6.433,3,17,14
150,VIR,P013374,PBCN,8.5,5,23,18
151,BER,P006251,P006919,6.616,1,13,12
151,BER,P006251,P007025,5.166,1,8,7
151,BER,P006251,P007550,3.634,2,8,6
151,BER,P006251,P008173,4.017,-4,9,13
151,BER,P006251,P008211,7.334,-4,17,21
151,BER,P006251,P008780,6.082,1,13,12
151,BER,P006251,P008967,8.35,0,22,22
151,BER,P006251,P012604,7.317,1,14,13
151,BER,P006251,P013386,6.416,-2,16,18
151,BER,P006919,P007025,13.733,6,31,25
151,BER,P006919,P007550,4.734,8,15,7
151,BER,P006919,P008173,2.567,1,7,6
151,BER,P006919,P008211,1.767,2,7,5
151,BER,P006919,P008780,10.115,1,21,20
151,BER,P006919,P008967,1.916,2,5,3
151,BER,P006919,P011934,10.8,9,30,21
151,BER,P006919,P012604,13.383,7,31,24
151,BER,P006919,P013386,4.033,3,12,9
151,BER,P007025,P007550,4.017,8,10,2
151,BER,P007025,P008173,3.267,-1,7,8
151,BER,P007025,P008211,1.75,0,2,2
151,BER,P007025,P008780,8.199,-1,16,17
151,BER,P007025,P011631,1.05,2,2,0
151,BER,P007025,P011934,9.267,3,23,20
151,BER,P007025,P012604,11.983,7,26,19
151,BER,P007025,P013386,3.5,-1,7,8
151,BER,P007550,P008211,9.767,5,26,21
151,BER,P007550,P008967,6.95,1,17,16
151,BER,P007550,P011631,5.833,1,13,12
151,BER,P007550,P011934,5.067,5,16,11
151,BER,P007550,P012604,10.584,16,31,15
151,BER,P007550,P013386,0.35,-2,0,2
151,BER,P008173,P008211,9.334,-14,17,31
151,BER,P008173,P008967,8.634,-12,17,29
151,BER,P008173,P011934,7.884,-9,15,24
151,BER,P008173,P013386,11.901,-13,24,37
151,BER,P008211,P008780,5.25,-4,6,10
151,BER,P008211,P008967,20.834,-15,40,55
151,BER,P008211,P011631,8.383,5,17,12
151,BER,P008211,P011934,10.434,-17,18,35
151,BER,P008211,P012604,7.934,10,23,13
151,BER,P008211,P013386,14.617,-20,23,43
151,BER,P008780,P008967,7.166,-2,11,13
151,BER,P008780,P011631,2.55,4,4,0
151,BER,P008780,P011934,6.733,-8,10,18
151,BER,P008780,P012604,8.966,-1,16,17
151,BER,P008780,P013386,6.399,-2,11,13
151,BER,P008967,P011631,7.333,3,15,12
151,BER,P008967,P011934,8.867,-19,11,30
151,BER,P008967,P012604,5.8,6,14,8
151,BER,P008967,P013386,15.15,-16,28,44
151,BER,P011631,P011934,1.8,-3,3,6
151,BER,P011631,P012604,3.683,6,10,4
151,BER,P011631,P013386,2.9,2,4,2
151,BER,P011934,P012604,8.55,8,23,15
151,BER,P011934,P013386,9.334,-17,15,32
151,OLY,P001255,P003469,13.701,11,39,28
151,OLY,P001255,P003941,4.234,-1,7,8
151,OLY,P001255,P007947,0.35,2,2,0
151,OLY,P001255,P007982,6.567,3,18,15
151,OLY,P001255,P008811,10.8,12,34,22
151,OLY,P001255,P008829,1.683,2,4,2
151,OLY,P001255,P008855,8.817,10,25,15
151,OLY,P001255,P009849,3.917,1,7,6
151,OLY,P001255,P013380,11.467,12,36,24
151,OLY,P003469,P003941,9.234,-7,15,22
151,OLY,P003469,P007853,10.616,-8,21,29
151,OLY,P003469,P007947,14.966,-2,31,33
151,OLY,P003469,P007982,4.884,1,14,13
151,OLY,P003469,P008811,18.733,12,51,39
151,OLY,P003469,P008855,16.017,9,39,30
151,OLY,P003469,P009849,2.234,-1,3,4
151,OLY,P003469,P013380,22.883,13,59,46
151,OLY,P003941,P007853,10.366,-13,12,25
151,OLY,P003941,P007947,6.683,-4,12,16
151,OLY,P003941,P007982,6.75,-10,5,15
151,OLY,P003941,P008829,5.366,-7,4,11
151,OLY,P003941,P008855,1.167,0,2,2
151,OLY,P003941,P009849,7.6,-8,7,15
151,OLY,P003941,P013380,7.0,-6,12,18
151,OLY,P007853,P007947,10.616,-8,21,29
151,OLY,P007853,P007982,9.116,-6,13,19
151,OLY,P007853,P008811,10.249,1,27,26
151,OLY,P007853,P008829,9.999,-4,18,22
151,OLY,P007853,P008855,4.083,-3,11,14
151,OLY,P007853,P009849,9.999,-4,18,22
151,OLY,P007853,P013380,7.416,-3,15,18
151,OLY,P007947,P008811,7.933,0,17,17
151,OLY,P007947,P008855,7.55,1,16,15
151,OLY,P007947,P013380,11.766,3,25,22
151,OLY,P007982,P008811,8.933,7,26,19
151,OLY,P007982,P008829,10.799,-4,17,21
151,OLY,P007982,P009849,11.866,-5,18,23
151,OLY,P007982,P013380,3.817,2,13,11
151,OLY,P008811,P008829,6.316,5,18,13
151,OLY,P008811,P008855,15.383,9,40,31
151,OLY,P008811,P009849,6.316,5,18,13
151,OLY,P008811,P013380,15.533,17,45,28
151,OLY,P008829,P008855,0.883,2,5,3
151,OLY,P008829,P009849,11.682,-2,22,24
151,OLY,P008855,P009849,2.05,2,7,5
151,OLY,P008855,P013380,11.65,14,31,17
152,RED,P000848,P002553,7.234,10,22,12
152,RED,P000848,P004866,7.767,-3,12,15
152,RED,P000848,P006436,5.0,0,13,13
152,RED,P000848,P009035,10.567,-5,15,20
152,RED,P000848,P009048,5.833,-6,6,12
152,RED,P000848,P010612,5.184,10,14,4
152,RED,P000848,P011194,4.917,1,8,7
152,RED,P000848,P012044,11.818,9,29,20
152,RED,P000848,P012786,12.884,4,29,25
152,RED,P002553,P006436,8.184,6,18,12
152,RED,P002553,P010612,6.184,10,14,4
152,RED,P002553,P012044,10.801,13,27,14
152,RED,P002553,P012786,10.801,13,27,14
152,RED,P004866,P006436,8.684,4,25,21
152,RED,P004866,P009035,24.884,-5,48,53
152,RED,P004866,P009048,17.15,-13,23,36
152,RED,P004866,P010612,14.7,1,32,31
152,RED,P004866,P011194,14.1,-6,22,28
152,RED,P004866,P012044,8.434,3,23,20
152,RED,P004866,P012786,3.817,-1,7,8
152,RED,P006436,P009035,10.584,3,28,25
152,RED,P006436,P009048,6.817,-4,12,16
152,RED,P006436,P010612,11.201,10,27,17
152,RED,P006436,P011194,2.784,4,9,5
152,RED,P006436,P012044,12.801,10,34,24
152,RED,P006436,P012786,9.017,3,18,15
152,RED,P009035,P009048,20.7,-13,29,42
152,RED,P009035,P010612,18.634,4,38,34
152,RED,P009035,P011194,16.134,-1,28,29
152,RED,P009035,P012044,9.201,3,23,20
152,RED,P009035,P012786,6.1,-6,7,13
152,RED,P009048,P010612,13.95,-5,20,25
152,RED,P009048,P011194,15.984,-3,26,29
152,RED,P009048,P012044,0.85,-3,0,3
152,RED,P009048,P012786,1.516,-5,0,5
152,RED,P010612,P011194,10.617,1,19,18
152,RED,P010612,P012044,10.718,17,30,13
152,RED,P010612,P012786,8.084,8,14,6
152,RED,P012044,P012786,15.385,12,34,22
152,TEL,P005145,P006835,5.133,-7,4,11
152,TEL,P005145,P007519,1.516,-6,0,6
152,TEL,P005145,P007990,3.2,-4,2,6
152,TEL,P005145,P011193,4.434,-3,4,7
152,TEL,P005145,P011202,4.417,-5,4,9
152,TEL,P005145,P011219,3.417,-5,2,7
152,TEL,P005145,P013381,0.15,-2,0,2
152,TEL,P005145,P013382,1.533,-4,0,4
152,TEL,P006835,P007519,28.715,6,65,59
152,TEL,P006835,P007990,2.666,-2,2,4
152,TEL,P006835,P011193,24.266,17,50,33
152,TEL,P006835,P011202,9.516,-13,10,23
152,TEL,P006835,P011219,31.815,12,65,53
152,TEL,P006835,P013250,9.516,4,17,13
152,TEL,P006835,P013381,8.1,-9,14,23
152,TEL,P006835,P013382,27.865,12,65,53
152,TEL,P007519,P007990,1.649,-4,0,4
152,TEL,P007519,P011193,16.083,18,42,24
152,TEL,P007519,P011202,3.766,-13,4,17
152,TEL,P007519,P011219,24.649,15,59,44
152,TEL,P007519,P013250,4.95,4,13,9
152,TEL,P007519,P013381,7.2,-9,12,21
152,TEL,P007519,P013382,26.332,13,65,52
152,TEL,P007990,P011193,2.734,-5,2,7
152,TEL,P007990,P011202,3.617,-8,2,10
152,TEL,P007990,P011219,2.0,-7,0,7
152,TEL,P007990,P013382,1.666,-6,0,6
152,TEL,P011193,P011202,10.55,-19,9,28
152,TEL,P011193,P011219,23.799,5,42,37
152,TEL,P011193,P013250,5.949,0,7,7
152,TEL,P011193,P013381,2.483,-7,2,9
152,TEL,P011193,P013382,19.166,10,42,32
152,TEL,P011202,P011219,9.016,-19,5,24
152,TEL,P011202,P013250,3.566,-3,2,5
152,TEL,P011202,P013381,1.583,-7,0,7
152,TEL,P011202,P013382,4.433,-17,4,21
152,TEL,P011219,P013250,9.199,-2,14,16
152,TEL,P011219,P013381,8.067,-6,14,20
152,TEL,P011219,P013382,27.698,3,59,56
152,TEL,P013250,P013381,1.667,0,2,2
152,TEL,P013250,P013382,5.349,1,13,12
152,TEL,P013381,P013382,6.55,-8,12,20
153,MIL,P000796,P001392,21.566,1,41,40
153,MIL,P000796,P006085,15.283,-5,26,31
153,MIL,P000796,P007831,26.816,-10,49,59
153,MIL,P000796,P008985,8.017,-7,12,19
153,MIL,P000796,P008987,21.2,0,40,40
153,MIL,P000796,P011064,14.3,-1,27,28
153,MIL,P000796,P011199,6.133,4,13,9
153,MIL,P000796,P013384,2.767,4,4,0
153,MIL,P000796,P013385,2.25,-10,0,10
153,MIL,P001392,P006085,19.516,16,46,30
153,MIL,P001392,P007831,25.616,-1,51,52
153,MIL,P001392,P008985,3.433,8,10,2
153,MIL,P001392,P008987,22.916,3,48,45
153,MIL,P001392,P011064,9.533,-9,15,24
153,MIL,P001392,P011199,13.616,10,33,23
153,MIL,P006085,P007831,18.333,-2,36,38
153,MIL,P006085,P008985,7.15,-5,13,18
153,MIL,P006085,P008987,16.133,11,41,30
153,MIL,P006085,P011199,12.8,10,31,21
153,MIL,P006085,P013384,1.467,-3,3,6
153,MIL,P006085,P013385,2.25,-10,0,10
153,MIL,P007831,P008985,5.683,-11,8,19
153,MIL,P007831,P008987,22.916,-6,46,52
153,MIL,P007831,P011064,12.966,-10,23,33
153,MIL,P007831,P011199,10.616,2,23,21
153,MIL,P007831,P013385,2.25,-10,0,10
153,MIL,P008985,P008987,12.133,10,27,17
153,MIL,P008985,P011064,7.233,5,14,9
153,MIL,P008985,P011199,6.366,7,15,8
153,MIL,P008985,P013384,5.267,3,9,6
153,MIL,P008985,P013385,2.25,-10,0,10
153,MIL,P008987,P011064,15.483,-6,24,30
153,MIL,P008987,P011199,10.416,5,25,20
153,MIL,P008987,P013384,5.267,3,9,6
153,MIL,P011064,P011199,3.749,-1,7,8
153,MIL,P011064,P013384,3.8,6,6,0
153,MIL,P011199,P013384,2.5,-1,5,6
153,MUN,P001557,P004508,1.417,-2,0,2
153,MUN,P001557,P007056,8.117,-1,12,13
153,MUN,P001557,P007201,10.45,3,15,12
153,MUN,P001557,P010391,6.633,2,10,8
153,MUN,P001557,P011224,4.817,0,7,7
153,MUN,P001557,P011987,9.467,4,17,13
153,MUN,P001557,P013368,3.767,2,7,5
153,MUN,P004508,P007056,25.65,4,55,51
153,MUN,P004508,P007201,23.367,10,53,43
153,MUN,P004508,P007639,4.2,-5,7,12
153,MUN,P004508,P007929,4.2,-5,7,12
153,MUN,P004508,P010391,23.367,10,53,43
153,MUN,P004508,P011224,7.6,-13,9,22
153,MUN,P004508,P011244,6.483,-11,9,20
153,MUN,P004508,P011987,23.116,8,55,47
153,MUN,P007056,P007201,29.35,12,63,51
153,MUN,P007056,P010391,28.983,12,63,51
153,MUN,P007056,P011224,5.567,-13,4,17
153,MUN,P007056,P011244,2.283,-6,2,8
153,MUN,P007056,P011987,29.933,7,67,60
153,MUN,P007056,P013368,1.117,-3,2,5
153,MUN,P007201,P010391,28.583,14,63,49
153,MUN,P007201,P011224,5.217,-1,5,6
153,MUN,P007201,P011987,29.583,19,68,49
153,MUN,P007201,P013368,3.05,3,5,2
153,MUN,P007639,P007929,4.2,-5,7,12
153,MUN,P007639,P011224,4.2,-5,7,12
153,MUN,P007639,P011244,4.2,-5,7,12
153,MUN,P007929,P011224,4.2,-5,7,12
153,MUN,P007929,P011244,4.2,-5,7,12
153,MUN,P010391,P011224,1.8,-4,0,4
153,MUN,P010391,P011987,26.166,16,63,47
153,MUN,P010391,P013368,0.4,-2,0,2
153,MUN,P011224,P011244,6.483,-11,9,20
153,MUN,P011224,P011987,7.217,-8,9,17
153,MUN,P011224,P013368,4.167,0,7,7
153,MUN,P011244,P011987,2.283,-6,2,8
153,MUN,P011987,P013368,4.167,0,7,7
154,IST,P004887,P006590,9.0,-4,17,21
154,IST,P004887,P007109,8.05,3,16,13
154,IST,P004887,P007200,18.15,0,35,35
154,IST,P004887,P009664,2.75,-2,5,7
154,IST,P004887,P009846,17.8,-6,29,35
154,IST,P004887,P011078,9.534,-10,12,22
154,IST,P004887,P012710,12.367,-11,18,29
154,IST,P004887,P013363,15.017,-10,24,34
154,IST,P006590,P007109,3.5,3,8,5
154,IST,P006590,P007200,17.599,-10,33,43
154,IST,P006590,P009513,0.033,0,0,0
154,IST,P006590,P009664,8.216,-8,12,20
154,IST,P006590,P009846,4.366,-2,7,9
154,IST,P006590,P011078,14.766,-8,28,36
154,IST,P006590,P012710,9.583,-8,19,27
154,IST,P006590,P012788,12.299,-9,22,31
154,IST,P006590,P013363,5.966,-6,10,16
154,IST,P007109,P007200,12.134,6,30,24
154,IST,P007109,P009513,0.333,-2,0,2
154,IST,P007109,P009846,11.967,5,30,25
154,IST,P007109,P011078,7.75,3,22,19
154,IST,P007109,P012788,7.75,3,22,19
154,IST,P007109,P013363,11.716,3,24,21
154,IST,P007200,P009513,0.033,0,0,0
154,IST,P007200,P009664,8.216,-8,12,20
154,IST,P007200,P009846,16.183,3,35,32
154,IST,P007200,P011078,15.05,-3,34,37
154,IST,P007200,P012710,9.033,-3,19,22
154,IST,P007200,P012788,11.233,-5,26,31
154,IST,P007200,P013363,10.033,0,20,20
154,IST,P009513,P011078,0.366,-2,0,2
154,IST,P009513,P012788,0.333,-2,0,2
154,IST,P009513,P013363,0.366,-2,0,2
154,IST,P009664,P009846,3.483,-4,5,9
154,IST,P009664,P011078,4.733,-4,7,11
154,IST,P009664,P012788,5.466,-6,7,13
154,IST,P009846,P011078,10.534,-7,20,27
154,IST,P009846,P012710,7.25,-7,8,15
154,IST,P009846,P012788,4.9,0,14,14
154,IST,P009846,P013363,14.317,-6,24,30
154,IST,P011078,P012710,13.117,-16,19,35
154,IST,P011078,P012788,16.066,-7,36,43
154,IST,P011078,P013363,10.616,-14,14,28
154,IST,P012710,P012788,3.583,-6,7,13
154,IST,P012710,P013363,8.867,-17,10,27
154,IST,P012788,P013363,5.566,-4,10,14
154,MCO,P002581,P005985,11.899,6,29,23
154,MCO,P002581,P008099,6.216,-3,11,14
154,MCO,P002581,P008161,0.633,0,0,0
154,MCO,P002581,P009754,10.566,7,28,21
154,MCO,P002581,P011212,6.099,5,14,9
154,MCO,P002581,P011231,6.25,6,18,12
154,MCO,P002581,P012515,7.583,3,20,17
154,MCO,P002581,P013365,8.082,0,16,16
154,MCO,P005844,P005985,5.366,-5,5,10
154,MCO,P005844,P008099,9.749,3,20,17
154,MCO,P005844,P009754,7.083,6,17,11
154,MCO,P005844,P011212,11.099,2,21,19
154,MCO,P005844,P011231,8.366,5,20,15
154,MCO,P005844,P013365,2.733,-3,1,4
154,MCO,P005985,P008099,9.715,-9,12,21
154,MCO,P005985,P009754,17.533,17,49,32
154,MCO,P005985,P011212,13.015,-4,24,28
154,MCO,P005985,P011231,11.299,1,26,25
154,MCO,P005985,P012515,14.433,15,40,25
154,MCO,P005985,P013365,18.299,7,41,34
154,MCO,P005985,PLCZ,10.833,8,30,22
154,MCO,P008099,P009754,11.916,8,30,22
154,MCO,P008099,P011212,19.198,8,42,34
154,MCO,P008099,P011231,18.465,8,42,34
154,MCO,P008099,P012515,1.133,-5,0,5
154,MCO,P008099,P013365,2.516,-7,0,7
154,MCO,P008099,PLCZ,5.016,1,11,10
154,MCO,P008161,P009754,0.633,0,0,0
154,MCO,P008161,P011212,0.633,0,0,0
154,MCO,P008161,P013365,0.633,0,0,0
154,MCO,P009754,P011212,16.632,12,42,30
154,MCO,P009754,P011231,14.516,12,41,29
154,MCO,P009754,P012515,12.15,17,37,20
154,MCO,P009754,P013365,14.916,15,38,23
154,MCO,P009754,PLCZ,11.783,14,34,20
154,MCO,P011212,P011231,19.598,6,46,40
154,MCO,P011212,P013365,5.666,-4,8,12
154,MCO,P011212,PLCZ,7.716,-1,19,20
154,MCO,P011231,P012515,2.317,7,10,3
154,MCO,P011231,P013365,1.5,-1,3,4
154,MCO,P011231,PLCZ,7.949,0,18,18
154,MCO,P012515,P013365,13.266,11,33,22
154,MCO,P012515,PLCZ,6.85,12,20,8
154,MCO,P013365,PLCZ,8.117,10,24,14
155,BER,P006251,P006919,5.667,3,12,9
155,BER,P006251,P007550,3.8,2,8,6
155,BER,P006251,P008173,3.8,2,8,6
155,BER,P006251,P008211,15.183,2,25,23
155,BER,P006251,P008780,17.05,3,29,26
155,BER,P006251,P008967,17.05,3,29,26
155,BER,P006251,P011631,0.05,0,0,0
155,BER,P006251,P011934,2.85,-3,3,6
155,BER,P006251,P013386,17.95,8,34,26
155,BER,P006919,P007025,4.583,-11,6,17
155,BER,P006919,P007550,7.717,1,14,13
155,BER,P006919,P008173,15.634,-12,26,38
155,BER,P006919,P008780,5.4,1,12,11
155,BER,P006919,P008967,3.2,-1,6,7
155,BER,P006919,P011631,7.633,-13,12,25
155,BER,P006919,P011934,12.683,-17,17,34
155,BER,P006919,P013386,10.551,5,23,18
155,BER,P007025,P008173,4.583,-11,6,17
155,BER,P007025,P011631,4.583,-11,6,17
155,BER,P007025,P011934,4.583,-11,6,17
155,BER,P007550,P008173,7.717,1,14,13
155,BER,P007550,P011934,6.767,-4,9,13
155,BER,P007550,P013386,4.867,4,11,7
155,BER,P008173,P008780,2.767,0,6,6
155,BER,P008173,P008967,0.567,-2,0,2
155,BER,P008173,P011631,7.35,-11,12,23
155,BER,P008173,P011934,11.917,-17,15,32
155,BER,P008173,P013386,8.201,2,17,15
155,BER,P008211,P008780,21.733,0,37,37
155,BER,P008211,P008967,21.733,0,37,37
155,BER,P008211,P011934,6.55,-2,12,14
155,BER,P008211,P013386,21.733,0,37,37
155,BER,P008780,P008967,24.366,1,43,42
155,BER,P008780,P011631,3.05,-2,6,8
155,BER,P008780,P011934,7.316,-2,14,16
155,BER,P008780,P013386,26.85,3,49,46
155,BER,P008967,P011631,0.283,-2,0,2
155,BER,P008967,P011934,7.883,-4,14,18
155,BER,P008967,P013386,24.65,1,43,42
155,BER,P011631,P011934,4.816,-13,6,19
155,BER,P011631,P013386,2.767,0,6,6
155,BER,P011934,P013386,11.567,-3,20,23
155,MAD,P003108,P003733,4.083,4,14,10
155,MAD,P003108,P005791,15.116,2,27,25
155,MAD,P003108,P005928,12.083,7,30,23
155,MAD,P003108,P006540,8.583,3,18,15
155,MAD,P003108,P007630,9.834,8,26,18
155,MAD,P003108,P009005,9.467,3,21,18
155,MAD,P003108,P011247,12.867,3,23,20
155,MAD,P003108,P011649,8.033,1,14,13
155,MAD,P003108,PTGB,19.734,9,39,30
155,MAD,P003733,P005791,17.317,0,32,32
155,MAD,P003733,P005928,17.316,6,38,32
155,MAD,P003733,P006540,17.533,1,33,32
155,MAD,P003733,P007630,1.583,3,7,4
155,MAD,P003733,P009005,16.65,5,35,30
155,MAD,P003733,P011247,1.817,-1,3,4
155,MAD,P003733,PTGB,0.233,2,2,0
155,MAD,P005791,P005928,21.6,4,41,37
155,MAD,P005791,P006540,22.467,2,41,39
155,MAD,P005791,P009005,19.084,-2,32,34
155,MAD,P005791,P011247,7.4,-3,9,12
155,MAD,P005791,P011649,2.466,-3,0,3
155,MAD,P005791,PTGB,10.55,4,18,14
155,MAD,P005928,P006540,22.766,6,45,39
155,MAD,P005928,P007630,4.433,4,14,10
155,MAD,P005928,P009005,17.683,7,39,32
155,MAD,P005928,P011649,1.133,-3,0,3
155,MAD,P005928,PTGB,8.05,9,21,12
155,MAD,P006540,P007630,0.933,0,2,2
155,MAD,P006540,P009005,15.05,1,27,26
155,MAD,P006540,P011247,0.867,-2,0,2
155,MAD,P006540,P011649,1.133,-3,0,3
155,MAD,P006540,PTGB,5.2,8,14,6
155,MAD,P007630,P009005,5.2,4,14,10
155,MAD,P007630,P011247,6.334,4,14,10
155,MAD,P007630,P011649,5.567,4,14,10
155,MAD,P007630,PTGB,9.184,5,21,16
155,MAD,P009005,P011247,6.834,-3,9,12
155,MAD,P009005,PTGB,8.1,1,15,14
155,MAD,P011247,P011649,6.9,4,14,10
155,MAD,P011247,PTGB,11.917,2,20,18
155,MAD,P011649,PTGB,6.9,4,14,10
157,TEL,P005145,P006835,1.717,4,4,0
157,TEL,P005145,P007519,1.4,0,3,3
157,TEL,P005145,P011193,1.717,4,4,0
157,TEL,P005145,P011202,1.717,4,4,0
157,TEL,P005145,P012604,1.4,0,3,3
157,TEL,P005145,P013250,3.117,4,7,3
157,TEL,P005145,P013381,1.4,0,3,3
157,TEL,P006835,P007519,22.4,13,51,38
157,TEL,P006835,P007990,12.533,15,35,20
157,TEL,P006835,P011193,23.05,21,52,31
157,TEL,P006835,P011202,4.2,3,8,5
157,TEL,P006835,P011219,20.417,19,46,27
157,TEL,P006835,P012604,8.966,4,23,19
157,TEL,P006835,P013250,4.6,2,8,6
157,TEL,P006835,P013381,4.783,-1,12,13
157,TEL,P006835,P013382,23.266,16,53,37
157,TEL,P007519,P007990,6.817,2,19,17
157,TEL,P007519,P011193,14.35,7,30,23
157,TEL,P007519,P011202,4.634,1,11,10
157,TEL,P007519,P011219,15.334,13,37,24
157,TEL,P007519,P012604,13.434,-1,33,34
157,TEL,P007519,P013250,6.434,0,14,14
157,TEL,P007519,P013381,8.434,-5,17,22
157,TEL,P007519,P013382,17.167,6,37,31
157,TEL,P007990,P011193,7.633,9,20,11
157,TEL,P007990,P011202,2.667,-2,8,10
157,TEL,P007990,P011219,6.517,8,16,8
157,TEL,P007990,P012604,10.617,0,31,31
157,TEL,P007990,P013250,2.65,-1,8,9
157,TEL,P007990,P013381,8.984,-4,24,28
157,TEL,P007990,P013382,10.05,9,27,18
157,TEL,P011193,P011202,1.717,4,4,0
157,TEL,P011193,P011219,18.067,17,42,25
157,TEL,P011193,P012604,3.916,-1,8,9
157,TEL,P011193,P013250,1.717,4,4,0
157,TEL,P011193,P013381,0.65,-1,2,3
157,TEL,P011193,P013382,21.983,16,50,34
157,TEL,P011202,P011219,3.284,4,11,7
157,TEL,P011202,P012604,5.201,-3,15,18
157,TEL,P011202,P013250,9.384,1,23,22
157,TEL,P011202,P013381,4.417,-9,8,17
157,TEL,P011202,P013382,0.383,-3,0,3
157,TEL,P011219,P012604,1.184,2,7,5
157,TEL,P011219,P013250,3.267,5,11,6
157,TEL,P011219,P013381,0.017,-1,0,1
157,TEL,P011219,P013382,18.317,17,42,25
157,TEL,P012604,P013250,6.984,-3,18,21
157,TEL,P012604,P013381,11.751,-8,27,35
157,TEL,P012604,P013382,6.483,-2,15,17
157,TEL,P013250,P013381,5.8,-8,11,19
157,TEL,P013250,P013382,0.783,-4,0,4
157,TEL,P013381,P013382,2.3,-7,4,11
157,ZAL,P002329,P002676,3.583,0,8,8
157,ZAL,P002329,P003048,9.233,0,19,19
157,ZAL,P002329,P005504,3.7,-6,5,11
157,ZAL,P002329,P007029,5.45,4,15,11
157,ZAL,P002329,P007513,9.05,-3,19,22
157,ZAL,P002329,P007975,4.533,-4,8,12
157,ZAL,P002329,P011051,0.65,-1,3,4
157,ZAL,P002329,P011983,2.517,-2,6,8
157,ZAL,P002329,P012622,5.583,-5,10,15
157,ZAL,P002329,P013403,10.033,-11,15,26
157,ZAL,P002676,P003048,10.633,-8,16,24
157,ZAL,P002676,P005504,1.717,-4,0,4
157,ZAL,P002676,P007029,10.55,3,27,24
157,ZAL,P002676,P007513,13.184,-5,27,32
157,ZAL,P002676,P007975,15.049,-5,29,34
157,ZAL,P002676,P011051,8.833,0,22,22
157,ZAL,P002676,P012622,2.983,-5,0,5
157,ZAL,P002676,P012715,5.217,-6,6,12
157,ZAL,P002676,P013403,12.983,-18,17,35
157,ZAL,P003048,P007029,7.4,4,17,13
157,ZAL,P003048,P007513,13.15,-4,22,26
157,ZAL,P003048,P007975,9.183,-11,9,20
157,ZAL,P003048,P012622,5.533,-6,7,13
157,ZAL,P003048,P012715,3.5,-2,6,8
157,ZAL,P003048,P013403,16.3,-17,20,37
157,ZAL,P005504,P007029,2.1,-1,3,4
157,ZAL,P005504,P007513,3.0,-4,5,9
157,ZAL,P005504,P007975,3.183,0,6,6
157,ZAL,P005504,P011983,1.867,-1,3,4
157,ZAL,P005504,P012622,3.7,-6,5,11
157,ZAL,P005504,P012715,2.1,-1,3,4
157,ZAL,P005504,P013403,1.833,-5,2,7
157,ZAL,P007029,P007513,15.85,11,44,33
157,ZAL,P007029,P007975,10.066,1,28,27
157,ZAL,P007029,P011051,13.033,2,37,35
157,ZAL,P007029,P011983,2.6,-5,5,10
157,ZAL,P007029,P012622,5.783,3,16,13
157,ZAL,P007029,P012715,4.9,-3,8,11
157,ZAL,P007029,P013403,12.4,1,28,27
157,ZAL,P007513,P007975,8.683,3,21,18
157,ZAL,P007513,P011051,9.25,7,30,23
157,ZAL,P007513,P012622,9.666,0,21,21
157,ZAL,P007513,P012715,2.95,1,6,5
157,ZAL,P007513,P013403,16.817,-10,33,43
157,ZAL,P007975,P011051,10.916,-2,27,29
157,ZAL,P007975,P011983,4.467,-6,8,14
157,ZAL,P007975,P012622,7.683,-9,5,14
157,ZAL,P007975,P012715,4.983,-5,8,13
157,ZAL,P007975,P013403,14.382,-14,19,33
157,ZAL,P011051,P011983,2.6,-5,5,10
157,ZAL,P011051,P012622,5.816,5,14,9
157,ZAL,P011051,P012715,1.95,-4,2,6
157,ZAL,P011051,P013403,8.816,2,24,22
157,ZAL,P011983,P012622,1.867,-1,3,4
157,ZAL,P011983,P012715,1.95,-4,2,6
157,ZAL,P012622,P013403,11.582,-4,23,27
157,ZAL,P012715,P013403,2.65,-4,3,7
156,MIL,P000796,P001392,8.683,5,23,18
156,MIL,P000796,P001518,9.85,2,22,20
156,MIL,P000796,P006085,9.483,0,22,22
156,MIL,P000796,P006509,7.867,0,18,18
156,MIL,P000796,P007831,22.917,0,51,51
156,MIL,P000796,P008985,22.667,0,48,48
156,MIL,P000796,P008987,20.15,3,47,44
156,MIL,P000796,P011064,18.383,10,45,35
156,MIL,P001392,P001518,13.016,7,28,21
156,MIL,P001392,P006085,14.333,1,30,29
156,MIL,P001392,P006509,8.583,6,21,15
156,MIL,P001392,P007831,6.6,-3,12,15
156,MIL,P001392,P008985,3.5,-4,4,8
156,MIL,P001392,P008987,7.9,-7,12,19
156,MIL,P001392,P011064,4.35,-2,7,9
156,MIL,P001392,P011941,2.317,-5,2,7
156,MIL,P001392,P013385,5.45,-2,9,11
156,MIL,P001518,P006085,9.933,6,23,17
156,MIL,P001518,P006509,10.5,3,23,20
156,MIL,P001518,P007831,5.0,-2,7,9
156,MIL,P001518,P008985,3.267,-3,4,7
156,MIL,P001518,P008987,2.233,1,3,2
156,MIL,P001518,P011064,3.083,1,5,4
156,MIL,P001518,P011941,0.167,-1,0,1
156,MIL,P001518,P013385,2.683,2,5,3
156,MIL,P006085,P006509,8.583,6,21,15
156,MIL,P006085,P007831,5.167,-9,8,17
156,MIL,P006085,P008985,5.083,-8,7,15
156,MIL,P006085,P008987,6.65,-11,10,21
156,MIL,P006085,P011941,1.65,-3,2,5
156,MIL,P006085,P013385,5.45,-2,9,11
156,MIL,P006509,P007831,2.134,-5,2,7
156,MIL,P006509,P008985,2.134,-5,2,7
156,MIL,P006509,P008987,0.217,-2,0,2
156,MIL,P006509,P011941,0.167,-1,0,1
156,MIL,P006509,P013385,2.683,2,5,3
156,MIL,P007831,P008985,21.317,0,46,46
156,MIL,P007831,P008987,25.15,0,54,54
156,MIL,P007831,P011064,20.616,11,48,37
156,MIL,P007831,P013385,2.767,-4,4,8
156,MIL,P008985,P008987,21.55,-1,46,47
156,MIL,P008985,P011064,17.6,9,41,32
156,MIL,P008985,P011941,2.15,-4,2,6
156,MIL,P008987,P011064,20.433,9,46,37
156,MIL,P008987,P011941,2.15,-4,2,6
156,MIL,P008987,P013385,2.767,-4,4,8
156,MIL,P011064,P011941,0.667,-2,0,2
156,OLY,P001255,P003469,22.317,3,48,45
156,OLY,P001255,P007853,3.683,-4,9,13
156,OLY,P001255,P007947,5.95,5,13,8
156,OLY,P001255,P007982,13.65,6,37,31
156,OLY,P001255,P008811,22.067,1,42,41
156,OLY,P001255,P008829,2.134,5,9,4
156,OLY,P001255,P008855,16.25,-5,25,30
156,OLY,P001255,P013380,19.617,-3,41,44
156,OLY,P003469,P007853,5.2,-4,11,15
156,OLY,P003469,P007947,11.217,5,28,23
156,OLY,P003469,P007982,17.817,6,48,42
156,OLY,P003469,P008811,17.967,2,34,32
156,OLY,P003469,P008829,11.784,4,30,26
156,OLY,P003469,P008855,19.35,-3,32,35
156,OLY,P003469,P013380,24.684,-5,53,58
156,OLY,P007853,P007982,4.05,-4,9,13
156,OLY,P007853,P008811,0.85,0,2,2
156,OLY,P007853,P008829,2.367,0,4,4
156,OLY,P007853,P008855,2.85,0,6,6
156,OLY,P007853,P013380,5.2,-4,11,15
156,OLY,P007947,P007982,16.1,4,37,33
156,OLY,P007947,P008811,7.75,0,11,11
156,OLY,P007947,P008829,12.734,4,31,27
156,OLY,P007947,P008855,8.45,1,14,13
156,OLY,P007947,P013380,6.467,-3,14,17
156,OLY,P007982,P008811,12.617,5,28,23
156,OLY,P007982,P008829,13.718,4,33,29
156,OLY,P007982,P008855,8.233,1,16,15
156,OLY,P007982,P013380,14.751,-2,36,38
156,OLY,P008811,P008829,3.934,0,7,7
156,OLY,P008811,P008855,16.417,-4,26,30
156,OLY,P008811,P013380,19.934,0,38,38
156,OLY,P008829,P008855,6.75,2,14,12
156,OLY,P008829,P013380,9.451,-3,20,23
156,OLY,P008855,P013380,13.7,-4,23,27
158,BAR,P000925,P002939,22.733,-3,42,45
158,BAR,P000925,P003478,10.483,5,21,16
158,BAR,P000925,P009862,23.599,4,45,41
158,BAR,P000925,P009992,1.717,-2,3,5
158,BAR,P000925,P010106,1.083,-2,0,2
158,BAR,P000925,P012745,2.883,-4,3,7
158,BAR,P000925,P012795,14.899,-5,27,32
158,BAR,P000925,P013379,22.466,5,45,40
158,BAR,P000925,P013505,1.533,6,6,0
158,BAR,P002939,P003196,1.783,-2,0,2
158,BAR,P002939,P003478,10.733,-3,15,18
158,BAR,P002939,P009862,21.766,-2,39,41
158,BAR,P002939,P009992,1.717,-2,3,5
158,BAR,P002939,P012745,3.583,-4,3,7
158,BAR,P002939,P012795,14.816,-3,27,30
158,BAR,P002939,P013379,20.933,-1,39,40
158,BAR,P003196,P003478,8.484,-4,11,15
158,BAR,P003196,P007464,3.584,-5,5,10
158,BAR,P003196,P009862,4.049,-2,7,9
158,BAR,P003196,P009992,4.95,0,12,12
158,BAR,P003196,P010106,11.117,-1,24,25
158,BAR,P003196,P012745,14.65,-5,26,31
158,BAR,P003196,P012795,8.233,1,17,16
158,BAR,P003196,P013505,1.75,-2,2,4
158,BAR,P003478,P007464,3.584,-5,5,10
158,BAR,P003478,P009862,10.449,4,18,14
158,BAR,P003478,P009992,2.834,1,7,6
158,BAR,P003478,P010106,4.951,0,9,9
158,BAR,P003478,P012745,10.284,-6,14,20
158,BAR,P003478,P012795,2.1,1,2,1
158,BAR,P003478,P013379,8.683,7,18,11
158,BAR,P003478,P013505,3.283,4,8,4
158,BAR,P007464,P010106,2.767,-5,3,8
158,BAR,P007464,P012745,3.584,-5,5,10
158,BAR,P007464,P013505,0.817,0,2,2
158,BAR,P009862,P010106,3.416,0,7,7
158,BAR,P009862,P012745,5.215,-4,7,11
158,BAR,P009862,P012795,17.199,-2,34,36
158,BAR,P009862,P013379,22.433,6,45,39
158,BAR,P009862,P013505,2.466,4,6,2
158,BAR,P009992,P010106,4.95,0,12,12
158,BAR,P009992,P012745,6.667,-2,15,17
158,BAR,P009992,P012795,3.833,-3,8,11
158,BAR,P010106,P012745,12.2,-3,24,27
158,BAR,P010106,P012795,8.316,-1,17,18
158,BAR,P012745,P012795,9.316,-1,17,18
158,BAR,P012745,P013505,1.75,-2,2,4
158,BAR,P012795,P013379,13.816,-3,27,30
158,BAR,P013379,P013505,1.533,6,6,0
158,RED,P000848,P004866,4.966,-2,10,12
158,RED,P000848,P007960,1.866,4,9,5
158,RED,P000848,P009035,3.816,0,9,9
158,RED,P000848,P009048,3.699,3,10,7
158,RED,P000848,P011194,6.832,2,19,17
158,RED,P000848,P012044,3.166,0,10,10
158,RED,P000848,P012786,2.983,1,9,8
158,RED,P002553,P004866,6.716,-1,11,12
158,RED,P002553,P006436,4.684,1,9,8
158,RED,P002553,P007960,7.75,-3,12,15
158,RED,P002553,P009048,4.883,-4,8,12
158,RED,P002553,P010612,2.984,-3,2,5
158,RED,P002553,P011194,6.634,-5,11,16
158,RED,P002553,P012044,4.684,1,9,8
158,RED,P002553,P012786,3.933,2,6,4
158,RED,P004866,P006436,2.701,-2,3,5
158,RED,P004866,P007960,18.734,3,33,30
158,RED,P004866,P009035,16.802,2,29,27
158,RED,P004866,P009048,18.184,-2,29,31
158,RED,P004866,P010612,4.967,2,9,7
158,RED,P004866,P011194,14.251,-8,25,33
158,RED,P004866,P012044,9.25,7,24,17
158,RED,P004866,P012786,18.833,9,39,30
158,RED,P006436,P007960,6.418,-1,12,13
158,RED,P006436,P009035,7.302,-5,10,15
158,RED,P006436,P009048,2.834,-6,0,6
158,RED,P006436,P010612,5.351,-3,8,11
158,RED,P006436,P011194,4.935,4,12,8
158,RED,P006436,P012044,8.735,5,19,14
158,RED,P006436,P012786,4.984,-9,3,12
158,RED,P007960,P009035,18.818,11,41,30
158,RED,P007960,P009048,18.483,1,37,36
158,RED,P007960,P010612,4.167,3,6,3
158,RED,P007960,P011194,10.284,3,25,22
158,RED,P007960,P012044,6.734,12,18,6
158,RED,P007960,P012786,13.15,3,23,20
158,RED,P009035,P009048,16.684,1,29,28
158,RED,P009035,P010612,4.984,2,11,9
158,RED,P009035,P011194,8.251,6,21,15
158,RED,P009035,P012044,6.968,7,18,11
158,RED,P009035,P012786,12.651,-4,20,24
158,RED,P009048,P011194,8.383,-3,15,18
158,RED,P009048,P012044,0.033,1,1,0
158,RED,P009048,P012786,13.217,1,23,22
158,RED,P010612,P011194,4.617,2,11,9
158,RED,P010612,P012044,9.318,-1,17,18
158,RED,P010612,P012786,4.884,-6,4,10
158,RED,P011194,P012044,11.484,10,32,22
158,RED,P011194,P012786,5.333,1,13,12
158,RED,P012044,P012786,7.7,-2,16,18
159,PAR,P006591,P007870,4.733,0,9,9
159,PAR,P006591,P008232,21.85,13,51,38
159,PAR,P006591,P011836,10.067,2,24,22
159,PAR,P006591,P011981,10.367,9,28,19
159,PAR,P006591,P012720,9.083,11,24,13
159,PAR,P006591,P013369,14.917,2,32,30
159,PAR,P006591,P013370,23.383,15,56,41
159,PAR,P007632,P007870,7.683,-6,15,21
159,PAR,P007632,P011050,3.4,-3,5,8
159,PAR,P007632,P011836,11.083,-9,20,29
159,PAR,P007632,P012720,11.083,-9,20,29
159,PAR,P007632,P013369,11.083,-9,20,29
159,PAR,P007870,P008232,4.733,0,9,9
159,PAR,P007870,P011836,7.683,-6,15,21
159,PAR,P007870,P012720,7.683,-6,15,21
159,PAR,P007870,P013369,12.416,-6,24,30
159,PAR,P007870,P013370,4.733,0,9,9
159,PAR,P008232,P011836,9.734,1,23,22
159,PAR,P008232,P011981,10.184,11,27,16
159,PAR,P008232,P012720,11.267,12,32,20
159,PAR,P008232,P013369,15.751,3,35,32
159,PAR,P008232,P013370,24.217,16,59,43
159,PAR,P011050,P011836,4.117,-5,5,10
159,PAR,P011050,P012720,4.117,-5,5,10
159,PAR,P011050,P013369,4.117,-5,5,10
159,PAR,P011050,P013370,0.717,-2,0,2
159,PAR,P011836,P011981,3.584,4,11,7
159,PAR,P011836,P012720,23.067,1,49,48
159,PAR,P011836,P013369,17.868,-11,35,46
159,PAR,P011836,P013370,14.001,7,34,27
159,PAR,P011981,P012720,4.434,12,15,3
159,PAR,P011981,P013369,12.301,13,33,20
159,PAR,P011981,P013370,13.334,19,38,19
159,PAR,P012720,P013369,16.801,-4,34,38
159,PAR,P012720,P013370,14.401,16,38,22
159,PAR,P013369,P013370,20.018,9,46,37
159,ULK,P002849,P002968,2.65,-4,1,5
159,ULK,P002849,P004004,7.617,-3,17,20
159,ULK,P002849,P006961,6.899,-8,11,19
159,ULK,P002849,P007182,3.167,-4,4,8
159,ULK,P002849,P008962,6.116,-4,14,18
159,ULK,P002849,P009783,7.633,-12,7,19
159,ULK,P002849,P011205,8.733,-5,17,22
159,ULK,P002849,P013396,4.917,-8,5,13
159,ULK,P002968,P002969,5.217,-4,8,12
159,ULK,P002968,P004004,6.8,-7,8,15
159,ULK,P002968,P006961,10.95,-4,20,24
159,ULK,P002968,P008962,10.617,-3,20,23
159,ULK,P002968,P009783,8.05,-3,13,16
159,ULK,P002968,P011205,6.467,0,13,13
159,ULK,P002968,P013396,2.317,-3,1,4
159,ULK,P002969,P004004,5.616,0,11,11
159,ULK,P002969,P006961,8.467,-3,14,17
159,ULK,P002969,P007182,8.516,7,23,16
159,ULK,P002969,P008962,13.733,3,31,28
159,ULK,P002969,P009783,1.833,4,9,5
159,ULK,P002969,P011205,11.55,5,28,23
159,ULK,P004004,P006961,10.466,0,25,25
159,ULK,P004004,P007182,14.283,-6,29,35
159,ULK,P004004,P008962,20.466,-4,44,48
159,ULK,P004004,P009783,9.767,-11,14,25
159,ULK,P004004,P011205,13.883,4,35,31
159,ULK,P004004,P013396,9.434,-13,13,26
159,ULK,P006961,P007182,8.233,6,17,11
159,ULK,P006961,P008962,22.016,0,48,48
159,ULK,P006961,P009783,9.249,-4,16,20
159,ULK,P006961,P011205,17.383,3,38,35
159,ULK,P006961,P013396,2.533,-2,3,5
159,ULK,P007182,P008962,17.449,6,42,36
159,ULK,P007182,P009783,5.583,-1,14,15
159,ULK,P007182,P011205,16.716,9,40,31
159,ULK,P007182,P013396,8.517,-9,15,24
159,ULK,P008962,P009783,11.466,2,30,28
159,ULK,P008962,P011205,26.682,6,64,58
159,ULK,P008962,P013396,8.183,-10,11,21
159,ULK,P009783,P011205,7.849,5,21,16
159,ULK,P009783,P013396,4.034,-8,4,12
159,ULK,P011205,P013396,7.933,-7,12,19
160,BAS,P007230,P008072,6.983,-6,14,20
160,BAS,P007230,P011085,10.566,10,30,20
160,BAS,P007230,P011196,19.683,22,52,30
160,BAS,P007230,P011948,19.1,28,54,26
160,BAS,P007230,P012080,7.333,-10,12,22
160,BAS,P007230,P012201,21.0,22,52,30
160,BAS,P007230,P012597,13.983,12,35,23
160,BAS,P007230,P013367,17.816,18,47,29
160,BAS,P008072,P011085,9.2,-13,15,28
160,BAS,P008072,P011948,4.75,1,8,7
160,BAS,P008072,P012080,4.8,-9,9,18
160,BAS,P008072,P012201,6.583,-1,11,12
160,BAS,P008072,P012597,1.833,-2,3,5
160,BAS,P008072,P013367,11.383,-10,20,30
160,BAS,P011085,P011196,9.799,4,27,23
160,BAS,P011085,P011948,12.25,5,28,23
160,BAS,P011085,P012080,4.8,-9,9,18
160,BAS,P011085,P012201,13.333,-3,28,31
160,BAS,P011085,P012597,9.399,-4,22,26
160,BAS,P011085,P013367,16.449,6,41,35
160,BAS,P011196,P011948,19.467,10,50,40
160,BAS,P011196,P012080,2.533,-1,3,4
160,BAS,P011196,P012201,22.85,4,53,49
160,BAS,P011196,P012597,20.466,5,49,44
160,BAS,P011196,P013367,9.866,16,30,14
160,BAS,P011948,P012201,24.434,13,58,45
160,BAS,P011948,P012597,13.767,0,33,33
160,BAS,P011948,P013367,12.9,19,33,14
160,BAS,P012080,P012201,2.533,-1,3,4
160,BAS,P012080,P012597,2.533,-1,3,4
160,BAS,P012080,P013367,4.8,-9,9,18
160,BAS,P012201,P012597,21.216,-2,47,49
160,BAS,P012201,P013367,15.583,12,36,24
160,BAS,P012597,P013367,5.999,4,16,12
160,PRS,P004197,P005793,1.25,0,4,4
160,PRS,P004197,P010390,13.0,-2,26,28
160,PRS,P004197,P012608,13.0,-2,26,28
160,PRS,P004197,P012610,13.0,-2,26,28
160,PRS,P004197,P012613,11.75,-2,22,24
160,PRS,P004512,P005793,7.467,0,14,14
160,PRS,P004512,P007032,7.467,0,14,14
160,PRS,P004512,P012609,7.467,0,14,14
160,PRS,P004512,P012640,7.467,0,14,14
160,PRS,P005793,P007032,13.783,6,31,25
160,PRS,P005793,P010390,2.083,-3,4,7
160,PRS,P005793,P012608,2.083,-3,4,7
160,PRS,P005793,P012609,12.95,9,31,22
160,PRS,P005793,P012610,2.083,-3,4,7
160,PRS,P005793,P012640,12.95,9,31,22
160,PRS,P005793,P013373,5.483,9,17,8
160,PRS,P007032,P010390,2.65,-4,5,9
160,PRS,P007032,P012608,6.533,-12,10,22
160,PRS,P007032,P012609,16.833,1,36,35
160,PRS,P007032,P012610,6.533,-12,10,22
160,PRS,P007032,P012613,5.7,-9,10,19
160,PRS,P007032,P012640,12.95,9,31,22
160,PRS,P007032,P013373,5.483,9,17,8
160,PRS,P010390,P012608,21.083,-7,44,51
160,PRS,P010390,P012609,2.733,1,9,8
160,PRS,P010390,P012610,21.083,-7,44,51
160,PRS,P010390,P012613,16.267,-5,31,36
160,PRS,P010390,P012640,5.433,-1,13,14
160,PRS,P012608,P012609,8.699,-14,15,29
160,PRS,P012608,P012610,27.049,-22,50,72
160,PRS,P012608,P012613,22.233,-20,37,57
160,PRS,P012608,P012640,7.516,-8,14,22
160,PRS,P012609,P012610,8.699,-14,15,29
160,PRS,P012609,P012613,5.966,-15,6,21
160,PRS,P012609,P012640,17.766,3,41,38
160,PRS,P012609,P013373,5.483,9,17,8
160,PRS,P012610,P012613,22.233,-20,37,57
160,PRS,P012610,P012640,7.516,-8,14,22
160,PRS,P012613,P012640,4.783,-9,5,14
160,PRS,P012640,P013373,5.483,9,17,8
161,MUN,P001557,P004508,9.75,-9,15,24
161,MUN,P001557,P007056,7.0,7,16,9
161,MUN,P001557,P007201,18.4,-4,33,37
161,MUN,P001557,P010391,16.166,-3,29,32
161,MUN,P001557,P011224,6.383,0,15,15
161,MUN,P001557,P011987,19.233,-3,36,39
161,MUN,P004508,P007056,12.917,1,23,22
161,MUN,P004508,P007201,27.417,-7,46,53
161,MUN,P004508,P007639,3.1,-10,2,12
161,MUN,P004508,P010391,19.833,4,34,30
161,MUN,P004508,P011224,14.401,-17,20,37
161,MUN,P004508,P011244,3.1,-10,2,12
161,MUN,P004508,P011987,25.033,-15,42,57
161,MUN,P004508,P012123,1.767,-6,0,6
161,MUN,P004508,P013368,4.75,1,8,7
161,MUN,P007056,P007201,19.084,7,36,29
161,MUN,P007056,P010391,17.0,17,37,20
161,MUN,P007056,P011224,5.817,-5,8,13
161,MUN,P007056,P011987,17.85,5,36,31
161,MUN,P007201,P010391,28.483,9,52,43
161,MUN,P007201,P011224,13.784,-8,23,31
161,MUN,P007201,P011987,32.35,-6,58,64
161,MUN,P007201,P013368,4.75,1,8,7
161,MUN,P007639,P011224,3.1,-10,2,12
161,MUN,P007639,P011244,3.1,-10,2,12
161,MUN,P007639,P011987,1.333,-4,2,6
161,MUN,P007639,P012123,1.767,-6,0,6
161,MUN,P010391,P011224,7.033,4,14,10
161,MUN,P010391,P011987,25.599,6,49,43
161,MUN,P010391,P013368,3.15,3,5,2
161,MUN,P011224,P011244,3.1,-10,2,12
161,MUN,P011224,P011987,12.233,-15,22,37
161,MUN,P011224,P012123,1.767,-6,0,6
161,MUN,P011224,P013368,3.25,-1,6,7
161,MUN,P011244,P011987,1.333,-4,2,6
161,MUN,P011244,P012123,1.767,-6,0,6
161,MUN,P011987,P013368,3.1,0,5,5
161,PAN,P001926,P004088,11.767,21,32,11
161,PAN,P001926,P005161,1.5,-2,0,2
161,PAN,P001926,P005353,5.984,-5,7,12
161,PAN,P001926,P007866,17.1,35,52,17
161,PAN,P001926,P011204,15.434,4,27,23
161,PAN,P001926,P012712,6.534,-5,7,12
161,PAN,P001926,P012774,23.067,31,59,28
161,PAN,P001926,P013383,19.15,33,52,19
161,PAN,P004088,P005353,2.35,-6,0,6
161,PAN,P004088,P007866,15.783,22,45,23
161,PAN,P004088,P011204,8.15,-5,13,18
161,PAN,P004088,P012712,2.067,-3,0,3
161,PAN,P004088,P012774,15.783,22,45,23
161,PAN,P004088,P013383,15.5,25,45,20
161,PAN,P005161,P011204,1.5,-2,0,2
161,PAN,P005161,P012774,1.5,-2,0,2
161,PAN,P005161,P013383,1.5,-2,0,2
161,PAN,P005353,P007866,0.283,-3,0,3
161,PAN,P005353,P009622,2.25,-4,0,4
161,PAN,P005353,P011204,6.267,-8,7,15
161,PAN,P005353,P011209,2.25,-4,0,4
161,PAN,P005353,P012712,8.234,-9,7,16
161,PAN,P005353,P012774,6.45,-9,7,16
161,PAN,P007866,P009622,1.733,-8,0,8
161,PAN,P007866,P011204,20.016,-2,41,43
161,PAN,P007866,P011209,4.8,-3,8,11
161,PAN,P007866,P012712,1.733,-8,0,8
161,PAN,P007866,P012774,29.716,22,73,51
161,PAN,P007866,P013383,27.7,33,73,40
161,PAN,P009622,P011204,1.733,-8,0,8
161,PAN,P009622,P011209,2.25,-4,0,4
161,PAN,P009622,P012712,3.983,-12,0,12
161,PAN,P009622,P012774,3.983,-12,0,12
161,PAN,P011204,P011209,4.8,-3,8,11
161,PAN,P011204,P012712,8.267,-13,7,20
161,PAN,P011204,P012774,25.983,-6,48,54
161,PAN,P011204,P013383,20.05,7,41,34
161,PAN,P011209,P012712,2.25,-4,0,4
161,PAN,P011209,P012774,7.05,-7,8,15
161,PAN,P011209,P013383,4.8,-3,8,11
161,PAN,P012712,P012774,8.45,-14,7,21
161,PAN,P012712,P013383,0.55,0,0,0
161,PAN,P012774,P013383,29.75,31,73,42
162,ASV,P000229,P002100,6.65,-3,7,10
162,ASV,P000229,P003526,7.084,-5,7,12
162,ASV,P000229,P007027,0.45,-2,0,2
162,ASV,P000229,P008991,7.8,-3,7,10
162,ASV,P000229,P010545,0.65,-4,0,4
162,ASV,P000229,P011225,1.483,-2,0,2
162,ASV,P000229,P013371,8.317,-7,7,14
162,ASV,P000229,P013405,1.366,-2,0,2
162,ASV,P002100,P003526,17.4,-9,28,37
162,ASV,P002100,P007027,10.883,-6,21,27
162,ASV,P002100,P008991,9.6,-1,15,16
162,ASV,P002100,P010316,0.1,0,0,0
162,ASV,P002100,P010545,7.7,-8,13,21
162,ASV,P002100,P013371,11.4,-6,17,23
162,ASV,P002100,P013405,5.867,-3,11,14
162,ASV,P003526,P007027,16.483,-14,32,46
162,ASV,P003526,P008991,10.2,-6,15,21
162,ASV,P003526,P010316,3.433,-3,8,11
162,ASV,P003526,P010545,12.817,-11,24,35
162,ASV,P003526,P011225,5.4,-6,11,17
162,ASV,P003526,P013371,11.834,-8,17,25
162,ASV,P003526,P013405,7.817,-6,14,20
162,ASV,P007027,P008991,3.566,-3,8,11
162,ASV,P007027,P010316,16.883,-4,28,32
162,ASV,P007027,P010545,26.267,-12,44,56
162,ASV,P007027,P011225,17.25,-7,29,36
162,ASV,P007027,P013371,6.683,-5,12,17
162,ASV,P007027,P013405,21.267,-7,34,41
162,ASV,P008991,P010316,0.483,-5,0,5
162,ASV,P008991,P011225,1.633,-5,0,5
162,ASV,P008991,P013371,10.617,-1,15,16
162,ASV,P008991,P013405,1.033,0,0,0
162,ASV,P010316,P010545,18.367,7,38,31
162,ASV,P010316,P011225,17.367,2,36,34
162,ASV,P010316,P013371,3.55,6,12,6
162,ASV,P010316,P013405,15.617,5,30,25
162,ASV,P010545,P011225,19.167,2,39,37
162,ASV,P010545,P013371,6.133,-3,14,17
162,ASV,P010545,P013405,23.567,-3,44,47
162,ASV,P011225,P013371,3.55,4,10,6
162,ASV,P011225,P013405,17.35,0,31,31
162,ASV,P013371,P013405,4.916,4,12,8
162,VIR,P002084,P004554,9.183,9,17,8
162,VIR,P002084,P004888,18.917,22,39,17
162,VIR,P002084,P005738,5.984,5,16,11
162,VIR,P002084,P006739,21.899,21,45,24
162,VIR,P002084,P009549,13.766,13,26,13
162,VIR,P002084,P011816,4.316,-3,7,10
162,VIR,P002084,P012585,9.467,2,19,17
162,VIR,P002084,P012591,8.333,-5,16,21
162,VIR,P002084,P013374,6.733,6,13,7
162,VIR,P002084,PBCN,6.266,-2,14,16
162,VIR,P004554,P004888,9.983,9,20,11
162,VIR,P004554,P005738,1.783,-2,5,7
162,VIR,P004554,P006739,10.483,10,22,12
162,VIR,P004554,P009549,7.883,7,16,9
162,VIR,P004554,P012585,2.283,0,3,3
162,VIR,P004554,P012591,0.483,-3,0,3
162,VIR,P004554,PBCN,1.783,-2,5,7
162,VIR,P004888,P005738,8.517,-3,21,24
162,VIR,P004888,P006739,23.083,17,47,30
162,VIR,P004888,P009549,18.917,11,37,26
162,VIR,P004888,P012585,10.101,4,20,16
162,VIR,P004888,P012591,1.034,0,2,2
162,VIR,P004888,P013374,12.634,0,23,23
162,VIR,P004888,PBCN,4.75,-8,11,19
162,VIR,P005738,P006739,6.0,0,17,17
162,VIR,P005738,P009549,6.7,-4,14,18
162,VIR,P005738,P012585,9.65,11,24,13
162,VIR,P005738,P012591,5.75,8,14,6
162,VIR,P005738,P013374,8.083,1,18,17
162,VIR,P005738,PBCN,10.933,0,27,27
162,VIR,P006739,P009549,16.817,16,35,19
162,VIR,P006739,P011816,3.133,-1,5,6
162,VIR,P006739,P012585,9.067,4,18,14
162,VIR,P006739,P012591,4.016,-1,8,9
162,VIR,P006739,P013374,10.3,6,22,16
162,VIR,P006739,PBCN,6.666,-4,17,21
162,VIR,P009549,P012585,6.783,-6,11,17
162,VIR,P009549,P012591,2.316,-4,2,6
162,VIR,P009549,P013374,14.2,2,27,25
162,VIR,P009549,PBCN,5.55,-3,12,15
162,VIR,P011816,P012585,1.183,-2,2,4
162,VIR,P011816,P012591,4.316,-3,7,10
162,VIR,P011816,PBCN,4.316,-3,7,10
162,VIR,P012585,P012591,7.35,1,16,15
162,VIR,P012585,P013374,8.8,1,17,16
162,VIR,P012585,PBCN,5.916,5,14,9
162,VIR,P012591,P013374,5.216,3,11,8
162,VIR,P012591,PBCN,9.382,4,20,16
162,VIR,P013374,PBCN,8.966,1,21,20
163,OLY,P001255,P003469,26.967,11,63,52
163,OLY,P001255,P003941,12.917,14,33,19
163,OLY,P001255,P007853,9.284,11,25,14
163,OLY,P001255,P007982,11.984,15,33,18
163,OLY,P001255,P008811,16.367,1,37,36
163,OLY,P001255,P008829,2.317,4,7,3
163,OLY,P001255,P008855,20.0,4,45,41
163,OLY,P001255,P013380,17.3,0,37,37
163,OLY,P003469,P003941,15.567,10,38,28
163,OLY,P003469,P007853,12.051,7,30,23
163,OLY,P003469,P007982,13.884,8,33,25
163,OLY,P003469,P008811,16.367,1,37,36
163,OLY,P003469,P008829,0.117,0,0,0
163,OLY,P003469,P008855,24.967,4,57,53
163,OLY,P003469,P013380,18.284,3,42,39
163,OLY,P003941,P007853,16.218,9,39,30
163,OLY,P003941,P007982,16.551,8,36,28
163,OLY,P003941,P008829,4.284,2,9,7
163,OLY,P003941,P008855,8.6,3,20,17
163,OLY,P003941,P013380,5.267,2,13,11
163,OLY,P007853,P007982,19.135,0,42,42
163,OLY,P007853,P008811,0.45,-3,0,3
163,OLY,P007853,P008829,8.068,-4,17,21
163,OLY,P007853,P008855,4.967,0,12,12
163,OLY,P007853,P013380,6.618,-5,15,20
163,OLY,P007853,P013514,3.217,-3,8,11
163,OLY,P007982,P008811,1.95,-1,6,7
163,OLY,P007982,P008829,8.068,-4,17,21
163,OLY,P007982,P008855,6.8,1,15,14
163,OLY,P007982,P013380,5.751,-8,10,18
163,OLY,P007982,P013514,3.217,-3,8,11
163,OLY,P008811,P008829,0.45,-3,0,3
163,OLY,P008811,P008855,16.367,1,37,36
163,OLY,P008811,P013380,15.317,-4,31,35
163,OLY,P008829,P013380,5.751,-8,10,18
163,OLY,P008829,P013514,3.217,-3,8,11
163,OLY,P008855,P013380,18.167,3,42,39
163,OLY,P013380,P013514,3.217,-3,8,11
163,ZAL,P002329,P002676,12.266,15,35,20
163,ZAL,P002329,P003048,11.532,2,22,20
163,ZAL,P002329,P005504,1.467,-2,4,6
163,ZAL,P002329,P007029,7.233,-5,15,20
163,ZAL,P002329,P007513,9.632,-20,12,32
163,ZAL,P002329,P007975,16.782,13,37,24
163,ZAL,P002329,P011051,8.516,-2,18,20
163,ZAL,P002329,P011983,3.8,1,7,6
163,ZAL,P002329,P012622,0.85,-2,0,2
163,ZAL,P002329,P013403,13.982,-8,26,34
163,ZAL,P002676,P003048,14.333,4,33,29
163,ZAL,P002676,P007029,11.334,9,31,22
163,ZAL,P002676,P007513,5.616,-3,14,17
163,ZAL,P002676,P007975,20.45,13,50,37
163,ZAL,P002676,P011051,11.6,6,31,25
163,ZAL,P002676,P011983,14.167,4,34,30
163,ZAL,P002676,P012622,1.767,-6,2,8
163,ZAL,P002676,P012715,1.45,-2,2,4
163,ZAL,P002676,P013403,10.749,0,24,24
163,ZAL,P003048,P007029,8.6,0,19,19
163,ZAL,P003048,P007513,5.032,-5,5,10
163,ZAL,P003048,P007975,19.232,-1,38,39
163,ZAL,P003048,P011983,6.433,-1,14,15
163,ZAL,P003048,P012622,0.35,-2,0,2
163,ZAL,P003048,P012715,1.45,-2,2,4
163,ZAL,P003048,P013403,9.966,1,19,18
163,ZAL,P005504,P007029,2.884,-4,4,8
163,ZAL,P005504,P007513,2.884,-4,4,8
163,ZAL,P005504,P012715,1.417,-2,0,2
163,ZAL,P005504,P013403,2.884,-4,4,8
163,ZAL,P007029,P007513,12.0,-11,20,31
163,ZAL,P007029,P007975,9.917,6,25,19
163,ZAL,P007029,P011051,7.6,0,17,17
163,ZAL,P007029,P011983,10.317,3,25,22
163,ZAL,P007029,P012622,0.117,0,0,0
163,ZAL,P007029,P012715,1.417,-2,0,2
163,ZAL,P007029,P013403,4.917,-12,4,16
163,ZAL,P007513,P007975,5.032,-5,5,10
163,ZAL,P007513,P011051,7.516,-11,14,25
163,ZAL,P007513,P011983,4.799,0,11,11
163,ZAL,P007513,P012622,0.117,0,0,0
163,ZAL,P007513,P012715,1.417,-2,0,2
163,ZAL,P007513,P013403,7.683,-19,7,26
163,ZAL,P007975,P011051,10.367,9,29,20
163,ZAL,P007975,P011983,12.184,-5,23,28
163,ZAL,P007975,P012622,5.9,-6,14,20
163,ZAL,P007975,P012715,4.85,0,14,14
163,ZAL,P007975,P013403,13.682,8,33,25
163,ZAL,P011051,P011983,9.884,-2,20,22
163,ZAL,P011051,P012622,5.667,-4,14,18
163,ZAL,P011051,P012715,3.4,2,12,10
163,ZAL,P011051,P013403,6.982,-6,17,23
163,ZAL,P011983,P012622,2.917,-9,2,11
163,ZAL,P011983,P012715,0.767,-3,0,3
163,ZAL,P012622,P012715,3.4,2,12,10
163,ZAL,P012622,P013403,2.983,3,12,9
163,ZAL,P012715,P013403,5.5,1,14,13
165,ASV,P000229,P002100,10.716,-3,19,22
165,ASV,P000229,P003526,9.533,-7,11,18
165,ASV,P000229,P007027,2.45,-1,2,3
165,ASV,P000229,P010545,6.283,1,12,11
165,ASV,P000229,P011225,1.317,0,0,0
165,ASV,P000229,P013371,9.583,-2,17,19
165,ASV,P000229,P013377,2.467,-1,3,4
165,ASV,P000229,P013405,5.783,1,12,11
165,ASV,P002100,P003526,13.399,-7,18,25
165,ASV,P002100,P007027,7.616,-10,9,19
165,ASV,P002100,P010316,2.384,2,2,0
165,ASV,P002100,P010545,16.866,-6,31,37
165,ASV,P002100,P011225,7.683,-8,16,24
165,ASV,P002100,P013371,12.117,-3,23,26
165,ASV,P002100,P013377,2.467,-1,3,4
165,ASV,P002100,P013405,15.216,-4,31,35
165,ASV,P003526,P007027,4.449,-4,3,7
165,ASV,P003526,P010316,0.25,0,0,0
165,ASV,P003526,P010545,8.882,-5,11,16
165,ASV,P003526,P011225,4.516,-1,6,7
165,ASV,P003526,P013371,8.05,-8,9,17
165,ASV,P003526,P013377,2.467,-1,3,4
165,ASV,P003526,P013405,7.982,-3,11,14
165,ASV,P007027,P010316,17.25,5,30,25
165,ASV,P007027,P010545,23.366,-8,35,43
165,ASV,P007027,P011225,21.616,-9,32,41
165,ASV,P007027,P013371,0.4,-2,0,2
165,ASV,P007027,P013405,24.849,-7,37,44
165,ASV,P010316,P010545,17.967,5,30,25
165,ASV,P010316,P011225,16.083,3,28,25
165,ASV,P010316,P013371,0.967,0,0,0
165,ASV,P010316,P013405,17.967,5,30,25
165,ASV,P010545,P011225,24.566,-7,44,51
165,ASV,P010545,P013371,8.25,0,18,18
165,ASV,P010545,P013405,29.816,0,55,55
165,ASV,P011225,P013371,1.167,1,6,5
165,ASV,P011225,P013405,25.316,-7,44,51
165,ASV,P013371,P013377,2.467,-1,3,4
165,ASV,P013371,P013405,5.467,3,16,13
165,MIL,P000796,P001518,3.166,5,10,5
165,MIL,P000796,P005670,1.733,-4,2,6
165,MIL,P000796,P006085,4.1,-1,2,3
165,MIL,P000796,P006509,3.183,3,6,3
165,MIL,P000796,P007831,22.716,6,45,39
165,MIL,P000796,P008985,14.9,7,32,25
165,MIL,P000796,P008987,9.549,8,23,15
165,MIL,P000796,P011064,18.066,10,43,33
165,MIL,P000796,P011941,12.067,-4,18,22
165,MIL,P000796,P013384,9.648,6,23,17
165,MIL,P001518,P007831,3.766,3,10,7
165,MIL,P001518,P008985,4.016,-1,3,4
165,MIL,P001518,P008987,3.783,-1,3,4
165,MIL,P001518,P011064,6.116,6,13,7
165,MIL,P001518,P013384,6.949,4,13,9
165,MIL,P005670,P006509,0.95,-1,2,3
165,MIL,P005670,P007831,0.783,-3,0,3
165,MIL,P005670,P008987,1.733,-4,2,6
165,MIL,P005670,P013384,1.733,-4,2,6
165,MIL,P006085,P006509,7.483,-3,12,15
165,MIL,P006085,P007831,7.983,-7,11,18
165,MIL,P006085,P008985,5.0,2,5,3
165,MIL,P006085,P008987,8.716,-2,14,16
165,MIL,P006085,P011941,2.767,-5,2,7
165,MIL,P006085,P013385,4.883,0,10,10
165,MIL,P006509,P007831,5.233,-6,9,15
165,MIL,P006509,P008985,4.816,8,9,1
165,MIL,P006509,P008987,10.999,1,20,19
165,MIL,P006509,P011941,1.25,-3,2,5
165,MIL,P006509,P013384,3.516,4,8,4
165,MIL,P006509,P013385,6.566,1,12,11
165,MIL,P007831,P008985,15.401,-1,28,29
165,MIL,P007831,P008987,13.216,-5,26,31
165,MIL,P007831,P011064,18.45,10,43,33
165,MIL,P007831,P011941,13.934,-7,20,27
165,MIL,P007831,P013384,8.582,-1,17,18
165,MIL,P007831,P013385,2.8,-5,7,12
165,MIL,P008985,P008987,15.616,16,32,16
165,MIL,P008985,P011064,17.667,10,36,26
165,MIL,P008985,P011941,11.001,-3,15,18
165,MIL,P008985,P013384,9.582,7,16,9
165,MIL,P008985,P013385,6.933,7,12,5
165,MIL,P008987,P011064,10.75,13,25,12
165,MIL,P008987,P011941,1.867,-3,2,5
165,MIL,P008987,P013384,13.265,5,22,17
165,MIL,P008987,P013385,9.566,4,19,15
165,MIL,P011064,P011941,11.167,-2,18,20
165,MIL,P011064,P013384,12.815,12,27,15
165,MIL,P011064,P013385,2.833,5,7,2
165,MIL,P011941,P013384,1.683,-1,3,4
165,MIL,P013384,P013385,4.683,4,9,5
164,BER,P006251,P007025,4.333,-4,9,13
164,BER,P006251,P007550,4.649,-9,6,15
164,BER,P006251,P008062,9.083,6,27,21
164,BER,P006251,P008173,5.983,-9,10,19
164,BER,P006251,P008211,7.366,-12,14,26
164,BER,P006251,P008384,11.166,-6,26,32
164,BER,P006251,P008967,15.716,-5,37,42
164,BER,P006251,P011631,0.35,-3,0,3
164,BER,P006251,P011934,13.699,-16,24,40
164,BER,P006251,P013386,5.383,6,19,13
164,BER,P007025,P008062,4.3,-6,7,13
164,BER,P007025,P008173,6.799,7,19,12
164,BER,P007025,P008211,3.066,-3,6,9
164,BER,P007025,P008384,4.25,7,13,6
164,BER,P007025,P008967,3.783,-3,7,10
164,BER,P007025,P011631,6.766,5,17,12
164,BER,P007025,P011934,10.049,6,26,20
164,BER,P007025,P013386,1.05,-5,0,5
164,BER,P007550,P008173,6.283,-5,8,13
164,BER,P007550,P008211,4.65,-5,6,11
164,BER,P007550,P008384,3.649,-4,4,8
164,BER,P007550,P008967,2.016,-4,2,6
164,BER,P007550,P011631,3.65,0,4,4
164,BER,P007550,P011934,4.116,-6,6,12
164,BER,P007550,P013386,4.183,-3,4,7
164,BER,P008062,P008173,1.983,0,6,6
164,BER,P008062,P008384,12.483,2,36,34
164,BER,P008062,P008967,13.766,2,37,35
164,BER,P008062,P011631,7.183,-7,16,23
164,BER,P008062,P011934,4.233,-3,8,11
164,BER,P008062,P013386,12.033,2,35,33
164,BER,P008173,P008211,13.033,-11,26,37
164,BER,P008173,P008384,8.316,7,21,14
164,BER,P008173,P008967,6.284,-6,14,20
164,BER,P008173,P011631,15.366,5,37,32
164,BER,P008173,P011934,15.716,-4,37,41
164,BER,P008173,P013386,5.633,0,10,10
164,BER,P008211,P008384,2.35,-6,4,10
164,BER,P008211,P008967,7.667,-9,18,27
164,BER,P008211,P011631,8.367,-8,16,24
164,BER,P008211,P011934,13.016,-14,28,42
164,BER,P008211,P013386,2.017,0,2,2
164,BER,P008384,P008967,15.316,-8,36,44
164,BER,P008384,P011631,12.366,2,31,29
164,BER,P008384,P011934,9.166,1,20,19
164,BER,P008384,P013386,13.666,1,37,36
164,BER,P008967,P011631,9.05,-12,20,32
164,BER,P008967,P011934,14.0,-13,28,41
164,BER,P008967,P013386,10.066,2,29,27
164,BER,P011631,P011934,9.733,5,27,22
164,BER,P011631,P013386,10.833,-7,20,27
164,MCO,P001932,P005844,17.168,15,47,32
164,MCO,P001932,P005985,12.018,17,32,15
164,MCO,P001932,P009754,11.318,14,37,23
164,MCO,P001932,P011212,15.468,13,39,26
164,MCO,P001932,P011231,9.467,15,30,15
164,MCO,P001932,P013365,8.901,2,19,17
164,MCO,P005844,P005985,11.668,11,30,19
164,MCO,P005844,P008099,0.65,-2,0,2
164,MCO,P005844,P009754,10.318,10,35,25
164,MCO,P005844,P011212,15.118,7,37,30
164,MCO,P005844,P011231,8.05,11,26,15
164,MCO,P005844,P013365,9.968,0,21,21
164,MCO,P005985,P008099,15.1,-6,36,42
164,MCO,P005985,P009754,16.401,14,52,38
164,MCO,P005985,P011212,13.185,3,26,23
164,MCO,P005985,P011231,12.667,-1,31,32
164,MCO,P005985,P013365,14.651,10,37,27
164,MCO,P005985,PLCZ,14.45,-4,36,40
164,MCO,P008099,P009754,17.133,4,48,44
164,MCO,P008099,P011212,9.767,-6,20,26
164,MCO,P008099,P011231,7.983,-11,15,26
164,MCO,P008099,P013365,13.017,7,37,30
164,MCO,P008099,PLCZ,20.35,-2,52,54
164,MCO,P009754,P011212,14.518,10,43,33
164,MCO,P009754,P011231,12.4,8,37,29
164,MCO,P009754,P013365,16.251,8,48,40
164,MCO,P009754,PLCZ,17.133,4,48,44
164,MCO,P011212,P011231,11.25,5,26,21
164,MCO,P011212,P013365,14.185,0,33,33
164,MCO,P011212,PLCZ,9.117,-4,20,24
164,MCO,P011231,PLCZ,7.983,-11,15,26
164,MCO,P013365,PLCZ,12.367,9,37,28
166,BAS,P007230,P007579,2.533,-1,5,6
166,BAS,P007230,P008072,2.817,-5,0,5
166,BAS,P007230,P011196,13.8,1,31,30
166,BAS,P007230,P011948,16.333,0,36,36
166,BAS,P007230,P012080,3.484,-7,0,7
166,BAS,P007230,P012201,18.483,-3,36,39
166,BAS,P007230,P012597,15.767,1,33,32
166,BAS,P007230,P013367,3.383,-6,3,9
166,BAS,P007579,P008072,5.25,-6,4,10
166,BAS,P007579,P011085,14.684,3,27,24
166,BAS,P007579,P011948,4.217,-5,5,10
166,BAS,P007579,P012080,13.0,7,27,20
166,BAS,P007579,P012201,11.967,8,28,20
166,BAS,P007579,P012597,2.617,-4,2,6
166,BAS,P007579,P013367,14.6,6,30,24
166,BAS,P008072,P011085,5.933,-6,4,10
166,BAS,P008072,P011948,2.25,-4,0,4
166,BAS,P008072,P012080,6.5,-7,4,11
166,BAS,P008072,P012201,3.5,-5,0,5
166,BAS,P008072,P012597,3.467,-4,0,4
166,BAS,P008072,P013367,5.283,-7,4,11
166,BAS,P011085,P011196,5.483,0,10,10
166,BAS,P011085,P011948,7.85,-4,10,14
166,BAS,P011085,P012080,13.0,7,27,20
166,BAS,P011085,P012201,15.6,9,33,24
166,BAS,P011085,P012597,3.033,-8,0,8
166,BAS,P011085,P013367,17.817,11,37,26
166,BAS,P011196,P011948,19.283,1,41,40
166,BAS,P011196,P012080,0.667,-2,0,2
166,BAS,P011196,P012201,18.616,3,41,38
166,BAS,P011196,P012597,14.433,-3,31,34
166,BAS,P011196,P013367,4.85,4,10,6
166,BAS,P011948,P012080,0.667,-2,0,2
166,BAS,P011948,P012201,21.949,2,46,44
166,BAS,P011948,P012597,17.583,-7,33,40
166,BAS,P011948,P013367,6.6,3,13,10
166,BAS,P012080,P012201,12.134,4,23,19
166,BAS,P012080,P012597,1.884,-2,0,2
166,BAS,P012080,P013367,14.6,2,27,25
166,BAS,P012201,P012597,16.416,-1,33,34
166,BAS,P012201,P013367,17.667,7,36,29
166,RED,P000848,P002553,2.033,4,8,4
166,RED,P000848,P004866,15.599,-2,30,32
166,RED,P000848,P006436,14.999,9,38,29
166,RED,P000848,P007960,4.716,-4,6,10
166,RED,P000848,P009035,17.682,1,36,35
166,RED,P000848,P009048,13.333,-2,26,28
166,RED,P000848,P010588,4.116,7,14,7
166,RED,P000848,P010612,1.2,2,4,2
166,RED,P000848,P012044,5.182,5,14,9
166,RED,P002553,P004866,4.217,-7,5,12
166,RED,P002553,P006436,8.133,10,18,8
166,RED,P002553,P007960,1.65,-7,0,7
166,RED,P002553,P009048,3.217,-8,2,10
166,RED,P002553,P010588,8.517,8,19,11
166,RED,P002553,P010612,9.817,-3,13,16
166,RED,P002553,P011194,1.183,-2,0,2
166,RED,P002553,P012044,6.333,7,13,6
166,RED,P002553,PJDR,2.3,2,6,4
166,RED,P004866,P006436,13.916,5,30,25
166,RED,P004866,P007960,8.333,-15,6,21
166,RED,P004866,P009035,23.066,-1,42,43
166,RED,P004866,P009048,17.217,-14,28,42
166,RED,P004866,P010588,3.35,-4,5,9
166,RED,P004866,P010612,11.634,-6,17,23
166,RED,P004866,P011194,2.417,8,8,0
166,RED,P004866,P012044,8.383,3,14,11
166,RED,P004866,PJDR,1.0,1,3,2
166,RED,P006436,P007960,0.05,0,0,0
166,RED,P006436,P009035,18.499,5,40,35
166,RED,P006436,P009048,10.8,6,26,20
166,RED,P006436,P010588,11.249,14,28,14
166,RED,P006436,P010612,12.783,8,24,16
166,RED,P006436,P011194,2.15,-2,2,4
166,RED,P006436,P012044,11.299,7,21,14
166,RED,P006436,PJDR,2.65,-2,5,7
166,RED,P007960,P009035,6.683,-8,6,14
166,RED,P007960,P009048,5.433,-11,4,15
166,RED,P007960,P010588,0.05,0,0,0
166,RED,P007960,P010612,3.567,-11,0,11
166,RED,P007960,P012044,2.85,-4,2,6
166,RED,P009035,P009048,14.683,-4,28,32
166,RED,P009035,P010588,5.399,0,12,12
166,RED,P009035,P010612,11.617,2,22,20
166,RED,P009035,P011194,3.384,8,10,2
166,RED,P009035,P012044,10.233,4,18,14
166,RED,P009035,PJDR,1.35,-3,2,5
166,RED,P009048,P010588,2.35,-5,2,7
166,RED,P009048,P010612,4.567,-10,4,14
166,RED,P010588,P010612,10.95,3,21,18
166,RED,P010588,P012044,6.033,10,15,5
166,RED,P010588,PJDR,3.65,-1,8,9
166,RED,P010612,P011194,4.567,6,10,4
166,RED,P010612,P012044,11.384,6,17,11
166,RED,P010612,PJDR,3.65,-1,8,9
166,RED,P011194,P012044,4.567,6,10,4
167,IST,P004887,P006372,0.05,0,0,0
167,IST,P004887,P006590,6.883,0,22,22
167,IST,P004887,P007109,2.867,-3,7,10
167,IST,P004887,P007200,20.184,1,50,49
167,IST,P004887,P009846,8.984,-1,28,29
167,IST,P004887,P011078,15.334,-2,32,34
167,IST,P004887,P012710,14.184,3,29,26
167,IST,P004887,P013363,14.167,9,36,27
167,IST,P004887,P013364,2.083,-3,4,7
167,IST,P006372,P009846,0.05,0,0,0
167,IST,P006372,P013363,0.05,0,0,0
167,IST,P006372,P013364,0.05,0,0,0
167,IST,P006590,P007109,12.216,-7,17,24
167,IST,P006590,P007200,10.399,-10,24,34
167,IST,P006590,P009846,16.883,-5,33,38
167,IST,P006590,P011078,5.083,-1,6,7
167,IST,P006590,P012710,1.667,-2,2,4
167,IST,P006590,P012788,9.15,-4,11,15
167,IST,P006590,P013363,4.933,0,16,16
167,IST,P006590,P013364,4.65,-3,9,12
167,IST,P007109,P007200,14.116,-14,20,34
167,IST,P007109,P009846,17.516,-11,24,35
167,IST,P007109,P011078,10.117,-5,13,18
167,IST,P007109,P012788,15.283,-7,18,25
167,IST,P007109,P013363,4.75,-1,9,10
167,IST,P007109,P013364,9.867,0,16,16
167,IST,P007200,P009846,17.233,-10,37,47
167,IST,P007200,P011078,19.717,-5,38,43
167,IST,P007200,P012710,14.184,3,29,26
167,IST,P007200,P012788,8.666,-9,9,18
167,IST,P007200,P013363,17.65,7,42,35
167,IST,P007200,P013364,7.383,-3,11,14
167,IST,P009846,P011078,8.567,-3,14,17
167,IST,P009846,P012710,4.284,-1,10,11
167,IST,P009846,P012788,13.933,-3,18,21
167,IST,P009846,P013363,4.983,0,16,16
167,IST,P009846,P013364,6.967,2,12,10
167,IST,P011078,P012710,12.517,5,27,22
167,IST,P011078,P012788,6.783,-3,6,9
167,IST,P011078,P013363,12.717,7,26,19
167,IST,P011078,P013364,4.033,-5,6,11
167,IST,P012710,P013363,9.9,4,19,15
167,IST,P012788,P013364,7.317,-2,10,12
167,IST,P013363,P013364,1.65,2,4,2
167,ULK,P002849,P004004,14.033,4,31,27
167,ULK,P002849,P006961,16.566,2,32,30
167,ULK,P002849,P007182,7.549,-6,13,19
167,ULK,P002849,P008962,9.65,9,22,13
167,ULK,P002849,P009783,4.566,-2,8,10
167,ULK,P002849,P010560,2.033,1,3,2
167,ULK,P002849,P011205,11.499,-1,24,25
167,ULK,P002849,P013396,2.9,5,7,2
167,ULK,P002968,P004004,3.783,-2,8,10
167,ULK,P002968,P006961,3.417,1,9,8
167,ULK,P002968,P008962,7.2,-1,17,18
167,ULK,P002968,P009783,3.783,-2,8,10
167,ULK,P002968,P010560,1.717,-2,2,4
167,ULK,P002968,P011205,3.417,1,9,8
167,ULK,P002968,P013396,5.483,1,15,14
167,ULK,P004004,P006961,17.25,0,37,37
167,ULK,P004004,P007182,12.866,3,29,26
167,ULK,P004004,P008962,20.217,10,49,39
167,ULK,P004004,P009783,7.866,-4,15,19
167,ULK,P004004,P010560,5.783,13,17,4
167,ULK,P004004,P011205,17.683,11,45,34
167,ULK,P004004,P013396,10.183,9,25,16
167,ULK,P006961,P007182,13.666,-11,24,35
167,ULK,P006961,P008962,19.817,6,45,39
167,ULK,P006961,P009783,4.566,-2,8,10
167,ULK,P006961,P010560,5.034,-1,7,8
167,ULK,P006961,P011205,20.783,-3,44,47
167,ULK,P006961,P013396,5.833,4,14,10
167,ULK,P007182,P008962,11.667,-1,21,22
167,ULK,P007182,P009783,4.566,-2,8,10
167,ULK,P007182,P010560,8.45,10,20,10
167,ULK,P007182,P011205,16.716,0,34,34
167,ULK,P007182,P013396,5.316,-1,7,8
167,ULK,P008962,P009783,4.633,-4,10,14
167,ULK,P008962,P010560,12.051,6,18,12
167,ULK,P008962,P011205,24.967,9,52,43
167,ULK,P008962,P013396,15.666,2,30,28
167,ULK,P009783,P011205,2.183,-4,5,9
167,ULK,P009783,P013396,4.633,-4,10,14
167,ULK,P010560,P011205,13.417,14,26,12
167,ULK,P010560,P013396,6.183,7,11,4
167,ULK,P011205,P013396,10.399,5,21,16
168,PAN,P001926,P004088,6.967,-5,14,19
168,PAN,P001926,P005161,4.466,11,16,5
168,PAN,P001926,P005353,9.383,5,28,23
168,PAN,P001926,P007866,5.216,-2,12,14
168,PAN,P001926,P009622,9.1,12,24,12
168,PAN,P001926,P011204,3.95,-3,8,11
168,PAN,P001926,P012712,12.034,4,30,26
168,PAN,P001926,P012774,8.017,-9,18,27
168,PAN,P001926,P013383,5.867,-1,10,11
168,PAN,P004088,P005353,9.049,16,38,22
168,PAN,P004088,P007866,2.2,1,6,5
168,PAN,P004088,P009622,9.0,15,30,15
168,PAN,P004088,P011204,3.883,1,11,10
168,PAN,P004088,P012712,13.883,9,43,34
168,PAN,P004088,P012774,12.316,9,43,34
168,PAN,P004088,P013383,7.034,-6,11,17
168,PAN,P005161,P005353,15.067,10,39,29
168,PAN,P005161,P007866,3.333,-4,6,10
168,PAN,P005161,P009622,9.833,10,29,19
168,PAN,P005161,P011204,5.667,1,12,11
168,PAN,P005161,P012712,12.167,15,35,20
168,PAN,P005161,P012774,11.034,0,25,25
168,PAN,P005161,P013383,0.433,1,2,1
168,PAN,P005353,P007866,4.483,-8,6,14
168,PAN,P005353,P009622,15.5,23,53,30
168,PAN,P005353,P011204,10.9,4,26,22
168,PAN,P005353,P012712,23.45,32,79,47
168,PAN,P005353,P012774,23.9,14,71,57
168,PAN,P007866,P009622,5.533,-3,12,15
168,PAN,P007866,P011204,4.35,-5,8,13
168,PAN,P007866,P011209,1.767,-1,4,5
168,PAN,P007866,P012712,2.767,-2,6,8
168,PAN,P007866,P012774,7.25,-10,12,22
168,PAN,P007866,P013383,2.633,2,8,6
168,PAN,P009622,P012712,14.167,28,49,21
168,PAN,P009622,P012774,11.467,13,39,26
168,PAN,P009622,P013383,4.2,2,8,6
168,PAN,P011204,P011209,3.6,3,11,8
168,PAN,P011204,P012712,15.517,5,40,35
168,PAN,P011204,P012774,17.1,2,42,40
168,PAN,P011204,P013383,3.433,0,10,10
168,PAN,P011209,P012712,3.6,3,11,8
168,PAN,P011209,P012774,3.6,3,11,8
168,PAN,P011209,P013383,1.833,4,7,3
168,PAN,P012712,P012774,27.284,17,83,66
168,PAN,P012712,P013383,6.667,-3,12,15
168,PAN,P012774,P013383,5.1,-3,12,15
168,VIR,P001844,P002084,3.434,0,10,10
168,VIR,P001844,P004888,3.434,0,10,10
168,VIR,P001844,P005738,0.817,-2,0,2
168,VIR,P001844,P006739,3.434,0,10,10
168,VIR,P001844,P013374,2.617,2,10,8
168,VIR,P002084,P004888,15.167,-13,32,45
168,VIR,P002084,P005738,1.434,-3,3,6
168,VIR,P002084,P006739,16.75,-14,36,50
168,VIR,P002084,P009549,9.833,-10,19,29
168,VIR,P002084,P012585,4.033,-10,4,14
168,VIR,P002084,P012591,1.167,-7,0,7
168,VIR,P002084,P013374,16.483,-18,33,51
168,VIR,P002084,PBCN,3.367,-9,7,16
168,VIR,P004888,P005738,8.118,7,21,14
168,VIR,P004888,P006739,24.251,-11,56,67
168,VIR,P004888,P009549,16.067,-10,33,43
168,VIR,P004888,P011816,8.584,11,23,12
168,VIR,P004888,P012585,7.567,-3,15,18
168,VIR,P004888,P013374,20.4,-17,44,61
168,VIR,P004888,PBCN,10.484,-4,26,30
168,VIR,P005738,P006739,6.301,3,15,12
168,VIR,P005738,P009549,11.35,3,29,26
168,VIR,P005738,P011816,14.55,7,37,30
168,VIR,P005738,P012585,9.683,1,25,24
168,VIR,P005738,P012591,3.883,-3,5,8
168,VIR,P005738,PBCN,7.8,3,25,22
168,VIR,P006739,P009549,13.167,-12,27,39
168,VIR,P006739,P011816,5.4,8,14,6
168,VIR,P006739,P012585,4.883,-5,10,15
168,VIR,P006739,P013374,19.533,-15,45,60
168,VIR,P006739,PBCN,9.617,-2,27,29
168,VIR,P009549,P011816,11.35,3,29,26
168,VIR,P009549,P012585,10.766,-1,25,26
168,VIR,P009549,P012591,3.883,-3,5,8
168,VIR,P009549,P013374,12.583,-16,23,39
168,VIR,P009549,PBCN,6.733,-6,18,24
168,VIR,P011816,P012585,11.917,0,30,30
168,VIR,P011816,P012591,4.75,-3,7,10
168,VIR,P011816,P013374,2.767,1,7,6
168,VIR,P011816,PBCN,9.95,5,29,24
168,VIR,P012585,P012591,5.917,-10,7,17
168,VIR,P012585,P013374,9.367,-15,15,30
168,VIR,P012585,PBCN,12.067,-13,29,42
168,VIR,P012591,P013374,2.034,-7,2,9
168,VIR,P012591,PBCN,2.034,-7,2,9
168,VIR,P013374,PBCN,10.284,-15,21,36
169,BAR,P002939,P003196,13.299,5,33,28
169,BAR,P002939,P003478,19.05,6,47,41
169,BAR,P002939,P006568,6.65,3,16,13
169,BAR,P002939,P009862,22.916,8,56,48
169,BAR,P002939,P009992,2.083,0,4,4
169,BAR,P002939,P012745,22.916,8,56,48
169,BAR,P002939,P012795,1.783,2,5,3
169,BAR,P002939,P013379,2.967,0,7,7
169,BAR,P003196,P003478,14.683,6,37,31
169,BAR,P003196,P009862,20.166,11,51,40
169,BAR,P003196,P009992,1.65,0,4,4
169,BAR,P003196,P010106,7.267,6,20,14
169,BAR,P003196,P012745,18.266,11,47,36
169,BAR,P003196,P012795,4.633,5,14,9
169,BAR,P003196,P013379,2.3,0,6,6
169,BAR,P003478,P006568,6.95,4,17,13
169,BAR,P003478,P009862,23.883,10,59,49
169,BAR,P003478,P009992,3.133,-2,8,10
169,BAR,P003478,P010106,7.6,2,20,18
169,BAR,P003478,P012745,26.533,7,66,59
169,BAR,P003478,P013379,5.5,-1,14,15
169,BAR,P006568,P009862,7.767,4,17,13
169,BAR,P006568,P009992,4.15,3,5,2
169,BAR,P006568,P010106,5.267,4,6,2
169,BAR,P006568,P012745,6.65,3,16,13
169,BAR,P006568,P012795,4.967,3,5,2
169,BAR,P006568,P013379,5.267,4,6,2
169,BAR,P009862,P009992,3.749,-5,4,9
169,BAR,P009862,P010106,9.4,2,19,17
169,BAR,P009862,P012745,29.249,11,70,59
169,BAR,P009862,P012795,5.283,3,12,9
169,BAR,P009862,P013379,7.583,-4,12,16
169,BAR,P009992,P010106,8.983,-4,15,19
169,BAR,P009992,P012745,6.399,-5,12,17
169,BAR,P009992,P012795,4.783,1,7,6
169,BAR,P009992,P013379,10.066,-4,17,21
169,BAR,P010106,P012745,9.1,1,22,21
169,BAR,P010106,P012795,8.05,4,14,10
169,BAR,P010106,P013379,11.933,-3,20,23
169,BAR,P012745,P012795,2.4,5,8,3
169,BAR,P012745,P013379,7.283,-5,15,20
169,BAR,P012795,P013379,7.433,1,11,10
169,PRS,P004197,P004512,0.3,0,0,0
169,PRS,P004197,P005793,1.183,1,2,1
169,PRS,P004197,P010390,13.517,-8,24,32
169,PRS,P004197,P012608,14.7,-7,26,33
169,PRS,P004197,P012610,14.7,-7,26,33
169,PRS,P004197,P012613,14.4,-7,26,33
169,PRS,P004512,P005793,4.417,-4,8,12
169,PRS,P004512,P007032,4.117,-4,8,12
169,PRS,P004512,P012608,1.75,0,0,0
169,PRS,P004512,P012609,5.567,-4,8,12
169,PRS,P004512,P012610,1.75,0,0,0
169,PRS,P004512,P012613,1.45,0,0,0
169,PRS,P004512,P012640,4.117,-4,8,12
169,PRS,P005793,P007032,17.451,-10,31,41
169,PRS,P005793,P010390,4.867,-1,9,10
169,PRS,P005793,P012608,6.45,-5,7,12
169,PRS,P005793,P012609,13.784,-2,32,34
169,PRS,P005793,P012610,3.083,-1,6,7
169,PRS,P005793,P012613,3.983,-4,7,11
169,PRS,P005793,P012640,16.351,-7,30,37
169,PRS,P005793,P013373,6.167,1,12,11
169,PRS,P007032,P010390,9.184,-1,21,22
169,PRS,P007032,P012608,8.784,-7,14,21
169,PRS,P007032,P012609,12.984,-3,29,32
169,PRS,P007032,P012610,5.617,-2,14,16
169,PRS,P007032,P012613,6.617,-6,14,20
169,PRS,P007032,P012640,16.151,-8,29,37
169,PRS,P007032,P013373,6.167,1,12,11
169,PRS,P010390,P012608,21.001,-13,36,49
169,PRS,P010390,P012609,1.7,4,9,5
169,PRS,P010390,P012610,17.834,-8,36,44
169,PRS,P010390,P012613,17.834,-8,36,44
169,PRS,P010390,P012640,4.867,-1,9,10
169,PRS,P012608,P012609,3.533,6,10,4
169,PRS,P012608,P012610,23.65,-4,49,53
169,PRS,P012608,P012613,23.55,-3,50,53
169,PRS,P012608,P012640,4.4,-2,5,7
169,PRS,P012608,P013373,0.25,3,3,0
169,PRS,P012609,P012610,3.333,5,9,4
169,PRS,P012609,P012613,4.533,2,10,8
169,PRS,P012609,P012640,14.217,0,34,34
169,PRS,P012609,P013373,6.417,4,15,11
169,PRS,P012610,P012613,23.35,-4,49,53
169,PRS,P012610,P012640,1.033,2,4,2
169,PRS,P012610,P013373,0.25,3,3,0
169,PRS,P012613,P012640,2.233,-1,5,6
169,PRS,P012613,P013373,0.25,3,3,0
169,PRS,P012640,P013373,6.167,1,12,11
170,PAR,P006591,P006760,0.833,2,2,0
170,PAR,P006591,P007870,3.966,5,11,6
170,PAR,P006591,P008232,7.2,15,23,8
170,PAR,P006591,P010781,10.199,1,21,20
170,PAR,P006591,P011836,9.416,1,17,16
170,PAR,P006591,P011981,14.266,13,35,22
170,PAR,P006591,P012720,8.816,17,29,12
170,PAR,P006591,P013369,5.249,5,14,9
170,PAR,P006591,P013370,12.983,13,32,19
170,PAR,P006760,P007632,12.867,6,25,19
170,PAR,P006760,P007870,11.667,6,23,17
170,PAR,P006760,P011981,4.233,4,10,6
170,PAR,P006760,P012720,15.9,10,33,23
170,PAR,P006760,P013369,15.067,8,31,23
170,PAR,P006760,P013370,3.033,4,8,4
170,PAR,P007632,P007870,11.667,6,23,17
170,PAR,P007632,P008232,3.233,-4,7,11
170,PAR,P007632,P010781,6.7,-3,21,24
170,PAR,P007632,P011050,3.467,1,14,13
170,PAR,P007632,P011836,3.467,1,14,13
170,PAR,P007632,P011981,4.433,-4,9,13
170,PAR,P007632,P012720,12.867,6,25,19
170,PAR,P007632,P013369,12.867,6,25,19
170,PAR,P007632,P013370,6.7,-3,21,24
170,PAR,P007870,P010781,3.966,5,11,6
170,PAR,P007870,P011836,3.183,5,7,2
170,PAR,P007870,P012720,12.45,6,27,21
170,PAR,P007870,P013369,15.633,11,34,23
170,PAR,P008232,P010781,3.233,-4,7,11
170,PAR,P008232,P011981,10.433,11,30,19
170,PAR,P008232,P012720,7.2,15,23,8
170,PAR,P008232,P013369,1.283,0,3,3
170,PAR,P008232,P013370,9.15,11,27,16
170,PAR,P010781,P011050,3.467,1,14,13
170,PAR,P010781,P011836,12.883,2,31,29
170,PAR,P010781,P011981,9.466,-8,17,25
170,PAR,P010781,P012720,0.783,0,4,4
170,PAR,P010781,P013369,3.966,5,11,6
170,PAR,P010781,P013370,12.933,-7,31,38
170,PAR,P011050,P011836,3.467,1,14,13
170,PAR,P011050,P013370,3.467,1,14,13
170,PAR,P011836,P011981,6.233,-4,10,14
170,PAR,P011836,P013369,3.183,5,7,2
170,PAR,P011836,P013370,9.7,-3,24,27
170,PAR,P011981,P012720,11.433,19,33,14
170,PAR,P011981,P013369,4.683,2,11,9
170,PAR,P011981,P013370,18.416,11,45,34
170,PAR,P012720,P013369,17.133,8,38,30
170,PAR,P012720,P013370,8.95,19,28,9
170,PAR,P013369,P013370,2.2,2,6,4
170,TEL,P006835,P007519,17.234,-13,30,43
170,TEL,P006835,P007990,17.051,-3,44,47
170,TEL,P006835,P011193,25.484,-2,52,54
170,TEL,P006835,P011202,7.066,-4,17,21
170,TEL,P006835,P011219,18.967,-4,39,43
170,TEL,P006835,P012604,12.451,-5,28,33
170,TEL,P006835,P013250,2.35,-6,2,8
170,TEL,P006835,P013381,7.8,-3,19,22
170,TEL,P006835,P013382,21.469,-12,37,49
170,TEL,P007519,P007990,3.967,-7,9,16
170,TEL,P007519,P011193,12.4,-6,17,23
170,TEL,P007519,P011202,0.933,-2,0,2
170,TEL,P007519,P011219,11.933,-1,26,27
170,TEL,P007519,P012604,6.651,-4,12,16
170,TEL,P007519,P013250,1.4,0,4,4
170,TEL,P007519,P013381,3.65,0,12,12
170,TEL,P007519,P013382,15.568,-11,26,37
170,TEL,P007990,P011193,14.534,0,35,35
170,TEL,P007990,P011202,7.283,-1,19,20
170,TEL,P007990,P011219,12.817,-3,27,30
170,TEL,P007990,P012604,9.567,-10,21,31
170,TEL,P007990,P013250,4.0,-8,4,12
170,TEL,P007990,P013381,10.817,-15,19,34
170,TEL,P007990,P013382,9.968,-13,14,27
170,TEL,P011193,P011202,4.716,2,15,13
170,TEL,P011193,P011219,14.084,-2,29,31
170,TEL,P011193,P012604,12.117,-4,23,27
170,TEL,P011193,P013381,5.5,-7,7,14
170,TEL,P011193,P013382,18.901,-5,30,35
170,TEL,P011202,P011219,6.333,-7,6,13
170,TEL,P011202,P012604,4.866,2,15,13
170,TEL,P011202,P013250,6.533,-9,6,15
170,TEL,P011202,P013381,5.066,-5,4,9
170,TEL,P011202,P013382,2.2,-4,2,6
170,TEL,P011219,P012604,2.083,2,4,2
170,TEL,P011219,P013250,8.233,-10,10,20
170,TEL,P011219,P013381,10.083,-9,19,28
170,TEL,P011219,P013382,15.667,-6,28,34
170,TEL,P012604,P013250,2.083,2,4,2
170,TEL,P012604,P013381,2.117,-2,4,6
170,TEL,P012604,P013382,12.001,-9,17,26
170,TEL,P013250,P013381,5.033,-10,4,14
170,TEL,P013250,P013382,4.1,-7,6,13
170,TEL,P013381,P013382,2.934,-9,4,13
171,MAD,P003108,P003583,4.9,2,11,9
171,MAD,P003108,P003733,7.6,-1,15,16
171,MAD,P003108,P005791,9.216,4,21,17
171,MAD,P003108,P005928,11.067,17,36,19
171,MAD,P003108,P006540,6.716,17,26,9
171,MAD,P003108,P007630,10.901,2,24,22
171,MAD,P003108,P011247,13.95,-9,20,29
171,MAD,P003108,P011649,5.117,12,14,2
171,MAD,P003108,P013378,12.05,-4,24,28
171,MAD,P003108,PTGB,18.551,-8,33,41
171,MAD,P003583,P003733,1.05,0,2,2
171,MAD,P003583,P005928,2.283,4,10,6
171,MAD,P003583,P006540,2.283,4,10,6
171,MAD,P003583,P009213,2.033,3,7,4
171,MAD,P003583,P011247,4.65,1,8,7
171,MAD,P003583,P011649,0.117,0,0,0
171,MAD,P003583,P013378,4.533,1,8,7
171,MAD,P003583,PTGB,5.883,5,16,11
171,MAD,P003733,P005791,19.25,3,40,37
171,MAD,P003733,P005928,16.367,3,37,34
171,MAD,P003733,P006540,16.85,7,38,31
171,MAD,P003733,P007630,0.867,-1,0,1
171,MAD,P003733,P009213,13.567,3,27,24
171,MAD,P003733,P011247,4.8,-1,5,6
171,MAD,P003733,PTGB,4.317,-5,4,9
171,MAD,P005791,P005928,18.233,5,41,36
171,MAD,P005791,P006540,17.416,10,41,31
171,MAD,P005791,P009213,12.95,1,25,24
171,MAD,P005791,P011247,3.933,0,5,5
171,MAD,P005791,P011649,1.616,3,5,2
171,MAD,P005791,P013378,1.3,-1,1,2
171,MAD,P005791,PTGB,4.75,-5,5,10
171,MAD,P005928,P006540,19.549,18,53,35
171,MAD,P005928,P007630,4.334,10,15,5
171,MAD,P005928,P009213,13.783,2,30,28
171,MAD,P005928,P011649,4.683,12,14,2
171,MAD,P005928,P013378,2.567,0,7,7
171,MAD,P005928,PTGB,6.534,5,21,16
171,MAD,P006540,P007630,2.0,7,7,0
171,MAD,P006540,P009213,14.983,4,32,28
171,MAD,P006540,P011247,2.15,3,5,2
171,MAD,P006540,P011649,3.616,10,12,2
171,MAD,P006540,PTGB,1.233,4,8,4
171,MAD,P007630,P011247,6.567,-8,9,17
171,MAD,P007630,P011649,3.817,7,9,2
171,MAD,P007630,P013378,6.217,-4,15,19
171,MAD,P007630,PTGB,8.901,-5,17,22
171,MAD,P009213,P011247,1.2,2,2,0
171,MAD,P009213,P011649,0.433,-2,0,2
171,MAD,P009213,PTGB,0.983,3,5,2
171,MAD,P011247,P011649,0.867,-2,0,2
171,MAD,P011247,P013378,9.483,-4,17,21
171,MAD,P011247,PTGB,13.0,-10,17,27
171,MAD,P011649,PTGB,1.934,0,2,2
171,MAD,P013378,PTGB,12.05,-4,24,28
171,MUN,P001557,P004508,9.533,-7,20,27
171,MUN,P001557,P005460,1.467,-1,4,5
171,MUN,P001557,P007056,20.299,-15,35,50
171,MUN,P001557,P007201,9.733,-15,10,25
171,MUN,P001557,P011224,18.583,-10,33,43
171,MUN,P001557,P011244,6.733,0,17,17
171,MUN,P001557,P011987,19.733,-15,33,48
171,MUN,P001557,P012123,0.983,-1,4,5
171,MUN,P004508,P005460,10.467,-3,21,24
171,MUN,P004508,P007056,17.3,0,36,36
171,MUN,P004508,P007201,7.767,-4,16,20
171,MUN,P004508,P007929,10.767,0,26,26
171,MUN,P004508,P011224,14.733,4,32,28
171,MUN,P004508,P011244,14.7,2,29,27
171,MUN,P004508,P011987,18.451,0,35,35
171,MUN,P004508,P012123,7.35,-4,13,17
171,MUN,P005460,P007201,5.567,1,14,13
171,MUN,P005460,P007929,9.6,-3,21,24
171,MUN,P005460,P011224,3.25,0,11,11
171,MUN,P005460,P011244,6.367,-5,11,16
171,MUN,P005460,P011987,4.651,-2,9,11
171,MUN,P005460,P012123,6.367,-3,9,12
171,MUN,P007056,P007201,9.733,-15,10,25
171,MUN,P007056,P007929,1.167,3,5,2
171,MUN,P007056,P011224,23.716,-5,40,45
171,MUN,P007056,P011244,13.033,8,29,21
171,MUN,P007056,P011987,26.033,-7,45,52
171,MUN,P007056,P012123,0.983,-1,4,5
171,MUN,P007201,P007929,4.7,1,14,13
171,MUN,P007201,P011224,9.316,-9,15,24
171,MUN,P007201,P011987,10.6,-15,10,25
171,MUN,P007201,P012123,3.784,0,7,7
171,MUN,P007929,P011224,1.783,1,7,6
171,MUN,P007929,P011244,6.067,-1,12,13
171,MUN,P007929,P011987,3.484,2,10,8
171,MUN,P007929,P012123,5.5,-3,9,12
171,MUN,P011224,P011244,12.35,5,24,19
171,MUN,P011224,P011987,24.133,-6,42,48
171,MUN,P011244,P011987,14.784,7,32,25
171,MUN,P011244,P012123,3.566,-4,6,10
171,MUN,P011987,P012123,0.867,0,0,0
172,BER,P006251,P007025,4.35,2,9,7
172,BER,P006251,P008062,14.133,-7,23,30
172,BER,P006251,P008173,7.55,5,19,14
172,BER,P006251,P008211,9.666,-4,19,23
172,BER,P006251,P008384,15.15,-2,27,29
172,BER,P006251,P008780,6.1,3,17,14
172,BER,P006251,P008967,12.75,-9,18,27
172,BER,P006251,P011934,5.133,-6,11,17
172,BER,P006251,P013386,18.1,2,33,31
172,BER,P007025,P008062,1.35,2,5,3
172,BER,P007025,P008173,2.4,0,2,2
172,BER,P007025,P008211,1.583,-2,2,4
172,BER,P007025,P008384,4.35,2,9,7
172,BER,P007025,P008780,0.983,-2,0,2
172,BER,P007025,P011631,0.983,-2,0,2
172,BER,P007025,P011934,0.983,-2,0,2
172,BER,P007025,P013386,4.35,2,9,7
172,BER,P008062,P008173,2.917,-3,7,10
172,BER,P008062,P008211,4.933,-9,7,16
172,BER,P008062,P008384,19.267,-12,34,46
172,BER,P008062,P008967,19.933,-20,29,49
172,BER,P008062,P011631,9.484,-11,18,29
172,BER,P008062,P011934,10.3,-18,19,37
172,BER,P008062,P013386,14.483,-6,22,28
172,BER,P008173,P008211,13.217,3,33,30
172,BER,P008173,P008384,2.334,2,4,2
172,BER,P008173,P008780,12.2,4,28,24
172,BER,P008173,P011631,8.734,-2,18,20
172,BER,P008173,P011934,11.267,-4,23,27
172,BER,P008173,P013386,5.517,7,14,7
172,BER,P008211,P008384,1.583,-2,2,4
172,BER,P008211,P008780,11.817,6,28,22
172,BER,P008211,P008967,3.533,-6,2,8
172,BER,P008211,P011631,8.417,-1,18,19
172,BER,P008211,P011934,10.95,-3,23,26
172,BER,P008211,P013386,7.633,-2,14,16
172,BER,P008384,P008967,17.0,-14,27,41
172,BER,P008384,P011631,6.534,-7,11,18
172,BER,P008384,P011934,7.317,-14,12,26
172,BER,P008384,P013386,15.533,-1,26,27
172,BER,P008780,P008967,0.6,0,0,0
172,BER,P008780,P011631,6.45,1,11,10
172,BER,P008780,P011934,8.95,-1,16,17
172,BER,P008780,P013386,4.1,5,12,7
172,BER,P008967,P011631,7.2,-8,11,19
172,BER,P008967,P011934,7.983,-15,12,27
172,BER,P008967,P013386,13.133,-8,17,25
172,BER,P011631,P011934,13.284,-10,24,34
172,BER,P011631,P013386,2.65,0,5,5
172,BER,P011934,P013386,0.833,-3,0,3
172,ULK,P002849,P002969,2.483,-5,2,7
172,ULK,P002849,P004004,2.917,1,5,4
172,ULK,P002849,P006961,8.084,4,20,16
172,ULK,P002849,P007182,1.667,1,3,2
172,ULK,P002849,P008962,6.583,-6,16,22
172,ULK,P002849,P010560,11.167,-4,24,28
172,ULK,P002849,P011205,9.867,-4,22,26
172,ULK,P002849,P013396,1.9,-3,4,7
172,ULK,P002968,P002969,0.483,2,2,0
172,ULK,P002968,P003091,0.483,2,2,0
172,ULK,P002968,P004004,15.7,18,39,21
172,ULK,P002968,P006961,9.449,19,31,12
172,ULK,P002968,P008962,21.449,24,55,31
172,ULK,P002968,P009783,13.516,7,28,21
172,ULK,P002968,P010560,3.466,7,14,7
172,ULK,P002968,P011205,12.033,19,36,17
172,ULK,P002968,P013396,11.149,6,21,15
172,ULK,P002969,P003091,1.583,2,4,2
172,ULK,P002969,P004004,1.55,0,5,5
172,ULK,P002969,P006961,1.583,2,4,2
172,ULK,P002969,P007182,2.383,0,5,5
172,ULK,P002969,P008962,4.866,-5,7,12
172,ULK,P002969,P010560,5.966,-5,9,14
172,ULK,P002969,P011205,3.316,-5,2,7
172,ULK,P002969,P013396,1.583,2,4,2
172,ULK,P003091,P006961,1.583,2,4,2
172,ULK,P003091,P010560,1.1,0,2,2
172,ULK,P003091,P013396,1.583,2,4,2
172,ULK,P004004,P006961,9.467,14,26,12
172,ULK,P004004,P007182,1.55,0,5,5
172,ULK,P004004,P008962,17.25,18,44,26
172,ULK,P004004,P009783,9.15,5,18,13
172,ULK,P004004,P010560,6.55,4,18,14
172,ULK,P004004,P011205,7.901,14,23,9
172,ULK,P004004,P013396,8.633,2,13,11
172,ULK,P006961,P007182,2.884,-1,3,4
172,ULK,P006961,P008962,13.683,17,41,24
172,ULK,P006961,P009783,1.033,0,2,2
172,ULK,P006961,P010560,13.867,9,36,27
172,ULK,P006961,P011205,14.884,16,39,23
172,ULK,P006961,P013396,2.883,2,6,4
172,ULK,P007182,P008962,5.8,-5,7,12
172,ULK,P007182,P009783,2.2,-3,2,5
172,ULK,P007182,P010560,5.267,-1,8,9
172,ULK,P007182,P011205,5.917,-4,5,9
172,ULK,P007182,P013396,2.2,-3,2,5
172,ULK,P008962,P009783,15.716,4,30,26
172,ULK,P008962,P010560,13.649,-1,35,36
172,ULK,P008962,P011205,22.866,8,54,46
172,ULK,P008962,P013396,13.466,-2,23,25
172,ULK,P009783,P011205,8.383,2,19,17
172,ULK,P009783,P013396,12.866,1,21,20
172,ULK,P010560,P011205,13.3,-2,28,30
172,ULK,P010560,P013396,3.0,-3,6,9
172,ULK,P011205,P013396,6.133,-4,12,16
173,BAR,P002939,P003478,8.533,13,22,9
173,BAR,P002939,P006568,6.833,3,13,10
173,BAR,P002939,P007464,5.534,3,10,7
173,BAR,P002939,P009862,7.266,3,13,10
173,BAR,P002939,P009992,11.234,5,25,20
173,BAR,P002939,P012745,14.516,8,33,25
173,BAR,P002939,P012795,9.967,-5,16,21
173,BAR,P002939,P013379,10.117,2,20,18
173,BAR,P003478,P006568,1.233,4,5,1
173,BAR,P003478,P007464,13.15,19,37,18
173,BAR,P003478,P009862,8.766,9,28,19
173,BAR,P003478,P009992,15.933,24,46,22
173,BAR,P003478,P010106,6.25,4,14,10
173,BAR,P003478,P012745,8.299,8,23,15
173,BAR,P003478,P012795,0.316,-2,0,2
173,BAR,P003478,P013379,17.116,17,45,28
173,BAR,P006568,P009862,12.567,2,26,24
173,BAR,P006568,P009992,4.067,-4,7,11
173,BAR,P006568,P010106,1.667,3,6,3
173,BAR,P006568,P012745,12.567,2,26,24
173,BAR,P006568,P012795,11.334,-2,21,23
173,BAR,P007464,P009862,8.1,9,30,21
173,BAR,P007464,P009992,16.601,18,48,30
173,BAR,P007464,P010106,3.05,6,8,2
173,BAR,P007464,P012745,1.55,3,5,2
173,BAR,P007464,P012795,3.617,-1,11,12
173,BAR,P007464,P013379,15.134,15,43,28
173,BAR,P009862,P009992,13.267,1,40,39
173,BAR,P009862,P010106,3.884,-1,10,11
173,BAR,P009862,P012745,16.4,-6,33,39
173,BAR,P009862,P012795,15.817,-6,35,41
173,BAR,P009862,P013379,11.933,1,37,36
173,BAR,P009992,P010106,4.033,8,10,2
173,BAR,P009992,P012745,13.716,-3,32,35
173,BAR,P009992,P012795,13.067,-14,29,43
173,BAR,P009992,P013379,23.15,13,63,50
173,BAR,P010106,P012745,4.867,1,12,11
173,BAR,P010106,P012795,1.667,3,6,3
173,BAR,P010106,P013379,6.25,4,14,10
173,BAR,P012745,P012795,16.8,-11,32,43
173,BAR,P012745,P013379,10.749,-6,24,30
173,BAR,P012795,P013379,9.083,-10,22,32
173,MCO,P001932,P005844,2.617,-5,3,8
173,MCO,P001932,P005985,5.683,-9,5,14
173,MCO,P001932,P008099,0.65,-2,0,2
173,MCO,P001932,P009754,8.933,-15,13,28
173,MCO,P001932,P011212,3.9,-8,8,16
173,MCO,P001932,P011231,4.55,-10,8,18
173,MCO,P001932,P013365,5.033,-7,5,12
173,MCO,P001932,PLCZ,6.966,-12,10,22
173,MCO,P002581,P005985,5.484,-5,10,15
173,MCO,P002581,P008099,6.868,-6,12,18
173,MCO,P002581,P009754,2.751,-7,4,11
173,MCO,P002581,P011212,3.384,-3,6,9
173,MCO,P002581,P011231,3.801,-6,6,12
173,MCO,P002581,P012515,5.117,0,10,10
173,MCO,P002581,P013365,4.067,-1,8,9
173,MCO,P005844,P005985,18.717,13,51,38
173,MCO,P005844,P008099,18.217,16,53,37
173,MCO,P005844,P009754,12.667,0,26,26
173,MCO,P005844,P011212,14.584,-4,31,35
173,MCO,P005844,P011231,14.151,-7,25,32
173,MCO,P005844,P012515,3.35,-2,4,6
173,MCO,P005844,P013365,9.233,13,31,18
173,MCO,P005985,P008099,22.267,13,63,50
173,MCO,P005985,P009754,17.167,-4,32,36
173,MCO,P005985,P011212,12.7,1,32,31
173,MCO,P005985,P011231,12.884,-9,24,33
173,MCO,P005985,P012515,4.55,1,10,9
173,MCO,P005985,P013365,19.733,6,48,42
173,MCO,P005985,PLCZ,5.083,-7,5,12
173,MCO,P008099,P009754,9.484,6,27,21
173,MCO,P008099,P011212,13.967,1,36,35
173,MCO,P008099,P011231,14.151,-9,28,37
173,MCO,P008099,P012515,8.467,-2,14,16
173,MCO,P008099,P013365,14.7,13,43,30
173,MCO,P008099,PLCZ,0.433,-2,0,2
173,MCO,P009754,P011212,9.017,-15,14,29
173,MCO,P009754,P011231,13.068,-18,21,39
173,MCO,P009754,P013365,9.116,3,21,18
173,MCO,P009754,PLCZ,6.533,-10,10,20
173,MCO,P011212,P011231,16.884,-20,29,49
173,MCO,P011212,P012515,3.917,-3,4,7
173,MCO,P011212,P013365,6.3,4,19,15
173,MCO,P011212,PLCZ,1.883,-5,5,10
173,MCO,P011231,P012515,3.917,-3,4,7
173,MCO,P011231,P013365,1.55,-3,2,5
173,MCO,P011231,PLCZ,2.316,-7,5,12
173,MCO,P012515,P013365,4.55,1,10,9
173,MCO,P013365,PLCZ,4.65,-5,5,10
174,PAN,P004088,P005161,3.417,3,8,5
174,PAN,P004088,P005353,16.634,8,40,32
174,PAN,P004088,P007866,7.7,-1,16,17
174,PAN,P004088,P011204,26.317,3,63,60
174,PAN,P004088,P012712,21.834,1,52,51
174,PAN,P004088,P012774,24.434,6,61,55
174,PAN,P004088,P013383,8.0,4,24,20
174,PAN,P005161,P005353,6.934,12,23,11
174,PAN,P005161,P007866,1.0,-1,0,1
174,PAN,P005161,P011204,5.317,7,15,8
174,PAN,P005161,P011209,3.667,7,11,4
174,PAN,P005161,P012712,7.934,11,23,12
174,PAN,P005161,P012774,3.467,5,12,7
174,PAN,P005353,P007866,1.717,2,6,4
174,PAN,P005353,P011204,26.934,10,62,52
174,PAN,P005353,P011209,12.067,5,26,21
174,PAN,P005353,P012712,27.834,12,64,52
174,PAN,P005353,P012774,26.084,7,59,52
174,PAN,P007866,P011204,7.7,-1,16,17
174,PAN,P007866,P012712,2.45,-6,2,8
174,PAN,P007866,P012774,6.7,0,16,16
174,PAN,P007866,P013383,3.533,3,8,5
174,PAN,P011204,P011209,10.217,4,21,17
174,PAN,P011204,P012712,32.134,3,74,71
174,PAN,P011204,P012774,32.917,2,77,75
174,PAN,P011204,P013383,8.0,4,24,20
174,PAN,P011209,P012712,12.067,5,26,21
174,PAN,P011209,P012774,10.25,-1,20,21
174,PAN,P012712,P012774,30.284,1,71,70
174,PAN,P012712,P013383,4.467,1,16,15
174,PAN,P012774,P013383,8.0,4,24,20
174,PAR,P006591,P006760,4.534,2,8,6
174,PAR,P006591,P007870,5.234,4,12,8
174,PAR,P006591,P008232,7.0,3,16,13
174,PAR,P006591,P010781,6.633,3,16,13
174,PAR,P006591,P011836,0.15,0,0,0
174,PAR,P006591,P011981,8.75,1,20,19
174,PAR,P006591,P012720,12.834,5,28,23
174,PAR,P006591,P013369,6.201,2,12,10
174,PAR,P006760,P007870,12.834,-3,29,32
174,PAR,P006760,P008232,3.05,3,12,9
174,PAR,P006760,P010781,20.267,-10,44,54
174,PAR,P006760,P011836,13.1,-5,29,34
174,PAR,P006760,P011981,12.184,-7,21,28
174,PAR,P006760,P012720,20.284,0,45,45
174,PAR,P006760,P013369,8.434,-4,13,17
174,PAR,P006760,P013370,4.517,-8,7,15
174,PAR,P007632,P007870,3.533,-3,5,8
174,PAR,P007632,P008232,4.05,-5,5,10
174,PAR,P007632,P010781,4.05,-5,5,10
174,PAR,P007632,P011981,0.517,-2,0,2
174,PAR,P007632,P013370,4.05,-5,5,10
174,PAR,P007870,P008232,5.883,-3,10,13
174,PAR,P007870,P010781,15.383,-13,32,45
174,PAR,P007870,P011836,6.0,-8,11,19
174,PAR,P007870,P011981,5.167,-2,15,17
174,PAR,P007870,P012720,12.567,2,32,30
174,PAR,P007870,P013369,5.984,1,13,12
174,PAR,P007870,P013370,9.883,-11,17,28
174,PAR,P008232,P010781,15.416,1,38,37
174,PAR,P008232,P011836,3.05,3,12,9
174,PAR,P008232,P011981,7.0,1,16,15
174,PAR,P008232,P012720,11.883,6,33,27
174,PAR,P008232,P013369,0.517,0,0,0
174,PAR,P008232,P013370,5.883,-5,10,15
174,PAR,P010781,P011836,13.517,-4,30,34
174,PAR,P010781,P011981,19.384,-6,39,45
174,PAR,P010781,P012720,25.233,-1,60,61
174,PAR,P010781,P013369,4.65,-9,6,15
174,PAR,P010781,P013370,10.667,-12,18,30
174,PAR,P011836,P011981,4.467,1,7,6
174,PAR,P011836,P012720,9.0,4,23,19
174,PAR,P011836,P013370,4.784,-7,8,15
174,PAR,P011981,P012720,20.984,-6,43,49
174,PAR,P011981,P013369,6.767,-11,10,21
174,PAR,P011981,P013370,0.784,-1,1,2
174,PAR,P012720,P013369,10.851,-7,18,25
174,PAR,P012720,P013370,2.1,1,6,5
175,MIL,P000796,P001518,1.6,1,3,2
175,MIL,P000796,P005670,3.8,8,12,4
175,MIL,P000796,P006509,2.516,9,15,6
175,MIL,P000796,P007831,20.334,22,54,32
175,MIL,P000796,P008985,16.467,18,44,26
175,MIL,P000796,P008987,4.683,9,22,13
175,MIL,P000796,P011064,19.55,22,54,32
175,MIL,P000796,P011941,15.734,18,39,21
175,MIL,P000796,P013384,3.384,5,13,8
175,MIL,P001518,P005670,11.9,8,34,26
175,MIL,P001518,P006509,14.283,2,34,32
175,MIL,P001518,P006721,3.533,-2,8,10
175,MIL,P001518,P007831,4.5,4,12,8
175,MIL,P001518,P008985,5.9,7,17,10
175,MIL,P001518,P008987,13.65,7,35,28
175,MIL,P001518,P011064,4.35,-3,5,8
175,MIL,P001518,P013384,15.416,0,36,36
175,MIL,P005670,P006509,9.016,6,28,22
175,MIL,P005670,P006721,3.533,-2,8,10
175,MIL,P005670,P007831,5.084,9,15,6
175,MIL,P005670,P008985,2.734,6,10,4
175,MIL,P005670,P008987,8.267,14,30,16
175,MIL,P005670,P011064,1.333,2,2,0
175,MIL,P005670,P011941,0.7,2,2,0
175,MIL,P005670,P013384,10.033,7,31,24
175,MIL,P006509,P006721,3.533,-2,8,10
175,MIL,P006509,P007831,0.833,3,5,2
175,MIL,P006509,P008985,2.033,3,5,2
175,MIL,P006509,P008987,13.266,13,41,28
175,MIL,P006509,P011064,5.75,2,16,14
175,MIL,P006509,P013384,15.966,8,44,36
175,MIL,P006721,P013384,3.533,-2,8,10
175,MIL,P007831,P008985,20.167,21,53,32
175,MIL,P007831,P008987,6.7,6,21,15
175,MIL,P007831,P011064,18.35,20,48,28
175,MIL,P007831,P011941,16.534,18,39,21
175,MIL,P007831,P013384,3.634,-3,5,8
175,MIL,P008985,P008987,6.616,7,18,11
175,MIL,P008985,P011064,15.5,17,41,24
175,MIL,P008985,P011941,15.417,16,37,21
175,MIL,P008985,P013384,3.966,1,7,6
175,MIL,P008987,P011064,6.9,1,20,19
175,MIL,P008987,P011941,0.8,0,0,0
175,MIL,P008987,P013384,15.65,7,41,34
175,MIL,P011064,P011941,15.734,18,39,21
175,MIL,P011064,P013384,5.601,-3,11,14
175,MIL,P011941,P013384,1.217,0,0,0
175,TEL,P006835,P007519,17.432,-13,27,40
175,TEL,P006835,P007990,11.399,-6,24,30
175,TEL,P006835,P011193,18.867,-18,33,51
175,TEL,P006835,P011202,7.483,1,20,19
175,TEL,P006835,P011214,9.016,-11,11,22
175,TEL,P006835,P011219,4.483,-2,10,12
175,TEL,P006835,P012604,15.199,-12,30,42
175,TEL,P006835,P013250,2.399,-4,2,6
175,TEL,P006835,P013381,2.116,-6,0,6
175,TEL,P006835,P013382,19.266,-17,31,48
175,TEL,P007519,P007990,13.433,-5,28,33
175,TEL,P007519,P011193,11.25,-11,15,26
175,TEL,P007519,P011202,4.617,0,8,8
175,TEL,P007519,P011214,13.567,-10,22,32
175,TEL,P007519,P011219,14.584,-6,33,39
175,TEL,P007519,P012604,8.033,-7,14,21
175,TEL,P007519,P013250,3.417,-1,9,10
175,TEL,P007519,P013381,5.817,-2,15,17
175,TEL,P007519,P013382,20.25,-13,37,50
175,TEL,P007990,P011193,5.667,-8,10,18
175,TEL,P007990,P011202,9.667,-7,18,25
175,TEL,P007990,P011214,8.317,-6,10,16
175,TEL,P007990,P011219,13.884,-14,28,42
175,TEL,P007990,P012604,7.016,-12,14,26
175,TEL,P007990,P013250,2.5,-5,4,9
175,TEL,P007990,P013381,4.367,-1,12,13
175,TEL,P007990,P013382,10.15,-8,20,28
175,TEL,P011193,P011202,4.7,-1,14,15
175,TEL,P011193,P011214,6.933,-15,7,22
175,TEL,P011193,P011219,2.167,-2,2,4
175,TEL,P011193,P012604,11.367,-5,24,29
175,TEL,P011193,P013381,0.6,-2,0,2
175,TEL,P011193,P013382,17.117,-18,27,45
175,TEL,P011202,P011214,4.434,2,8,6
175,TEL,P011202,P011219,4.334,-7,6,13
175,TEL,P011202,P012604,7.383,-8,18,26
175,TEL,P011202,P013250,2.5,-5,4,9
175,TEL,P011202,P013382,2.15,1,8,7
175,TEL,P011214,P011219,7.101,-5,13,18
175,TEL,P011214,P013250,3.417,-1,9,10
175,TEL,P011214,P013381,1.45,-1,3,4
175,TEL,P011214,P013382,10.233,-17,13,30
175,TEL,P011219,P012604,3.4,-8,6,14
175,TEL,P011219,P013250,4.501,-4,11,15
175,TEL,P011219,P013381,5.284,0,15,15
175,TEL,P011219,P013382,10.534,-4,24,28
175,TEL,P012604,P013250,3.483,-7,4,11
175,TEL,P012604,P013381,1.583,-4,0,4
175,TEL,P012604,P013382,9.8,-5,18,23
175,TEL,P013250,P013381,2.433,-3,3,6
175,TEL,P013250,P013382,2.95,-2,6,8
175,TEL,P013381,P013382,5.95,-5,12,17
176,ASV,P000229,P002100,7.583,-1,15,16
176,ASV,P000229,P003526,5.75,2,11,9
176,ASV,P000229,P007027,2.817,0,5,5
176,ASV,P000229,P008991,5.383,5,11,6
176,ASV,P000229,P010545,4.967,-6,9,15
176,ASV,P000229,P011225,2.917,-3,6,9
176,ASV,P000229,P013371,7.383,2,14,12
176,ASV,P000229,P013405,4.6,-3,9,12
176,ASV,P002100,P003526,6.167,5,11,6
176,ASV,P002100,P007027,10.367,8,23,15
176,ASV,P002100,P008991,16.9,9,39,30
176,ASV,P002100,P010316,6.298,-4,13,17
176,ASV,P002100,P010545,6.649,-6,12,18
176,ASV,P002100,P011225,5.633,-10,10,20
176,ASV,P002100,P013371,17.433,13,41,28
176,ASV,P002100,P013405,17.166,-2,40,42
176,ASV,P003526,P007027,10.017,6,17,11
176,ASV,P003526,P008991,11.75,15,23,8
176,ASV,P003526,P010316,1.0,-4,0,4
176,ASV,P003526,P010545,1.367,-7,0,7
176,ASV,P003526,P011225,2.25,-4,3,7
176,ASV,P003526,P013371,10.817,12,20,8
176,ASV,P003526,P013405,3.35,7,7,0
176,ASV,P007027,P008991,15.517,18,35,17
176,ASV,P007027,P010316,11.316,-4,19,23
176,ASV,P007027,P010545,11.3,-7,19,26
176,ASV,P007027,P011225,13.65,-6,24,30
176,ASV,P007027,P013371,12.684,17,30,13
176,ASV,P007027,P013405,19.6,12,44,32
176,ASV,P008991,P010316,4.249,-1,10,11
176,ASV,P008991,P011225,3.766,-1,7,8
176,ASV,P008991,P013371,18.667,20,44,24
176,ASV,P008991,P013405,13.7,11,35,24
176,ASV,P010316,P010545,12.549,-7,22,29
176,ASV,P010316,P011225,12.949,-9,24,33
176,ASV,P010316,P013371,3.416,1,8,7
176,ASV,P010316,P013405,15.415,-4,32,36
176,ASV,P010545,P011225,13.617,-13,25,38
176,ASV,P010545,P013371,3.466,0,6,6
176,ASV,P010545,P013405,16.149,-6,31,37
176,ASV,P011225,P013405,14.75,-10,29,39
176,ASV,P013371,P013405,14.666,15,37,22
176,IST,P004887,P006590,5.117,0,5,5
176,IST,P004887,P007109,4.717,4,7,3
176,IST,P004887,P007200,23.166,4,49,45
176,IST,P004887,P009513,1.85,2,4,2
176,IST,P004887,P009846,12.817,1,19,18
176,IST,P004887,P011078,23.216,8,54,46
176,IST,P004887,P012710,21.516,2,47,45
176,IST,P004887,P013363,6.983,6,20,14
176,IST,P004887,P013364,5.55,-3,11,14
176,IST,P006590,P007109,9.384,0,13,13
176,IST,P006590,P007200,3.934,-2,4,6
176,IST,P006590,P009513,3.967,-4,4,8
176,IST,P006590,P009846,9.867,0,13,13
176,IST,P006590,P011078,2.1,2,5,3
176,IST,P006590,P012710,0.55,-2,0,2
176,IST,P006590,P012788,4.817,-2,8,10
176,IST,P007109,P007200,9.785,-4,15,19
176,IST,P007109,P009513,4.35,-4,4,8
176,IST,P007109,P009846,17.335,-6,29,35
176,IST,P007109,P011078,10.184,-3,21,24
176,IST,P007109,P012710,1.817,-2,2,4
176,IST,P007109,P012788,11.568,-10,20,30
176,IST,P007109,P013363,4.417,-7,5,12
176,IST,P007109,P013364,0.383,0,0,0
176,IST,P007200,P009513,0.95,0,4,4
176,IST,P007200,P009846,17.118,-5,27,32
176,IST,P007200,P011078,26.35,3,58,55
176,IST,P007200,P012710,23.333,0,49,49
176,IST,P007200,P012788,6.318,-4,11,15
176,IST,P007200,P013363,8.7,3,20,17
176,IST,P007200,P013364,5.55,-3,11,14
176,IST,P009513,P009846,3.9,-2,4,6
176,IST,P009513,P011078,1.266,2,4,2
176,IST,P009513,P012710,0.883,2,4,2
176,IST,P009513,P012788,3.0,-4,4,8
176,IST,P009513,P013363,0.383,0,0,0
176,IST,P009513,P013364,0.383,0,0,0
176,IST,P009846,P011078,16.651,-4,33,37
176,IST,P009846,P012710,9.217,-5,14,19
176,IST,P009846,P012788,11.501,-8,20,28
176,IST,P009846,P013363,3.334,-7,5,12
176,IST,P011078,P012710,22.783,2,49,47
176,IST,P011078,P012788,5.734,-5,12,17
176,IST,P011078,P013363,10.383,2,25,23
176,IST,P011078,P013364,5.933,-3,11,14
176,IST,P012710,P013363,7.683,6,20,14
176,IST,P012710,P013364,5.55,-3,11,14
176,IST,P012788,P013363,3.334,-7,5,12
176,IST,P013363,P013364,0.383,0,0,0
177,MAD,P003108,P003583,12.968,5,20,15
177,MAD,P003108,P003733,18.6,8,35,27
177,MAD,P003108,P005791,4.367,5,12,7
177,MAD,P003108,P005928,17.018,-5,32,37
177,MAD,P003108,P006540,9.918,3,20,17
177,MAD,P003108,P007630,9.183,0,22,22
177,MAD,P003108,P009213,0.483,1,4,3
177,MAD,P003108,P011247,14.017,13,33,20
177,MAD,P003108,P011649,5.733,-1,9,10
177,MAD,P003108,P013378,5.768,5,14,9
177,MAD,P003108,PTGB,8.417,6,15,9
177,MAD,P003583,P003733,18.217,21,38,17
177,MAD,P003583,P005928,6.134,-9,4,13
177,MAD,P003583,P006540,4.584,-1,5,6
177,MAD,P003583,P009213,6.183,14,18,4
177,MAD,P003583,P011247,13.017,28,34,6
177,MAD,P003583,P013378,0.934,-2,0,2
177,MAD,P003583,PTGB,14.567,20,33,13
177,MAD,P003733,P005928,9.117,-7,13,20
177,MAD,P003733,P006540,3.667,1,5,4
177,MAD,P003733,P007630,7.666,1,15,14
177,MAD,P003733,P009213,7.666,15,22,7
177,MAD,P003733,P011247,19.933,29,49,20
177,MAD,P003733,P011649,3.016,0,2,2
177,MAD,P003733,PTGB,15.65,20,33,13
177,MAD,P005791,P005928,10.467,0,23,23
177,MAD,P005791,P006540,10.467,0,23,23
177,MAD,P005791,P009213,6.1,-5,11,16
177,MAD,P005791,P013378,10.467,0,23,23
177,MAD,P005928,P006540,14.701,-5,28,33
177,MAD,P005928,P007630,6.517,-1,16,17
177,MAD,P005928,P009213,6.1,-5,11,16
177,MAD,P005928,P011247,4.417,-2,11,13
177,MAD,P005928,P011649,3.35,-1,7,8
177,MAD,P005928,P013378,11.751,0,25,25
177,MAD,P005928,PTGB,2.9,-5,2,7
177,MAD,P006540,P007630,1.0,-1,3,4
177,MAD,P006540,P009213,6.133,-5,11,16
177,MAD,P006540,P011247,1.35,3,3,0
177,MAD,P006540,P011649,1.0,-1,3,4
177,MAD,P006540,P013378,11.384,-2,23,25
177,MAD,P007630,P009213,1.483,1,4,3
177,MAD,P007630,P011247,8.183,-1,17,18
177,MAD,P007630,P011649,5.633,-1,9,10
177,MAD,P007630,P013378,0.367,2,2,0
177,MAD,P007630,PTGB,1.1,0,0,0
177,MAD,P009213,P011247,7.766,15,22,7
177,MAD,P009213,P011649,0.1,0,0,0
177,MAD,P009213,P013378,6.2,-5,11,16
177,MAD,P009213,PTGB,7.25,14,18,4
177,MAD,P011247,P011649,3.633,-2,4,6
177,MAD,P011247,P013378,0.117,0,0,0
177,MAD,P011247,PTGB,12.767,25,31,6
177,MAD,P011649,P013378,0.467,2,2,0
177,MAD,P013378,PTGB,0.017,0,0,0
177,ZAL,P002329,P002676,10.667,-6,19,25
177,ZAL,P002329,P003048,4.267,-4,3,7
177,ZAL,P002329,P003210,6.917,-1,8,9
177,ZAL,P002329,P005504,10.85,-6,19,25
177,ZAL,P002329,P007029,9.584,-1,10,11
177,ZAL,P002329,P007513,12.968,-23,14,37
177,ZAL,P002329,P007975,0.733,1,3,2
177,ZAL,P002329,P011051,4.501,-12,0,12
177,ZAL,P002329,P011983,5.75,-8,1,9
177,ZAL,P002329,P012715,2.284,-10,0,10
177,ZAL,P002329,P013403,9.951,-18,11,29
177,ZAL,P002676,P003048,3.083,-7,0,7
177,ZAL,P002676,P003210,6.0,5,15,10
177,ZAL,P002676,P005504,15.317,6,35,29
177,ZAL,P002676,P007029,7.634,6,17,11
177,ZAL,P002676,P007513,23.201,-7,44,51
177,ZAL,P002676,P007975,2.733,7,11,4
177,ZAL,P002676,P011051,10.534,1,24,23
177,ZAL,P002676,P011983,6.45,3,18,15
177,ZAL,P002676,P012715,11.817,3,22,19
177,ZAL,P002676,P013403,18.3,-11,31,42
177,ZAL,P003048,P003210,3.433,-4,1,5
177,ZAL,P003048,P007029,4.35,-2,3,5
177,ZAL,P003048,P007513,4.717,-9,2,11
177,ZAL,P003048,P011983,3.633,-4,1,5
177,ZAL,P003048,P012715,4.6,-13,0,13
177,ZAL,P003048,P013403,4.517,-9,2,11
177,ZAL,P003210,P005504,3.167,3,7,4
177,ZAL,P003210,P007029,9.917,0,14,14
177,ZAL,P003210,P007513,0.267,-2,0,2
177,ZAL,P003210,P011051,5.167,-1,10,11
177,ZAL,P003210,P011983,8.6,-5,11,16
177,ZAL,P003210,P012715,2.017,-3,2,5
177,ZAL,P003210,P013403,1.583,0,4,4
177,ZAL,P005504,P007029,3.1,5,7,2
177,ZAL,P005504,P007513,12.617,1,28,27
177,ZAL,P005504,P007975,2.733,7,11,4
177,ZAL,P005504,P012715,4.667,12,16,4
177,ZAL,P005504,P013403,9.617,-4,17,21
177,ZAL,P007029,P007513,6.501,-3,8,11
177,ZAL,P007029,P011051,8.968,-6,12,18
177,ZAL,P007029,P011983,9.084,-9,7,16
177,ZAL,P007029,P012715,5.517,-4,8,12
177,ZAL,P007029,P013403,1.017,2,2,0
177,ZAL,P007513,P007975,2.733,7,11,4
177,ZAL,P007513,P011051,11.168,-11,16,27
177,ZAL,P007513,P011983,5.617,-3,10,13
177,ZAL,P007513,P012715,14.201,-7,22,29
177,ZAL,P007513,P013403,20.018,-19,29,48
177,ZAL,P007975,P012715,2.0,6,8,2
177,ZAL,P011051,P011983,10.584,-4,20,24
177,ZAL,P011051,P012715,6.951,-9,8,17
177,ZAL,P011051,P013403,7.467,-6,14,20
177,ZAL,P011983,P012715,2.017,-3,2,5
177,ZAL,P011983,P013403,5.133,1,14,13
177,ZAL,P012715,P013403,8.801,-12,8,20
178,PRS,P004197,P010390,13.767,-1,21,22
178,PRS,P004197,P012608,13.767,-1,21,22
178,PRS,P004197,P012610,13.767,-1,21,22
178,PRS,P004197,P012613,13.767,-1,21,22
178,PRS,P004512,P007032,4.25,-7,5,12
178,PRS,P004512,P012608,2.584,-2,4,6
178,PRS,P004512,P012609,6.834,-9,9,18
178,PRS,P004512,P012610,1.817,2,4,2
178,PRS,P004512,P012613,2.584,-2,4,6
178,PRS,P004512,P012640,5.017,-11,5,16
178,PRS,P004512,P013373,4.25,-7,5,12
178,PRS,P005793,P007032,3.4,-5,4,9
178,PRS,P005793,P010390,1.583,-3,2,5
178,PRS,P005793,P012608,2.716,-2,3,5
178,PRS,P005793,P012609,4.533,-4,5,9
178,PRS,P005793,P012610,2.716,-2,3,5
178,PRS,P005793,P012613,1.133,1,1,0
178,PRS,P005793,P012640,4.983,-8,6,14
178,PRS,P005793,P013373,3.4,-5,4,9
178,PRS,P007032,P010390,2.533,2,6,4
178,PRS,P007032,P012608,5.85,1,13,12
178,PRS,P007032,P012609,13.233,-10,26,36
178,PRS,P007032,P012610,5.85,1,13,12
178,PRS,P007032,P012612,5.583,2,17,15
178,PRS,P007032,P012613,5.85,1,13,12
178,PRS,P007032,P012640,16.55,-11,33,44
178,PRS,P007032,P013373,13.233,-10,26,36
178,PRS,P010390,P012608,19.733,-4,31,35
178,PRS,P010390,P012610,19.733,-4,31,35
178,PRS,P010390,P012613,18.15,-1,29,30
178,PRS,P010390,P012640,3.433,-5,4,9
178,PRS,P012608,P012609,3.717,-1,5,6
178,PRS,P012608,P012610,26.0,-2,43,45
178,PRS,P012608,P012613,25.184,-3,41,44
178,PRS,P012608,P012640,7.517,-10,11,21
178,PRS,P012609,P012610,2.95,3,5,2
178,PRS,P012609,P012612,5.583,2,17,15
178,PRS,P012609,P012613,3.717,-1,5,6
178,PRS,P012609,P012640,14.0,-14,26,40
178,PRS,P012609,P013373,13.233,-10,26,36
178,PRS,P012610,P012613,24.417,1,41,40
178,PRS,P012610,P012640,6.75,-6,11,17
178,PRS,P012612,P012640,5.583,2,17,15
178,PRS,P012612,P013373,5.583,2,17,15
178,PRS,P012613,P012640,5.934,-7,9,16
178,PRS,P012640,P013373,13.233,-10,26,36
178,RED,P000848,P004866,13.834,-3,24,27
178,RED,P000848,P006436,2.067,5,8,3
178,RED,P000848,P007960,15.084,2,33,31
178,RED,P000848,P009035,20.252,3,39,36
178,RED,P000848,P009048,21.118,6,46,40
178,RED,P000848,P010588,4.117,-3,6,9
178,RED,P000848,P010612,5.984,3,14,11
178,RED,P000848,P011194,4.317,8,14,6
178,RED,P000848,P012044,0.767,-1,0,1
178,RED,P004866,P006436,0.383,2,2,0
178,RED,P004866,P007960,12.25,-1,21,22
178,RED,P004866,P009035,15.884,2,29,27
178,RED,P004866,P009048,17.084,-1,31,32
178,RED,P004866,P010588,1.2,-3,2,5
178,RED,P004866,P010612,2.867,0,5,5
178,RED,P004866,P011194,4.834,0,10,10
178,RED,P006436,P007960,8.417,8,23,15
178,RED,P006436,P009035,5.433,13,18,5
178,RED,P006436,P009048,5.55,6,17,11
178,RED,P006436,P010588,7.317,5,14,9
178,RED,P006436,P010612,14.867,9,32,23
178,RED,P006436,P011194,13.467,6,29,23
178,RED,P006436,P012044,11.767,10,25,15
178,RED,P007960,P009035,16.434,2,33,31
178,RED,P007960,P009048,18.567,3,42,39
178,RED,P007960,P010612,9.117,7,25,18
178,RED,P007960,P011194,6.0,6,18,12
178,RED,P007960,P012044,3.867,5,9,4
178,RED,P009035,P009048,23.518,6,46,40
178,RED,P009035,P010588,2.917,0,4,4
178,RED,P009035,P010612,11.401,4,22,18
178,RED,P009035,P011194,7.134,9,17,8
178,RED,P009035,P012044,2.967,5,8,3
178,RED,P009048,P010588,4.117,-3,6,9
178,RED,P009048,P010612,11.184,3,26,23
178,RED,P009048,P011194,8.734,8,26,18
178,RED,P010588,P010612,8.234,-1,12,13
178,RED,P010588,P011194,7.517,-1,13,14
178,RED,P010588,P012044,6.317,2,11,9
178,RED,P010612,P011194,18.684,14,43,29
178,RED,P010612,P012044,12.534,9,25,16
178,RED,P011194,P012044,11.917,6,22,16
179,MUN,P001557,P004508,10.0,-7,18,25
179,MUN,P001557,P005460,1.767,-9,0,9
179,MUN,P001557,P007056,3.2,1,8,7
179,MUN,P001557,P007201,3.2,1,8,7
179,MUN,P001557,P007639,14.533,-19,21,40
179,MUN,P001557,P007929,5.6,-15,4,19
179,MUN,P001557,P011224,2.566,3,5,2
179,MUN,P001557,P011987,1.667,0,5,5
179,MUN,P001557,P012123,16.3,-28,21,49
179,MUN,P001557,P012126,2.867,-7,5,12
179,MUN,P001557,P013368,16.3,-28,21,49
179,MUN,P004508,P005460,1.851,-11,0,11
179,MUN,P004508,P007056,14.333,-3,33,36
179,MUN,P004508,P007201,14.333,-3,33,36
179,MUN,P004508,P007639,5.567,0,13,13
179,MUN,P004508,P007929,0.084,-2,0,2
179,MUN,P004508,P011224,12.666,-3,28,31
179,MUN,P004508,P011987,12.8,-4,30,34
179,MUN,P004508,P012123,7.317,-7,13,20
179,MUN,P004508,P012126,0.584,1,3,2
179,MUN,P004508,P013368,7.401,-9,13,22
179,MUN,P005460,P007639,0.017,-2,0,2
179,MUN,P005460,P007929,0.084,-2,0,2
179,MUN,P005460,P012123,1.767,-9,0,9
179,MUN,P005460,P012126,0.067,0,0,0
179,MUN,P005460,P013368,1.851,-11,0,11
179,MUN,P007056,P007201,19.383,-12,38,50
179,MUN,P007056,P007929,5.05,-9,5,14
179,MUN,P007056,P011224,17.716,-12,33,45
179,MUN,P007056,P011987,17.85,-13,35,48
179,MUN,P007201,P007929,5.05,-9,5,14
179,MUN,P007201,P011224,17.716,-12,33,45
179,MUN,P007201,P011987,17.85,-13,35,48
179,MUN,P007639,P007929,9.334,-19,11,30
179,MUN,P007639,P011224,1.033,2,2,0
179,MUN,P007639,P012123,18.767,-20,31,51
179,MUN,P007639,P012126,7.101,-8,15,23
179,MUN,P007639,P013368,18.784,-22,31,53
179,MUN,P007929,P011224,5.05,-9,5,14
179,MUN,P007929,P011987,5.05,-9,5,14
179,MUN,P007929,P012123,9.317,-17,11,28
179,MUN,P007929,P012126,3.784,-2,7,9
179,MUN,P007929,P013368,9.401,-19,11,30
179,MUN,P011224,P011987,16.183,-13,30,43
179,MUN,P011224,P012123,1.033,2,2,0
179,MUN,P011224,P013368,1.033,2,2,0
179,MUN,P012123,P012126,7.101,-8,15,23
179,MUN,P012123,P013368,20.534,-29,31,60
179,MUN,P012126,P013368,7.168,-8,15,23
179,OLY,P003469,P003941,17.966,36,60,24
179,OLY,P003469,P007853,23.033,36,71,35
179,OLY,P003469,P007947,22.367,17,62,45
179,OLY,P003469,P007982,20.783,30,59,29
179,OLY,P003469,P008811,17.267,12,43,31
179,OLY,P003469,P008829,18.816,32,56,24
179,OLY,P003469,P008855,5.4,12,16,4
179,OLY,P003469,P009849,3.95,-4,6,10
179,OLY,P003469,P010392,10.05,17,33,16
179,OLY,P003469,P011965,1.3,4,6,2
179,OLY,P003941,P007853,18.533,32,62,30
179,OLY,P003941,P007947,11.233,13,33,20
179,OLY,P003941,P007982,11.783,18,37,19
179,OLY,P003941,P008829,10.849,18,34,16
179,OLY,P003941,P008855,0.3,2,2,0
179,OLY,P003941,P009849,2.183,-1,4,5
179,OLY,P003941,P010392,7.317,10,26,16
179,OLY,P003941,P011965,1.3,4,6,2
179,OLY,P007853,P007947,15.567,17,46,29
179,OLY,P007853,P007982,10.983,15,33,18
179,OLY,P007853,P008811,6.9,1,15,14
179,OLY,P007853,P008829,11.383,15,33,18
179,OLY,P007853,P009849,3.95,-4,6,10
179,OLY,P007853,P010392,14.817,12,42,30
179,OLY,P007853,P011965,3.667,2,9,7
179,OLY,P007853,P013514,2.367,-2,3,5
179,OLY,P007947,P007982,9.217,3,24,21
179,OLY,P007947,P008811,11.134,4,29,25
179,OLY,P007947,P008829,8.983,5,23,18
179,OLY,P007947,P009849,3.95,-4,6,10
179,OLY,P007947,P010392,7.017,13,25,12
179,OLY,P007982,P008811,11.4,9,28,19
179,OLY,P007982,P008829,19.033,24,55,31
179,OLY,P007982,P008855,5.4,12,16,4
179,OLY,P007982,P010392,4.133,-3,8,11
179,OLY,P008811,P008829,10.367,11,28,17
179,OLY,P008811,P008855,5.1,10,14,4
179,OLY,P008811,P009849,1.767,-3,2,5
179,OLY,P008811,P010392,5.133,4,13,9
179,OLY,P008829,P008855,5.4,12,16,4
179,OLY,P008829,P010392,4.767,-5,9,14
179,OLY,P008829,P011965,2.367,-2,3,5
179,OLY,P008829,P013514,2.367,-2,3,5
179,OLY,P010392,P011965,3.667,2,9,7
179,OLY,P010392,P013514,2.367,-2,3,5
179,OLY,P011965,P013514,2.367,-2,3,5
180,BAS,P004058,P007579,16.934,23,44,21
180,BAS,P004058,P008072,2.817,7,9,2
180,BAS,P004058,P011085,18.651,16,42,26
180,BAS,P004058,P011196,8.717,-2,14,16
180,BAS,P004058,P012058,7.483,9,19,10
180,BAS,P004058,P012080,12.117,7,26,19
180,BAS,P004058,P012201,5.084,-7,4,11
180,BAS,P004058,P013367,11.201,11,26,15
180,BAS,P007579,P008072,2.817,7,9,2
180,BAS,P007579,P008850,1.867,-1,2,3
180,BAS,P007579,P011085,16.867,19,43,24
180,BAS,P007579,P011196,8.3,2,17,15
180,BAS,P007579,P012058,7.483,9,19,10
180,BAS,P007579,P012080,12.767,9,29,20
180,BAS,P007579,P012201,1.267,0,2,2
180,BAS,P007579,P013367,13.034,12,31,19
180,BAS,P008072,P008850,1.633,-1,2,3
180,BAS,P008072,P011085,3.1,9,11,2
180,BAS,P008072,P012080,1.916,1,4,3
180,BAS,P008072,P012201,1.916,1,4,3
180,BAS,P008072,P013367,4.733,8,13,5
180,BAS,P008850,P011196,12.734,-19,13,32
180,BAS,P008850,P012080,14.367,-20,15,35
180,BAS,P008850,P012201,12.5,-19,13,32
180,BAS,P008850,P013367,14.367,-20,15,35
180,BAS,P011085,P011196,12.584,-2,23,25
180,BAS,P011085,P012058,6.116,9,17,8
180,BAS,P011085,P012080,14.9,9,35,26
180,BAS,P011085,P012201,7.934,-1,14,15
180,BAS,P011085,P013367,13.984,13,35,22
180,BAS,P011196,P012080,22.417,-20,32,52
180,BAS,P011196,P012201,17.751,-23,21,44
180,BAS,P011196,P013367,21.701,-20,32,52
180,BAS,P012058,P012080,5.3,6,14,8
180,BAS,P012058,P013367,3.55,3,7,4
180,BAS,P012080,P012201,19.867,-20,27,47
180,BAS,P012080,P013367,21.817,-16,34,50
180,BAS,P012201,P013367,17.417,-19,23,42
180,VIR,P001844,P002084,7.583,-7,6,13
180,VIR,P001844,P005738,5.716,-3,6,9
180,VIR,P001844,P006739,5.567,-7,6,13
180,VIR,P001844,P009549,6.682,-2,9,11
180,VIR,P001844,P011816,3.933,-2,8,10
180,VIR,P001844,P012585,6.583,-4,8,12
180,VIR,P001844,P013374,5.8,-6,8,14
180,VIR,P001844,PBCN,4.2,-5,5,10
180,VIR,P002084,P005738,21.816,9,45,36
180,VIR,P002084,P006273,0.117,-1,2,3
180,VIR,P002084,P006739,25.783,14,58,44
180,VIR,P002084,P009549,27.948,16,59,43
180,VIR,P002084,P012585,24.5,19,56,37
180,VIR,P002084,P013374,7.566,4,16,12
180,VIR,P002084,PBCN,2.083,-2,2,4
180,VIR,P005738,P006273,0.117,-1,2,3
180,VIR,P005738,P006739,22.666,12,50,38
180,VIR,P005738,P009549,24.098,14,51,37
180,VIR,P005738,P011816,2.916,4,8,4
180,VIR,P005738,P012585,21.316,17,50,33
180,VIR,P005738,P013374,0.033,0,0,0
180,VIR,P005738,PBCN,0.25,0,0,0
180,VIR,P006273,P006739,0.117,-1,2,3
180,VIR,P006273,P012585,0.117,-1,2,3
180,VIR,P006739,P009549,29.932,13,63,50
180,VIR,P006739,P011816,8.267,-10,10,20
180,VIR,P006739,P012585,25.284,16,58,42
180,VIR,P006739,P013374,11.417,-8,18,26
180,VIR,P006739,PBCN,7.167,-13,7,20
180,VIR,P009549,P011816,5.283,-1,10,11
180,VIR,P009549,P012585,26.015,26,62,36
180,VIR,P009549,P013374,9.166,1,18,17
180,VIR,P009549,PBCN,3.8,-7,4,11
180,VIR,P011816,P012585,6.733,-5,10,15
180,VIR,P011816,P013374,7.734,-15,7,22
180,VIR,P011816,PBCN,7.734,-15,7,22
180,VIR,P012585,P013374,9.917,-3,16,19
180,VIR,P012585,PBCN,4.467,-9,2,11
180,VIR,P013374,PBCN,9.567,-17,9,26
181,ASV,P000229,P002100,10.566,-14,18,32
181,ASV,P000229,P003526,10.566,-14,18,32
181,ASV,P000229,P007027,2.883,-9,2,11
181,ASV,P000229,P008991,10.566,-14,18,32
181,ASV,P000229,P010316,4.267,-1,7,8
181,ASV,P000229,P010545,0.917,1,3,2
181,ASV,P000229,P011225,0.167,-2,0,2
181,ASV,P000229,P012263,4.1,1,7,6
181,ASV,P000229,P013371,11.95,-6,23,29
181,ASV,P000229,P013377,3.35,-2,4,6
181,ASV,P002100,P003526,12.632,-16,18,34
181,ASV,P002100,P007027,5.682,-9,2,11
181,ASV,P002100,P008991,13.916,-16,20,36
181,ASV,P002100,P010316,2.133,0,2,2
181,ASV,P002100,P010545,1.833,0,0,0
181,ASV,P002100,P011225,1.866,0,0,0
181,ASV,P002100,P013371,10.1,-7,18,25
181,ASV,P002100,P013405,4.4,-2,2,4
181,ASV,P003526,P007027,5.266,-13,3,16
181,ASV,P003526,P008991,13.383,-20,19,39
181,ASV,P003526,P010316,0.033,0,0,0
181,ASV,P003526,P010545,0.783,0,0,0
181,ASV,P003526,P011225,0.816,0,0,0
181,ASV,P003526,P013371,10.5,-11,17,28
181,ASV,P003526,P013405,2.817,-6,1,7
181,ASV,P007027,P008991,6.766,-16,4,20
181,ASV,P007027,P010316,15.866,-9,30,39
181,ASV,P007027,P010545,15.35,-6,29,35
181,ASV,P007027,P011225,16.149,-3,30,33
181,ASV,P007027,P013371,2.184,-10,1,11
181,ASV,P007027,P013405,18.45,-13,31,44
181,ASV,P008991,P010316,3.483,-3,3,6
181,ASV,P008991,P011225,1.233,0,1,1
181,ASV,P008991,P013371,11.817,-14,19,33
181,ASV,P008991,P013405,6.3,-9,4,13
181,ASV,P010316,P010545,17.917,-6,36,42
181,ASV,P010316,P011225,17.966,-6,34,40
181,ASV,P010316,P012263,4.1,1,7,6
181,ASV,P010316,P013371,9.534,-8,13,21
181,ASV,P010316,P013377,3.35,-2,4,6
181,ASV,P010316,P013405,20.483,-10,36,46
181,ASV,P010545,P011225,18.533,-6,33,39
181,ASV,P010545,P012263,0.75,3,3,0
181,ASV,P010545,P013371,4.867,-3,7,10
181,ASV,P010545,P013405,18.05,-7,33,40
181,ASV,P011225,P013371,3.65,-3,4,7
181,ASV,P011225,P013405,18.816,-4,34,38
181,ASV,P012263,P013371,4.1,1,7,6
181,ASV,P012263,P013377,3.35,-2,4,6
181,ASV,P013371,P013377,3.35,-2,4,6
181,ASV,P013371,P013405,8.084,-13,7,20
181,PAR,P006760,P007736,15.133,12,29,17
181,PAR,P006760,P007870,18.75,17,39,22
181,PAR,P006760,P010781,16.15,18,35,17
181,PAR,P006760,P011836,1.866,0,0,0
181,PAR,P006760,P011981,15.216,23,43,20
181,PAR,P006760,P012720,9.716,9,20,11
181,PAR,P006760,P013369,10.033,9,22,13
181,PAR,P007632,P007736,2.55,2,6,4
181,PAR,P007632,P008232,4.1,-1,6,7
181,PAR,P007632,P011050,4.1,-1,6,7
181,PAR,P007632,P011836,4.1,-1,6,7
181,PAR,P007632,P013369,1.55,-3,0,3
181,PAR,P007736,P007870,13.184,13,27,14
181,PAR,P007736,P008232,2.55,2,6,4
181,PAR,P007736,P010781,15.916,12,29,17
181,PAR,P007736,P011050,2.55,2,6,4
181,PAR,P007736,P011836,3.366,2,6,4
181,PAR,P007736,P011981,11.249,13,25,12
181,PAR,P007736,P012720,3.133,-1,2,3
181,PAR,P007736,P013369,4.233,-1,4,5
181,PAR,P007870,P010781,13.184,13,27,14
181,PAR,P007870,P011836,1.833,0,0,0
181,PAR,P007870,P011981,12.25,18,35,17
181,PAR,P007870,P012720,8.416,4,14,10
181,PAR,P007870,P013369,7.383,3,14,11
181,PAR,P008232,P011050,5.917,2,13,11
181,PAR,P008232,P011836,5.917,2,13,11
181,PAR,P008232,P012720,1.817,3,7,4
181,PAR,P008232,P013369,3.367,0,7,7
181,PAR,P010781,P011050,5.05,6,16,10
181,PAR,P010781,P011836,12.399,7,33,26
181,PAR,P010781,P011981,18.799,20,48,28
181,PAR,P010781,P012720,15.733,12,41,29
181,PAR,P010781,P013369,16.833,12,43,31
181,PAR,P011050,P011836,10.967,8,29,21
181,PAR,P011050,P012720,6.867,9,23,14
181,PAR,P011050,P013369,8.417,6,23,17
181,PAR,P011836,P011981,7.349,1,17,16
181,PAR,P011836,P012720,15.233,10,40,30
181,PAR,P011836,P013369,17.566,7,40,33
181,PAR,P011981,P012720,11.566,10,35,25
181,PAR,P011981,P013369,13.699,11,37,26
181,PAR,P012720,P013369,19.983,20,58,38
182,BAS,P004058,P007579,13.6,-6,33,39
182,BAS,P004058,P008072,0.733,2,2,0
182,BAS,P004058,P011085,13.8,0,38,38
182,BAS,P004058,P011196,12.416,-2,33,35
182,BAS,P004058,P012080,11.0,4,32,28
182,BAS,P004058,P012201,11.117,8,34,26
182,BAS,P004058,P012597,11.25,-6,22,28
182,BAS,P004058,P013367,1.816,4,10,6
182,BAS,P007579,P011085,11.783,-2,29,31
182,BAS,P007579,P011196,7.816,-7,17,24
182,BAS,P007579,P012080,6.084,-4,24,28
182,BAS,P007579,P012201,4.001,-1,19,20
182,BAS,P007579,P012597,5.917,-10,19,29
182,BAS,P007579,P013367,-1.933,-2,3,5
182,BAS,P008072,P012080,12.616,2,24,22
182,BAS,P008072,P012201,12.616,2,24,22
182,BAS,P008072,P012597,12.616,2,24,22
182,BAS,P008072,P013367,11.883,0,22,22
182,BAS,P011085,P011196,11.366,-7,28,35
182,BAS,P011085,P012080,7.4,1,21,20
182,BAS,P011085,P012201,7.517,5,23,18
182,BAS,P011085,P012597,7.05,-4,14,18
182,BAS,P011085,P013367,2.416,-1,7,8
182,BAS,P011196,P012080,21.649,5,46,41
182,BAS,P011196,P012201,20.566,5,41,36
182,BAS,P011196,P012597,21.933,-6,32,38
182,BAS,P011196,P013367,17.782,4,35,31
182,BAS,P012080,P012201,33.783,1,70,69
182,BAS,P012080,P012597,29.033,-2,56,58
182,BAS,P012080,P013367,26.699,1,55,54
182,BAS,P012201,P012597,31.4,2,65,63
182,BAS,P012201,P013367,27.732,2,60,58
182,BAS,P012597,P013367,24.533,0,48,48
182,OLY,P001255,P003469,10.833,-5,15,20
182,OLY,P001255,P007853,0.15,0,0,0
182,OLY,P001255,P007982,10.833,-5,15,20
182,OLY,P001255,P008811,10.683,-5,15,20
182,OLY,P001255,P010392,0.15,0,0,0
182,OLY,P001255,P013380,10.683,-5,15,20
182,OLY,P003469,P003941,9.333,5,28,23
182,OLY,P003469,P007853,28.516,7,72,65
182,OLY,P003469,P007947,12.899,2,34,32
182,OLY,P003469,P007982,29.416,0,61,61
182,OLY,P003469,P008811,29.666,-3,59,62
182,OLY,P003469,P008829,0.05,0,0,0
182,OLY,P003469,P010392,2.867,-3,4,7
182,OLY,P003469,P013380,33.216,5,75,70
182,OLY,P003941,P007853,13.883,4,40,36
182,OLY,P003941,P007947,12.15,2,36,34
182,OLY,P003941,P007982,1.916,3,6,3
182,OLY,P003941,P008829,4.55,-1,12,13
182,OLY,P003941,P013380,13.7,3,38,35
182,OLY,P007853,P007947,15.716,-1,42,43
182,OLY,P007853,P007982,21.716,7,53,46
182,OLY,P007853,P008811,20.233,2,47,45
182,OLY,P007853,P008829,5.85,-1,15,16
182,OLY,P007853,P010392,2.867,-3,4,7
182,OLY,P007853,P013380,28.333,9,75,66
182,OLY,P007947,P007982,3.116,0,8,8
182,OLY,P007947,P008811,3.566,-3,6,9
182,OLY,P007947,P008829,2.817,-3,8,11
182,OLY,P007947,P013380,12.6,-1,34,35
182,OLY,P007982,P008811,30.283,-1,62,63
182,OLY,P007982,P008829,3.033,2,7,5
182,OLY,P007982,P010392,2.867,-3,4,7
182,OLY,P007982,P013380,26.416,5,56,51
182,OLY,P008811,P008829,1.25,0,3,3
182,OLY,P008811,P010392,2.717,-3,4,7
182,OLY,P008811,P013380,25.266,1,52,51
182,OLY,P008829,P013380,5.85,-1,15,16
183,BER,P006251,P007025,4.6,-8,7,15
183,BER,P006251,P007550,6.234,-10,9,19
183,BER,P006251,P008062,7.384,-9,12,21
183,BER,P006251,P008384,15.6,-7,32,39
183,BER,P006251,P008780,16.433,-11,34,45
183,BER,P006251,P008967,17.583,-10,37,47
183,BER,P006251,P011631,3.617,-5,7,12
183,BER,P006251,P011934,6.967,-7,14,21
183,BER,P006251,P013386,16.85,-13,32,45
183,BER,P007025,P007550,13.317,-2,20,22
183,BER,P007025,P008062,15.633,-19,18,37
183,BER,P007025,P008384,5.217,-1,6,7
183,BER,P007025,P008780,1.283,-1,5,6
183,BER,P007025,P008967,3.716,-7,7,14
183,BER,P007025,P011631,12.75,-9,16,25
183,BER,P007025,P011934,18.433,-18,25,43
183,BER,P007025,P013386,3.383,5,8,3
183,BER,P007550,P008062,14.484,-11,23,34
183,BER,P007550,P008384,2.884,6,6,0
183,BER,P007550,P011631,12.301,-3,21,24
183,BER,P007550,P011934,12.517,-2,20,22
183,BER,P007550,P013386,6.867,-2,13,15
183,BER,P008062,P008384,4.2,-8,5,13
183,BER,P008062,P008967,3.866,-9,5,14
183,BER,P008062,P011631,14.55,-22,19,41
183,BER,P008062,P011934,15.983,-21,18,39
183,BER,P008062,P013386,7.5,-5,16,21
183,BER,P008384,P008780,15.15,-10,29,39
183,BER,P008384,P008967,16.583,-13,32,45
183,BER,P008384,P011631,6.067,-4,7,11
183,BER,P008384,P011934,7.484,1,16,15
183,BER,P008384,P013386,14.883,-16,23,39
183,BER,P008780,P008967,16.433,-11,34,45
183,BER,P008780,P011934,3.65,0,12,12
183,BER,P008780,P013386,12.783,-11,22,33
183,BER,P008967,P011631,2.366,-8,2,10
183,BER,P008967,P011934,6.433,-8,14,22
183,BER,P008967,P013386,14.216,-14,25,39
183,BER,P011631,P011934,11.95,-9,16,25
183,BER,P011631,P013386,5.267,-8,8,16
183,BER,P011934,P013386,2.583,0,5,5
183,MIL,P000796,P001518,2.767,3,9,6
183,MIL,P000796,P005670,4.184,0,12,12
183,MIL,P000796,P006509,6.166,10,20,10
183,MIL,P000796,P007831,19.534,17,55,38
183,MIL,P000796,P008985,21.551,19,61,42
183,MIL,P000796,P008987,5.267,4,17,13
183,MIL,P000796,P011064,12.101,7,33,26
183,MIL,P000796,P011941,13.967,11,37,26
183,MIL,P000796,P013384,2.467,1,8,7
183,MIL,P001518,P005670,4.916,-1,8,9
183,MIL,P001518,P006509,7.349,8,16,8
183,MIL,P001518,P006701,4.067,8,10,2
183,MIL,P001518,P006721,3.5,6,8,2
183,MIL,P001518,P007831,4.15,5,13,8
183,MIL,P001518,P008985,6.733,5,18,13
183,MIL,P001518,P008987,10.149,8,21,13
183,MIL,P001518,P011064,5.7,6,14,8
183,MIL,P001518,P011941,4.067,8,10,2
183,MIL,P001518,P013384,12.266,12,25,13
183,MIL,P005670,P006509,6.0,2,13,11
183,MIL,P005670,P007831,5.101,-1,13,14
183,MIL,P005670,P008985,5.967,-1,13,14
183,MIL,P005670,P008987,9.85,-1,20,21
183,MIL,P005670,P011941,4.984,4,12,8
183,MIL,P005670,P013384,6.866,2,13,11
183,MIL,P006509,P007831,10.299,11,29,18
183,MIL,P006509,P008985,7.449,15,24,9
183,MIL,P006509,P008987,13.332,14,32,18
183,MIL,P006509,P011064,4.416,1,7,6
183,MIL,P006509,P011941,8.883,4,20,16
183,MIL,P006509,P013384,7.566,7,15,8
183,MIL,P006701,P006721,3.5,6,8,2
183,MIL,P006701,P008987,0.567,2,2,0
183,MIL,P006701,P011941,4.067,8,10,2
183,MIL,P006701,P013384,4.067,8,10,2
183,MIL,P006721,P011941,3.5,6,8,2
183,MIL,P006721,P013384,3.5,6,8,2
183,MIL,P007831,P008985,20.817,22,59,37
183,MIL,P007831,P008987,9.4,5,26,21
183,MIL,P007831,P011064,11.117,4,27,23
183,MIL,P007831,P011941,14.25,9,34,25
183,MIL,P008985,P008987,9.233,6,26,20
183,MIL,P008985,P011064,12.101,7,33,26
183,MIL,P008985,P011941,13.517,12,35,23
183,MIL,P008985,P013384,4.7,-1,11,12
183,MIL,P008987,P011064,5.983,1,10,9
183,MIL,P008987,P011941,4.917,2,10,8
183,MIL,P008987,P013384,10.366,7,20,13
183,MIL,P011064,P011941,9.25,2,23,21
183,MIL,P011064,P013384,5.4,4,13,9
183,MIL,P011941,P013384,8.134,10,21,11
184,IST,P004887,P006590,5.433,2,12,10
184,IST,P004887,P007109,16.966,-9,26,35
184,IST,P004887,P007200,21.149,1,45,44
184,IST,P004887,P009664,5.533,0,14,14
184,IST,P004887,P009846,23.632,-6,46,52
184,IST,P004887,P011078,20.449,-4,38,42
184,IST,P004887,P012710,4.617,4,12,8
184,IST,P004887,P013363,11.217,-4,19,23
184,IST,P006590,P007109,0.1,2,3,1
184,IST,P006590,P007200,13.833,0,32,32
184,IST,P006590,P009664,13.317,0,31,31
184,IST,P006590,P009846,5.049,2,14,12
184,IST,P006590,P011078,3.0,4,8,4
184,IST,P006590,P012710,3.25,2,7,5
184,IST,P006590,P012788,11.167,-1,24,25
184,IST,P006590,P013363,7.601,2,17,15
184,IST,P006590,P013364,4.05,-1,8,9
184,IST,P007109,P007200,12.35,-2,26,28
184,IST,P007109,P009664,0.117,0,3,3
184,IST,P007109,P009846,17.083,-9,29,38
184,IST,P007109,P011078,16.983,-11,26,37
184,IST,P007109,P013363,4.733,-7,3,10
184,IST,P007200,P009664,15.417,-3,38,41
184,IST,P007200,P009846,22.249,0,51,51
184,IST,P007200,P011078,15.833,0,34,34
184,IST,P007200,P012710,3.25,2,7,5
184,IST,P007200,P012788,9.767,-3,21,24
184,IST,P007200,P013363,6.234,-2,14,16
184,IST,P007200,P013364,4.05,-1,8,9
184,IST,P009664,P009846,9.883,1,27,26
184,IST,P009664,P011078,6.334,4,17,13
184,IST,P009664,P012788,12.634,0,28,28
184,IST,P009664,P013363,5.851,-1,14,15
184,IST,P009664,P013364,4.05,-1,8,9
184,IST,P009846,P011078,21.933,-5,42,47
184,IST,P009846,P012710,1.367,2,5,3
184,IST,P009846,P012788,4.6,1,10,9
184,IST,P009846,P013363,7.6,-6,12,18
184,IST,P011078,P012710,1.367,2,5,3
184,IST,P011078,P012788,4.334,4,11,7
184,IST,P011078,P013363,8.967,-2,15,17
184,IST,P012710,P013363,4.617,4,12,8
184,IST,P012788,P013363,3.984,0,10,10
184,IST,P012788,P013364,4.05,-1,8,9
184,PRS,P004197,P004512,5.85,4,14,10
184,PRS,P004197,P005793,7.183,3,20,17
184,PRS,P004197,P007032,13.266,4,35,31
184,PRS,P004197,P010390,0.233,-3,1,4
184,PRS,P004197,P012608,0.233,-3,1,4
184,PRS,P004197,P012610,0.233,-3,1,4
184,PRS,P004197,P012640,13.033,7,34,27
184,PRS,P004197,P013373,13.033,7,34,27
184,PRS,P004512,P007032,8.3,-1,19,20
184,PRS,P004512,P012608,3.8,-6,6,12
184,PRS,P004512,P012610,3.8,-6,6,12
184,PRS,P004512,P012613,3.8,-6,6,12
184,PRS,P004512,P012640,7.2,3,15,12
184,PRS,P004512,P013373,5.85,4,14,10
184,PRS,P005793,P007032,7.183,3,20,17
184,PRS,P005793,P012640,7.183,3,20,17
184,PRS,P005793,P013373,7.183,3,20,17
184,PRS,P007032,P010390,3.567,1,10,9
184,PRS,P007032,P012608,6.034,-2,17,19
184,PRS,P007032,P012609,0.467,-1,0,1
184,PRS,P007032,P012610,5.567,-1,17,18
184,PRS,P007032,P012613,5.801,1,16,15
184,PRS,P007032,P012640,13.05,9,36,27
184,PRS,P007032,P013373,13.033,7,34,27
184,PRS,P010390,P012608,20.617,1,41,40
184,PRS,P010390,P012609,17.517,-1,31,32
184,PRS,P010390,P012610,20.15,2,41,39
184,PRS,P010390,P012613,19.634,6,40,34
184,PRS,P010390,P013373,0.75,-2,0,2
184,PRS,P012608,P012609,17.517,-1,31,32
184,PRS,P012608,P012610,26.5,-2,54,56
184,PRS,P012608,P012613,25.984,2,53,51
184,PRS,P012608,P012640,3.9,1,8,7
184,PRS,P012608,P013373,3.283,-2,5,7
184,PRS,P012609,P012610,17.05,0,31,31
184,PRS,P012609,P012613,16.767,1,31,30
184,PRS,P012609,P013373,0.75,-2,0,2
184,PRS,P012610,P012613,25.517,3,53,50
184,PRS,P012610,P012640,3.9,1,8,7
184,PRS,P012610,P013373,3.283,-2,5,7
184,PRS,P012613,P012640,3.9,1,8,7
184,PRS,P012613,P013373,2.533,0,5,5
184,PRS,P012640,P013373,15.566,7,39,32
185,MAD,P003108,P003733,13.467,0,36,36
185,MAD,P003108,P005791,13.267,1,36,35
185,MAD,P003108,P005928,17.017,2,49,47
185,MAD,P003108,P006540,12.383,-2,35,37
185,MAD,P003108,P007630,14.9,-7,38,45
185,MAD,P003108,P009213,8.451,1,19,18
185,MAD,P003108,P011247,6.633,-9,16,25
185,MAD,P003108,P011649,6.066,-2,14,16
185,MAD,P003108,P013378,7.433,-5,20,25
185,MAD,P003108,PTGB,13.251,-3,33,36
185,MAD,P003733,P005791,21.634,13,70,57
185,MAD,P003733,P005928,20.684,8,69,61
185,MAD,P003733,P006540,14.65,-1,42,43
185,MAD,P003733,P007630,3.567,-4,8,12
185,MAD,P003733,P009213,17.818,9,55,46
185,MAD,P003733,P011247,3.65,8,19,11
185,MAD,P003733,PTGB,5.534,3,13,10
185,MAD,P005791,P005928,22.134,8,71,63
185,MAD,P005791,P006540,17.117,-4,46,50
185,MAD,P005791,P009213,15.101,13,51,38
185,MAD,P005791,P011247,3.65,8,19,11
185,MAD,P005791,PTGB,7.301,1,19,18
185,MAD,P005928,P006540,19.55,-3,54,57
185,MAD,P005928,P007630,6.617,3,20,17
185,MAD,P005928,P009213,15.668,9,52,43
185,MAD,P005928,P011247,3.65,8,19,11
185,MAD,P005928,P011649,2.283,5,8,3
185,MAD,P005928,P013378,0.8,4,4,0
185,MAD,P005928,PTGB,6.801,0,18,18
185,MAD,P006540,P007630,2.383,1,8,7
185,MAD,P006540,P009213,7.217,-1,19,20
185,MAD,P006540,P011649,1.483,1,4,3
185,MAD,P006540,PTGB,3.417,-3,8,11
185,MAD,P007630,P009213,5.084,-3,10,13
185,MAD,P007630,P011247,6.633,-9,16,25
185,MAD,P007630,P011649,6.066,-2,14,16
185,MAD,P007630,P013378,7.433,-5,20,25
185,MAD,P007630,PTGB,6.917,-2,18,20
185,MAD,P009213,P011247,3.65,8,19,11
185,MAD,P009213,PTGB,7.951,4,19,15
185,MAD,P011247,P011649,3.783,-7,6,13
185,MAD,P011247,P013378,6.633,-9,16,25
185,MAD,P011247,PTGB,2.85,-2,10,12
185,MAD,P011649,P013378,4.583,-3,10,13
185,MAD,P013378,PTGB,2.85,-2,10,12
185,TEL,P004233,P006835,5.034,2,19,17
185,TEL,P004233,P007519,7.917,3,22,19
185,TEL,P004233,P007990,3.216,-3,11,14
185,TEL,P004233,P011193,11.983,-2,36,38
185,TEL,P004233,P011214,9.233,-8,26,34
185,TEL,P004233,P011219,6.4,1,16,15
185,TEL,P004233,P012604,3.033,-2,11,13
185,TEL,P004233,P013382,3.984,-3,15,18
185,TEL,P006835,P007519,22.617,12,69,57
185,TEL,P006835,P007990,6.5,-4,15,19
185,TEL,P006835,P011193,11.416,3,37,34
185,TEL,P006835,P011202,15.033,3,43,40
185,TEL,P006835,P011214,9.65,-3,32,35
185,TEL,P006835,P011219,15.383,12,49,37
185,TEL,P006835,P012604,3.783,-2,6,8
185,TEL,P006835,P013382,20.184,1,58,57
185,TEL,P007519,P007990,4.367,-2,11,13
185,TEL,P007519,P011193,13.533,1,38,37
185,TEL,P007519,P011202,13.7,5,39,34
185,TEL,P007519,P011214,11.367,-5,33,38
185,TEL,P007519,P011219,19.333,4,54,50
185,TEL,P007519,P012604,3.55,-2,6,8
185,TEL,P007519,P013382,21.684,0,60,60
185,TEL,P007990,P011193,9.998,-5,27,32
185,TEL,P007990,P011202,3.1,-4,9,13
185,TEL,P007990,P011214,11.265,-3,32,35
185,TEL,P007990,P011219,0.849,-3,0,3
185,TEL,P007990,P012604,9.383,-1,26,27
185,TEL,P007990,P013382,4.45,1,9,8
185,TEL,P011193,P011202,2.183,-4,4,8
185,TEL,P011193,P011214,20.482,-10,58,68
185,TEL,P011193,P011219,7.249,-3,17,20
185,TEL,P011193,P012604,8.149,0,23,23
185,TEL,P011193,P013382,11.067,-4,32,36
185,TEL,P011202,P011214,3.05,-2,9,11
185,TEL,P011202,P011219,11.983,5,34,29
185,TEL,P011202,P012604,0.45,-2,0,2
185,TEL,P011202,P013382,12.433,3,34,31
185,TEL,P011214,P011219,4.499,-9,7,16
185,TEL,P011214,P012604,7.366,2,23,21
185,TEL,P011214,P013382,10.284,-2,32,34
185,TEL,P011219,P013382,14.1,-3,39,42
185,TEL,P012604,P013382,4.75,3,9,6
186,VIR,P001133,P001844,5.483,-1,6,7
186,VIR,P001133,P002084,4.767,2,8,6
186,VIR,P001133,P005738,8.316,-2,12,14
186,VIR,P001133,P006739,19.666,-8,30,38
186,VIR,P001133,P009549,18.533,0,32,32
186,VIR,P001133,P012585,14.716,-4,22,26
186,VIR,P001133,P013374,10.183,-7,16,23
186,VIR,P001133,PBCN,11.4,-8,18,26
186,VIR,P001844,P002084,0.65,0,2,2
186,VIR,P001844,P005738,5.966,4,9,5
186,VIR,P001844,P006739,1.883,-2,0,2
186,VIR,P001844,P009549,4.733,6,11,5
186,VIR,P001844,P011816,4.183,-6,5,11
186,VIR,P001844,P012585,10.766,-2,16,18
186,VIR,P001844,P013374,5.25,-1,10,11
186,VIR,P001844,PBCN,4.15,-6,5,11
186,VIR,P002084,P005738,3.25,-8,2,10
186,VIR,P002084,P006739,10.534,-6,13,19
186,VIR,P002084,P009549,10.767,-6,15,21
186,VIR,P002084,P011816,0.033,0,0,0
186,VIR,P002084,P012585,5.217,2,8,6
186,VIR,P002084,P012591,3.25,-8,2,10
186,VIR,P002084,P013374,3.134,0,5,5
186,VIR,P002084,PBCN,3.134,0,5,5
186,VIR,P005738,P006739,12.167,-2,23,25
186,VIR,P005738,P009549,13.75,4,30,26
186,VIR,P005738,P011816,2.967,7,11,4
186,VIR,P005738,P012585,11.2,15,28,13
186,VIR,P005738,P012591,3.25,-8,2,10
186,VIR,P005738,P013374,1.717,7,7,0
186,VIR,P005738,PBCN,2.417,-1,4,5
186,VIR,P006739,P009549,24.234,-2,44,46
186,VIR,P006739,P011816,4.451,5,13,8
186,VIR,P006739,P012585,16.601,2,31,29
186,VIR,P006739,P012591,3.25,-8,2,10
186,VIR,P006739,P013374,15.418,-7,25,32
186,VIR,P006739,PBCN,16.268,-8,27,35
186,VIR,P009549,P011816,3.367,7,11,4
186,VIR,P009549,P012585,14.45,15,34,19
186,VIR,P009549,P012591,3.25,-8,2,10
186,VIR,P009549,P013374,11.517,3,22,19
186,VIR,P009549,PBCN,11.267,-3,19,22
186,VIR,P011816,P012585,8.634,-1,18,19
186,VIR,P011816,P013374,5.634,-8,7,15
186,VIR,P011816,PBCN,5.267,-8,7,15
186,VIR,P012585,P013374,11.201,-8,18,26
186,VIR,P012585,PBCN,9.151,-11,13,24
186,VIR,P013374,PBCN,18.618,-11,30,41
186,ZAL,P002329,P002676,20.851,8,43,35
186,ZAL,P002329,P003048,15.968,4,33,29
186,ZAL,P002329,P005504,6.716,6,17,11
186,ZAL,P002329,P007029,2.85,4,9,5
186,ZAL,P002329,P007513,20.0,2,42,40
186,ZAL,P002329,P007975,17.734,5,41,36
186,ZAL,P002329,P011051,3.3,-5,5,10
186,ZAL,P002329,P012622,3.867,-4,6,10
186,ZAL,P002329,P013403,12.65,0,24,24
186,ZAL,P002676,P003048,15.318,8,28,20
186,ZAL,P002676,P005504,10.766,11,24,13
186,ZAL,P002676,P007029,4.817,-6,7,13
186,ZAL,P002676,P007513,23.651,14,45,31
186,ZAL,P002676,P007975,26.451,11,54,43
186,ZAL,P002676,P011051,8.067,-6,9,15
186,ZAL,P002676,P012715,7.434,1,14,13
186,ZAL,P002676,P013403,7.517,3,12,9
186,ZAL,P003048,P007029,2.2,1,6,5
186,ZAL,P003048,P007513,15.5,-1,25,26
186,ZAL,P003048,P007975,12.885,10,29,19
186,ZAL,P003048,P011051,5.0,0,5,5
186,ZAL,P003048,P012622,5.067,-4,7,11
186,ZAL,P003048,P013403,11.934,-2,19,21
186,ZAL,P005504,P007029,2.233,6,6,0
186,ZAL,P005504,P007513,11.3,16,27,11
186,ZAL,P005504,P007975,10.766,11,24,13
186,ZAL,P005504,P011051,1.583,3,3,0
186,ZAL,P005504,P012715,4.467,8,10,2
186,ZAL,P005504,P013403,3.233,7,9,2
186,ZAL,P007029,P007513,2.583,6,9,3
186,ZAL,P007029,P007975,4.817,-6,7,13
186,ZAL,P007029,P011051,4.55,-4,7,11
186,ZAL,P007029,P012715,2.967,-7,4,11
186,ZAL,P007029,P013403,2.583,6,9,3
186,ZAL,P007513,P007975,18.917,12,40,28
186,ZAL,P007513,P011051,8.933,-5,10,15
186,ZAL,P007513,P012622,3.833,-8,3,11
186,ZAL,P007513,P012715,4.467,8,10,2
186,ZAL,P007513,P013403,11.216,-4,17,21
186,ZAL,P007975,P011051,8.817,-5,12,17
186,ZAL,P007975,P012622,2.334,2,6,4
186,ZAL,P007975,P012715,7.434,1,14,13
186,ZAL,P007975,P013403,5.117,3,13,10
186,ZAL,P011051,P012622,3.4,-4,5,9
186,ZAL,P011051,P012715,2.967,-7,4,11
186,ZAL,P011051,P013403,4.783,-3,8,11
186,ZAL,P012622,P013403,6.167,-6,9,15
187,RED,P002553,P004007,2.95,2,8,6
187,RED,P002553,P006436,2.95,2,8,6
187,RED,P002553,P007960,6.517,-2,17,19
187,RED,P002553,P010612,3.567,-4,9,13
187,RED,P002553,P012044,6.517,-2,17,19
187,RED,P002553,PJDR,3.567,-4,9,13
187,RED,P004007,P004866,11.0,-1,21,22
187,RED,P004007,P006436,9.534,4,23,19
187,RED,P004007,P007960,10.45,3,25,22
187,RED,P004007,P009035,10.6,-3,19,22
187,RED,P004007,P009048,14.267,7,34,27
187,RED,P004007,P010612,2.184,4,11,7
187,RED,P004007,P011194,3.884,8,15,7
187,RED,P004007,P012044,4.467,2,10,8
187,RED,P004007,PJDR,0.4,2,2,0
187,RED,P004866,P006436,6.716,-8,9,17
187,RED,P004866,P007960,12.517,3,28,25
187,RED,P004866,P009035,13.1,-8,22,30
187,RED,P004866,P009048,23.067,1,51,50
187,RED,P004866,P010612,12.817,2,30,28
187,RED,P004866,P011194,10.9,6,29,23
187,RED,P004866,P012044,0.933,-3,0,3
187,RED,P004866,PJDR,4.95,0,14,14
187,RED,P006436,P007960,3.133,-1,8,9
187,RED,P006436,P009035,5.983,-8,8,16
187,RED,P006436,P009048,9.05,3,22,19
187,RED,P006436,P010588,3.05,-5,4,9
187,RED,P006436,P010612,8.667,-2,22,24
187,RED,P006436,P011194,12.667,-1,30,31
187,RED,P006436,P012044,11.15,-7,20,27
187,RED,P006436,PJDR,2.7,-1,6,7
187,RED,P007960,P009035,8.95,-6,18,24
187,RED,P007960,P009048,12.517,3,28,25
187,RED,P007960,P010612,8.401,1,20,19
187,RED,P007960,P011194,3.567,9,10,1
187,RED,P007960,P012044,6.517,-2,17,19
187,RED,P007960,PJDR,3.567,-4,9,13
187,RED,P009035,P009048,13.35,-9,22,31
187,RED,P009035,P010612,2.567,-3,3,6
187,RED,P009035,P011194,2.95,-2,6,8
187,RED,P009035,P012044,2.7,-1,6,7
187,RED,P009035,PJDR,4.0,0,8,8
187,RED,P009048,P010612,14.101,10,41,31
187,RED,P009048,P011194,13.484,16,42,26
187,RED,P009048,P012044,1.3,2,2,0
187,RED,P009048,PJDR,5.2,-1,14,15
187,RED,P010588,P010612,3.05,-5,4,9
187,RED,P010588,P011194,3.05,-5,4,9
187,RED,P010588,P012044,3.05,-5,4,9
187,RED,P010612,P011194,15.984,2,42,40
187,RED,P010612,P012044,7.767,-14,13,27
187,RED,P010612,PJDR,8.367,-7,21,28
187,RED,P011194,P012044,8.2,-9,12,21
187,RED,P011194,PJDR,6.85,-4,18,22
187,RED,P012044,PJDR,6.267,-5,15,20
187,ULK,P002849,P004004,19.866,14,55,41
187,ULK,P002849,P005216,13.534,-7,31,38
187,ULK,P002849,P006961,15.183,6,41,35
187,ULK,P002849,P008104,8.049,13,22,9
187,ULK,P002849,P008962,22.083,6,56,50
187,ULK,P002849,P009783,9.4,14,26,12
187,ULK,P002849,P010560,6.15,4,16,12
187,ULK,P002849,P011205,17.067,-2,41,43
187,ULK,P004004,P005216,7.233,-1,22,23
187,ULK,P004004,P006961,14.266,12,42,30
187,ULK,P004004,P007182,8.317,4,21,17
187,ULK,P004004,P008104,11.699,16,32,16
187,ULK,P004004,P008962,22.816,12,62,50
187,ULK,P004004,P009783,11.05,14,31,17
187,ULK,P004004,P010560,6.15,4,16,12
187,ULK,P004004,P011205,12.867,-3,31,34
187,ULK,P005216,P006961,11.8,-8,27,35
187,ULK,P005216,P007182,4.75,-7,7,14
187,ULK,P005216,P008962,18.667,-14,40,54
187,ULK,P005216,P009783,4.017,0,8,8
187,ULK,P005216,P011205,14.667,-19,25,44
187,ULK,P006961,P007182,6.117,-7,9,16
187,ULK,P006961,P008104,4.766,8,15,7
187,ULK,P006961,P008962,15.933,-7,36,43
187,ULK,P006961,P010560,5.75,6,16,10
187,ULK,P006961,P011205,12.917,-14,22,36
187,ULK,P007182,P008104,3.65,3,10,7
187,ULK,P007182,P008962,11.784,-7,22,29
187,ULK,P007182,P009783,5.667,0,13,13
187,ULK,P007182,P011205,6.851,-14,6,20
187,ULK,P008104,P008962,7.866,11,20,9
187,ULK,P008104,P009783,6.933,8,17,9
187,ULK,P008104,P010560,3.833,5,12,7
187,ULK,P008962,P009783,15.067,14,39,25
187,ULK,P008962,P010560,0.4,-2,0,2
187,ULK,P008962,P011205,22.384,-17,45,62
187,ULK,P009783,P011205,8.134,6,22,16
187,ULK,P010560,P011205,2.317,-1,4,5
188,BAR,P000925,P002939,6.5,-9,8,17
188,BAR,P000925,P003478,3.317,-5,6,11
188,BAR,P000925,P007464,10.5,1,21,20
188,BAR,P000925,P009862,6.15,-7,10,17
188,BAR,P000925,P009992,12.334,7,27,20
188,BAR,P000925,P010106,9.4,4,21,17
188,BAR,P000925,P012745,10.333,1,25,24
188,BAR,P000925,P013379,5.734,-4,6,10
188,BAR,P002939,P003478,15.734,7,31,24
188,BAR,P002939,P006568,11.0,10,25,15
188,BAR,P002939,P007464,2.5,-1,7,8
188,BAR,P002939,P009862,20.65,-1,38,39
188,BAR,P002939,P009992,5.5,4,11,7
188,BAR,P002939,P012745,23.05,2,45,43
188,BAR,P002939,P012795,4.1,-3,8,11
188,BAR,P002939,P013379,6.634,-1,7,8
188,BAR,P003478,P006568,6.9,13,17,4
188,BAR,P003478,P007464,2.734,8,13,5
188,BAR,P003478,P009862,15.451,1,28,27
188,BAR,P003478,P009992,6.034,11,19,8
188,BAR,P003478,P010106,5.434,1,12,11
188,BAR,P003478,P012745,19.268,4,37,33
188,BAR,P003478,P013379,10.468,0,17,17
188,BAR,P006568,P009862,11.0,10,25,15
188,BAR,P006568,P012745,11.0,10,25,15
188,BAR,P006568,P012795,4.1,-3,8,11
188,BAR,P007464,P009862,1.083,-1,5,6
188,BAR,P007464,P009992,13.95,10,33,23
188,BAR,P007464,P010106,12.55,10,31,21
188,BAR,P007464,P012745,7.249,7,24,17
188,BAR,P007464,P013379,9.634,2,18,16
188,BAR,P009862,P009992,2.417,3,6,3
188,BAR,P009862,P010106,1.567,-5,0,5
188,BAR,P009862,P012745,22.384,-4,40,44
188,BAR,P009862,P012795,4.1,-3,8,11
188,BAR,P009862,P013379,4.734,-9,0,9
188,BAR,P009992,P010106,14.35,10,35,25
188,BAR,P009992,P012745,12.216,14,34,20
188,BAR,P009992,P013379,13.267,5,27,22
188,BAR,P010106,P012745,8.983,3,21,18
188,BAR,P010106,P013379,11.384,-3,20,23
188,BAR,P012745,P012795,4.1,-3,8,11
188,BAR,P012745,P013379,10.217,-6,13,19
188,PAN,P001926,P004088,13.649,-7,28,35
188,PAN,P001926,P005353,6.95,-1,10,11
188,PAN,P001926,P007866,9.982,1,21,20
188,PAN,P001926,P009622,3.2,7,9,2
188,PAN,P001926,P011204,12.699,0,24,24
188,PAN,P001926,P011209,0.15,-2,0,2
188,PAN,P001926,P012712,13.366,-3,26,29
188,PAN,P001926,P012774,10.466,-7,19,26
188,PAN,P001926,P013383,8.066,-4,11,15
188,PAN,P004088,P005161,1.533,1,4,3
188,PAN,P004088,P005353,19.816,5,39,34
188,PAN,P004088,P007866,9.549,-6,19,25
188,PAN,P004088,P011204,27.082,-8,51,59
188,PAN,P004088,P011209,0.15,-2,0,2
188,PAN,P004088,P012712,27.049,-12,49,61
188,PAN,P004088,P012774,28.049,-8,55,63
188,PAN,P004088,P013383,9.183,-11,11,22
188,PAN,P005161,P005353,1.533,1,4,3
188,PAN,P005161,P011204,1.533,1,4,3
188,PAN,P005161,P012774,1.533,1,4,3
188,PAN,P005353,P009622,1.617,1,3,2
188,PAN,P005353,P011204,21.083,9,40,31
188,PAN,P005353,P012712,21.05,5,38,33
188,PAN,P005353,P012774,18.283,4,34,30
188,PAN,P007866,P009622,1.583,6,6,0
188,PAN,P007866,P011204,7.332,-3,14,17
188,PAN,P007866,P012712,6.499,-3,14,17
188,PAN,P007866,P012774,9.849,-10,15,25
188,PAN,P007866,P013383,6.266,-1,11,12
188,PAN,P009622,P011204,3.2,7,9,2
188,PAN,P009622,P012712,3.2,7,9,2
188,PAN,P011204,P011209,0.15,-2,0,2
188,PAN,P011204,P012712,30.699,-6,56,62
188,PAN,P011204,P012774,23.899,-8,42,50
188,PAN,P011204,P013383,4.583,-10,0,10
188,PAN,P011209,P012712,0.15,-2,0,2
188,PAN,P012712,P012774,23.033,-12,40,52
188,PAN,P012712,P013383,3.75,-10,0,10
188,PAN,P012774,P013383,8.216,-8,11,19
189,MCO,P001932,P002581,1.517,1,4,3
189,MCO,P001932,P005844,8.467,-2,16,18
189,MCO,P001932,P005985,1.884,-2,4,6
189,MCO,P001932,P008099,4.733,4,11,7
189,MCO,P001932,P009754,10.417,7,24,17
189,MCO,P001932,P011212,6.918,-1,15,16
189,MCO,P001932,P011226,0.65,2,2,0
189,MCO,P001932,P011231,10.784,4,24,20
189,MCO,P001932,P012515,0.65,2,2,0
189,MCO,P001932,P013365,0.867,-1,2,3
189,MCO,P001932,PLCZ,2.317,6,8,2
189,MCO,P002581,P005985,22.234,8,56,48
189,MCO,P002581,P008099,13.383,2,34,32
189,MCO,P002581,P009754,11.934,15,34,19
189,MCO,P002581,P011212,3.8,3,11,8
189,MCO,P002581,P011226,14.484,1,33,32
189,MCO,P002581,P011231,8.066,9,24,15
189,MCO,P002581,P012515,11.983,8,32,24
189,MCO,P002581,P013365,6.267,-11,8,19
189,MCO,P005844,P005985,0.367,-3,0,3
189,MCO,P005844,P008099,7.383,2,20,18
189,MCO,P005844,P009754,10.75,-1,25,26
189,MCO,P005844,P011212,6.384,-8,14,22
189,MCO,P005844,P011231,11.117,-4,25,29
189,MCO,P005985,P008099,13.25,-8,31,39
189,MCO,P005985,P009754,14.434,9,36,27
189,MCO,P005985,P011212,5.734,-10,10,20
189,MCO,P005985,P011226,14.884,-2,33,35
189,MCO,P005985,P011231,10.0,-4,23,27
189,MCO,P005985,P012515,10.933,7,29,22
189,MCO,P005985,P013365,6.267,-11,8,19
189,MCO,P005985,PLCZ,3.017,-12,2,14
189,MCO,P008099,P009754,12.95,11,39,28
189,MCO,P008099,P011212,4.483,-7,12,19
189,MCO,P008099,P011226,9.817,-5,21,26
189,MCO,P008099,P011231,11.999,0,33,33
189,MCO,P008099,P012515,2.949,0,9,9
189,MCO,P008099,P013365,5.4,-10,6,16
189,MCO,P008099,PLCZ,0.917,-9,0,9
189,MCO,P009754,P011212,10.434,-2,24,26
189,MCO,P009754,P011226,8.834,6,25,19
189,MCO,P009754,P011231,18.667,8,44,36
189,MCO,P009754,P012515,6.767,3,15,12
189,MCO,P009754,PLCZ,4.817,0,10,10
189,MCO,P011212,P011231,14.384,-7,33,40
189,MCO,P011212,P012515,3.066,4,9,5
189,MCO,P011212,P013365,0.867,-1,2,3
189,MCO,P011212,PLCZ,4.934,-3,10,13
189,MCO,P011226,P012515,5.067,3,12,9
189,MCO,P011226,P013365,5.4,-10,6,16
189,MCO,P011226,PLCZ,0.4,-3,0,3
189,MCO,P011231,P012515,7.049,5,20,15
189,MCO,P011231,PLCZ,4.934,-3,10,13
189,MUN,P001557,P004508,0.367,-2,3,5
189,MUN,P001557,P007056,14.684,1,36,35
189,MUN,P001557,P007201,7.367,10,20,10
189,MUN,P001557,P010391,14.684,1,36,35
189,MUN,P001557,P011224,2.917,-3,8,11
189,MUN,P001557,P011244,4.4,-6,8,14
189,MUN,P001557,P011987,14.317,3,33,30
189,MUN,P004508,P005460,7.916,1,20,19
189,MUN,P004508,P007056,14.284,-1,35,36
189,MUN,P004508,P007201,12.817,7,41,34
189,MUN,P004508,P007929,2.3,-1,5,6
189,MUN,P004508,P010391,9.8,7,32,25
189,MUN,P004508,P011224,17.3,-2,39,41
189,MUN,P004508,P011244,9.016,-5,11,16
189,MUN,P004508,P011987,15.0,-4,34,38
189,MUN,P005460,P007201,2.9,2,11,9
189,MUN,P005460,P007929,2.3,-1,5,6
189,MUN,P005460,P010391,1.433,0,2,2
189,MUN,P005460,P011224,7.916,1,20,19
189,MUN,P005460,P011244,5.016,-1,9,10
189,MUN,P005460,P011987,4.183,2,13,11
189,MUN,P007056,P007201,20.767,13,57,44
189,MUN,P007056,P010391,26.167,8,70,62
189,MUN,P007056,P011224,15.417,-6,31,37
189,MUN,P007056,P011244,8.4,-10,10,20
189,MUN,P007056,P011987,28.617,-5,61,66
189,MUN,P007201,P010391,18.2,17,54,37
189,MUN,P007201,P011224,11.4,3,32,29
189,MUN,P007201,P011987,21.217,8,57,49
189,MUN,P007929,P011224,2.3,-1,5,6
189,MUN,P007929,P011244,2.3,-1,5,6
189,MUN,P010391,P011224,10.933,2,28,26
189,MUN,P010391,P011244,6.483,-6,10,16
189,MUN,P010391,P011987,22.7,3,56,53
189,MUN,P011224,P011244,9.016,-5,11,16
189,MUN,P011224,P011987,16.133,-9,30,39
189,MUN,P011244,P011987,9.033,-10,12,22
190,ASV,P000229,P002100,15.65,1,32,31
190,ASV,P000229,P003526,7.983,2,17,15
190,ASV,P000229,P007027,20.032,-6,38,44
190,ASV,P000229,P008991,6.816,4,13,9
190,ASV,P000229,P010545,13.066,-7,24,31
190,ASV,P000229,P011225,8.316,-7,9,16
190,ASV,P000229,P013371,10.199,16,29,13
190,ASV,P000229,P013377,7.333,4,17,13
190,ASV,P000229,P013405,19.465,-3,37,40
190,ASV,P002100,P003526,13.05,2,26,24
190,ASV,P002100,P007027,10.783,-2,26,28
190,ASV,P002100,P008991,9.7,7,24,17
190,ASV,P002100,P010316,7.8,4,20,16
190,ASV,P002100,P010545,7.516,2,22,20
190,ASV,P002100,P011225,4.283,4,13,9
190,ASV,P002100,P013371,11.15,15,29,14
190,ASV,P002100,P013377,7.567,2,14,12
190,ASV,P002100,P013405,11.833,9,34,25
190,ASV,P003526,P007027,3.8,-4,6,10
190,ASV,P003526,P008991,5.95,3,13,10
190,ASV,P003526,P010316,5.3,-2,9,11
190,ASV,P003526,P010545,0.533,0,2,2
190,ASV,P003526,P011225,0.533,0,2,2
190,ASV,P003526,P013371,8.95,4,18,14
190,ASV,P003526,P013377,6.75,-3,11,14
190,ASV,P003526,P013405,0.283,-2,0,2
190,ASV,P007027,P008991,2.483,3,5,2
190,ASV,P007027,P010316,9.3,-4,16,20
190,ASV,P007027,P010545,22.649,-8,43,51
190,ASV,P007027,P011225,15.266,-12,20,32
190,ASV,P007027,P013371,6.049,16,24,8
190,ASV,P007027,P013377,5.583,1,14,13
190,ASV,P007027,P013405,26.915,0,56,56
190,ASV,P008991,P010316,5.367,6,16,10
190,ASV,P008991,P011225,6.233,7,16,9
190,ASV,P008991,P013371,5.95,3,13,10
190,ASV,P008991,P013405,6.233,7,16,9
190,ASV,P010316,P010545,8.733,-7,13,20
190,ASV,P010316,P011225,11.233,-1,24,25
190,ASV,P010316,P013371,4.467,1,8,7
190,ASV,P010316,P013377,2.25,1,5,4
190,ASV,P010316,P013405,11.15,2,25,23
190,ASV,P010545,P011225,13.316,-15,17,32
190,ASV,P010545,P013371,4.266,11,16,5
190,ASV,P010545,P013405,22.649,-8,43,51
190,ASV,P011225,P013405,19.016,-8,31,39
190,ASV,P013371,P013377,5.783,9,16,7
190,ASV,P013371,P013405,7.382,17,27,10
190,ASV,P013377,P013405,3.066,6,11,5
190,BER,P006251,P006919,4.85,0,11,11
190,BER,P006251,P007025,3.233,-2,7,9
190,BER,P006251,P008062,12.316,4,24,20
190,BER,P006251,P008211,16.967,-5,28,33
190,BER,P006251,P008384,11.75,5,26,21
190,BER,P006251,P008780,19.717,3,42,39
190,BER,P006251,P008967,31.667,4,66,62
190,BER,P006251,P011934,7.083,11,19,8
190,BER,P006251,P013386,26.417,-8,49,57
190,BER,P006919,P007025,3.984,-3,5,8
190,BER,P006919,P008211,2.867,-1,4,5
190,BER,P006919,P008384,0.417,1,1,0
190,BER,P006919,P008780,8.134,0,16,16
190,BER,P006919,P008967,4.15,3,11,8
190,BER,P006919,P011934,3.284,0,5,5
190,BER,P006919,P013386,4.85,0,11,11
190,BER,P007025,P008062,3.9,-7,4,11
190,BER,P007025,P008211,2.867,-1,4,5
190,BER,P007025,P008384,5.1,-4,7,11
190,BER,P007025,P008780,6.167,-2,12,14
190,BER,P007025,P008967,1.4,-1,5,6
190,BER,P007025,P011631,3.55,-7,4,11
190,BER,P007025,P011934,6.367,-2,11,13
190,BER,P007025,P013386,3.7,-7,5,12
190,BER,P008062,P008211,3.083,-3,2,5
190,BER,P008062,P008384,14.65,1,31,30
190,BER,P008062,P008967,13.833,5,29,24
190,BER,P008062,P011631,5.417,-6,9,15
190,BER,P008062,P011934,7.967,3,19,16
190,BER,P008062,P013386,9.766,-5,14,19
190,BER,P008211,P008384,1.467,-4,2,6
190,BER,P008211,P008780,18.084,-3,35,38
190,BER,P008211,P008967,19.767,-9,35,44
190,BER,P008211,P011631,2.8,-4,7,11
190,BER,P008211,P011934,8.15,-2,18,20
190,BER,P008211,P013386,14.484,-8,21,29
190,BER,P008384,P008780,1.467,3,3,0
190,BER,P008384,P008967,12.484,4,29,25
190,BER,P008384,P011631,5.417,-6,9,15
190,BER,P008384,P011934,9.167,6,22,16
190,BER,P008384,P013386,8.417,-6,14,20
190,BER,P008780,P008967,21.034,0,47,47
190,BER,P008780,P011631,2.8,-4,7,11
190,BER,P008780,P011934,9.35,1,21,20
190,BER,P008780,P013386,16.451,-2,33,35
190,BER,P008967,P011631,4.667,-3,12,15
190,BER,P008967,P011934,10.95,6,29,23
190,BER,P008967,P013386,25.384,-5,49,54
190,BER,P011631,P011934,6.95,-7,16,23
190,BER,P011631,P013386,1.267,-3,0,3
191,MIL,P000796,P001518,5.4,-5,9,14
191,MIL,P000796,P006509,18.734,-2,38,40
191,MIL,P000796,P007831,28.417,-8,55,63
191,MIL,P000796,P008985,26.1,-4,51,55
191,MIL,P000796,P008987,18.367,-12,32,44
191,MIL,P000796,P011064,16.067,-13,27,40
191,MIL,P000796,P011941,10.417,8,25,17
191,MIL,P000796,P013384,8.766,4,23,19
191,MIL,P001518,P006509,4.4,-4,8,12
191,MIL,P001518,P007831,3.5,-3,6,9
191,MIL,P001518,P008985,4.767,-4,6,10
191,MIL,P001518,P008987,4.334,-8,1,9
191,MIL,P001518,P011064,5.117,-9,3,12
191,MIL,P001518,P011941,1.733,-4,0,4
191,MIL,P001518,P013384,5.217,-11,3,14
191,MIL,P006509,P007831,19.834,-3,40,43
191,MIL,P006509,P008985,11.767,2,24,22
191,MIL,P006509,P008987,7.868,-11,10,21
191,MIL,P006509,P011064,11.418,-9,19,28
191,MIL,P006509,P011941,14.134,3,30,27
191,MIL,P006509,P013384,2.117,-4,3,7
191,MIL,P007831,P008985,21.45,-4,41,45
191,MIL,P007831,P008987,20.051,-21,30,51
191,MIL,P007831,P011064,15.134,-18,22,40
191,MIL,P007831,P011941,13.417,5,30,25
191,MIL,P007831,P013384,6.733,0,16,16
191,MIL,P008985,P008987,18.017,-12,30,42
191,MIL,P008985,P011064,12.467,-16,16,32
191,MIL,P008985,P011941,7.167,5,16,11
191,MIL,P008985,P013384,8.133,5,20,15
191,MIL,P008987,P011064,17.134,-24,20,44
191,MIL,P008987,P011941,5.45,-9,5,14
191,MIL,P008987,P013384,9.983,1,20,19
191,MIL,P011064,P011941,9.417,-8,14,22
191,MIL,P011064,P013384,5.25,-3,7,10
191,MIL,P011941,P013384,1.733,-4,0,4
191,PAR,P006760,P007736,4.5,-3,10,13
191,PAR,P006760,P007870,10.933,-3,20,23
191,PAR,P006760,P010781,15.483,16,36,20
191,PAR,P006760,P011836,2.566,0,6,6
191,PAR,P006760,P011981,22.333,17,52,35
191,PAR,P006760,P012720,18.416,17,42,25
191,PAR,P006760,P013369,17.433,12,42,30
191,PAR,P007736,P007870,4.5,-3,10,13
191,PAR,P007736,P011981,4.5,-3,10,13
191,PAR,P007736,P013369,4.5,-3,10,13
191,PAR,P007870,P008232,2.083,-1,5,6
191,PAR,P007870,P010781,11.166,6,24,18
191,PAR,P007870,P011836,4.183,2,9,7
191,PAR,P007870,P011981,10.35,0,20,20
191,PAR,P007870,P012720,12.116,4,24,20
191,PAR,P007870,P013369,11.133,-1,24,25
191,PAR,P008232,P010781,10.133,1,22,21
191,PAR,P008232,P011050,1.017,-5,0,5
191,PAR,P008232,P011981,7.033,7,17,10
191,PAR,P008232,P012720,10.133,1,22,21
191,PAR,P008232,P013369,10.133,1,22,21
191,PAR,P010781,P011050,4.367,-5,7,12
191,PAR,P010781,P011836,7.533,2,16,14
191,PAR,P010781,P011981,21.933,26,53,27
191,PAR,P010781,P012720,32.566,22,74,52
191,PAR,P010781,P013369,27.083,20,64,44
191,PAR,P011050,P011836,3.35,0,7,7
191,PAR,P011050,P012720,4.367,-5,7,12
191,PAR,P011050,P013369,4.367,-5,7,12
191,PAR,P011836,P011981,1.983,3,6,3
191,PAR,P011836,P012720,9.516,5,22,17
191,PAR,P011836,P013369,8.933,8,22,14
191,PAR,P011981,P012720,24.866,27,59,32
191,PAR,P011981,P013369,24.466,19,59,40
191,PAR,P012720,P013369,30.016,21,70,49
192,PRS,P004197,P004512,7.917,-6,17,23
192,PRS,P004197,P007032,13.567,-7,34,41
192,PRS,P004197,P012611,3.417,-6,5,11
192,PRS,P004197,P012612,9.067,-7,22,29
192,PRS,P004197,P012640,16.984,-13,39,52
192,PRS,P004197,P013373,16.984,-13,39,52
192,PRS,P004512,P007032,7.917,-6,17,23
192,PRS,P004512,P012608,4.067,4,9,5
192,PRS,P004512,P012610,4.067,4,9,5
192,PRS,P004512,P012613,4.067,4,9,5
192,PRS,P004512,P012640,11.984,-2,26,28
192,PRS,P004512,P013373,7.917,-6,17,23
192,PRS,P007032,P012612,5.65,-1,17,18
192,PRS,P007032,P012640,13.567,-7,34,41
192,PRS,P007032,P013373,13.567,-7,34,41
192,PRS,P010390,P012608,18.95,22,48,26
192,PRS,P010390,P012609,18.95,22,48,26
192,PRS,P010390,P012610,18.95,22,48,26
192,PRS,P010390,P012613,18.95,22,48,26
192,PRS,P012608,P012609,18.95,22,48,26
192,PRS,P012608,P012610,23.017,26,57,31
192,PRS,P012608,P012613,23.017,26,57,31
192,PRS,P012608,P012640,4.067,4,9,5
192,PRS,P012609,P012610,18.95,22,48,26
192,PRS,P012609,P012613,18.95,22,48,26
192,PRS,P012610,P012613,23.017,26,57,31
192,PRS,P012610,P012640,4.067,4,9,5
192,PRS,P012611,P012612,3.417,-6,5,11
192,PRS,P012611,P012640,3.417,-6,5,11
192,PRS,P012611,P013373,3.417,-6,5,11
192,PRS,P012612,P012640,9.067,-7,22,29
192,PRS,P012612,P013373,9.067,-7,22,29
192,PRS,P012613,P012640,4.067,4,9,5
192,PRS,P012640,P013373,16.984,-13,39,52
192,TEL,P006835,P007519,22.167,-12,40,52
192,TEL,P006835,P007990,14.517,7,33,26
192,TEL,P006835,P011193,14.583,6,36,30
192,TEL,P006835,P011202,12.067,-4,23,27
192,TEL,P006835,P011214,9.967,-3,17,20
192,TEL,P006835,P011219,11.7,1,26,25
192,TEL,P006835,P011433,0.933,4,4,0
192,TEL,P006835,P012604,8.583,3,21,18
192,TEL,P006835,P013381,3.15,9,11,2
192,TEL,P006835,P013382,23.333,-7,45,52
192,TEL,P007519,P007990,15.184,-6,32,38
192,TEL,P007519,P011193,7.433,-3,16,19
192,TEL,P007519,P011202,12.951,-17,19,36
192,TEL,P007519,P011214,10.117,-10,18,28
192,TEL,P007519,P011219,9.817,-11,17,28
192,TEL,P007519,P012604,8.75,-1,19,20
192,TEL,P007519,P013381,4.417,0,10,10
192,TEL,P007519,P013382,19.7,-8,37,45
192,TEL,P007990,P011193,6.917,-8,11,19
192,TEL,P007990,P011202,10.684,-9,22,31
192,TEL,P007990,P011214,9.751,-4,21,25
192,TEL,P007990,P011219,6.767,-9,12,21
192,TEL,P007990,P011433,2.166,7,9,2
192,TEL,P007990,P012604,10.316,-2,23,25
192,TEL,P007990,P013381,10.333,3,26,23
192,TEL,P007990,P013382,10.433,-7,19,26
192,TEL,P011193,P011202,4.8,2,13,11
192,TEL,P011193,P011214,9.484,-3,17,20
192,TEL,P011193,P011219,6.0,4,18,14
192,TEL,P011193,P012604,3.666,-10,5,15
192,TEL,P011193,P013381,3.75,-4,7,11
192,TEL,P011193,P013382,13.899,-8,29,37
192,TEL,P011202,P011214,8.034,-16,11,27
192,TEL,P011202,P011219,12.284,-7,25,32
192,TEL,P011202,P011433,1.233,3,5,2
192,TEL,P011202,P012604,1.233,3,5,2
192,TEL,P011202,P013381,4.35,0,10,10
192,TEL,P011202,P013382,8.3,-3,15,18
192,TEL,P011214,P011219,2.567,-8,4,12
192,TEL,P011214,P013381,5.534,5,15,10
192,TEL,P011214,P013382,7.95,-5,13,18
192,TEL,P011219,P013382,7.933,2,18,16
192,TEL,P011433,P012604,2.166,7,9,2
192,TEL,P011433,P013381,2.166,7,9,2
192,TEL,P012604,P013381,4.799,-2,11,13
192,TEL,P012604,P013382,10.283,-10,19,29
192,TEL,P013381,P013382,2.833,-6,5,11
193,MAD,P003108,P003733,2.917,-6,8,14
193,MAD,P003108,P005791,18.415,-2,37,39
193,MAD,P003108,P005928,14.066,-11,23,34
193,MAD,P003108,P006540,14.183,-11,28,39
193,MAD,P003108,P007630,10.85,-1,23,24
193,MAD,P003108,P009213,4.7,-8,2,10
193,MAD,P003108,P011247,14.683,9,33,24
193,MAD,P003108,P011649,11.199,-3,19,22
193,MAD,P003108,P013378,11.833,10,31,21
193,MAD,P003108,PTGB,17.882,3,36,33
193,MAD,P003733,P005791,9.083,-5,20,25
193,MAD,P003733,P005928,8.45,-4,17,21
193,MAD,P003733,P006540,9.75,-8,20,28
193,MAD,P003733,P007630,0.667,-3,0,3
193,MAD,P003733,P009213,6.833,-2,12,14
193,MAD,P003733,PTGB,1.3,-4,3,7
193,MAD,P005791,P005928,16.099,-4,29,33
193,MAD,P005791,P006540,14.399,-6,29,35
193,MAD,P005791,P009213,8.766,-4,12,16
193,MAD,P005791,P011247,7.716,3,16,13
193,MAD,P005791,P011649,9.766,-1,17,18
193,MAD,P005791,P013378,4.133,4,12,8
193,MAD,P005791,PTGB,12.615,-1,24,25
193,MAD,P005928,P006540,17.982,-11,35,46
193,MAD,P005928,P007630,6.983,-12,12,24
193,MAD,P005928,P009213,11.816,-11,20,31
193,MAD,P005928,P011649,10.766,-6,20,26
193,MAD,P005928,P013378,0.733,0,2,2
193,MAD,P005928,PTGB,5.433,-5,6,11
193,MAD,P006540,P007630,8.683,-10,17,27
193,MAD,P006540,P009213,9.816,-5,26,31
193,MAD,P006540,P011247,4.584,-2,15,17
193,MAD,P006540,P011649,9.116,-6,25,31
193,MAD,P006540,P013378,5.317,-2,17,19
193,MAD,P006540,PTGB,2.166,-3,4,7
193,MAD,P007630,P009213,4.15,-7,8,15
193,MAD,P007630,P011247,6.05,8,17,9
193,MAD,P007630,P011649,3.616,-5,8,13
193,MAD,P007630,P013378,6.783,8,19,11
193,MAD,P007630,PTGB,4.35,6,12,6
193,MAD,P009213,P011247,2.7,-2,8,10
193,MAD,P009213,P011649,2.7,-3,14,17
193,MAD,P009213,P013378,1.6,-2,8,10
193,MAD,P009213,PTGB,4.983,-8,2,10
193,MAD,P011247,P011649,3.0,-1,12,13
193,MAD,P011247,P013378,11.9,10,37,27
193,MAD,P011247,PTGB,11.299,11,26,15
193,MAD,P011649,P013378,0.517,0,8,8
193,MAD,P011649,PTGB,4.916,1,9,8
193,MAD,P013378,PTGB,7.716,12,22,10
193,OLY,P001255,P003469,23.166,16,61,45
193,OLY,P001255,P003941,10.433,11,28,17
193,OLY,P001255,P007853,0.8,0,8,8
193,OLY,P001255,P007947,14.066,12,40,28
193,OLY,P001255,P007982,9.1,4,21,17
193,OLY,P001255,P008811,11.933,5,25,20
193,OLY,P001255,P013380,23.166,16,61,45
193,OLY,P003469,P003941,17.75,12,42,30
193,OLY,P003469,P007853,10.834,3,33,30
193,OLY,P003469,P007947,22.183,19,62,43
193,OLY,P003469,P007982,11.017,0,24,24
193,OLY,P003469,P008811,14.65,7,36,29
193,OLY,P003469,P010392,2.8,-2,4,6
193,OLY,P003469,P013380,30.4,21,82,61
193,OLY,P003941,P007853,14.117,-8,24,32
193,OLY,P003941,P007947,20.416,7,44,37
193,OLY,P003941,P007982,4.984,-11,8,19
193,OLY,P003941,P008829,6.8,-9,10,19
193,OLY,P003941,P010392,5.883,-1,9,10
193,OLY,P003941,P013380,17.817,11,43,32
193,OLY,P007853,P007947,13.5,-2,35,37
193,OLY,P007853,P007982,4.984,-11,8,19
193,OLY,P007853,P008811,2.717,2,11,9
193,OLY,P007853,P008829,6.8,-9,10,19
193,OLY,P007853,P010392,5.883,-1,9,10
193,OLY,P007853,P013380,10.901,2,34,32
193,OLY,P007947,P007982,0.85,-7,0,7
193,OLY,P007947,P008811,5.55,3,15,12
193,OLY,P007947,P008829,4.583,-9,5,14
193,OLY,P007947,P010392,5.883,-1,9,10
193,OLY,P007947,P013380,20.033,18,58,40
193,OLY,P007982,P008811,9.1,4,21,17
193,OLY,P007982,P008829,3.067,-7,5,12
193,OLY,P007982,P013380,13.234,0,29,29
193,OLY,P008811,P013380,14.65,7,36,29
193,OLY,P008829,P010392,3.083,1,5,4
193,OLY,P008829,P013380,2.867,-3,5,8
194,ULK,P002849,P002968,6.217,1,11,10
194,ULK,P002849,P004004,10.183,8,30,22
194,ULK,P002849,P005216,6.6,2,16,14
194,ULK,P002849,P006961,13.533,1,25,24
194,ULK,P002849,P008104,5.867,-11,7,18
194,ULK,P002849,P008962,13.717,-3,29,32
194,ULK,P002849,P009783,5.617,-6,14,20
194,ULK,P002849,P010560,1.217,4,6,2
194,ULK,P002849,P011205,18.517,0,42,42
194,ULK,P002968,P004004,8.0,9,24,15
194,ULK,P002968,P005216,4.667,1,9,8
194,ULK,P002968,P006961,9.383,12,29,17
194,ULK,P002968,P008104,5.133,9,20,11
194,ULK,P002968,P008962,6.45,9,22,13
194,ULK,P002968,P009783,1.767,-2,2,4
194,ULK,P002968,P010560,1.517,0,2,2
194,ULK,P002968,P011205,7.534,1,13,12
194,ULK,P004004,P005216,0.433,1,5,4
194,ULK,P004004,P006961,11.949,17,42,25
194,ULK,P004004,P007182,5.116,-6,6,12
194,ULK,P004004,P008104,10.433,2,27,25
194,ULK,P004004,P008962,21.249,14,59,45
194,ULK,P004004,P009783,9.349,0,24,24
194,ULK,P004004,P010560,3.417,2,8,6
194,ULK,P004004,P011205,12.799,13,39,26
194,ULK,P005216,P006961,5.75,3,11,8
194,ULK,P005216,P008962,1.5,0,2,2
194,ULK,P005216,P009783,0.85,-1,5,6
194,ULK,P005216,P011205,6.6,2,16,14
194,ULK,P006961,P007182,0.2,0,0,0
194,ULK,P006961,P008104,13.266,12,37,25
194,ULK,P006961,P008962,21.582,20,61,41
194,ULK,P006961,P009783,7.566,13,25,12
194,ULK,P006961,P011205,20.899,14,50,36
194,ULK,P007182,P008104,4.15,-9,4,13
194,ULK,P007182,P008962,5.816,-9,6,15
194,ULK,P007182,P009783,4.633,-4,6,10
194,ULK,P007182,P010560,1.183,-5,0,5
194,ULK,P007182,P011205,2.166,-3,2,5
194,ULK,P008104,P008962,20.633,-2,48,50
194,ULK,P008104,P009783,12.95,-2,28,30
194,ULK,P008104,P010560,0.5,-3,0,3
194,ULK,P008104,P011205,10.4,-4,21,25
194,ULK,P008962,P009783,15.416,4,38,34
194,ULK,P008962,P010560,3.917,-1,8,9
194,ULK,P008962,P011205,23.116,8,55,47
194,ULK,P009783,P011205,12.316,10,38,28
194,ULK,P010560,P011205,3.917,-1,8,9
194,ZAL,P002329,P002676,4.349,-9,4,13
194,ZAL,P002329,P003048,13.984,-15,31,46
194,ZAL,P002329,P003210,0.2,0,0,0
194,ZAL,P002329,P007029,0.2,0,0,0
194,ZAL,P002329,P007513,16.967,-20,26,46
194,ZAL,P002329,P007975,18.767,-13,42,55
194,ZAL,P002329,P011051,8.5,5,15,10
194,ZAL,P002329,P011983,6.567,-4,11,15
194,ZAL,P002329,P012622,10.317,-10,21,31
194,ZAL,P002329,P013403,19.017,-14,38,52
194,ZAL,P002676,P003048,0.5,2,2,0
194,ZAL,P002676,P005504,4.433,4,10,6
194,ZAL,P002676,P007513,13.883,-12,24,36
194,ZAL,P002676,P007975,17.5,-1,38,39
194,ZAL,P002676,P011051,12.467,3,30,27
194,ZAL,P002676,P011983,9.75,1,22,21
194,ZAL,P002676,P012622,5.25,6,17,11
194,ZAL,P002676,P013403,10.4,2,25,23
194,ZAL,P003048,P003210,0.2,0,0,0
194,ZAL,P003048,P007029,0.2,0,0,0
194,ZAL,P003048,P007513,7.634,-11,14,25
194,ZAL,P003048,P007975,11.201,-7,31,38
194,ZAL,P003048,P011983,5.717,-2,11,13
194,ZAL,P003048,P012622,8.167,-10,19,29
194,ZAL,P003048,P013403,9.401,-9,24,33
194,ZAL,P003210,P007029,0.2,0,0,0
194,ZAL,P003210,P013403,0.2,0,0,0
194,ZAL,P005504,P007513,4.433,4,10,6
194,ZAL,P005504,P007975,4.433,4,10,6
194,ZAL,P005504,P011983,4.433,4,10,6
194,ZAL,P007029,P013403,0.2,0,0,0
194,ZAL,P007513,P007975,20.734,-15,39,54
194,ZAL,P007513,P011051,13.567,-4,23,27
194,ZAL,P007513,P011983,11.267,-1,22,23
194,ZAL,P007513,P012622,6.383,-5,8,13
194,ZAL,P007513,P013403,16.6,-20,26,46
194,ZAL,P007975,P011051,14.801,7,35,28
194,ZAL,P007975,P011983,15.534,-3,33,36
194,ZAL,P007975,P012622,9.184,1,30,29
194,ZAL,P007975,P013403,18.518,3,50,47
194,ZAL,P011051,P011983,5.384,-5,12,17
194,ZAL,P011051,P012622,7.4,6,19,13
194,ZAL,P011051,P013403,14.217,16,34,18
194,ZAL,P011983,P012622,2.1,-8,5,13
194,ZAL,P011983,P013403,1.384,6,6,0
194,ZAL,P012622,P013403,13.467,4,33,29
195,MCO,P005844,P005985,5.65,-5,8,13
195,MCO,P005844,P008099,5.383,-8,8,16
195,MCO,P005844,P009754,0.983,-3,0,3
195,MCO,P005844,P011212,4.5,-5,7,12
195,MCO,P005844,P011226,6.383,-12,8,20
195,MCO,P005844,P011231,0.017,-1,0,1
195,MCO,P005844,P012515,2.616,-14,1,15
195,MCO,P005985,P008099,23.4,2,43,41
195,MCO,P005985,P009754,17.465,-1,26,27
195,MCO,P005985,P011212,14.416,0,27,27
195,MCO,P005985,P011226,19.466,-7,28,35
195,MCO,P005985,P011231,31.299,2,55,53
195,MCO,P005985,P012515,17.582,-13,24,37
195,MCO,P005985,P013365,1.766,0,2,2
195,MCO,P005985,PLCZ,23.616,6,43,37
195,MCO,P008099,P009754,3.217,3,7,4
195,MCO,P008099,P011212,18.016,-1,37,38
195,MCO,P008099,P011226,21.6,-7,39,46
195,MCO,P008099,P011231,22.617,8,48,40
195,MCO,P008099,P012515,9.917,-12,20,32
195,MCO,P008099,P013365,0.4,2,2,0
195,MCO,P008099,PLCZ,11.85,5,24,19
195,MCO,P009754,P011212,1.083,-1,2,3
195,MCO,P009754,P011226,3.499,2,5,3
195,MCO,P009754,P011231,16.399,4,28,24
195,MCO,P009754,P012515,12.515,-4,16,20
195,MCO,P009754,P013365,2.316,2,4,2
195,MCO,P009754,PLCZ,14.583,2,24,22
195,MCO,P011212,P011226,14.433,-7,28,35
195,MCO,P011212,P011231,14.616,2,35,33
195,MCO,P011212,P012515,6.383,-7,16,23
195,MCO,P011212,P013365,0.483,2,4,2
195,MCO,P011212,PLCZ,6.866,1,16,15
195,MCO,P011226,P011231,17.7,4,37,33
195,MCO,P011226,P012515,12.899,-16,24,40
195,MCO,P011226,P013365,1.666,4,6,2
195,MCO,P011226,PLCZ,5.55,3,9,6
195,MCO,P011231,P012515,20.266,-3,39,42
195,MCO,P011231,P013365,2.166,4,8,4
195,MCO,P011231,PLCZ,22.516,8,42,34
195,MCO,P012515,P013365,2.399,2,6,4
195,MCO,P012515,PLCZ,9.483,-1,14,15
195,RED,P004007,P004866,13.199,-3,25,28
195,RED,P004007,P006436,-4.217,0,2,2
195,RED,P004007,P007960,9.083,-9,15,24
195,RED,P004007,P009035,11.533,-4,25,29
195,RED,P004007,P009048,10.083,-3,22,25
195,RED,P004007,P010588,0.267,0,2,2
195,RED,P004007,P010612,12.566,0,22,22
195,RED,P004007,P011194,4.916,-5,7,12
195,RED,P004007,P012044,8.366,-12,8,20
195,RED,P004866,P006436,-0.634,1,6,5
195,RED,P004866,P007960,7.3,-6,10,16
195,RED,P004866,P009035,19.216,-3,28,31
195,RED,P004866,P009048,28.2,16,55,39
195,RED,P004866,P010612,30.033,18,50,32
195,RED,P004866,P011194,15.85,15,35,20
195,RED,P004866,P012044,27.1,10,43,33
195,RED,P006436,P007960,2.766,0,8,8
195,RED,P006436,P009035,-2.3,-9,4,13
195,RED,P006436,P009048,-1.2,-2,5,7
195,RED,P006436,P010588,2.034,-8,2,10
195,RED,P006436,P010612,7.5,-5,15,20
195,RED,P006436,P011194,7.533,2,14,12
195,RED,P006436,P012044,9.45,-7,16,23
195,RED,P007960,P009035,8.633,-9,14,23
195,RED,P007960,P009048,9.433,0,20,20
195,RED,P007960,P010612,8.032,-1,21,22
195,RED,P007960,P011194,5.499,5,17,12
195,RED,P007960,P012044,5.782,4,19,15
195,RED,P009035,P009048,20.283,-9,29,38
195,RED,P009035,P010588,2.034,-8,2,10
195,RED,P009035,P010612,17.5,0,24,24
195,RED,P009035,P012044,13.433,-14,10,24
195,RED,P009048,P010588,1.2,-5,0,5
195,RED,P009048,P010612,26.367,28,54,26
195,RED,P009048,P011194,12.317,26,38,12
195,RED,P009048,P012044,23.717,17,45,28
195,RED,P010588,P010612,0.834,-3,2,5
195,RED,P010588,P012044,1.767,-8,0,8
195,RED,P010612,P011194,21.266,17,51,34
195,RED,P010612,P012044,30.966,14,61,47
195,RED,P011194,P012044,22.283,20,54,34
196,BAS,P004058,P007579,4.867,-11,2,13
196,BAS,P004058,P011085,2.8,-4,2,6
196,BAS,P004058,P011196,5.417,3,13,10
196,BAS,P004058,P011948,2.8,-4,2,6
196,BAS,P004058,P012080,4.534,2,11,9
196,BAS,P004058,P012201,4.384,4,11,7
196,BAS,P004058,P012597,4.534,2,11,9
196,BAS,P007579,P011085,6.4,-11,8,19
196,BAS,P007579,P011196,7.8,-9,12,21
196,BAS,P007579,P011948,7.4,-7,12,19
196,BAS,P007579,P012080,3.317,-3,4,7
196,BAS,P007579,P012201,1.917,-5,0,5
196,BAS,P007579,P012597,3.617,-7,3,10
196,BAS,P007579,P013367,3.55,-3,7,10
196,BAS,P008072,P012080,9.917,2,18,16
196,BAS,P008072,P012201,9.917,2,18,16
196,BAS,P008072,P012597,9.917,2,18,16
196,BAS,P008072,P013367,9.917,2,18,16
196,BAS,P011085,P011196,12.6,-7,21,28
196,BAS,P011085,P011948,8.917,-9,12,21
196,BAS,P011085,P012080,3.683,2,9,7
196,BAS,P011085,P012201,6.2,4,13,9
196,BAS,P011085,P012597,7.25,4,16,12
196,BAS,P011085,P013367,2.55,-7,3,10
196,BAS,P011196,P011948,15.884,3,36,33
196,BAS,P011196,P012080,19.25,26,61,35
196,BAS,P011196,P012201,20.367,26,61,35
196,BAS,P011196,P012597,18.617,21,55,34
196,BAS,P011196,P013367,12.733,5,33,28
196,BAS,P011948,P012080,6.967,12,24,12
196,BAS,P011948,P012201,8.484,10,24,14
196,BAS,P011948,P012597,6.334,7,18,11
196,BAS,P011948,P013367,6.75,0,16,16
196,BAS,P012080,P012201,29.684,21,75,54
196,BAS,P012080,P012597,26.884,16,66,50
196,BAS,P012080,P013367,20.1,14,48,34
196,BAS,P012201,P012597,28.751,20,70,50
196,BAS,P012201,P013367,19.1,10,44,34
196,BAS,P012597,P013367,15.9,7,35,28
196,PAN,P001926,P004088,8.05,6,20,14
196,PAN,P001926,P005161,11.333,9,30,21
196,PAN,P001926,P005353,10.533,3,27,24
196,PAN,P001926,P009622,6.783,2,17,15
196,PAN,P001926,P011204,8.267,6,20,14
196,PAN,P001926,P011209,6.566,2,17,15
196,PAN,P001926,P012712,4.6,-2,9,11
196,PAN,P001926,P013383,3.2,6,8,2
196,PAN,P004088,P005161,5.25,5,13,8
196,PAN,P004088,P005353,16.717,-12,26,38
196,PAN,P004088,P009622,4.85,-5,6,11
196,PAN,P004088,P011204,15.084,-10,26,36
196,PAN,P004088,P012712,14.567,-18,19,37
196,PAN,P004088,P012774,11.65,-17,12,29
196,PAN,P004088,P013383,3.1,-1,6,7
196,PAN,P005161,P005353,8.0,3,21,18
196,PAN,P005161,P009622,10.484,0,26,26
196,PAN,P005161,P011204,6.284,2,15,13
196,PAN,P005161,P011209,10.267,0,26,26
196,PAN,P005161,P012712,5.234,-6,10,16
196,PAN,P005161,P012774,3.584,-1,7,8
196,PAN,P005161,P013383,2.5,8,8,0
196,PAN,P005353,P009622,11.6,-8,22,30
196,PAN,P005353,P011204,15.084,-10,26,36
196,PAN,P005353,P011209,9.85,-4,22,26
196,PAN,P005353,P012712,18.567,-19,27,46
196,PAN,P005353,P012774,15.917,-17,21,38
196,PAN,P009622,P011204,1.151,-5,2,7
196,PAN,P009622,P011209,19.967,-1,45,46
196,PAN,P009622,P012712,19.784,-12,35,47
196,PAN,P009622,P012774,17.317,-3,32,35
196,PAN,P009622,P013383,8.2,8,19,11
196,PAN,P011204,P011209,0.817,-3,2,5
196,PAN,P011204,P012712,10.868,-18,15,33
196,PAN,P011204,P012774,6.917,-14,6,20
196,PAN,P011209,P012712,14.717,-7,29,36
196,PAN,P011209,P012774,12.584,0,26,26
196,PAN,P011209,P013383,5.1,9,13,4
196,PAN,P012712,P012774,23.967,-18,37,55
196,PAN,P012712,P013383,5.7,0,11,11
196,PAN,P012774,P013383,5.0,2,11,9
197,MUN,P001557,P004508,7.566,10,14,4
197,MUN,P001557,P005460,0.8,1,2,1
197,MUN,P001557,P007056,18.6,16,47,31
197,MUN,P001557,P007201,18.083,3,37,34
197,MUN,P001557,P010391,15.466,6,30,24
197,MUN,P001557,P011224,5.817,8,19,11
197,MUN,P001557,P011987,18.8,12,47,35
197,MUN,P004508,P005460,9.551,-2,14,16
197,MUN,P004508,P007056,14.85,-9,23,32
197,MUN,P004508,P007201,15.2,-26,13,39
197,MUN,P004508,P007929,3.234,-10,2,12
197,MUN,P004508,P010391,11.866,-20,11,31
197,MUN,P004508,P011224,18.601,0,32,32
197,MUN,P004508,P011244,7.884,1,12,11
197,MUN,P004508,P011987,16.367,2,27,25
197,MUN,P004508,P012123,0.017,-2,0,2
197,MUN,P005460,P007201,0.867,-4,0,4
197,MUN,P005460,P007929,3.234,-10,2,12
197,MUN,P005460,P011224,9.551,-2,14,16
197,MUN,P005460,P011244,7.884,1,12,11
197,MUN,P005460,P011987,6.317,8,12,4
197,MUN,P007056,P007201,26.167,-15,48,63
197,MUN,P007056,P010391,21.083,-10,39,49
197,MUN,P007056,P011224,11.667,-1,25,26
197,MUN,P007056,P011987,21.884,1,50,49
197,MUN,P007056,P012123,0.017,-2,0,2
197,MUN,P007201,P007929,0.867,-4,0,4
197,MUN,P007201,P010391,22.966,-13,39,52
197,MUN,P007201,P011224,10.134,-15,15,30
197,MUN,P007201,P011987,21.367,-12,40,52
197,MUN,P007201,P012123,0.017,-2,0,2
197,MUN,P007929,P011224,3.234,-10,2,12
197,MUN,P007929,P011244,2.367,-6,2,8
197,MUN,P010391,P011224,4.183,-6,6,12
197,MUN,P010391,P011987,16.283,-7,31,38
197,MUN,P010391,P012123,0.017,-2,0,2
197,MUN,P011224,P011244,7.884,1,12,11
197,MUN,P011224,P011987,13.801,13,31,18
197,MUN,P011244,P011987,5.517,7,10,3
197,VIR,P001133,P001844,9.65,7,22,15
197,VIR,P001133,P002084,9.15,9,29,20
197,VIR,P001133,P005738,17.133,-7,32,39
197,VIR,P001133,P006739,22.668,4,52,48
197,VIR,P001133,P009549,21.916,6,57,51
197,VIR,P001133,P012585,16.266,13,41,28
197,VIR,P001133,P012591,8.933,-4,19,23
197,VIR,P001133,P013374,1.933,5,6,1
197,VIR,P001133,PBCN,4.883,3,10,7
197,VIR,P001844,P002084,11.983,1,18,17
197,VIR,P001844,P005738,3.85,-3,6,9
197,VIR,P001844,P006739,7.117,2,12,10
197,VIR,P001844,P009549,12.266,-2,20,22
197,VIR,P001844,P012585,16.149,6,28,22
197,VIR,P001844,P013374,10.049,1,14,13
197,VIR,P002084,P005738,0.083,-2,0,2
197,VIR,P002084,P006739,13.917,13,33,20
197,VIR,P002084,P009549,15.516,5,34,29
197,VIR,P002084,P012585,20.933,12,44,32
197,VIR,P002084,P012591,0.083,-2,0,2
197,VIR,P002084,P013374,11.866,1,15,14
197,VIR,P002084,PBCN,0.533,3,3,0
197,VIR,P005738,P006739,14.134,-4,26,30
197,VIR,P005738,P009549,14.783,-5,32,37
197,VIR,P005738,P012585,5.266,-3,6,9
197,VIR,P005738,P012591,8.933,-4,19,23
197,VIR,P005738,PBCN,4.35,0,7,7
197,VIR,P006739,P009549,20.201,6,49,43
197,VIR,P006739,P012585,16.267,11,33,22
197,VIR,P006739,P012591,8.85,-2,19,21
197,VIR,P006739,P013374,5.383,5,7,2
197,VIR,P006739,PBCN,3.667,1,5,4
197,VIR,P009549,P012585,20.282,11,46,35
197,VIR,P009549,P012591,8.933,-4,19,23
197,VIR,P009549,P013374,12.166,6,21,15
197,VIR,P009549,PBCN,2.533,5,10,5
197,VIR,P012585,P013374,13.799,6,21,15
197,VIR,P012585,PBCN,3.566,0,5,5
198,BAR,P000925,P002939,5.45,3,11,8
198,BAR,P000925,P003478,11.083,14,25,11
198,BAR,P000925,P007464,1.4,-3,5,8
198,BAR,P000925,P009862,10.499,4,23,19
198,BAR,P000925,P009992,8.183,3,21,18
198,BAR,P000925,P010106,10.299,12,23,11
198,BAR,P000925,P012745,10.366,6,23,17
198,BAR,P000925,P012795,4.533,3,9,6
198,BAR,P000925,P013379,6.783,6,16,10
198,BAR,P002939,P003478,14.867,-3,33,36
198,BAR,P002939,P006568,13.584,-2,34,36
198,BAR,P002939,P007464,2.25,4,9,5
198,BAR,P002939,P009862,13.751,-4,28,32
198,BAR,P002939,P009992,8.534,8,25,17
198,BAR,P002939,P010106,3.367,1,8,7
198,BAR,P002939,P012745,15.834,-4,32,36
198,BAR,P002939,P013379,3.367,1,8,7
198,BAR,P003478,P006568,9.4,-6,22,28
198,BAR,P003478,P007464,2.25,4,9,5
198,BAR,P003478,P009862,16.034,-2,31,33
198,BAR,P003478,P009992,6.6,8,18,10
198,BAR,P003478,P010106,7.75,9,16,7
198,BAR,P003478,P012745,16.917,-2,33,35
198,BAR,P003478,P013379,5.567,2,9,7
198,BAR,P006568,P007464,2.25,4,9,5
198,BAR,P006568,P009862,9.817,-2,22,24
198,BAR,P006568,P009992,8.85,13,28,15
198,BAR,P006568,P010106,3.7,6,11,5
198,BAR,P006568,P012745,10.7,-2,24,26
198,BAR,P006568,P013379,2.167,1,6,5
198,BAR,P007464,P009862,1.4,-3,5,8
198,BAR,P007464,P009992,6.583,1,20,19
198,BAR,P007464,P010106,2.933,0,6,6
198,BAR,P007464,P012745,1.4,-3,5,8
198,BAR,P007464,P012795,2.933,0,6,6
198,BAR,P007464,P013379,2.933,0,6,6
198,BAR,P009862,P009992,6.567,0,18,18
198,BAR,P009862,P010106,8.766,4,16,12
198,BAR,P009862,P012745,23.784,-1,49,50
198,BAR,P009862,P012795,1.333,-1,0,1
198,BAR,P009862,P013379,3.717,-7,4,11
198,BAR,P009992,P010106,16.083,9,37,28
198,BAR,P009992,P012745,8.517,2,22,20
198,BAR,P009992,P012795,6.133,4,15,11
198,BAR,P009992,P013379,14.55,4,32,28
198,BAR,P010106,P012745,9.833,6,18,12
198,BAR,P010106,P012795,7.466,3,15,12
198,BAR,P010106,P013379,16.667,2,34,32
198,BAR,P012745,P012795,1.333,-1,0,1
198,BAR,P012745,P013379,4.784,-5,6,11
198,BAR,P012795,P013379,6.133,4,15,11
198,IST,P004887,P006590,8.883,5,16,11
198,IST,P004887,P007109,7.2,7,21,14
198,IST,P004887,P007200,12.316,-3,22,25
198,IST,P004887,P009664,8.35,-9,12,21
198,IST,P004887,P009846,11.766,3,24,21
198,IST,P004887,P011078,17.083,-7,33,40
198,IST,P004887,P012710,2.717,3,5,2
198,IST,P004887,P012742,10.567,-5,17,22
198,IST,P004887,P013363,2.784,-2,5,7
198,IST,P004887,P013364,2.866,-4,1,5
198,IST,P006590,P007109,1.4,-1,8,9
198,IST,P006590,P007200,8.866,-3,19,22
198,IST,P006590,P009664,9.35,2,21,19
198,IST,P006590,P009846,9.15,-4,19,23
198,IST,P006590,P011078,8.217,2,19,17
198,IST,P006590,P012710,4.617,-1,13,14
198,IST,P006590,P012742,6.467,0,12,12
198,IST,P006590,P012788,8.217,-6,16,22
198,IST,P006590,P013363,4.3,1,11,10
198,IST,P006590,P013364,4.533,-3,6,9
198,IST,P007109,P007200,12.167,4,33,29
198,IST,P007109,P009846,13.1,1,34,33
198,IST,P007109,P011078,12.717,5,29,24
198,IST,P007109,P012710,6.267,-1,15,16
198,IST,P007109,P012742,1.95,0,4,4
198,IST,P007109,P013363,1.017,3,3,0
198,IST,P007109,P013364,0.65,-2,1,3
198,IST,P007200,P009664,2.666,-5,2,7
198,IST,P007200,P009846,23.984,-1,51,52
198,IST,P007200,P011078,16.117,-5,29,34
198,IST,P007200,P012710,12.001,2,27,25
198,IST,P007200,P012742,3.217,-3,5,8
198,IST,P007200,P012788,8.05,-2,16,18
198,IST,P007200,P013363,1.133,0,2,2
198,IST,P007200,P013364,6.083,-8,6,14
198,IST,P009664,P011078,11.517,-8,21,29
198,IST,P009664,P012742,8.35,-9,12,21
198,IST,P009664,P012788,4.3,1,11,10
198,IST,P009664,P013363,6.067,-4,13,17
198,IST,P009846,P011078,15.517,-3,30,33
198,IST,P009846,P012710,13.418,1,29,28
198,IST,P009846,P012742,4.034,-2,8,10
198,IST,P009846,P012788,7.634,-5,14,19
198,IST,P009846,P013364,6.733,-10,7,17
198,IST,P011078,P012710,7.134,0,11,11
198,IST,P011078,P012742,10.317,-9,16,25
198,IST,P011078,P012788,5.434,1,13,12
198,IST,P011078,P013363,5.951,-1,14,15
198,IST,P011078,P013364,2.2,-7,1,8
198,IST,P012710,P012742,3.084,1,7,6
198,IST,P012710,P012788,4.434,-1,9,10
198,IST,P012742,P012788,2.167,-1,5,6
198,IST,P012742,P013363,2.784,-2,5,7
198,IST,P012742,P013364,0.667,-2,1,3
198,IST,P012788,P013363,4.3,1,11,10
198,IST,P012788,P013364,3.2,-4,5,9
199,IST,P004887,P006590,3.75,3,12,9
199,IST,P004887,P007109,2.75,0,4,4
199,IST,P004887,P007200,15.8,17,35,18
199,IST,P004887,P009846,21.2,22,49,27
199,IST,P004887,P011078,22.033,27,54,27
199,IST,P004887,P012710,18.9,28,50,22
199,IST,P004887,P012742,0.683,-3,0,3
199,IST,P004887,P013363,4.216,6,12,6
199,IST,P006590,P007109,14.517,9,41,32
199,IST,P006590,P007200,0.417,0,2,2
199,IST,P006590,P009846,5.684,10,19,9
199,IST,P006590,P011078,4.467,2,14,12
199,IST,P006590,P012710,6.234,12,23,11
199,IST,P006590,P012742,16.501,17,52,35
199,IST,P006590,P012788,17.318,17,54,37
199,IST,P006590,P013363,15.384,10,47,37
199,IST,P007109,P007200,2.75,0,4,4
199,IST,P007109,P009846,4.25,4,8,4
199,IST,P007109,P011078,2.45,2,4,2
199,IST,P007109,P012742,14.217,11,41,30
199,IST,P007109,P012788,14.217,11,41,30
199,IST,P007109,P013363,12.717,7,37,30
199,IST,P007200,P009846,15.917,19,37,18
199,IST,P007200,P011078,15.5,19,35,16
199,IST,P007200,P012710,12.567,17,31,14
199,IST,P007200,P012742,0.6,2,2,0
199,IST,P007200,P012788,0.117,2,2,0
199,IST,P009846,P011078,21.25,26,51,25
199,IST,P009846,P012710,19.567,31,53,22
199,IST,P009846,P012742,3.75,7,12,5
199,IST,P009846,P012788,3.417,12,14,2
199,IST,P009846,P013363,3.433,5,9,4
199,IST,P011078,P012710,20.267,27,54,27
199,IST,P011078,P012742,0.683,-3,0,3
199,IST,P011078,P012788,1.367,-1,4,5
199,IST,P011078,P013363,5.583,5,16,11
199,IST,P012710,P012742,1.967,7,9,2
199,IST,P012710,P012788,3.334,6,13,7
199,IST,P012710,P013363,6.1,8,19,11
199,IST,P012742,P012788,16.301,20,52,32
199,IST,P012742,P013363,13.234,10,40,30
199,IST,P012788,P013363,14.601,9,44,35
199,MIL,P001518,P006085,13.083,-14,25,39
199,MIL,P001518,P006509,8.317,1,21,20
199,MIL,P001518,P006721,4.817,-1,14,15
199,MIL,P001518,P007831,7.484,-6,12,18
199,MIL,P001518,P008985,10.55,-15,18,33
199,MIL,P001518,P008987,3.566,-15,4,19
199,MIL,P001518,P011064,3.384,0,7,7
199,MIL,P001518,P011941,10.501,-2,19,21
199,MIL,P001518,P013384,13.834,-20,28,48
199,MIL,P005670,P006509,3.084,-3,4,7
199,MIL,P005670,P006721,4.967,-3,9,12
199,MIL,P005670,P007831,1.883,0,5,5
199,MIL,P005670,P008985,0.417,-2,0,2
199,MIL,P005670,P008987,1.883,0,5,5
199,MIL,P005670,P011941,3.084,-3,4,7
199,MIL,P005670,P013384,4.55,-1,9,10
199,MIL,P006085,P006509,9.45,-2,23,25
199,MIL,P006085,P006721,4.817,-1,14,15
199,MIL,P006085,P007831,3.9,-10,2,12
199,MIL,P006085,P008985,7.199,-14,11,25
199,MIL,P006085,P008987,6.916,-26,8,34
199,MIL,P006085,P011941,8.05,-9,11,20
199,MIL,P006085,P013384,12.317,-24,22,46
199,MIL,P006509,P006721,7.901,-4,18,22
199,MIL,P006509,P008985,4.533,-3,7,10
199,MIL,P006509,P008987,1.133,-3,2,5
199,MIL,P006509,P011941,7.717,-4,13,17
199,MIL,P006509,P013384,8.001,-2,20,22
199,MIL,P006721,P007831,1.883,0,5,5
199,MIL,P006721,P008985,1.85,1,5,4
199,MIL,P006721,P008987,3.316,3,10,7
199,MIL,P006721,P011064,1.433,3,5,2
199,MIL,P006721,P011941,3.084,-3,4,7
199,MIL,P006721,P013384,10.8,1,28,27
199,MIL,P007831,P008985,14.351,-16,18,34
199,MIL,P007831,P008987,15.95,-25,18,43
199,MIL,P007831,P011064,14.751,-15,18,33
199,MIL,P007831,P011941,20.585,-27,25,52
199,MIL,P007831,P013384,11.017,-17,17,34
199,MIL,P008985,P008987,15.516,-25,20,45
199,MIL,P008985,P011064,13.367,-9,18,27
199,MIL,P008985,P011941,18.884,-19,25,44
199,MIL,P008985,P013384,6.933,-14,14,28
199,MIL,P008987,P011064,12.8,-12,16,28
199,MIL,P008987,P011941,14.717,-26,15,41
199,MIL,P008987,P013384,10.599,-23,18,41
199,MIL,P011064,P011941,14.751,-15,18,33
199,MIL,P011064,P013384,4.25,0,10,10
199,MIL,P011941,P013384,11.835,-16,18,34
200,PAN,P001926,P004088,9.616,24,31,7
200,PAN,P001926,P005161,2.483,-2,4,6
200,PAN,P001926,P007866,2.483,-2,4,6
200,PAN,P001926,P009622,2.483,0,5,5
200,PAN,P001926,P011204,10.983,9,28,19
200,PAN,P001926,P011209,4.583,7,13,6
200,PAN,P001926,P012712,15.2,35,50,15
200,PAN,P001926,P012774,15.15,26,46,20
200,PAN,P001926,P013383,17.683,35,55,20
200,PAN,P004088,P005161,0.217,-2,1,3
200,PAN,P004088,P007866,3.467,-7,4,11
200,PAN,P004088,P009622,3.066,-2,5,7
200,PAN,P004088,P011204,13.25,-17,18,35
200,PAN,P004088,P011209,6.967,7,13,6
200,PAN,P004088,P011442,0.917,-2,0,2
200,PAN,P004088,P012712,19.15,11,43,32
200,PAN,P004088,P012774,14.45,2,36,34
200,PAN,P004088,P013383,18.632,14,45,31
200,PAN,P005161,P007866,2.7,-4,5,9
200,PAN,P005161,P011204,4.717,-3,9,12
200,PAN,P005161,P011209,3.65,0,7,7
200,PAN,P005161,P012774,3.084,-2,6,8
200,PAN,P005161,P013383,2.017,1,4,3
200,PAN,P007866,P009622,0.583,-2,0,2
200,PAN,P007866,P011204,5.95,-9,8,17
200,PAN,P007866,P011209,1.633,-1,3,4
200,PAN,P007866,P012712,2.667,-3,3,6
200,PAN,P007866,P012774,3.734,-6,5,11
200,PAN,P007866,P013383,0.583,-2,0,2
200,PAN,P009622,P011204,0.583,-2,0,2
200,PAN,P009622,P012774,2.483,0,5,5
200,PAN,P009622,P013383,3.066,-2,5,7
200,PAN,P011204,P011209,12.667,-5,18,23
200,PAN,P011204,P011442,0.917,-2,0,2
200,PAN,P011204,P012712,25.517,-6,49,55
200,PAN,P011204,P012774,24.151,-7,52,59
200,PAN,P011204,P013383,24.533,-2,50,52
200,PAN,P011209,P011442,0.917,-2,0,2
200,PAN,P011209,P012712,11.967,3,21,18
200,PAN,P011209,P012774,7.017,-3,12,15
200,PAN,P011209,P013383,13.067,6,25,19
200,PAN,P011442,P012712,0.917,-2,0,2
200,PAN,P012712,P012774,24.817,11,62,51
200,PAN,P012712,P013383,28.633,23,72,49
200,PAN,P012774,P013383,26.65,15,68,53
200,ZAL,P002329,P002676,0.8,-3,0,3
200,ZAL,P002329,P003048,8.932,10,25,15
200,ZAL,P002329,P005504,6.216,-11,9,20
200,ZAL,P002329,P007029,10.632,-1,23,24
200,ZAL,P002329,P007513,9.982,-1,20,21
200,ZAL,P002329,P007975,8.85,-7,18,25
200,ZAL,P002329,P011983,1.866,-1,3,4
200,ZAL,P002329,P012622,9.616,-5,19,24
200,ZAL,P002329,P013403,10.966,-13,19,32
200,ZAL,P002676,P003048,4.833,3,11,8
200,ZAL,P002676,P005504,15.183,-7,27,34
200,ZAL,P002676,P007029,8.7,-6,13,19
200,ZAL,P002676,P007513,12.6,3,25,22
200,ZAL,P002676,P007975,8.666,-12,13,25
200,ZAL,P002676,P012622,12.266,3,27,24
200,ZAL,P002676,P012715,2.083,3,7,4
200,ZAL,P002676,P013403,14.933,0,29,29
200,ZAL,P003048,P007029,10.815,11,28,17
200,ZAL,P003048,P007513,9.232,9,22,13
200,ZAL,P003048,P007975,4.983,2,14,12
200,ZAL,P003048,P011983,0.183,0,0,0
200,ZAL,P003048,P012622,8.949,20,30,10
200,ZAL,P003048,P013403,3.933,9,14,5
200,ZAL,P005504,P007029,6.766,-12,8,20
200,ZAL,P005504,P007513,15.733,-6,27,33
200,ZAL,P005504,P007975,14.299,-16,21,37
200,ZAL,P005504,P011983,1.683,-1,3,4
200,ZAL,P005504,P012622,11.982,-19,16,35
200,ZAL,P005504,P012715,5.033,3,11,8
200,ZAL,P005504,P013403,23.965,-19,38,57
200,ZAL,P007029,P007513,13.815,-1,26,27
200,ZAL,P007029,P007975,6.833,-12,10,22
200,ZAL,P007029,P011983,0.183,0,0,0
200,ZAL,P007029,P012622,10.732,1,24,23
200,ZAL,P007029,P013403,9.116,-12,12,24
200,ZAL,P007513,P007975,6.067,-5,8,13
200,ZAL,P007513,P011983,1.866,-1,3,4
200,ZAL,P007513,P012622,10.949,9,26,17
200,ZAL,P007513,P012715,2.95,0,4,4
200,ZAL,P007513,P013403,17.466,5,35,30
200,ZAL,P007975,P012622,11.799,-15,20,35
200,ZAL,P007975,P012715,5.033,3,11,8
200,ZAL,P007975,P013403,17.066,-22,25,47
200,ZAL,P011983,P013403,1.683,-1,3,4
200,ZAL,P012622,P013403,14.699,-18,22,40
200,ZAL,P012715,P013403,5.033,3,11,8
201,MCO,P001932,P004790,0.033,0,0,0
201,MCO,P001932,P005844,11.066,4,25,21
201,MCO,P001932,P005985,20.617,-7,41,48
201,MCO,P001932,P008099,14.867,-9,28,37
201,MCO,P001932,P011226,11.717,-19,13,32
201,MCO,P001932,P011231,16.334,-1,36,37
201,MCO,P001932,P012515,4.767,-3,9,12
201,MCO,P001932,PLCZ,10.535,-17,12,29
201,MCO,P004790,P005844,10.183,9,25,16
201,MCO,P004790,P005985,9.683,9,25,16
201,MCO,P004790,P008099,10.283,9,25,16
201,MCO,P004790,P008161,10.25,9,25,16
201,MCO,P004790,P011226,0.6,0,0,0
201,MCO,P004790,PLCZ,0.1,0,0,0
201,MCO,P005844,P005985,23.499,23,58,35
201,MCO,P005844,P008099,24.516,17,57,40
201,MCO,P005844,P008161,11.9,8,27,19
201,MCO,P005844,P011226,8.516,-1,13,14
201,MCO,P005844,P011231,8.633,16,26,10
201,MCO,P005844,P012515,1.283,-4,1,5
201,MCO,P005985,P008099,27.849,14,69,55
201,MCO,P005985,P008161,11.883,11,30,19
201,MCO,P005985,P011226,14.566,-8,26,34
201,MCO,P005985,P011231,19.783,8,50,42
201,MCO,P005985,P012515,2.9,3,9,6
201,MCO,P005985,PLCZ,11.084,-13,20,33
201,MCO,P008099,P008161,14.55,13,34,21
201,MCO,P008099,P011226,14.0,-6,25,31
201,MCO,P008099,P011231,14.616,15,42,27
201,MCO,P008099,P012515,1.867,-6,0,6
201,MCO,P008099,PLCZ,6.984,-7,12,19
201,MCO,P008161,P011226,4.417,1,6,5
201,MCO,P008161,P011231,2.55,5,7,2
201,MCO,P008161,PLCZ,2.65,5,7,2
201,MCO,P011226,P011231,10.633,1,23,22
201,MCO,P011226,P012515,2.25,-5,1,6
201,MCO,P011226,PLCZ,9.701,-11,13,24
201,MCO,P011231,P012515,2.517,2,8,6
201,MCO,P011231,PLCZ,12.334,-6,24,30
201,MCO,P012515,PLCZ,3.484,1,8,7
201,VIR,P001133,P001844,8.833,1,22,21
201,VIR,P001133,P002084,7.767,-5,11,16
201,VIR,P001133,P005738,7.566,-7,10,17
201,VIR,P001133,P006739,22.483,-4,43,47
201,VIR,P001133,P009549,13.75,-6,27,33
201,VIR,P001133,P012585,12.866,-7,20,27
201,VIR,P001133,P012591,9.867,1,17,16
201,VIR,P001133,P013374,4.45,4,10,6
201,VIR,P001133,PBCN,9.95,-5,20,25
201,VIR,P001844,P002084,3.417,2,7,5
201,VIR,P001844,P005738,8.733,0,13,13
201,VIR,P001844,P006739,11.0,11,31,20
201,VIR,P001844,P009549,9.267,-4,17,21
201,VIR,P001844,P012585,11.266,17,31,14
201,VIR,P001844,P012591,8.333,10,23,13
201,VIR,P001844,P013374,8.8,11,20,9
201,VIR,P001844,PBCN,0.883,0,4,4
201,VIR,P002084,P006739,11.35,-11,19,30
201,VIR,P002084,P009549,7.517,-6,14,20
201,VIR,P002084,P012585,7.416,-5,10,15
201,VIR,P002084,P012591,6.783,1,14,13
201,VIR,P002084,P013374,6.233,-4,13,17
201,VIR,P002084,PBCN,5.517,-8,8,16
201,VIR,P005738,P006739,11.716,-9,18,27
201,VIR,P005738,P009549,8.633,-6,12,18
201,VIR,P005738,P012585,10.449,-6,18,24
201,VIR,P005738,P012591,4.316,-6,7,13
201,VIR,P005738,P013374,4.9,1,7,6
201,VIR,P005738,PBCN,6.483,-7,11,18
201,VIR,P006739,P009549,18.25,-10,36,46
201,VIR,P006739,P012585,15.449,0,33,33
201,VIR,P006739,P012591,15.383,5,37,32
201,VIR,P006739,P013374,12.1,5,29,24
201,VIR,P006739,PBCN,15.733,-15,30,45
201,VIR,P009549,P012585,5.399,-6,6,12
201,VIR,P009549,P012591,4.184,0,10,10
201,VIR,P009549,P013374,13.15,-1,25,26
201,VIR,P009549,PBCN,9.65,-5,21,26
201,VIR,P012585,P012591,12.766,9,32,23
201,VIR,P012585,P013374,5.766,12,17,5
201,VIR,P012585,PBCN,6.083,-10,9,19
201,VIR,P012591,P013374,6.9,13,21,8
201,VIR,P012591,PBCN,3.6,-5,7,12
201,VIR,P013374,PBCN,5.033,-5,10,15
203,RED,P002553,P004866,0.917,-2,0,2
203,RED,P002553,P006436,3.617,2,10,8
203,RED,P002553,P010588,1.617,0,2,2
203,RED,P002553,P010612,1.617,0,2,2
203,RED,P002553,P011194,2.917,0,8,8
203,RED,P002553,P012044,2.917,0,8,8
203,RED,P002553,PJDR,4.534,0,10,10
203,RED,P004007,P004866,7.366,-3,14,17
203,RED,P004007,P007960,1.55,-2,0,2
203,RED,P004007,P009035,7.683,-3,14,17
203,RED,P004007,P009048,8.116,-3,14,17
203,RED,P004007,P010588,7.966,-3,14,17
203,RED,P004007,P010612,3.283,-4,0,4
203,RED,P004007,P011194,1.0,0,0,0
203,RED,P004007,P012044,1.7,-2,0,2
203,RED,P004866,P006436,1.433,-2,2,4
203,RED,P004866,P007960,3.733,-4,4,8
203,RED,P004866,P009035,14.434,-1,30,31
203,RED,P004866,P009048,19.101,-5,40,45
203,RED,P004866,P010588,17.518,-7,34,41
203,RED,P004866,P010612,9.901,-5,14,19
203,RED,P004866,P011194,12.351,2,26,24
203,RED,P004866,P012044,5.317,-1,8,9
203,RED,P004866,PJDR,10.201,-4,20,24
203,RED,P006436,P007960,4.417,-9,2,11
203,RED,P006436,P009035,0.85,0,0,0
203,RED,P006436,P010588,0.7,2,2,0
203,RED,P006436,P010612,5.117,-7,4,11
203,RED,P006436,P011194,5.284,-7,8,15
203,RED,P006436,P012044,7.101,-9,10,19
203,RED,P006436,PJDR,3.617,2,10,8
203,RED,P007960,P009035,1.417,0,0,0
203,RED,P007960,P010612,7.284,-11,4,15
203,RED,P007960,P011194,3.684,-7,2,9
203,RED,P007960,P012044,7.051,-11,4,15
203,RED,P009035,P009048,14.717,-9,28,37
203,RED,P009035,P010588,12.367,-3,26,29
203,RED,P009035,P010612,9.434,-1,14,15
203,RED,P009035,P011194,6.517,0,12,12
203,RED,P009035,P012044,5.651,6,10,4
203,RED,P009035,PJDR,8.734,-1,18,19
203,RED,P009048,P010588,16.367,-10,30,40
203,RED,P009048,P010612,5.767,-7,8,15
203,RED,P009048,P011194,11.634,-1,26,27
203,RED,P009048,P012044,0.15,0,0,0
203,RED,P009048,PJDR,9.884,-5,22,27
203,RED,P010588,P010612,11.784,5,25,20
203,RED,P010588,P011194,9.15,2,21,19
203,RED,P010588,P012044,5.15,9,17,8
203,RED,P010588,PJDR,9.917,1,25,24
203,RED,P010612,P011194,10.384,-7,15,22
203,RED,P010612,P012044,13.951,-2,21,23
203,RED,P010612,PJDR,7.15,3,17,14
203,RED,P011194,P012044,10.634,-4,17,21
203,RED,P011194,PJDR,15.517,2,37,35
203,RED,P012044,PJDR,7.85,6,21,15
203,TEL,P005145,P006835,1.583,2,2,0
203,TEL,P005145,P007519,1.733,2,2,0
203,TEL,P005145,P007990,0.15,0,0,0
203,TEL,P005145,P011193,1.583,2,2,0
203,TEL,P005145,P011214,1.733,2,2,0
203,TEL,P005145,P013381,0.15,0,0,0
203,TEL,P006835,P007519,27.602,5,58,53
203,TEL,P006835,P007990,13.868,-4,26,30
203,TEL,P006835,P011193,26.668,6,53,47
203,TEL,P006835,P011202,2.2,-3,4,7
203,TEL,P006835,P011214,14.067,10,30,20
203,TEL,P006835,P011219,16.568,-4,36,40
203,TEL,P006835,P013381,2.684,-2,4,6
203,TEL,P006835,P013382,22.368,6,51,45
203,TEL,P007519,P007990,14.684,1,31,30
203,TEL,P007519,P011193,22.984,7,45,38
203,TEL,P007519,P011202,3.333,-6,7,13
203,TEL,P007519,P011214,16.117,16,37,21
203,TEL,P007519,P011219,15.334,-5,34,39
203,TEL,P007519,P012604,4.733,4,13,9
203,TEL,P007519,P013381,6.051,5,14,9
203,TEL,P007519,P013382,18.301,7,43,36
203,TEL,P007990,P011193,12.234,2,19,17
203,TEL,P007990,P011202,5.417,-4,9,13
203,TEL,P007990,P011214,13.3,12,28,16
203,TEL,P007990,P011219,7.401,-6,17,23
203,TEL,P007990,P012604,7.717,8,19,11
203,TEL,P007990,P013381,4.684,5,12,7
203,TEL,P007990,P013382,8.417,2,19,17
203,TEL,P011193,P011202,2.084,2,2,0
203,TEL,P011193,P011214,13.733,14,27,13
203,TEL,P011193,P011219,15.268,-2,32,34
203,TEL,P011193,P012604,3.367,4,6,2
203,TEL,P011193,P013381,1.367,0,2,2
203,TEL,P011193,P013382,21.784,5,48,43
203,TEL,P011202,P011214,1.85,1,2,1
203,TEL,P011202,P011219,3.567,-5,7,12
203,TEL,P011202,P012604,3.217,-1,5,6
203,TEL,P011214,P012604,6.017,11,16,5
203,TEL,P011214,P013381,6.051,5,14,9
203,TEL,P011214,P013382,9.0,13,28,15
203,TEL,P011219,P012604,1.7,-3,3,6
203,TEL,P011219,P013382,13.234,-3,27,30
203,TEL,P012604,P013381,3.217,7,10,3
203,TEL,P012604,P013382,0.9,2,4,2
207,PAR,P006760,P007736,9.3,21,28,7
207,PAR,P006760,P007870,12.1,9,28,19
207,PAR,P006760,P010781,24.966,4,62,58
207,PAR,P006760,P011050,2.383,-6,4,10
207,PAR,P006760,P011981,15.233,7,42,35
207,PAR,P006760,P012720,24.283,0,57,57
207,PAR,P006760,P013369,22.799,13,63,50
207,PAR,P007736,P007870,9.617,9,26,17
207,PAR,P007736,P008232,6.049,-7,6,13
207,PAR,P007736,P010781,15.483,2,32,30
207,PAR,P007736,P011981,12.666,-3,22,25
207,PAR,P007736,P012720,8.433,5,14,9
207,PAR,P007736,P013369,13.716,13,36,23
207,PAR,P007870,P010781,15.567,5,35,30
207,PAR,P007870,P011981,5.417,-6,10,16
207,PAR,P007870,P012720,8.617,-3,14,17
207,PAR,P007870,P013369,10.95,6,27,21
207,PAR,P008232,P010781,8.233,-2,14,16
207,PAR,P008232,P011981,8.766,-2,14,16
207,PAR,P008232,P012720,5.333,1,8,7
207,PAR,P008232,P013369,6.683,2,14,12
207,PAR,P010781,P011050,2.383,-6,4,10
207,PAR,P010781,P011981,24.133,-7,54,61
207,PAR,P010781,P012720,26.283,-7,56,63
207,PAR,P010781,P013369,29.616,3,75,72
207,PAR,P011050,P012720,2.383,-6,4,10
207,PAR,P011050,P013369,2.383,-6,4,10
207,PAR,P011981,P012720,20.566,8,50,42
207,PAR,P011981,P013369,23.083,7,60,53
207,PAR,P012720,P013369,22.566,6,57,51
207,PRS,P004197,P004512,5.033,-2,8,10
207,PRS,P004197,P005793,6.033,-10,13,23
207,PRS,P004197,P007032,12.8,-9,25,34
207,PRS,P004197,P012608,3.534,1,8,7
207,PRS,P004197,P012609,2.767,-2,5,7
207,PRS,P004197,P012610,3.534,1,8,7
207,PRS,P004197,P012612,2.667,-1,4,5
207,PRS,P004197,P012613,3.534,1,8,7
207,PRS,P004197,P012640,13.567,-6,28,34
207,PRS,P004197,P013373,11.867,-5,25,30
207,PRS,P004512,P005793,0.933,-4,0,4
207,PRS,P004512,P007032,5.033,-2,8,10
207,PRS,P004512,P012608,5.1,0,12,12
207,PRS,P004512,P012610,5.1,0,12,12
207,PRS,P004512,P012613,5.1,0,12,12
207,PRS,P004512,P012640,10.133,-2,20,22
207,PRS,P004512,P013373,4.1,2,8,6
207,PRS,P005793,P007032,6.033,-10,13,23
207,PRS,P005793,P012640,6.033,-10,13,23
207,PRS,P005793,P013373,5.1,-6,13,19
207,PRS,P007032,P010390,2.717,-4,5,9
207,PRS,P007032,P012608,3.517,-4,7,11
207,PRS,P007032,P012609,0.55,2,2,0
207,PRS,P007032,P012610,3.517,-4,7,11
207,PRS,P007032,P012612,2.667,-1,4,5
207,PRS,P007032,P012613,3.517,-4,7,11
207,PRS,P007032,P012640,12.8,-9,25,34
207,PRS,P007032,P013373,12.117,-7,25,32
207,PRS,P010390,P012608,16.034,1,34,33
207,PRS,P010390,P012609,11.4,5,27,22
207,PRS,P010390,P012610,16.034,1,34,33
207,PRS,P010390,P012613,16.034,1,34,33
207,PRS,P010390,P012640,1.917,0,2,2
207,PRS,P012608,P012609,16.45,6,39,33
207,PRS,P012608,P012610,27.201,3,61,58
207,PRS,P012608,P012613,27.201,3,61,58
207,PRS,P012608,P012640,9.517,4,22,18
207,PRS,P012608,P013373,0.25,-2,0,2
207,PRS,P012609,P012610,16.45,6,39,33
207,PRS,P012609,P012613,16.45,6,39,33
207,PRS,P012609,P012640,1.733,1,5,4
207,PRS,P012610,P012613,27.201,3,61,58
207,PRS,P012610,P012640,9.517,4,22,18
207,PRS,P012610,P013373,0.25,-2,0,2
207,PRS,P012612,P012640,2.667,-1,4,5
207,PRS,P012612,P013373,2.667,-1,4,5
207,PRS,P012613,P012640,9.517,4,22,18
207,PRS,P012613,P013373,0.25,-2,0,2
207,PRS,P012640,P013373,11.867,-5,25,30
202,BAS,P004058,P007579,5.433,-4,7,11
202,BAS,P004058,P011085,9.3,-8,14,22
202,BAS,P004058,P011196,9.3,-8,14,22
202,BAS,P004058,P012201,3.867,-4,7,11
202,BAS,P004058,P012597,6.017,-9,9,18
202,BAS,P004058,P013367,3.283,1,5,4
202,BAS,P007579,P008072,0.9,1,3,2
202,BAS,P007579,P008850,1.4,3,5,2
202,BAS,P007579,P011085,14.5,-4,27,31
202,BAS,P007579,P011196,6.434,-4,9,13
202,BAS,P007579,P011948,3.317,0,7,7
202,BAS,P007579,P012201,8.617,2,20,18
202,BAS,P007579,P012597,9.317,-2,20,22
202,BAS,P007579,P013367,13.75,4,30,26
202,BAS,P008072,P008850,12.883,-5,27,32
202,BAS,P008072,P011196,0.017,0,0,0
202,BAS,P008072,P011948,3.866,2,12,10
202,BAS,P008072,P012201,12.017,-6,24,30
202,BAS,P008072,P012597,9.034,-7,15,22
202,BAS,P008072,P013367,12.883,-5,27,32
202,BAS,P008850,P011196,0.667,0,2,2
202,BAS,P008850,P011948,4.533,2,14,12
202,BAS,P008850,P012201,12.15,-8,24,32
202,BAS,P008850,P012597,9.017,-7,15,22
202,BAS,P008850,P013367,13.55,-5,29,34
202,BAS,P011085,P011196,17.833,2,40,38
202,BAS,P011085,P011948,6.533,3,14,11
202,BAS,P011085,P012201,20.533,10,53,43
202,BAS,P011085,P012597,17.35,0,43,43
202,BAS,P011085,P013367,19.683,13,49,36
202,BAS,P011196,P011948,5.75,4,14,10
202,BAS,P011196,P012201,12.1,6,33,27
202,BAS,P011196,P012597,10.217,-3,25,28
202,BAS,P011196,P013367,11.75,11,31,20
202,BAS,P011948,P012201,9.199,4,23,19
202,BAS,P011948,P012597,0.733,0,2,2
202,BAS,P011948,P013367,10.333,5,26,21
202,BAS,P012201,P012597,24.234,-2,56,58
202,BAS,P012201,P013367,28.083,6,68,62
202,BAS,P012597,P013367,19.617,2,47,45
202,MAD,P003108,P003583,0.767,-4,0,4
202,MAD,P003108,P003733,14.883,5,35,30
202,MAD,P003108,P005791,11.25,2,26,24
202,MAD,P003108,P005928,16.283,-3,36,39
202,MAD,P003108,P006540,16.983,-1,38,39
202,MAD,P003108,P007630,12.466,0,25,25
202,MAD,P003108,P011247,8.2,1,15,14
202,MAD,P003108,P011649,2.517,-5,2,7
202,MAD,P003108,P013378,7.083,-2,14,16
202,MAD,P003108,PTGB,7.5,-1,13,14
202,MAD,P003583,P005928,3.25,-3,7,10
202,MAD,P003583,P009213,3.25,-3,7,10
202,MAD,P003583,P011247,1.95,-5,2,7
202,MAD,P003583,P011649,4.017,-7,7,14
202,MAD,P003583,PTGB,2.834,-6,5,11
202,MAD,P003733,P005791,10.8,9,29,20
202,MAD,P003733,P005928,15.833,4,39,35
202,MAD,P003733,P006540,16.533,6,41,35
202,MAD,P003733,P007630,16.049,5,37,32
202,MAD,P003733,P009213,1.3,1,3,2
202,MAD,P003733,P011247,5.683,6,13,7
202,MAD,P003733,PTGB,4.983,4,11,7
202,MAD,P005791,P005928,23.516,8,58,50
202,MAD,P005791,P006540,23.516,8,58,50
202,MAD,P005791,P007630,5.333,4,14,10
202,MAD,P005791,P009213,6.933,2,18,16
202,MAD,P005791,P013378,12.716,-1,29,30
202,MAD,P005928,P006540,28.549,3,68,65
202,MAD,P005928,P007630,10.366,-1,24,25
202,MAD,P005928,P009213,10.183,-1,25,26
202,MAD,P005928,P011247,1.183,-1,2,3
202,MAD,P005928,P011649,3.25,-3,7,10
202,MAD,P005928,P013378,12.716,-1,29,30
202,MAD,P005928,PTGB,2.067,-2,5,7
202,MAD,P006540,P007630,11.066,1,26,25
202,MAD,P006540,P009213,6.933,2,18,16
202,MAD,P006540,P011247,0.7,2,2,0
202,MAD,P006540,P013378,12.716,-1,29,30
202,MAD,P007630,P011247,7.433,5,15,10
202,MAD,P007630,P011649,1.75,-1,2,3
202,MAD,P007630,PTGB,6.733,3,13,10
202,MAD,P009213,P011247,1.183,-1,2,3
202,MAD,P009213,P011649,3.25,-3,7,10
202,MAD,P009213,P013378,5.633,1,15,14
202,MAD,P009213,PTGB,2.067,-2,5,7
202,MAD,P011247,P011649,3.7,-6,4,10
202,MAD,P011247,PTGB,7.5,-1,13,14
202,MAD,P011649,PTGB,4.584,-7,7,14
204,BER,P006251,P007025,0.767,-3,2,5
204,BER,P006251,P008062,16.917,-9,28,37
204,BER,P006251,P008173,8.0,-4,18,22
204,BER,P006251,P008211,20.0,-16,31,47
204,BER,P006251,P008384,4.917,3,15,12
204,BER,P006251,P008967,24.15,-10,44,54
204,BER,P006251,P011934,5.084,1,13,12
204,BER,P006251,P013386,19.833,-14,33,47
204,BER,P006919,P007025,9.033,5,27,22
204,BER,P006919,P008062,6.767,1,20,19
204,BER,P006919,P008173,8.316,-3,18,21
204,BER,P006919,P008211,1.8,-1,2,3
204,BER,P006919,P008384,13.283,-1,36,37
204,BER,P006919,P008967,6.05,-7,11,18
204,BER,P006919,P011934,11.5,-3,32,35
204,BER,P006919,P013386,3.583,1,6,5
204,BER,P007025,P008062,6.067,3,20,17
204,BER,P007025,P008173,3.733,-1,9,10
204,BER,P007025,P008211,0.767,-3,2,5
204,BER,P007025,P008384,9.033,5,27,22
204,BER,P007025,P011934,7.25,3,23,20
204,BER,P007025,P013386,2.55,-1,6,7
204,BER,P008062,P008211,13.317,-9,20,29
204,BER,P008062,P008384,10.367,1,28,27
204,BER,P008062,P008967,17.617,-11,28,39
204,BER,P008062,P011934,6.601,-1,18,19
204,BER,P008062,P013386,17.083,-7,30,37
204,BER,P008173,P008211,8.483,-8,13,21
204,BER,P008173,P008384,7.833,1,23,22
204,BER,P008173,P008967,12.583,-6,27,33
204,BER,P008173,P011934,9.983,-1,27,28
204,BER,P008173,P013386,6.333,-6,9,15
204,BER,P008211,P008967,21.033,-14,31,45
204,BER,P008211,P011934,2.15,-2,4,6
204,BER,P008211,P013386,19.65,-15,29,44
204,BER,P008384,P008967,9.167,-3,24,27
204,BER,P008384,P011934,14.434,0,41,41
204,BER,P008384,P013386,3.766,2,10,8
204,BER,P008967,P011934,9.334,-5,22,27
204,BER,P008967,P013386,20.866,-12,33,45
204,MUN,P001288,P001557,3.267,7,14,7
204,MUN,P001288,P004508,13.916,-10,29,39
204,MUN,P001288,P007056,13.683,6,31,25
204,MUN,P001288,P007201,9.633,-15,17,32
204,MUN,P001288,P010391,14.567,5,34,29
204,MUN,P001288,P011244,9.383,-5,16,21
204,MUN,P001288,P011987,17.167,1,39,38
204,MUN,P001288,P012123,5.233,-2,11,13
204,MUN,P001288,P013368,4.283,-3,13,16
204,MUN,P001557,P004508,9.317,10,26,16
204,MUN,P001557,P007056,17.55,27,51,24
204,MUN,P001557,P007201,8.451,7,28,21
204,MUN,P001557,P010391,14.967,18,45,27
204,MUN,P001557,P011244,7.9,9,22,13
204,MUN,P001557,P011987,20.484,26,62,36
204,MUN,P004508,P007056,15.75,10,40,30
204,MUN,P004508,P007201,13.533,-7,29,36
204,MUN,P004508,P010391,9.5,1,21,20
204,MUN,P004508,P011244,3.783,-4,8,12
204,MUN,P004508,P011987,17.617,5,43,38
204,MUN,P004508,P012123,5.233,-2,11,13
204,MUN,P004508,P013368,4.283,-3,13,16
204,MUN,P007056,P007201,6.817,6,19,13
204,MUN,P007056,P010391,22.766,20,54,34
204,MUN,P007056,P011244,13.616,10,30,20
204,MUN,P007056,P011987,28.15,25,67,42
204,MUN,P007201,P010391,3.501,-4,11,15
204,MUN,P007201,P011244,3.667,-6,8,14
204,MUN,P007201,P011987,12.284,-2,34,36
204,MUN,P007201,P012123,4.466,-5,6,11
204,MUN,P007201,P013368,3.516,-6,8,14
204,MUN,P010391,P011244,15.5,6,36,30
204,MUN,P010391,P011987,24.267,18,59,41
204,MUN,P011244,P011987,13.5,8,30,22
204,MUN,P011244,P012123,1.783,-2,2,4
204,MUN,P011987,P012123,1.617,1,5,4
204,MUN,P011987,P013368,2.45,-2,9,11
204,MUN,P012123,P013368,2.6,2,9,7
205,ASV,P000229,P002100,5.766,-8,9,17
205,ASV,P000229,P004194,7.4,-5,16,21
205,ASV,P000229,P007027,3.734,-2,9,11
205,ASV,P000229,P008991,2.866,2,7,5
205,ASV,P000229,P009818,0.783,-1,2,3
205,ASV,P000229,P010545,1.2,-2,0,2
205,ASV,P000229,P011225,3.617,0,9,9
205,ASV,P000229,P013371,5.649,-6,9,15
205,ASV,P000229,P013405,6.517,-10,11,21
205,ASV,P002100,P003526,8.566,2,21,19
205,ASV,P002100,P004194,7.133,-3,15,18
205,ASV,P002100,P007027,6.517,3,18,15
205,ASV,P002100,P008991,11.365,3,28,25
205,ASV,P002100,P009818,7.199,-4,15,19
205,ASV,P002100,P010316,2.733,-2,8,10
205,ASV,P002100,P010545,4.167,4,15,11
205,ASV,P002100,P011225,3.816,3,13,10
205,ASV,P002100,P013371,9.799,-4,21,25
205,ASV,P002100,P013405,7.067,-6,17,23
205,ASV,P003526,P004194,2.883,-1,8,9
205,ASV,P003526,P007027,17.35,8,44,36
205,ASV,P003526,P008991,6.066,1,13,12
205,ASV,P003526,P009818,7.066,0,11,11
205,ASV,P003526,P010316,0.033,0,0,0
205,ASV,P003526,P010545,14.117,14,41,27
205,ASV,P003526,P011225,12.583,8,33,25
205,ASV,P003526,P013371,3.633,2,10,8
205,ASV,P003526,P013405,11.767,6,35,29
205,ASV,P004194,P007027,3.267,-5,9,14
205,ASV,P004194,P008991,4.233,7,13,6
205,ASV,P004194,P011225,3.15,-3,9,12
205,ASV,P004194,P013371,7.016,-1,15,16
205,ASV,P004194,P013405,6.05,-13,11,24
205,ASV,P007027,P008991,3.167,-3,3,6
205,ASV,P007027,P009818,6.35,0,9,9
205,ASV,P007027,P010316,5.4,1,13,12
205,ASV,P007027,P010545,21.45,20,61,41
205,ASV,P007027,P011225,23.067,14,62,48
205,ASV,P007027,P013405,21.634,12,64,52
205,ASV,P008991,P009818,8.133,-8,15,23
205,ASV,P008991,P010316,3.5,-4,8,12
205,ASV,P008991,P011225,3.25,-6,6,12
205,ASV,P008991,P013371,7.016,4,19,15
205,ASV,P009818,P010316,3.467,-4,8,12
205,ASV,P009818,P010545,3.083,3,6,3
205,ASV,P009818,P011225,6.4,-3,12,15
205,ASV,P009818,P013371,2.783,-3,6,9
205,ASV,P010316,P010545,4.633,3,13,10
205,ASV,P010316,P011225,7.616,-1,19,20
205,ASV,P010316,P013371,0.517,0,2,2
205,ASV,P010316,P013405,4.633,3,13,10
205,ASV,P010545,P011225,18.783,21,53,32
205,ASV,P010545,P013405,18.367,17,55,38
205,ASV,P011225,P013405,18.85,15,56,41
205,ASV,P013371,P013405,2.783,-8,2,10
205,BAR,P000925,P002939,13.966,-5,31,36
205,BAR,P000925,P003478,8.583,-5,17,22
205,BAR,P000925,P007464,2.533,0,4,4
205,BAR,P000925,P009862,10.332,-5,21,26
205,BAR,P000925,P009992,10.683,3,26,23
205,BAR,P000925,P012745,8.033,-2,21,23
205,BAR,P000925,P012795,5.933,-3,10,13
205,BAR,P000925,P013379,5.933,-3,10,13
205,BAR,P002939,P003196,1.233,0,4,4
205,BAR,P002939,P003478,13.967,-8,32,40
205,BAR,P002939,P006568,4.633,-3,10,13
205,BAR,P002939,P007464,2.967,-3,6,9
205,BAR,P002939,P009862,16.015,-15,33,48
205,BAR,P002939,P009992,12.867,3,34,31
205,BAR,P002939,P012745,19.2,-12,46,58
205,BAR,P002939,P012795,8.2,-7,13,20
205,BAR,P002939,P013379,12.484,-10,23,33
205,BAR,P003196,P003478,1.133,-6,0,6
205,BAR,P003196,P007464,4.949,-1,14,15
205,BAR,P003196,P009862,4.949,-1,14,15
205,BAR,P003196,P009992,2.583,5,10,5
205,BAR,P003196,P012745,4.949,-1,14,15
205,BAR,P003478,P006568,5.833,-1,12,13
205,BAR,P003478,P007464,4.75,-4,6,10
205,BAR,P003478,P009862,16.816,-12,30,42
205,BAR,P003478,P009992,11.118,12,28,16
205,BAR,P003478,P012745,17.9,-9,39,48
205,BAR,P003478,P013379,5.968,5,16,11
205,BAR,P006568,P009862,5.833,-1,12,13
205,BAR,P006568,P009992,1.2,2,2,0
205,BAR,P006568,P012745,5.833,-1,12,13
205,BAR,P007464,P009862,11.732,4,33,29
205,BAR,P007464,P009992,10.583,10,31,21
205,BAR,P007464,P012745,5.466,-4,14,18
205,BAR,P007464,P012795,4.9,0,15,15
205,BAR,P007464,P013379,5.984,2,17,15
205,BAR,P009862,P009992,15.499,15,45,30
205,BAR,P009862,P012745,21.132,-10,48,58
205,BAR,P009862,P012795,6.016,1,16,15
205,BAR,P009862,P013379,10.2,0,24,24
205,BAR,P009992,P012745,13.067,15,41,26
205,BAR,P009992,P012795,8.666,1,23,22
205,BAR,P009992,P013379,15.134,6,40,34
205,BAR,P012745,P012795,1.334,-4,1,5
205,BAR,P012745,P013379,7.218,-4,16,20
205,BAR,P012795,P013379,11.683,-4,26,30
206,OLY,P001255,P003469,19.066,-3,38,41
206,OLY,P001255,P003941,8.783,-6,14,20
206,OLY,P001255,P007982,19.066,-3,38,41
206,OLY,P001255,P008811,10.283,3,24,21
206,OLY,P001255,P013380,19.066,-3,38,41
206,OLY,P003469,P003941,10.849,-7,17,24
206,OLY,P003469,P007947,8.032,2,19,17
206,OLY,P003469,P007982,27.331,-3,54,57
206,OLY,P003469,P008811,13.449,8,35,27
206,OLY,P003469,P008829,8.582,1,20,19
206,OLY,P003469,P009849,1.05,3,6,3
206,OLY,P003469,P010392,3.35,2,8,6
206,OLY,P003469,P013380,21.815,-3,43,46
206,OLY,P003941,P007947,8.183,-2,13,15
206,OLY,P003941,P007982,16.966,-8,27,35
206,OLY,P003941,P008829,7.45,-4,11,15
206,OLY,P003941,P013380,15.633,-5,26,31
206,OLY,P007947,P007982,13.099,-2,23,25
206,OLY,P007947,P008811,5.233,-6,11,17
206,OLY,P007947,P008829,16.766,-11,30,41
206,OLY,P007947,P009849,4.4,-7,9,16
206,OLY,P007947,P010392,3.35,2,8,6
206,OLY,P007947,P013380,10.933,-12,15,27
206,OLY,P007982,P008811,14.549,6,33,27
206,OLY,P007982,P008829,15.799,-2,28,30
206,OLY,P007982,P009849,2.15,1,4,3
206,OLY,P007982,P010392,3.35,2,8,6
206,OLY,P007982,P013380,30.082,-3,57,60
206,OLY,P008811,P008829,8.666,-4,18,22
206,OLY,P008811,P009849,6.55,-6,13,19
206,OLY,P008811,P013380,17.066,-5,34,39
206,OLY,P008829,P009849,6.55,-6,13,19
206,OLY,P008829,P010392,3.35,2,8,6
206,OLY,P008829,P013380,13.633,-12,20,32
206,OLY,P009849,P013380,5.5,-9,7,16
206,ULK,P002849,P004004,6.883,4,17,13
206,ULK,P002849,P005216,9.434,5,23,18
206,ULK,P002849,P006961,11.367,9,27,18
206,ULK,P002849,P008104,0.133,0,2,2
206,ULK,P002849,P008962,11.283,6,26,20
206,ULK,P002849,P009783,0.8,3,3,0
206,ULK,P002849,P011205,6.1,9,18,9
206,ULK,P002968,P004004,15.984,0,31,31
206,ULK,P002968,P005216,8.75,-4,16,20
206,ULK,P002968,P006961,15.784,-5,26,31
206,ULK,P002968,P008104,11.067,-2,20,22
206,ULK,P002968,P008962,22.468,-5,39,44
206,ULK,P002968,P009783,13.533,1,25,24
206,ULK,P002968,P011205,12.15,-1,23,24
206,ULK,P004004,P005216,11.067,-1,28,29
206,ULK,P004004,P006961,19.65,10,47,37
206,ULK,P004004,P007182,3.566,5,13,8
206,ULK,P004004,P008104,8.933,3,20,17
206,ULK,P004004,P008962,24.083,3,52,49
206,ULK,P004004,P009783,10.883,5,21,16
206,ULK,P004004,P011205,4.683,7,15,8
206,ULK,P005216,P006961,18.784,-2,40,42
206,ULK,P005216,P007182,0.733,-3,3,6
206,ULK,P005216,P008104,0.133,0,2,2
206,ULK,P005216,P008962,18.067,-1,39,40
206,ULK,P005216,P009783,0.85,-1,3,4
206,ULK,P005216,P011205,7.85,-1,14,15
206,ULK,P006961,P007182,3.566,5,13,8
206,ULK,P006961,P008104,7.033,9,18,9
206,ULK,P006961,P008962,26.734,4,54,50
206,ULK,P006961,P009783,6.483,4,12,8
206,ULK,P006961,P011205,13.467,2,27,25
206,ULK,P007182,P008104,2.833,8,10,2
206,ULK,P007182,P008962,2.266,4,10,6
206,ULK,P007182,P009783,1.3,1,3,2
206,ULK,P008104,P008962,10.9,0,23,23
206,ULK,P008104,P009783,10.0,3,21,18
206,ULK,P008104,P011205,5.1,3,12,9
206,ULK,P008962,P009783,11.65,0,19,19
206,ULK,P008962,P011205,16.617,9,38,29
206,ULK,P009783,P011205,7.033,4,17,13
208,MUN,P001288,P001557,11.117,6,26,20
208,MUN,P001288,P004508,7.483,-3,13,16
208,MUN,P001288,P007056,19.683,-4,40,44
208,MUN,P001288,P007201,3.333,3,11,8
208,MUN,P001288,P010391,23.732,7,56,49
208,MUN,P001288,P011244,14.382,5,35,30
208,MUN,P001288,P011987,18.266,6,43,37
208,MUN,P001557,P004508,19.534,13,50,37
208,MUN,P001557,P007056,12.184,9,29,20
208,MUN,P001557,P007201,12.15,12,34,22
208,MUN,P001557,P010391,16.75,16,46,30
208,MUN,P001557,P011244,14.117,15,41,26
208,MUN,P001557,P011987,13.284,13,34,21
208,MUN,P004508,P007056,10.017,5,23,18
208,MUN,P004508,P007201,14.933,6,38,32
208,MUN,P004508,P010391,14.949,2,35,33
208,MUN,P004508,P011244,14.666,5,36,31
208,MUN,P004508,P011987,10.35,0,21,21
208,MUN,P007056,P007201,2.45,4,7,3
208,MUN,P007056,P010391,20.416,3,45,42
208,MUN,P007056,P011244,11.083,-1,24,25
208,MUN,P007056,P011987,14.967,0,32,32
208,MUN,P007201,P010391,11.566,6,33,27
208,MUN,P007201,P011244,14.866,6,40,34
208,MUN,P007201,P011987,9.966,3,25,22
208,MUN,P010391,P011244,21.115,3,52,49
208,MUN,P010391,P011987,19.332,3,45,42
208,MUN,P011244,P011987,23.299,7,56,49
208,ZAL,P002329,P002676,7.85,6,24,18
208,ZAL,P002329,P003048,7.533,-1,13,14
208,ZAL,P002329,P003210,0.4,0,0,0
208,ZAL,P002329,P005504,7.85,6,24,18
208,ZAL,P002329,P007029,8.417,-7,11,18
208,ZAL,P002329,P007975,23.934,-5,50,55
208,ZAL,P002329,P011051,11.134,-9,18,27
208,ZAL,P002329,P011983,3.717,5,9,4
208,ZAL,P002329,P012622,5.534,-12,5,17
208,ZAL,P002329,P012715,6.883,0,14,14
208,ZAL,P002329,P013403,14.084,-3,32,35
208,ZAL,P002676,P003048,8.067,0,20,20
208,ZAL,P002676,P003210,7.167,-5,12,17
208,ZAL,P002676,P005504,7.85,6,24,18
208,ZAL,P002676,P007029,12.4,-6,30,36
208,ZAL,P002676,P007975,15.867,1,44,43
208,ZAL,P002676,P011051,9.8,-9,18,27
208,ZAL,P002676,P011983,12.466,-6,27,33
208,ZAL,P002676,P012622,4.484,0,6,6
208,ZAL,P002676,P013403,8.117,-3,19,22
208,ZAL,P003048,P003210,2.45,-2,4,6
208,ZAL,P003048,P007029,10.967,-1,25,26
208,ZAL,P003048,P007975,13.15,1,29,28
208,ZAL,P003048,P011051,4.383,2,11,9
208,ZAL,P003048,P011983,6.584,-3,14,17
208,ZAL,P003048,P012715,4.633,0,8,8
208,ZAL,P003048,P013403,4.633,0,8,8
208,ZAL,P003210,P007029,6.0,-2,12,14
208,ZAL,P003210,P011051,5.117,-3,8,11
208,ZAL,P003210,P011983,5.95,-6,8,14
208,ZAL,P003210,P012622,2.784,1,4,3
208,ZAL,P003210,P013403,0.4,-3,0,3
208,ZAL,P005504,P007975,7.85,6,24,18
208,ZAL,P005504,P011983,1.833,5,7,2
208,ZAL,P005504,P013403,6.017,1,17,16
208,ZAL,P007029,P007975,14.817,-11,29,40
208,ZAL,P007029,P011051,14.233,-10,27,37
208,ZAL,P007029,P011983,10.467,-8,22,30
208,ZAL,P007029,P012622,4.834,-8,5,13
208,ZAL,P007029,P012715,1.133,1,3,2
208,ZAL,P007975,P011051,15.334,-15,28,43
208,ZAL,P007975,P011983,7.917,0,21,21
208,ZAL,P007975,P012622,6.751,-13,7,20
208,ZAL,P007975,P012715,6.883,0,14,14
208,ZAL,P007975,P013403,15.301,-4,34,38
208,ZAL,P011051,P011983,5.933,-8,8,16
208,ZAL,P011051,P012622,10.018,-12,11,23
208,ZAL,P011051,P012715,2.25,0,6,6
208,ZAL,P011051,P013403,5.534,-8,9,17
208,ZAL,P011983,P012622,1.65,0,0,0
208,ZAL,P011983,P013403,0.883,-3,0,3
208,ZAL,P012622,P013403,4.017,-4,6,10
208,ZAL,P012715,P013403,5.75,-1,11,12
209,BAR,P002939,P003196,11.966,-2,24,26
209,BAR,P002939,P003478,5.185,4,17,13
209,BAR,P002939,P006568,9.883,-3,16,19
209,BAR,P002939,P007464,9.35,-1,18,19
209,BAR,P002939,P009862,18.166,-4,33,37
209,BAR,P002939,P009992,14.016,0,31,31
209,BAR,P002939,P010106,6.3,-1,15,16
209,BAR,P002939,P011666,1.983,-7,0,7
209,BAR,P002939,P012745,15.75,3,34,31
209,BAR,P002939,P013379,12.401,3,36,33
209,BAR,P003196,P003478,9.65,-6,18,24
209,BAR,P003196,P009862,7.482,-5,9,14
209,BAR,P003196,P009992,16.233,-2,36,38
209,BAR,P003196,P010106,13.916,-3,30,33
209,BAR,P003196,P012745,4.533,-5,3,8
209,BAR,P003196,P013379,15.216,-1,36,37
209,BAR,P003478,P007464,2.65,0,7,7
209,BAR,P003478,P009862,9.417,3,23,20
209,BAR,P003478,P009992,12.35,7,35,28
209,BAR,P003478,P010106,10.95,-4,21,25
209,BAR,P003478,P012745,7.2,7,21,14
209,BAR,P003478,P013379,17.934,5,46,41
209,BAR,P006568,P007464,8.95,-3,16,19
209,BAR,P006568,P009862,9.883,-3,16,19
209,BAR,P006568,P009992,0.933,0,0,0
209,BAR,P006568,P011666,1.983,-7,0,7
209,BAR,P006568,P012745,7.9,4,16,12
209,BAR,P007464,P009862,11.933,-1,25,26
209,BAR,P007464,P009992,2.916,2,9,7
209,BAR,P007464,P011666,1.983,-7,0,7
209,BAR,P007464,P012745,7.3,6,18,12
209,BAR,P007464,P013379,2.65,0,7,7
209,BAR,P009862,P009992,9.065,0,19,19
209,BAR,P009862,P010106,6.7,-2,9,11
209,BAR,P009862,P011666,1.983,-7,0,7
209,BAR,P009862,P012745,17.549,3,34,31
209,BAR,P009862,P013379,11.95,0,28,28
209,BAR,P009992,P010106,10.65,3,29,26
209,BAR,P009992,P012745,6.099,0,11,11
209,BAR,P009992,P013379,19.666,6,54,48
209,BAR,P010106,P012745,6.183,-5,7,12
209,BAR,P010106,P013379,14.033,0,33,33
209,BAR,P012745,P013379,7.15,3,20,17
209,BAS,P004058,P007579,3.383,-4,6,10
209,BAS,P004058,P011085,2.583,-6,4,10
209,BAS,P004058,P011196,3.383,-4,6,10
209,BAS,P004058,P011948,3.383,-4,6,10
209,BAS,P004058,P012080,0.8,2,2,0
209,BAS,P007579,P011085,9.416,-6,21,27
209,BAS,P007579,P011196,10.216,-4,23,27
209,BAS,P007579,P011948,8.983,-7,20,27
209,BAS,P007579,P012080,2.033,5,5,0
209,BAS,P007579,P013367,6.833,0,17,17
209,BAS,P008072,P011085,2.25,7,7,0
209,BAS,P008072,P012080,14.767,4,28,24
209,BAS,P008072,P012201,14.767,4,28,24
209,BAS,P008072,P012597,12.517,-3,21,24
209,BAS,P008072,P013367,14.767,4,28,24
209,BAS,P011085,P011196,16.916,-9,34,43
209,BAS,P011085,P011948,12.049,-8,26,34
209,BAS,P011085,P012080,7.583,6,19,13
209,BAS,P011085,P012201,9.983,4,22,18
209,BAS,P011085,P013367,16.816,4,39,35
209,BAS,P011196,P011948,19.899,-1,48,49
209,BAS,P011196,P012080,13.183,6,34,28
209,BAS,P011196,P012201,14.783,2,35,33
209,BAS,P011196,P012597,6.133,2,19,17
209,BAS,P011196,P013367,15.483,0,33,33
209,BAS,P011948,P012080,8.316,7,26,19
209,BAS,P011948,P012201,11.149,6,30,24
209,BAS,P011948,P012597,6.133,2,19,17
209,BAS,P011948,P013367,10.616,1,25,24
209,BAS,P012080,P012201,26.15,5,59,54
209,BAS,P012080,P012597,18.65,-1,40,41
209,BAS,P012080,P013367,21.25,6,43,37
209,BAS,P012201,P012597,18.65,-1,40,41
209,BAS,P012201,P013367,23.65,4,46,42
209,BAS,P012597,P013367,12.517,-3,21,24
210,MIL,P006085,P006509,11.234,-3,18,21
210,MIL,P006085,P006721,9.567,0,18,18
210,MIL,P006085,P007831,4.684,-4,3,7
210,MIL,P006085,P008985,2.817,-2,4,6
210,MIL,P006085,P008987,6.384,5,12,7
210,MIL,P006085,P011941,4.067,-7,4,11
210,MIL,P006085,P013384,6.183,-1,13,14
210,MIL,P006509,P006721,12.083,2,24,22
210,MIL,P006509,P007831,11.733,-1,19,20
210,MIL,P006509,P008985,10.116,2,20,18
210,MIL,P006509,P008987,11.583,6,22,16
210,MIL,P006509,P011064,2.766,1,6,5
210,MIL,P006509,P011941,9.183,-6,14,20
210,MIL,P006509,P013384,6.766,-1,13,14
210,MIL,P006721,P007831,10.05,-2,17,19
210,MIL,P006721,P008985,7.683,-5,12,17
210,MIL,P006721,P008987,9.317,5,20,15
210,MIL,P006721,P011064,6.95,-1,14,15
210,MIL,P006721,P011941,2.4,-4,4,8
210,MIL,P006721,P013384,8.35,1,19,18
210,MIL,P007831,P008985,19.816,8,46,38
210,MIL,P007831,P008987,27.534,4,56,52
210,MIL,P007831,P011064,21.0,8,49,41
210,MIL,P007831,P011941,19.917,8,45,37
210,MIL,P007831,P013384,5.134,3,13,10
210,MIL,P008985,P008987,21.233,13,52,39
210,MIL,P008985,P011064,18.433,11,46,35
210,MIL,P008985,P011941,18.433,16,48,32
210,MIL,P008985,P013384,5.933,1,12,11
210,MIL,P008987,P011064,21.467,11,53,42
210,MIL,P008987,P011941,23.4,13,55,42
210,MIL,P008987,P013384,9.95,15,30,15
210,MIL,P011064,P011941,16.95,14,45,31
210,MIL,P011064,P013384,8.034,8,23,15
210,MIL,P011941,P013384,8.85,2,21,19
210,PAN,P001926,P004088,16.483,-6,34,40
210,PAN,P001926,P005161,3.617,-4,8,12
210,PAN,P001926,P007866,22.7,1,47,46
210,PAN,P001926,P009622,9.283,-7,13,20
210,PAN,P001926,P011204,11.266,-7,21,28
210,PAN,P001926,P011209,1.916,-7,0,7
210,PAN,P001926,P011221,4.383,-12,4,16
210,PAN,P001926,P012712,25.599,-2,51,53
210,PAN,P001926,P012774,25.232,-6,50,56
210,PAN,P001926,P013383,4.049,-2,8,10
210,PAN,P004088,P005161,2.934,-5,5,10
210,PAN,P004088,P007866,13.4,4,30,26
210,PAN,P004088,P009622,4.267,-9,5,14
210,PAN,P004088,P011204,10.5,3,20,17
210,PAN,P004088,P011209,5.016,-7,5,12
210,PAN,P004088,P011221,4.383,-12,4,16
210,PAN,P004088,P012712,19.617,7,43,36
210,PAN,P004088,P012774,16.35,2,36,34
210,PAN,P004088,P013383,8.45,3,18,15
210,PAN,P005161,P009622,3.617,-4,8,12
210,PAN,P005161,P011221,1.717,-10,0,10
210,PAN,P005161,P012774,0.683,1,3,2
210,PAN,P005161,P013383,1.9,6,8,2
210,PAN,P007866,P009622,4.05,1,5,4
210,PAN,P007866,P011204,11.75,-4,22,26
210,PAN,P007866,P011209,3.4,0,5,5
210,PAN,P007866,P012712,24.617,1,50,49
210,PAN,P007866,P012774,22.4,1,47,46
210,PAN,P007866,P013383,0.883,0,2,2
210,PAN,P009622,P011209,1.333,-4,0,4
210,PAN,P009622,P011221,2.75,-14,0,14
210,PAN,P009622,P012712,4.333,1,5,4
210,PAN,P009622,P012774,5.016,2,8,6
210,PAN,P009622,P013383,2.483,6,8,2
210,PAN,P011204,P011209,3.1,0,5,5
210,PAN,P011204,P011221,1.633,2,4,2
210,PAN,P011204,P012712,19.25,-6,35,41
210,PAN,P011204,P012774,15.4,-8,28,36
210,PAN,P011204,P013383,7.633,-4,13,17
210,PAN,P011209,P011221,1.033,-4,0,4
210,PAN,P011209,P012712,2.217,0,3,3
210,PAN,P011209,P012774,0.583,-3,0,3
210,PAN,P011209,P013383,1.466,-3,2,5
210,PAN,P011221,P012712,1.633,2,4,2
210,PAN,P012712,P012774,29.733,-3,58,61
210,PAN,P012712,P013383,7.333,-4,11,15
210,PAN,P012774,P013383,8.599,-6,14,20
211,ASV,P000229,P002100,2.933,-3,4,7
211,ASV,P000229,P004194,10.467,2,26,24
211,ASV,P000229,P007027,13.284,6,34,28
211,ASV,P000229,P009818,2.083,2,4,2
211,ASV,P000229,P010545,3.667,-1,8,9
211,ASV,P000229,P011225,13.284,6,34,28
211,ASV,P000229,P013371,2.933,-3,4,7
211,ASV,P000229,P013405,16.217,3,38,35
211,ASV,P002100,P003526,5.384,1,8,7
211,ASV,P002100,P004194,3.283,0,12,12
211,ASV,P002100,P007027,9.083,-2,26,28
211,ASV,P002100,P008991,1.05,0,3,3
211,ASV,P002100,P009818,13.25,1,29,28
211,ASV,P002100,P010316,8.884,-4,15,19
211,ASV,P002100,P010545,6.684,-12,14,26
211,ASV,P002100,P011225,5.783,-1,10,11
211,ASV,P002100,P013371,15.117,-8,35,43
211,ASV,P002100,P013405,12.149,-8,24,32
211,ASV,P003526,P004194,4.017,-3,3,6
211,ASV,P003526,P007027,4.417,-2,4,6
211,ASV,P003526,P008991,0.6,3,3,0
211,ASV,P003526,P009818,3.717,4,6,2
211,ASV,P003526,P010316,4.984,0,7,7
211,ASV,P003526,P010545,5.084,-9,2,11
211,ASV,P003526,P011225,3.417,-6,0,6
211,ASV,P003526,P013371,5.984,4,11,7
211,ASV,P004194,P007027,17.767,-1,41,42
211,ASV,P004194,P008991,0.6,3,3,0
211,ASV,P004194,P009818,1.183,1,6,5
211,ASV,P004194,P010545,4.284,-5,3,8
211,ASV,P004194,P011225,13.884,-4,26,30
211,ASV,P004194,P013371,3.883,3,15,12
211,ASV,P004194,P013405,11.7,0,29,29
211,ASV,P007027,P008991,0.6,3,3,0
211,ASV,P007027,P009818,6.983,-1,20,21
211,ASV,P007027,P010316,1.8,-3,0,3
211,ASV,P007027,P010545,10.218,-8,15,23
211,ASV,P007027,P011225,21.434,0,39,39
211,ASV,P007027,P013371,6.75,-2,24,26
211,ASV,P007027,P013405,20.4,2,46,44
211,ASV,P008991,P010316,1.05,0,3,3
211,ASV,P008991,P013371,1.65,3,6,3
211,ASV,P008991,P013405,1.05,0,3,3
211,ASV,P009818,P010316,4.184,0,5,5
211,ASV,P009818,P010545,1.317,-4,4,8
211,ASV,P009818,P011225,3.8,0,5,5
211,ASV,P009818,P013371,9.45,1,24,23
211,ASV,P009818,P013405,7.033,0,13,13
211,ASV,P010316,P010545,5.45,-7,7,14
211,ASV,P010316,P011225,4.65,-7,5,12
211,ASV,P010316,P013371,6.034,0,10,10
211,ASV,P010316,P013405,5.7,-7,8,15
211,ASV,P010545,P011225,10.017,-6,13,19
211,ASV,P010545,P013371,4.701,-11,9,20
211,ASV,P010545,P013405,7.45,-5,13,18
211,ASV,P011225,P013405,20.867,2,44,42
211,ASV,P013371,P013405,6.366,-7,14,21
211,PRS,P004197,P004512,4.233,-1,13,14
211,PRS,P004197,P005793,11.266,3,30,27
211,PRS,P004197,P007032,15.499,2,43,41
211,PRS,P004197,P010390,2.083,-1,0,1
211,PRS,P004197,P012640,15.499,2,43,41
211,PRS,P004197,P013373,13.416,3,43,40
211,PRS,P004512,P007032,4.233,-1,13,14
211,PRS,P004512,P012608,4.333,-11,0,11
211,PRS,P004512,P012610,4.333,-11,0,11
211,PRS,P004512,P012613,4.333,-11,0,11
211,PRS,P004512,P012640,8.566,-12,13,25
211,PRS,P004512,P013373,4.233,-1,13,14
211,PRS,P005793,P007032,11.266,3,30,27
211,PRS,P005793,P010390,2.083,-1,0,1
211,PRS,P005793,P012640,11.266,3,30,27
211,PRS,P005793,P013373,9.183,4,30,26
211,PRS,P007032,P010390,4.266,-4,2,6
211,PRS,P007032,P012608,3.833,-5,4,9
211,PRS,P007032,P012609,1.65,-2,2,4
211,PRS,P007032,P012610,3.833,-5,4,9
211,PRS,P007032,P012613,3.833,-5,4,9
211,PRS,P007032,P012640,15.499,2,43,41
211,PRS,P007032,P013373,13.416,3,43,40
211,PRS,P010390,P012608,18.517,20,46,26
211,PRS,P010390,P012609,15.017,21,38,17
211,PRS,P010390,P012610,18.517,20,46,26
211,PRS,P010390,P012613,18.517,20,46,26
211,PRS,P010390,P012640,3.4,1,6,5
211,PRS,P012608,P012609,16.667,19,40,21
211,PRS,P012608,P012610,24.5,7,48,41
211,PRS,P012608,P012613,24.5,7,48,41
211,PRS,P012608,P012640,5.65,-9,6,15
211,PRS,P012609,P012610,16.667,19,40,21
211,PRS,P012609,P012613,16.667,19,40,21
211,PRS,P012610,P012613,24.5,7,48,41
211,PRS,P012610,P012640,5.65,-9,6,15
211,PRS,P012613,P012640,5.65,-9,6,15
211,PRS,P012640,P013373,13.416,3,43,40
212,BER,P006251,P006919,6.233,-7,14,21
212,BER,P006251,P007025,2.25,2,7,5
212,BER,P006251,P008062,8.2,-4,16,20
212,BER,P006251,P008173,14.517,0,29,29
212,BER,P006251,P008211,11.6,-3,22,25
212,BER,P006251,P008780,9.1,0,20,20
212,BER,P006251,P011934,10.733,3,23,20
212,BER,P006251,P013386,6.567,-7,13,20
212,BER,P006919,P007025,9.449,0,18,18
212,BER,P006919,P008062,6.033,-4,12,16
212,BER,P006919,P008173,6.334,5,17,12
212,BER,P006919,P008211,5.034,-5,10,15
212,BER,P006919,P008780,12.3,5,29,24
212,BER,P006919,P011626,0.433,0,0,0
212,BER,P006919,P011631,6.733,3,15,12
212,BER,P006919,P011934,12.683,5,29,24
212,BER,P006919,P013386,8.1,2,20,18
212,BER,P007025,P008062,5.616,6,14,8
212,BER,P007025,P008211,4.217,3,11,8
212,BER,P007025,P008780,6.433,0,13,13
212,BER,P007025,P011626,0.583,2,2,0
212,BER,P007025,P011631,7.149,6,16,10
212,BER,P007025,P011934,8.866,5,20,15
212,BER,P007025,P013386,3.633,0,7,7
212,BER,P008062,P008173,14.167,-6,30,36
212,BER,P008062,P008211,13.75,4,32,28
212,BER,P008062,P011631,11.583,4,28,24
212,BER,P008062,P011934,8.516,7,22,15
212,BER,P008062,P013386,11.267,-7,22,29
212,BER,P008173,P008211,19.934,1,45,44
212,BER,P008173,P008780,11.234,10,30,20
212,BER,P008173,P011631,8.0,-4,21,25
212,BER,P008173,P011934,16.084,12,40,28
212,BER,P008173,P013386,11.334,-2,28,30
212,BER,P008211,P008780,12.951,-4,30,34
212,BER,P008211,P011626,0.15,2,2,0
212,BER,P008211,P011631,12.45,3,34,31
212,BER,P008211,P011934,19.851,3,47,44
212,BER,P008211,P013386,6.867,-4,15,19
212,BER,P008780,P011626,0.583,2,2,0
212,BER,P008780,P011631,5.583,0,15,15
212,BER,P008780,P011934,18.984,6,44,38
212,BER,P008780,P013386,3.7,5,13,8
212,BER,P011626,P011934,0.583,2,2,0
212,BER,P011631,P011934,11.233,4,29,25
212,BER,P011631,P013386,5.933,0,14,14
212,BER,P011934,P013386,2.467,5,8,3
212,TEL,P004233,P005145,2.383,-6,2,8
212,TEL,P004233,P007990,4.25,-5,6,11
212,TEL,P004233,P011193,2.8,-3,3,6
212,TEL,P004233,P011214,4.667,-2,7,9
212,TEL,P004233,P011219,2.967,-3,4,7
212,TEL,P004233,P012604,4.083,-5,5,10
212,TEL,P004233,P013250,4.25,-5,6,11
212,TEL,P004233,P013382,2.8,-3,3,6
212,TEL,P005145,P007519,3.033,1,8,7
212,TEL,P005145,P007990,4.733,-1,16,17
212,TEL,P005145,P011193,6.45,-2,20,22
212,TEL,P005145,P011202,0.167,-1,1,2
212,TEL,P005145,P011214,1.333,2,4,2
212,TEL,P005145,P011219,4.017,0,16,16
212,TEL,P005145,P012604,2.383,-6,2,8
212,TEL,P005145,P013250,2.416,-2,4,6
212,TEL,P005145,P013381,3.133,1,8,7
212,TEL,P005145,P013382,5.416,-2,15,17
212,TEL,P007519,P007990,3.217,-2,5,7
212,TEL,P007519,P011193,7.566,3,18,15
212,TEL,P007519,P011202,3.217,-2,5,7
212,TEL,P007519,P011214,9.366,5,20,15
212,TEL,P007519,P011219,8.25,-2,18,20
212,TEL,P007519,P012604,3.65,-2,5,7
212,TEL,P007519,P013250,3.333,-2,5,7
212,TEL,P007519,P013381,6.516,-4,12,16
212,TEL,P007519,P013382,8.316,1,16,15
212,TEL,P007990,P011193,12.117,4,34,30
212,TEL,P007990,P011202,6.484,0,15,15
212,TEL,P007990,P011214,13.318,-8,24,32
212,TEL,P007990,P011219,12.317,-6,26,32
212,TEL,P007990,P012604,7.217,-3,16,19
212,TEL,P007990,P013250,5.75,-11,7,18
212,TEL,P007990,P013381,1.333,-2,0,2
212,TEL,P007990,P013382,13.6,-2,35,37
212,TEL,P011193,P011202,8.317,8,24,16
212,TEL,P011193,P011214,15.566,6,33,27
212,TEL,P011193,P011219,19.117,8,51,43
212,TEL,P011193,P012604,5.95,-2,12,14
212,TEL,P011193,P013250,1.267,0,2,2
212,TEL,P011193,P013381,6.533,5,20,15
212,TEL,P011193,P013382,25.117,9,63,54
212,TEL,P011202,P011214,5.717,3,14,11
212,TEL,P011202,P011219,5.217,5,15,10
212,TEL,P011202,P012604,3.217,-2,5,7
212,TEL,P011202,P013250,1.434,-1,3,4
212,TEL,P011202,P013381,4.567,3,13,10
212,TEL,P011202,P013382,8.467,7,25,18
212,TEL,P011214,P011219,11.667,-7,18,25
212,TEL,P011214,P012604,5.667,0,11,11
212,TEL,P011214,P013250,3.584,-8,4,12
212,TEL,P011214,P013381,1.766,2,4,2
212,TEL,P011214,P013382,14.417,-1,29,30
212,TEL,P011219,P012604,1.8,2,6,4
212,TEL,P011219,P013250,7.934,-11,10,21
212,TEL,P011219,P013381,7.85,0,20,20
212,TEL,P011219,P013382,22.0,2,52,50
212,TEL,P012604,P013250,1.283,-2,2,4
212,TEL,P012604,P013381,1.033,-2,0,2
212,TEL,P012604,P013382,5.517,-2,12,14
212,TEL,P013250,P013381,4.066,-2,5,7
212,TEL,P013250,P013382,6.083,-8,8,16
212,TEL,P013381,P013382,7.999,3,18,15
213,ULK,P002849,P002968,7.8,-3,15,18
213,ULK,P002849,P002969,2.133,-3,6,9
213,ULK,P002849,P004004,6.666,-6,14,20
213,ULK,P002849,P005216,12.483,6,32,26
213,ULK,P002849,P006961,11.4,8,31,23
213,ULK,P002849,P008104,6.916,-11,15,26
213,ULK,P002849,P008962,7.333,4,20,16
213,ULK,P002849,P009783,2.3,0,4,4
213,ULK,P002849,P010560,2.133,-3,6,9
213,ULK,P002849,P011205,9.9,0,21,21
213,ULK,P002968,P004004,10.766,1,26,25
213,ULK,P002968,P005216,13.999,8,34,26
213,ULK,P002968,P006961,9.5,4,23,19
213,ULK,P002968,P008104,6.233,0,13,13
213,ULK,P002968,P008962,8.599,6,19,13
213,ULK,P002968,P009783,10.266,16,30,14
213,ULK,P002968,P011205,13.765,0,28,28
213,ULK,P002969,P005216,2.133,-3,6,9
213,ULK,P002969,P008104,2.133,-3,6,9
213,ULK,P002969,P010560,2.133,-3,6,9
213,ULK,P004004,P005216,7.883,3,22,19
213,ULK,P004004,P006961,11.934,9,33,24
213,ULK,P004004,P007182,9.468,4,19,15
213,ULK,P004004,P008104,12.967,-3,25,28
213,ULK,P004004,P008962,14.734,4,32,28
213,ULK,P004004,P009783,11.034,7,28,21
213,ULK,P004004,P011205,6.416,-3,13,16
213,ULK,P005216,P006961,12.55,8,35,27
213,ULK,P005216,P007182,1.3,1,5,4
213,ULK,P005216,P008104,2.133,-3,6,9
213,ULK,P005216,P008962,11.982,8,29,21
213,ULK,P005216,P009783,10.699,14,32,18
213,ULK,P005216,P010560,2.133,-3,6,9
213,ULK,P005216,P011205,16.765,13,41,28
213,ULK,P006961,P007182,5.334,6,14,8
213,ULK,P006961,P008104,5.2,2,12,10
213,ULK,P006961,P008962,10.0,6,25,19
213,ULK,P006961,P009783,3.5,4,13,9
213,ULK,P006961,P011205,10.05,9,26,17
213,ULK,P007182,P008104,6.884,0,11,11
213,ULK,P007182,P008962,9.001,4,17,13
213,ULK,P007182,P009783,6.267,0,13,13
213,ULK,P007182,P011205,2.95,5,9,4
213,ULK,P008104,P008962,10.834,2,21,19
213,ULK,P008104,P009783,8.134,2,15,13
213,ULK,P008104,P010560,2.133,-3,6,9
213,ULK,P008104,P011205,2.433,-7,2,9
213,ULK,P008962,P009783,13.7,10,29,19
213,ULK,P008962,P011205,13.549,12,32,20
213,ULK,P009783,P011205,9.432,11,24,13
213,VIR,P001133,P001844,12.884,-4,26,30
213,VIR,P001133,P002084,10.517,-2,18,20
213,VIR,P001133,P005738,10.067,-3,21,24
213,VIR,P001133,P006739,23.184,-3,44,47
213,VIR,P001133,P009549,20.218,-5,38,43
213,VIR,P001133,P011816,2.734,1,9,8
213,VIR,P001133,P012585,13.318,7,34,27
213,VIR,P001133,P012591,11.683,-8,17,25
213,VIR,P001133,P013374,5.95,-1,10,11
213,VIR,P001133,PBCN,6.517,-2,15,17
213,VIR,P001844,P002084,10.183,-4,17,21
213,VIR,P001844,P005738,11.333,-12,24,36
213,VIR,P001844,P006273,2.133,3,9,6
213,VIR,P001844,P006739,8.483,-4,16,20
213,VIR,P001844,P009549,9.868,-8,21,29
213,VIR,P001844,P011816,8.066,-6,17,23
213,VIR,P001844,P012585,11.267,-5,27,32
213,VIR,P001844,P012591,5.866,-6,7,13
213,VIR,P001844,P013374,2.667,-3,7,10
213,VIR,P001844,PBCN,4.25,-3,9,12
213,VIR,P002084,P005738,3.5,-3,5,8
213,VIR,P002084,P006739,10.267,2,20,18
213,VIR,P002084,P009549,7.168,-1,13,14
213,VIR,P002084,P011816,2.483,-3,3,6
213,VIR,P002084,P012585,5.117,-6,5,11
213,VIR,P002084,P012591,5.55,-2,9,11
213,VIR,P002084,PBCN,1.283,-1,2,3
213,VIR,P005738,P006273,2.133,3,9,6
213,VIR,P005738,P006739,10.717,-9,18,27
213,VIR,P005738,P009549,12.184,-1,30,31
213,VIR,P005738,P011816,7.049,-6,14,20
213,VIR,P005738,P012585,16.4,-1,40,41
213,VIR,P005738,P012591,5.033,-8,6,14
213,VIR,P005738,P013374,2.667,-3,7,10
213,VIR,P005738,PBCN,2.117,-5,2,7
213,VIR,P006273,P011816,2.133,3,9,6
213,VIR,P006273,P012585,2.133,3,9,6
213,VIR,P006739,P009549,17.751,-2,33,35
213,VIR,P006739,P011816,2.6,-3,6,9
213,VIR,P006739,P012585,10.634,3,24,21
213,VIR,P006739,P012591,10.783,-10,13,23
213,VIR,P006739,P013374,5.95,-1,10,11
213,VIR,P006739,PBCN,3.367,-1,8,9
213,VIR,P009549,P012585,10.751,5,28,23
213,VIR,P009549,P012591,8.334,-7,12,19
213,VIR,P009549,P013374,7.134,-5,13,18
213,VIR,P011816,P012585,8.9,-1,23,24
213,VIR,P011816,P012591,1.333,-4,0,4
213,VIR,P011816,PBCN,3.834,-1,11,12
213,VIR,P012585,P012591,1.8,0,4,4
213,VIR,P012585,P013374,4.15,-2,11,13
213,VIR,P012585,PBCN,6.334,-3,15,18
213,VIR,P012591,P013374,4.467,-2,6,8
213,VIR,P012591,PBCN,1.283,-1,2,3
213,VIR,P013374,PBCN,1.483,1,4,3
214,MAD,P003108,P003733,12.849,-6,21,27
214,MAD,P003108,P005791,14.333,6,31,25
214,MAD,P003108,P005928,11.383,-5,17,22
214,MAD,P003108,P006540,8.999,-12,7,19
214,MAD,P003108,P011247,18.55,3,42,39
214,MAD,P003108,P011649,12.384,3,28,25
214,MAD,P003108,P013667,11.883,-11,18,29
214,MAD,P003108,PTGB,14.483,2,32,30
214,MAD,P003733,P005791,16.75,1,28,27
214,MAD,P003733,P005928,21.067,-5,35,40
214,MAD,P003733,P006540,16.8,-5,26,31
214,MAD,P003733,P009213,8.017,-5,11,16
214,MAD,P003733,P011247,6.833,3,17,14
214,MAD,P003733,P011649,1.6,0,2,2
214,MAD,P003733,P013667,7.433,-6,14,20
214,MAD,P003733,PTGB,5.383,3,14,11
214,MAD,P005791,P005928,14.817,0,23,23
214,MAD,P005791,P006540,13.967,4,24,20
214,MAD,P005791,P009213,8.017,-5,11,16
214,MAD,P005791,P011247,10.55,8,29,21
214,MAD,P005791,P011649,10.217,7,26,19
214,MAD,P005791,PTGB,12.817,11,36,25
214,MAD,P005928,P006540,18.417,-4,28,32
214,MAD,P005928,P009213,7.2,-7,9,16
214,MAD,P005928,P011247,3.717,3,10,7
214,MAD,P005928,P011649,2.45,0,3,3
214,MAD,P005928,P013667,8.7,-5,15,20
214,MAD,P005928,PTGB,6.317,3,12,9
214,MAD,P006540,P009213,5.817,-3,9,12
214,MAD,P006540,P011247,1.733,-5,1,6
214,MAD,P006540,P011649,2.017,0,3,3
214,MAD,P006540,P013667,6.183,-13,5,18
214,MAD,P006540,PTGB,6.667,2,13,11
214,MAD,P009213,P011247,1.25,2,2,0
214,MAD,P009213,P011649,1.683,2,2,0
214,MAD,P009213,P013667,0.433,0,0,0
214,MAD,P009213,PTGB,1.383,-4,0,4
214,MAD,P011247,P011649,13.634,5,30,25
214,MAD,P011247,P013667,9.65,-4,16,20
214,MAD,P011247,PTGB,14.883,1,33,32
214,MAD,P011649,P013667,5.867,-2,7,9
214,MAD,P011649,PTGB,14.484,5,31,26
214,MAD,P013667,PTGB,8.383,-7,9,16
214,MCO,P001932,P002581,10.332,6,30,24
214,MCO,P001932,P004790,17.0,7,36,29
214,MCO,P001932,P005844,12.867,7,20,13
214,MCO,P001932,P005985,24.616,8,47,39
214,MCO,P001932,P008099,16.899,7,38,31
214,MCO,P001932,P011226,19.9,10,37,27
214,MCO,P001932,P011231,12.716,13,26,13
214,MCO,P001932,P012515,11.416,7,24,17
214,MCO,P001932,PLCZ,8.25,3,18,15
214,MCO,P002581,P004790,6.683,-1,17,18
214,MCO,P002581,P005985,10.432,-12,23,35
214,MCO,P002581,P008099,10.982,-7,24,31
214,MCO,P002581,P011226,5.999,-7,12,19
214,MCO,P002581,P011231,7.549,0,17,17
214,MCO,P002581,P012515,6.883,5,17,12
214,MCO,P004790,P005844,11.567,6,19,13
214,MCO,P004790,P005985,18.25,5,36,31
214,MCO,P004790,P008099,3.15,-4,6,10
214,MCO,P004790,P011226,8.517,0,12,12
214,MCO,P004790,P012515,7.833,7,18,11
214,MCO,P005844,P005985,13.867,3,20,17
214,MCO,P005844,P008099,1.0,-4,0,4
214,MCO,P005844,P011226,9.567,-1,13,14
214,MCO,P005844,P011231,2.033,-1,1,2
214,MCO,P005844,P012515,4.567,2,7,5
214,MCO,P005985,P008099,14.516,-15,24,39
214,MCO,P005985,P011226,20.9,-12,29,41
214,MCO,P005985,P011231,7.699,-6,9,15
214,MCO,P005985,P012515,9.417,6,21,15
214,MCO,P005985,PLCZ,4.767,3,11,8
214,MCO,P008099,P011226,17.633,-6,32,38
214,MCO,P008099,P011231,15.282,2,30,28
214,MCO,P008099,P012515,4.767,-1,9,10
214,MCO,P008099,PLCZ,9.367,4,21,17
214,MCO,P011226,P011231,12.716,1,23,22
214,MCO,P011226,P012515,1.584,-1,3,4
214,MCO,P011226,PLCZ,8.784,4,19,15
214,MCO,P011231,P012515,3.383,0,6,6
214,MCO,P011231,PLCZ,4.95,3,12,9
214,MCO,P012515,PLCZ,1.35,-1,3,4
215,IST,P004887,P006590,12.45,2,33,31
215,IST,P004887,P007109,4.9,-5,6,11
215,IST,P004887,P007200,4.133,-1,9,10
215,IST,P004887,P009664,0.883,-1,0,1
215,IST,P004887,P009846,15.983,9,43,34
215,IST,P004887,P011078,9.1,-6,17,23
215,IST,P004887,P012710,11.683,12,40,28
215,IST,P004887,P012742,7.516,11,26,15
215,IST,P004887,P013363,3.216,3,10,7
215,IST,P006372,P009846,0.05,0,0,0
215,IST,P006372,P011078,0.05,0,0,0
215,IST,P006372,P012742,0.05,0,0,0
215,IST,P006372,P012788,0.05,0,0,0
215,IST,P006590,P007109,1.884,-5,0,5
215,IST,P006590,P007200,0.883,1,3,2
215,IST,P006590,P009846,12.017,7,34,27
215,IST,P006590,P011078,7.367,-12,10,22
215,IST,P006590,P012710,11.883,7,37,30
215,IST,P006590,P012742,5.25,15,24,9
215,IST,P006590,P012788,0.75,4,4,0
215,IST,P006590,P013363,1.516,-3,3,6
215,IST,P007109,P007200,9.417,-6,18,24
215,IST,P007109,P009846,9.701,-5,19,24
215,IST,P007109,P011078,4.134,-4,5,9
215,IST,P007109,P012710,0.267,-2,0,2
215,IST,P007109,P012742,9.434,-9,17,26
215,IST,P007109,P012788,8.401,-6,16,22
215,IST,P007109,P013363,6.134,-10,7,17
215,IST,P007200,P009664,4.95,4,13,9
215,IST,P007200,P009846,7.8,-1,17,18
215,IST,P007200,P011078,3.717,-3,5,8
215,IST,P007200,P012710,7.034,-8,9,17
215,IST,P007200,P012742,16.801,-8,32,40
215,IST,P007200,P012788,17.235,-9,31,40
215,IST,P007200,P013363,13.634,-9,23,32
215,IST,P009664,P009846,0.883,-1,0,1
215,IST,P009664,P011078,0.883,-1,0,1
215,IST,P009664,P012742,4.95,4,13,9
215,IST,P009664,P012788,4.95,4,13,9
215,IST,P009664,P013363,5.833,3,13,10
215,IST,P009846,P011078,12.967,-3,26,29
215,IST,P009846,P012710,15.4,14,47,33
215,IST,P009846,P012742,12.817,13,40,27
215,IST,P009846,P012788,9.484,3,23,20
215,IST,P009846,P013363,5.966,4,15,11
215,IST,P011078,P012710,12.0,-6,25,31
215,IST,P011078,P012742,0.05,0,0,0
215,IST,P011078,P012788,7.967,-5,13,18
215,IST,P011078,P013363,10.033,-4,19,23
215,IST,P012710,P012742,7.934,10,26,16
215,IST,P012710,P012788,8.834,-5,14,19
215,IST,P012710,P013363,8.233,-2,18,20
215,IST,P012742,P012788,14.318,-2,30,32
215,IST,P012742,P013363,9.284,-6,16,22
215,IST,P012788,P013363,16.951,-12,28,40
215,OLY,P001255,P003469,25.482,11,64,53
215,OLY,P001255,P003941,13.549,-4,29,33
215,OLY,P001255,P007853,7.882,3,19,16
215,OLY,P001255,P007947,4.533,1,9,8
215,OLY,P001255,P007982,20.683,2,51,49
215,OLY,P001255,P008811,12.783,8,35,27
215,OLY,P001255,P008829,0.85,-7,0,7
215,OLY,P001255,P010392,0.883,-1,2,3
215,OLY,P001255,P013380,18.683,3,47,44
215,OLY,P003469,P003941,17.699,2,41,39
215,OLY,P003469,P007853,13.115,13,35,22
215,OLY,P003469,P007947,6.266,8,16,8
215,OLY,P003469,P007982,25.866,12,67,55
215,OLY,P003469,P008811,13.816,12,39,27
215,OLY,P003469,P008829,0.05,0,0,0
215,OLY,P003469,P010392,0.933,-1,2,3
215,OLY,P003469,P013380,23.033,-1,56,57
215,OLY,P003941,P007853,16.366,8,36,28
215,OLY,P003941,P007947,11.916,2,25,23
215,OLY,P003941,P007982,13.933,0,32,32
215,OLY,P003941,P008829,6.7,-5,11,16
215,OLY,P003941,P009849,2.933,-5,4,9
215,OLY,P003941,P013380,14.5,-10,30,40
215,OLY,P007853,P007947,8.433,2,18,16
215,OLY,P007853,P007982,13.682,6,32,26
215,OLY,P007853,P008811,5.132,-6,11,17
215,OLY,P007853,P008829,8.483,-11,12,23
215,OLY,P007853,P009849,3.816,-4,5,9
215,OLY,P007853,P010392,0.933,-1,2,3
215,OLY,P007853,P013380,8.35,-2,18,20
215,OLY,P007947,P007982,1.683,7,7,0
215,OLY,P007947,P008811,1.0,1,2,1
215,OLY,P007947,P008829,6.75,-5,11,16
215,OLY,P007947,P009849,2.933,-5,4,9
215,OLY,P007947,P010392,0.05,0,0,0
215,OLY,P007947,P013380,8.3,1,16,15
215,OLY,P007982,P008811,13.666,6,36,30
215,OLY,P007982,P008829,1.733,-6,1,7
215,OLY,P007982,P009849,0.883,1,1,0
215,OLY,P007982,P013380,18.267,-4,45,49
215,OLY,P008811,P008829,1.733,-6,1,7
215,OLY,P008811,P009849,0.883,1,1,0
215,OLY,P008811,P010392,0.883,-1,2,3
215,OLY,P008811,P013380,12.3,9,33,24
215,OLY,P008829,P009849,3.816,-4,5,9
215,OLY,P008829,P010392,0.05,0,0,0
215,OLY,P008829,P013380,3.767,0,7,7
216,PAR,P006760,P007736,8.483,-3,15,18
216,PAR,P006760,P007870,24.833,0,42,42
216,PAR,P006760,P010781,16.283,1,27,26
216,PAR,P006760,P011836,8.85,-6,14,20
216,PAR,P006760,P011981,8.867,1,16,15
216,PAR,P006760,P012720,13.816,-1,19,20
216,PAR,P006760,P013369,24.301,-3,43,46
216,PAR,P006760,P013370,17.167,3,32,29
216,PAR,P007736,P007870,6.216,-2,9,11
216,PAR,P007736,P010781,10.032,4,22,18
216,PAR,P007736,P011836,6.466,5,15,10
216,PAR,P007736,P011981,8.733,4,21,17
216,PAR,P007736,P012720,7.999,5,15,10
216,PAR,P007736,P013369,3.384,-2,8,10
216,PAR,P007736,P013370,8.483,-3,15,18
216,PAR,P007870,P010781,18.233,-3,31,34
216,PAR,P007870,P011836,12.333,-10,20,30
216,PAR,P007870,P011981,3.05,3,6,3
216,PAR,P007870,P012720,18.216,-7,25,32
216,PAR,P007870,P013369,21.784,-8,37,45
216,PAR,P007870,P013370,12.267,3,22,19
216,PAR,P010781,P011836,10.267,-2,19,21
216,PAR,P010781,P011981,9.2,5,19,14
216,PAR,P010781,P012720,12.183,0,21,21
216,PAR,P010781,P013369,15.601,-3,24,27
216,PAR,P010781,P013370,10.733,2,21,19
216,PAR,P011836,P011981,5.867,4,13,9
216,PAR,P011836,P012720,17.283,-4,33,37
216,PAR,P011836,P013369,11.734,-11,18,29
216,PAR,P011981,P012720,6.2,8,15,7
216,PAR,P011981,P013369,7.201,1,14,13
216,PAR,P011981,P013370,6.15,2,12,10
216,PAR,P012720,P013369,13.917,-8,21,29
216,PAR,P012720,P013370,3.05,3,3,0
216,PAR,P013369,P013370,10.818,2,23,21
216,RED,P000848,P004866,4.083,1,6,5
216,RED,P000848,P006436,9.3,-2,13,15
216,RED,P000848,P007960,1.25,2,2,0
216,RED,P000848,P009035,7.067,3,8,5
216,RED,P000848,P009048,7.549,-4,11,15
216,RED,P000848,P010588,4.183,-6,7,13
216,RED,P000848,P011194,7.55,-5,11,16
216,RED,P000848,P012044,3.35,-1,2,3
216,RED,P004866,P006436,4.7,5,12,7
216,RED,P004866,P007960,11.984,4,23,19
216,RED,P004866,P009035,22.067,5,41,36
216,RED,P004866,P009048,25.417,5,49,44
216,RED,P004866,P010588,14.883,5,30,25
216,RED,P004866,P010612,14.85,6,34,28
216,RED,P004866,P011194,20.2,3,39,36
216,RED,P004866,P012044,5.416,2,10,8
216,RED,P006436,P007960,1.283,0,0,0
216,RED,P006436,P009035,7.667,-1,9,10
216,RED,P006436,P009048,7.633,0,13,13
216,RED,P006436,P010588,3.95,-4,7,11
216,RED,P006436,P010612,4.45,0,11,11
216,RED,P006436,P011194,10.267,-4,20,24
216,RED,P006436,P012044,5.95,-2,11,13
216,RED,P007960,P009035,9.7,6,20,14
216,RED,P007960,P009048,13.15,2,21,19
216,RED,P007960,P010588,11.917,2,21,19
216,RED,P007960,P011194,3.584,0,5,5
216,RED,P009035,P009048,19.85,2,35,33
216,RED,P009035,P010588,8.617,4,18,14
216,RED,P009035,P010612,11.867,-5,20,25
216,RED,P009035,P011194,15.451,-4,24,28
216,RED,P009035,P012044,7.25,-2,9,11
216,RED,P009048,P010588,18.616,1,37,36
216,RED,P009048,P010612,10.967,3,24,21
216,RED,P009048,P011194,18.5,-5,34,39
216,RED,P009048,P012044,0.05,0,0,0
216,RED,P010588,P010612,2.733,5,9,4
216,RED,P010588,P011194,10.433,-3,19,22
216,RED,P010612,P011194,16.95,3,37,34
216,RED,P010612,P012044,5.983,0,13,13
216,RED,P011194,P012044,9.333,-1,15,16
217,IST,P004887,P006590,6.0,-2,11,13
217,IST,P004887,P006640,0.117,-3,0,3
217,IST,P004887,P007109,14.734,-7,21,28
217,IST,P004887,P009846,23.95,2,42,40
217,IST,P004887,P011078,23.518,3,42,39
217,IST,P004887,P012710,10.267,6,21,15
217,IST,P004887,P012742,7.701,-6,8,14
217,IST,P004887,P013363,13.717,3,23,20
217,IST,P006372,P006590,4.3,-3,7,10
217,IST,P006372,P007109,4.3,-3,7,10
217,IST,P006372,P012742,4.3,-3,7,10
217,IST,P006372,P012788,4.3,-3,7,10
217,IST,P006590,P007109,12.166,-2,25,27
217,IST,P006590,P009846,7.433,-1,16,17
217,IST,P006590,P011078,7.433,-1,16,17
217,IST,P006590,P012742,4.733,-1,9,10
217,IST,P006590,P012788,6.166,0,14,14
217,IST,P006590,P013363,0.433,2,2,0
217,IST,P006640,P007109,0.117,-3,0,3
217,IST,P006640,P011078,0.284,-3,0,3
217,IST,P006640,P012710,0.167,0,0,0
217,IST,P006640,P012742,0.284,-3,0,3
217,IST,P006640,P012788,0.167,0,0,0
217,IST,P007109,P009846,17.45,-3,30,33
217,IST,P007109,P011078,17.318,-4,30,34
217,IST,P007109,P012742,9.384,-10,9,19
217,IST,P007109,P012788,8.8,-2,18,20
217,IST,P007109,P013363,9.867,-2,16,18
217,IST,P009846,P011078,30.284,17,66,49
217,IST,P009846,P012710,14.317,16,36,20
217,IST,P009846,P012742,11.484,7,23,16
217,IST,P009846,P012788,7.817,11,24,13
217,IST,P009846,P013363,14.333,3,27,24
217,IST,P011078,P012710,16.468,15,40,25
217,IST,P011078,P012742,13.503,5,27,22
217,IST,P011078,P012788,10.268,8,28,20
217,IST,P011078,P013363,16.068,4,31,27
217,IST,P012710,P012742,10.335,10,27,17
217,IST,P012710,P012788,6.201,9,19,10
217,IST,P012710,P013363,8.117,4,17,13
217,IST,P012742,P012788,12.018,6,28,22
217,IST,P012742,P013363,5.134,-5,6,11
217,IST,P012788,P013363,4.267,-1,10,11
217,MAD,P003108,P003733,18.868,-6,35,41
217,MAD,P003108,P005791,15.183,-5,26,31
217,MAD,P003108,P005928,21.483,-2,39,41
217,MAD,P003108,P006540,7.3,-5,12,17
217,MAD,P003108,P007630,2.983,2,6,4
217,MAD,P003108,P011247,8.534,-5,14,19
217,MAD,P003108,P011649,14.45,-4,29,33
217,MAD,P003108,P013667,11.084,-4,21,25
217,MAD,P003108,PTGB,5.183,-7,6,13
217,MAD,P003733,P005791,7.901,-2,14,16
217,MAD,P003733,P005928,19.051,2,38,36
217,MAD,P003733,P006540,7.3,-5,12,17
217,MAD,P003733,P007630,6.551,-6,7,13
217,MAD,P003733,P011247,6.485,-11,7,18
217,MAD,P003733,P011649,12.652,5,31,26
217,MAD,P003733,P013666,2.817,-1,2,3
217,MAD,P003733,P013667,17.635,-7,31,38
217,MAD,P003733,PTGB,2.884,-5,3,8
217,MAD,P005791,P005928,12.433,-1,22,23
217,MAD,P005791,P006540,1.8,-1,0,1
217,MAD,P005791,P007630,10.167,8,22,14
217,MAD,P005791,P011247,11.884,5,26,21
217,MAD,P005791,P011649,15.517,-2,31,33
217,MAD,P005791,P013666,3.1,1,5,4
217,MAD,P005791,PTGB,11.483,1,22,21
217,MAD,P005928,P006540,7.3,-5,12,17
217,MAD,P005928,P007630,6.4,2,11,9
217,MAD,P005928,P011247,3.75,2,6,4
217,MAD,P005928,P011649,11.15,5,27,22
217,MAD,P005928,P013666,2.817,-1,2,3
217,MAD,P005928,P013667,12.584,2,25,23
217,MAD,P005928,PTGB,3.1,0,6,6
217,MAD,P006540,P007630,1.8,-1,0,1
217,MAD,P006540,P013666,1.8,-1,0,1
217,MAD,P006540,P013667,7.3,-5,12,17
217,MAD,P006540,PTGB,1.8,-1,0,1
217,MAD,P007630,P011247,10.751,3,24,21
217,MAD,P007630,P011649,6.334,6,16,10
217,MAD,P007630,P013666,5.917,0,7,7
217,MAD,P007630,P013667,6.434,-6,7,13
217,MAD,P007630,PTGB,9.067,0,16,16
217,MAD,P011247,P011649,9.118,0,21,21
217,MAD,P011247,P013666,1.3,2,5,3
217,MAD,P011247,P013667,5.051,-9,6,15
217,MAD,P011247,PTGB,10.867,-3,19,22
217,MAD,P011649,P013667,4.751,7,17,10
217,MAD,P011649,PTGB,7.1,3,20,17
217,MAD,P013666,P013667,2.817,-1,2,3
217,MAD,P013666,PTGB,3.1,1,5,4
217,MAD,P013667,PTGB,2.884,-5,3,8
218,BER,P006251,P006919,7.483,1,12,11
218,BER,P006251,P008062,7.716,-1,10,11
218,BER,P006251,P008173,6.584,1,14,13
218,BER,P006251,P008211,7.15,-1,12,13
218,BER,P006251,P008967,13.967,0,24,24
218,BER,P006251,P011934,3.617,-1,2,3
218,BER,P006251,P013386,10.683,1,22,21
218,BER,P006919,P007025,8.684,-11,8,19
218,BER,P006919,P008062,15.016,-8,18,26
218,BER,P006919,P008173,4.901,-8,6,14
218,BER,P006919,P008211,1.849,0,0,0
218,BER,P006919,P008967,9.384,-5,16,21
218,BER,P006919,P011626,2.4,-3,2,5
218,BER,P006919,P011631,10.034,-14,10,24
218,BER,P006919,P011934,11.984,-13,10,23
218,BER,P006919,P013386,7.933,-3,14,17
218,BER,P007025,P008062,6.767,-7,8,15
218,BER,P007025,P008173,9.001,-5,12,17
218,BER,P007025,P008211,6.267,-2,10,12
218,BER,P007025,P008967,0.217,0,0,0
218,BER,P007025,P011626,9.267,-4,14,18
218,BER,P007025,P011631,7.101,-7,8,15
218,BER,P007025,P011934,13.268,-11,16,27
218,BER,P007025,P013386,2.5,-1,4,5
218,BER,P008062,P008173,2.55,-2,2,4
218,BER,P008062,P008211,6.766,-3,5,8
218,BER,P008062,P008967,9.367,-1,15,16
218,BER,P008062,P011626,0.6,1,2,1
218,BER,P008062,P011631,12.817,-9,15,24
218,BER,P008062,P011934,10.867,-9,8,17
218,BER,P008062,P013386,9.666,-1,17,18
218,BER,P008173,P008211,16.901,-4,24,28
218,BER,P008173,P008967,10.685,-5,16,21
218,BER,P008173,P011626,8.667,-5,12,17
218,BER,P008173,P011631,6.768,-8,4,12
218,BER,P008173,P011934,14.318,-10,16,26
218,BER,P008173,P013386,7.701,-2,14,16
218,BER,P008211,P008967,10.451,-1,15,16
218,BER,P008211,P011626,6.267,-2,10,12
218,BER,P008211,P011631,7.7,-2,5,7
218,BER,P008211,P011934,10.867,-4,12,16
218,BER,P008211,P013386,10.25,-1,15,16
218,BER,P008967,P011631,6.085,-6,7,13
218,BER,P008967,P011934,6.601,-4,4,8
218,BER,P008967,P013386,13.451,-2,27,29
218,BER,P011626,P011631,0.6,1,2,1
218,BER,P011626,P011934,8.667,-5,12,17
218,BER,P011626,P013386,0.6,1,2,1
218,BER,P011631,P011934,10.351,-11,8,19
218,BER,P011631,P013386,6.684,-4,9,13
218,ZAL,P002329,P002676,19.417,12,38,26
218,ZAL,P002329,P003048,15.299,7,33,26
218,ZAL,P002329,P003210,7.65,-4,11,15
218,ZAL,P002329,P005504,10.767,12,21,9
218,ZAL,P002329,P007029,5.766,5,14,9
218,ZAL,P002329,P007975,18.416,23,43,20
218,ZAL,P002329,P011983,19.05,15,40,25
218,ZAL,P002329,P013403,7.899,6,16,10
218,ZAL,P002676,P003048,10.883,2,21,19
218,ZAL,P002676,P003210,5.733,-6,7,13
218,ZAL,P002676,P005504,10.767,12,21,9
218,ZAL,P002676,P007975,17.034,16,35,19
218,ZAL,P002676,P011051,1.117,-4,0,4
218,ZAL,P002676,P011983,18.651,9,38,29
218,ZAL,P002676,P012622,3.35,-2,4,6
218,ZAL,P002676,P013403,4.116,1,4,3
218,ZAL,P003048,P003210,6.166,-4,10,14
218,ZAL,P003048,P007029,7.016,6,15,9
218,ZAL,P003048,P007975,12.616,14,28,14
218,ZAL,P003048,P011983,8.283,3,19,16
218,ZAL,P003048,P012622,3.483,3,5,2
218,ZAL,P003048,P013403,11.382,9,21,12
218,ZAL,P003210,P005504,4.9,1,8,7
218,ZAL,P003210,P007029,6.033,3,11,8
218,ZAL,P003210,P011051,3.2,1,5,4
218,ZAL,P003210,P011330,2.5,1,5,4
218,ZAL,P003210,P011983,7.5,-5,10,15
218,ZAL,P003210,P012622,6.616,2,12,10
218,ZAL,P003210,P013403,6.766,3,13,10
218,ZAL,P005504,P007029,3.05,0,4,4
218,ZAL,P005504,P007975,11.417,12,22,10
218,ZAL,P005504,P011330,2.5,1,5,4
218,ZAL,P005504,P011983,13.267,13,26,13
218,ZAL,P005504,P012622,5.55,1,9,8
218,ZAL,P005504,P013403,3.05,0,4,4
218,ZAL,P007029,P007975,7.816,4,13,9
218,ZAL,P007029,P011051,3.783,1,5,4
218,ZAL,P007029,P011983,1.216,0,0,0
218,ZAL,P007029,P012622,8.083,2,10,8
218,ZAL,P007029,P013403,12.633,7,24,17
218,ZAL,P007975,P011051,1.7,-4,0,4
218,ZAL,P007975,P011983,15.75,17,35,18
218,ZAL,P007975,P012622,7.317,-1,7,8
218,ZAL,P007975,P013403,10.866,7,17,10
218,ZAL,P011051,P011983,1.7,-4,0,4
218,ZAL,P011051,P012622,4.9,-3,5,8
218,ZAL,P011051,P013403,3.2,1,5,4
218,ZAL,P011330,P011983,2.5,1,5,4
218,ZAL,P011330,P012622,2.5,1,5,4
218,ZAL,P011983,P012622,4.2,-3,5,8
218,ZAL,P011983,P013403,0.883,2,2,0
218,ZAL,P012622,P013403,9.733,4,14,10
219,ASV,P000229,P002100,2.166,4,6,2
219,ASV,P000229,P003526,0.217,0,0,0
219,ASV,P000229,P004194,9.583,0,16,16
219,ASV,P000229,P007027,8.75,2,16,14
219,ASV,P000229,P009818,3.25,-3,4,7
219,ASV,P000229,P010316,0.15,-2,0,2
219,ASV,P000229,P011225,4.633,-1,6,7
219,ASV,P000229,P013371,3.25,-3,4,7
219,ASV,P000229,P013405,6.333,3,12,9
219,ASV,P002100,P003526,1.767,-2,0,2
219,ASV,P002100,P004194,4.299,1,9,8
219,ASV,P002100,P007027,11.133,16,29,13
219,ASV,P002100,P009818,14.282,-7,28,35
219,ASV,P002100,P010316,4.866,-8,5,13
219,ASV,P002100,P010545,12.733,1,23,22
219,ASV,P002100,P011225,6.2,5,14,9
219,ASV,P002100,P013371,8.366,-11,11,22
219,ASV,P002100,P013405,13.716,13,35,22
219,ASV,P003526,P004194,11.417,-1,16,17
219,ASV,P003526,P007027,10.784,0,16,16
219,ASV,P003526,P009818,0.467,0,0,0
219,ASV,P003526,P010545,1.134,-1,0,1
219,ASV,P003526,P011225,10.567,0,16,16
219,ASV,P003526,P013371,1.767,-2,0,2
219,ASV,P003526,P013405,12.084,-2,16,18
219,ASV,P004194,P007027,20.783,-3,32,35
219,ASV,P004194,P009818,4.083,-4,7,11
219,ASV,P004194,P010316,1.35,-5,0,5
219,ASV,P004194,P011225,16.666,-6,22,28
219,ASV,P004194,P013371,6.316,-9,7,16
219,ASV,P004194,P013405,20.499,-5,31,36
219,ASV,P007027,P009818,9.25,3,21,18
219,ASV,P007027,P010316,2.9,-6,1,7
219,ASV,P007027,P010545,7.617,8,15,7
219,ASV,P007027,P011225,23.15,0,36,36
219,ASV,P007027,P013371,3.35,-4,4,8
219,ASV,P007027,P013405,27.283,8,50,42
219,ASV,P009818,P010316,4.866,-8,5,13
219,ASV,P009818,P010545,9.766,-5,17,22
219,ASV,P009818,P011225,3.233,-1,8,9
219,ASV,P009818,P013371,9.483,-10,15,25
219,ASV,P009818,P013405,8.116,3,23,20
219,ASV,P010316,P010545,4.866,-8,5,13
219,ASV,P010316,P011225,1.583,-5,0,5
219,ASV,P010316,P013371,2.933,-5,4,9
219,ASV,P010316,P013405,1.35,-5,0,5
219,ASV,P010545,P011225,4.017,3,6,3
219,ASV,P010545,P013371,5.4,-6,8,14
219,ASV,P010545,P013405,8.067,8,18,10
219,ASV,P011225,P013371,0.933,-3,0,3
219,ASV,P011225,P013405,23.15,0,36,36
219,ASV,P013371,P013405,5.066,-7,7,14
219,RED,P000848,P002553,5.0,-1,7,8
219,RED,P000848,P004866,10.816,-5,13,18
219,RED,P000848,P006436,1.683,3,3,0
219,RED,P000848,P007960,2.217,5,7,2
219,RED,P000848,P009035,7.316,-2,10,12
219,RED,P000848,P009048,12.316,-3,17,20
219,RED,P000848,P010588,6.483,2,10,8
219,RED,P000848,P010612,0.833,-4,0,4
219,RED,P000848,P011194,1.2,3,3,0
219,RED,P000848,P012044,6.2,2,10,8
219,RED,P002553,P004866,3.983,-3,3,6
219,RED,P002553,P006436,3.85,1,6,5
219,RED,P002553,P007960,4.867,3,10,7
219,RED,P002553,P009048,7.05,5,13,8
219,RED,P002553,P010612,3.35,1,6,5
219,RED,P002553,P012044,7.3,-6,7,13
219,RED,P004007,P004866,5.25,-4,7,11
219,RED,P004007,P006436,0.516,0,0,0
219,RED,P004007,P007960,0.383,0,0,0
219,RED,P004007,P009035,7.45,-5,10,15
219,RED,P004007,P009048,5.117,-4,7,11
219,RED,P004007,P010588,8.45,-8,11,19
219,RED,P004007,P010612,3.583,-4,4,8
219,RED,P004007,P011194,1.383,-3,1,4
219,RED,P004007,P012044,3.2,-4,4,8
219,RED,P004866,P006436,3.533,1,10,9
219,RED,P004866,P009035,18.133,6,37,31
219,RED,P004866,P009048,22.566,-1,40,41
219,RED,P004866,P010588,16.25,2,30,28
219,RED,P004866,P010612,5.583,2,13,11
219,RED,P004866,P011194,2.1,-5,3,8
219,RED,P004866,P012044,8.65,-1,16,17
219,RED,P006436,P007960,10.85,10,21,11
219,RED,P006436,P009035,6.282,6,16,10
219,RED,P006436,P009048,7.1,6,16,10
219,RED,P006436,P010588,1.282,2,4,2
219,RED,P006436,P010612,9.383,8,19,11
219,RED,P006436,P011194,4.967,5,10,5
219,RED,P006436,P012044,10.95,6,23,17
219,RED,P007960,P009035,3.333,2,7,5
219,RED,P007960,P009048,4.234,7,10,3
219,RED,P007960,P010612,9.15,7,18,11
219,RED,P007960,P011194,3.667,7,8,1
219,RED,P007960,P012044,8.767,7,19,12
219,RED,P009035,P009048,18.933,3,35,32
219,RED,P009035,P010588,17.983,5,33,28
219,RED,P009035,P010612,10.166,7,23,16
219,RED,P009035,P012044,6.4,10,21,11
219,RED,P009048,P010588,15.083,3,27,24
219,RED,P009048,P010612,6.783,8,16,8
219,RED,P009048,P011194,1.3,-2,2,4
219,RED,P009048,P012044,8.65,2,17,15
219,RED,P010588,P010612,8.0,0,15,15
219,RED,P010588,P011194,2.183,-6,2,8
219,RED,P010588,P012044,4.95,-4,8,12
219,RED,P010612,P011194,4.65,-2,7,9
219,RED,P010612,P012044,11.183,1,23,22
219,RED,P011194,P012044,7.15,-1,12,13
220,PAN,P001926,P004088,15.934,4,44,40
220,PAN,P001926,P005161,4.117,4,8,4
220,PAN,P001926,P007866,15.151,2,33,31
220,PAN,P001926,P009622,8.017,0,13,13
220,PAN,P001926,P011204,10.467,6,26,20
220,PAN,P001926,P011209,0.3,-1,2,3
220,PAN,P001926,P012712,26.584,5,65,60
220,PAN,P001926,P012774,15.133,-1,39,40
220,PAN,P001926,P013383,10.633,1,30,29
220,PAN,P004088,P005161,7.367,4,18,14
220,PAN,P004088,P007866,7.134,2,20,18
220,PAN,P004088,P011204,21.251,1,44,43
220,PAN,P004088,P011209,1.017,-5,2,7
220,PAN,P004088,P012712,21.984,-4,52,56
220,PAN,P004088,P012774,21.3,2,52,50
220,PAN,P004088,P013383,21.417,-4,48,52
220,PAN,P005161,P007866,4.117,4,8,4
220,PAN,P005161,P009622,4.117,4,8,4
220,PAN,P005161,P011204,7.367,4,18,14
220,PAN,P005161,P012712,4.117,4,8,4
220,PAN,P005161,P012774,7.367,4,18,14
220,PAN,P005161,P013383,7.367,4,18,14
220,PAN,P007866,P009622,8.017,0,13,13
220,PAN,P007866,P011204,6.117,3,16,13
220,PAN,P007866,P011209,0.3,-1,2,3
220,PAN,P007866,P012712,15.151,2,33,31
220,PAN,P007866,P012774,4.617,-4,7,11
220,PAN,P009622,P012712,8.017,0,13,13
220,PAN,P009622,P012774,3.9,-4,5,9
220,PAN,P011204,P011209,0.717,-4,0,4
220,PAN,P011204,P012712,16.517,-2,34,36
220,PAN,P011204,P012774,16.133,3,36,33
220,PAN,P011204,P013383,16.967,-3,34,37
220,PAN,P011209,P012712,1.017,-5,2,7
220,PAN,P011209,P013383,0.717,-4,0,4
220,PAN,P012712,P012774,20.466,-5,47,52
220,PAN,P012712,P013383,16.683,-7,38,45
220,PAN,P012774,P013383,22.416,1,56,55
220,ULK,P002849,P004004,5.632,-11,4,15
220,ULK,P002849,P005216,3.25,-4,2,6
220,ULK,P002849,P006961,3.35,-1,4,5
220,ULK,P002849,P007182,3.55,-2,4,6
220,ULK,P002849,P008104,1.533,-5,2,7
220,ULK,P002849,P008962,4.899,-10,4,14
220,ULK,P002849,P009783,5.399,-9,6,15
220,ULK,P002849,P011205,6.183,-6,6,12
220,ULK,P002968,P004004,15.567,4,37,33
220,ULK,P002968,P005216,11.166,10,33,23
220,ULK,P002968,P006961,3.667,2,12,10
220,ULK,P002968,P008104,7.6,-1,15,16
220,ULK,P002968,P008962,20.25,8,47,39
220,ULK,P002968,P009783,18.05,6,39,33
220,ULK,P002968,P011205,15.3,11,41,30
220,ULK,P004004,P005216,6.666,3,19,16
220,ULK,P004004,P006961,3.433,-2,8,10
220,ULK,P004004,P007182,2.716,-6,2,8
220,ULK,P004004,P008104,9.133,-6,17,23
220,ULK,P004004,P008962,22.649,-8,46,54
220,ULK,P004004,P009783,16.499,-13,24,37
220,ULK,P004004,P011205,11.633,3,27,24
220,ULK,P005216,P006961,14.034,2,37,35
220,ULK,P005216,P007182,11.417,-4,25,29
220,ULK,P005216,P008962,16.983,11,50,39
220,ULK,P005216,P009783,7.666,5,19,14
220,ULK,P005216,P011205,20.35,13,59,46
220,ULK,P006961,P007182,11.167,-3,27,30
220,ULK,P006961,P008962,10.3,1,29,28
220,ULK,P006961,P009783,3.033,2,11,9
220,ULK,P006961,P011205,13.684,7,40,33
220,ULK,P007182,P008962,8.35,-2,23,25
220,ULK,P007182,P009783,1.216,-1,2,3
220,ULK,P007182,P011205,9.184,2,25,23
220,ULK,P008104,P008962,9.133,-6,17,23
220,ULK,P008104,P009783,9.133,-6,17,23
220,ULK,P008962,P009783,19.949,-8,34,42
220,ULK,P008962,P011205,22.683,10,58,48
220,ULK,P009783,P011205,13.583,4,28,24
221,MIL,P001518,P005670,2.017,-4,2,6
221,MIL,P001518,P006085,2.067,2,5,3
221,MIL,P001518,P006509,8.218,-1,15,16
221,MIL,P001518,P006721,2.6,3,8,5
221,MIL,P001518,P007831,13.718,-8,22,30
221,MIL,P001518,P008985,12.701,0,26,26
221,MIL,P001518,P008987,11.701,-4,20,24
221,MIL,P001518,P011064,8.567,-1,18,19
221,MIL,P001518,P011941,0.467,3,3,0
221,MIL,P001518,P013384,3.067,6,11,5
221,MIL,P001518,P013385,2.017,-4,2,6
221,MIL,P005670,P006509,4.95,1,10,9
221,MIL,P005670,P006721,4.183,2,8,6
221,MIL,P005670,P007831,2.017,-4,2,6
221,MIL,P005670,P011064,1.25,-3,0,3
221,MIL,P005670,P013384,4.183,2,8,6
221,MIL,P005670,P013385,6.2,-2,10,12
221,MIL,P006085,P006509,11.234,-7,21,28
221,MIL,P006085,P006721,10.5,-5,21,26
221,MIL,P006085,P007831,1.583,-5,0,5
221,MIL,P006085,P008985,0.483,0,0,0
221,MIL,P006085,P008987,6.75,-8,8,16
221,MIL,P006085,P011941,4.117,-3,8,11
221,MIL,P006085,P013384,10.134,-2,21,23
221,MIL,P006509,P006721,14.9,-2,32,34
221,MIL,P006509,P007831,6.084,-12,4,16
221,MIL,P006509,P008985,5.384,-2,8,10
221,MIL,P006509,P008987,10.484,-14,10,24
221,MIL,P006509,P011941,4.584,0,11,11
221,MIL,P006509,P013384,15.484,4,35,31
221,MIL,P006509,P013385,4.95,1,10,9
221,MIL,P006721,P007831,2.183,-8,0,8
221,MIL,P006721,P008985,1.95,-2,3,5
221,MIL,P006721,P008987,6.3,-9,8,17
221,MIL,P006721,P011064,0.767,-3,0,3
221,MIL,P006721,P011941,3.067,-1,8,9
221,MIL,P006721,P013384,13.967,3,32,29
221,MIL,P006721,P013385,4.183,2,8,6
221,MIL,P007831,P008985,21.401,-12,33,45
221,MIL,P007831,P008987,22.501,-17,33,50
221,MIL,P007831,P011064,17.951,-9,31,40
221,MIL,P007831,P011941,8.617,-5,13,18
221,MIL,P007831,P013385,2.017,-4,2,6
221,MIL,P008985,P008987,21.401,-12,33,45
221,MIL,P008985,P011064,16.701,-6,31,37
221,MIL,P008985,P011941,9.084,-2,16,18
221,MIL,P008985,P013384,1.167,4,6,2
221,MIL,P008987,P011064,16.701,-6,31,37
221,MIL,P008987,P011941,9.667,-7,13,20
221,MIL,P008987,P013384,5.167,-3,8,11
221,MIL,P011064,P011941,8.617,-5,13,18
221,MIL,P011064,P013385,1.25,-3,0,3
221,MIL,P011941,P013384,4.584,0,11,11
221,MIL,P013384,P013385,4.183,2,8,6
221,MUN,P001288,P001557,10.184,14,26,12
221,MUN,P001288,P004508,12.467,9,27,18
221,MUN,P001288,P005460,2.583,-4,5,9
221,MUN,P001288,P007201,19.584,19,45,26
221,MUN,P001288,P007639,4.917,2,11,9
221,MUN,P001288,P010391,21.334,19,50,31
221,MUN,P001288,P011244,11.484,11,25,14
221,MUN,P001288,P011987,15.451,14,35,21
221,MUN,P001557,P004508,19.818,3,41,38
221,MUN,P001557,P005460,3.151,-5,6,11
221,MUN,P001557,P007201,13.801,13,39,26
221,MUN,P001557,P007639,8.75,-1,13,14
221,MUN,P001557,P010391,15.667,13,40,27
221,MUN,P001557,P011244,9.467,0,18,18
221,MUN,P001557,P011987,13.801,3,29,26
221,MUN,P001557,P012123,1.517,-1,2,3
221,MUN,P001557,P013368,1.984,-3,2,5
221,MUN,P004508,P005460,5.734,-9,11,20
221,MUN,P004508,P007201,14.617,8,36,28
221,MUN,P004508,P007639,11.367,0,20,20
221,MUN,P004508,P010391,17.633,9,40,31
221,MUN,P004508,P011244,14.784,6,30,24
221,MUN,P004508,P011987,11.951,-2,23,25
221,MUN,P004508,P012123,1.517,-1,2,3
221,MUN,P004508,P013368,1.984,-3,2,5
221,MUN,P005460,P007201,3.45,-4,9,13
221,MUN,P005460,P007639,0.3,-2,0,2
221,MUN,P005460,P010391,2.283,-2,5,7
221,MUN,P005460,P011987,1.934,-6,4,10
221,MUN,P005460,P012123,1.517,-1,2,3
221,MUN,P005460,P013368,1.984,-3,2,5
221,MUN,P007201,P010391,25.484,22,61,39
221,MUN,P007201,P011244,15.284,10,33,23
221,MUN,P007201,P011987,14.384,12,37,25
221,MUN,P007639,P010391,4.183,-1,8,9
221,MUN,P007639,P011244,6.817,2,13,11
221,MUN,P007639,P011987,9.134,0,15,15
221,MUN,P010391,P011244,16.917,11,36,25
221,MUN,P010391,P011987,15.167,13,36,23
221,MUN,P011244,P011987,13.651,8,29,21
221,MUN,P011987,P013368,0.467,-2,0,2
221,MUN,P012123,P013368,1.517,-1,2,3
222,BAS,P004058,P007230,0.75,-2,0,2
222,BAS,P004058,P011085,3.3,-9,0,9
222,BAS,P004058,P011196,3.3,-9,0,9
222,BAS,P004058,P011948,3.017,-9,0,9
222,BAS,P004058,P012201,2.55,-7,0,7
222,BAS,P004058,P012597,0.283,0,0,0
222,BAS,P007230,P007579,8.233,-7,17,24
222,BAS,P007230,P011085,2.3,-6,3,9
222,BAS,P007230,P011196,2.3,-5,2,7
222,BAS,P007230,P011948,5.967,-9,12,21
222,BAS,P007230,P012201,6.467,-4,12,16
222,BAS,P007230,P012597,3.683,-2,5,7
222,BAS,P007230,P013367,8.9,-9,17,26
222,BAS,P007579,P011085,2.183,-3,5,8
222,BAS,P007579,P011196,1.233,-1,2,3
222,BAS,P007579,P011948,4.9,-5,12,17
222,BAS,P007579,P012080,8.65,6,27,21
222,BAS,P007579,P012201,15.117,2,39,37
222,BAS,P007579,P012597,11.383,5,30,25
222,BAS,P007579,P013367,17.233,-1,44,45
222,BAS,P011085,P011196,17.833,-8,34,42
222,BAS,P011085,P011948,4.567,-13,3,16
222,BAS,P011085,P012080,12.233,-2,26,28
222,BAS,P011085,P012201,17.716,-5,36,41
222,BAS,P011085,P012597,4.799,1,12,11
222,BAS,P011085,P013367,15.133,1,37,36
222,BAS,P011196,P011948,4.034,-11,0,11
222,BAS,P011196,P012080,15.866,1,31,30
222,BAS,P011196,P012201,21.349,-2,41,43
222,BAS,P011196,P012597,10.965,2,21,19
222,BAS,P011196,P013367,19.116,5,41,36
222,BAS,P011948,P012201,5.934,-10,9,19
222,BAS,P011948,P012597,0.35,0,0,0
222,BAS,P011948,P013367,5.567,-7,12,19
222,BAS,P012080,P012201,24.516,7,58,51
222,BAS,P012080,P012597,13.866,6,34,28
222,BAS,P012080,P013367,22.933,10,56,46
222,BAS,P012201,P012597,19.882,9,47,38
222,BAS,P012201,P013367,32.333,10,78,68
222,BAS,P012597,P013367,19.249,11,47,36
222,MCO,P001932,P002581,6.184,5,19,14
222,MCO,P001932,P004790,11.133,-9,22,31
222,MCO,P001932,P005844,19.05,0,42,42
222,MCO,P001932,P005985,26.134,4,62,58
222,MCO,P001932,P008099,12.601,5,31,26
222,MCO,P001932,P008161,0.35,0,0,0
222,MCO,P001932,P011226,21.067,-9,40,49
222,MCO,P001932,P011231,13.701,17,42,25
222,MCO,P001932,P012515,8.667,7,25,18
222,MCO,P001932,PLCZ,5.517,0,13,13
222,MCO,P002581,P005985,5.017,-1,14,15
222,MCO,P002581,P008099,12.501,9,33,24
222,MCO,P002581,P011226,7.367,2,14,12
222,MCO,P002581,P011231,11.451,11,33,22
222,MCO,P002581,P012515,7.484,10,19,9
222,MCO,P004790,P005844,10.783,-9,22,31
222,MCO,P004790,P005985,11.133,-9,22,31
222,MCO,P004790,P008161,0.35,0,0,0
222,MCO,P004790,P011226,11.133,-9,22,31
222,MCO,P005844,P005985,19.617,1,43,42
222,MCO,P005844,P008099,2.334,0,3,3
222,MCO,P005844,P011226,15.584,-7,31,38
222,MCO,P005844,P011231,8.267,12,21,9
222,MCO,P005844,P012515,2.833,7,10,3
222,MCO,P005985,P008099,13.518,-1,30,31
222,MCO,P005985,P008161,0.35,0,0,0
222,MCO,P005985,P011226,25.401,-10,51,61
222,MCO,P005985,P011231,14.151,10,38,28
222,MCO,P005985,P012515,5.717,3,16,13
222,MCO,P005985,PLCZ,7.034,-1,16,17
222,MCO,P008099,P011226,15.168,-1,28,29
222,MCO,P008099,P011231,13.218,13,36,23
222,MCO,P008099,P012515,10.001,5,22,17
222,MCO,P008099,PLCZ,6.667,-2,13,15
222,MCO,P008161,P011226,0.35,0,0,0
222,MCO,P011226,P011231,10.551,8,23,15
222,MCO,P011226,P012515,6.584,0,10,10
222,MCO,P011226,PLCZ,6.667,-2,13,15
222,MCO,P011231,P012515,10.134,18,32,14
222,MCO,P011231,PLCZ,0.867,-1,3,4
222,MCO,P012515,PLCZ,3.384,-6,6,12
223,BAR,P002939,P003196,1.883,-1,3,4
223,BAR,P002939,P003478,14.883,11,43,32
223,BAR,P002939,P006568,14.133,11,41,30
223,BAR,P002939,P009862,17.049,8,44,36
223,BAR,P002939,P009992,2.333,-1,1,2
223,BAR,P002939,P010106,0.15,0,0,0
223,BAR,P002939,P012745,18.249,9,45,36
223,BAR,P002939,P012795,2.483,0,2,2
223,BAR,P002939,P013379,2.433,-1,1,2
223,BAR,P003196,P003478,2.366,1,7,6
223,BAR,P003196,P007464,2.966,8,13,5
223,BAR,P003196,P009862,8.983,6,23,17
223,BAR,P003196,P009992,10.717,13,31,18
223,BAR,P003196,P010106,18.85,20,53,33
223,BAR,P003196,P011666,0.983,0,2,2
223,BAR,P003196,P012745,7.999,6,23,17
223,BAR,P003196,P012795,15.301,10,36,26
223,BAR,P003196,P013379,12.684,13,33,20
223,BAR,P003478,P006568,13.8,11,41,30
223,BAR,P003478,P009862,16.166,12,48,36
223,BAR,P003478,P010106,1.283,1,5,4
223,BAR,P003478,P012745,16.166,12,48,36
223,BAR,P006568,P007464,2.8,0,2,2
223,BAR,P006568,P009862,14.133,11,41,30
223,BAR,P006568,P009992,2.8,0,2,2
223,BAR,P006568,P011666,2.8,0,2,2
223,BAR,P006568,P012745,15.266,9,41,32
223,BAR,P006568,P012795,2.0,2,2,0
223,BAR,P007464,P009862,1.983,8,11,3
223,BAR,P007464,P009992,2.8,0,2,2
223,BAR,P007464,P010106,2.966,8,13,5
223,BAR,P007464,P011666,3.783,0,4,4
223,BAR,P007464,P012745,4.099,6,13,7
223,BAR,P007464,P012795,1.667,2,2,0
223,BAR,P009862,P009992,0.983,-2,0,2
223,BAR,P009862,P010106,7.25,7,20,13
223,BAR,P009862,P012745,22.132,15,62,47
223,BAR,P009862,P012795,5.067,-3,5,8
223,BAR,P009862,P013379,3.05,-2,2,4
223,BAR,P009992,P010106,10.717,13,31,18
223,BAR,P009992,P011666,2.8,0,2,2
223,BAR,P009992,P012745,3.416,-3,1,4
223,BAR,P009992,P012795,13.634,16,34,18
223,BAR,P009992,P013379,13.0,12,32,20
223,BAR,P010106,P011666,0.983,0,2,2
223,BAR,P010106,P012745,6.166,7,20,13
223,BAR,P010106,P012795,14.651,11,35,24
223,BAR,P010106,P013379,12.784,13,33,20
223,BAR,P011666,P012745,2.116,-2,2,4
223,BAR,P011666,P012795,1.667,2,2,0
223,BAR,P012745,P012795,4.3,-2,4,6
223,BAR,P012745,P013379,2.283,-1,1,2
223,BAR,P012795,P013379,14.034,14,34,20
223,TEL,P004233,P007519,3.25,0,7,7
223,TEL,P004233,P011202,2.9,-8,0,8
223,TEL,P004233,P011219,4.917,-2,7,9
223,TEL,P004233,P011433,6.15,-8,7,15
223,TEL,P004233,P012604,6.15,-8,7,15
223,TEL,P004233,P013381,1.233,-6,0,6
223,TEL,P005145,P007519,0.05,-2,0,2
223,TEL,P005145,P007990,6.45,-7,15,22
223,TEL,P005145,P011193,6.45,-7,15,22
223,TEL,P005145,P011202,3.583,1,9,8
223,TEL,P005145,P011214,4.117,-5,9,14
223,TEL,P005145,P012604,2.333,-2,6,8
223,TEL,P005145,P013381,2.817,-6,6,12
223,TEL,P007519,P007990,5.934,2,13,11
223,TEL,P007519,P011193,10.983,-9,27,36
223,TEL,P007519,P011202,4.234,1,4,3
223,TEL,P007519,P011214,15.366,-6,32,38
223,TEL,P007519,P011219,22.384,-4,47,51
223,TEL,P007519,P011433,4.333,1,9,8
223,TEL,P007519,P012604,9.234,2,19,17
223,TEL,P007519,P013381,0.617,0,0,0
223,TEL,P007519,P013382,17.683,-5,38,43
223,TEL,P007990,P011193,12.518,-18,20,38
223,TEL,P007990,P011202,7.484,-3,13,16
223,TEL,P007990,P011214,11.068,-13,17,30
223,TEL,P007990,P011219,9.518,-4,15,19
223,TEL,P007990,P011433,0.1,0,0,0
223,TEL,P007990,P012604,8.351,-1,19,20
223,TEL,P007990,P013381,5.868,-9,9,18
223,TEL,P007990,P013382,6.317,-3,11,14
223,TEL,P011193,P011202,6.684,-5,11,16
223,TEL,P011193,P011214,21.018,-23,41,64
223,TEL,P011193,P011219,14.567,-15,29,44
223,TEL,P011193,P011433,1.217,0,2,2
223,TEL,P011193,P012604,4.567,-2,11,13
223,TEL,P011193,P013381,6.368,-9,11,20
223,TEL,P011193,P013382,13.9,-12,29,41
223,TEL,P011202,P011214,5.551,-4,3,7
223,TEL,P011202,P011219,6.668,-4,4,8
223,TEL,P011202,P011433,4.017,-8,2,10
223,TEL,P011202,P012604,8.267,-8,12,20
223,TEL,P011202,P013381,3.567,-9,2,11
223,TEL,P011202,P013382,2.317,-1,0,1
223,TEL,P011214,P011219,17.867,-13,32,45
223,TEL,P011214,P011433,1.083,1,2,1
223,TEL,P011214,P012604,2.2,1,5,4
223,TEL,P011214,P013381,5.151,-9,9,18
223,TEL,P011214,P013382,18.183,-9,34,43
223,TEL,P011219,P011433,4.917,-2,7,9
223,TEL,P011219,P012604,9.818,-1,17,18
223,TEL,P011219,P013381,0.617,0,0,0
223,TEL,P011219,P013382,19.467,-11,38,49
223,TEL,P011433,P012604,8.35,-7,11,18
223,TEL,P011433,P013381,2.45,-6,2,8
223,TEL,P011433,P013382,1.183,1,2,1
223,TEL,P012604,P013381,4.084,-6,5,11
223,TEL,P012604,P013382,3.45,0,8,8
223,TEL,P013381,P013382,0.1,0,0,0
224,OLY,P001255,P003469,22.383,23,59,36
224,OLY,P001255,P003941,18.0,-1,32,33
224,OLY,P001255,P007853,6.567,-8,6,14
224,OLY,P001255,P007982,22.383,23,59,36
224,OLY,P001255,P008811,8.5,17,29,12
224,OLY,P001255,P008829,4.067,-7,2,9
224,OLY,P001255,P010392,1.4,-5,0,5
224,OLY,P001255,P011965,0.05,0,0,0
224,OLY,P001255,P013380,22.65,22,57,35
224,OLY,P003469,P003941,13.933,6,30,24
224,OLY,P003469,P007853,10.067,-9,17,26
224,OLY,P003469,P007982,30.0,15,72,57
224,OLY,P003469,P008811,16.067,9,42,33
224,OLY,P003469,P013380,27.55,16,68,52
224,OLY,P003941,P007853,8.684,-9,10,19
224,OLY,P003941,P007982,16.1,5,34,29
224,OLY,P003941,P008829,6.234,-8,6,14
224,OLY,P003941,P010392,3.517,-6,4,10
224,OLY,P003941,P013380,14.2,5,28,23
224,OLY,P007853,P007982,15.951,0,33,33
224,OLY,P007853,P008811,11.384,2,25,23
224,OLY,P007853,P008829,9.951,2,18,16
224,OLY,P007853,P010392,7.284,4,16,12
224,OLY,P007853,P011965,0.05,0,0,0
224,OLY,P007853,P013380,10.334,-10,15,25
224,OLY,P007982,P008811,19.784,19,54,35
224,OLY,P007982,P008829,5.884,9,16,7
224,OLY,P007982,P010392,5.884,9,16,7
224,OLY,P007982,P013380,27.55,16,68,52
224,OLY,P008811,P008829,3.717,10,12,2
224,OLY,P008811,P010392,3.767,10,12,2
224,OLY,P008811,P011965,0.05,0,0,0
224,OLY,P008811,P013380,16.067,9,42,33
224,OLY,P008829,P010392,7.234,4,16,12
224,OLY,P008829,P013380,2.717,-2,2,4
224,OLY,P010392,P011965,0.05,0,0,0
224,PRS,P004197,P004512,5.7,-10,10,20
224,PRS,P004197,P005793,8.267,-9,10,19
224,PRS,P004197,P007032,11.25,-18,13,31
224,PRS,P004197,P010390,2.267,1,3,2
224,PRS,P004197,P012613,0.2,0,0,0
224,PRS,P004197,P012640,11.25,-18,13,31
224,PRS,P004197,P013373,6.066,-18,3,21
224,PRS,P004512,P005793,4.134,0,10,10
224,PRS,P004512,P007032,5.7,-10,10,20
224,PRS,P004512,P012608,2.283,5,5,0
224,PRS,P004512,P012610,2.283,5,5,0
224,PRS,P004512,P012611,1.417,1,3,2
224,PRS,P004512,P012613,2.283,5,5,0
224,PRS,P004512,P012640,9.4,-4,18,22
224,PRS,P004512,P013373,4.4,-8,6,14
224,PRS,P005793,P007032,8.267,-9,10,19
224,PRS,P005793,P010390,3.5,4,8,4
224,PRS,P005793,P012608,3.916,3,9,6
224,PRS,P005793,P012609,4.299,1,9,8
224,PRS,P005793,P012610,3.916,3,9,6
224,PRS,P005793,P012611,1.8,-1,3,4
224,PRS,P005793,P012613,2.883,0,4,4
224,PRS,P005793,P012640,10.067,-10,13,23
224,PRS,P005793,P013373,4.883,-10,3,13
224,PRS,P007032,P010390,4.367,-1,6,7
224,PRS,P007032,P012608,2.917,-3,5,8
224,PRS,P007032,P012609,2.917,-3,5,8
224,PRS,P007032,P012610,2.917,-3,5,8
224,PRS,P007032,P012613,1.017,-1,2,3
224,PRS,P007032,P012640,11.25,-18,13,31
224,PRS,P007032,P013373,6.066,-18,3,21
224,PRS,P010390,P012608,18.183,6,43,37
224,PRS,P010390,P012609,18.183,6,43,37
224,PRS,P010390,P012610,18.183,6,43,37
224,PRS,P010390,P012613,11.133,6,27,21
224,PRS,P010390,P012640,5.984,0,11,11
224,PRS,P012608,P012609,24.666,-3,52,55
224,PRS,P012608,P012610,26.949,2,57,55
224,PRS,P012608,P012613,19.899,2,41,39
224,PRS,P012608,P012640,8.983,-4,16,20
224,PRS,P012609,P012610,24.666,-3,52,55
224,PRS,P012609,P012611,0.383,-2,0,2
224,PRS,P012609,P012613,17.616,-3,36,39
224,PRS,P012609,P012640,7.083,-11,11,22
224,PRS,P012609,P013373,0.383,-2,0,2
224,PRS,P012610,P012613,19.899,2,41,39
224,PRS,P012610,P012640,8.983,-4,16,20
224,PRS,P012611,P012640,1.8,-1,3,4
224,PRS,P012611,P013373,1.8,-1,3,4
224,PRS,P012613,P012640,5.466,-3,8,11
224,PRS,P012640,P013373,7.866,-19,6,25
225,PAR,P006760,P007736,16.317,-2,23,25
225,PAR,P006760,P007870,13.317,-5,21,26
225,PAR,P006760,P010781,30.983,7,62,55
225,PAR,P006760,P011981,23.716,8,52,44
225,PAR,P006760,P012720,26.284,8,53,45
225,PAR,P006760,P013369,20.383,0,45,45
225,PAR,P007736,P007870,13.718,-4,17,21
225,PAR,P007736,P008232,2.284,1,4,3
225,PAR,P007736,P010781,17.984,4,27,23
225,PAR,P007736,P011981,9.333,3,14,11
225,PAR,P007736,P012720,11.851,4,18,14
225,PAR,P007736,P013369,7.517,-2,13,15
225,PAR,P007870,P008232,2.284,1,4,3
225,PAR,P007870,P010781,18.801,4,36,32
225,PAR,P007870,P011981,9.4,4,22,18
225,PAR,P007870,P012720,14.368,0,26,26
225,PAR,P007870,P013369,10.384,4,26,22
225,PAR,P008232,P010781,2.284,1,4,3
225,PAR,P008232,P012720,0.767,0,0,0
225,PAR,P008232,P013369,1.517,1,4,3
225,PAR,P010781,P011981,28.683,13,65,52
225,PAR,P010781,P012720,29.101,14,62,48
225,PAR,P010781,P013369,25.1,9,60,51
225,PAR,P011981,P012720,21.067,15,52,37
225,PAR,P011981,P013369,22.533,9,55,46
225,PAR,P012720,P013369,20.034,3,45,42
225,VIR,P001133,P001844,10.2,6,25,19
225,VIR,P001133,P002084,6.367,-4,8,12
225,VIR,P001133,P005738,6.45,10,21,11
225,VIR,P001133,P006739,21.2,-5,44,49
225,VIR,P001133,P009549,26.018,-11,45,56
225,VIR,P001133,P012585,15.8,1,32,31
225,VIR,P001133,P012591,11.717,-5,23,28
225,VIR,P001133,P013374,16.3,-8,28,36
225,VIR,P001133,P013695,7.684,-8,10,18
225,VIR,P001844,P002084,7.167,-7,6,13
225,VIR,P001844,P005738,13.767,3,27,24
225,VIR,P001844,P006739,8.716,1,19,18
225,VIR,P001844,P009549,8.001,1,13,12
225,VIR,P001844,P012585,14.6,1,27,26
225,VIR,P001844,P013374,3.75,-4,4,8
225,VIR,P001844,P013695,0.15,0,0,0
225,VIR,P001844,PBCN,3.717,-5,3,8
225,VIR,P002084,P005738,9.417,-4,12,16
225,VIR,P002084,P006739,1.383,-2,1,3
225,VIR,P002084,P009549,10.684,-1,16,17
225,VIR,P002084,P012585,15.784,-8,20,28
225,VIR,P002084,P013695,8.617,-1,14,15
225,VIR,P002084,PBCN,3.717,-5,3,8
225,VIR,P005738,P006739,4.966,5,15,10
225,VIR,P005738,P009549,7.334,6,15,9
225,VIR,P005738,P012585,16.017,6,33,27
225,VIR,P005738,P013695,2.4,3,6,3
225,VIR,P005738,PBCN,3.717,-5,3,8
225,VIR,P006739,P009549,16.784,-10,30,40
225,VIR,P006739,P012585,7.949,0,18,18
225,VIR,P006739,P012591,11.717,-5,23,28
225,VIR,P006739,P013374,16.3,-8,28,36
225,VIR,P006739,P013695,1.317,-4,2,6
225,VIR,P009549,P012585,15.851,-1,26,27
225,VIR,P009549,P012591,11.717,-5,23,28
225,VIR,P009549,P013374,15.467,-6,28,34
225,VIR,P009549,P013695,10.084,-5,16,21
225,VIR,P012585,P013374,2.983,-5,3,8
225,VIR,P012585,P013695,8.767,-1,14,15
225,VIR,P012585,PBCN,3.717,-5,3,8
225,VIR,P012591,P013374,10.4,-1,21,22
225,VIR,P012591,P013695,1.317,-4,2,6
226,MAD,P003583,P003733,1.383,-3,2,5
226,MAD,P003583,P005928,4.267,-7,2,9
226,MAD,P003583,P007630,12.15,-1,25,26
226,MAD,P003583,P011247,14.766,-2,27,29
226,MAD,P003583,P011649,14.55,-3,25,28
226,MAD,P003583,P013378,10.217,0,21,21
226,MAD,P003583,P013666,2.616,-3,4,7
226,MAD,P003583,P013667,3.783,-5,2,7
226,MAD,P003733,P005791,21.967,0,40,40
226,MAD,P003733,P005928,19.417,-1,35,36
226,MAD,P003733,P007630,7.316,-14,10,24
226,MAD,P003733,P009213,1.183,-8,0,8
226,MAD,P003733,P011247,4.083,-4,7,11
226,MAD,P003733,P011649,0.583,-3,0,3
226,MAD,P003733,P013378,0.267,0,0,0
226,MAD,P003733,P013666,13.5,-1,23,24
226,MAD,P003733,P013667,17.7,1,32,31
226,MAD,P003733,PTGB,9.333,1,19,18
226,MAD,P005791,P005928,19.267,1,35,34
226,MAD,P005791,P007630,5.1,-6,8,14
226,MAD,P005791,P009213,0.35,-3,0,3
226,MAD,P005791,P011247,2.7,-1,5,6
226,MAD,P005791,P013378,0.267,0,0,0
226,MAD,P005791,P013666,12.017,2,21,19
226,MAD,P005791,P013667,16.867,6,32,26
226,MAD,P005791,PTGB,9.333,1,19,18
226,MAD,P005928,P007630,4.267,-9,5,14
226,MAD,P005928,P009213,0.5,-5,0,5
226,MAD,P005928,P011247,3.1,-3,2,5
226,MAD,P005928,P011649,4.267,-7,2,9
226,MAD,P005928,P013378,1.434,-4,0,4
226,MAD,P005928,P013666,9.317,3,16,13
226,MAD,P005928,P013667,19.567,-1,32,33
226,MAD,P005928,PTGB,9.333,1,19,18
226,MAD,P007630,P009213,1.183,-8,0,8
226,MAD,P007630,P011247,14.95,2,30,28
226,MAD,P007630,P011649,12.617,-1,23,24
226,MAD,P007630,P013378,11.751,0,21,21
226,MAD,P007630,P013666,4.183,-4,7,11
226,MAD,P007630,P013667,2.1,-5,0,5
226,MAD,P007630,PTGB,1.783,-2,3,5
226,MAD,P009213,P011649,0.583,-3,0,3
226,MAD,P009213,P013666,0.1,0,0,0
226,MAD,P009213,P013667,0.833,-5,0,5
226,MAD,P011247,P011649,14.65,1,25,24
226,MAD,P011247,P013378,10.317,4,21,17
226,MAD,P011247,P013666,5.316,-4,9,13
226,MAD,P011247,P013667,5.05,-5,2,7
226,MAD,P011649,P013378,11.484,0,21,21
226,MAD,P011649,P013666,1.233,0,2,2
226,MAD,P011649,P013667,5.633,-8,2,10
226,MAD,P013378,P013667,1.267,0,0,0
226,MAD,P013666,P013667,10.65,3,18,15
226,MAD,P013667,PTGB,7.55,3,16,13
226,ULK,P002849,P004004,9.483,15,26,11
226,ULK,P002849,P005216,3.983,0,5,5
226,ULK,P002849,P006961,18.799,4,37,33
226,ULK,P002849,P007182,4.983,0,8,8
226,ULK,P002849,P008104,5.166,-7,7,14
226,ULK,P002849,P008962,12.183,17,31,14
226,ULK,P002849,P009783,8.483,8,20,12
226,ULK,P002849,P010560,6.067,-2,11,13
226,ULK,P002849,P011205,7.917,6,17,11
226,ULK,P002849,P013696,2.8,-9,2,11
226,ULK,P002968,P004004,9.334,-5,10,15
226,ULK,P002968,P005216,9.017,0,23,23
226,ULK,P002968,P006961,0.617,3,3,0
226,ULK,P002968,P008104,3.583,0,0,0
226,ULK,P002968,P008962,14.034,1,26,25
226,ULK,P002968,P009783,10.5,2,19,17
226,ULK,P002968,P010560,3.534,-1,7,8
226,ULK,P002968,P011205,5.517,4,16,12
226,ULK,P004004,P005216,5.084,-1,12,13
226,ULK,P004004,P006961,8.466,13,24,11
226,ULK,P004004,P007182,1.0,0,3,3
226,ULK,P004004,P008104,5.016,2,5,3
226,ULK,P004004,P008962,17.967,12,35,23
226,ULK,P004004,P009783,10.65,7,18,11
226,ULK,P004004,P010560,6.734,1,13,12
226,ULK,P004004,P011205,2.134,4,6,2
226,ULK,P005216,P006961,7.133,-1,10,11
226,ULK,P005216,P007182,6.316,-3,8,11
226,ULK,P005216,P008962,11.484,-4,25,29
226,ULK,P005216,P009783,7.45,7,22,15
226,ULK,P005216,P010560,2.917,-4,4,8
226,ULK,P005216,P011205,11.216,2,23,21
226,ULK,P006961,P007182,10.166,0,17,17
226,ULK,P006961,P008104,5.166,-7,7,14
226,ULK,P006961,P008962,16.95,15,38,23
226,ULK,P006961,P009783,12.683,14,29,15
226,ULK,P006961,P010560,5.517,-3,10,13
226,ULK,P006961,P011205,13.367,7,27,20
226,ULK,P006961,P013696,2.8,-9,2,11
226,ULK,P007182,P008104,1.0,0,3,3
226,ULK,P007182,P008962,4.5,-3,6,9
226,ULK,P007182,P009783,3.533,6,9,3
226,ULK,P007182,P011205,9.166,0,14,14
226,ULK,P008104,P008962,4.949,2,2,0
226,ULK,P008104,P009783,5.066,-2,0,2
226,ULK,P008104,P010560,2.25,-7,2,9
226,ULK,P008104,P013696,2.8,-9,2,11
226,ULK,P008962,P009783,21.95,15,45,30
226,ULK,P008962,P010560,7.351,4,16,12
226,ULK,P008962,P011205,14.768,9,36,27
226,ULK,P009783,P011205,11.867,9,30,21
226,ULK,P009783,P013696,0.55,-2,0,2
226,ULK,P010560,P011205,1.784,7,7,0
226,ULK,P010560,P013696,2.25,-7,2,9
227,BER,P006251,P006919,8.9,-5,13,18
227,BER,P006251,P007025,11.666,1,18,17
227,BER,P006251,P008062,14.517,4,25,21
227,BER,P006251,P008173,13.716,0,23,23
227,BER,P006251,P008211,18.466,1,29,28
227,BER,P006251,P008967,19.134,4,36,32
227,BER,P006251,P011631,17.666,8,35,27
227,BER,P006251,P013386,8.867,3,13,10
227,BER,P006919,P007025,6.217,-2,8,10
227,BER,P006919,P008062,4.35,-6,6,12
227,BER,P006919,P008173,12.401,-11,21,32
227,BER,P006919,P008211,5.149,-2,8,10
227,BER,P006919,P008967,9.601,-10,17,27
227,BER,P006919,P011631,11.417,-3,17,20
227,BER,P006919,P013386,5.501,-9,10,19
227,BER,P007025,P008173,12.283,-1,18,19
227,BER,P007025,P008211,3.433,0,4,4
227,BER,P007025,P008967,3.0,1,6,5
227,BER,P007025,P011631,9.366,-3,14,17
227,BER,P007025,P013386,3.167,0,4,4
227,BER,P008062,P008173,3.834,-6,9,15
227,BER,P008062,P008211,18.45,7,33,26
227,BER,P008062,P008967,21.968,-1,42,43
227,BER,P008062,P011631,13.767,4,29,25
227,BER,P008062,P013386,12.718,-6,24,30
227,BER,P008173,P008211,5.216,-3,8,11
227,BER,P008173,P008967,12.151,-9,26,35
227,BER,P008173,P011631,15.867,-5,28,33
227,BER,P008173,P013386,10.268,-9,19,28
227,BER,P008211,P008967,19.8,4,37,33
227,BER,P008211,P011631,11.566,5,22,17
227,BER,P008211,P013386,12.584,4,23,19
227,BER,P008967,P011631,19.501,4,42,38
227,BER,P008967,P013386,15.985,-9,30,39
227,BER,P011631,P013386,7.518,-10,13,23
227,RED,P000848,P004007,2.617,2,6,4
227,RED,P000848,P004866,4.733,5,9,4
227,RED,P000848,P006436,3.766,2,6,4
227,RED,P000848,P007960,6.784,4,13,9
227,RED,P000848,P009035,6.65,1,10,9
227,RED,P000848,P009048,5.117,6,15,9
227,RED,P000848,P010588,4.917,4,13,9
227,RED,P000848,P010612,10.417,-1,17,18
227,RED,P000848,P011194,13.483,5,26,21
227,RED,P000848,P012044,12.716,4,21,17
227,RED,P002553,P004007,5.217,5,18,13
227,RED,P002553,P006436,4.584,5,16,11
227,RED,P002553,P010588,2.967,1,8,7
227,RED,P002553,P010612,0.633,0,2,2
227,RED,P002553,P011194,2.25,4,10,6
227,RED,P002553,P012044,5.217,5,18,13
227,RED,P004007,P004866,10.517,-7,13,20
227,RED,P004007,P006436,4.584,5,16,11
227,RED,P004007,P007960,1.85,-1,3,4
227,RED,P004007,P009035,6.651,-6,9,15
227,RED,P004007,P009048,12.334,-5,19,24
227,RED,P004007,P010588,9.484,1,16,15
227,RED,P004007,P010612,1.15,-2,2,4
227,RED,P004007,P011194,14.534,-3,28,31
227,RED,P004007,P012044,6.534,3,18,15
227,RED,P004866,P006436,5.816,-1,6,7
227,RED,P004866,P009035,11.651,-2,21,23
227,RED,P004866,P009048,18.017,-5,27,32
227,RED,P004866,P010588,10.867,5,20,15
227,RED,P004866,P010612,5.267,2,12,10
227,RED,P004866,P011194,14.316,-2,21,23
227,RED,P004866,P012044,3.616,5,7,2
227,RED,P006436,P009035,1.65,-1,2,3
227,RED,P006436,P009048,3.666,1,6,5
227,RED,P006436,P010588,3.217,1,8,7
227,RED,P006436,P010612,1.4,-1,2,3
227,RED,P006436,P011194,5.816,6,14,8
227,RED,P006436,P012044,7.233,7,20,13
227,RED,P007960,P009035,4.317,3,8,5
227,RED,P007960,P009048,2.767,1,8,7
227,RED,P007960,P010612,4.934,5,10,5
227,RED,P007960,P011194,2.467,1,5,4
227,RED,P007960,P012044,4.017,3,5,2
227,RED,P009035,P009048,13.368,0,26,26
227,RED,P009035,P010588,5.484,3,11,8
227,RED,P009035,P010612,12.434,1,22,21
227,RED,P009035,P011194,7.617,-8,10,18
227,RED,P009035,P012044,5.45,-3,5,8
227,RED,P009048,P010588,10.634,3,18,15
227,RED,P009048,P010612,6.984,4,17,13
227,RED,P009048,P011194,12.983,-3,22,25
227,RED,P009048,P012044,0.466,2,2,0
227,RED,P010588,P010612,7.017,-1,15,16
227,RED,P010588,P011194,9.3,1,17,16
227,RED,P010588,P012044,7.117,2,18,16
227,RED,P010612,P011194,7.25,-6,11,17
227,RED,P010612,P012044,9.85,-5,14,19
227,RED,P011194,P012044,13.316,5,28,23
228,MIL,P001518,P006085,7.166,-2,18,20
228,MIL,P001518,P006509,7.766,0,17,17
228,MIL,P001518,P007831,4.883,-4,8,12
228,MIL,P001518,P008985,3.166,9,11,2
228,MIL,P001518,P008987,2.783,3,5,2
228,MIL,P001518,P011064,2.783,3,5,2
228,MIL,P001518,P011941,4.183,-4,8,12
228,MIL,P001518,P013384,4.083,-3,10,13
228,MIL,P001518,P013385,2.983,2,10,8
228,MIL,P006085,P006509,11.867,-1,24,25
228,MIL,P006085,P006721,1.2,1,5,4
228,MIL,P006085,P007831,7.7,-6,10,16
228,MIL,P006085,P008985,5.233,10,16,6
228,MIL,P006085,P008987,7.667,2,12,10
228,MIL,P006085,P011941,8.167,1,15,14
228,MIL,P006085,P013384,4.866,-3,10,13
228,MIL,P006085,P013385,5.466,-2,10,12
228,MIL,P006509,P006721,1.2,1,5,4
228,MIL,P006509,P007831,14.8,-13,30,43
228,MIL,P006509,P008985,9.549,11,31,20
228,MIL,P006509,P008987,19.033,-1,43,44
228,MIL,P006509,P011064,12.149,-3,31,34
228,MIL,P006509,P011941,13.117,-4,25,29
228,MIL,P006509,P013384,1.9,-4,4,8
228,MIL,P006509,P013385,4.683,-2,10,12
228,MIL,P006721,P008985,1.2,1,5,4
228,MIL,P006721,P008987,1.2,1,5,4
228,MIL,P007831,P008985,12.183,3,34,31
228,MIL,P007831,P008987,26.6,-3,56,59
228,MIL,P007831,P011064,23.083,-1,54,55
228,MIL,P007831,P011941,25.8,-1,54,55
228,MIL,P007831,P013384,6.033,1,10,9
228,MIL,P007831,P013385,2.05,-4,0,4
228,MIL,P008985,P008987,18.416,10,49,39
228,MIL,P008985,P011064,14.266,6,39,33
228,MIL,P008985,P011941,12.467,8,29,21
228,MIL,P008985,P013385,1.516,6,6,0
228,MIL,P008987,P011064,25.166,2,59,57
228,MIL,P008987,P011941,24.134,6,51,45
228,MIL,P008987,P013384,3.85,0,4,4
228,MIL,P008987,P013385,2.483,-4,0,4
228,MIL,P011064,P011941,20.15,1,44,43
228,MIL,P011064,P013384,3.067,0,4,4
228,MIL,P011941,P013384,5.25,1,10,9
228,MIL,P013384,P013385,2.683,-4,4,8
228,ZAL,P002329,P002676,12.201,2,28,26
228,ZAL,P002329,P003048,7.651,1,18,17
228,ZAL,P002329,P003210,0.533,0,0,0
228,ZAL,P002329,P005504,9.984,-1,22,23
228,ZAL,P002329,P007029,8.034,-1,22,23
228,ZAL,P002329,P007975,19.318,-1,45,46
228,ZAL,P002329,P011051,1.9,-3,0,3
228,ZAL,P002329,P011983,9.467,-5,21,26
228,ZAL,P002329,P013403,10.384,4,24,20
228,ZAL,P002676,P003048,0.334,1,1,0
228,ZAL,P002676,P003210,1.833,-1,4,5
228,ZAL,P002676,P005504,9.984,-1,22,23
228,ZAL,P002676,P007029,15.25,11,39,28
228,ZAL,P002676,P007975,22.784,1,53,52
228,ZAL,P002676,P011051,20.166,5,42,37
228,ZAL,P002676,P011983,14.783,3,28,25
228,ZAL,P002676,P012622,1.3,-1,4,5
228,ZAL,P002676,P013403,24.633,8,59,51
228,ZAL,P003048,P005504,0.017,0,0,0
228,ZAL,P003048,P007029,7.317,0,17,17
228,ZAL,P003048,P007975,7.634,1,18,17
228,ZAL,P003048,P011051,0.017,0,0,0
228,ZAL,P003048,P011983,6.3,3,17,14
228,ZAL,P003048,P013403,1.334,-2,1,3
228,ZAL,P003210,P007029,1.517,-6,0,6
228,ZAL,P003210,P011051,3.35,-7,4,11
228,ZAL,P003210,P012622,2.817,-7,4,11
228,ZAL,P003210,P013403,3.35,-7,4,11
228,ZAL,P005504,P007975,9.967,-1,22,23
228,ZAL,P005504,P011051,0.017,0,0,0
228,ZAL,P005504,P011983,2.817,-5,4,9
228,ZAL,P005504,P013403,7.15,4,18,14
228,ZAL,P007029,P007975,16.734,1,43,42
228,ZAL,P007029,P011051,16.75,0,34,34
228,ZAL,P007029,P011983,16.183,11,37,26
228,ZAL,P007029,P012622,1.517,-6,0,6
228,ZAL,P007029,P013403,14.434,-2,32,34
228,ZAL,P007975,P011051,12.483,-4,25,29
228,ZAL,P007975,P011983,15.25,-4,32,36
228,ZAL,P007975,P013403,17.634,-1,42,43
228,ZAL,P011051,P011983,12.316,5,24,19
228,ZAL,P011051,P012622,2.817,-7,4,11
228,ZAL,P011051,P013403,18.316,-5,35,40
228,ZAL,P011983,P013403,8.616,4,17,13
228,ZAL,P012622,P013403,2.817,-7,4,11
229,IST,P004887,P006590,3.733,0,9,9
229,IST,P004887,P007109,5.65,-4,9,13
229,IST,P004887,P009664,4.733,2,10,8
229,IST,P004887,P009846,12.999,-5,26,31
229,IST,P004887,P011078,10.699,-6,20,26
229,IST,P004887,P012710,4.416,-4,9,13
229,IST,P004887,P012742,2.3,1,6,5
229,IST,P004887,P013363,7.466,-4,15,19
229,IST,P006590,P007109,4.15,-15,6,21
229,IST,P006590,P009846,9.617,-17,18,35
229,IST,P006590,P011078,13.767,-15,25,40
229,IST,P006590,P012710,17.567,-5,44,49
229,IST,P006590,P012742,5.0,4,20,16
229,IST,P006590,P012788,12.483,-3,31,34
229,IST,P006590,P013363,12.283,-5,31,36
229,IST,P007109,P009664,1.8,-1,2,3
229,IST,P007109,P009846,15.818,-12,34,46
229,IST,P007109,P011078,14.034,-11,28,39
229,IST,P007109,P012710,2.067,-6,4,10
229,IST,P007109,P012742,1.85,-3,6,9
229,IST,P007109,P012788,6.8,1,19,18
229,IST,P007109,P013363,11.367,-5,28,33
229,IST,P009664,P009846,7.416,2,12,10
229,IST,P009664,P011078,2.433,1,4,3
229,IST,P009664,P012742,4.983,1,8,7
229,IST,P009664,P012788,2.683,0,2,2
229,IST,P009664,P013363,5.616,3,10,7
229,IST,P009846,P011078,22.284,-13,46,59
229,IST,P009846,P012710,10.6,-15,21,36
229,IST,P009846,P012742,6.8,-2,14,16
229,IST,P009846,P012788,13.534,-2,29,31
229,IST,P009846,P013363,20.8,-8,44,52
229,IST,P011078,P012710,14.717,-11,28,39
229,IST,P011078,P012788,13.184,3,28,25
229,IST,P011078,P013363,18.15,-4,37,41
229,IST,P012710,P012742,4.967,4,20,16
229,IST,P012710,P012788,14.084,0,36,36
229,IST,P012710,P013363,13.85,-3,34,37
229,IST,P012742,P012788,9.5,1,28,27
229,IST,P012742,P013363,11.8,2,34,32
229,IST,P012788,P013363,22.0,4,55,51
229,PAN,P001926,P004088,17.05,12,52,40
229,PAN,P001926,P005161,4.35,2,12,10
229,PAN,P001926,P007866,13.167,5,40,35
229,PAN,P001926,P011204,16.034,1,44,43
229,PAN,P001926,P012712,19.517,10,54,44
229,PAN,P001926,P012774,19.584,17,54,37
229,PAN,P001926,P013383,15.634,13,44,31
229,PAN,P004088,P005161,4.383,2,12,10
229,PAN,P004088,P007866,11.583,-5,31,36
229,PAN,P004088,P011204,14.849,-2,40,42
229,PAN,P004088,P012712,20.766,10,59,49
229,PAN,P004088,P012774,18.399,14,50,36
229,PAN,P004088,P013383,13.566,17,40,23
229,PAN,P005161,P011204,0.033,0,0,0
229,PAN,P005161,P012774,4.383,2,12,10
229,PAN,P005161,P013383,4.383,2,12,10
229,PAN,P007866,P009622,0.833,2,2,0
229,PAN,P007866,P011204,17.466,-2,43,45
229,PAN,P007866,P012712,17.066,1,44,43
229,PAN,P007866,P012774,15.55,12,43,31
229,PAN,P007866,P013383,2.467,3,9,6
229,PAN,P009622,P011204,4.116,-1,9,10
229,PAN,P009622,P012712,4.116,-1,9,10
229,PAN,P009622,P012774,4.116,-1,9,10
229,PAN,P009622,P013383,3.283,-3,7,10
229,PAN,P011204,P011209,1.45,1,1,0
229,PAN,P011204,P012712,27.199,-2,64,66
229,PAN,P011204,P012774,22.949,3,52,49
229,PAN,P011204,P013383,14.7,6,39,33
229,PAN,P011209,P012712,1.45,1,1,0
229,PAN,P011209,P012774,1.45,1,1,0
229,PAN,P011209,P013383,1.45,1,1,0
229,PAN,P012712,P012774,26.399,12,62,50
229,PAN,P012712,P013383,16.083,9,39,30
229,PAN,P012774,P013383,20.166,8,49,41
230,ASV,P000229,P002100,10.117,-7,16,23
230,ASV,P000229,P003526,4.517,3,9,6
230,ASV,P000229,P004194,4.667,-1,8,9
230,ASV,P000229,P007027,3.9,-8,2,10
230,ASV,P000229,P008991,3.45,-4,0,4
230,ASV,P000229,P009818,6.933,-13,4,17
230,ASV,P000229,P010545,11.117,5,25,20
230,ASV,P000229,P011225,11.033,-7,13,20
230,ASV,P000229,P013371,6.784,-2,14,16
230,ASV,P000229,P013405,8.75,-2,17,19
230,ASV,P002100,P003526,7.534,-7,11,18
230,ASV,P002100,P004194,0.317,-3,0,3
230,ASV,P002100,P007027,1.183,-4,0,4
230,ASV,P002100,P008991,1.35,0,0,0
230,ASV,P002100,P009818,6.983,-9,9,18
230,ASV,P002100,P010545,13.384,-4,25,29
230,ASV,P002100,P011225,10.767,-9,15,24
230,ASV,P002100,P013371,4.984,2,12,10
230,ASV,P002100,P013405,11.117,-3,20,23
230,ASV,P003526,P004194,15.567,4,27,23
230,ASV,P003526,P007027,14.616,-2,21,23
230,ASV,P003526,P009818,3.2,-2,5,7
230,ASV,P003526,P010316,0.117,3,3,0
230,ASV,P003526,P010545,13.051,8,26,18
230,ASV,P003526,P011225,17.701,8,35,27
230,ASV,P003526,P013371,6.0,0,9,9
230,ASV,P003526,P013405,17.233,1,30,29
230,ASV,P004194,P007027,16.0,-1,28,29
230,ASV,P004194,P010545,7.034,7,16,9
230,ASV,P004194,P011225,12.101,0,23,23
230,ASV,P004194,P013371,7.083,-1,11,12
230,ASV,P004194,P013405,13.967,-9,23,32
230,ASV,P007027,P008991,2.1,-4,0,4
230,ASV,P007027,P009818,3.15,-6,0,6
230,ASV,P007027,P010545,5.35,0,10,10
230,ASV,P007027,P011225,12.067,-6,17,23
230,ASV,P007027,P013371,7.083,-1,11,12
230,ASV,P007027,P013405,15.883,-12,23,35
230,ASV,P008991,P009818,3.45,-4,0,4
230,ASV,P008991,P011225,3.45,-4,0,4
230,ASV,P009818,P010545,3.75,-5,7,12
230,ASV,P009818,P011225,10.133,-15,9,24
230,ASV,P009818,P013405,2.933,-6,2,8
230,ASV,P010316,P010545,0.117,3,3,0
230,ASV,P010316,P011225,0.117,3,3,0
230,ASV,P010316,P013405,0.117,3,3,0
230,ASV,P010545,P011225,15.301,11,35,24
230,ASV,P010545,P013371,4.984,2,12,10
230,ASV,P010545,P013405,11.784,9,29,20
230,ASV,P011225,P013405,14.334,-5,26,31
230,ASV,P013371,P013405,11.35,4,23,19
230,MUN,P001288,P001557,5.166,6,10,4
230,MUN,P001288,P004508,10.083,-4,15,19
230,MUN,P001288,P005460,4.034,7,11,4
230,MUN,P001288,P007201,20.717,11,41,30
230,MUN,P001288,P007639,4.533,0,8,8
230,MUN,P001288,P010391,20.166,15,42,27
230,MUN,P001288,P011224,2.867,1,7,6
230,MUN,P001288,P011244,14.8,-3,24,27
230,MUN,P001288,P011987,18.634,11,38,27
230,MUN,P001557,P004508,14.45,6,31,25
230,MUN,P001557,P005460,2.317,8,8,0
230,MUN,P001557,P007201,9.95,11,21,10
230,MUN,P001557,P007639,11.483,2,22,20
230,MUN,P001557,P010391,11.583,14,23,9
230,MUN,P001557,P011224,5.817,-2,14,16
230,MUN,P001557,P011987,8.834,3,19,16
230,MUN,P004508,P005460,4.067,-2,6,8
230,MUN,P004508,P007201,15.067,-7,22,29
230,MUN,P004508,P007639,13.033,0,24,24
230,MUN,P004508,P010391,11.966,9,24,15
230,MUN,P004508,P011224,9.884,-12,16,28
230,MUN,P004508,P011244,5.85,-7,5,12
230,MUN,P004508,P011987,11.868,-15,17,32
230,MUN,P005460,P007201,7.318,1,13,12
230,MUN,P005460,P010391,5.034,12,14,2
230,MUN,P005460,P011224,3.834,-5,5,10
230,MUN,P005460,P011987,8.868,7,19,12
230,MUN,P007201,P007639,5.583,7,12,5
230,MUN,P007201,P010391,22.05,15,43,28
230,MUN,P007201,P011224,6.734,0,15,15
230,MUN,P007201,P011244,13.25,-1,22,23
230,MUN,P007201,P011987,23.335,3,43,40
230,MUN,P007639,P010391,5.666,4,8,4
230,MUN,P007639,P011224,7.367,-4,16,20
230,MUN,P007639,P011244,1.55,-2,2,4
230,MUN,P007639,P011987,2.917,-7,4,11
230,MUN,P010391,P011244,11.033,4,22,18
230,MUN,P010391,P011987,18.834,19,44,25
230,MUN,P011224,P011244,1.55,-2,2,4
230,MUN,P011224,P011987,6.751,-12,9,21
230,MUN,P011244,P011987,11.167,-1,19,20
231,MCO,P001932,P002581,7.517,0,16,16
231,MCO,P001932,P004790,10.55,-4,21,25
231,MCO,P001932,P005844,13.534,-6,24,30
231,MCO,P001932,P005985,22.367,-3,41,44
231,MCO,P001932,P008099,18.317,-5,34,39
231,MCO,P001932,P008161,3.683,1,8,7
231,MCO,P001932,P011226,21.517,-4,42,46
231,MCO,P001932,P011231,8.266,-1,16,17
231,MCO,P001932,P012515,4.734,-5,8,13
231,MCO,P001932,PLCZ,6.783,-1,14,15
231,MCO,P002581,P005985,12.967,-3,24,27
231,MCO,P002581,P008099,12.967,-3,24,27
231,MCO,P002581,P011226,12.967,-3,24,27
231,MCO,P002581,P011231,5.45,-3,8,11
231,MCO,P004790,P005844,11.6,-4,21,25
231,MCO,P004790,P005985,5.55,-2,9,11
231,MCO,P004790,P008099,6.8,-4,10,14
231,MCO,P004790,P008161,3.683,1,8,7
231,MCO,P004790,P011226,3.8,-1,7,8
231,MCO,P004790,P012515,4.417,-2,8,10
231,MCO,P005844,P005985,8.85,-3,12,15
231,MCO,P005844,P008099,10.417,-8,13,21
231,MCO,P005844,P008161,4.316,-1,8,9
231,MCO,P005844,P011226,7.417,-5,10,15
231,MCO,P005844,P012515,4.734,-5,8,13
231,MCO,P005985,P008099,22.35,-9,34,43
231,MCO,P005985,P008161,0.633,-2,0,2
231,MCO,P005985,P011226,31.3,-12,52,64
231,MCO,P005985,P011231,16.683,-10,26,36
231,MCO,P005985,P012515,4.433,-5,5,10
231,MCO,P005985,PLCZ,7.067,-3,13,16
231,MCO,P008099,P008161,4.016,-3,6,9
231,MCO,P008099,P011226,23.25,-11,37,48
231,MCO,P008099,P011231,11.066,-7,18,25
231,MCO,P008099,P012515,5.367,-10,7,17
231,MCO,P008099,PLCZ,1.45,0,5,5
231,MCO,P008161,P011226,0.633,-2,0,2
231,MCO,P008161,P012515,0.3,2,2,0
231,MCO,P011226,P011231,17.266,-9,29,38
231,MCO,P011226,P012515,3.0,-7,3,10
231,MCO,P011226,PLCZ,7.65,-2,16,18
231,MCO,P011231,P012515,2.683,-4,3,7
231,MCO,P011231,PLCZ,7.65,-2,16,18
231,PAR,P006760,P007736,13.366,13,34,21
231,PAR,P006760,P007870,2.717,0,5,5
231,PAR,P006760,P010781,25.067,12,59,47
231,PAR,P006760,P011981,23.733,14,56,42
231,PAR,P006760,P012720,15.917,7,36,29
231,PAR,P006760,P013369,15.167,2,31,29
231,PAR,P006760,P013370,9.833,8,23,15
231,PAR,P007736,P010781,13.033,11,32,21
231,PAR,P007736,P011981,13.366,13,34,21
231,PAR,P007736,P012720,2.833,6,9,3
231,PAR,P007736,P013369,2.083,1,4,3
231,PAR,P007736,P013370,8.783,8,23,15
231,PAR,P007870,P008232,13.55,3,25,22
231,PAR,P007870,P010781,4.117,4,9,5
231,PAR,P007870,P012720,16.267,3,30,27
231,PAR,P007870,P013369,16.267,3,30,27
231,PAR,P007870,P013370,12.15,-1,21,22
231,PAR,P008232,P010781,2.45,4,4,0
231,PAR,P008232,P012720,13.55,3,25,22
231,PAR,P008232,P013369,13.55,3,25,22
231,PAR,P008232,P013370,11.1,-1,21,22
231,PAR,P010781,P011981,23.4,12,54,42
231,PAR,P010781,P012720,16.984,9,38,29
231,PAR,P010781,P013369,16.234,4,33,29
231,PAR,P010781,P013370,8.783,8,23,15
231,PAR,P011981,P012720,13.2,7,31,24
231,PAR,P011981,P013369,12.45,2,26,24
231,PAR,P011981,P013370,8.783,8,23,15
231,PAR,P012720,P013369,26.967,6,54,48
231,PAR,P012720,P013370,12.15,-1,21,22
231,PAR,P013369,P013370,12.15,-1,21,22
232,BAS,P007230,P008850,0.033,2,2,0
232,BAS,P007230,P011085,10.833,5,22,17
232,BAS,P007230,P011196,10.833,5,22,17
232,BAS,P007230,P011948,7.0,5,15,10
232,BAS,P007230,P012080,3.8,-2,5,7
232,BAS,P007230,P012597,4.85,1,8,7
232,BAS,P007230,P013367,5.983,4,14,10
232,BAS,P007579,P011085,3.6,-1,7,8
232,BAS,P007579,P011948,5.25,0,13,13
232,BAS,P007579,P012080,13.217,-1,34,35
232,BAS,P007579,P012201,14.817,-2,37,39
232,BAS,P007579,P012597,7.567,-2,20,22
232,BAS,P007579,P013367,14.817,-2,37,39
232,BAS,P008850,P011085,0.033,2,2,0
232,BAS,P008850,P011196,0.033,2,2,0
232,BAS,P008850,P013367,0.033,2,2,0
232,BAS,P011085,P011196,12.883,8,32,24
232,BAS,P011085,P011948,10.65,7,28,21
232,BAS,P011085,P012080,5.8,-2,9,11
232,BAS,P011085,P012201,5.65,2,17,15
232,BAS,P011085,P012597,5.2,-3,8,11
232,BAS,P011085,P013367,11.283,10,31,21
232,BAS,P011196,P011948,21.35,9,45,36
232,BAS,P011196,P012080,16.1,-1,25,26
232,BAS,P011196,P012201,14.35,4,30,26
232,BAS,P011196,P012597,7.333,-3,10,13
232,BAS,P011196,P013367,17.85,12,42,30
232,BAS,P011948,P012080,15.95,2,30,28
232,BAS,P011948,P012201,19.6,4,43,39
232,BAS,P011948,P012597,3.533,-1,5,6
232,BAS,P011948,P013367,23.067,10,53,43
232,BAS,P012080,P012201,25.517,0,54,54
232,BAS,P012080,P012597,13.5,-4,27,31
232,BAS,P012080,P013367,23.384,0,52,52
232,BAS,P012201,P012597,10.05,-6,22,28
232,BAS,P012201,P013367,26.684,6,65,59
232,BAS,P012597,P013367,7.567,-2,20,22
232,TEL,P004233,P005145,14.133,-1,22,23
232,TEL,P004233,P007990,12.766,-7,15,22
232,TEL,P004233,P011193,2.367,-2,2,4
232,TEL,P004233,P011202,3.717,4,9,5
232,TEL,P004233,P011214,11.65,-6,13,19
232,TEL,P004233,P011219,5.95,1,12,11
232,TEL,P004233,P012604,3.484,1,6,5
232,TEL,P004233,P013250,15.733,0,26,26
232,TEL,P004233,P013381,0.983,1,3,2
232,TEL,P004233,P013382,1.617,1,4,3
232,TEL,P005145,P007990,10.416,-5,13,18
232,TEL,P005145,P011202,3.717,4,9,5
232,TEL,P005145,P011214,7.683,-5,7,12
232,TEL,P005145,P011219,5.95,1,12,11
232,TEL,P005145,P013250,14.133,-1,22,23
232,TEL,P005145,P013381,0.5,3,3,0
232,TEL,P007990,P011193,4.15,1,9,8
232,TEL,P007990,P011202,0.983,0,2,2
232,TEL,P007990,P011214,12.816,-4,18,22
232,TEL,P007990,P011219,2.733,0,6,6
232,TEL,P007990,P012604,4.65,3,11,8
232,TEL,P007990,P013250,11.399,-5,15,20
232,TEL,P007990,P013381,0.483,-2,0,2
232,TEL,P007990,P013382,1.8,3,7,4
232,TEL,P011193,P011202,14.934,1,38,37
232,TEL,P011193,P011214,4.167,1,9,8
232,TEL,P011193,P011219,18.601,-10,43,53
232,TEL,P011193,P012604,18.818,-11,42,53
232,TEL,P011193,P013381,7.617,-9,15,24
232,TEL,P011193,P013382,20.418,-7,50,57
232,TEL,P011202,P011214,1.5,2,4,2
232,TEL,P011202,P011219,18.151,2,44,42
232,TEL,P011202,P012604,12.967,-1,32,33
232,TEL,P011202,P013250,5.217,6,13,7
232,TEL,P011202,P013381,3.967,7,13,6
232,TEL,P011202,P013382,15.451,3,40,37
232,TEL,P011214,P012604,6.784,6,17,11
232,TEL,P011214,P013250,10.783,-2,15,17
232,TEL,P011214,P013381,0.483,-2,0,2
232,TEL,P011214,P013382,3.934,6,13,7
232,TEL,P011219,P012604,15.134,-14,33,47
232,TEL,P011219,P013250,5.95,1,12,11
232,TEL,P011219,P013381,7.134,-7,15,22
232,TEL,P011219,P013382,18.601,-10,43,53
232,TEL,P012604,P013250,3.1,3,8,5
232,TEL,P012604,P013381,3.667,-11,5,16
232,TEL,P012604,P013382,19.068,-8,46,54
232,TEL,P013250,P013381,0.5,3,3,0
232,TEL,P013250,P013382,2.117,3,6,3
232,TEL,P013381,P013382,7.134,-7,15,22
233,BAR,P002939,P003196,5.9,3,16,13
233,BAR,P002939,P006568,13.984,-1,29,30
233,BAR,P002939,P007464,10.667,1,22,21
233,BAR,P002939,P009862,23.301,3,52,49
233,BAR,P002939,P009992,13.084,9,35,26
233,BAR,P002939,P012745,19.684,4,45,41
233,BAR,P002939,P012795,9.45,1,23,22
233,BAR,P002939,P013379,16.934,8,42,34
233,BAR,P003196,P009862,1.533,4,7,3
233,BAR,P003196,P009992,7.5,-2,14,16
233,BAR,P003196,P010106,3.133,-1,5,6
233,BAR,P003196,P012745,2.95,-1,5,6
233,BAR,P003196,P012795,9.033,2,21,19
233,BAR,P003196,P013379,6.083,3,16,13
233,BAR,P006568,P007464,11.517,-3,22,25
233,BAR,P006568,P009862,17.917,-6,36,42
233,BAR,P006568,P009992,2.717,-3,5,8
233,BAR,P006568,P010106,3.933,-5,7,12
233,BAR,P006568,P012745,13.05,-5,24,29
233,BAR,P006568,P012795,3.683,0,9,9
233,BAR,P006568,P013379,4.867,-1,12,13
233,BAR,P007464,P009862,11.517,-3,22,25
233,BAR,P007464,P010106,0.85,-4,0,4
233,BAR,P007464,P012745,11.517,-3,22,25
233,BAR,P009862,P009992,8.234,5,21,16
233,BAR,P009862,P010106,4.933,3,16,13
233,BAR,P009862,P012745,22.417,8,54,46
233,BAR,P009862,P012795,8.583,4,25,21
233,BAR,P009862,P013379,14.501,6,39,33
233,BAR,P009992,P010106,6.917,-12,6,18
233,BAR,P009992,P012745,12.801,-6,24,30
233,BAR,P009992,P012795,11.867,-8,20,28
233,BAR,P009992,P013379,16.884,5,39,34
233,BAR,P010106,P012745,9.367,-8,15,23
233,BAR,P010106,P012795,10.9,-5,22,27
233,BAR,P010106,P013379,6.967,-4,17,21
233,BAR,P012745,P012795,11.467,-7,20,27
233,BAR,P012745,P013379,12.951,2,31,29
233,BAR,P012795,P013379,16.417,-3,40,43
233,OLY,P001255,P003469,23.2,12,53,41
233,OLY,P001255,P003941,5.783,5,14,9
233,OLY,P001255,P007853,5.1,3,12,9
233,OLY,P001255,P007982,23.2,12,53,41
233,OLY,P001255,P008811,17.417,7,39,32
233,OLY,P001255,P010392,3.983,5,10,5
233,OLY,P001255,P013380,14.117,4,31,27
233,OLY,P003469,P003941,9.316,8,24,16
233,OLY,P003469,P007853,11.9,-1,26,27
233,OLY,P003469,P007982,31.533,6,70,64
233,OLY,P003469,P008811,23.017,1,49,48
233,OLY,P003469,P008829,2.333,1,6,5
233,OLY,P003469,P010392,6.316,6,16,10
233,OLY,P003469,P011965,0.8,3,3,0
233,OLY,P003469,P013380,20.917,0,45,45
233,OLY,P003941,P007853,12.667,1,32,31
233,OLY,P003941,P007982,8.516,5,21,16
233,OLY,P003941,P008829,8.7,-3,22,25
233,OLY,P003941,P010392,4.533,-4,8,12
233,OLY,P003941,P011965,7.167,-1,19,20
233,OLY,P003941,P013380,6.05,5,20,15
233,OLY,P007853,P007982,11.9,-1,26,27
233,OLY,P007853,P008811,6.9,-9,11,20
233,OLY,P007853,P008829,7.667,-7,17,24
233,OLY,P007853,P010392,2.017,-5,2,7
233,OLY,P007853,P011965,7.667,-7,17,24
233,OLY,P007853,P013380,12.45,-6,29,35
233,OLY,P007982,P008811,23.017,1,49,48
233,OLY,P007982,P008829,1.533,-2,3,5
233,OLY,P007982,P010392,5.516,3,13,10
233,OLY,P007982,P013380,20.917,0,45,45
233,OLY,P008811,P008829,1.3,-3,1,4
233,OLY,P008811,P010392,3.8,5,10,5
233,OLY,P008811,P011965,1.3,-3,1,4
233,OLY,P008811,P013380,20.517,-7,40,47
233,OLY,P008829,P010392,4.35,-4,8,12
233,OLY,P008829,P011965,8.467,-4,20,24
233,OLY,P008829,P013380,5.65,-2,15,17
233,OLY,P010392,P011965,2.817,-2,5,7
233,OLY,P011965,P013380,5.65,-2,15,17
234,PRS,P004197,P004512,5.483,10,18,8
234,PRS,P004197,P005793,10.383,16,29,13
234,PRS,P004197,P007032,13.3,5,32,27
234,PRS,P004197,P010390,2.384,5,8,3
234,PRS,P004197,P011949,4.75,-14,3,17
234,PRS,P004197,P012608,2.75,-1,2,3
234,PRS,P004197,P012609,0.2,-3,0,3
234,PRS,P004197,P012613,4.35,5,7,2
234,PRS,P004197,P012640,15.85,7,34,27
234,PRS,P004197,P013373,4.75,-14,3,17
234,PRS,P004512,P005793,5.483,10,18,8
234,PRS,P004512,P007032,5.483,10,18,8
234,PRS,P004512,P012640,5.483,10,18,8
234,PRS,P005793,P007032,10.95,28,41,13
234,PRS,P005793,P010390,2.117,5,8,3
234,PRS,P005793,P012608,4.233,6,12,6
234,PRS,P005793,P012609,0.2,-3,0,3
234,PRS,P005793,P012613,5.183,10,15,5
234,PRS,P005793,P012640,12.583,28,41,13
234,PRS,P007032,P010390,2.634,8,8,0
234,PRS,P007032,P011949,4.75,-14,3,17
234,PRS,P007032,P012608,3.517,10,14,4
234,PRS,P007032,P012609,1.117,1,2,1
234,PRS,P007032,P012613,4.667,11,17,6
234,PRS,P007032,P012640,16.1,15,46,31
234,PRS,P007032,P013373,4.75,-14,3,17
234,PRS,P010390,P012608,22.918,-7,39,46
234,PRS,P010390,P012609,18.034,-11,31,42
234,PRS,P010390,P012610,20.434,-8,35,43
234,PRS,P010390,P012613,22.068,-6,37,43
234,PRS,P010390,P012640,6.151,10,14,4
234,PRS,P011949,P012640,4.75,-14,3,17
234,PRS,P011949,P013373,4.75,-14,3,17
234,PRS,P012608,P012609,18.434,-10,33,43
234,PRS,P012608,P012610,20.434,-8,35,43
234,PRS,P012608,P012613,25.851,2,49,47
234,PRS,P012608,P012640,8.667,12,20,8
234,PRS,P012609,P012610,17.117,-8,31,39
234,PRS,P012609,P012613,18.234,-7,33,40
234,PRS,P012609,P012640,0.4,1,2,1
234,PRS,P012610,P012613,20.434,-8,35,43
234,PRS,P012610,P012640,3.317,0,4,4
234,PRS,P012613,P012640,9.817,13,23,10
234,PRS,P012640,P013373,4.75,-14,3,17
234,VIR,P001133,P001844,13.835,-4,26,30
234,VIR,P001133,P002084,10.234,5,24,19
234,VIR,P001133,P005738,18.302,-6,31,37
234,VIR,P001133,P006739,18.853,-1,35,36
234,VIR,P001133,P009549,24.186,1,51,50
234,VIR,P001133,P012585,4.584,4,13,9
234,VIR,P001133,P012591,5.684,-4,9,13
234,VIR,P001133,P013695,13.601,5,33,28
234,VIR,P001133,PBCN,7.801,8,18,10
234,VIR,P001844,P002084,3.017,-5,2,7
234,VIR,P001844,P005738,14.568,-4,24,28
234,VIR,P001844,P006739,4.068,-7,5,12
234,VIR,P001844,P009549,14.018,-11,25,36
234,VIR,P001844,P012585,4.434,-3,6,9
234,VIR,P001844,P012591,1.117,-2,3,5
234,VIR,P001844,P013374,1.75,-5,2,7
234,VIR,P001844,P013695,6.917,-13,10,23
234,VIR,P001844,PBCN,5.484,6,13,7
234,VIR,P002084,P005738,4.6,-2,5,7
234,VIR,P002084,P006739,16.5,8,38,30
234,VIR,P002084,P009549,10.517,-3,17,20
234,VIR,P002084,P012585,10.333,-6,17,23
234,VIR,P002084,P012591,13.917,-5,25,30
234,VIR,P002084,P013374,5.683,-3,11,14
234,VIR,P002084,P013695,3.967,9,14,5
234,VIR,P002084,PBCN,3.3,2,7,5
234,VIR,P005738,P006739,10.418,-5,14,19
234,VIR,P005738,P009549,18.252,-9,29,38
234,VIR,P005738,P012585,4.167,-2,2,4
234,VIR,P005738,P012591,3.333,-2,5,7
234,VIR,P005738,P013695,9.067,-5,16,21
234,VIR,P005738,PBCN,8.901,3,18,15
234,VIR,P006739,P009549,14.219,-5,27,32
234,VIR,P006739,P012585,8.7,-3,17,20
234,VIR,P006739,P012591,12.1,-2,24,26
234,VIR,P006739,P013374,3.933,2,9,7
234,VIR,P006739,P013695,7.751,7,22,15
234,VIR,P006739,PBCN,5.734,2,9,7
234,VIR,P009549,P012585,5.284,-4,7,11
234,VIR,P009549,P012591,4.967,-3,9,12
234,VIR,P009549,P013374,0.783,-4,0,4
234,VIR,P009549,P013695,13.034,-1,29,30
234,VIR,P009549,PBCN,5.484,3,14,11
234,VIR,P012585,P012591,6.683,-5,11,16
234,VIR,P012585,P013374,5.683,-3,11,14
234,VIR,P012585,P013695,1.117,5,7,2
234,VIR,P012585,PBCN,0.483,5,5,0
234,VIR,P012591,P013374,4.9,1,11,10
234,VIR,P012591,P013695,0.55,-2,2,4
234,VIR,P012591,PBCN,3.017,0,5,5
234,VIR,P013695,PBCN,0.2,3,3,0
235,RED,P000848,P004866,26.851,-3,55,58
235,RED,P000848,P007960,2.983,3,10,7
235,RED,P000848,P009035,15.484,-4,27,31
235,RED,P000848,P009048,21.767,-2,48,50
235,RED,P000848,P010588,8.801,0,20,20
235,RED,P000848,P010612,0.834,1,2,1
235,RED,P000848,P011194,26.284,-2,55,57
235,RED,P000848,P012044,5.468,3,11,8
235,RED,P004007,P004866,0.55,0,0,0
235,RED,P004007,P006436,0.384,-3,0,3
235,RED,P004007,P007960,0.55,0,0,0
235,RED,P004007,P009035,3.134,-4,4,8
235,RED,P004007,P009048,0.067,0,0,0
235,RED,P004007,P010588,2.517,-4,4,8
235,RED,P004007,P010612,3.134,-4,4,8
235,RED,P004007,P012044,2.2,-1,4,5
235,RED,P004866,P007960,4.55,5,14,9
235,RED,P004866,P009035,19.334,-4,32,36
235,RED,P004866,P009048,21.767,-2,48,50
235,RED,P004866,P010588,10.401,-2,21,23
235,RED,P004866,P010612,4.684,1,7,6
235,RED,P004866,P011194,26.967,-2,55,57
235,RED,P004866,P012044,8.768,3,16,13
235,RED,P006436,P007960,6.184,-3,12,15
235,RED,P006436,P009035,4.301,-2,7,9
235,RED,P006436,P009048,0.067,0,0,0
235,RED,P006436,P010588,0.317,-3,0,3
235,RED,P006436,P010612,6.568,-6,12,18
235,RED,P006436,P011194,2.267,-4,5,9
235,RED,P006436,P012044,6.184,-3,12,15
235,RED,P007960,P009035,5.484,3,11,8
235,RED,P007960,P009048,2.983,3,10,7
235,RED,P007960,P010612,7.751,-1,16,17
235,RED,P007960,P011194,5.25,-1,15,16
235,RED,P007960,P012044,7.201,-1,16,17
235,RED,P009035,P009048,10.767,-6,18,24
235,RED,P009035,P010588,4.651,-2,9,11
235,RED,P009035,P010612,10.885,1,20,19
235,RED,P009035,P011194,15.9,-6,25,31
235,RED,P009035,P012044,14.468,4,27,23
235,RED,P009048,P010588,7.967,-1,18,19
235,RED,P009048,P010612,0.067,0,0,0
235,RED,P009048,P011194,21.767,-2,48,50
235,RED,P009048,P012044,0.117,2,2,0
235,RED,P010588,P010612,5.218,-3,9,12
235,RED,P010588,P011194,7.967,-1,18,19
235,RED,P010588,P012044,4.901,0,9,9
235,RED,P010612,P011194,2.95,-4,5,9
235,RED,P010612,P012044,12.785,-1,25,26
235,RED,P011194,P012044,7.584,-2,14,16
235,ZAL,P002329,P002676,7.75,-4,17,21
235,ZAL,P002329,P003048,1.967,0,2,2
235,ZAL,P002329,P005504,8.917,5,20,15
235,ZAL,P002329,P007029,12.284,-4,23,27
235,ZAL,P002329,P007513,7.817,6,18,12
235,ZAL,P002329,P007975,14.018,3,31,28
235,ZAL,P002329,P011051,6.467,-4,15,19
235,ZAL,P002329,P011983,10.117,2,22,20
235,ZAL,P002329,P012715,0.067,0,0,0
235,ZAL,P002676,P003048,19.766,4,39,35
235,ZAL,P002676,P005504,1.383,-1,3,4
235,ZAL,P002676,P007029,13.883,-6,26,32
235,ZAL,P002676,P007513,9.216,-3,16,19
235,ZAL,P002676,P007975,26.166,5,61,56
235,ZAL,P002676,P011051,17.334,0,41,41
235,ZAL,P002676,P011983,22.35,13,52,39
235,ZAL,P002676,P012181,0.517,0,0,0
235,ZAL,P002676,P012715,2.767,4,9,5
235,ZAL,P003048,P007029,9.3,4,20,16
235,ZAL,P003048,P007513,7.133,-2,13,15
235,ZAL,P003048,P007975,16.483,6,34,28
235,ZAL,P003048,P011051,8.2,0,17,17
235,ZAL,P003048,P011983,16.483,4,31,27
235,ZAL,P005504,P007029,10.3,4,23,19
235,ZAL,P005504,P007513,8.333,5,21,16
235,ZAL,P005504,P007975,7.217,6,17,11
235,ZAL,P005504,P011983,5.05,-3,8,11
235,ZAL,P007029,P007513,14.984,3,32,29
235,ZAL,P007029,P007975,17.7,1,37,36
235,ZAL,P007029,P011051,3.934,-11,3,14
235,ZAL,P007029,P011330,0.117,-2,0,2
235,ZAL,P007029,P011983,11.0,1,20,19
235,ZAL,P007029,P012181,0.634,-2,0,2
235,ZAL,P007513,P007975,9.583,7,23,16
235,ZAL,P007513,P011051,2.917,-4,2,6
235,ZAL,P007513,P011330,0.117,-2,0,2
235,ZAL,P007513,P011983,6.866,-4,11,15
235,ZAL,P007513,P012181,0.634,-2,0,2
235,ZAL,P007975,P011051,15.701,2,39,37
235,ZAL,P007975,P011983,21.034,14,49,35
235,ZAL,P007975,P012715,2.834,4,9,5
235,ZAL,P011051,P011330,0.117,-2,0,2
235,ZAL,P011051,P011983,14.134,9,38,29
235,ZAL,P011051,P012181,0.634,-2,0,2
235,ZAL,P011051,P012715,2.834,4,9,5
235,ZAL,P011330,P012181,0.117,-2,0,2
235,ZAL,P011983,P012715,2.834,4,9,5
236,MCO,P002581,P004132,3.084,-7,4,11
236,MCO,P002581,P005985,2.884,-4,4,8
236,MCO,P002581,P008099,2.617,-4,4,8
236,MCO,P002581,P009754,5.501,-8,8,16
236,MCO,P002581,P011226,5.501,-8,8,16
236,MCO,P002581,P011231,2.417,-1,4,5
236,MCO,P004132,P004790,1.134,-2,3,5
236,MCO,P004132,P005844,3.317,3,7,4
236,MCO,P004132,P005985,17.034,0,36,36
236,MCO,P004132,P008099,10.635,-2,23,25
236,MCO,P004132,P009754,16.617,-7,30,37
236,MCO,P004132,P011212,9.668,0,21,21
236,MCO,P004132,P011226,20.568,1,40,39
236,MCO,P004132,P011231,12.883,2,24,22
236,MCO,P004790,P005844,11.0,1,22,21
236,MCO,P004790,P005985,6.384,0,18,18
236,MCO,P004790,P008099,12.134,-1,25,26
236,MCO,P004790,P009754,1.5,0,2,2
236,MCO,P004790,P011212,12.134,-1,25,26
236,MCO,P004790,P011226,4.25,-1,5,6
236,MCO,P005844,P005985,8.617,-3,22,25
236,MCO,P005844,P008099,14.85,-2,29,31
236,MCO,P005844,P009754,4.717,1,11,10
236,MCO,P005844,P011212,17.167,1,36,35
236,MCO,P005844,P011226,6.683,0,10,10
236,MCO,P005844,P011231,2.317,3,7,4
236,MCO,P005985,P008099,10.234,-5,27,32
236,MCO,P005985,P009754,17.834,1,35,34
236,MCO,P005985,P011212,14.201,-4,36,40
236,MCO,P005985,P011226,17.717,-5,35,40
236,MCO,P005985,P011231,17.367,4,35,31
236,MCO,P008099,P009754,5.017,-6,8,14
236,MCO,P008099,P011212,19.551,-3,41,44
236,MCO,P008099,P011226,13.384,-5,23,28
236,MCO,P008099,P011231,0.25,0,0,0
236,MCO,P009754,P011212,6.367,-1,13,14
236,MCO,P009754,P011226,16.484,-4,30,34
236,MCO,P009754,P011231,17.367,4,35,31
236,MCO,P011212,P011226,10.767,-1,19,20
236,MCO,P011212,P011231,4.217,1,9,8
236,MCO,P011226,P011231,13.65,3,26,23
236,MIL,P000796,P001392,9.133,14,24,10
236,MIL,P000796,P001518,5.649,-1,6,7
236,MIL,P000796,P005670,2.466,-2,2,4
236,MIL,P000796,P006085,5.183,9,16,7
236,MIL,P000796,P006509,19.016,7,43,36
236,MIL,P000796,P007831,22.817,10,52,42
236,MIL,P000796,P008987,21.034,13,53,40
236,MIL,P000796,P011064,19.917,1,39,38
236,MIL,P000796,P011941,2.1,2,4,2
236,MIL,P000796,P013384,6.149,3,13,10
236,MIL,P001392,P001518,6.066,-5,8,13
236,MIL,P001392,P005670,1.816,-2,0,2
236,MIL,P001392,P006085,10.116,6,28,22
236,MIL,P001392,P006509,2.832,6,8,2
236,MIL,P001392,P006721,0.067,0,0,0
236,MIL,P001392,P007831,7.017,7,19,12
236,MIL,P001392,P008987,10.05,4,24,20
236,MIL,P001392,P011064,3.234,-4,2,6
236,MIL,P001392,P011941,7.033,-1,16,17
236,MIL,P001392,P013384,6.5,-1,15,16
236,MIL,P001518,P005670,2.599,-2,2,4
236,MIL,P001518,P006085,3.916,1,13,12
236,MIL,P001518,P006509,4.749,1,8,7
236,MIL,P001518,P007831,8.133,-1,15,16
236,MIL,P001518,P008987,5.784,-5,9,14
236,MIL,P001518,P011064,6.85,-5,8,13
236,MIL,P001518,P011941,2.766,0,8,8
236,MIL,P001518,P013384,8.616,-7,15,22
236,MIL,P005670,P006509,1.816,-2,0,2
236,MIL,P005670,P007831,0.783,0,2,2
236,MIL,P005670,P008987,0.133,0,0,0
236,MIL,P005670,P013384,0.783,0,2,2
236,MIL,P006085,P006509,0.633,2,2,0
236,MIL,P006085,P006721,0.067,0,0,0
236,MIL,P006085,P007831,6.6,-1,16,17
236,MIL,P006085,P008987,6.4,1,19,18
236,MIL,P006085,P011941,8.366,-1,18,19
236,MIL,P006085,P013384,6.583,3,20,17
236,MIL,P006509,P007831,19.0,8,47,39
236,MIL,P006509,P008987,19.133,8,47,39
236,MIL,P006509,P011064,18.617,2,41,39
236,MIL,P006721,P011941,0.067,0,0,0
236,MIL,P006721,P013384,0.067,0,0,0
236,MIL,P007831,P008987,26.801,8,63,55
236,MIL,P007831,P011064,22.867,2,45,43
236,MIL,P007831,P011941,4.766,-3,8,11
236,MIL,P007831,P013384,5.416,-2,9,11
236,MIL,P008987,P011064,22.501,-2,43,45
236,MIL,P008987,P011941,3.433,-3,6,9
236,MIL,P008987,P013384,4.067,-4,8,12
236,MIL,P011064,P013384,4.55,-6,2,8
236,MIL,P011941,P013384,4.933,2,12,10
237,MUN,P001288,P001557,8.516,-1,21,22
237,MUN,P001288,P004508,16.782,-2,40,42
237,MUN,P001288,P005460,6.432,-9,9,18
237,MUN,P001288,P007201,19.332,1,42,41
237,MUN,P001288,P007639,6.567,-3,15,18
237,MUN,P001288,P010391,16.249,-12,30,42
237,MUN,P001288,P011224,15.749,-1,38,39
237,MUN,P001288,P011244,2.317,-1,2,3
237,MUN,P001288,P011987,26.649,-12,57,69
237,MUN,P001288,P012123,0.267,0,2,2
237,MUN,P001557,P004508,10.033,2,24,22
237,MUN,P001557,P005460,2.583,-4,7,11
237,MUN,P001557,P007201,10.466,7,23,16
237,MUN,P001557,P007639,3.184,-2,8,10
237,MUN,P001557,P010391,14.55,1,33,32
237,MUN,P001557,P011224,9.75,0,23,23
237,MUN,P001557,P011987,7.383,1,19,18
237,MUN,P001557,P012123,0.267,0,2,2
237,MUN,P004508,P005460,5.616,4,14,10
237,MUN,P004508,P007201,19.465,15,48,33
237,MUN,P004508,P007639,4.734,-7,9,16
237,MUN,P004508,P010391,13.583,3,32,29
237,MUN,P004508,P011224,21.899,5,51,46
237,MUN,P004508,P011987,15.016,0,38,38
237,MUN,P005460,P007201,5.182,2,9,7
237,MUN,P005460,P010391,6.199,-11,9,20
237,MUN,P005460,P011224,6.649,-7,12,19
237,MUN,P005460,P011987,4.399,-11,4,15
237,MUN,P007201,P010391,17.065,5,34,29
237,MUN,P007201,P011224,17.965,10,41,31
237,MUN,P007201,P011244,2.317,-1,2,3
237,MUN,P007201,P011987,19.532,1,45,44
237,MUN,P007639,P010391,7.067,-1,18,19
237,MUN,P007639,P011224,2.417,0,7,7
237,MUN,P007639,P011987,6.567,-3,15,18
237,MUN,P010391,P011224,11.266,-2,23,25
237,MUN,P010391,P011244,2.317,-1,2,3
237,MUN,P010391,P011987,17.832,-10,35,45
237,MUN,P011224,P011987,12.966,-5,31,36
237,MUN,P011224,P012123,0.267,0,2,2
237,MUN,P011244,P011987,2.317,-1,2,3
237,MUN,P011987,P012123,0.267,0,2,2
237,PRS,P004197,P005793,1.216,0,4,4
237,PRS,P004197,P007032,12.85,7,33,26
237,PRS,P004197,P010390,1.567,0,6,6
237,PRS,P004197,P011949,12.9,7,33,26
237,PRS,P004197,P012608,2.15,-2,6,8
237,PRS,P004197,P012610,1.483,-2,4,6
237,PRS,P004197,P012613,0.35,2,2,0
237,PRS,P004197,P012640,13.25,9,35,26
237,PRS,P004197,P013373,13.166,7,33,26
237,PRS,P005793,P007032,1.533,2,4,2
237,PRS,P005793,P010390,13.783,9,34,25
237,PRS,P005793,P012608,14.366,7,34,27
237,PRS,P005793,P012610,13.899,9,34,25
237,PRS,P005793,P012613,10.85,7,23,16
237,PRS,P005793,P012640,1.234,-4,3,7
237,PRS,P005793,P013373,0.583,-2,0,2
237,PRS,P007032,P010390,8.133,-11,11,22
237,PRS,P007032,P011949,13.133,9,34,25
237,PRS,P007032,P012608,10.449,-8,20,28
237,PRS,P007032,P012610,9.899,-8,19,27
237,PRS,P007032,P012613,7.466,-5,15,20
237,PRS,P007032,P012640,13.316,11,36,25
237,PRS,P007032,P013373,15.349,7,40,33
237,PRS,P010390,P011949,0.867,-2,1,3
237,PRS,P010390,P012608,23.45,-2,49,51
237,PRS,P010390,P012610,21.766,0,46,46
237,PRS,P010390,P012613,18.75,3,37,34
237,PRS,P010390,P012640,4.851,-2,12,14
237,PRS,P010390,P013373,0.633,-3,0,3
237,PRS,P011949,P012608,0.867,-2,1,3
237,PRS,P011949,P012640,13.45,7,34,27
237,PRS,P011949,P013373,12.583,9,33,24
237,PRS,P012608,P012610,25.732,-2,57,59
237,PRS,P012608,P012613,22.133,3,48,45
237,PRS,P012608,P012640,6.101,-3,16,19
237,PRS,P012608,P013373,4.416,-7,9,16
237,PRS,P012610,P012613,21.316,3,46,43
237,PRS,P012610,P012640,4.417,-1,13,14
237,PRS,P012610,P013373,4.416,-7,9,16
237,PRS,P012613,P012640,4.467,1,12,11
237,PRS,P012613,P013373,3.2,-2,9,11
237,PRS,P012640,P013373,13.65,6,35,29
238,BAR,P002939,P003196,2.983,-3,2,5
238,BAR,P002939,P003478,10.4,-5,18,23
238,BAR,P002939,P006568,13.367,7,28,21
238,BAR,P002939,P007464,13.666,-2,33,35
238,BAR,P002939,P009992,11.649,-2,29,31
238,BAR,P002939,P012745,20.834,-3,46,49
238,BAR,P002939,P012795,19.734,7,48,41
238,BAR,P002939,P013379,16.899,-7,36,43
238,BAR,P003196,P007464,5.35,-3,6,9
238,BAR,P003196,P009992,5.35,-3,6,9
238,BAR,P003196,P012317,2.367,0,4,4
238,BAR,P003196,P013379,5.35,-3,6,9
238,BAR,P003478,P006568,7.85,-6,11,17
238,BAR,P003478,P009992,0.633,-4,0,4
238,BAR,P003478,P012745,11.033,-9,18,27
238,BAR,P003478,P012795,11.033,-9,18,27
238,BAR,P003478,P013379,3.183,-3,7,10
238,BAR,P006568,P007464,8.183,11,17,6
238,BAR,P006568,P009992,7.349,14,20,6
238,BAR,P006568,P012745,14.817,10,33,23
238,BAR,P006568,P012795,17.2,10,35,25
238,BAR,P006568,P013379,3.166,2,4,2
238,BAR,P007464,P009992,19.315,-4,48,52
238,BAR,P007464,P011666,0.233,0,0,0
238,BAR,P007464,P012317,2.817,-3,4,7
238,BAR,P007464,P012745,15.217,0,43,43
238,BAR,P007464,P012795,14.183,13,45,32
238,BAR,P007464,P013379,19.632,-8,48,56
238,BAR,P009992,P011666,0.233,0,0,0
238,BAR,P009992,P012317,3.817,-5,7,12
238,BAR,P009992,P012745,16.933,-6,44,50
238,BAR,P009992,P012795,13.799,7,44,37
238,BAR,P009992,P013379,17.982,-17,42,59
238,BAR,P011666,P012795,0.233,0,0,0
238,BAR,P011666,P013379,0.233,0,0,0
238,BAR,P012317,P012745,1.45,-5,3,8
238,BAR,P012317,P012795,1.0,-2,3,5
238,BAR,P012317,P013379,3.817,-5,7,12
238,BAR,P012745,P012795,26.234,5,65,60
238,BAR,P012745,P013379,15.75,-16,40,56
238,BAR,P012795,P013379,14.716,-3,42,45
238,MAD,P003108,P003583,4.75,0,10,10
238,MAD,P003108,P003733,17.034,3,48,45
238,MAD,P003108,P005791,7.834,4,22,18
238,MAD,P003108,P005928,13.718,-3,41,44
238,MAD,P003108,P006540,11.917,-1,36,37
238,MAD,P003108,P007630,0.417,-3,0,3
238,MAD,P003108,P011247,13.166,5,27,22
238,MAD,P003108,P011649,4.934,-3,10,13
238,MAD,P003108,P013667,12.483,-1,30,31
238,MAD,P003108,PTGB,15.883,7,32,25
238,MAD,P003583,P005928,4.55,0,10,10
238,MAD,P003583,P006540,3.2,0,6,6
238,MAD,P003583,P011247,1.55,0,4,4
238,MAD,P003583,P011649,4.517,0,10,10
238,MAD,P003583,PTGB,0.433,0,0,0
238,MAD,P003733,P005791,11.334,15,37,22
238,MAD,P003733,P005928,13.451,10,48,38
238,MAD,P003733,P006540,12.217,10,45,35
238,MAD,P003733,P007630,7.667,7,21,14
238,MAD,P003733,P011247,10.833,3,21,18
238,MAD,P003733,P011649,0.417,-3,0,3
238,MAD,P003733,P013667,12.483,-1,30,31
238,MAD,P003733,PTGB,11.7,8,26,18
238,MAD,P005791,P005928,20.418,5,52,47
238,MAD,P005791,P006540,20.384,4,51,47
238,MAD,P005791,P007630,14.467,3,32,29
238,MAD,P005791,P011247,1.883,2,2,0
238,MAD,P005791,P013378,7.217,-7,11,18
238,MAD,P005791,PTGB,5.667,2,9,7
238,MAD,P005928,P006540,25.601,0,66,66
238,MAD,P005928,P007630,14.884,0,32,32
238,MAD,P005928,P011247,1.35,0,4,4
238,MAD,P005928,P011649,4.734,-3,10,13
238,MAD,P005928,P013378,7.217,-7,11,18
238,MAD,P005928,P013667,2.75,-4,9,13
238,MAD,P005928,PTGB,4.067,2,9,7
238,MAD,P006540,P007630,14.467,3,32,29
238,MAD,P006540,P011247,0.783,2,2,0
238,MAD,P006540,P011649,2.967,0,6,6
238,MAD,P006540,P013378,7.217,-7,11,18
238,MAD,P006540,P013667,2.75,-4,9,13
238,MAD,P006540,PTGB,4.033,1,8,7
238,MAD,P007630,P011649,0.417,-3,0,3
238,MAD,P007630,P013378,7.217,-7,11,18
238,MAD,P011247,P011649,1.55,0,4,4
238,MAD,P011247,P013667,9.733,3,21,18
238,MAD,P011247,PTGB,11.816,5,23,18
238,MAD,P011649,PTGB,0.2,0,0,0
238,MAD,P013667,PTGB,9.733,3,21,18
239,TEL,P007990,P011202,13.949,13,36,23
239,TEL,P007990,P011214,13.766,7,32,25
239,TEL,P007990,P011219,17.466,5,41,36
239,TEL,P007990,P011433,10.383,14,35,21
239,TEL,P007990,P012604,11.332,-4,24,28
239,TEL,P007990,P013381,5.6,4,16,12
239,TEL,P007990,P013382,9.916,-4,18,22
239,TEL,P007990,P013699,12.116,-11,14,25
239,TEL,P011202,P011214,12.05,10,32,22
239,TEL,P011202,P011219,16.583,8,40,32
239,TEL,P011202,P011433,10.883,15,35,20
239,TEL,P011202,P012604,4.066,8,13,5
239,TEL,P011202,P013381,1.617,8,8,0
239,TEL,P011202,P013382,7.9,2,16,14
239,TEL,P011202,P013699,6.616,-4,8,12
239,TEL,P011214,P011219,16.967,4,39,35
239,TEL,P011214,P011433,10.167,3,26,23
239,TEL,P011214,P012604,11.716,10,28,18
239,TEL,P011214,P013381,13.567,9,32,23
239,TEL,P011214,P013382,18.166,1,39,38
239,TEL,P011214,P013699,18.333,12,40,28
239,TEL,P011219,P011433,13.367,15,44,29
239,TEL,P011219,P012604,6.583,0,16,16
239,TEL,P011219,P013381,10.317,6,27,21
239,TEL,P011219,P013382,17.85,5,39,34
239,TEL,P011219,P013699,13.999,-11,18,29
239,TEL,P011433,P012604,5.267,5,15,10
239,TEL,P011433,P013381,3.051,2,8,6
239,TEL,P011433,P013382,7.517,2,21,19
239,TEL,P011433,P013699,0.033,0,0,0
239,TEL,P012604,P013381,8.95,5,21,16
239,TEL,P012604,P013382,12.433,10,31,21
239,TEL,P012604,P013699,12.849,6,28,22
239,TEL,P013381,P013382,13.633,13,36,23
239,TEL,P013381,P013699,13.333,9,32,23
239,TEL,P013382,P013699,17.649,3,32,29
239,ULK,P002849,P005216,1.45,0,0,0
239,ULK,P002849,P006961,6.684,-9,11,20
239,ULK,P002849,P007182,5.367,-1,9,10
239,ULK,P002849,P008104,9.5,-9,15,24
239,ULK,P002849,P008962,4.3,-5,4,9
239,ULK,P002849,P009783,4.3,0,4,4
239,ULK,P002849,P009863,3.067,-2,6,8
239,ULK,P002849,P011205,7.9,-7,9,16
239,ULK,P002849,P013696,1.3,-3,2,5
239,ULK,P002968,P005216,4.566,-3,8,11
239,ULK,P002968,P006961,5.983,-9,6,15
239,ULK,P002968,P008104,0.733,3,3,0
239,ULK,P002968,P008962,14.082,-5,24,29
239,ULK,P002968,P009783,13.699,-2,24,26
239,ULK,P002968,P009863,9.516,-2,16,18
239,ULK,P002968,P011205,7.749,-2,15,17
239,ULK,P005216,P006961,3.833,-2,8,10
239,ULK,P005216,P007182,6.9,4,17,13
239,ULK,P005216,P008104,0.65,-4,0,4
239,ULK,P005216,P008962,10.649,-2,25,27
239,ULK,P005216,P009783,8.916,-4,17,21
239,ULK,P005216,P009863,3.833,-4,9,13
239,ULK,P005216,P011205,10.199,-9,16,25
239,ULK,P006961,P007182,10.85,-8,20,28
239,ULK,P006961,P008104,7.317,-7,17,24
239,ULK,P006961,P008962,16.55,-14,32,46
239,ULK,P006961,P009783,7.684,-1,15,16
239,ULK,P006961,P009863,15.417,-9,30,39
239,ULK,P006961,P011205,12.45,-12,25,37
239,ULK,P006961,P013696,2.5,-1,8,9
239,ULK,P007182,P008104,3.917,-1,9,10
239,ULK,P007182,P008962,8.933,-4,20,24
239,ULK,P007182,P009783,3.45,3,9,6
239,ULK,P007182,P009863,7.783,-4,16,20
239,ULK,P007182,P011205,10.0,-9,16,25
239,ULK,P008104,P008962,7.683,0,15,15
239,ULK,P008104,P009783,6.233,-1,9,10
239,ULK,P008104,P009863,7.1,-1,17,18
239,ULK,P008104,P011205,7.1,-11,9,20
239,ULK,P008104,P013696,3.967,-1,10,11
239,ULK,P008962,P009783,23.816,3,48,45
239,ULK,P008962,P009863,20.933,-3,45,48
239,ULK,P008962,P011205,21.115,-12,39,51
239,ULK,P008962,P013696,2.667,2,8,6
239,ULK,P009783,P009863,16.9,-1,36,37
239,ULK,P009783,P011205,14.999,-1,28,29
239,ULK,P009783,P013696,1.467,0,2,2
239,ULK,P009863,P011205,10.016,-9,19,28
239,ULK,P009863,P013696,3.967,-1,10,11
240,BER,P006251,P006919,8.5,-16,9,25
240,BER,P006251,P007025,3.134,-1,6,7
240,BER,P006251,P008062,11.534,-11,18,29
240,BER,P006251,P008384,13.085,-11,22,33
240,BER,P006251,P008780,8.834,-9,13,22
240,BER,P006251,P008967,13.517,-17,17,34
240,BER,P006251,P011934,8.785,1,18,17
240,BER,P006251,P012721,6.65,-7,11,18
240,BER,P006251,P013386,7.433,-9,10,19
240,BER,P006919,P007025,2.717,-2,7,9
240,BER,P006919,P008062,10.934,-14,17,31
240,BER,P006919,P008384,4.45,-8,3,11
240,BER,P006919,P008780,9.566,-10,16,26
240,BER,P006919,P008967,16.683,-17,26,43
240,BER,P006919,P011631,9.633,-9,17,26
240,BER,P006919,P011934,11.167,-12,20,32
240,BER,P006919,P012721,3.183,-10,3,13
240,BER,P006919,P013386,5.167,2,14,12
240,BER,P007025,P008062,3.601,0,8,8
240,BER,P007025,P008384,4.351,0,11,11
240,BER,P007025,P008780,5.184,-5,12,17
240,BER,P007025,P011631,5.651,-4,14,18
240,BER,P007025,P011934,7.418,-6,15,21
240,BER,P007025,P012721,1.717,-3,2,5
240,BER,P007025,P013386,1.367,1,5,4
240,BER,P008062,P008384,8.284,-5,15,20
240,BER,P008062,P008967,15.701,-7,29,36
240,BER,P008062,P011631,7.351,-1,15,16
240,BER,P008062,P011934,12.635,-3,25,28
240,BER,P008062,P012721,6.784,-7,13,20
240,BER,P008062,P013386,8.184,4,20,16
240,BER,P008384,P008780,9.251,-6,15,21
240,BER,P008384,P008967,9.467,-9,11,20
240,BER,P008384,P011631,4.45,0,8,8
240,BER,P008384,P011934,7.385,5,21,16
240,BER,P008384,P012721,3.717,-2,8,10
240,BER,P008384,P013386,5.7,-8,6,14
240,BER,P008780,P008967,11.799,-11,16,27
240,BER,P008780,P011631,9.916,-5,20,25
240,BER,P008780,P011934,8.384,-3,19,22
240,BER,P008780,P012721,5.433,2,11,9
240,BER,P008780,P013386,6.633,-9,10,19
240,BER,P008967,P011631,11.616,-2,21,23
240,BER,P008967,P011934,10.984,-3,21,24
240,BER,P008967,P012721,6.783,0,14,14
240,BER,P008967,P013386,13.45,-6,25,31
240,BER,P011631,P011934,9.867,-8,19,27
240,BER,P011631,P012721,5.567,2,13,11
240,BER,P011631,P013386,5.017,3,13,10
240,BER,P011934,P012721,5.084,4,11,7
240,BER,P011934,P013386,2.367,1,7,6
240,BER,P012721,P013386,3.95,1,10,9
240,IST,P004887,P006590,5.3,0,9,9
240,IST,P004887,P007109,8.517,-4,17,21
240,IST,P004887,P007200,15.851,8,36,28
240,IST,P004887,P009664,7.551,14,21,7
240,IST,P004887,P009846,9.617,-1,16,17
240,IST,P004887,P011078,13.334,6,28,22
240,IST,P004887,P012710,5.3,0,9,9
240,IST,P004887,P012742,7.817,2,17,15
240,IST,P004887,P013363,11.317,7,27,20
240,IST,P006372,P007109,2.533,4,6,2
240,IST,P006372,P009664,2.533,4,6,2
240,IST,P006372,P011078,2.533,4,6,2
240,IST,P006372,P012742,0.383,0,0,0
240,IST,P006372,P013363,2.15,4,6,2
240,IST,P006590,P007109,3.05,0,6,6
240,IST,P006590,P009664,2.916,3,6,3
240,IST,P006590,P009846,9.483,0,17,17
240,IST,P006590,P011078,9.483,0,17,17
240,IST,P006590,P012710,6.433,0,11,11
240,IST,P006590,P012788,1.267,-3,2,5
240,IST,P007109,P007200,14.467,4,38,34
240,IST,P007109,P009664,7.366,13,22,9
240,IST,P007109,P009846,9.65,0,21,21
240,IST,P007109,P011078,11.567,3,27,24
240,IST,P007109,P012710,2.5,-4,1,5
240,IST,P007109,P012742,14.232,7,35,28
240,IST,P007109,P012788,6.7,7,24,17
240,IST,P007109,P013363,18.882,10,51,41
240,IST,P007200,P009664,11.75,21,37,16
240,IST,P007200,P009846,5.617,-3,8,11
240,IST,P007200,P011078,12.067,9,33,24
240,IST,P007200,P012710,2.233,2,7,5
240,IST,P007200,P012742,11.1,10,30,20
240,IST,P007200,P012788,2.25,5,10,5
240,IST,P007200,P013363,17.333,20,53,33
240,IST,P009664,P009846,6.749,2,11,9
240,IST,P009664,P011078,13.365,16,35,19
240,IST,P009664,P012710,2.499,3,8,5
240,IST,P009664,P012742,4.217,12,14,2
240,IST,P009664,P013363,9.85,24,36,12
240,IST,P009846,P011078,15.65,-3,25,28
240,IST,P009846,P012710,9.366,-5,12,17
240,IST,P009846,P012742,4.816,2,12,10
240,IST,P009846,P012788,4.45,2,14,12
240,IST,P009846,P013363,4.266,2,12,10
240,IST,P011078,P012710,9.216,2,18,16
240,IST,P011078,P012742,0.933,0,0,0
240,IST,P011078,P012788,1.784,-1,4,5
240,IST,P011078,P013363,8.6,16,31,15
240,IST,P012710,P012742,1.633,-3,0,3
240,IST,P012710,P013363,2.016,1,6,5
240,IST,P012742,P012788,4.916,8,20,12
240,IST,P012742,P013363,15.149,10,40,30
240,IST,P012788,P013363,5.433,10,22,12
241,OLY,P001255,P003469,8.934,16,27,11
241,OLY,P001255,P003941,9.1,3,23,20
241,OLY,P001255,P007853,3.15,3,8,5
241,OLY,P001255,P007947,10.9,2,26,24
241,OLY,P001255,P007982,5.05,15,17,2
241,OLY,P001255,P008811,10.0,17,28,11
241,OLY,P001255,P008829,12.883,7,32,25
241,OLY,P001255,P009849,10.166,4,24,20
241,OLY,P001255,P013380,6.217,13,19,6
241,OLY,P003469,P003941,15.118,15,46,31
241,OLY,P003469,P007853,12.334,0,24,24
241,OLY,P003469,P007947,8.584,0,20,20
241,OLY,P003469,P007982,11.934,9,28,19
241,OLY,P003469,P008811,11.217,3,20,17
241,OLY,P003469,P008829,8.767,9,26,17
241,OLY,P003469,P010392,10.884,11,33,22
241,OLY,P003469,P013380,17.568,9,40,31
241,OLY,P003941,P007853,6.25,9,18,9
241,OLY,P003941,P007947,12.167,1,30,29
241,OLY,P003941,P007982,1.567,4,8,4
241,OLY,P003941,P008829,13.633,8,36,28
241,OLY,P003941,P009849,4.866,-1,10,11
241,OLY,P003941,P010392,10.884,11,33,22
241,OLY,P003941,P013380,6.351,6,20,14
241,OLY,P007853,P007947,1.95,-4,0,4
241,OLY,P007853,P007982,8.067,-5,8,13
241,OLY,P007853,P008811,10.017,-9,8,17
241,OLY,P007853,P008829,9.75,9,20,11
241,OLY,P007853,P009849,1.05,-2,0,2
241,OLY,P007853,P010392,5.983,8,12,4
241,OLY,P007853,P013380,6.517,-9,6,15
241,OLY,P007947,P008811,7.25,1,14,13
241,OLY,P007947,P008829,13.783,2,32,30
241,OLY,P007947,P009849,10.35,2,24,22
241,OLY,P007947,P010392,7.05,4,18,14
241,OLY,P007947,P013380,5.634,0,12,12
241,OLY,P007982,P008811,12.767,7,22,15
241,OLY,P007982,P008829,2.4,2,2,0
241,OLY,P007982,P010392,3.617,3,7,4
241,OLY,P007982,P013380,11.934,9,28,19
241,OLY,P008811,P008829,8.8,5,16,11
241,OLY,P008811,P009849,5.917,3,14,11
241,OLY,P008811,P010392,2.883,2,2,0
241,OLY,P008811,P013380,11.217,3,20,17
241,OLY,P008829,P009849,10.783,2,24,22
241,OLY,P008829,P010392,8.933,8,20,12
241,OLY,P010392,P013380,4.834,5,15,10
241,VIR,P001844,P004554,4.983,-5,3,8
241,VIR,P001844,P005738,4.833,-5,12,17
241,VIR,P001844,P009549,20.399,1,41,40
241,VIR,P001844,P011816,13.883,3,30,27
241,VIR,P001844,P012585,8.049,-3,15,18
241,VIR,P001844,P012591,10.799,7,25,18
241,VIR,P001844,P013374,19.799,2,46,44
241,VIR,P001844,P013695,8.683,-2,12,14
241,VIR,P001844,PBCN,7.7,-10,12,22
241,VIR,P004554,P006739,0.483,0,0,0
241,VIR,P004554,P009549,8.85,-6,12,18
241,VIR,P004554,P011816,7.65,-18,6,24
241,VIR,P004554,P012585,12.533,-20,14,34
241,VIR,P004554,P012591,11.15,-16,14,30
241,VIR,P004554,P013695,11.2,-21,7,28
241,VIR,P004554,PBCN,2.883,-2,0,2
241,VIR,P005738,P006739,1.983,-1,3,4
241,VIR,P005738,P009549,4.833,-5,12,17
241,VIR,P005738,P012585,1.983,-1,3,4
241,VIR,P005738,P012591,1.983,-1,3,4
241,VIR,P005738,P013374,6.816,-6,15,21
241,VIR,P005738,PBCN,4.833,-5,12,17
241,VIR,P006739,P009549,1.333,3,3,0
241,VIR,P006739,P011816,1.333,3,3,0
241,VIR,P006739,P012585,4.416,-5,7,12
241,VIR,P006739,P012591,4.799,-2,10,12
241,VIR,P006739,P013374,5.266,-2,10,12
241,VIR,P006739,P013695,0.95,0,0,0
241,VIR,P006739,PBCN,2.433,-4,4,8
241,VIR,P009549,P011816,12.883,8,29,21
241,VIR,P009549,P012585,8.433,-4,16,20
241,VIR,P009549,P012591,16.899,5,37,32
241,VIR,P009549,P013374,17.649,5,41,36
241,VIR,P009549,P013695,7.017,-1,9,10
241,VIR,P009549,PBCN,7.7,-10,12,22
241,VIR,P011816,P012585,11.133,-18,14,32
241,VIR,P011816,P012591,15.216,-5,27,32
241,VIR,P011816,P013374,14.316,10,33,23
241,VIR,P011816,P013695,10.983,-12,14,26
241,VIR,P011816,PBCN,0.467,-3,0,3
241,VIR,P012585,P012591,16.599,-21,25,46
241,VIR,P012585,P013374,9.399,-5,19,24
241,VIR,P012585,P013695,12.75,-19,15,34
241,VIR,P012585,PBCN,2.433,-4,4,8
241,VIR,P012591,P013374,13.915,4,32,28
241,VIR,P012591,P013695,7.417,-15,7,22
241,VIR,P012591,PBCN,1.483,-4,4,8
241,VIR,P013374,P013695,5.85,4,12,8
241,VIR,P013374,PBCN,7.25,-12,16,28
241,VIR,P013695,PBCN,3.35,-2,0,2
242,BAS,P004058,P007230,8.749,-2,15,17
242,BAS,P004058,P007579,1.533,-2,2,4
242,BAS,P004058,P011085,2.916,3,5,2
242,BAS,P004058,P011196,8.749,-2,15,17
242,BAS,P004058,P011948,4.299,4,11,7
242,BAS,P004058,P012080,5.75,-3,12,15
242,BAS,P004058,P012201,3.0,-6,0,6
242,BAS,P007230,P007579,4.0,-6,6,12
242,BAS,P007230,P008072,3.033,3,5,2
242,BAS,P007230,P011085,8.165,4,12,8
242,BAS,P007230,P011196,13.965,-6,23,29
242,BAS,P007230,P011948,7.299,2,17,15
242,BAS,P007230,P012080,11.049,2,21,19
242,BAS,P007230,P012201,3.483,-8,0,8
242,BAS,P007230,P013367,8.249,-1,13,14
242,BAS,P007579,P011085,10.533,-8,19,27
242,BAS,P007579,P011196,5.217,-8,6,14
242,BAS,P007579,P011948,3.833,-4,6,10
242,BAS,P007579,P012080,10.7,-10,19,29
242,BAS,P007579,P012201,9.316,-6,19,25
242,BAS,P007579,P013367,13.0,-12,23,35
242,BAS,P008072,P011085,13.05,1,22,21
242,BAS,P008072,P012080,13.05,1,22,21
242,BAS,P008072,P012201,10.017,-2,17,19
242,BAS,P008072,P013367,13.05,1,22,21
242,BAS,P011085,P011196,8.799,-1,16,17
242,BAS,P011085,P011948,0.916,5,5,0
242,BAS,P011085,P012080,28.383,-9,52,61
242,BAS,P011085,P012201,23.649,-10,45,55
242,BAS,P011085,P013367,28.249,-9,52,61
242,BAS,P011196,P011948,7.299,2,17,15
242,BAS,P011196,P012080,11.683,-3,25,28
242,BAS,P011196,P012201,5.933,-8,9,17
242,BAS,P011196,P013367,8.883,-6,17,23
242,BAS,P011948,P012080,3.216,5,10,5
242,BAS,P011948,P012201,0.333,2,2,0
242,BAS,P011948,P013367,3.333,0,8,8
242,BAS,P012080,P012201,23.067,-16,43,59
242,BAS,P012080,P013367,27.966,-7,52,59
242,BAS,P012201,P013367,22.266,-10,45,55
242,PAR,P004761,P007736,1.417,5,5,0
242,PAR,P004761,P007870,2.367,5,7,2
242,PAR,P004761,P010781,7.55,-3,12,15
242,PAR,P004761,P011836,13.167,9,30,21
242,PAR,P004761,P011981,10.8,4,23,19
242,PAR,P004761,P012720,7.0,12,18,6
242,PAR,P004761,P013369,6.35,10,18,8
242,PAR,P004761,P013370,4.017,-6,7,13
242,PAR,P007736,P007870,4.767,5,10,5
242,PAR,P007736,P008232,2.783,-3,2,5
242,PAR,P007736,P010781,4.767,5,10,5
242,PAR,P007736,P011836,1.984,8,8,0
242,PAR,P007736,P012720,3.35,0,5,5
242,PAR,P007870,P008232,14.0,-5,24,29
242,PAR,P007870,P010781,16.934,3,34,31
242,PAR,P007870,P011836,5.484,7,14,7
242,PAR,P007870,P012720,17.117,-3,31,34
242,PAR,P007870,P013369,13.767,-3,26,29
242,PAR,P007870,P013370,3.5,-1,6,7
242,PAR,P008232,P010781,15.317,-3,28,31
242,PAR,P008232,P011981,1.317,2,4,2
242,PAR,P008232,P012720,15.317,-3,28,31
242,PAR,P008232,P013369,12.534,0,26,26
242,PAR,P010781,P011836,16.117,7,36,29
242,PAR,P010781,P011981,14.5,1,30,29
242,PAR,P010781,P012720,25.267,7,52,45
242,PAR,P010781,P013369,21.267,5,47,42
242,PAR,P010781,P013370,4.017,-6,7,13
242,PAR,P011836,P011981,19.2,9,44,35
242,PAR,P011836,P012720,18.517,19,46,27
242,PAR,P011836,P013369,17.3,14,43,29
242,PAR,P011836,P013370,6.967,-9,11,20
242,PAR,P011981,P012720,16.717,19,43,24
242,PAR,P011981,P013369,16.067,17,43,26
242,PAR,P011981,P013370,3.467,-8,5,13
242,PAR,P012720,P013369,29.101,16,69,53
242,PAR,P012720,P013370,2.95,-3,4,7
242,PAR,P013369,P013370,2.95,-3,4,7
243,ASV,P002100,P007027,16.75,1,44,43
243,ASV,P002100,P008991,12.934,6,29,23
243,ASV,P002100,P009818,5.584,-11,7,18
243,ASV,P002100,P010316,20.417,10,57,47
243,ASV,P002100,P010545,11.534,0,32,32
243,ASV,P002100,P011225,1.717,0,2,2
243,ASV,P002100,P013371,15.134,-2,36,38
243,ASV,P002100,P013377,1.583,-5,0,5
243,ASV,P002100,P013405,16.017,13,37,24
243,ASV,P002100,PKIR,2.534,-8,0,8
243,ASV,P007027,P008991,9.4,3,20,17
243,ASV,P007027,P009818,5.517,-10,7,17
243,ASV,P007027,P010316,27.349,-2,72,74
243,ASV,P007027,P010545,18.233,1,54,53
243,ASV,P007027,P011225,15.666,-4,34,38
243,ASV,P007027,P013371,5.833,-2,19,21
243,ASV,P007027,P013377,3.066,-7,2,9
243,ASV,P007027,P013405,20.732,8,52,44
243,ASV,P007027,PKIR,0.25,0,0,0
243,ASV,P008991,P009818,4.234,-15,2,17
243,ASV,P008991,P010316,11.35,11,32,21
243,ASV,P008991,P011225,3.8,-3,7,10
243,ASV,P008991,P013371,8.3,1,20,19
243,ASV,P008991,P013405,8.633,17,26,9
243,ASV,P008991,PKIR,1.417,-8,0,8
243,ASV,P009818,P010316,3.55,-10,5,15
243,ASV,P009818,P010545,2.45,-3,5,8
243,ASV,P009818,P011225,2.817,-7,2,9
243,ASV,P009818,P013371,1.167,-8,0,8
243,ASV,P009818,PKIR,1.417,-8,0,8
243,ASV,P010316,P010545,19.95,2,55,53
243,ASV,P010316,P011225,13.949,-4,32,36
243,ASV,P010316,P013371,11.467,7,34,27
243,ASV,P010316,P013377,3.066,-7,2,9
243,ASV,P010316,P013405,26.366,17,67,50
243,ASV,P010545,P011225,10.383,1,25,24
243,ASV,P010545,P013371,6.834,-3,16,19
243,ASV,P010545,P013405,17.167,6,41,35
243,ASV,P010545,PKIR,1.117,0,0,0
243,ASV,P011225,P013377,1.483,-2,2,4
243,ASV,P011225,P013405,12.849,3,32,29
243,ASV,P013371,P013405,9.517,7,19,12
243,ASV,P013371,PKIR,2.284,-8,0,8
243,ASV,P013377,P013405,3.066,-7,2,9
243,ASV,P013405,PKIR,1.117,0,0,0
243,PAN,P001926,P005161,11.067,2,26,24
243,PAN,P001926,P007866,12.55,4,33,29
243,PAN,P001926,P009622,3.75,-4,7,11
243,PAN,P001926,P011204,15.633,-13,31,44
243,PAN,P001926,P012712,12.75,-5,27,32
243,PAN,P001926,P012774,14.567,4,39,35
243,PAN,P001926,P013383,3.8,-2,11,13
243,PAN,P001926,PLHK,9.283,6,22,16
243,PAN,P004088,P007866,0.45,-2,0,2
243,PAN,P004088,P009622,12.35,-4,26,30
243,PAN,P004088,P011204,1.767,2,6,4
243,PAN,P004088,P012712,12.35,-4,26,30
243,PAN,P004088,P012774,10.583,-6,20,26
243,PAN,P004088,P013383,11.9,-2,26,28
243,PAN,P005161,P007866,9.067,2,24,22
243,PAN,P005161,P009622,5.95,2,17,15
243,PAN,P005161,P011204,5.85,-9,8,17
243,PAN,P005161,P012712,8.184,3,20,17
243,PAN,P005161,P012774,12.151,11,37,26
243,PAN,P005161,P013383,0.85,1,3,2
243,PAN,P005161,PLHK,12.017,12,33,21
243,PAN,P007866,P009622,1.183,-4,1,5
243,PAN,P007866,P011204,7.783,-9,15,24
243,PAN,P007866,P012712,4.9,-1,11,12
243,PAN,P007866,P012774,10.417,9,30,21
243,PAN,P007866,PLHK,5.65,9,18,9
243,PAN,P009622,P011204,7.1,3,18,15
243,PAN,P009622,P012712,22.167,3,53,50
243,PAN,P009622,P012774,18.25,2,42,40
243,PAN,P009622,P013383,16.483,3,39,36
243,PAN,P009622,PLHK,4.367,3,13,10
243,PAN,P011204,P012712,16.1,2,38,36
243,PAN,P011204,P012774,10.933,-2,26,28
243,PAN,P011204,P013383,6.7,7,22,15
243,PAN,P011204,PLHK,4.066,-5,4,9
243,PAN,P012712,P012774,25.016,0,59,59
243,PAN,P012712,P013383,18.133,2,45,43
243,PAN,P012712,PLHK,8.0,0,17,17
243,PAN,P012774,P013383,14.666,-1,34,35
243,PAN,P012774,PLHK,11.217,11,33,22
146,PRS,P004197,P005793,3.733,-9,1,10
146,PRS,P004197,P007032,11.6,-15,15,30
146,PRS,P004197,P011949,7.45,-3,14,17
146,PRS,P004197,P012613,0.417,-3,0,3
146,PRS,P004197,P012640,11.6,-15,15,30
146,PRS,P004197,P013373,11.6,-15,15,30
146,PRS,P005793,P007032,5.834,-16,3,19
146,PRS,P005793,P010390,15.417,11,35,24
146,PRS,P005793,P012608,16.351,6,35,29
146,PRS,P005793,P012610,16.351,6,35,29
146,PRS,P005793,P012613,15.017,8,33,25
146,PRS,P005793,P012640,3.9,-9,1,10
146,PRS,P005793,P013373,3.733,-9,1,10
146,PRS,P007032,P010390,9.367,3,27,24
146,PRS,P007032,P011949,7.45,-3,14,17
146,PRS,P007032,P012608,10.301,-2,27,29
146,PRS,P007032,P012610,10.301,-2,27,29
146,PRS,P007032,P012613,7.251,-5,14,19
146,PRS,P007032,P012640,13.9,-13,26,39
146,PRS,P007032,P013373,11.6,-15,15,30
146,PRS,P010390,P012608,26.867,15,67,52
146,PRS,P010390,P012610,26.867,15,67,52
146,PRS,P010390,P012613,23.567,15,54,39
146,PRS,P010390,P012640,5.383,1,18,17
146,PRS,P011949,P012640,7.45,-3,14,17
146,PRS,P011949,P013373,7.45,-3,14,17
146,PRS,P012608,P012610,28.401,11,68,57
146,PRS,P012608,P012613,24.934,11,55,44
146,PRS,P012608,P012640,6.15,2,19,17
146,PRS,P012608,P013373,0.6,1,1,0
146,PRS,P012610,P012613,24.934,11,55,44
146,PRS,P012610,P012640,6.15,2,19,17
146,PRS,P012610,P013373,0.6,1,1,0
146,PRS,P012613,P012640,4.267,-3,8,11
146,PRS,P012613,P013373,1.017,-2,1,3
146,PRS,P012640,P013373,12.2,-14,16,30
146,ULK,P002849,P002968,5.467,-10,7,17
146,ULK,P002849,P004004,6.15,-8,9,17
146,ULK,P002849,P006961,4.834,-6,8,14
146,ULK,P002849,P007182,1.417,-2,1,3
146,ULK,P002849,P008962,4.717,0,11,11
146,ULK,P002849,P009783,7.45,-9,12,21
146,ULK,P002849,P009863,6.885,-2,15,17
146,ULK,P002849,P010560,1.567,0,2,2
146,ULK,P002849,P011205,7.917,-11,11,22
146,ULK,P002968,P004004,13.85,5,31,26
146,ULK,P002968,P006961,10.017,2,21,19
146,ULK,P002968,P008962,13.5,11,31,20
146,ULK,P002968,P009783,1.966,-5,2,7
146,ULK,P002968,P009863,10.151,5,21,16
146,ULK,P002968,P010560,9.1,6,20,14
146,ULK,P002968,P011205,11.817,-10,19,29
146,ULK,P004004,P006961,12.651,12,35,23
146,ULK,P004004,P007182,5.084,-1,11,12
146,ULK,P004004,P008962,19.084,17,51,34
146,ULK,P004004,P009783,4.166,-11,4,15
146,ULK,P004004,P009863,11.051,13,33,20
146,ULK,P004004,P010560,8.734,7,21,14
146,ULK,P004004,P011205,11.966,6,29,23
146,ULK,P006961,P007182,10.185,2,25,23
146,ULK,P006961,P008962,18.868,21,52,31
146,ULK,P006961,P009783,1.867,-3,3,6
146,ULK,P006961,P009863,20.102,15,54,39
146,ULK,P006961,P010560,6.517,14,16,2
146,ULK,P006961,P011205,7.167,-5,18,23
146,ULK,P007182,P008104,3.433,-8,1,9
146,ULK,P007182,P008962,12.701,-2,27,29
146,ULK,P007182,P009783,5.117,-8,4,12
146,ULK,P007182,P009863,8.401,3,23,20
146,ULK,P007182,P010560,4.101,9,11,2
146,ULK,P007182,P011205,6.033,-9,9,18
146,ULK,P008104,P008962,3.433,-8,1,9
146,ULK,P008104,P009783,3.433,-8,1,9
146,ULK,P008104,P011205,3.433,-8,1,9
146,ULK,P008962,P009783,7.767,-8,12,20
146,ULK,P008962,P009863,21.235,17,57,40
146,ULK,P008962,P010560,12.934,19,33,14
146,ULK,P008962,P011205,18.233,-3,41,44
146,ULK,P009783,P009863,4.568,3,12,9
146,ULK,P009783,P011205,8.266,-11,10,21
146,ULK,P009863,P010560,5.117,10,12,2
146,ULK,P009863,P011205,10.234,-4,25,29
146,ULK,P010560,P011205,7.334,3,17,14
244,MCO,P002581,P005985,2.617,1,3,2
244,MCO,P002581,P008099,10.684,-9,20,29
244,MCO,P002581,P009754,7.151,-10,14,24
244,MCO,P002581,P011212,5.067,-2,9,11
244,MCO,P002581,P011226,9.134,-4,23,27
244,MCO,P002581,P011231,11.551,-8,23,31
244,MCO,P004132,P004790,11.25,11,24,13
244,MCO,P004132,P005985,26.501,18,62,44
244,MCO,P004132,P008099,6.067,6,18,12
244,MCO,P004132,P009754,16.335,19,50,31
244,MCO,P004132,P011212,25.717,14,58,44
244,MCO,P004132,P011226,22.05,7,41,34
244,MCO,P004132,P011231,5.884,5,19,14
244,MCO,P004790,P005985,11.25,11,24,13
244,MCO,P004790,P009754,3.567,7,14,7
244,MCO,P004790,P011212,11.25,11,24,13
244,MCO,P004790,P011226,7.683,4,10,6
244,MCO,P005985,P008099,5.867,4,12,8
244,MCO,P005985,P009754,16.952,20,51,31
244,MCO,P005985,P011212,25.317,12,52,40
244,MCO,P005985,P011226,20.967,6,38,32
244,MCO,P005985,P011231,7.001,4,18,14
244,MCO,P008099,P009754,9.468,-5,23,28
244,MCO,P008099,P011212,8.4,-2,17,19
244,MCO,P008099,P011226,12.867,-3,30,33
244,MCO,P008099,P011231,13.651,-3,32,35
244,MCO,P009754,P011212,14.268,9,40,31
244,MCO,P009754,P011226,16.218,0,37,37
244,MCO,P009754,P011231,9.985,-4,27,31
244,MCO,P011212,P011226,23.633,7,48,41
244,MCO,P011212,P011231,9.484,-1,20,21
244,MCO,P011226,P011231,12.184,-5,29,34
244,PRS,P004197,P004512,11.6,-1,31,32
244,PRS,P004197,P005793,1.667,0,4,4
244,PRS,P004197,P007032,14.317,-9,31,40
244,PRS,P004197,P011949,13.75,-5,31,36
244,PRS,P004197,P012608,1.2,-2,2,4
244,PRS,P004197,P012611,3.767,11,13,2
244,PRS,P004197,P012613,1.2,-2,2,4
244,PRS,P004197,P012640,16.884,4,42,38
244,PRS,P004197,P013373,7.951,12,20,8
244,PRS,P004512,P007032,9.516,-13,22,35
244,PRS,P004512,P011949,10.366,-18,22,40
244,PRS,P004512,P012608,0.85,-5,0,5
244,PRS,P004512,P012610,1.433,-10,0,10
244,PRS,P004512,P012611,2.667,7,9,2
244,PRS,P004512,P012640,13.033,-11,31,42
244,PRS,P004512,P013373,2.667,7,9,2
244,PRS,P005793,P007032,2.35,1,5,4
244,PRS,P005793,P010390,9.55,0,13,13
244,PRS,P005793,P012608,10.75,-2,15,17
244,PRS,P005793,P012610,8.867,-1,12,13
244,PRS,P005793,P012613,10.75,-2,15,17
244,PRS,P005793,P012640,0.467,2,2,0
244,PRS,P005793,P013373,0.467,2,2,0
244,PRS,P007032,P010390,3.366,0,10,10
244,PRS,P007032,P011949,14.583,-20,29,49
244,PRS,P007032,P012608,5.916,-8,14,22
244,PRS,P007032,P012610,3.266,-6,9,15
244,PRS,P007032,P012613,5.049,-2,14,16
244,PRS,P007032,P012640,15.05,-18,31,49
244,PRS,P007032,P013373,5.051,-5,7,12
244,PRS,P010390,P011949,1.117,0,0,0
244,PRS,P010390,P012608,19.133,2,33,31
244,PRS,P010390,P012610,18.45,1,32,31
244,PRS,P010390,P012613,18.016,2,33,31
244,PRS,P010390,P012640,6.9,3,11,8
244,PRS,P011949,P012608,3.317,-11,2,13
244,PRS,P011949,P012610,2.55,-10,0,10
244,PRS,P011949,P012611,1.1,4,4,0
244,PRS,P011949,P012613,0.483,0,2,2
244,PRS,P011949,P012640,17.65,-21,33,54
244,PRS,P011949,P013373,5.684,-3,9,12
244,PRS,P012608,P012610,19.3,-4,32,36
244,PRS,P012608,P012613,19.699,0,37,37
244,PRS,P012608,P012640,9.1,-8,13,21
244,PRS,P012608,P013373,0.867,-6,0,6
244,PRS,P012610,P012613,17.333,1,32,31
244,PRS,P012610,P012640,8.333,-7,11,18
244,PRS,P012611,P012640,3.767,11,13,2
244,PRS,P012611,P013373,3.767,11,13,2
244,PRS,P012613,P012640,6.266,3,13,10
244,PRS,P012640,P013373,8.818,6,20,14
245,MAD,P003108,P003583,6.383,-5,6,11
245,MAD,P003108,P003733,16.333,-12,26,38
245,MAD,P003108,P005791,19.784,-16,39,55
245,MAD,P003108,P005928,24.033,-14,41,55
245,MAD,P003108,P006540,24.367,-9,47,56
245,MAD,P003108,P007630,13.049,-4,20,24
245,MAD,P003108,P009213,2.484,-6,4,10
245,MAD,P003108,P011247,3.934,-2,8,10
245,MAD,P003108,P011649,3.35,-6,4,10
245,MAD,P003108,P013667,7.917,-1,13,14
245,MAD,P003108,PTGB,16.634,-9,32,41
245,MAD,P003583,P003733,6.383,-5,6,11
245,MAD,P003583,P005928,6.383,-5,6,11
245,MAD,P003583,P007630,6.383,-5,6,11
245,MAD,P003733,P005791,9.617,-7,20,27
245,MAD,P003733,P005928,17.55,-12,26,38
245,MAD,P003733,P006540,6.966,0,15,15
245,MAD,P003733,P007630,9.566,-5,11,16
245,MAD,P003733,P009213,1.167,-3,2,5
245,MAD,P003733,P013667,2.433,0,2,2
245,MAD,P003733,PTGB,3.517,-4,4,8
245,MAD,P005791,P005928,14.767,-12,29,41
245,MAD,P005791,P006540,19.35,-3,40,43
245,MAD,P005791,P007630,1.133,0,3,3
245,MAD,P005791,P009213,2.484,-6,4,10
245,MAD,P005791,P011247,3.934,-2,8,10
245,MAD,P005791,P011649,5.683,2,10,8
245,MAD,P005791,P013667,3.433,6,8,2
245,MAD,P005791,PTGB,12.483,-2,27,29
245,MAD,P005928,P006540,13.833,-2,28,30
245,MAD,P005928,P007630,9.266,-4,11,15
245,MAD,P005928,P009213,1.167,-3,2,5
245,MAD,P005928,P011649,1.75,-1,2,3
245,MAD,P005928,P013667,3.617,2,4,2
245,MAD,P005928,PTGB,8.634,-5,15,20
245,MAD,P006540,P007630,6.366,1,13,12
245,MAD,P006540,P009213,1.317,-3,2,5
245,MAD,P006540,P011247,3.934,-2,8,10
245,MAD,P006540,P011649,6.733,0,12,12
245,MAD,P006540,P013667,12.083,5,23,18
245,MAD,P006540,PTGB,19.383,1,40,39
245,MAD,P007630,P011649,0.533,1,2,1
245,MAD,P007630,P013667,7.05,0,11,11
245,MAD,P007630,PTGB,7.05,0,11,11
245,MAD,P009213,P011247,1.317,-3,2,5
245,MAD,P011247,PTGB,2.617,1,6,5
245,MAD,P011649,P013667,3.9,3,8,5
245,MAD,P011649,PTGB,4.983,1,10,9
245,MAD,P013667,PTGB,12.967,5,23,18
245,PAN,P001926,P004088,7.366,6,17,11
245,PAN,P001926,P005161,5.75,-5,7,12
245,PAN,P001926,P007866,14.717,17,42,25
245,PAN,P001926,P009622,7.133,-3,11,14
245,PAN,P001926,P011204,16.034,5,31,26
245,PAN,P001926,P011209,0.317,-2,0,2
245,PAN,P001926,P011442,0.534,-2,0,2
245,PAN,P001926,P012712,12.949,6,28,22
245,PAN,P001926,P012774,18.866,13,44,31
245,PAN,P001926,P013383,6.133,-5,4,9
245,PAN,P001926,PLHK,2.133,-6,0,6
245,PAN,P004088,P007866,10.383,10,32,22
245,PAN,P004088,P009622,0.833,2,4,2
245,PAN,P004088,P011204,18.967,13,46,33
245,PAN,P004088,P012712,18.05,10,45,35
245,PAN,P004088,P012774,20.433,20,56,36
245,PAN,P004088,P013383,10.95,7,24,17
245,PAN,P004088,PLHK,0.55,0,0,0
245,PAN,P005161,P007866,2.4,3,5,2
245,PAN,P005161,P009622,5.667,-5,7,12
245,PAN,P005161,P011204,1.767,-2,2,4
245,PAN,P005161,P012712,0.083,0,0,0
245,PAN,P005161,P012774,3.983,-3,5,8
245,PAN,P005161,P013383,1.767,-2,2,4
245,PAN,P005161,PLHK,1.583,-6,0,6
245,PAN,P007866,P009622,2.65,3,7,4
245,PAN,P007866,P011204,16.184,15,46,31
245,PAN,P007866,P011209,0.317,-2,0,2
245,PAN,P007866,P011442,0.534,-2,0,2
245,PAN,P007866,P012712,14.233,14,45,31
245,PAN,P007866,P012774,20.05,22,59,37
245,PAN,P009622,P011204,2.35,-2,2,4
245,PAN,P009622,P012712,0.633,0,0,0
245,PAN,P009622,P012774,4.783,-1,9,10
245,PAN,P009622,P013383,2.983,0,4,4
245,PAN,P009622,PLHK,1.5,-6,0,6
245,PAN,P011204,P011209,2.817,-4,0,4
245,PAN,P011204,P011442,0.534,-2,0,2
245,PAN,P011204,P012712,27.75,13,61,48
245,PAN,P011204,P012774,28.934,21,68,47
245,PAN,P011204,P013383,14.367,1,24,23
245,PAN,P011204,PLHK,2.5,-2,0,2
245,PAN,P011209,P011442,0.317,-2,0,2
245,PAN,P011209,P012712,2.5,-2,0,2
245,PAN,P011209,P012774,2.5,-2,0,2
245,PAN,P011209,PLHK,2.5,-2,0,2
245,PAN,P011442,P012774,0.217,0,0,0
245,PAN,P012712,P012774,27.933,18,67,49
245,PAN,P012712,P013383,12.6,3,22,19
245,PAN,P012712,PLHK,3.133,-2,0,2
245,PAN,P012774,P013383,11.2,8,24,16
245,PAN,P012774,PLHK,4.633,-8,0,8
246,BAS,P004058,P007230,1.633,3,5,2
246,BAS,P004058,P007579,10.933,-2,19,21
246,BAS,P004058,P008072,0.333,0,0,0
246,BAS,P004058,P011085,11.617,1,21,20
246,BAS,P004058,P011196,13.033,4,26,22
246,BAS,P004058,P011948,11.683,0,21,21
246,BAS,P004058,P012080,2.333,2,5,3
246,BAS,P004058,P012201,2.967,4,7,3
246,BAS,P007230,P008072,10.95,-3,12,15
246,BAS,P007230,P011085,0.35,0,0,0
246,BAS,P007230,P011196,7.1,5,15,10
246,BAS,P007230,P011948,4.833,2,10,8
246,BAS,P007230,P012080,13.567,0,17,17
246,BAS,P007230,P012201,18.4,2,27,25
246,BAS,P007230,P013367,16.767,-1,22,23
246,BAS,P007579,P011085,14.083,-8,24,32
246,BAS,P007579,P011196,10.666,-1,19,20
246,BAS,P007579,P011948,14.466,-9,24,33
246,BAS,P007579,P012080,0.383,-1,0,1
246,BAS,P007579,P012201,3.8,-8,5,13
246,BAS,P007579,P013367,3.533,-7,5,12
246,BAS,P008072,P011948,0.75,-2,0,2
246,BAS,P008072,P012080,11.7,-5,12,17
246,BAS,P008072,P012201,11.7,-5,12,17
246,BAS,P008072,P013367,11.367,-5,12,17
246,BAS,P011085,P011196,12.767,5,26,21
246,BAS,P011085,P011948,16.0,-3,31,34
246,BAS,P011085,P012080,0.917,0,0,0
246,BAS,P011085,P012201,6.634,-3,12,15
246,BAS,P011085,P013367,5.3,-4,10,14
246,BAS,P011196,P011948,21.316,11,44,33
246,BAS,P011196,P012080,7.117,7,13,6
246,BAS,P011196,P012201,13.484,15,30,15
246,BAS,P011196,P013367,11.117,10,23,13
246,BAS,P011948,P012080,5.033,2,8,6
246,BAS,P011948,P012201,15.2,2,30,28
246,BAS,P011948,P013367,14.183,1,28,27
246,BAS,P012080,P012201,18.784,3,25,22
246,BAS,P012080,P013367,16.834,0,20,20
246,BAS,P012201,P013367,26.367,-2,40,42
246,ZAL,P002329,P002676,11.784,-1,17,18
246,ZAL,P002329,P003048,12.618,-1,22,23
246,ZAL,P002329,P005504,8.9,1,12,11
246,ZAL,P002329,P007029,9.434,-6,12,18
246,ZAL,P002329,P007513,18.684,9,37,28
246,ZAL,P002329,P007975,24.484,12,46,34
246,ZAL,P002329,P011051,7.667,8,18,10
246,ZAL,P002329,P011983,18.551,12,38,26
246,ZAL,P002329,P013775,4.35,-2,6,8
246,ZAL,P002676,P003048,5.567,-10,7,17
246,ZAL,P002676,P005504,13.7,4,19,15
246,ZAL,P002676,P007029,1.767,-5,2,7
246,ZAL,P002676,P007513,3.367,0,4,4
246,ZAL,P002676,P007975,18.8,-1,26,27
246,ZAL,P002676,P011051,5.533,-2,7,9
246,ZAL,P002676,P011983,16.3,-6,22,28
246,ZAL,P002676,P012622,0.25,-3,0,3
246,ZAL,P003048,P007029,10.318,-6,12,18
246,ZAL,P003048,P007513,11.284,-1,19,20
246,ZAL,P003048,P007975,11.417,-3,20,23
246,ZAL,P003048,P011051,3.967,-6,4,10
246,ZAL,P003048,P011983,10.884,-7,18,25
246,ZAL,P003048,P012622,0.25,-3,0,3
246,ZAL,P003048,P013775,7.567,-3,10,13
246,ZAL,P005504,P007029,1.533,-3,2,5
246,ZAL,P005504,P007513,1.683,-1,2,3
246,ZAL,P005504,P007975,13.933,1,19,18
246,ZAL,P005504,P011051,5.033,0,7,7
246,ZAL,P005504,P011983,10.95,2,15,13
246,ZAL,P007029,P007513,7.817,-6,10,16
246,ZAL,P007029,P007975,4.8,-2,6,8
246,ZAL,P007029,P011051,2.234,0,2,2
246,ZAL,P007029,P011983,2.734,-3,2,5
246,ZAL,P007029,P012622,0.25,-3,0,3
246,ZAL,P007029,P013775,6.517,-2,8,10
246,ZAL,P007513,P007975,16.0,10,33,23
246,ZAL,P007513,P011051,7.783,5,18,13
246,ZAL,P007513,P011983,11.3,10,27,17
246,ZAL,P007513,P013775,4.35,-2,6,8
246,ZAL,P007975,P011051,14.366,2,27,25
246,ZAL,P007975,P011983,26.95,6,49,43
246,ZAL,P007975,P013775,1.05,-1,2,3
246,ZAL,P011051,P011983,16.6,2,29,27
246,ZAL,P011051,P013775,3.217,-1,4,5
246,ZAL,P011983,P012622,0.25,-3,0,3
246,ZAL,P011983,P013775,3.217,-1,4,5
247,MIL,P000796,P001392,5.917,-8,11,19
247,MIL,P000796,P001518,9.883,4,23,19
247,MIL,P000796,P005670,2.167,-5,3,8
247,MIL,P000796,P006085,3.75,-3,8,11
247,MIL,P000796,P006509,3.55,-3,7,10
247,MIL,P000796,P007831,13.367,-4,27,31
247,MIL,P000796,P008985,5.467,-1,12,13
247,MIL,P000796,P008987,13.367,-4,27,31
247,MIL,P000796,P011064,9.483,-1,20,21
247,MIL,P000796,P011941,1.517,-3,2,5
247,MIL,P001392,P001518,8.665,-8,15,23
247,MIL,P001392,P005670,2.667,-5,3,8
247,MIL,P001392,P006085,10.932,-14,19,33
247,MIL,P001392,P006509,3.066,-5,2,7
247,MIL,P001392,P006721,2.816,-3,6,9
247,MIL,P001392,P007831,2.2,-7,3,10
247,MIL,P001392,P008985,13.065,-18,22,40
247,MIL,P001392,P008987,9.416,-17,11,28
247,MIL,P001392,P011064,1.517,-1,3,4
247,MIL,P001392,P011941,3.667,-6,5,11
247,MIL,P001518,P005670,6.267,2,15,13
247,MIL,P001518,P006085,7.049,-5,15,20
247,MIL,P001518,P006509,8.333,1,17,16
247,MIL,P001518,P006721,8.25,3,22,19
247,MIL,P001518,P007831,11.183,1,25,24
247,MIL,P001518,P008985,12.948,-9,25,34
247,MIL,P001518,P008987,18.466,-3,37,40
247,MIL,P001518,P011064,10.167,3,23,20
247,MIL,P001518,P011941,1.117,-1,3,4
247,MIL,P005670,P006509,6.267,2,15,13
247,MIL,P005670,P006721,5.767,2,15,13
247,MIL,P005670,P007831,2.167,-5,3,8
247,MIL,P005670,P008985,3.8,-1,8,9
247,MIL,P005670,P008987,4.634,-2,10,12
247,MIL,P006085,P006509,1.733,-4,2,6
247,MIL,P006085,P006721,2.816,-3,6,9
247,MIL,P006085,P008985,10.932,-14,19,33
247,MIL,P006085,P008987,4.366,-8,5,13
247,MIL,P006085,P011941,2.15,-5,2,7
247,MIL,P006509,P006721,11.05,-5,21,26
247,MIL,P006509,P007831,8.333,-6,13,19
247,MIL,P006509,P008985,9.316,-4,16,20
247,MIL,P006509,P008987,11.633,-4,20,24
247,MIL,P006509,P011064,5.383,-8,7,15
247,MIL,P006721,P007831,4.95,-3,7,10
247,MIL,P006721,P008985,6.616,-4,14,18
247,MIL,P006721,P008987,6.917,0,14,14
247,MIL,P006721,P011064,4.95,-3,7,10
247,MIL,P007831,P008985,2.983,0,6,6
247,MIL,P007831,P008987,20.45,-10,39,49
247,MIL,P007831,P011064,15.3,-5,30,35
247,MIL,P007831,P011941,0.867,-1,3,4
247,MIL,P008985,P008987,9.449,-10,14,24
247,MIL,P008985,P011064,1.267,-1,3,4
247,MIL,P008985,P011941,3.417,-6,5,11
247,MIL,P008987,P011064,16.817,-6,33,39
247,MIL,P008987,P011941,3.017,-4,6,10
247,MIL,P011064,P011941,2.384,-2,6,8
247,ULK,P002849,P002968,4.333,5,13,8
247,ULK,P002849,P004004,2.3,3,8,5
247,ULK,P002849,P005216,16.566,12,45,33
247,ULK,P002849,P006961,12.367,15,36,21
247,ULK,P002849,P008962,2.534,5,9,4
247,ULK,P002849,P009783,2.75,2,6,4
247,ULK,P002849,P009863,10.65,9,28,19
247,ULK,P002849,P010560,5.816,-2,13,15
247,ULK,P002849,P011205,6.7,2,17,15
247,ULK,P002849,P013696,8.516,1,21,20
247,ULK,P002968,P004004,1.4,0,3,3
247,ULK,P002968,P005216,9.549,11,27,16
247,ULK,P002968,P006961,7.166,8,22,14
247,ULK,P002968,P008962,7.783,6,19,13
247,ULK,P002968,P009783,4.95,3,10,7
247,ULK,P002968,P009863,10.716,11,29,18
247,ULK,P002968,P011205,2.567,0,5,5
247,ULK,P004004,P005216,2.917,3,8,5
247,ULK,P004004,P006961,4.217,1,10,9
247,ULK,P004004,P007182,10.384,-2,20,22
247,ULK,P004004,P008962,13.134,-2,25,27
247,ULK,P004004,P009783,11.167,0,23,23
247,ULK,P004004,P010560,0.05,0,0,0
247,ULK,P004004,P011205,12.417,-2,25,27
247,ULK,P004004,P013696,3.55,3,10,7
247,ULK,P005216,P006961,14.333,19,43,24
247,ULK,P005216,P008962,6.883,12,21,9
247,ULK,P005216,P009783,5.166,7,13,6
247,ULK,P005216,P009863,14.382,16,40,24
247,ULK,P005216,P010560,5.766,-2,13,15
247,ULK,P005216,P011205,5.183,1,13,12
247,ULK,P005216,P013696,9.183,1,21,20
247,ULK,P006961,P007182,0.617,-2,0,2
247,ULK,P006961,P008962,7.317,8,22,14
247,ULK,P006961,P009783,2.783,4,8,4
247,ULK,P006961,P009863,12.933,17,39,22
247,ULK,P006961,P010560,0.05,0,0,0
247,ULK,P006961,P011205,2.767,-1,6,7
247,ULK,P006961,P013696,4.05,3,10,7
247,ULK,P007182,P008962,12.751,3,28,25
247,ULK,P007182,P009783,12.134,5,28,23
247,ULK,P007182,P009863,1.75,3,6,3
247,ULK,P007182,P010560,0.617,2,2,0
247,ULK,P007182,P011205,12.751,3,28,25
247,ULK,P008962,P009783,17.117,10,40,30
247,ULK,P008962,P009863,10.65,16,33,17
247,ULK,P008962,P010560,0.667,2,2,0
247,ULK,P008962,P011205,17.468,4,39,35
247,ULK,P008962,P013696,1.3,0,2,2
247,ULK,P009783,P009863,8.083,10,21,11
247,ULK,P009783,P010560,0.617,2,2,0
247,ULK,P009783,P011205,14.701,5,33,28
247,ULK,P009863,P010560,0.583,-3,0,3
247,ULK,P009863,P011205,4.434,4,12,8
247,ULK,P009863,P013696,1.083,-3,0,3
247,ULK,P010560,P011205,5.8,3,15,12
247,ULK,P010560,P013696,5.766,-2,13,15
247,ULK,P011205,P013696,5.816,1,15,14
248,MUN,P001288,P001557,11.567,12,30,18
248,MUN,P001288,P004508,23.967,4,55,51
248,MUN,P001288,P005460,3.234,-9,0,9
248,MUN,P001288,P007201,27.917,16,70,54
248,MUN,P001288,P007639,7.85,1,20,19
248,MUN,P001288,P010391,21.517,20,57,37
248,MUN,P001288,P011224,23.65,26,70,44
248,MUN,P001288,P011987,29.634,18,78,60
248,MUN,P001557,P004508,10.367,0,22,22
248,MUN,P001557,P007201,10.934,2,25,23
248,MUN,P001557,P007639,1.85,1,5,4
248,MUN,P001557,P010391,7.85,4,18,14
248,MUN,P001557,P011224,7.834,9,22,13
248,MUN,P001557,P011987,6.534,4,18,14
248,MUN,P004508,P005460,0.117,0,0,0
248,MUN,P004508,P007201,18.667,-1,40,41
248,MUN,P004508,P007639,7.85,1,20,19
248,MUN,P004508,P010391,8.15,2,17,15
248,MUN,P004508,P011224,18.484,-2,43,45
248,MUN,P004508,P011987,18.934,-4,43,47
248,MUN,P005460,P007201,3.117,-9,0,9
248,MUN,P005460,P010391,3.234,-9,0,9
248,MUN,P005460,P011987,3.234,-9,0,9
248,MUN,P007201,P010391,18.1,14,47,33
248,MUN,P007201,P011224,18.867,17,55,38
248,MUN,P007201,P011987,24.734,9,63,54
248,MUN,P007639,P010391,1.85,1,5,4
248,MUN,P007639,P011224,6.0,0,15,15
248,MUN,P007639,P011987,6.0,0,15,15
248,MUN,P010391,P011224,7.833,24,32,8
248,MUN,P010391,P011987,17.534,24,52,28
248,MUN,P011224,P011987,22.6,14,63,49
248,RED,P000848,P004866,5.734,-6,10,16
248,RED,P000848,P006436,13.917,0,35,35
248,RED,P000848,P007960,5.084,0,12,12
248,RED,P000848,P009035,19.517,9,53,44
248,RED,P000848,P009048,4.467,-8,7,15
248,RED,P000848,P010588,2.416,1,9,8
248,RED,P000848,P010612,17.067,7,47,40
248,RED,P000848,P011194,4.767,-6,7,13
248,RED,P000848,P012044,9.95,5,28,23
248,RED,P000848,PJDR,7.817,2,20,18
248,RED,P004007,P004866,15.183,-17,23,40
248,RED,P004007,P006436,1.783,-6,2,8
248,RED,P004007,P007960,7.767,0,15,15
248,RED,P004007,P009035,15.001,-9,25,34
248,RED,P004007,P009048,14.034,-5,25,30
248,RED,P004007,P010588,4.45,-12,2,14
248,RED,P004007,P010612,4.45,-12,2,14
248,RED,P004007,P012044,1.8,-6,0,6
248,RED,P004007,PJDR,4.8,-9,6,15
248,RED,P004866,P006436,3.85,-11,4,15
248,RED,P004866,P007960,9.834,-3,20,23
248,RED,P004866,P009035,16.651,-8,31,39
248,RED,P004866,P009048,17.334,-15,30,45
248,RED,P004866,P010588,2.316,-10,0,10
248,RED,P004866,P010612,2.433,-10,0,10
248,RED,P004866,P011194,3.55,-3,5,8
248,RED,P004866,P012044,1.983,0,3,3
248,RED,P004866,PJDR,4.8,-9,6,15
248,RED,P006436,P009035,12.383,5,33,28
248,RED,P006436,P009048,3.583,-8,4,12
248,RED,P006436,P010588,0.483,-1,2,3
248,RED,P006436,P010612,12.117,2,33,31
248,RED,P006436,P011194,3.167,-8,4,12
248,RED,P006436,P012044,3.7,1,11,10
248,RED,P006436,PJDR,7.817,2,20,18
248,RED,P007960,P009035,12.851,0,27,27
248,RED,P007960,P009048,9.834,-3,20,23
248,RED,P007960,P010612,3.017,3,7,4
248,RED,P007960,P012044,3.017,3,7,4
248,RED,P009035,P009048,16.551,-8,30,38
248,RED,P009035,P010588,4.55,-1,11,12
248,RED,P009035,P010612,17.984,8,47,39
248,RED,P009035,P011194,1.6,2,3,1
248,RED,P009035,P012044,9.7,4,26,22
248,RED,P009035,PJDR,11.284,-2,26,28
248,RED,P009048,P010588,1.167,2,2,0
248,RED,P009048,P010612,1.167,2,2,0
248,RED,P009048,P011194,2.4,-5,2,7
248,RED,P009048,PJDR,3.467,-4,6,10
248,RED,P010588,P010612,6.866,-11,11,22
248,RED,P010588,P012044,3.883,-7,7,14
248,RED,P010588,PJDR,1.333,-5,0,5
248,RED,P010612,P011194,1.217,-3,2,5
248,RED,P010612,P012044,10.6,-3,25,28
248,RED,P010612,PJDR,9.15,-3,20,23
248,RED,P011194,P012044,2.367,-1,5,6
249,IST,P004887,P007109,10.417,17,25,8
249,IST,P004887,P007200,20.933,17,45,28
249,IST,P004887,P009846,19.75,21,47,26
249,IST,P004887,P011078,22.083,23,51,28
249,IST,P004887,P012710,13.699,5,29,24
249,IST,P004887,P012742,4.366,1,7,6
249,IST,P004887,P013363,5.216,4,12,8
249,IST,P006372,P007109,0.983,3,5,2
249,IST,P006372,P011078,0.983,3,5,2
249,IST,P006372,P012742,0.983,3,5,2
249,IST,P006372,P012788,0.983,3,5,2
249,IST,P006590,P007109,3.616,-9,2,11
249,IST,P006590,P007200,1.133,-6,0,6
249,IST,P006590,P012742,2.483,-3,2,5
249,IST,P006590,P012788,3.616,-9,2,11
249,IST,P006590,P013363,3.616,-9,2,11
249,IST,P007109,P007200,17.049,15,43,28
249,IST,P007109,P009846,18.25,22,46,24
249,IST,P007109,P011078,14.316,18,35,17
249,IST,P007109,P012742,11.266,7,28,21
249,IST,P007109,P012788,13.549,1,31,30
249,IST,P007109,P013363,6.882,-10,9,19
249,IST,P007200,P009846,24.4,24,59,35
249,IST,P007200,P011078,20.166,16,45,29
249,IST,P007200,P012710,13.1,2,26,24
249,IST,P007200,P012742,8.85,7,24,17
249,IST,P007200,P012788,9.183,2,24,22
249,IST,P007200,P013363,5.782,-9,10,19
249,IST,P009846,P011078,21.433,19,49,30
249,IST,P009846,P012710,10.2,4,22,18
249,IST,P009846,P012742,8.667,7,21,14
249,IST,P009846,P012788,8.584,7,21,14
249,IST,P009846,P013363,2.516,0,7,7
249,IST,P011078,P012710,11.666,6,26,20
249,IST,P011078,P012742,4.966,5,11,6
249,IST,P011078,P012788,3.783,3,10,7
249,IST,P011078,P013363,4.532,3,12,9
249,IST,P012710,P012742,6.583,1,11,10
249,IST,P012710,P012788,2.217,0,4,4
249,IST,P012710,P013363,6.199,2,14,12
249,IST,P012742,P012788,13.4,7,32,25
249,IST,P012742,P013363,9.832,-3,15,18
249,IST,P012788,P013363,7.749,-10,11,21
249,VIR,P001133,P001844,15.117,-9,24,33
249,VIR,P001133,P004554,8.65,-11,15,26
249,VIR,P001133,P005738,1.417,-5,0,5
249,VIR,P001133,P006739,9.434,-13,13,26
249,VIR,P001133,P009549,12.768,-12,20,32
249,VIR,P001133,P011816,9.799,-5,17,22
249,VIR,P001133,P012585,13.717,-10,21,31
249,VIR,P001133,P013374,11.434,-6,18,24
249,VIR,P001133,P013695,13.6,-17,20,37
249,VIR,P001844,P002084,3.517,-3,4,7
249,VIR,P001844,P004554,3.85,0,7,7
249,VIR,P001844,P005738,2.334,-5,0,5
249,VIR,P001844,P006739,1.484,0,0,0
249,VIR,P001844,P009549,8.834,-10,14,24
249,VIR,P001844,P011816,7.466,3,14,11
249,VIR,P001844,P012585,12.934,-9,19,28
249,VIR,P001844,P013374,9.967,-7,17,24
249,VIR,P001844,P013695,9.033,-8,13,21
249,VIR,P002084,P004554,7.534,2,17,15
249,VIR,P002084,P005738,1.167,0,0,0
249,VIR,P002084,P006739,13.417,4,27,23
249,VIR,P002084,P009549,8.5,-11,12,23
249,VIR,P002084,P011816,10.517,5,25,20
249,VIR,P002084,P012585,7.633,-2,11,13
249,VIR,P002084,P013374,7.233,-3,12,15
249,VIR,P002084,P013695,4.55,12,16,4
249,VIR,P004554,P006739,12.334,-9,25,34
249,VIR,P004554,P009549,10.517,-9,19,28
249,VIR,P004554,P011816,9.584,-7,19,26
249,VIR,P004554,P012585,1.833,-6,2,8
249,VIR,P004554,P013695,10.434,4,24,20
249,VIR,P005738,P006739,1.734,0,0,0
249,VIR,P005738,P009549,0.25,0,0,0
249,VIR,P005738,P012585,2.584,-5,0,5
249,VIR,P005738,P013695,0.85,-5,0,5
249,VIR,P006739,P009549,12.434,-13,18,31
249,VIR,P006739,P011816,12.85,-3,28,31
249,VIR,P006739,P012585,9.9,-3,13,16
249,VIR,P006739,P013374,8.7,-2,13,15
249,VIR,P006739,P013695,9.117,3,23,20
249,VIR,P009549,P011816,3.917,-7,6,13
249,VIR,P009549,P012585,8.317,-4,13,17
249,VIR,P009549,P013374,10.418,-16,11,27
249,VIR,P009549,P013695,9.117,-10,15,25
249,VIR,P011816,P012585,10.699,-3,19,22
249,VIR,P011816,P013374,8.249,7,19,12
249,VIR,P011816,P013695,8.183,10,21,11
249,VIR,P012585,P013374,14.367,-3,24,27
249,VIR,P012585,P013695,3.416,-3,6,9
249,VIR,P013374,P013695,4.3,-6,6,12
250,ASV,P000229,P004194,3.25,-1,10,11
250,ASV,P000229,P010316,0.65,2,2,0
250,ASV,P000229,P010545,4.133,-2,12,14
250,ASV,P000229,P011225,4.133,-2,12,14
250,ASV,P000229,P013371,0.233,-3,0,3
250,ASV,P000229,P013405,4.133,-2,12,14
250,ASV,P002100,P003526,1.95,1,3,2
250,ASV,P002100,P004194,12.85,-3,31,34
250,ASV,P002100,P008991,4.883,-8,10,18
250,ASV,P002100,P009818,9.267,-2,19,21
250,ASV,P002100,P010316,19.067,-3,51,54
250,ASV,P002100,P010545,16.818,4,41,37
250,ASV,P002100,P011225,15.201,7,42,35
250,ASV,P002100,P013371,13.516,-9,29,38
250,ASV,P002100,P013405,21.316,5,58,53
250,ASV,P003526,P004194,0.75,-2,0,2
250,ASV,P003526,P007027,3.3,-1,4,5
250,ASV,P003526,P010316,3.867,-2,8,10
250,ASV,P003526,P010545,9.0,-2,15,17
250,ASV,P003526,P011225,9.017,-2,15,17
250,ASV,P003526,P013371,0.083,0,0,0
250,ASV,P003526,P013405,8.433,0,15,15
250,ASV,P004194,P008991,2.0,-1,6,7
250,ASV,P004194,P009818,3.583,-4,5,9
250,ASV,P004194,P010316,10.067,1,28,27
250,ASV,P004194,P010545,7.101,-5,15,20
250,ASV,P004194,P011225,7.967,5,27,22
250,ASV,P004194,P013371,8.133,-9,14,23
250,ASV,P004194,P013405,8.699,3,28,25
250,ASV,P007027,P010545,3.3,-1,4,5
250,ASV,P007027,P011225,3.3,-1,4,5
250,ASV,P007027,P013405,3.3,-1,4,5
250,ASV,P008991,P010316,4.883,-8,10,18
250,ASV,P008991,P013371,4.883,-8,10,18
250,ASV,P008991,P013405,2.883,-7,4,11
250,ASV,P009818,P010316,1.55,-2,2,4
250,ASV,P009818,P010545,5.684,2,14,12
250,ASV,P009818,P011225,5.167,-1,11,12
250,ASV,P009818,P013371,4.1,-1,8,9
250,ASV,P009818,P013405,7.717,0,17,17
250,ASV,P010316,P010545,13.784,1,34,33
250,ASV,P010316,P011225,12.684,7,38,31
250,ASV,P010316,P013371,10.883,-10,23,33
250,ASV,P010316,P013405,16.833,2,48,46
250,ASV,P010545,P011225,23.134,-4,51,55
250,ASV,P010545,P013371,5.2,0,14,14
250,ASV,P010545,P013405,24.25,3,60,57
250,ASV,P011225,P013371,0.233,-3,0,3
250,ASV,P011225,P013405,25.1,2,64,62
250,ASV,P013371,P013405,7.732,-5,18,23
250,TEL,P007990,P011193,3.333,-1,9,10
250,TEL,P007990,P011202,5.533,6,18,12
250,TEL,P007990,P011214,4.483,0,12,12
250,TEL,P007990,P011219,5.683,11,23,12
250,TEL,P007990,P012604,9.516,13,35,22
250,TEL,P007990,P013382,5.283,3,17,14
250,TEL,P007990,P013699,6.833,12,26,14
250,TEL,P011193,P011202,3.833,3,13,10
250,TEL,P011193,P011214,17.233,-8,36,44
250,TEL,P011193,P011219,14.551,-3,30,33
250,TEL,P011193,P011433,2.317,-6,6,12
250,TEL,P011193,P012604,5.966,0,18,18
250,TEL,P011193,P013381,10.317,-4,19,23
250,TEL,P011193,P013382,18.55,-11,40,51
250,TEL,P011193,P013699,3.1,6,9,3
250,TEL,P011202,P011214,12.832,-6,27,33
250,TEL,P011202,P011219,15.166,20,46,26
250,TEL,P011202,P011433,5.149,-6,10,16
250,TEL,P011202,P012604,11.148,7,31,24
250,TEL,P011202,P013381,1.383,-2,0,2
250,TEL,P011202,P013382,11.449,-4,26,30
250,TEL,P011202,P013699,15.499,22,49,27
250,TEL,P011214,P011219,19.85,-1,39,40
250,TEL,P011214,P011433,4.916,-7,12,19
250,TEL,P011214,P012604,8.915,-3,24,27
250,TEL,P011214,P013381,12.083,-4,21,25
250,TEL,P011214,P013382,28.832,-7,64,71
250,TEL,P011214,P013699,12.116,8,33,25
250,TEL,P011219,P011433,2.65,-4,5,9
250,TEL,P011219,P012604,9.783,12,33,21
250,TEL,P011219,P013381,11.35,-6,19,25
250,TEL,P011219,P013382,21.884,-1,48,49
250,TEL,P011219,P013699,16.883,24,53,29
250,TEL,P011433,P012604,6.466,-10,13,23
250,TEL,P011433,P013381,0.55,0,0,0
250,TEL,P011433,P013382,4.65,-12,11,23
250,TEL,P011433,P013699,3.566,1,11,10
250,TEL,P012604,P013381,0.933,2,2,0
250,TEL,P012604,P013382,9.532,-5,28,33
250,TEL,P012604,P013699,12.065,20,44,24
250,TEL,P013381,P013382,11.533,-4,21,25
250,TEL,P013381,P013699,0.183,2,2,0
250,TEL,P013382,P013699,12.083,13,37,24
251,OLY,P001255,P003469,18.001,8,41,33
251,OLY,P001255,P003941,5.534,-1,10,11
251,OLY,P001255,P007853,1.417,-1,2,3
251,OLY,P001255,P007947,8.201,-6,13,19
251,OLY,P001255,P007982,12.25,19,37,18
251,OLY,P001255,P008811,14.917,14,40,26
251,OLY,P001255,P008829,2.45,5,9,4
251,OLY,P001255,P013380,19.034,14,48,34
251,OLY,P003469,P003941,16.851,0,32,32
251,OLY,P003469,P007853,5.434,-3,8,11
251,OLY,P003469,P007947,14.218,-8,23,31
251,OLY,P003469,P007982,16.466,13,40,27
251,OLY,P003469,P008811,13.15,7,31,24
251,OLY,P003469,P008829,10.0,-1,18,19
251,OLY,P003469,P013380,24.567,10,55,45
251,OLY,P003469,P013389,1.317,2,4,2
251,OLY,P003941,P007853,9.084,5,18,13
251,OLY,P003941,P007947,15.285,7,30,23
251,OLY,P003941,P007982,7.333,-2,12,14
251,OLY,P003941,P008829,15.767,4,28,24
251,OLY,P003941,P013380,13.534,0,24,24
251,OLY,P003941,P013389,7.084,7,14,7
251,OLY,P007853,P007947,9.084,5,18,13
251,OLY,P007853,P008829,7.667,6,16,10
251,OLY,P007853,P013389,3.65,8,10,2
251,OLY,P007947,P007982,0.683,-2,0,2
251,OLY,P007947,P008811,3.35,-7,3,10
251,OLY,P007947,P008829,8.434,6,16,10
251,OLY,P007947,P013380,9.551,-5,15,20
251,OLY,P007947,P013389,5.734,10,14,4
251,OLY,P007982,P008811,14.716,12,37,25
251,OLY,P007982,P008829,11.566,-2,21,23
251,OLY,P007982,P013380,22.049,10,49,39
251,OLY,P007982,P013389,3.133,-8,0,8
251,OLY,P008811,P008829,4.233,0,9,9
251,OLY,P008811,P013380,17.383,7,40,33
251,OLY,P008811,P013389,1.783,-5,0,5
251,OLY,P008829,P013380,12.333,-2,21,23
251,OLY,P008829,P013389,7.55,0,10,10
251,OLY,P013380,P013389,5.217,-6,4,10
251,PAR,P004761,P007870,11.85,10,28,18
251,PAR,P004761,P008232,5.283,5,8,3
251,PAR,P004761,P010781,10.983,14,25,11
251,PAR,P004761,P011050,3.883,3,9,6
251,PAR,P004761,P011836,3.4,-6,2,8
251,PAR,P004761,P011981,12.45,-2,19,21
251,PAR,P004761,P012720,5.783,4,12,8
251,PAR,P004761,P013369,9.2,-6,13,19
251,PAR,P004761,P013370,10.9,-2,16,18
251,PAR,P007736,P007870,5.183,-8,4,12
251,PAR,P007736,P008232,2.35,7,9,2
251,PAR,P007736,P010781,7.533,-1,13,14
251,PAR,P007736,P011050,7.533,-1,13,14
251,PAR,P007736,P012720,1.0,-2,0,2
251,PAR,P007736,P013369,6.533,1,13,12
251,PAR,P007870,P008232,9.35,1,19,18
251,PAR,P007870,P010781,23.499,-4,42,46
251,PAR,P007870,P011050,9.066,-5,13,18
251,PAR,P007870,P011836,1.433,-4,2,6
251,PAR,P007870,P011981,5.867,3,14,11
251,PAR,P007870,P012720,15.466,-5,28,33
251,PAR,P007870,P013369,16.833,-11,31,42
251,PAR,P007870,P013370,4.317,3,11,8
251,PAR,P008232,P010781,14.85,5,33,28
251,PAR,P008232,P011050,2.35,7,9,2
251,PAR,P008232,P011981,4.983,-5,5,10
251,PAR,P008232,P012720,9.05,-9,16,25
251,PAR,P008232,P013369,11.433,2,23,21
251,PAR,P008232,P013370,7.083,-1,10,11
251,PAR,P010781,P011050,11.416,2,22,20
251,PAR,P010781,P011836,4.65,-9,6,15
251,PAR,P010781,P011981,10.35,-2,19,21
251,PAR,P010781,P012720,20.816,-14,36,50
251,PAR,P010781,P013369,20.516,-6,40,46
251,PAR,P010781,P013370,5.583,3,12,9
251,PAR,P011050,P012720,4.883,1,9,8
251,PAR,P011050,P013369,6.533,1,13,12
251,PAR,P011836,P011981,6.617,-11,6,17
251,PAR,P011836,P012720,4.65,-9,6,15
251,PAR,P011836,P013369,8.05,-15,8,23
251,PAR,P011836,P013370,3.4,-6,2,8
251,PAR,P011981,P012720,7.25,-8,11,19
251,PAR,P011981,P013369,12.75,-9,19,28
251,PAR,P011981,P013370,10.933,-10,15,25
251,PAR,P012720,P013369,12.233,-10,22,32
251,PAR,P012720,P013370,2.133,-4,4,8
251,PAR,P013369,P013370,7.783,-7,10,17
252,BAR,P002939,P003196,13.4,17,43,26
252,BAR,P002939,P003478,17.483,4,39,35
252,BAR,P002939,P006568,14.951,9,37,28
252,BAR,P002939,P007464,13.884,13,43,30
252,BAR,P002939,P009992,10.951,14,36,22
252,BAR,P002939,P011666,1.867,5,7,2
252,BAR,P002939,P012745,21.884,8,53,45
252,BAR,P002939,P012795,15.167,8,35,27
252,BAR,P002939,P013379,9.017,10,27,17
252,BAR,P003196,P003478,6.299,-5,17,22
252,BAR,P003196,P007464,21.833,10,59,49
252,BAR,P003196,P009992,20.183,4,50,46
252,BAR,P003196,P011666,7.616,2,14,12
252,BAR,P003196,P012745,6.466,3,18,15
252,BAR,P003196,P012795,1.916,-1,3,4
252,BAR,P003196,P013379,17.283,6,44,38
252,BAR,P003478,P006568,13.417,6,30,24
252,BAR,P003478,P007464,6.266,-10,14,24
252,BAR,P003478,P009992,4.133,-6,10,16
252,BAR,P003478,P012745,18.316,4,41,37
252,BAR,P003478,P012795,14.05,6,31,25
252,BAR,P003478,P013379,3.9,-11,6,17
252,BAR,P006568,P007464,0.467,1,3,2
252,BAR,P006568,P009992,1.117,2,5,3
252,BAR,P006568,P011666,1.067,2,4,2
252,BAR,P006568,P012745,14.951,9,37,28
252,BAR,P006568,P012795,13.834,7,32,25
252,BAR,P007464,P009992,20.017,7,53,46
252,BAR,P007464,P011666,7.033,4,14,10
252,BAR,P007464,P012745,6.95,-1,18,19
252,BAR,P007464,P012795,0.05,0,0,0
252,BAR,P007464,P013379,17.9,4,44,40
252,BAR,P009992,P011666,6.866,-1,11,12
252,BAR,P009992,P012745,4.767,3,14,11
252,BAR,P009992,P012795,0.633,-2,0,2
252,BAR,P009992,P013379,16.533,3,41,38
252,BAR,P011666,P012745,1.117,2,4,2
252,BAR,P011666,P012795,1.75,0,4,4
252,BAR,P011666,P013379,7.616,2,14,12
252,BAR,P012745,P012795,15.167,8,35,27
252,BAR,P012745,P013379,1.25,-4,0,4
252,BAR,P012795,P013379,0.633,-2,0,2
252,BER,P006919,P008062,2.867,-7,3,10
252,BER,P006919,P008173,11.234,-5,23,28
252,BER,P006919,P008211,0.983,1,2,1
252,BER,P006919,P008384,0.05,0,0,0
252,BER,P006919,P008780,9.35,3,22,19
252,BER,P006919,P011631,7.317,1,21,20
252,BER,P006919,P011934,6.95,5,20,15
252,BER,P006919,P012721,0.467,-1,2,3
252,BER,P006919,P013386,5.217,-9,5,14
252,BER,P006919,P013774,4.433,-4,2,6
252,BER,P008062,P008173,2.867,-7,3,10
252,BER,P008062,P008211,3.599,0,10,10
252,BER,P008062,P008384,13.267,-4,28,32
252,BER,P008062,P008967,16.866,-4,38,42
252,BER,P008062,P011631,2.7,-4,3,7
252,BER,P008062,P011934,4.083,-1,9,10
252,BER,P008062,P012721,11.516,8,30,22
252,BER,P008062,P013386,14.967,-13,29,42
252,BER,P008062,P013774,6.2,-12,11,23
252,BER,P008173,P008384,3.35,0,7,7
252,BER,P008173,P008780,11.667,2,27,25
252,BER,P008173,P011631,10.367,0,27,27
252,BER,P008173,P011934,9.117,7,25,18
252,BER,P008173,P012721,0.717,0,3,3
252,BER,P008173,P013386,4.234,-10,3,13
252,BER,P008173,P013774,4.583,-7,2,9
252,BER,P008211,P008780,2.866,3,7,4
252,BER,P008211,P008967,4.249,2,12,10
252,BER,P008211,P011934,3.766,5,12,7
252,BER,P008211,P012721,4.449,8,15,7
252,BER,P008211,P013386,2.016,-5,2,7
252,BER,P008211,P013774,3.932,-2,8,10
252,BER,P008384,P008780,6.717,-7,10,17
252,BER,P008384,P008967,16.634,-11,31,42
252,BER,P008384,P011631,6.5,-7,9,16
252,BER,P008384,P011934,7.734,-9,10,19
252,BER,P008384,P012721,9.95,0,21,21
252,BER,P008384,P013386,11.067,0,26,26
252,BER,P008384,P013774,4.667,-6,10,16
252,BER,P008780,P008967,6.384,-6,12,18
252,BER,P008780,P011631,11.067,-2,27,29
252,BER,P008780,P011934,16.734,1,40,39
252,BER,P008780,P012721,5.717,-2,15,17
252,BER,P008780,P013386,2.35,-2,2,4
252,BER,P008780,P013774,8.216,-2,14,16
252,BER,P008967,P011631,3.4,-6,3,9
252,BER,P008967,P011934,10.467,-7,21,28
252,BER,P008967,P012721,15.283,6,39,33
252,BER,P008967,P013386,12.1,-6,26,32
252,BER,P008967,P013774,7.617,-8,18,26
252,BER,P011631,P011934,9.917,1,25,24
252,BER,P011631,P013386,2.667,-5,3,8
252,BER,P011631,P013774,1.133,-2,2,4
252,BER,P011934,P012721,7.6,1,22,21
252,BER,P011934,P013774,6.9,-3,12,15
252,BER,P012721,P013386,8.95,2,20,18
252,BER,P012721,P013774,4.283,2,13,11
252,BER,P013386,P013774,5.7,-12,8,20
253,ASV,P000229,P003526,3.833,-3,8,11
253,ASV,P000229,P004194,3.833,-3,8,11
253,ASV,P000229,P010545,3.833,-3,8,11
253,ASV,P000229,P011225,3.833,-3,8,11
253,ASV,P002100,P003526,10.367,-3,22,25
253,ASV,P002100,P004194,12.383,8,32,24
253,ASV,P002100,P008991,4.967,-9,10,19
253,ASV,P002100,P009818,13.267,1,35,34
253,ASV,P002100,P010316,4.967,-9,10,19
253,ASV,P002100,P010545,12.333,3,29,26
253,ASV,P002100,P011225,16.266,6,41,35
253,ASV,P002100,P013371,7.117,-4,18,22
253,ASV,P002100,P013405,17.933,-5,39,44
253,ASV,P003526,P004194,20.133,3,43,40
253,ASV,P003526,P009818,13.467,-4,27,31
253,ASV,P003526,P010316,7.067,-1,11,12
253,ASV,P003526,P010545,7.733,-14,10,24
253,ASV,P003526,P011225,22.449,-3,45,48
253,ASV,P003526,P013371,0.067,0,0,0
253,ASV,P003526,P013405,11.016,-7,14,21
253,ASV,P004194,P009818,10.367,4,25,21
253,ASV,P004194,P010316,8.5,-3,11,14
253,ASV,P004194,P010545,10.049,0,20,20
253,ASV,P004194,P011225,27.149,3,55,52
253,ASV,P004194,P013405,16.182,0,26,26
253,ASV,P008991,P010316,4.967,-9,10,19
253,ASV,P008991,P013371,4.967,-9,10,19
253,ASV,P008991,P013405,4.967,-9,10,19
253,ASV,P009818,P010316,2.217,0,3,3
253,ASV,P009818,P010545,7.883,-4,17,21
253,ASV,P009818,P011225,14.583,0,34,34
253,ASV,P009818,P013371,2.15,5,8,3
253,ASV,P009818,P013405,9.066,-2,19,21
253,ASV,P010316,P010545,1.433,-2,0,2
253,ASV,P010316,P011225,8.5,-3,11,14
253,ASV,P010316,P013371,4.967,-9,10,19
253,ASV,P010316,P013405,11.25,-12,18,30
253,ASV,P010545,P011225,14.265,-4,29,33
253,ASV,P010545,P013371,2.15,5,8,3
253,ASV,P010545,P013405,12.049,3,27,24
253,ASV,P011225,P013405,18.415,0,33,33
253,ASV,P013371,P013405,7.05,-4,18,22
253,ULK,P002849,P002968,2.617,2,6,4
253,ULK,P002849,P004004,5.866,1,12,11
253,ULK,P002849,P005216,0.783,-3,0,3
253,ULK,P002849,P006961,12.617,7,31,24
253,ULK,P002849,P007182,1.966,-4,2,6
253,ULK,P002849,P008962,5.083,4,12,8
253,ULK,P002849,P009783,3.766,3,10,7
253,ULK,P002849,P009863,15.266,11,40,29
253,ULK,P002849,P011205,15.15,5,36,31
253,ULK,P002849,P013696,8.15,6,23,17
253,ULK,P002968,P004004,7.633,0,18,18
253,ULK,P002968,P005216,6.35,-1,15,16
253,ULK,P002968,P006961,4.034,-1,9,10
253,ULK,P002968,P008962,9.05,-3,21,24
253,ULK,P002968,P009783,6.35,-1,15,16
253,ULK,P002968,P009863,5.317,0,12,12
253,ULK,P002968,P011205,5.317,0,12,12
253,ULK,P004004,P005216,16.983,0,32,32
253,ULK,P004004,P006961,0.667,0,0,0
253,ULK,P004004,P007182,5.966,-2,11,13
253,ULK,P004004,P008962,23.216,8,50,42
253,ULK,P004004,P009783,21.216,4,42,38
253,ULK,P004004,P009863,6.499,3,15,12
253,ULK,P004004,P011205,6.383,-3,11,14
253,ULK,P004004,P013696,6.567,1,9,8
253,ULK,P005216,P007182,5.316,-2,8,10
253,ULK,P005216,P008962,16.2,3,32,29
253,ULK,P005216,P009783,16.983,0,32,32
253,ULK,P005216,P013696,5.317,3,9,6
253,ULK,P006961,P007182,1.183,-1,2,3
253,ULK,P006961,P008962,3.467,0,11,11
253,ULK,P006961,P009863,14.75,7,42,35
253,ULK,P006961,P011205,15.417,7,42,35
253,ULK,P006961,P013696,9.533,9,31,22
253,ULK,P007182,P008962,5.183,1,11,10
253,ULK,P007182,P009783,5.316,-2,8,10
253,ULK,P007182,P009863,1.833,-1,5,6
253,ULK,P007182,P011205,1.833,-1,5,6
253,ULK,P008962,P009783,19.183,9,42,33
253,ULK,P008962,P009863,8.049,5,26,21
253,ULK,P008962,P011205,7.933,-1,22,23
253,ULK,P008962,P013696,6.7,6,17,11
253,ULK,P009783,P009863,3.133,4,7,3
253,ULK,P009783,P011205,2.35,-2,3,5
253,ULK,P009783,P013696,6.567,1,9,8
253,ULK,P009863,P011205,19.366,4,50,46
253,ULK,P009863,P013696,10.783,7,31,24
253,ULK,P011205,P013696,10.783,7,31,24
254,PRS,P005793,P007032,12.533,0,23,23
254,PRS,P005793,P010390,2.133,-10,0,10
254,PRS,P005793,P011949,10.083,4,20,16
254,PRS,P005793,P012608,5.066,-13,5,18
254,PRS,P005793,P012609,0.5,0,0,0
254,PRS,P005793,P012610,4.566,-13,5,18
254,PRS,P005793,P012613,4.05,-2,8,10
254,PRS,P005793,P012640,14.933,-3,28,31
254,PRS,P005793,P013373,11.2,5,23,18
254,PRS,P007032,P010390,3.2,-2,7,9
254,PRS,P007032,P011949,14.216,8,29,21
254,PRS,P007032,P012608,6.616,1,14,13
254,PRS,P007032,P012609,0.5,0,0,0
254,PRS,P007032,P012610,2.233,-6,2,8
254,PRS,P007032,P012613,8.033,10,19,9
254,PRS,P007032,P012640,17.733,12,39,27
254,PRS,P007032,P013373,11.2,5,23,18
254,PRS,P010390,P012608,20.484,-4,41,45
254,PRS,P010390,P012609,13.567,3,30,27
254,PRS,P010390,P012610,18.234,-9,34,43
254,PRS,P010390,P012613,18.234,8,41,33
254,PRS,P010390,P012640,6.084,-2,11,13
254,PRS,P011949,P012608,2.883,3,7,4
254,PRS,P011949,P012610,1.25,1,2,1
254,PRS,P011949,P012613,4.133,4,9,5
254,PRS,P011949,P012640,14.216,8,29,21
254,PRS,P011949,P013373,10.083,4,20,16
254,PRS,P012608,P012609,15.284,-1,33,34
254,PRS,P012608,P012610,21.917,-16,42,58
254,PRS,P012608,P012613,25.3,4,56,52
254,PRS,P012608,P012640,12.65,-6,26,32
254,PRS,P012609,P012610,14.784,-1,33,34
254,PRS,P012609,P012613,15.284,-1,33,34
254,PRS,P012609,P012640,1.217,-4,3,7
254,PRS,P012610,P012613,20.917,-3,44,47
254,PRS,P012610,P012640,8.767,-13,14,27
254,PRS,P012613,P012640,13.6,3,31,28
254,PRS,P012613,P013373,1.117,1,3,2
254,PRS,P012640,P013373,11.2,5,23,18
254,ZAL,P002329,P002676,5.016,-9,6,15
254,ZAL,P002329,P003048,10.916,2,27,25
254,ZAL,P002329,P005504,0.833,2,2,0
254,ZAL,P002329,P007029,5.683,9,17,8
254,ZAL,P002329,P007513,11.133,-7,23,30
254,ZAL,P002329,P007975,10.799,15,28,13
254,ZAL,P002329,P011051,4.333,-1,8,9
254,ZAL,P002329,P011983,8.466,-1,18,19
254,ZAL,P002329,P013775,7.149,2,19,17
254,ZAL,P002676,P003048,9.2,-10,16,26
254,ZAL,P002676,P005504,13.816,10,32,22
254,ZAL,P002676,P007029,3.533,2,10,8
254,ZAL,P002676,P007513,18.249,-2,37,39
254,ZAL,P002676,P007975,16.75,6,36,30
254,ZAL,P002676,P011051,3.817,-2,7,9
254,ZAL,P002676,P011983,12.783,9,30,21
254,ZAL,P002676,P012622,0.283,2,2,0
254,ZAL,P002676,P013775,8.617,-6,16,22
254,ZAL,P003048,P007029,10.533,9,26,17
254,ZAL,P003048,P007513,13.6,-11,26,37
254,ZAL,P003048,P007975,10.65,9,24,15
254,ZAL,P003048,P011983,3.3,-2,8,10
254,ZAL,P003048,P012622,3.133,-2,3,5
254,ZAL,P003048,P013775,13.8,1,30,29
254,ZAL,P005504,P007029,1.467,-4,0,4
254,ZAL,P005504,P007513,9.166,10,23,13
254,ZAL,P005504,P007975,15.75,5,33,28
254,ZAL,P005504,P011051,6.884,-8,10,18
254,ZAL,P005504,P011983,13.666,11,33,22
254,ZAL,P005504,P013775,5.95,-10,7,17
254,ZAL,P007029,P007513,6.833,2,15,13
254,ZAL,P007029,P007975,7.617,5,17,12
254,ZAL,P007029,P011051,1.467,-4,0,4
254,ZAL,P007029,P012622,3.133,-2,3,5
254,ZAL,P007029,P013775,7.734,3,16,13
254,ZAL,P007513,P007975,17.833,9,39,30
254,ZAL,P007513,P011051,4.333,-1,8,9
254,ZAL,P007513,P011983,13.566,7,34,27
254,ZAL,P007513,P012622,2.183,-2,3,5
254,ZAL,P007513,P013775,11.5,-13,20,33
254,ZAL,P007975,P011051,11.217,-9,18,27
254,ZAL,P007975,P011983,18.349,14,42,28
254,ZAL,P007975,P012622,0.95,0,0,0
254,ZAL,P007975,P013775,13.017,-2,23,25
254,ZAL,P011051,P011983,9.75,-5,18,23
254,ZAL,P011051,P013775,3.067,-6,3,9
254,ZAL,P011983,P013775,5.316,-1,13,14
254,ZAL,P012622,P013775,2.85,-4,1,5
255,BAS,P007230,P008072,14.884,-1,31,32
255,BAS,P007230,P011085,15.501,0,37,37
255,BAS,P007230,P011196,13.634,-5,32,37
255,BAS,P007230,P011948,15.534,-14,31,45
255,BAS,P007230,P012080,12.817,6,30,24
255,BAS,P007230,P012201,13.017,-6,26,32
255,BAS,P007230,P012597,9.167,3,26,23
255,BAS,P007230,P013367,19.518,-7,39,46
255,BAS,P008072,P011085,8.967,2,15,13
255,BAS,P008072,P011948,10.083,-11,17,28
255,BAS,P008072,P012080,18.416,7,44,37
255,BAS,P008072,P012201,23.333,-7,47,54
255,BAS,P008072,P012597,7.817,8,21,13
255,BAS,P008072,P013367,17.3,-6,33,39
255,BAS,P011085,P011196,14.801,-5,38,43
255,BAS,P011085,P011948,17.134,-9,39,48
255,BAS,P011085,P012080,6.884,4,14,10
255,BAS,P011085,P012201,8.267,-3,16,19
255,BAS,P011085,P012597,14.067,2,32,30
255,BAS,P011085,P013367,9.451,-3,21,24
255,BAS,P011196,P011948,13.484,-5,35,40
255,BAS,P011196,P012080,1.317,0,3,3
255,BAS,P011196,P012201,1.167,0,6,6
255,BAS,P011196,P012597,9.0,1,24,23
255,BAS,P011196,P013367,5.801,-6,14,20
255,BAS,P011948,P012080,3.466,0,11,11
255,BAS,P011948,P012201,11.25,-11,23,34
255,BAS,P011948,P012597,12.75,3,34,31
255,BAS,P011948,P013367,10.567,-17,18,35
255,BAS,P012080,P012201,16.549,2,39,37
255,BAS,P012080,P012597,6.483,9,20,11
255,BAS,P012080,P013367,13.0,0,27,27
255,BAS,P012201,P012597,7.817,8,21,13
255,BAS,P012201,P013367,16.6,-11,34,45
255,BAS,P012597,P013367,0.167,2,2,0
255,BER,P006251,P006919,0.667,2,2,0
255,BER,P006251,P008062,9.35,8,25,17
255,BER,P006251,P008173,0.483,0,0,0
255,BER,P006251,P008384,9.166,6,23,17
255,BER,P006251,P008780,0.483,0,0,0
255,BER,P006251,P008967,9.35,8,25,17
255,BER,P006251,P011934,6.333,8,18,10
255,BER,P006251,P013386,3.5,0,7,7
255,BER,P006919,P008062,5.4,-3,11,14
255,BER,P006919,P008173,8.433,-1,17,18
255,BER,P006919,P008211,4.85,0,11,11
255,BER,P006919,P008780,11.584,5,25,20
255,BER,P006919,P008967,3.701,3,8,5
255,BER,P006919,P011631,4.934,0,10,10
255,BER,P006919,P011934,9.834,8,26,18
255,BER,P006919,P013386,4.9,-6,8,14
255,BER,P006919,P013774,13.633,0,26,26
255,BER,P008062,P008173,0.767,0,0,0
255,BER,P008062,P008211,5.317,-5,10,15
255,BER,P008062,P008384,15.334,16,44,28
255,BER,P008062,P008967,14.65,18,45,27
255,BER,P008062,P011631,5.05,-3,12,15
255,BER,P008062,P011934,13.367,8,38,30
255,BER,P008062,P013386,6.734,5,17,12
255,BER,P008062,P013774,6.967,8,18,10
255,BER,P008173,P008211,4.483,-10,6,16
255,BER,P008173,P008384,1.783,-3,2,5
255,BER,P008173,P008780,13.932,-14,25,39
255,BER,P008173,P011631,4.483,-10,6,16
255,BER,P008173,P011934,5.999,-8,11,19
255,BER,P008173,P013386,8.7,-6,14,20
255,BER,P008173,P013774,9.733,-4,19,23
255,BER,P008211,P008384,1.384,-1,3,4
255,BER,P008211,P008780,6.783,-7,14,21
255,BER,P008211,P008967,1.383,-1,4,5
255,BER,P008211,P011631,8.583,-11,17,28
255,BER,P008211,P011934,8.434,-12,18,30
255,BER,P008211,P013386,3.033,0,6,6
255,BER,P008211,P013774,4.15,-1,7,8
255,BER,P008384,P008780,1.816,0,7,7
255,BER,P008384,P008967,13.983,20,46,26
255,BER,P008384,P011631,4.067,6,15,9
255,BER,P008384,P011934,10.416,11,34,23
255,BER,P008384,P013386,6.734,5,17,12
255,BER,P008384,P013774,3.917,4,13,9
255,BER,P008780,P008967,4.417,4,13,9
255,BER,P008780,P011631,9.817,-2,23,25
255,BER,P008780,P011934,9.716,0,26,26
255,BER,P008780,P013386,7.933,-6,14,20
255,BER,P008780,P013774,10.583,-4,21,25
255,BER,P008967,P011631,7.667,5,22,17
255,BER,P008967,P011934,11.483,17,39,22
255,BER,P008967,P013386,5.967,5,17,12
255,BER,P008967,P013774,3.667,9,13,4
255,BER,P011631,P011934,8.034,-7,20,27
255,BER,P011631,P013386,4.583,2,13,11
255,BER,P011631,P013774,2.25,0,2,2
255,BER,P011934,P013774,8.716,7,26,19
255,BER,P013386,P013774,6.584,-3,11,14
256,MAD,P003108,P003583,7.034,2,16,14
256,MAD,P003108,P003733,14.95,2,25,23
256,MAD,P003108,P005791,3.016,3,5,2
256,MAD,P003108,P005928,7.967,0,21,21
256,MAD,P003108,P006540,8.217,4,25,21
256,MAD,P003108,P007630,3.767,1,7,6
256,MAD,P003108,P011247,16.633,4,27,23
256,MAD,P003108,P011649,4.467,8,15,7
256,MAD,P003108,P013667,14.55,-1,27,28
256,MAD,P003108,PTGB,17.799,-7,24,31
256,MAD,P003583,P003733,5.317,3,11,8
256,MAD,P003583,P005928,4.05,1,9,8
256,MAD,P003583,P006540,3.55,1,9,8
256,MAD,P003583,P007630,2.25,1,5,4
256,MAD,P003583,P011247,3.317,1,7,6
256,MAD,P003583,P011649,0.333,0,0,0
256,MAD,P003583,PTGB,3.617,-1,7,8
256,MAD,P003733,P005791,17.449,10,33,23
256,MAD,P003733,P005928,19.85,13,43,30
256,MAD,P003733,P006540,19.35,13,43,30
256,MAD,P003733,P007630,14.816,9,30,21
256,MAD,P003733,P011247,9.916,-2,12,14
256,MAD,P003733,P011649,0.333,0,0,0
256,MAD,P003733,P013667,7.0,-2,11,13
256,MAD,P003733,PTGB,10.083,-2,12,14
256,MAD,P005791,P005928,15.849,13,36,23
256,MAD,P005791,P006540,15.849,13,36,23
256,MAD,P005791,P007630,15.066,9,32,23
256,MAD,P005791,P011247,2.233,-1,1,2
256,MAD,P005791,P011649,0.633,2,4,2
256,MAD,P005791,PTGB,2.233,-1,1,2
256,MAD,P005928,P006540,22.866,9,53,44
256,MAD,P005928,P007630,15.399,9,32,23
256,MAD,P005928,P011649,2.433,3,9,6
256,MAD,P005928,P013667,3.467,-5,8,13
256,MAD,P005928,PTGB,1.583,-7,1,8
256,MAD,P006540,P007630,15.066,9,32,23
256,MAD,P006540,P011247,0.417,4,4,0
256,MAD,P006540,P011649,2.517,7,13,6
256,MAD,P006540,P013667,3.884,-1,12,13
256,MAD,P006540,PTGB,1.416,-7,1,8
256,MAD,P007630,P011247,3.767,1,7,6
256,MAD,P007630,P011649,0.916,0,2,2
256,MAD,P007630,P013667,1.85,0,2,2
256,MAD,P007630,PTGB,3.767,1,7,6
256,MAD,P011247,P011649,2.95,5,8,3
256,MAD,P011247,P013667,11.083,4,19,15
256,MAD,P011247,PTGB,16.216,0,23,23
256,MAD,P011649,P013667,4.417,6,13,7
256,MAD,P011649,PTGB,2.533,1,4,3
256,MAD,P013667,PTGB,11.949,-5,16,21
256,VIR,P001133,P001844,8.85,-7,14,21
256,VIR,P001133,P002084,3.767,-1,6,7
256,VIR,P001133,P004554,3.833,-9,2,11
256,VIR,P001133,P005738,4.5,2,7,5
256,VIR,P001133,P009549,21.267,-9,31,40
256,VIR,P001133,P011816,0.683,0,0,0
256,VIR,P001133,P012585,11.35,-9,11,20
256,VIR,P001133,P012591,11.984,-9,18,27
256,VIR,P001133,P013374,10.217,-3,16,19
256,VIR,P001133,P013695,12.817,1,19,18
256,VIR,P001844,P002084,2.733,2,5,3
256,VIR,P001844,P004554,0.917,-2,2,4
256,VIR,P001844,P005738,2.433,0,3,3
256,VIR,P001844,P009549,11.767,-8,20,28
256,VIR,P001844,P011816,2.617,-3,4,7
256,VIR,P001844,P012585,5.816,-7,7,14
256,VIR,P001844,P012591,5.534,-3,10,13
256,VIR,P001844,P013374,10.867,-6,18,24
256,VIR,P001844,P013695,5.266,2,9,7
256,VIR,P002084,P004554,3.984,-4,9,13
256,VIR,P002084,P005738,8.583,5,19,14
256,VIR,P002084,P009549,5.434,0,14,14
256,VIR,P002084,P011816,3.633,-5,3,8
256,VIR,P002084,P012585,14.4,-3,28,31
256,VIR,P002084,P012591,8.334,4,20,16
256,VIR,P002084,P013374,0.783,-2,0,2
256,VIR,P002084,P013695,16.817,-4,32,36
256,VIR,P004554,P009549,5.667,-10,8,18
256,VIR,P004554,P011816,2.184,-3,3,6
256,VIR,P004554,P012585,7.817,-13,11,24
256,VIR,P004554,P012591,3.233,-5,2,7
256,VIR,P004554,P013374,0.017,0,0,0
256,VIR,P004554,P013695,3.684,-6,7,13
256,VIR,P005738,P009549,5.4,2,9,7
256,VIR,P005738,P012585,13.083,7,26,19
256,VIR,P005738,P012591,5.5,7,16,9
256,VIR,P005738,P013695,12.833,5,24,19
256,VIR,P009549,P011816,4.334,-1,8,9
256,VIR,P009549,P012585,17.217,-11,25,36
256,VIR,P009549,P012591,11.734,-5,20,25
256,VIR,P009549,P013374,14.551,-4,24,28
256,VIR,P009549,P013695,15.901,2,29,27
256,VIR,P011816,P012585,7.833,-8,9,17
256,VIR,P011816,P012591,0.117,2,2,0
256,VIR,P011816,P013374,5.117,-3,8,11
256,VIR,P011816,P013695,5.35,-3,7,10
256,VIR,P012585,P012591,9.1,0,18,18
256,VIR,P012585,P013374,6.95,-5,8,13
256,VIR,P012585,P013695,22.034,-3,37,40
256,VIR,P012591,P013374,5.534,-3,10,13
256,VIR,P012591,P013695,8.334,4,20,16
256,VIR,P013374,P013695,7.3,2,12,10
257,MCO,P002581,P004790,5.65,5,13,8
257,MCO,P002581,P005985,7.766,-1,16,17
257,MCO,P002581,P008099,9.416,4,19,15
257,MCO,P002581,P009754,11.067,1,25,24
257,MCO,P002581,P011212,11.233,-2,21,23
257,MCO,P002581,P011226,11.949,-2,24,26
257,MCO,P002581,P011231,8.216,-1,14,15
257,MCO,P002581,P012515,0.167,0,0,0
257,MCO,P004132,P004790,9.367,3,24,21
257,MCO,P004132,P005985,18.766,0,42,42
257,MCO,P004132,P008099,7.783,-2,14,16
257,MCO,P004132,P009754,5.0,1,11,10
257,MCO,P004132,P011212,11.783,3,30,27
257,MCO,P004132,P011226,14.566,0,33,33
257,MCO,P004132,P011231,10.199,-2,20,22
257,MCO,P004132,P012515,0.8,1,2,1
257,MCO,P004790,P005985,14.15,3,32,29
257,MCO,P004790,P008099,4.034,5,11,6
257,MCO,P004790,P009754,3.134,7,9,2
257,MCO,P004790,P011212,11.85,8,31,23
257,MCO,P004790,P011226,11.883,1,28,27
257,MCO,P005844,P005985,3.883,-3,11,14
257,MCO,P005844,P008099,1.733,-6,3,9
257,MCO,P005844,P009754,2.15,3,8,5
257,MCO,P005844,P011212,3.883,-3,11,14
257,MCO,P005844,P011226,3.883,-3,11,14
257,MCO,P005985,P008099,9.715,-9,17,26
257,MCO,P005985,P009754,8.817,2,25,23
257,MCO,P005985,P011212,23.132,-5,55,60
257,MCO,P005985,P011226,26.098,-8,58,66
257,MCO,P005985,P011231,10.065,-3,20,23
257,MCO,P008099,P009754,13.9,5,30,25
257,MCO,P008099,P011212,6.199,-7,10,17
257,MCO,P008099,P011226,9.698,-10,16,26
257,MCO,P008099,P011231,13.015,-5,22,27
257,MCO,P008099,P012515,0.967,1,2,1
257,MCO,P009754,P011212,8.267,1,21,20
257,MCO,P009754,P011226,8.8,1,24,23
257,MCO,P009754,P011231,10.766,-2,21,23
257,MCO,P009754,P012515,0.967,1,2,1
257,MCO,P011212,P011226,23.132,-5,55,60
257,MCO,P011212,P011231,8.849,-6,14,20
257,MCO,P011226,P011231,12.315,-2,23,25
257,MCO,P011231,P012515,0.967,1,2,1
257,TEL,P005145,P007519,10.567,-4,21,25
257,TEL,P005145,P007990,4.767,-3,7,10
257,TEL,P005145,P011193,4.3,-3,8,11
257,TEL,P005145,P011202,6.184,-5,9,14
257,TEL,P005145,P011219,5.0,-4,15,19
257,TEL,P005145,P012604,5.384,0,6,6
257,TEL,P005145,P013382,4.566,1,12,11
257,TEL,P005145,P013699,1.5,2,6,4
257,TEL,P007519,P007990,7.251,-2,15,17
257,TEL,P007519,P011193,14.183,-2,28,30
257,TEL,P007519,P011202,11.034,1,27,26
257,TEL,P007519,P011219,19.783,1,51,50
257,TEL,P007519,P012604,20.25,11,48,37
257,TEL,P007519,P013381,3.683,-2,6,8
257,TEL,P007519,P013382,19.698,9,50,41
257,TEL,P007519,P013699,2.483,0,6,6
257,TEL,P007990,P011202,13.651,-5,26,31
257,TEL,P007990,P011219,10.151,-2,22,24
257,TEL,P007990,P012604,7.101,0,16,16
257,TEL,P007990,P013381,7.017,-1,15,16
257,TEL,P007990,P013382,1.133,2,4,2
257,TEL,P007990,P013699,7.333,-1,15,16
257,TEL,P011193,P011202,1.417,-2,2,4
257,TEL,P011193,P011219,10.033,-5,20,25
257,TEL,P011193,P012604,15.217,3,28,25
257,TEL,P011193,P013381,3.15,1,4,3
257,TEL,P011193,P013382,14.933,0,28,28
257,TEL,P011193,P013699,2.167,0,2,2
257,TEL,P011202,P011219,15.584,4,43,39
257,TEL,P011202,P012604,14.134,4,39,35
257,TEL,P011202,P013381,7.2,-1,15,16
257,TEL,P011202,P013382,6.749,8,25,17
257,TEL,P011202,P013699,10.583,0,26,26
257,TEL,P011219,P012604,18.117,9,51,42
257,TEL,P011219,P013381,5.95,-4,7,11
257,TEL,P011219,P013382,19.849,5,55,50
257,TEL,P011219,P013699,11.733,0,28,28
257,TEL,P012604,P013381,5.4,2,12,10
257,TEL,P012604,P013382,21.316,15,55,40
257,TEL,P012604,P013699,8.617,0,21,21
257,TEL,P013381,P013382,4.316,-1,4,5
257,TEL,P013381,P013699,8.616,-2,13,15
257,TEL,P013382,P013699,7.9,1,19,18
258,MIL,P000796,P001392,16.083,6,34,28
258,MIL,P000796,P001518,5.65,-3,11,14
258,MIL,P000796,P006721,5.416,2,19,17
258,MIL,P000796,P007831,19.199,6,36,30
258,MIL,P000796,P008985,16.482,10,40,30
258,MIL,P000796,P008987,20.582,-1,33,34
258,MIL,P000796,P011064,17.516,-4,32,36
258,MIL,P000796,P013384,13.732,0,31,31
258,MIL,P001392,P001518,1.75,1,3,2
258,MIL,P001392,P006721,6.916,9,24,15
258,MIL,P001392,P007831,14.2,8,28,20
258,MIL,P001392,P008985,12.349,9,31,22
258,MIL,P001392,P008987,15.733,3,27,24
258,MIL,P001392,P011064,8.467,-1,13,14
258,MIL,P001392,P013384,6.616,0,16,16
258,MIL,P001392,P013385,1.15,-3,0,3
258,MIL,P001518,P006509,1.033,-2,2,4
258,MIL,P001518,P007831,5.583,-3,13,16
258,MIL,P001518,P008985,4.484,2,10,8
258,MIL,P001518,P008987,6.083,-9,9,18
258,MIL,P001518,P011064,6.2,-9,9,18
258,MIL,P001518,P013384,4.217,-1,7,8
258,MIL,P006509,P006721,2.217,-1,4,5
258,MIL,P006509,P007831,1.033,-2,2,4
258,MIL,P006509,P008987,3.25,-3,6,9
258,MIL,P006509,P011064,3.25,-3,6,9
258,MIL,P006509,P013384,2.217,-1,4,5
258,MIL,P006721,P007831,4.55,4,12,8
258,MIL,P006721,P008985,10.283,7,33,26
258,MIL,P006721,P008987,7.084,4,18,14
258,MIL,P006721,P011064,4.617,-2,11,13
258,MIL,P006721,P013384,8.917,1,27,26
258,MIL,P007831,P008985,15.916,11,33,22
258,MIL,P007831,P008987,26.165,0,47,47
258,MIL,P007831,P011064,13.399,-2,25,27
258,MIL,P007831,P013384,6.133,1,12,11
258,MIL,P007831,P013385,1.15,-3,0,3
258,MIL,P008985,P008987,16.733,6,31,25
258,MIL,P008985,P011064,6.817,2,16,14
258,MIL,P008985,P013384,14.05,0,34,34
258,MIL,P008985,P013385,1.15,-3,0,3
258,MIL,P008987,P011064,19.15,-5,34,39
258,MIL,P008987,P013384,11.734,-4,19,23
258,MIL,P008987,P013385,1.15,-3,0,3
258,MIL,P011064,P013384,9.584,-4,18,22
258,RED,P000848,P004866,15.433,5,32,27
258,RED,P000848,P006436,3.35,3,6,3
258,RED,P000848,P007960,5.984,3,17,14
258,RED,P000848,P009035,12.483,9,26,17
258,RED,P000848,P009048,11.667,-3,24,27
258,RED,P000848,P010588,15.366,8,34,26
258,RED,P000848,P010612,5.517,5,17,12
258,RED,P000848,P011194,7.2,-2,15,17
258,RED,P000848,P012044,5.166,6,8,2
258,RED,P000848,PJDR,5.434,6,17,11
258,RED,P004007,P007960,1.1,-2,0,2
258,RED,P004007,P009035,0.917,-2,3,5
258,RED,P004007,P009048,2.117,-4,5,9
258,RED,P004007,P010588,1.733,-9,2,11
258,RED,P004007,P010612,3.6,-11,5,16
258,RED,P004007,P011194,3.45,-9,5,14
258,RED,P004007,PJDR,1.483,-7,0,7
258,RED,P004866,P006436,3.767,-1,4,5
258,RED,P004866,P007960,1.933,2,6,4
258,RED,P004866,P009035,16.617,9,32,23
258,RED,P004866,P009048,18.967,1,35,34
258,RED,P004866,P010588,15.966,-2,27,29
258,RED,P004866,P010612,4.45,3,11,8
258,RED,P004866,P011194,13.383,-3,23,26
258,RED,P004866,P012044,6.266,2,10,8
258,RED,P004866,PJDR,4.55,0,8,8
258,RED,P006436,P009035,3.517,2,6,4
258,RED,P006436,P009048,1.4,-2,0,2
258,RED,P006436,P010588,5.766,0,11,11
258,RED,P006436,P010612,4.6,0,11,11
258,RED,P006436,P011194,7.05,-1,13,14
258,RED,P006436,P012044,7.883,4,17,13
258,RED,P006436,PJDR,0.067,-1,0,1
258,RED,P007960,P009048,3.55,-3,6,9
258,RED,P007960,P010588,2.367,1,8,7
258,RED,P007960,P010612,6.951,-1,15,16
258,RED,P007960,P011194,5.617,0,11,11
258,RED,P007960,PJDR,4.434,4,13,9
258,RED,P009035,P009048,11.268,5,25,20
258,RED,P009035,P010588,10.183,7,22,15
258,RED,P009035,P010612,2.417,2,9,7
258,RED,P009035,P011194,6.384,0,13,13
258,RED,P009035,P012044,7.066,2,12,10
258,RED,P009035,PJDR,4.616,2,8,6
258,RED,P009048,P010588,14.333,-6,27,33
258,RED,P009048,P010612,7.051,-6,14,20
258,RED,P009048,P011194,13.684,-7,22,29
258,RED,P009048,PJDR,2.367,1,2,1
258,RED,P010588,P010612,11.633,-5,26,31
258,RED,P010588,P011194,12.682,-12,20,32
258,RED,P010588,P012044,6.666,4,13,9
258,RED,P010588,PJDR,4.233,-2,10,12
258,RED,P010612,P011194,15.234,-8,32,40
258,RED,P010612,P012044,4.6,0,11,11
258,RED,P010612,PJDR,6.483,1,17,16
258,RED,P011194,P012044,7.666,0,17,17
258,RED,P011194,PJDR,8.25,-6,13,19
258,RED,P012044,PJDR,2.083,-2,4,6
259,OLY,P001255,P003469,14.484,15,36,21
259,OLY,P001255,P003941,3.05,2,5,3
259,OLY,P001255,P007853,2.7,3,5,2
259,OLY,P001255,P007947,6.784,8,14,6
259,OLY,P001255,P007982,13.5,13,33,20
259,OLY,P001255,P008811,16.934,17,40,23
259,OLY,P001255,P008829,5.5,4,9,5
259,OLY,P001255,P013380,14.517,12,33,21
259,OLY,P001255,P013389,2.467,2,5,3
259,OLY,P003469,P003941,9.7,-1,20,21
259,OLY,P003469,P007853,16.733,-10,29,39
259,OLY,P003469,P007947,12.15,-3,21,24
259,OLY,P003469,P007982,17.967,12,44,32
259,OLY,P003469,P008811,23.083,1,47,46
259,OLY,P003469,P008829,2.917,4,8,4
259,OLY,P003469,P013380,20.383,-6,40,46
259,OLY,P003469,P013389,15.183,-12,23,35
259,OLY,P003941,P007853,13.267,0,25,25
259,OLY,P003941,P007947,9.933,0,17,17
259,OLY,P003941,P007982,4.167,-1,8,9
259,OLY,P003941,P008829,6.95,4,13,9
259,OLY,P003941,P009849,1.35,-2,0,2
259,OLY,P003941,P013380,1.383,-4,0,4
259,OLY,P003941,P013389,6.6,-2,12,14
259,OLY,P007853,P007947,10.433,1,17,16
259,OLY,P007853,P007982,6.65,-3,13,16
259,OLY,P007853,P008811,7.516,-9,9,18
259,OLY,P007853,P008829,6.6,5,13,8
259,OLY,P007853,P009849,1.35,-2,0,2
259,OLY,P007853,P013380,6.733,-12,9,21
259,OLY,P007853,P013389,11.15,-9,16,25
259,OLY,P007947,P007982,0.667,2,2,0
259,OLY,P007947,P008811,6.15,1,11,10
259,OLY,P007947,P008829,4.667,4,7,3
259,OLY,P007947,P009849,0.283,0,0,0
259,OLY,P007947,P013380,3.25,-4,4,8
259,OLY,P007947,P013389,11.483,-5,19,24
259,OLY,P007982,P008811,15.983,11,38,27
259,OLY,P007982,P008829,5.467,2,10,8
259,OLY,P007982,P009849,1.067,-2,0,2
259,OLY,P007982,P013380,16.6,6,36,30
259,OLY,P008811,P008829,2.45,2,4,2
259,OLY,P008811,P013380,21.433,-1,44,45
259,OLY,P008811,P013389,8.583,-10,11,21
259,OLY,P008829,P009849,1.35,-2,0,2
259,OLY,P008829,P013380,3.167,1,4,3
259,OLY,P013380,P013389,5.266,-12,6,18
259,PAN,P001926,P004088,16.017,-12,24,36
259,PAN,P001926,P005161,3.967,2,10,8
259,PAN,P001926,P007866,18.516,6,43,37
259,PAN,P001926,P009622,18.966,8,40,32
259,PAN,P001926,P011204,5.767,-2,12,14
259,PAN,P001926,P012712,22.316,-2,42,44
259,PAN,P001926,P012774,12.766,8,30,22
259,PAN,P001926,P013383,7.484,-6,12,18
259,PAN,P001926,PLHK,3.333,-2,3,5
259,PAN,P004088,P005161,2.583,1,5,4
259,PAN,P004088,P007866,12.983,-4,25,29
259,PAN,P004088,P009622,10.283,-3,15,18
259,PAN,P004088,P011204,10.817,1,23,22
259,PAN,P004088,P012712,22.083,-2,40,42
259,PAN,P004088,P012774,7.6,-3,13,16
259,PAN,P004088,P013383,9.184,-8,12,20
259,PAN,P004088,PLHK,3.05,-2,3,5
259,PAN,P005161,P007866,6.567,2,14,12
259,PAN,P005161,P009622,11.633,-3,19,22
259,PAN,P005161,P011204,2.7,-8,0,8
259,PAN,P005161,P012712,6.016,1,11,10
259,PAN,P005161,P012774,8.0,-2,12,14
259,PAN,P005161,P013383,5.066,-5,5,10
259,PAN,P007866,P009622,13.166,14,33,19
259,PAN,P007866,P011204,5.95,3,17,14
259,PAN,P007866,P012712,16.699,9,40,31
259,PAN,P007866,P012774,10.733,16,32,16
259,PAN,P007866,P013383,2.05,-2,4,6
259,PAN,P009622,P011204,2.7,-8,0,8
259,PAN,P009622,P012712,20.532,3,37,34
259,PAN,P009622,P012774,15.299,8,32,24
259,PAN,P009622,P013383,10.616,-5,17,22
259,PAN,P009622,PLHK,3.333,-2,3,5
259,PAN,P011204,P012712,10.817,1,23,22
259,PAN,P011204,P012774,7.75,-5,11,16
259,PAN,P011204,P013383,7.567,-10,6,16
259,PAN,P012712,P012774,15.232,11,33,22
259,PAN,P012712,P013383,12.3,-3,19,22
259,PAN,P012712,PLHK,3.333,-2,3,5
259,PAN,P012774,P013383,13.933,-13,17,30
259,PAN,P012774,PLHK,0.283,0,0,0
260,IST,P004887,P006590,20.318,16,51,35
260,IST,P004887,P007109,15.317,25,44,19
260,IST,P004887,P007200,9.401,10,26,16
260,IST,P004887,P009664,3.567,-7,6,13
260,IST,P004887,P009846,18.484,-2,35,37
260,IST,P004887,P011078,18.418,7,41,34
260,IST,P004887,P012710,4.517,-6,6,12
260,IST,P004887,P012742,5.45,5,15,10
260,IST,P006590,P007109,16.584,22,51,29
260,IST,P006590,P007200,11.502,5,33,28
260,IST,P006590,P009664,4.384,-9,6,15
260,IST,P006590,P009846,14.951,2,30,28
260,IST,P006590,P011078,18.385,9,41,32
260,IST,P006590,P012710,5.334,-8,6,14
260,IST,P006590,P012742,7.584,-2,22,24
260,IST,P006590,P012788,4.834,-7,12,19
260,IST,P007109,P007200,22.734,-1,57,58
260,IST,P007109,P009846,21.167,13,54,41
260,IST,P007109,P011078,11.584,22,35,13
260,IST,P007109,P012742,19.134,-8,46,54
260,IST,P007109,P012788,15.084,-9,37,46
260,IST,P007200,P009664,1.784,2,6,4
260,IST,P007200,P009846,14.201,0,34,34
260,IST,P007200,P011078,7.652,14,26,12
260,IST,P007200,P012710,0.817,-2,0,2
260,IST,P007200,P012742,17.784,-5,45,50
260,IST,P007200,P012788,15.001,-3,41,44
260,IST,P009664,P009846,2.6,-11,0,11
260,IST,P009664,P011078,4.384,-9,6,15
260,IST,P009664,P012710,0.817,-2,0,2
260,IST,P009846,P011078,16.502,1,35,34
260,IST,P009846,P012710,4.517,-6,6,12
260,IST,P009846,P012742,13.017,1,33,32
260,IST,P009846,P012788,10.501,2,29,27
260,IST,P011078,P012710,5.334,-8,6,14
260,IST,P011078,P012742,0.534,2,4,2
260,IST,P011078,P012788,1.951,6,10,4
260,IST,P012742,P012788,13.901,-9,35,44
260,MUN,P001288,P001557,6.8,-1,14,15
260,MUN,P001288,P004508,2.301,-6,0,6
260,MUN,P001288,P005460,10.517,9,26,17
260,MUN,P001288,P007201,16.833,10,40,30
260,MUN,P001288,P007639,1.817,-4,0,4
260,MUN,P001288,P010391,16.3,9,38,29
260,MUN,P001288,P011224,2.834,-5,2,7
260,MUN,P001288,P011987,19.134,4,40,36
260,MUN,P001557,P004508,13.534,-16,30,46
260,MUN,P001557,P007201,13.0,-20,25,45
260,MUN,P001557,P007639,6.4,3,19,16
260,MUN,P001557,P010391,8.667,-11,14,25
260,MUN,P001557,P011224,12.967,-13,30,43
260,MUN,P001557,P011987,18.1,-10,44,54
260,MUN,P004508,P005460,7.601,7,22,15
260,MUN,P004508,P007201,14.468,-12,33,45
260,MUN,P004508,P007639,8.217,-1,19,20
260,MUN,P004508,P010391,9.585,-10,20,30
260,MUN,P004508,P011224,16.435,-10,36,46
260,MUN,P004508,P011987,20.535,-12,48,60
260,MUN,P005460,P007201,18.084,20,48,28
260,MUN,P005460,P010391,16.984,14,44,30
260,MUN,P005460,P011224,1.984,8,8,0
260,MUN,P005460,P011987,17.234,14,44,30
260,MUN,P007201,P010391,25.851,3,58,55
260,MUN,P007201,P011224,8.301,-10,19,29
260,MUN,P007201,P011987,28.667,1,69,68
260,MUN,P007639,P011224,8.217,-1,19,20
260,MUN,P007639,P011987,8.217,-1,19,20
260,MUN,P010391,P011224,2.851,-5,4,9
260,MUN,P010391,P011987,23.234,4,54,50
260,MUN,P011224,P011987,14.351,-8,34,42
261,BAR,P002939,P003196,8.266,3,9,6
261,BAR,P002939,P003478,17.617,-2,39,41
261,BAR,P002939,P007464,8.734,-10,15,25
261,BAR,P002939,P009862,11.633,3,27,24
261,BAR,P002939,P009992,10.416,7,16,9
261,BAR,P002939,P011666,3.499,3,6,3
261,BAR,P002939,P012745,20.616,2,45,43
261,BAR,P002939,P012795,7.983,2,9,7
261,BAR,P002939,P013379,27.632,4,50,46
261,BAR,P003196,P003478,1.133,-5,0,5
261,BAR,P003196,P009862,8.216,7,21,14
261,BAR,P003196,P009992,14.616,8,26,18
261,BAR,P003196,P011666,1.633,2,3,1
261,BAR,P003196,P012745,2.216,-6,3,9
261,BAR,P003196,P012795,12.783,12,25,13
261,BAR,P003196,P013379,13.333,15,25,10
261,BAR,P003478,P006568,0.367,-2,0,2
261,BAR,P003478,P007464,8.734,-10,15,25
261,BAR,P003478,P009862,11.084,-7,21,28
261,BAR,P003478,P009992,3.817,-6,7,13
261,BAR,P003478,P012745,19.567,-9,39,48
261,BAR,P003478,P013379,16.817,-3,35,38
261,BAR,P006568,P009862,2.95,0,14,14
261,BAR,P006568,P009992,2.95,0,14,14
261,BAR,P006568,P012745,2.95,0,14,14
261,BAR,P006568,P012795,2.583,2,14,12
261,BAR,P007464,P009862,1.467,-1,4,5
261,BAR,P007464,P009992,0.217,-2,0,2
261,BAR,P007464,P012745,8.517,-8,15,23
261,BAR,P007464,P013379,7.267,-9,11,20
261,BAR,P009862,P009992,10.9,4,33,29
261,BAR,P009862,P011666,2.766,2,5,3
261,BAR,P009862,P012745,16.533,-6,42,48
261,BAR,P009862,P012795,8.683,12,34,22
261,BAR,P009862,P013379,15.9,14,39,25
261,BAR,P009992,P011666,2.133,3,3,0
261,BAR,P009992,P012745,8.699,-1,26,27
261,BAR,P009992,P012795,15.366,14,39,25
261,BAR,P009992,P013379,16.15,17,32,15
261,BAR,P011666,P012745,2.566,2,4,2
261,BAR,P011666,P013379,4.199,4,7,3
261,BAR,P012745,P012795,4.316,1,19,18
261,BAR,P012745,P013379,19.816,1,41,40
261,BAR,P012795,P013379,12.35,13,24,11
261,PAR,P004761,P006591,12.85,-4,25,29
261,PAR,P004761,P007736,1.617,-7,0,7
261,PAR,P004761,P007870,23.834,7,48,41
261,PAR,P004761,P008232,2.117,1,5,4
261,PAR,P004761,P011836,22.951,2,52,50
261,PAR,P004761,P011981,13.034,-11,15,26
261,PAR,P004761,P012720,16.601,3,33,30
261,PAR,P004761,P013369,26.385,7,54,47
261,PAR,P004761,P013370,0.683,-2,0,2
261,PAR,P006591,P007736,1.617,-7,0,7
261,PAR,P006591,P007870,15.484,5,31,26
261,PAR,P006591,P011836,18.634,-6,44,50
261,PAR,P006591,P011981,16.75,-19,27,46
261,PAR,P006591,P012720,4.217,-4,14,18
261,PAR,P006591,P013369,19.201,-2,43,45
261,PAR,P006591,P013370,2.583,-3,4,7
261,PAR,P007736,P007870,0.7,-1,0,1
261,PAR,P007736,P011836,0.917,-6,0,6
261,PAR,P007736,P011981,1.617,-7,0,7
261,PAR,P007870,P011836,21.001,11,48,37
261,PAR,P007870,P011981,12.834,-3,14,17
261,PAR,P007870,P012720,12.384,5,25,20
261,PAR,P007870,P013369,26.035,8,50,42
261,PAR,P008232,P011836,2.117,1,5,4
261,PAR,P008232,P012720,2.117,1,5,4
261,PAR,P008232,P013369,2.117,1,5,4
261,PAR,P011836,P011981,15.584,-16,29,45
261,PAR,P011836,P012720,17.951,-2,44,46
261,PAR,P011836,P013369,30.002,3,70,67
261,PAR,P011836,P013370,2.583,-3,4,7
261,PAR,P011981,P012720,9.184,-6,20,26
261,PAR,P011981,P013369,19.018,-11,31,42
261,PAR,P011981,P013370,2.583,-3,4,7
261,PAR,P012720,P013369,20.818,-1,47,48
261,PAR,P013369,P013370,1.9,-1,4,5
262,MIL,P000796,P001392,7.8,3,23,20
262,MIL,P000796,P001518,4.95,0,11,11
262,MIL,P000796,P006509,4.117,-2,6,8
262,MIL,P000796,P006721,2.65,-6,2,8
262,MIL,P000796,P007831,22.484,-13,43,56
262,MIL,P000796,P008985,5.45,-8,6,14
262,MIL,P000796,P008987,13.834,-6,28,34
262,MIL,P000796,P011064,22.484,-13,43,56
262,MIL,P000796,P013384,5.117,-6,8,14
262,MIL,P000796,P013385,1.05,-1,2,3
262,MIL,P001392,P001518,11.984,6,29,23
262,MIL,P001392,P006509,7.267,-3,11,14
262,MIL,P001392,P006721,1.6,0,4,4
262,MIL,P001392,P007831,11.217,2,32,30
262,MIL,P001392,P008985,8.017,-1,19,20
262,MIL,P001392,P008987,17.251,-2,39,41
262,MIL,P001392,P011064,12.867,0,31,31
262,MIL,P001392,P013384,4.383,-3,11,14
262,MIL,P001392,P013385,2.55,-2,5,7
262,MIL,P001518,P006509,6.617,1,11,10
262,MIL,P001518,P006721,1.417,2,4,2
262,MIL,P001518,P007831,8.401,6,20,14
262,MIL,P001518,P008985,5.767,3,17,14
262,MIL,P001518,P008987,8.301,4,17,13
262,MIL,P001518,P011064,10.051,4,19,15
262,MIL,P001518,P013384,5.684,4,15,11
262,MIL,P001518,P013385,1.5,2,5,3
262,MIL,P006509,P007831,6.267,0,11,11
262,MIL,P006509,P008985,4.45,-5,7,12
262,MIL,P006509,P008987,11.734,-3,19,22
262,MIL,P006509,P011064,8.384,0,13,13
262,MIL,P006509,P013385,3.9,-4,6,10
262,MIL,P006721,P007831,4.383,-6,4,10
262,MIL,P006721,P008985,1.633,0,4,4
262,MIL,P006721,P008987,1.916,-2,2,4
262,MIL,P006721,P011064,4.35,-6,4,10
262,MIL,P006721,P013384,5.983,-6,8,14
262,MIL,P007831,P008985,6.9,-8,11,19
262,MIL,P007831,P008987,20.317,-6,43,49
262,MIL,P007831,P011064,28.434,-10,56,66
262,MIL,P007831,P013384,8.683,-9,14,23
262,MIL,P007831,P013385,2.85,0,6,6
262,MIL,P008985,P008987,12.55,-13,20,33
262,MIL,P008985,P011064,5.7,-6,8,14
262,MIL,P008985,P013384,3.383,4,11,7
262,MIL,P008985,P013385,2.55,-2,5,7
262,MIL,P008987,P011064,21.234,-4,42,46
262,MIL,P008987,P013384,3.749,-5,6,11
262,MIL,P008987,P013385,2.85,-3,4,7
262,MIL,P011064,P013384,8.65,-9,14,23
262,MIL,P011064,P013385,2.85,0,6,6
262,MIL,P013384,P013385,1.5,2,5,3
262,PRS,P004197,P005793,1.45,-4,0,4
262,PRS,P004197,P007032,5.083,-8,8,16
262,PRS,P004197,P007483,10.433,-1,24,25
262,PRS,P004197,P010390,0.65,-2,0,2
262,PRS,P004197,P011949,6.766,0,16,16
262,PRS,P004197,P012608,6.0,5,16,11
262,PRS,P004197,P012610,6.0,5,16,11
262,PRS,P004197,P012613,2.867,1,8,7
262,PRS,P004197,P012640,5.083,-8,8,16
262,PRS,P005793,P007032,8.7,-8,15,23
262,PRS,P005793,P007483,0.8,-2,0,2
262,PRS,P005793,P010390,3.633,1,5,4
262,PRS,P005793,P011949,5.717,-7,10,17
262,PRS,P005793,P012608,3.333,2,5,3
262,PRS,P005793,P012610,3.333,2,5,3
262,PRS,P005793,P012611,1.8,-1,0,1
262,PRS,P005793,P012613,0.35,-1,0,1
262,PRS,P005793,P012640,7.167,-11,10,21
262,PRS,P005793,P013373,5.717,-7,10,17
262,PRS,P007032,P007483,4.433,-6,8,14
262,PRS,P007032,P010390,2.183,1,5,4
262,PRS,P007032,P011949,9.35,-11,18,29
262,PRS,P007032,P012608,1.533,3,5,2
262,PRS,P007032,P012610,1.533,3,5,2
262,PRS,P007032,P012640,10.8,-15,18,33
262,PRS,P007032,P013373,5.717,-7,10,17
262,PRS,P007483,P011949,8.516,-2,18,20
262,PRS,P007483,P012608,9.35,8,25,17
262,PRS,P007483,P012610,9.35,8,25,17
262,PRS,P007483,P012611,3.35,3,9,6
262,PRS,P007483,P012613,4.467,6,15,9
262,PRS,P007483,P012640,4.433,-6,8,14
262,PRS,P010390,P011949,0.95,0,3,3
262,PRS,P010390,P012608,19.5,21,49,28
262,PRS,P010390,P012610,19.5,21,49,28
262,PRS,P010390,P012611,17.967,18,44,26
262,PRS,P010390,P012613,15.567,18,41,23
262,PRS,P010390,P012640,0.65,-2,0,2
262,PRS,P011949,P012608,5.833,2,13,11
262,PRS,P011949,P012610,5.833,2,13,11
262,PRS,P011949,P012611,2.7,-2,5,7
262,PRS,P011949,P012640,9.35,-11,18,29
262,PRS,P011949,P013373,5.717,-7,10,17
262,PRS,P012608,P012610,29.2,28,74,46
262,PRS,P012608,P012611,21.667,20,53,33
262,PRS,P012608,P012613,20.384,23,56,33
262,PRS,P012610,P012611,21.667,20,53,33
262,PRS,P012610,P012613,20.384,23,56,33
262,PRS,P012611,P012613,17.517,22,48,26
262,PRS,P012640,P013373,5.717,-7,10,17
263,MCO,P002581,P005985,5.55,6,15,9
263,MCO,P002581,P008099,6.466,2,12,10
263,MCO,P002581,P009754,10.533,4,23,19
263,MCO,P002581,P011212,8.133,12,21,9
263,MCO,P002581,P011226,9.099,5,18,13
263,MCO,P002581,P011231,6.733,3,16,13
263,MCO,P002581,P012515,1.55,0,3,3
263,MCO,P004132,P004790,0.333,0,0,0
263,MCO,P004132,P005985,21.583,5,53,48
263,MCO,P004132,P008099,8.149,-4,16,20
263,MCO,P004132,P009754,9.182,8,23,15
263,MCO,P004132,P011212,19.499,-3,44,47
263,MCO,P004132,P011226,17.783,5,42,37
263,MCO,P004132,P011231,15.667,5,37,32
263,MCO,P004132,P012515,4.6,-4,5,9
263,MCO,P004790,P008099,1.733,-2,0,2
263,MCO,P004790,P009754,1.733,-2,0,2
263,MCO,P004790,P011212,1.733,-2,0,2
263,MCO,P004790,PLCZ,1.4,-2,0,2
263,MCO,P005985,P008099,7.05,1,21,20
263,MCO,P005985,P009754,13.017,12,41,29
263,MCO,P005985,P011212,19.733,6,52,46
263,MCO,P005985,P011226,19.0,7,48,41
263,MCO,P005985,P011231,23.601,11,61,50
263,MCO,P005985,P012515,6.15,-4,8,12
263,MCO,P005985,PLCZ,2.384,0,9,9
263,MCO,P008099,P009754,14.182,4,29,25
263,MCO,P008099,P011212,13.082,-1,24,25
263,MCO,P008099,P011226,13.849,-5,23,28
263,MCO,P008099,P011231,2.7,0,8,8
263,MCO,P008099,PLCZ,2.917,1,7,6
263,MCO,P009754,P011212,12.532,8,29,21
263,MCO,P009754,P011226,15.849,4,31,27
263,MCO,P009754,P011231,11.634,4,32,28
263,MCO,P009754,P012515,1.55,0,3,3
263,MCO,P009754,PLCZ,3.784,-2,9,11
263,MCO,P011212,P011226,19.849,8,46,38
263,MCO,P011212,P011231,15.567,6,39,33
263,MCO,P011212,P012515,4.6,-4,5,9
263,MCO,P011212,PLCZ,1.4,-2,0,2
263,MCO,P011226,P011231,14.7,7,38,31
263,MCO,P011226,PLCZ,0.867,-3,2,5
263,MCO,P011231,P012515,6.15,-4,8,12
263,MCO,P011231,PLCZ,2.384,0,9,9
263,ULK,P002849,P002968,2.434,-1,3,4
263,ULK,P002849,P004004,11.667,2,31,29
263,ULK,P002849,P005216,9.95,-14,18,32
263,ULK,P002849,P006961,15.717,-5,32,37
263,ULK,P002849,P008962,11.566,-12,24,36
263,ULK,P002849,P009783,5.983,-7,7,14
263,ULK,P002849,P009863,9.384,-3,15,18
263,ULK,P002849,P011205,8.133,-7,10,17
263,ULK,P002849,P013696,3.434,3,8,5
263,ULK,P002968,P004004,14.284,16,36,20
263,ULK,P002968,P005216,11.783,11,31,20
263,ULK,P002968,P006961,3.151,5,9,4
263,ULK,P002968,P008962,13.6,10,33,23
263,ULK,P002968,P009783,9.433,4,20,16
263,ULK,P002968,P009863,7.684,-1,12,13
263,ULK,P002968,P011205,1.75,-7,0,7
263,ULK,P002968,P013696,0.017,-1,0,1
263,ULK,P004004,P005216,15.083,6,42,36
263,ULK,P004004,P006961,13.884,6,38,32
263,ULK,P004004,P008962,22.999,13,58,45
263,ULK,P004004,P009783,11.15,2,22,20
263,ULK,P004004,P009863,15.117,2,28,26
263,ULK,P004004,P011205,1.6,2,4,2
263,ULK,P004004,P013696,6.084,-5,9,14
263,ULK,P005216,P006961,8.717,-7,19,26
263,ULK,P005216,P008962,16.483,-3,41,44
263,ULK,P005216,P009783,10.383,-1,22,23
263,ULK,P005216,P009863,5.2,-5,7,12
263,ULK,P005216,P011205,3.933,-7,4,11
263,ULK,P006961,P008962,16.083,-5,41,46
263,ULK,P006961,P009783,2.667,-5,2,7
263,ULK,P006961,P009863,14.284,-7,28,35
263,ULK,P006961,P011205,9.183,-6,17,23
263,ULK,P006961,P013696,7.65,0,18,18
263,ULK,P008962,P009783,11.966,-3,21,24
263,ULK,P008962,P009863,18.599,-11,31,42
263,ULK,P008962,P011205,8.716,-14,15,29
263,ULK,P008962,P013696,5.916,-3,12,15
263,ULK,P009783,P009863,6.0,-7,4,11
263,ULK,P009783,P011205,5.233,-10,4,14
263,ULK,P009783,P013696,2.717,-5,2,7
263,ULK,P009863,P011205,6.733,-9,11,20
263,ULK,P009863,P013696,9.867,-3,20,23
263,ULK,P011205,P013696,3.783,2,11,9
264,OLY,P001255,P003469,25.383,-5,50,55
264,OLY,P001255,P003941,4.933,-2,2,4
264,OLY,P001255,P007853,19.2,3,40,37
264,OLY,P001255,P007947,8.167,-24,6,30
264,OLY,P001255,P008811,16.834,-8,34,42
264,OLY,P001255,P008829,6.15,5,14,9
264,OLY,P001255,P013380,7.45,-8,10,18
264,OLY,P001255,P013389,18.483,19,44,25
264,OLY,P003469,P003941,3.666,-2,2,4
264,OLY,P003469,P007853,21.183,7,47,40
264,OLY,P003469,P007947,14.467,-29,16,45
264,OLY,P003469,P008811,16.834,-8,34,42
264,OLY,P003469,P008829,12.733,2,26,24
264,OLY,P003469,P010392,4.6,-7,5,12
264,OLY,P003469,P013380,13.75,-11,19,30
264,OLY,P003469,P013389,20.316,21,49,28
264,OLY,P003941,P007853,10.433,-2,13,15
264,OLY,P003941,P007947,1.333,-3,0,3
264,OLY,P003941,P008829,6.767,0,11,11
264,OLY,P003941,P013380,5.5,0,11,11
264,OLY,P003941,P013389,9.1,1,13,12
264,OLY,P007853,P007947,5.6,-8,9,17
264,OLY,P007853,P008811,9.384,0,24,24
264,OLY,P007853,P008829,14.9,9,32,23
264,OLY,P007853,P013380,8.75,4,18,14
264,OLY,P007853,P013389,22.35,15,49,34
264,OLY,P007947,P008811,6.834,-21,6,27
264,OLY,P007947,P008829,6.3,-5,10,15
264,OLY,P007947,P010392,4.6,-7,5,12
264,OLY,P007947,P013380,9.017,-19,9,28
264,OLY,P007947,P013389,1.55,0,3,3
264,OLY,P008811,P013380,7.45,-8,10,18
264,OLY,P008811,P013389,10.0,13,28,15
264,OLY,P008829,P010392,4.6,-7,5,12
264,OLY,P008829,P013380,11.8,-3,20,23
264,OLY,P008829,P013389,14.75,7,30,23
264,OLY,P010392,P013380,3.05,-7,2,9
264,OLY,P010392,P013389,1.55,0,3,3
264,OLY,P013380,P013389,10.233,8,21,13
264,RED,P000848,P004007,1.3,-1,2,3
264,RED,P000848,P004866,15.367,19,39,20
264,RED,P000848,P006436,13.35,11,30,19
264,RED,P000848,P007960,14.967,15,34,19
264,RED,P000848,P009048,14.334,16,32,16
264,RED,P000848,P010588,6.967,8,14,6
264,RED,P000848,P010612,8.767,10,18,8
264,RED,P000848,P012044,7.616,14,23,9
264,RED,P004007,P004866,0.3,0,0,0
264,RED,P004007,P006436,1.85,-1,2,3
264,RED,P004007,P007960,1.85,-1,2,3
264,RED,P004007,P009048,0.55,0,0,0
264,RED,P004007,P012044,1.3,-1,2,3
264,RED,P004007,PLUO,0.25,0,0,0
264,RED,P004866,P006436,16.667,-5,35,40
264,RED,P004866,P007960,16.0,0,36,36
264,RED,P004866,P009048,15.5,0,36,36
264,RED,P004866,P010588,6.717,7,17,10
264,RED,P004866,P010612,13.1,0,32,32
264,RED,P004866,P012044,7.217,7,17,10
264,RED,P006436,P007960,20.6,3,46,43
264,RED,P006436,P009048,21.4,1,47,46
264,RED,P006436,P010588,13.883,-9,19,28
264,RED,P006436,P010612,20.233,-17,33,50
264,RED,P006436,P012044,14.333,3,26,23
264,RED,P006436,PJDR,8.166,-2,14,16
264,RED,P006436,PLUO,0.25,0,0,0
264,RED,P007960,P009048,21.867,6,48,42
264,RED,P007960,P010588,3.067,-2,2,4
264,RED,P007960,P010612,11.217,-8,20,28
264,RED,P007960,P012044,4.85,7,12,5
264,RED,P007960,PLUO,0.25,0,0,0
264,RED,P009048,P010588,5.667,-5,5,10
264,RED,P009048,P010612,13.317,-11,23,34
264,RED,P009048,P012044,3.05,8,10,2
264,RED,P009048,PJDR,1.933,-3,3,6
264,RED,P009048,PLUO,0.25,0,0,0
264,RED,P010588,P010612,19.4,1,33,32
264,RED,P010588,P012044,13.733,6,28,22
264,RED,P010588,PJDR,8.166,-2,14,16
264,RED,P010612,P012044,16.0,7,31,24
264,RED,P010612,PJDR,8.166,-2,14,16
264,RED,P012044,PJDR,6.233,1,11,10
265,BAS,P004058,P007230,1.75,-6,3,9
265,BAS,P004058,P007579,10.483,9,33,24
265,BAS,P004058,P011085,7.567,0,21,21
265,BAS,P004058,P011196,12.233,3,36,33
265,BAS,P004058,P011948,7.466,5,24,19
265,BAS,P004058,P012080,9.433,1,27,26
265,BAS,P007230,P007579,3.867,1,7,6
265,BAS,P007230,P008072,11.934,20,39,19
265,BAS,P007230,P008850,1.017,-3,0,3
265,BAS,P007230,P011085,8.634,-7,18,25
265,BAS,P007230,P011196,6.483,-6,15,21
265,BAS,P007230,P011948,13.883,27,47,20
265,BAS,P007230,P012080,21.034,13,57,44
265,BAS,P007230,P013367,20.534,21,58,37
265,BAS,P007579,P008850,1.35,-4,0,4
265,BAS,P007579,P010784,1.733,-1,3,4
265,BAS,P007579,P010788,1.35,-4,0,4
265,BAS,P007579,P011085,16.851,4,41,37
265,BAS,P007579,P011196,16.367,12,51,39
265,BAS,P007579,P011948,11.3,11,39,28
265,BAS,P007579,P012080,14.884,2,38,36
265,BAS,P007579,P013367,8.151,6,20,14
265,BAS,P008072,P011085,0.717,-3,0,3
265,BAS,P008072,P011948,11.217,23,39,16
265,BAS,P008072,P012080,11.934,20,39,19
265,BAS,P008072,P013367,11.934,20,39,19
265,BAS,P008850,P010784,1.35,-4,0,4
265,BAS,P008850,P010788,1.35,-4,0,4
265,BAS,P008850,P011085,1.35,-4,0,4
265,BAS,P008850,P011196,1.017,-3,0,3
265,BAS,P008850,P012080,1.017,-3,0,3
265,BAS,P008850,P013367,1.017,-3,0,3
265,BAS,P010784,P010788,1.35,-4,0,4
265,BAS,P010784,P011085,1.733,-1,3,4
265,BAS,P010784,P011196,0.383,3,3,0
265,BAS,P010784,P011948,0.383,3,3,0
265,BAS,P010788,P011085,1.35,-4,0,4
265,BAS,P011085,P011196,16.384,6,49,43
265,BAS,P011085,P011948,7.817,8,26,18
265,BAS,P011085,P012080,14.018,-11,30,41
265,BAS,P011085,P013367,11.451,4,28,24
265,BAS,P011196,P011948,13.266,11,43,32
265,BAS,P011196,P012080,16.25,-7,42,49
265,BAS,P011196,P013367,9.017,5,25,20
265,BAS,P011948,P012080,18.233,23,60,37
265,BAS,P011948,P013367,15.767,33,55,22
265,BAS,P012080,P013367,21.401,18,59,41
265,MUN,P001288,P001557,3.583,-5,6,11
265,MUN,P001288,P004508,9.232,-20,13,33
265,MUN,P001288,P005460,5.516,-4,10,14
265,MUN,P001288,P007201,19.415,-26,31,57
265,MUN,P001288,P007639,1.733,1,4,3
265,MUN,P001288,P010391,16.116,-14,29,43
265,MUN,P001288,P011224,13.915,-25,19,44
265,MUN,P001288,P011987,11.916,-5,22,27
265,MUN,P001288,P012123,3.166,-2,6,8
265,MUN,P001557,P004508,18.4,-10,45,55
265,MUN,P001557,P007201,8.266,-10,18,28
265,MUN,P001557,P007639,14.167,7,42,35
265,MUN,P001557,P010391,12.183,10,40,30
265,MUN,P001557,P011224,14.083,-8,35,43
265,MUN,P001557,P011987,12.116,2,34,32
265,MUN,P001557,P012123,6.934,2,20,18
265,MUN,P004508,P005460,0.533,-2,0,2
265,MUN,P004508,P007201,10.399,-31,12,43
265,MUN,P004508,P007639,15.9,8,46,38
265,MUN,P004508,P010391,12.35,-6,32,38
265,MUN,P004508,P011224,20.199,-26,39,65
265,MUN,P004508,P011987,8.083,-5,19,24
265,MUN,P004508,P012123,10.1,0,26,26
265,MUN,P005460,P007201,5.516,-4,10,14
265,MUN,P005460,P010391,4.983,-2,10,12
265,MUN,P005460,P011224,0.533,-2,0,2
265,MUN,P005460,P011987,4.983,-2,10,12
265,MUN,P007201,P010391,17.899,-9,38,47
265,MUN,P007201,P011224,16.865,-31,27,58
265,MUN,P007201,P011987,15.682,-8,31,39
265,MUN,P007201,P012123,2.35,-5,5,10
265,MUN,P007639,P010391,8.15,3,25,22
265,MUN,P007639,P011224,9.8,5,27,22
265,MUN,P007639,P011987,6.1,3,19,16
265,MUN,P007639,P012123,7.75,5,21,16
265,MUN,P010391,P011224,12.716,-9,28,37
265,MUN,P010391,P011987,19.799,3,50,47
265,MUN,P011224,P011987,8.449,-8,15,23
265,MUN,P011224,P012123,10.1,0,26,26
266,ASV,P000229,P002100,8.933,1,17,16
266,ASV,P000229,P003526,1.767,2,5,3
266,ASV,P000229,P004194,4.083,2,9,7
266,ASV,P000229,P007027,15.133,11,36,25
266,ASV,P000229,P009818,17.034,14,36,22
266,ASV,P000229,P010316,0.25,2,2,0
266,ASV,P000229,P010545,2.55,-1,5,6
266,ASV,P000229,P011225,11.2,10,23,13
266,ASV,P000229,P013371,6.767,2,9,7
266,ASV,P000229,P013405,19.883,9,38,29
266,ASV,P002100,P003526,4.484,-5,5,10
266,ASV,P002100,P004194,8.567,-3,14,17
266,ASV,P002100,P007027,13.417,-4,22,26
266,ASV,P002100,P009818,7.867,-11,11,22
266,ASV,P002100,P010316,3.783,-9,5,14
266,ASV,P002100,P010545,7.833,-11,10,21
266,ASV,P002100,P011225,0.583,-2,0,2
266,ASV,P002100,P013371,3.2,-7,5,12
266,ASV,P002100,P013405,10.133,-1,19,20
266,ASV,P003526,P004194,9.917,-15,10,25
266,ASV,P003526,P007027,16.084,-13,25,38
266,ASV,P003526,P009818,7.384,-4,15,19
266,ASV,P003526,P010545,12.167,-1,25,26
266,ASV,P003526,P011225,9.833,-10,15,25
266,ASV,P003526,P013405,2.7,-6,0,6
266,ASV,P004194,P007027,14.0,-13,19,32
266,ASV,P004194,P009818,1.217,-6,0,6
266,ASV,P004194,P010545,6.25,-3,10,13
266,ASV,P004194,P011225,5.433,-10,5,15
266,ASV,P004194,P013405,6.533,-4,9,13
266,ASV,P007027,P009818,15.884,6,37,31
266,ASV,P007027,P010545,12.95,-4,25,29
266,ASV,P007027,P011225,14.266,-2,29,31
266,ASV,P007027,P013405,16.066,3,31,28
266,ASV,P009818,P010316,2.833,-5,5,10
266,ASV,P009818,P010545,8.5,-5,18,23
266,ASV,P009818,P011225,16.183,8,33,25
266,ASV,P009818,P013371,8.767,-3,12,15
266,ASV,P009818,P013405,15.267,10,29,19
266,ASV,P010316,P010545,3.783,-9,5,14
266,ASV,P010316,P011225,0.833,0,2,2
266,ASV,P010316,P013371,3.45,-5,7,12
266,ASV,P010316,P013405,1.2,-2,2,4
266,ASV,P010545,P011225,7.716,-6,15,21
266,ASV,P010545,P013371,3.2,-7,5,12
266,ASV,P010545,P013405,1.983,-5,2,7
266,ASV,P011225,P013371,6.767,2,9,7
266,ASV,P011225,P013405,13.65,2,21,19
266,ASV,P013371,P013405,7.717,-2,9,11
266,MAD,P003108,P003583,0.833,-2,0,2
266,MAD,P003108,P003733,6.75,6,19,13
266,MAD,P003108,P005791,7.033,7,20,13
266,MAD,P003108,P005928,6.499,-7,5,12
266,MAD,P003108,P006540,1.333,2,5,3
266,MAD,P003108,P007630,2.467,-1,1,2
266,MAD,P003108,P009005,14.95,0,25,25
266,MAD,P003108,P011247,17.25,10,40,30
266,MAD,P003108,P011649,6.45,-4,5,9
266,MAD,P003108,P013667,14.75,0,25,25
266,MAD,P003108,PTGB,15.017,9,35,26
266,MAD,P003583,P003733,0.333,0,0,0
266,MAD,P003583,P005928,3.599,-9,1,10
266,MAD,P003583,P006540,2.766,-7,1,8
266,MAD,P003583,P007630,2.766,-7,1,8
266,MAD,P003583,P009005,0.533,-2,0,2
266,MAD,P003583,P011247,0.833,-2,0,2
266,MAD,P003583,P011649,2.733,-7,1,8
266,MAD,P003733,P005791,17.166,23,51,28
266,MAD,P003733,P005928,10.316,12,28,16
266,MAD,P003733,P006540,13.732,20,38,18
266,MAD,P003733,P007630,12.783,17,32,15
266,MAD,P003733,P009005,0.75,1,1,0
266,MAD,P003733,P011247,8.416,12,24,12
266,MAD,P003733,P013667,0.933,1,1,0
266,MAD,P003733,PTGB,5.417,4,14,10
266,MAD,P005791,P005928,10.933,13,29,16
266,MAD,P005791,P006540,12.816,19,37,18
266,MAD,P005791,P007630,12.833,18,33,15
266,MAD,P005791,P009005,0.417,0,0,0
266,MAD,P005791,P011247,7.166,11,23,12
266,MAD,P005791,PTGB,5.7,5,15,10
266,MAD,P005928,P006540,12.749,5,29,24
266,MAD,P005928,P007630,13.516,5,28,23
266,MAD,P005928,P009005,4.266,-5,2,7
266,MAD,P005928,P011247,0.833,-2,0,2
266,MAD,P005928,P011649,5.783,-7,3,10
266,MAD,P005928,P013667,4.133,-5,2,7
266,MAD,P005928,PTGB,2.033,-4,1,5
266,MAD,P006540,P007630,14.499,10,33,23
266,MAD,P006540,P009005,2.583,-4,3,7
266,MAD,P006540,P011247,4.832,3,12,9
266,MAD,P006540,P011649,4.266,-12,3,15
266,MAD,P006540,P013667,2.416,-4,3,7
266,MAD,P007630,P011247,3.45,4,6,2
266,MAD,P007630,P011649,2.433,-7,1,8
266,MAD,P007630,P013667,0.65,-2,0,2
266,MAD,P007630,PTGB,2.467,-1,1,2
266,MAD,P009005,P011247,12.966,-1,26,27
266,MAD,P009005,P011649,7.983,-9,7,16
266,MAD,P009005,P013667,16.166,-2,28,30
266,MAD,P009005,PTGB,7.85,6,20,14
266,MAD,P011247,P011649,5.233,-9,5,14
266,MAD,P011247,P013667,13.033,1,26,25
266,MAD,P011247,PTGB,12.984,13,34,21
266,MAD,P011649,P013667,7.983,-9,7,16
266,MAD,P013667,PTGB,8.6,4,20,16
267,TEL,P004233,P005145,4.283,0,4,4
267,TEL,P004233,P007519,8.25,13,25,12
267,TEL,P004233,P007990,7.216,5,11,6
267,TEL,P004233,P011193,7.8,9,23,14
267,TEL,P004233,P011202,1.734,0,2,2
267,TEL,P004233,P011219,13.999,16,34,18
267,TEL,P004233,P012604,3.467,8,10,2
267,TEL,P004233,P013381,8.083,12,22,10
267,TEL,P004233,P013699,9.5,1,13,12
267,TEL,P005145,P007519,0.083,0,0,0
267,TEL,P005145,P007990,9.083,-1,12,13
267,TEL,P005145,P011193,2.35,-2,4,6
267,TEL,P005145,P011202,7.283,-3,12,15
267,TEL,P005145,P011219,3.966,0,4,4
267,TEL,P005145,P012604,7.55,-3,12,15
267,TEL,P005145,P013699,11.466,-3,16,19
267,TEL,P007519,P011193,20.1,6,40,34
267,TEL,P007519,P011202,10.5,6,23,17
267,TEL,P007519,P011219,19.199,12,43,31
267,TEL,P007519,P012604,17.634,5,34,29
267,TEL,P007519,P013381,16.066,-3,33,36
267,TEL,P007519,P013699,6.632,1,18,17
267,TEL,P007990,P011202,5.25,-1,8,9
267,TEL,P007990,P011219,7.216,5,11,6
267,TEL,P007990,P012604,5.2,-1,8,9
267,TEL,P007990,P013381,3.333,5,7,2
267,TEL,P007990,P013699,12.366,4,19,15
267,TEL,P011193,P011202,8.951,-2,13,15
267,TEL,P011193,P011219,17.783,9,38,29
267,TEL,P011193,P012604,16.884,2,29,27
267,TEL,P011193,P013381,13.317,-7,21,28
267,TEL,P011193,P013699,5.083,-7,8,15
267,TEL,P011202,P011219,5.533,8,12,4
267,TEL,P011202,P012604,16.234,0,30,30
267,TEL,P011202,P013381,6.7,-3,14,17
267,TEL,P011202,P013699,12.683,-1,26,27
267,TEL,P011219,P012604,12.217,7,23,16
267,TEL,P011219,P013381,15.049,6,31,25
267,TEL,P011219,P013699,10.698,5,20,15
267,TEL,P012604,P013381,9.817,-12,13,25
267,TEL,P012604,P013699,11.733,2,25,23
267,TEL,P013381,P013699,7.699,2,19,17
267,VIR,P001133,P001844,12.233,-6,20,26
267,VIR,P001133,P002084,4.267,-4,2,6
267,VIR,P001133,P004554,14.234,-4,24,28
267,VIR,P001133,P004888,19.584,-8,30,38
267,VIR,P001133,P005738,1.717,-3,2,5
267,VIR,P001133,P006739,7.451,-8,10,18
267,VIR,P001133,P009549,16.367,-7,28,35
267,VIR,P001133,P011816,2.066,-3,4,7
267,VIR,P001133,P012585,7.084,-5,4,9
267,VIR,P001133,P012591,1.433,-2,2,4
267,VIR,P001133,PBCN,2.7,-6,2,8
267,VIR,P001844,P002084,4.15,9,11,2
267,VIR,P001844,P004554,14.484,6,27,21
267,VIR,P001844,P004888,15.117,5,29,24
267,VIR,P001844,P006739,4.15,9,11,2
267,VIR,P001844,P009549,7.3,1,16,15
267,VIR,P001844,P011816,2.066,-3,4,7
267,VIR,P001844,P012585,3.834,-5,2,7
267,VIR,P001844,P012591,1.433,-2,2,4
267,VIR,P001844,PBCN,1.433,-2,2,4
267,VIR,P002084,P004554,7.4,10,20,10
267,VIR,P002084,P004888,10.4,10,22,12
267,VIR,P002084,P005738,10.15,-6,15,21
267,VIR,P002084,P006739,18.7,4,35,31
267,VIR,P002084,P009549,4.784,-8,2,10
267,VIR,P002084,P012585,14.067,1,24,23
267,VIR,P002084,P012591,1.933,-6,2,8
267,VIR,P002084,PBCN,11.417,-10,15,25
267,VIR,P004554,P004888,21.801,6,44,38
267,VIR,P004554,P006739,10.95,13,28,15
267,VIR,P004554,P009549,11.251,-3,22,25
267,VIR,P004554,P012585,7.084,-4,11,15
267,VIR,P004888,P005738,1.717,-3,2,5
267,VIR,P004888,P006739,13.067,10,30,20
267,VIR,P004888,P009549,15.784,-7,28,35
267,VIR,P004888,P011816,0.633,-1,2,3
267,VIR,P004888,P012585,10.501,-4,13,17
267,VIR,P005738,P006739,11.867,-9,17,26
267,VIR,P005738,P009549,0.9,-3,2,5
267,VIR,P005738,P012585,9.034,0,13,13
267,VIR,P005738,P012591,1.933,-6,2,8
267,VIR,P005738,PBCN,10.15,-6,15,21
267,VIR,P006739,P009549,6.634,-8,10,18
267,VIR,P006739,P012585,11.767,5,22,17
267,VIR,P006739,P012591,1.933,-6,2,8
267,VIR,P006739,PBCN,11.417,-10,15,25
267,VIR,P009549,P011816,0.633,-1,2,3
267,VIR,P009549,P012585,3.284,-4,2,6
267,VIR,P009549,PBCN,1.267,-4,0,4
267,VIR,P011816,P012591,1.433,-2,2,4
267,VIR,P011816,PBCN,1.433,-2,2,4
267,VIR,P012585,PBCN,8.217,0,13,13
267,VIR,P012591,PBCN,3.366,-8,4,12
268,BER,P006251,P006919,8.868,-12,12,24
268,BER,P006251,P007025,3.517,0,8,8
268,BER,P006251,P008062,10.716,-7,23,30
268,BER,P006251,P008173,5.884,0,13,13
268,BER,P006251,P008211,6.251,-3,10,13
268,BER,P006251,P008384,14.801,-13,32,45
268,BER,P006251,P008780,3.284,-4,6,10
268,BER,P006251,P008967,12.433,-9,28,37
268,BER,P006251,P011631,8.433,-1,18,19
268,BER,P006251,P011934,2.967,-7,4,11
268,BER,P006251,P013774,2.85,0,10,10
268,BER,P006919,P007025,5.15,-2,9,11
268,BER,P006919,P008062,4.934,-9,4,13
268,BER,P006919,P008173,9.55,1,21,20
268,BER,P006919,P008211,8.218,6,19,13
268,BER,P006919,P008384,5.668,-17,3,20
268,BER,P006919,P008780,10.484,-14,15,29
268,BER,P006919,P008967,8.001,0,17,17
268,BER,P006919,P011631,2.1,-3,3,6
268,BER,P006919,P011934,10.717,-1,21,22
268,BER,P006919,P013774,7.05,-9,8,17
268,BER,P007025,P008062,0.6,-2,0,2
268,BER,P007025,P008173,3.517,0,8,8
268,BER,P007025,P008211,2.4,-2,5,7
268,BER,P007025,P008384,2.767,-4,4,8
268,BER,P007025,P008780,3.2,-2,5,7
268,BER,P007025,P011934,5.367,-4,9,13
268,BER,P007025,P013774,2.75,0,4,4
268,BER,P008062,P008211,3.867,5,7,2
268,BER,P008062,P008384,14.448,2,37,35
268,BER,P008062,P008967,19.032,5,44,39
268,BER,P008062,P011631,12.299,12,30,18
268,BER,P008062,P011934,7.183,3,14,11
268,BER,P008062,P013774,5.449,3,17,14
268,BER,P008173,P008211,6.101,8,16,8
268,BER,P008173,P008384,5.452,-8,6,14
268,BER,P008173,P008780,5.5,-10,7,17
268,BER,P008173,P008967,2.9,7,10,3
268,BER,P008173,P011631,1.8,1,5,4
268,BER,P008173,P011934,10.051,-6,18,24
268,BER,P008173,P013774,4.317,-9,4,13
268,BER,P008211,P008384,3.468,-5,4,9
268,BER,P008211,P008780,1.767,-6,1,7
268,BER,P008211,P008967,7.667,10,19,9
268,BER,P008211,P011631,4.1,-1,7,8
268,BER,P008211,P011934,6.384,8,16,8
268,BER,P008211,P013774,0.317,0,0,0
268,BER,P008384,P008780,3.935,-10,3,13
268,BER,P008384,P008967,15.515,2,42,40
268,BER,P008384,P011631,10.716,13,31,18
268,BER,P008384,P011934,8.934,-9,13,22
268,BER,P008384,P013774,7.5,-3,17,20
268,BER,P008780,P008967,0.767,0,3,3
268,BER,P008780,P011631,0.783,1,3,2
268,BER,P008780,P011934,7.917,-13,9,22
268,BER,P008780,P013774,7.167,-10,8,18
268,BER,P008967,P011631,13.199,10,32,22
268,BER,P008967,P011934,10.033,10,24,14
268,BER,P008967,P013774,4.849,5,17,12
268,BER,P011631,P011934,4.633,8,12,4
268,BER,P011631,P013774,1.933,4,7,3
268,BER,P011934,P013774,7.55,-9,8,17
268,PAN,P001926,P005161,2.433,-2,2,4
268,PAN,P001926,P007866,12.35,-3,23,26
268,PAN,P001926,P009622,7.734,-2,17,19
268,PAN,P001926,P011204,10.15,-21,10,31
268,PAN,P001926,P011209,2.333,3,5,2
268,PAN,P001926,P012712,14.917,-15,26,41
268,PAN,P001926,P012774,15.517,-12,28,40
268,PAN,P001926,P013383,6.034,-12,9,21
268,PAN,P004088,P011204,4.067,5,12,7
268,PAN,P004088,P012712,4.067,5,12,7
268,PAN,P004088,P012774,4.067,5,12,7
268,PAN,P004088,P013383,4.067,5,12,7
268,PAN,P005161,P007866,2.433,-2,2,4
268,PAN,P005161,P009622,1.633,-4,0,4
268,PAN,P005161,P011204,9.533,-1,19,20
268,PAN,P005161,P011209,1.567,2,5,3
268,PAN,P005161,P012712,8.733,-3,17,20
268,PAN,P005161,P012774,9.599,-7,14,21
268,PAN,P005161,P013383,5.9,-3,12,15
268,PAN,P005161,PLHK,2.833,0,5,5
268,PAN,P007866,P009622,9.984,4,22,18
268,PAN,P007866,P011204,8.267,-6,14,20
268,PAN,P007866,P011209,2.083,5,5,0
268,PAN,P007866,P012712,12.367,2,27,25
268,PAN,P007866,P012774,13.267,3,29,26
268,PAN,P007866,P013383,0.517,1,2,1
268,PAN,P009622,P011204,10.101,19,31,12
268,PAN,P009622,P011209,3.75,16,16,0
268,PAN,P009622,P012712,14.435,24,46,22
268,PAN,P009622,P012774,11.585,9,32,23
268,PAN,P009622,P013383,6.401,16,26,10
268,PAN,P009622,PLHK,0.717,2,2,0
268,PAN,P011204,P011209,6.1,17,22,5
268,PAN,P011204,P012712,31.484,3,69,66
268,PAN,P011204,P012774,25.417,-7,50,57
268,PAN,P011204,P013383,20.467,9,50,41
268,PAN,P011204,PLHK,3.55,2,7,5
268,PAN,P011209,P012712,6.533,18,23,5
268,PAN,P011209,P012774,1.716,4,4,0
268,PAN,P011209,P013383,5.25,15,20,5
268,PAN,P012712,P012774,30.984,1,68,67
268,PAN,P012712,P013383,21.134,7,53,46
268,PAN,P012712,PLHK,3.55,2,7,5
268,PAN,P012774,P013383,16.834,-6,36,42
268,PAN,P012774,PLHK,3.55,2,7,5
269,BAR,P002939,P003196,7.416,7,17,10
269,BAR,P002939,P003478,6.117,0,9,9
269,BAR,P002939,P006568,9.8,-2,14,16
269,BAR,P002939,P007464,7.433,-1,15,16
269,BAR,P002939,P009862,11.883,-3,23,26
269,BAR,P002939,P009992,4.633,7,10,3
269,BAR,P002939,P012745,15.933,3,27,24
269,BAR,P002939,P012795,18.75,2,36,34
269,BAR,P002939,P013379,8.367,3,17,14
269,BAR,P003196,P007464,8.45,6,20,14
269,BAR,P003196,P009862,11.966,3,26,23
269,BAR,P003196,P009992,12.416,6,25,19
269,BAR,P003196,P012745,7.449,2,14,12
269,BAR,P003196,P012795,7.449,2,14,12
269,BAR,P003196,P013379,8.45,6,20,14
269,BAR,P003478,P006568,6.117,0,9,9
269,BAR,P003478,P009862,0.467,0,0,0
269,BAR,P003478,P012745,6.584,0,9,9
269,BAR,P003478,P012795,6.584,0,9,9
269,BAR,P003478,P013379,0.467,0,0,0
269,BAR,P006568,P007464,1.433,-2,0,2
269,BAR,P006568,P009862,3.683,-2,5,7
269,BAR,P006568,P012745,9.15,-2,14,16
269,BAR,P006568,P012795,8.367,0,14,14
269,BAR,P006568,P013379,0.65,0,0,0
269,BAR,P007464,P009862,15.2,0,33,33
269,BAR,P007464,P009992,13.917,13,34,21
269,BAR,P007464,P012745,0.783,-2,0,2
269,BAR,P007464,P012795,8.367,2,21,19
269,BAR,P007464,P013379,17.417,8,41,33
269,BAR,P009862,P009992,17.0,8,40,32
269,BAR,P009862,P012745,14.883,3,30,27
269,BAR,P009862,P012795,21.817,5,49,44
269,BAR,P009862,P013379,20.301,6,46,40
269,BAR,P009992,P012745,7.666,2,16,14
269,BAR,P009992,P012795,13.133,9,30,21
269,BAR,P009992,P013379,17.567,15,45,30
269,BAR,P012745,P012795,21.75,6,41,35
269,BAR,P012745,P013379,5.934,4,13,9
269,BAR,P012795,P013379,14.251,6,34,28
269,ZAL,P002329,P002676,7.267,2,16,14
269,ZAL,P002329,P003048,7.1,4,16,12
269,ZAL,P002329,P005504,5.367,-2,9,11
269,ZAL,P002329,P007029,17.017,3,40,37
269,ZAL,P002329,P007513,11.217,-1,22,23
269,ZAL,P002329,P007975,16.001,-3,34,37
269,ZAL,P002329,P011051,12.401,-3,27,30
269,ZAL,P002329,P011983,13.035,-4,23,27
269,ZAL,P002329,P012622,0.067,0,0,0
269,ZAL,P002329,P013775,10.0,0,21,21
269,ZAL,P002676,P003048,1.75,-1,1,2
269,ZAL,P002676,P005504,8.667,-6,11,17
269,ZAL,P002676,P007029,5.85,-5,10,15
269,ZAL,P002676,P007513,0.85,-1,1,2
269,ZAL,P002676,P007975,11.0,-5,19,24
269,ZAL,P002676,P011051,5.55,-3,10,13
269,ZAL,P002676,P011983,10.267,-5,12,17
269,ZAL,P002676,P012622,0.067,0,0,0
269,ZAL,P003048,P007029,9.917,3,18,15
269,ZAL,P003048,P007513,15.784,1,30,29
269,ZAL,P003048,P007975,5.917,-1,11,12
269,ZAL,P003048,P011051,9.584,-3,14,17
269,ZAL,P003048,P011983,12.884,-1,20,21
269,ZAL,P003048,P013775,3.8,2,10,8
269,ZAL,P005504,P007029,4.25,-8,4,12
269,ZAL,P005504,P007513,2.25,-4,2,6
269,ZAL,P005504,P007975,9.217,-8,11,19
269,ZAL,P005504,P011051,3.15,-4,2,6
269,ZAL,P005504,P011983,9.884,-6,13,19
269,ZAL,P005504,P013775,0.883,-2,0,2
269,ZAL,P007029,P007513,10.717,1,20,19
269,ZAL,P007029,P007975,11.55,-6,25,31
269,ZAL,P007029,P011051,12.884,-4,26,30
269,ZAL,P007029,P011983,11.251,-6,16,22
269,ZAL,P007029,P012622,0.067,0,0,0
269,ZAL,P007029,P013775,9.433,2,21,19
269,ZAL,P007513,P007975,9.234,-4,15,19
269,ZAL,P007513,P011051,12.351,-4,18,22
269,ZAL,P007513,P011983,16.118,-4,26,30
269,ZAL,P007513,P013775,4.683,0,10,10
269,ZAL,P007975,P011051,21.401,-8,40,48
269,ZAL,P007975,P011983,20.235,-13,30,43
269,ZAL,P007975,P013775,5.317,0,11,11
269,ZAL,P011051,P011983,17.835,-11,24,35
269,ZAL,P011051,P012622,0.067,0,0,0
269,ZAL,P011051,P013775,5.317,0,11,11
269,ZAL,P011983,P013775,0.567,-2,0,2
270,IST,P004887,P006590,9.117,2,18,16
270,IST,P004887,P007200,1.317,2,2,0
270,IST,P004887,P009664,1.317,2,2,0
270,IST,P004887,P009846,7.8,0,16,16
270,IST,P004887,P011078,9.117,2,18,16
270,IST,P004887,P012710,7.8,0,16,16
270,IST,P006372,P009664,1.7,0,4,4
270,IST,P006372,P012710,1.7,0,4,4
270,IST,P006372,P012742,1.7,0,4,4
270,IST,P006372,P013363,1.7,0,4,4
270,IST,P006590,P007109,7.817,-2,15,17
270,IST,P006590,P007200,8.084,4,17,13
270,IST,P006590,P009664,5.417,2,12,10
270,IST,P006590,P009846,13.267,2,29,27
270,IST,P006590,P011078,13.317,-3,23,26
270,IST,P006590,P012710,10.533,7,24,17
270,IST,P006590,P012742,0.8,3,3,0
270,IST,P006590,P012788,2.584,-3,3,6
270,IST,P007109,P007200,15.366,17,42,25
270,IST,P007109,P009664,4.1,0,10,10
270,IST,P007109,P009846,7.033,6,19,13
270,IST,P007109,P011078,7.549,4,16,12
270,IST,P007109,P012710,3.849,9,10,1
270,IST,P007109,P012742,6.616,10,20,10
270,IST,P007109,P012788,9.15,6,24,18
270,IST,P007109,P013363,6.916,10,20,10
270,IST,P007200,P009664,4.934,5,12,7
270,IST,P007200,P009846,12.417,16,34,18
270,IST,P007200,P011078,12.7,18,32,14
270,IST,P007200,P012710,10.966,17,27,10
270,IST,P007200,P012742,7.483,6,19,13
270,IST,P007200,P012788,15.017,13,39,26
270,IST,P007200,P013363,6.916,10,20,10
270,IST,P009664,P009846,5.583,-1,14,15
270,IST,P009664,P011078,1.8,-1,2,3
270,IST,P009664,P012710,3.183,-1,8,9
270,IST,P009664,P012742,3.183,-1,8,9
270,IST,P009664,P013363,3.183,-1,8,9
270,IST,P009846,P011078,17.366,11,39,28
270,IST,P009846,P012710,20.166,17,49,32
270,IST,P009846,P012742,8.599,10,22,12
270,IST,P009846,P012788,13.25,20,34,14
270,IST,P009846,P013363,2.183,3,8,5
270,IST,P011078,P012710,17.749,17,42,25
270,IST,P011078,P012742,2.666,3,5,2
270,IST,P011078,P012788,12.217,12,28,16
270,IST,P011078,P013363,2.383,5,7,2
270,IST,P012710,P012742,9.666,8,22,14
270,IST,P012710,P012788,10.6,16,27,11
270,IST,P012710,P013363,5.516,6,15,9
270,IST,P012742,P012788,10.199,13,28,15
270,IST,P012742,P013363,8.416,8,25,17
270,IST,P012788,P013363,5.983,11,21,10
270,PAR,P004761,P006591,16.999,-5,34,39
270,PAR,P004761,P006760,7.016,-10,10,20
270,PAR,P004761,P007736,6.85,-5,14,19
270,PAR,P004761,P007870,13.867,-5,22,27
270,PAR,P004761,P008232,12.9,0,26,26
270,PAR,P004761,P010781,5.85,-3,10,13
270,PAR,P004761,P011836,3.433,-1,9,10
270,PAR,P004761,P011981,2.616,-4,5,9
270,PAR,P004761,P012720,0.483,-5,0,5
270,PAR,P004761,P013369,2.917,-5,2,7
270,PAR,P004761,P013370,6.733,3,12,9
270,PAR,P006591,P006760,7.066,-11,10,21
270,PAR,P006591,P007736,6.85,-5,14,19
270,PAR,P006591,P007870,12.017,-1,22,23
270,PAR,P006591,P008232,12.9,0,26,26
270,PAR,P006591,P010781,5.1,-1,10,11
270,PAR,P006591,P011836,4.233,-4,9,13
270,PAR,P006591,P011981,4.55,-9,5,14
270,PAR,P006591,P012720,1.3,-8,0,8
270,PAR,P006591,P013369,2.167,-3,2,5
270,PAR,P006591,P013370,6.75,3,12,9
270,PAR,P006760,P007870,7.433,-12,9,21
270,PAR,P006760,P008232,3.667,-8,4,12
270,PAR,P006760,P010781,12.267,-12,16,28
270,PAR,P006760,P011836,4.933,5,12,7
270,PAR,P006760,P011981,16.583,-15,25,40
270,PAR,P006760,P012720,15.316,-19,22,41
270,PAR,P006760,P013369,19.117,-19,26,45
270,PAR,P006760,P013370,2.666,-7,2,9
270,PAR,P007736,P007870,3.417,-4,5,9
270,PAR,P007736,P008232,6.85,-5,14,19
270,PAR,P007736,P011836,3.433,-1,9,10
270,PAR,P007870,P008232,9.467,1,17,16
270,PAR,P007870,P010781,4.767,-5,7,12
270,PAR,P007870,P011981,3.084,-5,5,10
270,PAR,P007870,P012720,5.067,-10,7,17
270,PAR,P007870,P013369,9.017,-16,11,27
270,PAR,P007870,P013370,11.8,-7,19,26
270,PAR,P008232,P011836,3.433,-1,9,10
270,PAR,P008232,P011981,3.667,-8,4,12
270,PAR,P008232,P012720,3.667,-8,4,12
270,PAR,P008232,P013369,3.667,-8,4,12
270,PAR,P008232,P013370,6.05,5,12,7
270,PAR,P010781,P011981,7.5,-7,9,16
270,PAR,P010781,P012720,4.25,-6,4,10
270,PAR,P010781,P013369,9.334,-14,8,22
270,PAR,P011836,P011981,4.933,5,12,7
270,PAR,P011836,P012720,4.933,5,12,7
270,PAR,P011836,P013369,4.133,8,12,4
270,PAR,P011981,P012720,16.417,-19,25,44
270,PAR,P011981,P013369,16.234,-13,25,38
270,PAR,P011981,P013370,3.084,-5,5,10
270,PAR,P012720,P013369,17.1,-16,27,43
270,PAR,P012720,P013370,5.067,-10,7,17
270,PAR,P013369,P013370,5.05,-10,7,17
271,PRS,P004197,P005793,10.783,-2,25,27
271,PRS,P004197,P007483,2.617,-1,9,10
271,PRS,P004197,P012608,10.733,-20,20,40
271,PRS,P004197,P012610,10.533,-21,19,40
271,PRS,P004197,P012611,9.9,3,29,26
271,PRS,P004197,P012613,11.083,-24,19,43
271,PRS,P004197,P012640,15.083,1,44,43
271,PRS,P004197,P013373,11.8,-4,31,35
271,PRS,P005793,P010390,0.383,-1,0,1
271,PRS,P005793,P012608,5.25,-13,5,18
271,PRS,P005793,P012610,5.05,-14,4,18
271,PRS,P005793,P012611,6.733,7,20,13
271,PRS,P005793,P012613,3.85,-10,4,14
271,PRS,P005793,P012640,8.133,4,21,17
271,PRS,P005793,P013373,7.75,5,21,16
271,PRS,P007483,P012611,2.617,-1,9,10
271,PRS,P007483,P012640,2.617,-1,9,10
271,PRS,P007483,P013373,2.617,-1,9,10
271,PRS,P010390,P012608,18.55,19,51,32
271,PRS,P010390,P012610,18.55,19,51,32
271,PRS,P010390,P012611,10.35,13,25,12
271,PRS,P010390,P012613,18.167,20,51,31
271,PRS,P010390,P012640,8.2,6,26,20
271,PRS,P012608,P012610,29.9,-5,70,75
271,PRS,P012608,P012611,10.35,13,25,12
271,PRS,P012608,P012613,28.7,-1,70,71
271,PRS,P012608,P012640,14.2,1,41,40
271,PRS,P012608,P013373,2.717,-10,2,12
271,PRS,P012610,P012611,10.35,13,25,12
271,PRS,P012610,P012613,28.7,-1,70,71
271,PRS,P012610,P012640,14.0,0,40,40
271,PRS,P012610,P013373,2.517,-11,1,12
271,PRS,P012611,P012613,10.9,10,25,15
271,PRS,P012611,P012640,9.9,3,29,26
271,PRS,P012611,P013373,9.9,3,29,26
271,PRS,P012613,P012640,13.35,1,40,39
271,PRS,P012613,P013373,2.25,-11,1,12
271,PRS,P012640,P013373,10.917,1,30,29
271,ULK,P002849,P004004,3.95,3,12,9
271,ULK,P002849,P005216,8.067,-5,18,23
271,ULK,P002849,P006961,4.0,1,12,11
271,ULK,P002849,P008104,4.533,4,14,10
271,ULK,P002849,P008962,8.867,5,25,20
271,ULK,P002849,P009783,3.933,-7,7,14
271,ULK,P002849,P009863,12.8,-2,32,34
271,ULK,P002849,P010560,3.767,-2,8,10
271,ULK,P002849,P013696,1.283,-5,0,5
271,ULK,P002968,P004004,12.782,-10,26,36
271,ULK,P002968,P005216,2.616,2,7,5
271,ULK,P002968,P006961,12.699,-10,24,34
271,ULK,P002968,P008104,2.683,-7,4,11
271,ULK,P002968,P008962,12.782,-10,26,36
271,ULK,P002968,P009783,2.5,-1,8,9
271,ULK,P002968,P009863,1.133,-4,2,6
271,ULK,P002968,P010560,3.933,0,7,7
271,ULK,P004004,P005216,16.584,26,58,32
271,ULK,P004004,P006961,21.816,-2,54,56
271,ULK,P004004,P008104,3.416,-5,6,11
271,ULK,P004004,P008962,26.683,10,72,62
271,ULK,P004004,P009783,7.934,-3,22,25
271,ULK,P004004,P009863,13.2,7,39,32
271,ULK,P004004,P010560,10.417,6,27,21
271,ULK,P004004,P013696,0.55,0,0,0
271,ULK,P005216,P006961,10.85,18,35,17
271,ULK,P005216,P008962,20.051,27,63,36
271,ULK,P005216,P009783,6.201,-11,14,25
271,ULK,P005216,P009863,16.784,9,47,38
271,ULK,P005216,P010560,10.568,11,30,19
271,ULK,P005216,P013696,1.283,-5,0,5
271,ULK,P006961,P008104,6.483,-5,16,21
271,ULK,P006961,P008962,26.866,-1,66,67
271,ULK,P006961,P009783,3.867,-1,11,12
271,ULK,P006961,P009863,12.15,-2,30,32
271,ULK,P006961,P010560,8.183,-2,16,18
271,ULK,P006961,P013696,0.55,0,0,0
271,ULK,P008104,P008962,6.483,-5,16,21
271,ULK,P008104,P009783,0.733,2,2,0
271,ULK,P008104,P009863,4.533,4,14,10
271,ULK,P008962,P009783,6.051,-3,17,20
271,ULK,P008962,P009863,19.934,7,54,47
271,ULK,P008962,P010560,16.001,2,37,35
271,ULK,P008962,P013696,0.55,0,0,0
271,ULK,P009783,P009863,4.7,-9,9,18
271,ULK,P009783,P010560,2.184,-2,6,8
271,ULK,P009783,P013696,1.833,-5,0,5
271,ULK,P009863,P010560,8.951,-5,17,22
271,ULK,P009863,P013696,1.283,-5,0,5
272,MCO,P001932,P002581,2.267,-2,4,6
272,MCO,P001932,P004132,6.883,9,23,14
272,MCO,P001932,P005985,1.967,0,4,4
272,MCO,P001932,P008099,5.7,4,17,13
272,MCO,P001932,P011212,3.75,1,10,9
272,MCO,P001932,P011226,6.883,9,23,14
272,MCO,P001932,P011231,9.15,7,27,20
272,MCO,P002581,P005985,10.001,-2,17,19
272,MCO,P002581,P008099,10.534,-11,17,28
272,MCO,P002581,P011212,5.9,-13,6,19
272,MCO,P002581,P011226,2.2,-7,0,7
272,MCO,P002581,P011231,10.867,-10,17,27
272,MCO,P002581,P012515,6.367,-3,7,10
272,MCO,P004132,P004790,4.65,0,7,7
272,MCO,P004132,P005985,21.45,12,46,34
272,MCO,P004132,P008099,4.999,10,28,18
272,MCO,P004132,P011212,25.633,13,56,43
272,MCO,P004132,P011226,19.133,4,38,34
272,MCO,P004132,P011231,23.116,18,60,42
272,MCO,P004132,P012515,10.4,10,18,8
272,MCO,P004790,P005985,4.65,0,7,7
272,MCO,P004790,P011212,4.65,0,7,7
272,MCO,P004790,P011226,4.65,0,7,7
272,MCO,P005985,P008099,9.801,7,34,27
272,MCO,P005985,P011212,29.217,12,62,50
272,MCO,P005985,P011226,16.117,-4,23,27
272,MCO,P005985,P011231,28.234,14,64,50
272,MCO,P005985,P012515,16.534,12,27,15
272,MCO,P005985,PLCZ,3.433,1,8,7
272,MCO,P008099,P011212,6.433,-6,23,29
272,MCO,P008099,P011226,7.666,-2,15,17
272,MCO,P008099,P011231,13.533,2,45,43
272,MCO,P008099,P012515,5.334,0,9,9
272,MCO,P011212,P011226,20.166,-6,33,39
272,MCO,P011212,P011231,29.483,2,63,61
272,MCO,P011212,P012515,13.067,8,20,12
272,MCO,P011212,PLCZ,3.433,1,8,7
272,MCO,P011226,P011231,17.649,-1,37,38
272,MCO,P011226,P012515,1.167,-2,0,2
272,MCO,P011226,PLCZ,3.433,1,8,7
272,MCO,P011231,P012515,16.067,11,27,16
272,MCO,P011231,PLCZ,3.433,1,8,7
272,ZAL,P002329,P002676,10.684,-3,29,32
272,ZAL,P002329,P003048,10.567,-6,31,37
272,ZAL,P002329,P005504,3.05,-1,3,4
272,ZAL,P002329,P007029,7.9,0,19,19
272,ZAL,P002329,P007513,9.367,-10,20,30
272,ZAL,P002329,P007975,15.05,-1,46,47
272,ZAL,P002329,P011051,10.35,1,24,23
272,ZAL,P002329,P011983,18.851,-7,34,41
272,ZAL,P002329,P013775,10.049,3,26,23
272,ZAL,P002676,P003048,14.567,-7,24,31
272,ZAL,P002676,P005504,8.667,4,13,9
272,ZAL,P002676,P007513,17.001,-10,22,32
272,ZAL,P002676,P007975,23.218,2,46,44
272,ZAL,P002676,P011051,21.335,5,32,27
272,ZAL,P002676,P011983,15.668,-5,24,29
272,ZAL,P002676,P013775,0.6,6,6,0
272,ZAL,P003048,P007029,10.3,-3,25,28
272,ZAL,P003048,P007513,16.9,-8,27,35
272,ZAL,P003048,P007975,16.867,-5,37,42
272,ZAL,P003048,P011051,11.167,4,13,9
272,ZAL,P003048,P011983,13.784,-9,26,35
272,ZAL,P003048,P012715,3.383,-8,5,13
272,ZAL,P003048,P013775,2.933,2,8,6
272,ZAL,P005504,P007029,0.25,-2,0,2
272,ZAL,P005504,P007513,1.367,1,1,0
272,ZAL,P005504,P007975,8.25,2,13,11
272,ZAL,P005504,P011051,5.867,3,10,7
272,ZAL,P005504,P011983,7.967,3,12,9
272,ZAL,P005504,P013775,0.25,-2,0,2
272,ZAL,P007029,P007513,4.2,-1,9,10
272,ZAL,P007029,P007975,7.483,-4,18,22
272,ZAL,P007029,P011051,1.533,3,5,2
272,ZAL,P007029,P011983,7.617,-5,17,22
272,ZAL,P007029,P012715,3.383,-8,5,13
272,ZAL,P007029,P013775,4.066,0,10,10
272,ZAL,P007513,P007975,12.534,-6,19,25
272,ZAL,P007513,P011051,14.651,-2,14,16
272,ZAL,P007513,P011983,7.301,-7,7,14
272,ZAL,P007513,P013775,2.483,-1,5,6
272,ZAL,P007975,P011051,28.001,5,47,42
272,ZAL,P007975,P011983,21.734,-9,44,53
272,ZAL,P007975,P012715,3.383,-8,5,13
272,ZAL,P007975,P013775,7.816,4,21,17
272,ZAL,P011051,P011983,12.234,-2,25,27
272,ZAL,P011051,P013775,6.866,3,18,15
272,ZAL,P011983,P012715,3.383,-8,5,13
272,ZAL,P011983,P013775,5.133,-3,10,13
273,BAR,P002939,P003196,15.75,8,41,33
273,BAR,P002939,P003478,9.483,-3,19,22
273,BAR,P002939,P007464,16.116,-2,39,41
273,BAR,P002939,P009862,16.017,-9,35,44
273,BAR,P002939,P009992,7.516,4,22,18
273,BAR,P002939,P012745,14.85,-12,34,46
273,BAR,P002939,P012795,6.517,-2,20,22
273,BAR,P002939,P013379,7.883,-4,18,22
273,BAR,P003196,P003478,8.367,11,23,12
273,BAR,P003196,P007464,17.85,11,50,39
273,BAR,P003196,P009862,21.551,13,58,45
273,BAR,P003196,P009992,16.601,11,49,38
273,BAR,P003196,P012745,17.751,1,45,44
273,BAR,P003196,P012795,7.584,5,25,20
273,BAR,P003196,P013379,2.35,4,5,1
273,BAR,P003478,P007464,6.799,5,20,15
273,BAR,P003478,P009862,6.551,6,17,11
273,BAR,P003478,P009992,11.132,4,31,27
273,BAR,P003478,P012745,6.717,-7,13,20
273,BAR,P003478,P012795,3.466,-3,9,12
273,BAR,P003478,P013379,8.749,-5,20,25
273,BAR,P007464,P009862,16.5,2,39,37
273,BAR,P007464,P009992,14.283,9,40,31
273,BAR,P007464,P012745,14.5,-6,31,37
273,BAR,P007464,P012795,7.5,-2,19,21
273,BAR,P007464,P013379,2.716,-1,6,7
273,BAR,P009862,P009992,13.001,7,35,28
273,BAR,P009862,P012745,25.218,-14,57,71
273,BAR,P009862,P012795,11.467,-8,27,35
273,BAR,P009862,P013379,5.767,-5,12,17
273,BAR,P009992,P012745,14.967,-2,36,38
273,BAR,P009992,P012795,12.85,1,36,35
273,BAR,P009992,P013379,5.582,-2,15,17
273,BAR,P012745,P012795,13.7,-10,32,42
273,BAR,P012745,P013379,6.833,-10,16,26
273,BAR,P012795,P013379,5.516,-5,16,21
273,MUN,P001288,P001557,6.333,-3,11,14
273,MUN,P001288,P004508,4.083,-9,4,13
273,MUN,P001288,P005460,20.116,21,61,40
273,MUN,P001288,P007201,20.349,12,58,46
273,MUN,P001288,P007639,5.183,-11,6,17
273,MUN,P001288,P010391,24.649,14,67,53
273,MUN,P001288,P011224,6.016,-10,7,17
273,MUN,P001288,P011987,25.399,6,66,60
273,MUN,P001557,P004508,10.266,2,32,30
273,MUN,P001557,P005460,2.5,4,6,2
273,MUN,P001557,P007201,2.733,-5,3,8
273,MUN,P001557,P007639,11.366,0,34,34
273,MUN,P001557,P010391,7.333,1,16,15
273,MUN,P001557,P011224,11.366,0,34,34
273,MUN,P001557,P011987,12.266,-3,29,32
273,MUN,P001557,P012123,2.233,0,7,7
273,MUN,P004508,P005460,1.7,-6,0,6
273,MUN,P004508,P007201,1.7,-6,0,6
273,MUN,P004508,P007639,14.349,-7,36,43
273,MUN,P004508,P010391,5.933,-3,11,14
273,MUN,P004508,P011224,16.049,-13,36,49
273,MUN,P004508,P011987,7.883,-10,18,28
273,MUN,P004508,P012123,2.233,0,7,7
273,MUN,P005460,P007201,19.316,11,55,44
273,MUN,P005460,P010391,20.483,16,60,44
273,MUN,P005460,P011224,2.533,-5,1,6
273,MUN,P005460,P011987,20.616,19,61,42
273,MUN,P007201,P010391,20.716,7,57,50
273,MUN,P007201,P011224,2.533,-5,1,6
273,MUN,P007201,P011987,20.849,10,58,48
273,MUN,P007639,P010391,4.733,1,11,10
273,MUN,P007639,P011224,15.449,-9,38,47
273,MUN,P007639,P011987,8.483,-10,20,30
273,MUN,P007639,P012123,2.233,0,7,7
273,MUN,P010391,P011224,5.933,-3,11,14
273,MUN,P010391,P011987,22.016,15,63,48
273,MUN,P011224,P011987,9.816,-11,21,32
273,MUN,P011224,P012123,2.233,0,7,7
274,ASV,P000229,P002100,0.633,-1,0,1
274,ASV,P000229,P003526,4.116,4,15,11
274,ASV,P000229,P007027,6.316,3,17,14
274,ASV,P000229,P008991,4.55,9,14,5
274,ASV,P000229,P009818,3.683,6,9,3
274,ASV,P000229,P010316,2.2,-1,2,3
274,ASV,P000229,P010545,1.766,-6,3,9
274,ASV,P000229,P013371,1.9,1,8,7
274,ASV,P000229,P013405,0.1,-3,0,3
274,ASV,P002100,P003526,8.884,12,25,13
274,ASV,P002100,P007027,11.2,6,25,19
274,ASV,P002100,P008991,4.567,-4,3,7
274,ASV,P002100,P009818,3.067,-3,3,6
274,ASV,P002100,P010316,10.768,2,17,15
274,ASV,P002100,P010545,13.717,10,31,21
274,ASV,P002100,P011225,5.834,3,10,7
274,ASV,P002100,P013371,1.934,1,3,2
274,ASV,P002100,P013405,15.268,14,35,21
274,ASV,P003526,P007027,23.35,17,58,41
274,ASV,P003526,P008991,2.467,7,12,5
274,ASV,P003526,P009818,1.583,4,7,3
274,ASV,P003526,P010316,2.318,0,4,4
274,ASV,P003526,P010545,20.9,10,46,36
274,ASV,P003526,P011225,3.218,0,6,6
274,ASV,P003526,P013371,14.301,1,28,27
274,ASV,P003526,P013405,21.535,13,47,34
274,ASV,P007027,P008991,7.15,4,18,14
274,ASV,P007027,P009818,4.233,4,9,5
274,ASV,P007027,P010316,7.25,-6,10,16
274,ASV,P007027,P010545,23.45,7,50,43
274,ASV,P007027,P011225,2.967,-3,6,9
274,ASV,P007027,P013371,12.65,5,28,23
274,ASV,P007027,P013405,23.834,7,51,44
274,ASV,P008991,P009818,5.6,2,9,7
274,ASV,P008991,P010316,8.734,-5,9,14
274,ASV,P008991,P011225,6.084,-5,7,12
274,ASV,P008991,P013371,0.884,3,5,2
274,ASV,P008991,P013405,4.7,-3,7,10
274,ASV,P009818,P010316,5.167,-1,5,6
274,ASV,P009818,P010545,1.15,1,3,2
274,ASV,P009818,P011225,2.517,-1,3,4
274,ASV,P010316,P010545,5.617,-1,10,11
274,ASV,P010316,P011225,9.518,-4,14,18
274,ASV,P010316,P013371,3.568,-3,3,6
274,ASV,P010316,P013405,11.468,-5,18,23
274,ASV,P010545,P011225,2.067,1,5,4
274,ASV,P010545,P013371,13.7,3,26,23
274,ASV,P010545,P013405,23.701,11,50,39
274,ASV,P011225,P013371,1.634,-4,0,4
274,ASV,P011225,P013405,7.901,-3,13,16
274,ASV,P013371,P013405,14.301,1,23,22
274,OLY,P001255,P003469,18.801,-4,27,31
274,OLY,P001255,P007853,3.917,-4,6,10
274,OLY,P001255,P007982,15.134,-8,22,30
274,OLY,P001255,P008811,16.734,-6,23,29
274,OLY,P001255,P008829,1.967,-2,4,6
274,OLY,P001255,P009849,1.2,-2,2,4
274,OLY,P001255,P012878,1.3,2,2,0
274,OLY,P001255,P013380,16.084,-2,23,25
274,OLY,P001255,P013389,4.867,2,7,5
274,OLY,P003469,P007853,5.917,1,11,10
274,OLY,P003469,P007982,18.751,-15,27,42
274,OLY,P003469,P008811,20.717,-9,32,41
274,OLY,P003469,P008829,9.984,1,18,17
274,OLY,P003469,P009849,5.183,4,11,7
274,OLY,P003469,P012878,3.067,0,2,2
274,OLY,P003469,P013380,27.517,-2,48,50
274,OLY,P003469,P013389,18.067,0,32,32
274,OLY,P007853,P007982,4.917,-6,9,15
274,OLY,P007853,P008811,3.283,0,6,6
274,OLY,P007853,P008829,5.751,-5,10,15
274,OLY,P007853,P009849,3.117,-6,5,11
274,OLY,P007853,P012878,3.684,-6,3,9
274,OLY,P007853,P013380,1.433,5,7,2
274,OLY,P007853,P013389,4.117,1,7,6
274,OLY,P007982,P008811,15.484,-8,23,31
274,OLY,P007982,P008829,5.467,-11,9,20
274,OLY,P007982,P009849,2.2,-4,5,9
274,OLY,P007982,P012878,1.0,-2,3,5
274,OLY,P007982,P013380,16.034,-13,23,36
274,OLY,P007982,P013389,4.817,-9,7,16
274,OLY,P008811,P008829,4.017,4,11,7
274,OLY,P008811,P009849,4.35,1,11,10
274,OLY,P008811,P013380,22.784,-3,41,44
274,OLY,P008811,P013389,11.567,1,25,24
274,OLY,P008829,P009849,12.851,2,29,27
274,OLY,P008829,P012878,4.551,-9,5,14
274,OLY,P008829,P013380,12.334,4,29,25
274,OLY,P008829,P013389,15.018,0,29,29
274,OLY,P009849,P012878,2.784,-7,5,12
274,OLY,P009849,P013380,10.067,5,24,19
274,OLY,P009849,P013389,10.984,3,24,21
274,OLY,P012878,P013380,2.167,-1,4,5
274,OLY,P012878,P013389,4.851,-5,4,9
274,OLY,P013380,P013389,21.184,3,45,42
275,BER,P006251,P007025,1.983,0,3,3
275,BER,P006251,P008173,8.516,-6,11,17
275,BER,P006251,P008211,1.7,1,3,2
275,BER,P006251,P008384,19.116,-1,35,36
275,BER,P006251,P008780,14.95,3,30,27
275,BER,P006251,P008967,14.566,-6,27,33
275,BER,P006251,P011631,1.25,1,2,1
275,BER,P006251,P011934,6.133,9,18,9
275,BER,P006251,P012721,9.567,0,14,14
275,BER,P006251,P013386,7.4,-5,4,9
275,BER,P006251,P013774,8.683,-8,17,25
275,BER,P007025,P008173,4.549,-4,5,9
275,BER,P007025,P008967,4.549,-4,5,9
275,BER,P007025,P011631,1.25,1,2,1
275,BER,P007025,P011934,1.233,1,2,1
275,BER,P007025,P013386,2.066,-6,1,7
275,BER,P007025,P013774,2.566,-4,2,6
275,BER,P008173,P008211,1.417,-2,3,5
275,BER,P008173,P008384,6.616,-8,5,13
275,BER,P008173,P008780,1.784,4,7,3
275,BER,P008173,P008967,15.866,-10,23,33
275,BER,P008173,P011631,1.25,1,2,1
275,BER,P008173,P011934,5.916,-5,8,13
275,BER,P008173,P012721,3.3,-2,3,5
275,BER,P008173,P013386,5.45,-2,8,10
275,BER,P008173,P013774,8.8,-6,17,23
275,BER,P008211,P008384,1.4,5,5,0
275,BER,P008211,P008780,7.633,-3,13,16
275,BER,P008211,P008967,1.417,-2,3,5
275,BER,P008211,P011631,3.083,0,6,6
275,BER,P008211,P011934,5.0,1,12,11
275,BER,P008211,P012721,6.583,-6,10,16
275,BER,P008211,P013386,4.05,-6,4,10
275,BER,P008211,P013774,3.917,-8,5,13
275,BER,P008384,P008780,18.117,4,40,36
275,BER,P008384,P008967,15.916,-11,29,40
275,BER,P008384,P011631,1.2,-5,0,5
275,BER,P008384,P011934,9.766,9,26,17
275,BER,P008384,P012721,9.133,2,13,11
275,BER,P008384,P013386,5.4,0,5,5
275,BER,P008384,P013774,11.4,-11,22,33
275,BER,P008780,P008967,11.084,1,31,30
275,BER,P008780,P011631,4.283,-5,6,11
275,BER,P008780,P011934,9.583,13,29,16
275,BER,P008780,P012721,13.783,-4,21,25
275,BER,P008780,P013386,9.267,-4,14,18
275,BER,P008780,P013774,13.184,-9,29,38
275,BER,P008967,P011631,2.45,-4,2,6
275,BER,P008967,P011934,8.916,1,20,19
275,BER,P008967,P012721,3.3,-2,3,5
275,BER,P008967,P013386,5.75,-5,8,13
275,BER,P008967,P013774,16.85,-10,37,47
275,BER,P011631,P011934,3.083,0,6,6
275,BER,P011631,P012721,3.083,0,6,6
275,BER,P011631,P013774,1.2,-5,0,5
275,BER,P011934,P012721,7.666,2,14,12
275,BER,P011934,P013774,4.7,1,13,12
275,BER,P012721,P013386,7.817,-5,7,12
275,BER,P012721,P013774,4.1,-9,5,14
275,BER,P013386,P013774,5.4,-7,9,16
275,PAR,P004761,P006591,8.467,-1,13,14
275,PAR,P004761,P006760,14.85,17,43,26
275,PAR,P004761,P007870,16.05,16,43,27
275,PAR,P004761,P010781,8.417,1,15,14
275,PAR,P004761,P011050,8.617,6,17,11
275,PAR,P004761,P011836,11.917,3,18,15
275,PAR,P004761,P011981,3.233,-3,3,6
275,PAR,P004761,P012720,22.083,21,56,35
275,PAR,P004761,P013369,17.966,16,44,28
275,PAR,P006591,P006760,2.35,-2,3,5
275,PAR,P006591,P007870,2.65,1,6,5
275,PAR,P006591,P010781,8.134,-1,13,14
275,PAR,P006591,P011050,5.817,-2,7,9
275,PAR,P006591,P011836,5.817,-2,7,9
275,PAR,P006591,P011981,2.35,-2,3,5
275,PAR,P006591,P012720,5.0,-1,9,10
275,PAR,P006591,P013369,2.683,-2,3,5
275,PAR,P006760,P007870,15.1,15,41,26
275,PAR,P006760,P010781,8.167,3,17,14
275,PAR,P006760,P011050,8.25,3,21,18
275,PAR,P006760,P011836,11.55,1,25,24
275,PAR,P006760,P011981,3.6,-6,3,9
275,PAR,P006760,P012720,23.7,11,56,45
275,PAR,P006760,P013369,20.233,6,51,45
275,PAR,P007870,P010781,6.683,5,16,11
275,PAR,P007870,P011836,7.983,6,16,10
275,PAR,P007870,P012720,20.133,18,51,33
275,PAR,P007870,P013369,11.933,11,31,20
275,PAR,P010781,P011050,9.684,-1,16,17
275,PAR,P010781,P011836,13.984,1,24,23
275,PAR,P010781,P011981,0.217,0,0,0
275,PAR,P010781,P012720,7.517,5,16,11
275,PAR,P010781,P013369,3.533,3,11,8
275,PAR,P011050,P011836,11.267,-7,18,25
275,PAR,P011050,P012720,5.0,2,12,10
275,PAR,P011050,P013369,7.633,3,21,18
275,PAR,P011836,P011981,2.417,1,3,2
275,PAR,P011836,P012720,12.6,1,21,20
275,PAR,P011836,P013369,9.133,-4,16,20
275,PAR,P011981,P012720,5.8,-5,6,11
275,PAR,P011981,P013369,5.583,-5,6,11
275,PAR,P012720,P013369,21.899,8,49,41
276,MAD,P003108,P003733,2.534,-6,3,9
276,MAD,P003108,P005791,6.151,-3,14,17
276,MAD,P003108,P005928,7.885,1,17,16
276,MAD,P003108,P006540,24.251,1,56,55
276,MAD,P003108,P007630,5.1,4,17,13
276,MAD,P003108,P009005,0.534,-2,3,5
276,MAD,P003108,P011247,16.833,-5,39,44
276,MAD,P003108,P011649,2.233,2,4,2
276,MAD,P003108,P013667,13.4,-8,22,30
276,MAD,P003108,PTGB,19.951,0,49,49
276,MAD,P003733,P005791,12.317,0,26,26
276,MAD,P003733,P005928,12.317,0,26,26
276,MAD,P003733,P006540,3.85,-2,5,7
276,MAD,P003733,P007630,8.05,4,21,17
276,MAD,P003733,P009005,8.467,2,21,19
276,MAD,P003733,PTGB,1.733,2,2,0
276,MAD,P005791,P005928,18.851,11,49,38
276,MAD,P005791,P006540,8.567,2,20,18
276,MAD,P005791,P007630,11.7,7,33,26
276,MAD,P005791,P009005,12.4,7,35,28
276,MAD,P005791,P011247,2.65,-5,6,11
276,MAD,P005791,P011649,3.65,3,12,9
276,MAD,P005791,PTGB,6.45,6,17,11
276,MAD,P005928,P006540,10.018,4,21,17
276,MAD,P005928,P007630,11.7,7,33,26
276,MAD,P005928,P009005,12.184,8,36,28
276,MAD,P005928,P011247,0.817,-1,2,3
276,MAD,P005928,P011649,5.5,3,14,11
276,MAD,P005928,P013667,3.217,-5,2,7
276,MAD,P005928,PTGB,6.051,8,16,8
276,MAD,P006540,P007630,5.15,1,17,16
276,MAD,P006540,P009005,1.1,6,6,0
276,MAD,P006540,P011247,18.683,-3,44,47
276,MAD,P006540,P011649,2.233,2,4,2
276,MAD,P006540,P013667,14.15,-7,23,30
276,MAD,P006540,PTGB,23.534,4,56,52
276,MAD,P007630,P009005,11.65,10,33,23
276,MAD,P007630,P011247,5.1,4,17,13
276,MAD,P007630,P011649,3.65,3,12,9
276,MAD,P007630,PTGB,5.1,4,17,13
276,MAD,P009005,P011247,1.033,3,3,0
276,MAD,P009005,P011649,3.65,3,12,9
276,MAD,P009005,P013667,0.75,1,1,0
276,MAD,P009005,PTGB,1.1,6,6,0
276,MAD,P011247,P011649,0.383,2,2,0
276,MAD,P011247,P013667,10.933,-2,21,23
276,MAD,P011247,PTGB,18.3,-5,42,47
276,MAD,P011649,P013667,2.233,2,4,2
276,MAD,P013667,PTGB,11.917,-9,19,28
276,MIL,P000796,P001392,14.366,7,41,34
276,MIL,P000796,P006085,3.983,-1,7,8
276,MIL,P000796,P006509,0.067,3,3,0
276,MIL,P000796,P006721,2.417,1,4,3
276,MIL,P000796,P007831,23.367,-4,54,58
276,MIL,P000796,P008985,7.267,-5,12,17
276,MIL,P000796,P008987,18.633,-4,44,48
276,MIL,P000796,P011064,19.85,-4,46,50
276,MIL,P000796,P011941,2.8,-2,5,7
276,MIL,P000796,P013384,2.85,1,8,7
276,MIL,P001392,P001518,4.7,-5,7,12
276,MIL,P001392,P006085,6.05,-7,9,16
276,MIL,P001392,P006509,1.067,0,0,0
276,MIL,P001392,P006721,7.167,-4,12,16
276,MIL,P001392,P007831,15.017,5,42,37
276,MIL,P001392,P008985,7.184,-10,9,19
276,MIL,P001392,P008987,15.834,1,42,41
276,MIL,P001392,P011064,15.017,5,42,37
276,MIL,P001392,P011941,1.067,0,0,0
276,MIL,P001392,P013384,1.067,0,0,0
276,MIL,P001518,P006085,4.7,-5,7,12
276,MIL,P001518,P006509,3.767,7,11,4
276,MIL,P001518,P006721,4.7,-5,7,12
276,MIL,P001518,P008985,8.467,2,18,16
276,MIL,P001518,P008987,0.817,0,0,0
276,MIL,P001518,P011941,2.95,7,11,4
276,MIL,P001518,P013384,3.767,7,11,4
276,MIL,P006085,P006721,9.284,-9,13,22
276,MIL,P006085,P007831,4.817,-4,7,11
276,MIL,P006085,P008985,9.284,-9,13,22
276,MIL,P006085,P008987,2.184,-5,2,7
276,MIL,P006085,P011941,1.583,-2,3,5
276,MIL,P006085,P013384,1.583,-2,3,5
276,MIL,P006509,P006721,0.017,0,0,0
276,MIL,P006509,P007831,0.717,1,3,2
276,MIL,P006509,P008985,5.551,8,14,6
276,MIL,P006509,P008987,0.817,0,0,0
276,MIL,P006509,P011941,4.667,5,11,6
276,MIL,P006509,P013384,5.534,8,14,6
276,MIL,P006721,P007831,6.918,1,17,16
276,MIL,P006721,P008985,9.301,-9,13,22
276,MIL,P006721,P008987,5.851,-2,15,17
276,MIL,P006721,P011064,3.667,3,13,10
276,MIL,P006721,P013384,2.55,0,10,10
276,MIL,P007831,P008985,8.818,-13,12,25
276,MIL,P007831,P008987,23.734,-5,59,64
276,MIL,P007831,P011064,23.584,-4,59,63
276,MIL,P007831,P011941,3.45,-4,5,9
276,MIL,P007831,P013384,6.05,-1,18,19
276,MIL,P008985,P008987,7.868,-17,7,24
276,MIL,P008985,P011064,4.867,-12,5,17
276,MIL,P008985,P011941,4.667,5,11,6
276,MIL,P008985,P013384,5.534,8,14,6
276,MIL,P008987,P011064,22.367,-4,57,61
276,MIL,P008987,P013384,3.367,0,10,10
276,MIL,P011064,P011941,1.217,0,2,2
276,MIL,P011064,P013384,3.767,0,12,12
276,MIL,P011941,P013384,7.467,3,16,13
277,BAS,P004058,P007230,13.033,0,26,26
277,BAS,P004058,P007579,4.05,1,10,9
277,BAS,P004058,P008072,11.6,-1,21,22
277,BAS,P004058,P011085,8.717,-9,13,22
277,BAS,P004058,P011196,3.717,-6,4,10
277,BAS,P004058,P011948,5.717,4,14,10
277,BAS,P004058,P012080,14.567,-1,28,29
277,BAS,P004058,P012201,6.334,-6,9,15
277,BAS,P004058,P013367,9.733,-6,15,21
277,BAS,P007230,P007579,4.05,1,10,9
277,BAS,P007230,P008072,17.3,0,36,36
277,BAS,P007230,P011085,2.383,-3,4,7
277,BAS,P007230,P011196,0.983,-3,0,3
277,BAS,P007230,P011948,15.183,-1,33,34
277,BAS,P007230,P012080,21.3,6,48,42
277,BAS,P007230,P012201,4.416,-9,4,13
277,BAS,P007230,P013367,21.816,-11,39,50
277,BAS,P007579,P011085,2.383,-3,4,7
277,BAS,P007579,P012080,1.867,6,8,2
277,BAS,P007579,P013367,3.85,-1,8,9
277,BAS,P008072,P011085,2.617,0,5,5
277,BAS,P008072,P011948,15.567,3,34,31
277,BAS,P008072,P012080,18.183,1,36,35
277,BAS,P008072,P012201,4.8,-5,5,10
277,BAS,P008072,P013367,15.733,-6,27,33
277,BAS,P011085,P011196,9.4,-9,17,26
277,BAS,P011085,P011948,8.3,-3,18,21
277,BAS,P011085,P012080,3.917,-4,6,10
277,BAS,P011085,P012201,12.017,-9,22,31
277,BAS,P011085,P013367,7.866,-8,15,23
277,BAS,P011196,P011948,7.999,-6,17,23
277,BAS,P011196,P012080,5.05,-6,8,14
277,BAS,P011196,P012201,11.716,-12,21,33
277,BAS,P011196,P013367,7.999,-6,17,23
277,BAS,P011948,P012080,16.416,3,37,34
277,BAS,P011948,P012201,15.582,-14,26,40
277,BAS,P011948,P013367,20.632,-10,41,51
277,BAS,P012080,P012201,9.366,-11,12,23
277,BAS,P012080,P013367,20.866,-2,41,43
277,BAS,P012201,P013367,12.965,-14,21,35
277,IST,P004887,P006590,16.633,17,53,36
277,IST,P004887,P007109,8.733,9,27,18
277,IST,P004887,P007200,10.667,4,27,23
277,IST,P004887,P009664,3.25,3,10,7
277,IST,P004887,P009846,7.9,8,26,18
277,IST,P004887,P011078,9.834,3,26,23
277,IST,P004887,P012710,6.584,0,16,16
277,IST,P004887,P012742,8.733,9,27,18
277,IST,P004887,P013363,1.934,-5,0,5
277,IST,P006590,P007109,10.166,9,31,22
277,IST,P006590,P007200,8.833,9,27,18
277,IST,P006590,P009664,3.2,3,10,7
277,IST,P006590,P009846,15.0,2,35,33
277,IST,P006590,P011078,14.9,2,35,33
277,IST,P006590,P012710,10.367,-1,21,22
277,IST,P006590,P012742,8.733,9,27,18
277,IST,P006590,P012788,7.1,-6,9,15
277,IST,P007109,P007200,20.999,19,53,34
277,IST,P007109,P009846,11.515,12,26,14
277,IST,P007109,P011078,7.066,6,20,14
277,IST,P007109,P012710,5.633,3,13,10
277,IST,P007109,P012742,17.032,13,41,28
277,IST,P007109,P012788,8.899,7,19,12
277,IST,P007109,P013363,3.017,-2,6,8
277,IST,P007200,P009664,1.017,-3,0,3
277,IST,P007200,P009846,10.482,12,22,10
277,IST,P007200,P011078,7.967,1,16,15
277,IST,P007200,P012710,7.783,1,15,14
277,IST,P007200,P012742,16.099,13,39,26
277,IST,P007200,P012788,7.866,7,15,8
277,IST,P007200,P013363,4.951,-7,6,13
277,IST,P009664,P009846,3.2,3,10,7
277,IST,P009664,P011078,4.217,0,10,10
277,IST,P009664,P012788,0.967,-3,0,3
277,IST,P009664,P013363,1.017,-3,0,3
277,IST,P009846,P011078,18.849,10,47,37
277,IST,P009846,P012710,14.216,4,30,26
277,IST,P009846,P012742,8.299,4,14,10
277,IST,P009846,P012788,15.799,1,26,25
277,IST,P011078,P012710,16.367,-2,32,34
277,IST,P011078,P012742,0.933,0,2,2
277,IST,P011078,P012788,10.116,-1,18,19
277,IST,P011078,P013363,4.951,-7,6,13
277,IST,P012710,P012742,1.783,2,4,2
277,IST,P012710,P012788,5.933,-3,7,10
277,IST,P012710,P013363,3.934,-4,6,10
277,IST,P012742,P012788,6.516,2,10,8
278,RED,P000848,P004866,4.033,0,6,6
278,RED,P000848,P006436,10.05,7,21,14
278,RED,P000848,P007960,3.184,9,13,4
278,RED,P000848,P009048,4.95,1,8,7
278,RED,P000848,P010588,6.15,-8,7,15
278,RED,P000848,P010612,4.151,4,13,9
278,RED,P000848,P011194,11.484,20,31,11
278,RED,P000848,P012044,10.484,13,28,15
278,RED,P000848,PJDR,7.25,10,17,7
278,RED,P004007,P004866,9.4,14,22,8
278,RED,P004007,P007960,6.366,2,11,9
278,RED,P004007,P009048,10.983,12,24,12
278,RED,P004007,P010588,5.267,8,13,5
278,RED,P004007,P010612,1.583,-2,2,4
278,RED,P004007,P011194,10.333,14,24,10
278,RED,P004866,P006436,5.8,1,13,12
278,RED,P004866,P007960,7.717,5,18,13
278,RED,P004866,P009048,16.683,11,35,24
278,RED,P004866,P010588,6.567,8,15,7
278,RED,P004866,P010612,0.817,0,2,2
278,RED,P004866,P011194,15.033,12,30,18
278,RED,P004866,P012044,1.284,2,4,2
278,RED,P004866,PJDR,4.534,-1,11,12
278,RED,P006436,P007960,2.117,1,7,6
278,RED,P006436,P009048,5.333,-1,11,12
278,RED,P006436,P010588,8.217,-5,10,15
278,RED,P006436,P010612,4.984,-4,5,9
278,RED,P006436,P011194,7.7,11,18,7
278,RED,P006436,P012044,12.701,8,24,16
278,RED,P006436,PJDR,10.967,9,26,17
278,RED,P006436,PLUO,4.267,1,5,4
278,RED,P007960,P009048,10.083,6,22,16
278,RED,P007960,P010588,5.433,8,12,4
278,RED,P007960,P010612,10.367,17,29,12
278,RED,P007960,P011194,8.9,13,24,11
278,RED,P007960,P012044,7.184,16,23,7
278,RED,P007960,PJDR,6.317,7,17,10
278,RED,P007960,PLUO,1.4,4,4,0
278,RED,P009048,P010588,8.867,10,19,9
278,RED,P009048,P010612,3.9,3,8,5
278,RED,P009048,P011194,16.883,13,34,21
278,RED,P009048,PJDR,3.25,-3,7,10
278,RED,P009048,PLUO,1.4,4,4,0
278,RED,P010588,P010612,10.667,4,17,13
278,RED,P010588,P011194,6.817,8,15,7
278,RED,P010588,P012044,11.6,1,18,17
278,RED,P010588,PJDR,6.616,5,13,8
278,RED,P010588,PLUO,5.667,5,9,4
278,RED,P010612,P011194,4.367,9,15,6
278,RED,P010612,P012044,11.701,10,26,16
278,RED,P010612,PJDR,4.2,6,10,4
278,RED,P010612,PLUO,5.667,5,9,4
278,RED,P011194,P012044,6.534,19,23,4
278,RED,P011194,PJDR,5.617,9,14,5
278,RED,P012044,PJDR,11.917,18,29,11
278,RED,P012044,PLUO,4.267,1,5,4
278,VIR,P001133,P001844,9.5,-12,13,25
278,VIR,P001133,P002084,11.883,-5,17,22
278,VIR,P001133,P004554,2.55,-8,1,9
278,VIR,P001133,P004888,20.382,-13,30,43
278,VIR,P001133,P006739,14.799,-3,21,24
278,VIR,P001133,P009549,16.717,-16,21,37
278,VIR,P001133,P011816,5.533,-8,6,14
278,VIR,P001133,P012585,7.316,-6,8,14
278,VIR,P001133,P013695,5.333,2,10,8
278,VIR,P001133,PBCN,7.183,-7,9,16
278,VIR,P001844,P002084,4.9,-2,10,12
278,VIR,P001844,P004554,2.55,-8,1,9
278,VIR,P001844,P004888,11.45,-20,14,34
278,VIR,P001844,P006739,5.801,-9,5,14
278,VIR,P001844,P009549,10.267,-12,14,26
278,VIR,P001844,P011816,3.75,-3,6,9
278,VIR,P001844,P012585,4.317,-9,4,13
278,VIR,P001844,P013695,5.801,-9,5,14
278,VIR,P002084,P004888,13.35,-9,17,26
278,VIR,P002084,P006739,6.733,-3,7,10
278,VIR,P002084,P009549,11.3,-6,16,22
278,VIR,P002084,P011816,1.467,-4,0,4
278,VIR,P002084,P012585,3.767,-7,1,8
278,VIR,P004554,P004888,2.55,-8,1,9
278,VIR,P004554,P009549,2.55,-8,1,9
278,VIR,P004888,P006739,15.733,-15,21,36
278,VIR,P004888,P009549,15.95,-16,20,36
278,VIR,P004888,P011816,4.517,-12,5,17
278,VIR,P004888,P012585,9.017,-18,9,27
278,VIR,P004888,P013695,9.0,-12,14,26
278,VIR,P004888,PBCN,2.983,-1,5,6
278,VIR,P006739,P009549,13.417,2,19,17
278,VIR,P006739,P011816,16.234,-15,21,36
278,VIR,P006739,P012585,13.1,-21,15,36
278,VIR,P006739,P013695,18.567,-11,28,39
278,VIR,P006739,PBCN,13.616,-5,19,24
278,VIR,P009549,P011816,8.583,0,14,14
278,VIR,P009549,P012585,1.717,-4,0,4
278,VIR,P009549,P013695,7.917,2,11,9
278,VIR,P009549,PBCN,7.25,2,12,10
278,VIR,P011816,P012585,8.984,-17,9,26
278,VIR,P011816,P013695,10.567,-5,17,22
278,VIR,P011816,PBCN,10.633,-4,14,18
278,VIR,P012585,P013695,7.667,-12,12,24
278,VIR,P012585,PBCN,3.383,-6,2,8
278,VIR,P013695,PBCN,9.416,1,15,14
279,PAN,P001926,P007866,5.616,0,11,11
279,PAN,P001926,P011204,16.267,-8,33,41
279,PAN,P001926,P011209,3.95,-4,7,11
279,PAN,P001926,P011442,5.517,-2,18,20
279,PAN,P001926,P012712,11.2,-8,15,23
279,PAN,P001926,P012774,16.683,-4,36,40
279,PAN,P001926,P013383,9.9,-4,25,29
279,PAN,P001926,PLHK,4.667,-2,7,9
279,PAN,P007866,P009622,15.05,22,48,26
279,PAN,P007866,P011204,12.633,16,37,21
279,PAN,P007866,P011209,8.033,6,22,16
279,PAN,P007866,P012712,12.633,16,37,21
279,PAN,P007866,P012774,20.666,22,59,37
279,PAN,P007866,P013383,8.033,6,22,16
279,PAN,P009622,P011204,10.95,15,37,22
279,PAN,P009622,P011209,10.167,3,24,21
279,PAN,P009622,P012712,14.817,14,44,30
279,PAN,P009622,P012774,21.117,18,61,43
279,PAN,P009622,P013383,10.584,3,24,21
279,PAN,P009622,PLHK,1.783,-3,6,9
279,PAN,P011204,P011209,2.2,-7,2,9
279,PAN,P011204,P011442,5.9,-3,18,21
279,PAN,P011204,P012712,21.75,7,52,45
279,PAN,P011204,P012774,25.883,8,68,60
279,PAN,P011204,P013383,8.567,-7,20,27
279,PAN,P011204,PLHK,6.45,-5,13,18
279,PAN,P011209,P011442,2.15,-6,2,8
279,PAN,P011209,P012712,4.367,-4,7,11
279,PAN,P011209,P012774,12.783,0,29,29
279,PAN,P011209,P013383,14.55,-4,31,35
279,PAN,P011442,P012774,4.283,-4,16,20
279,PAN,P011442,P013383,5.95,-5,18,23
279,PAN,P012712,P012774,25.917,9,59,50
279,PAN,P012712,P013383,6.934,-5,9,14
279,PAN,P012712,PLHK,6.45,-5,13,18
279,PAN,P012774,P013383,19.15,0,47,47
279,PAN,P012774,PLHK,6.45,-5,13,18
279,TEL,P004233,P005145,8.583,6,27,21
279,TEL,P004233,P007519,4.633,-2,6,8
279,TEL,P004233,P007990,8.583,6,27,21
279,TEL,P004233,P011193,3.566,3,11,8
279,TEL,P004233,P011219,8.533,-2,16,18
279,TEL,P004233,P012604,4.8,6,11,5
279,TEL,P004233,P013381,1.483,-6,2,8
279,TEL,P004233,P013382,3.033,4,10,6
279,TEL,P004233,P013699,9.65,1,22,21
279,TEL,P005145,P007519,7.783,7,22,15
279,TEL,P005145,P007990,13.299,9,37,28
279,TEL,P005145,P011193,10.299,7,29,22
279,TEL,P005145,P011219,11.133,5,26,21
279,TEL,P005145,P012604,7.466,11,24,13
279,TEL,P005145,P013381,0.783,-3,2,5
279,TEL,P005145,P013382,14.199,13,39,26
279,TEL,P005145,P013699,10.783,9,30,21
279,TEL,P007519,P007990,1.217,-3,2,5
279,TEL,P007519,P011193,16.367,-8,37,45
279,TEL,P007519,P011219,16.166,-17,30,47
279,TEL,P007519,P012604,18.516,-9,40,49
279,TEL,P007519,P013381,2.067,-3,3,6
279,TEL,P007519,P013382,20.416,-10,47,57
279,TEL,P007519,P013699,7.699,-7,13,20
279,TEL,P007990,P011193,5.683,-7,13,20
279,TEL,P007990,P011219,9.617,0,23,23
279,TEL,P007990,P012604,3.9,4,13,9
279,TEL,P007990,P013381,0.783,-3,2,5
279,TEL,P007990,P013382,8.55,1,22,21
279,TEL,P007990,P013699,10.1,9,29,20
279,TEL,P011193,P011219,16.117,-15,30,45
279,TEL,P011193,P012604,13.6,-9,32,41
279,TEL,P011193,P013381,4.217,-4,7,11
279,TEL,P011193,P013382,19.334,-16,39,55
279,TEL,P011193,P013699,2.417,-3,2,5
279,TEL,P011219,P012604,12.233,-17,23,40
279,TEL,P011219,P013381,2.75,-4,2,6
279,TEL,P011219,P013382,18.45,-15,37,52
279,TEL,P011219,P013699,12.933,-3,25,28
279,TEL,P012604,P013381,1.384,0,3,3
279,TEL,P012604,P013382,18.949,-10,45,55
279,TEL,P012604,P013699,8.816,4,21,17
279,TEL,P013381,P013382,3.434,-1,5,6
279,TEL,P013381,P013699,2.767,-4,2,6
279,TEL,P013382,P013699,12.899,6,32,26
280,ASV,P000229,P002100,9.216,3,19,16
280,ASV,P000229,P003526,5.75,-3,10,13
280,ASV,P000229,P007027,9.167,4,19,15
280,ASV,P000229,P008991,6.233,2,13,11
280,ASV,P000229,P010545,9.467,6,22,16
280,ASV,P000229,P011225,7.85,3,20,17
280,ASV,P000229,P013371,5.167,6,12,6
280,ASV,P000229,P013405,9.95,11,25,14
280,ASV,P002100,P003526,13.333,4,26,22
280,ASV,P002100,P007027,9.05,5,20,15
280,ASV,P002100,P008991,8.95,6,20,14
280,ASV,P002100,P010316,6.9,-9,8,17
280,ASV,P002100,P010545,11.799,-4,20,24
280,ASV,P002100,P011225,13.433,6,29,23
280,ASV,P002100,P013405,10.783,5,26,21
280,ASV,P003526,P007027,17.75,7,42,35
280,ASV,P003526,P008991,7.233,3,14,11
280,ASV,P003526,P010316,4.15,-4,5,9
280,ASV,P003526,P010545,16.783,0,35,35
280,ASV,P003526,P011225,10.65,0,20,20
280,ASV,P003526,P013371,8.15,6,21,15
280,ASV,P003526,P013405,12.733,7,31,24
280,ASV,P007027,P008991,2.883,2,6,4
280,ASV,P007027,P010316,4.784,-6,11,17
280,ASV,P007027,P010545,25.184,6,58,52
280,ASV,P007027,P011225,5.517,0,14,14
280,ASV,P007027,P013371,15.234,12,39,27
280,ASV,P007027,P013405,23.167,10,55,45
280,ASV,P008991,P010316,2.217,-2,3,5
280,ASV,P008991,P011225,8.567,8,20,12
280,ASV,P008991,P013371,1.0,-1,1,2
280,ASV,P008991,P013405,2.717,2,7,5
280,ASV,P010316,P010545,7.733,-11,12,23
280,ASV,P010316,P011225,6.65,-5,11,16
280,ASV,P010316,P013371,1.917,0,6,6
280,ASV,P010316,P013405,5.917,-7,12,19
280,ASV,P010545,P011225,8.649,-11,14,25
280,ASV,P010545,P013371,14.234,13,38,25
280,ASV,P010545,P013405,25.883,9,61,52
280,ASV,P011225,P013405,8.016,-5,16,21
280,ASV,P013371,P013405,15.234,12,39,27
280,ZAL,P002329,P002676,1.367,-5,0,5
280,ZAL,P002329,P003048,2.784,-4,4,8
280,ZAL,P002329,P005504,15.567,-1,30,31
280,ZAL,P002329,P007029,18.167,9,41,32
280,ZAL,P002329,P007513,13.118,-4,23,27
280,ZAL,P002329,P007975,10.784,1,24,23
280,ZAL,P002329,P011051,4.434,2,11,9
280,ZAL,P002329,P011983,13.835,-6,28,34
280,ZAL,P002329,P013775,11.084,-4,19,23
280,ZAL,P002676,P003048,1.367,-5,0,5
280,ZAL,P002676,P005504,1.65,2,5,3
280,ZAL,P002676,P007029,1.25,2,5,3
280,ZAL,P002676,P007975,7.934,-11,11,22
280,ZAL,P002676,P011051,6.567,-6,11,17
280,ZAL,P002676,P011983,6.684,-13,6,19
280,ZAL,P002676,P012715,4.917,-8,6,14
280,ZAL,P003048,P007513,1.417,1,4,3
280,ZAL,P003048,P007975,2.367,-3,2,5
280,ZAL,P003048,P011983,2.784,-4,4,8
280,ZAL,P003048,P013775,0.417,-1,2,3
280,ZAL,P005504,P007029,19.883,2,44,42
280,ZAL,P005504,P007513,13.667,0,25,25
280,ZAL,P005504,P007975,16.283,4,39,35
280,ZAL,P005504,P011051,12.3,2,28,26
280,ZAL,P005504,P011983,17.084,-1,36,37
280,ZAL,P005504,P013775,15.034,-4,25,29
280,ZAL,P007029,P007513,10.45,0,19,19
280,ZAL,P007029,P007975,14.333,3,36,33
280,ZAL,P007029,P011051,10.35,1,25,24
280,ZAL,P007029,P011983,13.417,4,33,29
280,ZAL,P007029,P013775,8.95,3,17,14
280,ZAL,P007513,P007975,3.2,3,8,5
280,ZAL,P007513,P011051,2.2,1,6,5
280,ZAL,P007513,P011983,5.668,-1,12,13
280,ZAL,P007513,P013775,11.084,-4,19,23
280,ZAL,P007975,P011051,21.651,-4,45,49
280,ZAL,P007975,P011983,26.168,-4,53,57
280,ZAL,P007975,P012715,4.917,-8,6,14
280,ZAL,P007975,P013775,4.367,-1,8,9
280,ZAL,P011051,P011983,19.818,-3,40,43
280,ZAL,P011051,P012715,4.917,-8,6,14
280,ZAL,P011051,P013775,4.367,-1,8,9
280,ZAL,P011983,P012715,4.917,-8,6,14
280,ZAL,P011983,P013775,6.501,-8,10,18
281,MCO,P001932,P002581,5.3,0,12,12
281,MCO,P001932,P004132,4.6,-6,8,14
281,MCO,P001932,P005985,18.65,-10,32,42
281,MCO,P001932,P008099,2.9,-1,4,5
281,MCO,P001932,P011212,3.633,-2,6,8
281,MCO,P001932,P011226,17.067,-2,34,36
281,MCO,P001932,P011231,14.2,-7,28,35
281,MCO,P001932,P012515,0.333,4,4,0
281,MCO,P001932,PLCZ,8.917,0,16,16
281,MCO,P002581,P005985,11.117,3,21,18
281,MCO,P002581,P008099,9.167,0,17,17
281,MCO,P002581,P011212,9.617,4,19,15
281,MCO,P002581,P011226,4.6,-1,10,11
281,MCO,P002581,P011231,8.567,0,17,17
281,MCO,P002581,P012515,1.3,-2,4,6
281,MCO,P004132,P005985,11.9,-1,24,25
281,MCO,P004132,P008099,7.584,1,11,10
281,MCO,P004132,P011212,15.017,5,31,26
281,MCO,P004132,P011226,9.551,3,20,17
281,MCO,P004132,P011231,17.117,6,39,33
281,MCO,P004132,P012515,8.167,8,23,15
281,MCO,P005985,P008099,9.217,0,13,13
281,MCO,P005985,P011212,17.1,8,35,27
281,MCO,P005985,P011226,21.617,-2,40,42
281,MCO,P005985,P011231,27.017,-1,53,54
281,MCO,P005985,P012515,2.933,3,10,7
281,MCO,P005985,PLCZ,8.917,0,16,16
281,MCO,P008099,P011212,13.951,0,24,24
281,MCO,P008099,P011226,4.784,-5,6,11
281,MCO,P008099,P011231,13.434,2,24,22
281,MCO,P008099,P012515,6.367,-1,13,14
281,MCO,P011212,P011226,7.984,4,16,12
281,MCO,P011212,P011231,22.417,7,46,39
281,MCO,P011212,P012515,9.217,2,23,21
281,MCO,P011226,P011231,18.034,1,38,37
281,MCO,P011226,P012515,0.45,2,4,2
281,MCO,P011226,PLCZ,8.917,0,16,16
281,MCO,P011231,P012515,9.433,8,27,19
281,MCO,P011231,PLCZ,8.917,0,16,16
281,OLY,P001255,P003469,21.467,-12,41,53
281,OLY,P001255,P007853,2.783,-6,3,9
281,OLY,P001255,P007982,20.001,-8,38,46
281,OLY,P001255,P008811,8.917,1,16,15
281,OLY,P001255,P008829,9.567,-9,17,26
281,OLY,P001255,P012878,5.617,-8,8,16
281,OLY,P001255,P013380,20.001,-8,38,46
281,OLY,P001255,P013389,2.783,-6,3,9
281,OLY,P003469,P007853,10.083,-7,17,24
281,OLY,P003469,P007982,28.484,3,62,59
281,OLY,P003469,P008811,9.15,2,17,15
281,OLY,P003469,P008829,17.9,-1,40,41
281,OLY,P003469,P010392,2.666,6,10,4
281,OLY,P003469,P012878,4.3,-6,8,14
281,OLY,P003469,P013380,22.301,-8,43,51
281,OLY,P003469,P013389,9.049,3,22,19
281,OLY,P007853,P007982,7.217,1,14,13
281,OLY,P007853,P008811,3.167,2,6,4
281,OLY,P007853,P008829,17.416,-3,29,32
281,OLY,P007853,P010392,3.933,-3,7,10
281,OLY,P007853,P012878,4.166,2,6,4
281,OLY,P007853,P013380,7.1,3,10,7
281,OLY,P007853,P013389,13.799,-1,24,25
281,OLY,P007982,P008811,9.15,2,17,15
281,OLY,P007982,P008829,16.351,5,37,32
281,OLY,P007982,P010392,2.583,8,10,2
281,OLY,P007982,P012878,5.617,-8,8,16
281,OLY,P007982,P013380,23.618,-10,43,53
281,OLY,P007982,P013389,6.183,11,19,8
281,OLY,P008811,P008829,3.167,2,6,4
281,OLY,P008811,P010392,3.4,3,7,4
281,OLY,P008811,P013380,8.917,1,16,15
281,OLY,P008811,P013389,3.4,3,7,4
281,OLY,P008829,P010392,6.283,4,16,12
281,OLY,P008829,P012878,5.483,0,6,6
281,OLY,P008829,P013380,13.884,0,24,24
281,OLY,P008829,P013389,16.149,6,33,27
281,OLY,P010392,P012878,0.683,-3,1,4
281,OLY,P010392,P013389,6.516,5,17,12
281,OLY,P012878,P013380,9.1,-3,13,16
281,OLY,P012878,P013389,4.166,2,6,4
281,OLY,P013380,P013389,3.483,5,5,0
282,BAR,P002939,P003196,19.284,-7,45,52
282,BAR,P002939,P003478,6.55,-6,12,18
282,BAR,P002939,P006568,1.967,-1,2,3
282,BAR,P002939,P007464,8.317,-12,17,29
282,BAR,P002939,P009862,11.251,-8,21,29
282,BAR,P002939,P009992,10.9,2,30,28
282,BAR,P002939,P011666,15.584,6,39,33
282,BAR,P002939,P012745,16.934,10,44,34
282,BAR,P002939,P012795,2.217,-4,6,10
282,BAR,P003196,P003478,9.484,0,22,22
282,BAR,P003196,P007464,8.567,-4,20,24
282,BAR,P003196,P009862,10.218,-4,22,26
282,BAR,P003196,P009992,12.084,5,35,30
282,BAR,P003196,P011666,13.367,7,35,28
282,BAR,P003196,P012745,13.651,3,35,32
282,BAR,P003196,P012795,2.217,-4,6,10
282,BAR,P003478,P006568,6.584,0,14,14
282,BAR,P003478,P007464,9.717,3,24,21
282,BAR,P003478,P009862,11.251,-1,24,25
282,BAR,P003478,P009992,9.518,6,24,18
282,BAR,P003478,P011666,4.817,1,12,11
282,BAR,P003478,P012745,6.351,-3,12,15
282,BAR,P006568,P007464,11.884,11,34,23
282,BAR,P006568,P009862,15.767,8,36,28
282,BAR,P006568,P009992,13.184,7,32,25
282,BAR,P006568,P011666,4.183,-4,4,8
282,BAR,P006568,P012745,3.9,-3,2,5
282,BAR,P006568,P012795,5.667,14,20,6
282,BAR,P007464,P009862,19.134,14,53,39
282,BAR,P007464,P009992,18.551,19,55,36
282,BAR,P007464,P011666,4.1,-5,9,14
282,BAR,P007464,P012745,2.0,3,7,4
282,BAR,P007464,P012795,7.534,11,25,14
282,BAR,P009862,P009992,19.818,13,51,38
282,BAR,P009862,P011666,8.0,-4,14,18
282,BAR,P009862,P012745,10.851,-4,19,23
282,BAR,P009862,P012795,5.65,14,20,6
282,BAR,P009992,P011666,6.549,1,15,14
282,BAR,P009992,P012745,10.217,-1,22,23
282,BAR,P009992,P012795,7.251,8,24,16
282,BAR,P011666,P012745,13.95,8,34,26
282,BAR,P011666,P012795,0.65,2,2,0
282,BAR,P012745,P012795,0.35,-1,1,2
282,MIL,P000796,P001518,9.449,-4,20,24
282,MIL,P000796,P006509,22.499,4,51,47
282,MIL,P000796,P006721,3.983,13,15,2
282,MIL,P000796,P007831,28.466,8,69,61
282,MIL,P000796,P008985,7.233,8,20,12
282,MIL,P000796,P008987,16.05,-2,33,35
282,MIL,P000796,P011064,26.699,13,69,56
282,MIL,P000796,P013384,4.817,0,15,15
282,MIL,P001518,P006509,10.149,-11,20,31
282,MIL,P001518,P007831,9.599,-6,20,26
282,MIL,P001518,P008985,7.799,3,20,17
282,MIL,P001518,P008987,3.433,-1,9,10
282,MIL,P001518,P011064,11.099,-1,27,28
282,MIL,P005670,P006721,2.933,-9,2,11
282,MIL,P005670,P008985,2.933,-9,2,11
282,MIL,P005670,P008987,2.933,-9,2,11
282,MIL,P005670,P013384,2.933,-9,2,11
282,MIL,P006085,P006721,1.05,-4,0,4
282,MIL,P006085,P007831,0.633,-2,0,2
282,MIL,P006085,P008985,1.683,-6,0,6
282,MIL,P006085,P008987,1.683,-6,0,6
282,MIL,P006085,P011941,0.633,-2,0,2
282,MIL,P006085,P013384,1.05,-4,0,4
282,MIL,P006509,P006721,2.933,11,11,0
282,MIL,P006509,P007831,22.366,2,51,49
282,MIL,P006509,P008985,5.416,0,14,14
282,MIL,P006509,P008987,15.966,-1,33,34
282,MIL,P006509,P011064,24.149,7,58,51
282,MIL,P006509,P013384,0.25,0,2,2
282,MIL,P006721,P007831,2.65,11,11,0
282,MIL,P006721,P008985,6.549,-11,8,19
282,MIL,P006721,P008987,5.216,-13,4,17
282,MIL,P006721,P011064,5.216,13,17,4
282,MIL,P006721,P013384,6.266,-11,8,19
282,MIL,P007831,P008985,7.6,-2,18,20
282,MIL,P007831,P008987,17.75,-10,35,45
282,MIL,P007831,P011064,25.366,11,65,54
282,MIL,P007831,P011941,1.55,-6,2,8
282,MIL,P007831,P013384,4.684,-6,13,19
282,MIL,P008985,P008987,11.666,-21,17,38
282,MIL,P008985,P011064,8.649,12,27,15
282,MIL,P008985,P011941,1.55,-6,2,8
282,MIL,P008985,P013384,8.65,-16,12,28
282,MIL,P008987,P011064,19.099,0,42,42
282,MIL,P008987,P011941,1.55,-6,2,8
282,MIL,P008987,P013384,9.65,-19,15,34
282,MIL,P011064,P013384,4.583,1,15,14
282,MIL,P011941,P013384,0.917,-4,2,6
283,MUN,P001288,P001557,10.434,-2,19,21
283,MUN,P001288,P004508,12.101,7,26,19
283,MUN,P001288,P005460,14.684,-2,29,31
283,MUN,P001288,P007201,23.217,4,49,45
283,MUN,P001288,P007639,4.384,4,14,10
283,MUN,P001288,P010391,20.834,8,49,41
283,MUN,P001288,P011224,7.75,11,21,10
283,MUN,P001288,P011987,13.4,6,33,27
283,MUN,P001557,P004508,17.651,6,35,29
283,MUN,P001557,P005460,5.017,-4,9,13
283,MUN,P001557,P007201,11.2,2,21,19
283,MUN,P001557,P007639,10.134,8,23,15
283,MUN,P001557,P010391,9.484,1,19,18
283,MUN,P001557,P011224,12.517,5,25,20
283,MUN,P001557,P011987,11.567,8,25,17
283,MUN,P004508,P005460,5.267,-1,12,13
283,MUN,P004508,P007201,10.35,0,19,19
283,MUN,P004508,P007639,10.134,8,23,15
283,MUN,P004508,P010391,7.967,4,19,15
283,MUN,P004508,P011224,15.384,10,33,23
283,MUN,P004508,P011987,10.15,2,21,19
283,MUN,P005460,P007201,17.8,-1,36,37
283,MUN,P005460,P010391,17.4,2,38,36
283,MUN,P005460,P011224,3.267,3,8,5
283,MUN,P005460,P011987,14.833,3,32,29
283,MUN,P007201,P007639,2.667,0,8,8
283,MUN,P007201,P010391,24.35,7,56,49
283,MUN,P007201,P011224,4.533,4,10,6
283,MUN,P007201,P011987,18.283,8,45,37
283,MUN,P007639,P010391,2.667,0,8,8
283,MUN,P007639,P011224,10.134,8,23,15
283,MUN,P007639,P011987,11.084,4,25,21
283,MUN,P010391,P011224,1.883,10,10,0
283,MUN,P010391,P011987,18.283,8,45,37
283,MUN,P011224,P011987,9.2,9,22,13
283,PAR,P004761,P006760,8.283,-8,12,20
283,PAR,P004761,P007870,4.45,1,7,6
283,PAR,P004761,P010781,4.866,-6,4,10
283,PAR,P004761,P011050,12.6,2,26,24
283,PAR,P004761,P011836,13.451,1,29,28
283,PAR,P004761,P011981,6.0,-3,12,15
283,PAR,P004761,P012720,24.15,-5,45,50
283,PAR,P004761,P013369,22.8,-2,45,47
283,PAR,P006760,P007870,14.683,-6,27,33
283,PAR,P006760,P010781,11.916,-14,19,33
283,PAR,P006760,P011836,7.234,-5,12,17
283,PAR,P006760,P011981,17.133,-15,31,46
283,PAR,P006760,P012720,17.983,-8,31,39
283,PAR,P006760,P013369,19.3,-16,32,48
283,PAR,P007870,P010781,8.466,-5,17,22
283,PAR,P007870,P011836,7.984,3,17,14
283,PAR,P007870,P011981,8.783,-8,17,25
283,PAR,P007870,P012720,14.15,1,26,25
283,PAR,P007870,P013369,13.284,-6,25,31
283,PAR,P010781,P011050,2.583,-1,4,5
283,PAR,P010781,P011836,2.35,-4,2,6
283,PAR,P010781,P011981,9.633,-9,19,28
283,PAR,P010781,P012720,8.349,-5,13,18
283,PAR,P010781,P013369,9.833,-16,14,30
283,PAR,P011050,P011836,10.017,3,22,19
283,PAR,P011050,P012720,12.6,2,26,24
283,PAR,P011050,P013369,12.6,2,26,24
283,PAR,P011836,P011981,2.517,-7,2,9
283,PAR,P011836,P012720,18.168,3,39,36
283,PAR,P011836,P013369,20.351,2,41,39
283,PAR,P011981,P012720,10.983,-5,21,26
283,PAR,P011981,P013369,13.483,-13,22,35
283,PAR,P012720,P013369,29.017,-3,55,58
284,IST,P004887,P006590,11.383,-5,22,27
284,IST,P004887,P007109,8.45,-11,12,23
284,IST,P004887,P007200,9.267,-2,22,24
284,IST,P004887,P009664,4.833,4,16,12
284,IST,P004887,P009846,16.85,-6,34,40
284,IST,P004887,P011078,15.183,-6,32,38
284,IST,P004887,P012710,7.367,0,16,16
284,IST,P004887,P012742,5.467,-1,12,13
284,IST,P004887,P013363,3.8,-1,10,11
284,IST,P006372,P007200,0.083,0,0,0
284,IST,P006372,P009846,0.083,0,0,0
284,IST,P006372,P011078,0.083,0,0,0
284,IST,P006372,P012742,0.083,0,0,0
284,IST,P006590,P007109,10.133,4,25,21
284,IST,P006590,P007200,5.901,7,20,13
284,IST,P006590,P009846,18.117,5,45,40
284,IST,P006590,P011078,11.55,-3,24,27
284,IST,P006590,P012710,7.817,-1,18,19
284,IST,P006590,P012742,0.833,3,3,0
284,IST,P006590,P012788,6.734,10,23,13
284,IST,P007109,P007200,11.85,2,23,21
284,IST,P007109,P009846,18.733,-2,38,40
284,IST,P007109,P011078,10.816,-6,20,26
284,IST,P007109,P012742,6.033,-4,8,12
284,IST,P007109,P012788,10.449,9,26,17
284,IST,P007200,P009664,7.117,2,18,16
284,IST,P007200,P009846,18.817,6,47,41
284,IST,P007200,P011078,14.0,3,30,27
284,IST,P007200,P012710,8.567,-2,22,24
284,IST,P007200,P012742,12.25,-3,25,28
284,IST,P007200,P012788,18.217,6,43,37
284,IST,P007200,P013363,5.067,-3,10,13
284,IST,P009664,P009846,1.033,5,6,1
284,IST,P009664,P011078,6.084,-3,12,15
284,IST,P009664,P012742,2.05,5,8,3
284,IST,P009664,P012788,2.284,-2,2,4
284,IST,P009664,P013363,5.067,-3,10,13
284,IST,P009846,P011078,16.416,0,34,34
284,IST,P009846,P012710,11.017,-1,26,27
284,IST,P009846,P012742,9.183,-1,20,21
284,IST,P009846,P012788,13.883,10,38,28
284,IST,P011078,P012710,8.233,5,18,13
284,IST,P011078,P012742,4.2,1,8,7
284,IST,P011078,P012788,9.9,4,20,16
284,IST,P011078,P013363,5.067,-3,10,13
284,IST,P012710,P012742,4.917,-1,12,13
284,IST,P012710,P012788,6.15,0,16,16
284,IST,P012742,P012788,7.316,1,16,15
284,IST,P012788,P013363,1.267,-2,0,2
284,TEL,P004233,P005145,9.251,-9,18,27
284,TEL,P004233,P007519,5.268,-17,6,23
284,TEL,P004233,P007990,11.485,-5,22,27
284,TEL,P004233,P011193,2.816,-4,6,10
284,TEL,P004233,P011219,12.534,-9,26,35
284,TEL,P004233,P011433,0.067,0,0,0
284,TEL,P004233,P013381,2.533,-6,4,10
284,TEL,P004233,P013382,5.252,-4,8,12
284,TEL,P004233,P013699,10.202,-2,22,24
284,TEL,P005145,P007519,8.55,-1,20,21
284,TEL,P005145,P007990,11.85,-7,27,34
284,TEL,P005145,P011193,6.883,7,18,11
284,TEL,P005145,P011219,16.2,1,39,38
284,TEL,P005145,P011433,0.067,0,0,0
284,TEL,P005145,P013381,0.783,0,2,2
284,TEL,P005145,P013382,10.15,2,25,23
284,TEL,P005145,P013699,9.334,-1,23,24
284,TEL,P007519,P007990,6.784,-4,14,18
284,TEL,P007519,P011193,20.534,4,45,41
284,TEL,P007519,P011219,25.001,-4,54,58
284,TEL,P007519,P013381,12.467,1,27,26
284,TEL,P007519,P013382,22.852,8,54,46
284,TEL,P007519,P013699,1.484,-3,4,7
284,TEL,P007990,P011193,6.2,-2,12,14
284,TEL,P007990,P011219,18.234,-4,39,43
284,TEL,P007990,P011433,0.067,0,0,0
284,TEL,P007990,P013381,4.05,1,9,8
284,TEL,P007990,P013382,12.201,-1,25,26
284,TEL,P007990,P013699,10.401,2,24,22
284,TEL,P011193,P011219,23.767,6,53,47
284,TEL,P011193,P013381,14.983,-2,32,34
284,TEL,P011193,P013382,22.284,12,51,39
284,TEL,P011193,P013699,0.733,3,3,0
284,TEL,P011219,P013381,14.7,0,32,32
284,TEL,P011219,P013382,28.851,11,66,55
284,TEL,P011219,P013699,11.117,3,27,24
284,TEL,P011433,P013699,0.067,0,0,0
284,TEL,P013381,P013382,13.484,6,30,24
284,TEL,P013382,P013699,6.534,-2,13,15
285,BAS,P004058,P007230,5.533,6,10,4
285,BAS,P004058,P008850,2.283,-5,2,7
285,BAS,P004058,P011085,1.883,-1,4,5
285,BAS,P004058,P011196,12.366,-1,20,21
285,BAS,P004058,P011948,10.083,4,18,14
285,BAS,P004058,P012080,10.483,0,16,16
285,BAS,P004058,P012201,6.833,-7,10,17
285,BAS,P007230,P007579,10.784,5,26,21
285,BAS,P007230,P008072,6.85,-3,15,18
285,BAS,P007230,P008850,7.6,-5,15,20
285,BAS,P007230,P011085,17.284,8,45,37
285,BAS,P007230,P011196,8.7,2,10,8
285,BAS,P007230,P011948,10.083,4,15,11
285,BAS,P007230,P012080,12.233,0,17,17
285,BAS,P007230,P012201,15.317,1,34,33
285,BAS,P007230,P013367,24.084,-2,49,51
285,BAS,P007579,P011085,9.367,9,26,17
285,BAS,P007579,P011948,1.417,-4,0,4
285,BAS,P007579,P012201,10.784,5,26,21
285,BAS,P007579,P013367,10.784,5,26,21
285,BAS,P008072,P008850,6.667,-3,15,18
285,BAS,P008072,P011085,4.75,0,11,11
285,BAS,P008072,P011948,0.183,0,0,0
285,BAS,P008072,P012080,2.1,-3,4,7
285,BAS,P008072,P013367,6.85,-3,15,18
285,BAS,P008850,P011085,4.567,0,11,11
285,BAS,P008850,P011196,2.283,-5,2,7
285,BAS,P008850,P012080,4.383,-8,6,14
285,BAS,P008850,P012201,1.35,-3,2,5
285,BAS,P008850,P013367,6.667,-3,15,18
285,BAS,P011085,P011196,3.783,0,10,10
285,BAS,P011085,P011948,3.749,6,15,9
285,BAS,P011085,P012080,1.75,-1,3,4
285,BAS,P011085,P012201,15.5,11,44,33
285,BAS,P011085,P013367,18.367,12,51,39
285,BAS,P011196,P011948,15.583,1,26,25
285,BAS,P011196,P012080,14.867,-6,18,24
285,BAS,P011196,P012201,11.433,-13,18,31
285,BAS,P011196,P013367,6.517,-6,8,14
285,BAS,P011948,P012080,13.917,-3,16,19
285,BAS,P011948,P012201,12.416,-10,21,31
285,BAS,P011948,P013367,9.033,-6,13,19
285,BAS,P012080,P012201,10.3,-15,11,26
285,BAS,P012080,P013367,9.367,-12,9,21
285,BAS,P012201,P013367,18.867,-1,42,43
285,ULK,P002849,P004004,14.05,-10,23,33
285,ULK,P002849,P005216,5.983,1,15,14
285,ULK,P002849,P006961,9.767,11,20,9
285,ULK,P002849,P008104,6.284,-1,9,10
285,ULK,P002849,P008962,17.767,2,32,30
285,ULK,P002849,P009783,8.866,-5,17,22
285,ULK,P002849,P009863,13.15,10,26,16
285,ULK,P002849,P010560,6.583,-5,9,14
285,ULK,P002849,P011205,10.35,1,21,20
285,ULK,P002968,P004004,1.133,-4,0,4
285,ULK,P002968,P005216,1.133,-4,0,4
285,ULK,P002968,P006961,3.784,0,10,10
285,ULK,P002968,P008104,2.567,4,8,4
285,ULK,P002968,P008962,4.25,-3,9,12
285,ULK,P002968,P009783,1.133,-4,0,4
285,ULK,P002968,P009863,4.467,3,13,10
285,ULK,P002968,P010560,1.35,2,4,2
285,ULK,P002968,P011205,2.583,2,8,6
285,ULK,P003091,P004004,2.984,5,9,4
285,ULK,P003091,P006961,3.467,4,9,5
285,ULK,P003091,P008104,5.317,9,16,7
285,ULK,P003091,P008962,2.167,4,7,3
285,ULK,P003091,P009783,0.867,0,2,2
285,ULK,P003091,P009863,1.85,5,7,2
285,ULK,P003091,P010560,2.283,5,7,2
285,ULK,P003091,P011205,2.333,4,7,3
285,ULK,P004004,P005216,7.116,-3,15,18
285,ULK,P004004,P006961,5.134,-2,4,6
285,ULK,P004004,P008104,4.851,3,13,10
285,ULK,P004004,P008962,12.0,-11,19,30
285,ULK,P004004,P009783,10.233,-9,19,28
285,ULK,P004004,P009863,6.734,-2,11,13
285,ULK,P004004,P010560,4.633,2,9,7
285,ULK,P004004,P011205,3.8,-5,6,11
285,ULK,P005216,P006961,1.983,-2,4,6
285,ULK,P005216,P008962,11.116,-5,23,28
285,ULK,P005216,P009783,7.116,-3,15,18
285,ULK,P005216,P009863,4.0,-2,8,10
285,ULK,P005216,P010560,4.0,-2,8,10
285,ULK,P005216,P011205,2.017,0,4,4
285,ULK,P006961,P008104,9.068,8,19,11
285,ULK,P006961,P008962,15.251,12,35,23
285,ULK,P006961,P009783,1.467,0,2,2
285,ULK,P006961,P009863,15.717,9,34,25
285,ULK,P006961,P010560,6.399,-5,10,15
285,ULK,P006961,P011205,9.167,9,25,16
285,ULK,P008104,P008962,8.818,2,15,13
285,ULK,P008104,P009783,1.467,0,2,2
285,ULK,P008104,P009863,9.467,12,26,14
285,ULK,P008104,P010560,8.9,2,18,16
285,ULK,P008104,P011205,6.733,1,14,13
285,ULK,P008962,P009783,10.599,-9,17,26
285,ULK,P008962,P009863,15.6,10,34,24
285,ULK,P008962,P010560,7.1,-8,10,18
285,ULK,P008962,P011205,15.6,2,31,29
285,ULK,P009783,P009863,0.633,0,0,0
285,ULK,P009783,P011205,3.483,-6,2,8
285,ULK,P009863,P010560,12.732,4,30,26
285,ULK,P009863,P011205,12.582,15,35,20
285,ULK,P010560,P011205,8.016,-3,15,18
286,BER,P006251,P007025,6.617,-5,7,12
286,BER,P006251,P008062,4.9,-6,7,13
286,BER,P006251,P008173,9.05,-20,7,27
286,BER,P006251,P008211,12.767,-13,18,31
286,BER,P006251,P008384,4.017,-5,5,10
286,BER,P006251,P008780,8.951,-15,11,26
286,BER,P006251,P008967,7.167,0,16,16
286,BER,P006251,P011631,10.534,-12,13,25
286,BER,P006251,P012721,8.401,-15,9,24
286,BER,P006251,P013774,7.8,-13,7,20
286,BER,P007025,P008062,1.467,-2,0,2
286,BER,P007025,P008211,6.2,-5,7,12
286,BER,P007025,P008384,3.417,-6,2,8
286,BER,P007025,P008967,2.783,1,5,4
286,BER,P007025,P011631,7.667,-7,7,14
286,BER,P007025,P012721,1.467,-2,0,2
286,BER,P007025,P013774,1.05,-2,0,2
286,BER,P008062,P008173,2.85,-7,3,10
286,BER,P008062,P008211,5.716,-13,6,19
286,BER,P008062,P008384,8.267,-16,12,28
286,BER,P008062,P008967,16.25,-15,33,48
286,BER,P008062,P011631,14.417,-8,30,38
286,BER,P008062,P012721,9.551,-7,19,26
286,BER,P008062,P013386,5.75,-10,9,19
286,BER,P008062,P013774,13.1,-12,25,37
286,BER,P008173,P008211,4.233,-6,6,12
286,BER,P008173,P008384,0.667,0,3,3
286,BER,P008173,P008780,8.55,-13,10,23
286,BER,P008173,P011631,3.3,-6,6,12
286,BER,P008173,P012721,6.5,-14,4,18
286,BER,P008173,P013386,2.35,0,6,6
286,BER,P008173,P013774,8.1,-14,7,21
286,BER,P008211,P008384,3.417,-6,2,8
286,BER,P008211,P008780,5.251,-2,13,15
286,BER,P008211,P008967,9.517,-8,18,26
286,BER,P008211,P011631,14.0,-17,21,38
286,BER,P008211,P012721,2.234,-3,5,8
286,BER,P008211,P013386,2.567,-1,6,7
286,BER,P008211,P013774,2.766,-6,2,8
286,BER,P008384,P008780,1.483,1,4,3
286,BER,P008384,P008967,9.083,-15,13,28
286,BER,P008384,P011631,7.317,-6,10,16
286,BER,P008384,P012721,3.2,-11,3,14
286,BER,P008384,P013386,7.0,-10,11,21
286,BER,P008384,P013774,4.8,-10,7,17
286,BER,P008780,P008967,4.684,-2,11,13
286,BER,P008780,P011631,3.867,1,10,9
286,BER,P008780,P012721,8.967,-16,11,27
286,BER,P008780,P013386,4.05,-1,8,9
286,BER,P008780,P013774,7.133,-13,6,19
286,BER,P008967,P011631,16.3,2,39,37
286,BER,P008967,P012721,10.551,-7,26,33
286,BER,P008967,P013386,7.45,-11,11,22
286,BER,P008967,P013774,11.083,-9,24,33
286,BER,P011631,P012721,6.584,5,18,13
286,BER,P011631,P013386,5.95,1,14,13
286,BER,P011631,P013774,8.0,-1,20,21
286,BER,P012721,P013386,1.8,-7,1,8
286,BER,P012721,P013774,14.817,-15,24,39
286,BER,P013386,P013774,2.283,-5,2,7
286,VIR,P001133,P001844,6.916,3,17,14
286,VIR,P001133,P002084,13.116,17,40,23
286,VIR,P001133,P004554,3.85,3,10,7
286,VIR,P001133,P004888,17.266,25,48,23
286,VIR,P001133,P006739,11.866,24,33,9
286,VIR,P001133,P009549,17.933,27,51,24
286,VIR,P001133,P011816,6.533,14,18,4
286,VIR,P001133,P012585,10.283,14,35,21
286,VIR,P001133,PBCN,6.233,9,20,11
286,VIR,P001844,P002084,6.367,5,15,10
286,VIR,P001844,P004554,7.833,4,21,17
286,VIR,P001844,P004888,6.383,4,17,13
286,VIR,P001844,P009549,6.834,-4,17,21
286,VIR,P001844,P011816,4.934,4,16,12
286,VIR,P001844,P012585,8.033,13,23,10
286,VIR,P001844,P013695,3.867,0,11,11
286,VIR,P001844,PBCN,8.233,7,23,16
286,VIR,P002084,P004554,0.25,0,0,0
286,VIR,P002084,P004888,6.883,8,20,12
286,VIR,P002084,P006739,7.2,15,24,9
286,VIR,P002084,P009549,9.651,15,32,17
286,VIR,P002084,P011816,4.901,10,17,7
286,VIR,P002084,P012585,13.367,19,43,24
286,VIR,P002084,P013695,0.234,-2,0,2
286,VIR,P002084,PBCN,11.167,21,37,16
286,VIR,P004554,P004888,5.433,2,12,10
286,VIR,P004554,P006739,7.6,-1,12,13
286,VIR,P004554,P009549,7.183,-2,15,17
286,VIR,P004554,P011816,1.583,-1,2,3
286,VIR,P004554,P012585,8.25,5,18,13
286,VIR,P004554,P013695,9.75,1,21,20
286,VIR,P004554,PBCN,10.0,1,21,20
286,VIR,P004888,P006739,9.216,14,20,6
286,VIR,P004888,P009549,16.416,20,43,23
286,VIR,P004888,P011816,8.116,13,20,7
286,VIR,P004888,P012585,5.683,10,20,10
286,VIR,P006739,P009549,11.816,24,30,6
286,VIR,P006739,P011816,8.083,19,21,2
286,VIR,P006739,P012585,8.617,4,20,16
286,VIR,P006739,P013695,6.117,-1,10,11
286,VIR,P006739,PBCN,11.217,14,30,16
286,VIR,P009549,P011816,9.3,16,25,9
286,VIR,P009549,P012585,4.734,7,18,11
286,VIR,P009549,P013695,2.884,-4,7,11
286,VIR,P009549,PBCN,6.717,9,22,13
286,VIR,P011816,P012585,3.717,7,12,5
286,VIR,P011816,P013695,0.217,-2,0,2
286,VIR,P011816,PBCN,4.684,12,17,5
286,VIR,P012585,P013695,7.117,3,14,11
286,VIR,P012585,PBCN,15.667,14,41,27
286,VIR,P013695,PBCN,9.75,1,21,20
287,MAD,P003108,P003733,5.233,0,11,11
287,MAD,P003108,P005791,6.567,0,13,13
287,MAD,P003108,P005928,8.533,-2,18,20
287,MAD,P003108,P006540,12.417,3,23,20
287,MAD,P003108,P007630,12.833,2,28,26
287,MAD,P003108,P009005,6.033,-5,11,16
287,MAD,P003108,P011247,12.683,0,23,23
287,MAD,P003108,P011649,5.15,-4,8,12
287,MAD,P003108,P013667,2.35,-2,3,5
287,MAD,P003108,PTGB,8.601,4,18,14
287,MAD,P003733,P005791,9.183,12,20,8
287,MAD,P003733,P005928,11.833,12,27,15
287,MAD,P003733,P007630,14.266,15,31,16
287,MAD,P003733,P009005,14.416,12,31,19
287,MAD,P003733,P011247,2.583,0,4,4
287,MAD,P003733,PTGB,0.15,-3,0,3
287,MAD,P005791,P005928,18.883,6,38,32
287,MAD,P005791,P006540,10.517,-5,21,26
287,MAD,P005791,P007630,12.133,14,25,11
287,MAD,P005791,P009005,16.083,8,33,25
287,MAD,P005791,P011247,3.767,2,8,6
287,MAD,P005791,P011649,4.1,-2,5,7
287,MAD,P005791,PTGB,9.367,-3,21,24
287,MAD,P005928,P006540,9.933,-6,19,25
287,MAD,P005928,P007630,18.149,12,38,26
287,MAD,P005928,P009005,19.199,3,40,37
287,MAD,P005928,P011247,1.116,-1,2,3
287,MAD,P005928,P011649,4.1,-2,5,7
287,MAD,P005928,PTGB,7.85,-6,17,23
287,MAD,P006540,P007630,9.116,3,18,15
287,MAD,P006540,P009005,9.416,-5,19,24
287,MAD,P006540,P011247,12.833,6,25,19
287,MAD,P006540,P011649,3.5,-5,3,8
287,MAD,P006540,P013667,2.35,-2,3,5
287,MAD,P006540,PTGB,17.25,3,37,34
287,MAD,P007630,P009005,20.332,7,37,30
287,MAD,P007630,P011247,10.099,1,18,17
287,MAD,P007630,P011649,2.95,1,5,4
287,MAD,P007630,PTGB,8.65,1,16,15
287,MAD,P009005,P011247,6.916,-4,10,14
287,MAD,P009005,P011649,1.3,0,0,0
287,MAD,P009005,PTGB,10.033,-8,19,27
287,MAD,P011247,P011649,2.35,-2,3,5
287,MAD,P011247,P013667,2.35,-2,3,5
287,MAD,P011247,PTGB,10.167,4,20,16
287,MAD,P011649,P013667,2.35,-2,3,5
287,RED,P000848,P004007,4.216,-2,8,10
287,RED,P000848,P004866,16.7,-2,35,37
287,RED,P000848,P006436,12.35,0,26,26
287,RED,P000848,P007960,4.633,-9,3,12
287,RED,P000848,P009048,16.7,-1,36,37
287,RED,P000848,P010588,5.95,1,13,12
287,RED,P000848,P010612,5.167,9,18,9
287,RED,P000848,P011194,15.583,-3,32,35
287,RED,P000848,P012044,4.833,-1,9,10
287,RED,P004007,P004866,0.816,0,2,2
287,RED,P004007,P006436,4.932,-2,10,12
287,RED,P004007,P007960,0.883,0,0,0
287,RED,P004007,P009048,1.966,-1,3,4
287,RED,P004007,P010588,5.432,0,10,10
287,RED,P004007,P011194,0.383,-2,0,2
287,RED,P004007,P012044,3.033,-1,5,6
287,RED,P004007,PJDR,1.599,0,2,2
287,RED,P004866,P006436,21.05,4,43,39
287,RED,P004866,P007960,6.866,-13,3,16
287,RED,P004866,P009048,19.617,0,42,42
287,RED,P004866,P010588,5.95,7,16,9
287,RED,P004866,P010612,14.117,5,30,25
287,RED,P004866,P011194,26.849,-9,46,55
287,RED,P004866,P012044,2.583,0,4,4
287,RED,P004866,PJDR,15.316,0,27,27
287,RED,P006436,P009048,16.534,1,32,31
287,RED,P006436,P010588,11.483,2,23,21
287,RED,P006436,P010612,9.968,-2,16,18
287,RED,P006436,P011194,16.55,-2,30,32
287,RED,P006436,P012044,3.033,-1,5,6
287,RED,P006436,PJDR,14.9,0,27,27
287,RED,P007960,P009048,5.616,-11,3,14
287,RED,P007960,P010588,2.0,1,3,2
287,RED,P007960,P010612,2.133,-2,0,2
287,RED,P007960,P011194,5.749,-14,0,14
287,RED,P007960,PJDR,3.116,-4,0,4
287,RED,P009048,P010588,10.017,2,19,17
287,RED,P009048,P010612,4.618,5,14,9
287,RED,P009048,P011194,14.433,-5,28,33
287,RED,P009048,PJDR,6.967,-2,11,13
287,RED,P010588,P010612,2.534,-2,2,4
287,RED,P010588,P011194,0.333,0,0,0
287,RED,P010588,P012044,3.033,-1,5,6
287,RED,P010588,PJDR,7.2,2,13,11
287,RED,P010612,P011194,14.117,5,30,25
287,RED,P010612,P012044,2.583,0,4,4
287,RED,P010612,PJDR,11.367,-6,14,20
287,RED,P011194,P012044,2.583,0,4,4
287,RED,P011194,PJDR,10.816,-6,14,20
287,RED,P012044,PJDR,0.783,0,0,0
288,PAN,P001926,P004088,21.033,11,59,48
288,PAN,P001926,P005353,3.033,4,10,6
288,PAN,P001926,P007866,8.633,-3,17,20
288,PAN,P001926,P009622,5.4,-2,15,17
288,PAN,P001926,P011204,19.75,14,54,40
288,PAN,P001926,P011209,0.15,0,2,2
288,PAN,P001926,P012712,22.35,7,59,52
288,PAN,P001926,P012774,27.883,10,73,63
288,PAN,P001926,P013383,10.7,-1,31,32
288,PAN,P004088,P005353,1.733,4,7,3
288,PAN,P004088,P007866,2.85,-6,4,10
288,PAN,P004088,P009622,2.617,-4,5,9
288,PAN,P004088,P011204,16.25,11,43,32
288,PAN,P004088,P011209,0.8,0,0,0
288,PAN,P004088,P012712,17.9,6,45,39
288,PAN,P004088,P012774,21.75,5,54,49
288,PAN,P004088,P013383,8.867,-7,19,26
288,PAN,P005353,P009622,1.3,0,3,3
288,PAN,P005353,P012712,3.033,4,10,6
288,PAN,P005353,P012774,3.033,4,10,6
288,PAN,P007866,P009622,0.783,2,2,0
288,PAN,P007866,P011204,5.0,1,11,10
288,PAN,P007866,P012712,6.8,-7,10,17
288,PAN,P007866,P012774,8.633,-3,17,20
288,PAN,P007866,P013383,1.833,4,7,3
288,PAN,P009622,P011204,4.117,-7,7,14
288,PAN,P009622,P011209,0.15,0,2,2
288,PAN,P009622,P012712,10.434,-13,22,35
288,PAN,P009622,P012774,8.584,-13,15,28
288,PAN,P009622,P013383,8.351,-15,17,32
288,PAN,P011204,P011209,4.533,0,11,11
288,PAN,P011204,P012712,21.717,2,51,49
288,PAN,P011204,P012774,29.1,5,72,67
288,PAN,P011204,P013383,15.933,-6,39,45
288,PAN,P011209,P012712,4.683,0,13,13
288,PAN,P011209,P012774,4.533,0,11,11
288,PAN,P011209,P013383,3.883,0,13,13
288,PAN,P012712,P012774,30.767,-6,70,76
288,PAN,P012712,P013383,12.784,-17,28,45
288,PAN,P012774,P013383,18.317,-14,42,56
288,PRS,P004197,P005793,6.316,-5,11,16
288,PRS,P004197,P007483,3.8,-1,10,11
288,PRS,P004197,P010390,2.633,-4,4,8
288,PRS,P004197,P012608,1.3,-4,3,7
288,PRS,P004197,P012609,10.116,-6,21,27
288,PRS,P004197,P012610,1.3,-4,3,7
288,PRS,P004197,P012611,1.3,-4,3,7
288,PRS,P004197,P012613,0.8,-4,1,5
288,PRS,P004197,P012640,10.116,-6,21,27
288,PRS,P004197,P013373,7.983,-2,19,21
288,PRS,P005793,P010390,1.433,-2,2,4
288,PRS,P005793,P012608,3.05,-2,6,8
288,PRS,P005793,P012609,6.316,-5,11,16
288,PRS,P005793,P012610,3.05,-2,6,8
288,PRS,P005793,P012613,3.05,-2,6,8
288,PRS,P005793,P012640,9.366,-7,17,24
288,PRS,P005793,P013373,4.883,-3,9,12
288,PRS,P007483,P012608,5.683,3,22,19
288,PRS,P007483,P012609,3.8,-1,10,11
288,PRS,P007483,P012610,5.683,3,22,19
288,PRS,P007483,P012611,3.5,2,12,10
288,PRS,P007483,P012613,6.233,1,20,19
288,PRS,P007483,P012640,5.983,0,20,20
288,PRS,P007483,P013373,3.25,1,12,11
288,PRS,P010390,P012608,9.717,11,27,16
288,PRS,P010390,P012609,1.433,-2,2,4
288,PRS,P010390,P012610,9.717,11,27,16
288,PRS,P010390,P012611,9.717,11,27,16
288,PRS,P010390,P012613,8.517,13,25,12
288,PRS,P010390,P012640,1.433,-2,2,4
288,PRS,P012608,P012610,29.883,9,80,71
288,PRS,P012608,P012611,21.1,14,56,42
288,PRS,P012608,P012613,28.533,11,76,65
288,PRS,P012608,P012640,10.933,-6,28,34
288,PRS,P012608,P013373,9.333,0,22,22
288,PRS,P012609,P012613,0.7,-2,0,2
288,PRS,P012609,P012640,10.116,-6,21,27
288,PRS,P012609,P013373,7.983,-2,19,21
288,PRS,P012610,P012611,21.1,14,56,42
288,PRS,P012610,P012613,28.533,11,76,65
288,PRS,P012610,P012640,10.933,-6,28,34
288,PRS,P012610,P013373,9.333,0,22,22
288,PRS,P012611,P012613,19.9,16,54,38
288,PRS,P012611,P012640,2.15,-1,4,5
288,PRS,P012611,P013373,5.633,4,12,8
288,PRS,P012613,P012640,11.483,-8,26,34
288,PRS,P012613,P013373,9.183,0,20,20
288,PRS,P012640,P013373,11.683,-6,29,35
