Gamecode,CODETEAM,J1,TIME,DELTA_SCORE,OFF,DEF
1,ASV,P002100,25.617,-25,49,74
1,ASV,P004194,22.65,-17,45,62
1,ASV,P006568,10.416,-5,15,20
1,ASV,P011225,29.7,-14,57,71
1,ASV,P011386,6.283,-3,7,10
1,ASV,P012080,29.95,-20,58,78
1,ASV,P012729,22.367,-6,38,44
1,ASV,P012730,24.567,-14,48,62
1,ASV,P012731,12.467,-2,22,24
1,ASV,P012732,15.983,1,26,25
1,RED,P000848,16.951,3,31,28
1,RED,P002553,21.534,20,58,38
1,RED,P003479,12.217,12,39,27
1,RED,P004720,5.067,-1,9,10
1,RED,P005099,22.35,4,42,38
1,RED,P006436,27.85,24,77,53
1,RED,P008966,13.067,3,20,17
1,RED,P011224,20.667,20,58,38
1,RED,P011964,14.55,-1,25,26
1,RED,P012711,18.365,8,46,38
1,RED,PJDR,14.616,6,29,23
1,RED,PLUO,12.766,7,36,29
2,BAR,P000925,21.966,14,47,33
2,BAR,P002939,23.433,7,54,47
2,BAR,P003196,16.084,1,38,37
2,BAR,P003478,15.933,15,37,22
2,BAR,P004866,21.5,6,48,42
2,BAR,P006435,24.716,7,54,47
2,BAR,P007464,7.767,1,16,15
2,BAR,P007519,16.567,10,37,27
2,BAR,P009992,14.001,13,35,22
2,BAR,P011244,20.134,3,51,48
2,BAR,P012745,17.899,8,38,30
2,IST,P004554,18.466,1,39,38
2,IST,P004888,27.55,-14,53,67
2,IST,P006372,10.033,-3,21,24
2,IST,P006590,15.499,-15,21,36
2,IST,P007200,32.466,-10,59,69
2,IST,P009513,3.2,-7,2,9
2,IST,P009664,26.949,-13,45,58
2,IST,P009846,16.417,-13,29,42
2,IST,P011078,26.299,-2,56,58
2,IST,P011981,19.433,-16,31,47
2,IST,PLHK,3.683,7,14,7
3,BER,P003958,25.616,-5,39,44
3,BER,P006819,7.218,-12,8,20
3,BER,P006919,26.016,10,52,42
3,BER,P007025,9.534,-6,11,17
3,BER,P007550,16.883,-7,26,33
3,BER,P008173,17.183,-14,29,43
3,BER,P008211,13.534,-3,23,26
3,BER,P008384,15.868,-12,25,37
3,BER,P008967,23.299,4,45,41
3,BER,P012720,28.549,-3,53,56
3,BER,P012721,16.3,-12,29,41
3,MUN,P003583,17.951,6,34,28
3,MUN,P004508,19.65,7,41,34
3,MUN,P005478,11.883,8,30,22
3,MUN,P006760,25.869,0,44,44
3,MUN,P007056,30.952,8,57,49
3,MUN,P007639,2.333,-3,5,8
3,MUN,P007975,18.718,-1,38,39
3,MUN,P008985,21.284,13,42,29
3,MUN,P010391,25.585,22,56,34
3,MUN,P011941,7.818,12,21,9
3,MUN,P011987,17.967,-12,32,44
4,PAR,P000956,5.616,5,16,11
4,PAR,P003983,25.866,-7,56,63
4,PAR,P004058,13.233,-7,22,29
4,PAR,P004172,4.917,-9,9,18
4,PAR,P007400,23.816,-5,54,59
4,PAR,P007673,14.1,0,33,33
4,PAR,P008987,26.066,-18,46,64
4,PAR,P009862,24.516,-21,38,59
4,PAR,P011050,11.15,-11,20,31
4,PAR,P011051,25.316,1,53,52
4,PAR,P012742,19.083,2,43,41
4,PAR,P012743,6.316,-5,15,20
4,TEL,P004233,6.6,-9,12,21
4,TEL,P005145,15.183,14,39,25
4,TEL,P007990,22.516,16,61,45
4,TEL,P009622,24.948,14,61,47
4,TEL,P009783,21.832,19,54,35
4,TEL,P011193,20.197,6,50,44
4,TEL,P011199,15.399,11,37,26
4,TEL,P011214,13.932,-8,31,39
4,TEL,P011219,21.381,1,48,47
4,TEL,P011971,15.532,4,37,33
4,TEL,P012744,22.465,7,50,43
5,VIR,P001133,31.016,-1,66,67
5,VIR,P001844,28.633,-19,46,65
5,VIR,P002084,10.666,-8,13,21
5,VIR,P003048,7.7,-3,10,13
5,VIR,P004007,24.732,9,56,47
5,VIR,P006739,11.366,16,33,17
5,VIR,P008847,25.234,11,58,47
5,VIR,P009549,28.883,-7,58,65
5,VIR,P011192,11.766,0,21,21
5,VIR,P012714,5.332,-4,11,15
5,VIR,PBCN,14.667,-9,23,32
5,ZAL,P002329,28.316,4,59,55
5,ZAL,P002676,20.065,-6,36,42
5,ZAL,P003210,7.783,-10,13,23
5,ZAL,P003211,26.633,22,64,42
5,ZAL,P005504,8.799,-22,9,31
5,ZAL,P007109,25.916,6,52,46
5,ZAL,P007513,0.15,-3,0,3
5,ZAL,P010390,27.516,21,63,42
5,ZAL,P011218,27.365,10,59,49
5,ZAL,P011965,11.932,-3,24,27
5,ZAL,P012715,15.515,-4,31,35
6,MIL,P000796,35.717,-11,65,76
6,MIL,P001518,0.134,-2,0,2
6,MIL,P002812,14.501,1,29,28
6,MIL,P002849,28.201,6,53,47
6,MIL,P005670,15.883,-1,33,34
6,MIL,P006433,27.517,0,46,46
6,MIL,P006509,17.517,-2,30,32
6,MIL,P006701,2.516,-3,3,6
6,MIL,P007201,32.75,-2,63,65
6,MIL,P007831,37.319,5,71,66
6,MIL,P009960,12.95,-6,17,23
6,ULK,P001932,7.933,7,16,9
6,ULK,P002968,6.033,4,11,7
6,ULK,P002969,0.117,2,2,0
6,ULK,P004004,18.633,1,34,33
6,ULK,P005844,31.565,6,62,56
6,ULK,P006661,31.115,6,58,52
6,ULK,P008962,30.699,1,63,62
6,ULK,P009849,30.415,1,59,58
6,ULK,P010560,33.015,-3,61,64
6,ULK,P011052,13.616,-4,26,30
6,ULK,P011157,13.299,-6,20,26
6,ULK,P011980,8.55,0,13,13
7,OLY,P001255,26.3,-8,51,59
7,OLY,P003941,35.567,18,75,57
7,OLY,P006302,0.35,0,0,0
7,OLY,P006589,10.0,-8,13,21
7,OLY,P007853,6.25,-10,6,16
7,OLY,P007982,27.217,5,49,44
7,OLY,P008829,36.833,21,78,57
7,OLY,P008855,38.75,20,82,62
7,OLY,P010392,11.917,-6,17,23
7,OLY,P010612,31.816,18,69,51
7,PAN,P001926,31.199,-1,55,56
7,PAN,P002328,30.383,-10,55,65
7,PAN,P003842,33.666,-6,58,64
7,PAN,P007553,12.45,-9,20,29
7,PAN,P007947,21.216,-17,27,44
7,PAN,P008084,8.05,10,17,7
7,PAN,P011204,32.5,-7,57,64
7,PAN,P011209,0.433,0,0,0
7,PAN,P011221,0.433,0,0,0
7,PAN,P011826,11.466,5,28,23
7,PAN,P012712,43.199,-15,73,88
8,BAS,P004603,11.233,-5,22,27
8,BAS,P004761,16.234,-7,29,36
8,BAS,P007230,27.3,0,48,48
8,BAS,P008072,23.933,7,51,44
8,BAS,P008850,1.684,-6,0,6
8,BAS,P009048,19.784,-2,39,41
8,BAS,P010444,21.234,-1,40,41
8,BAS,P011064,19.0,6,38,32
8,BAS,P011085,12.584,-2,29,31
8,BAS,P011948,23.417,5,48,43
8,BAS,P012201,23.602,-5,41,46
8,MAD,P001392,19.818,6,37,31
8,MAD,P003108,10.284,-1,26,27
8,MAD,P003733,2.217,-4,4,8
8,MAD,P004887,24.932,3,47,44
8,MAD,P005928,22.734,4,44,40
8,MAD,P006540,23.484,-10,42,52
8,MAD,P010357,34.834,9,70,61
8,MAD,P010868,6.151,-2,9,11
8,MAD,PBMT,17.634,11,39,28
8,MAD,PCVM,17.267,-2,35,37
8,MAD,PTGB,20.65,-4,42,46
9,MCO,P004790,7.734,-6,13,19
9,MCO,P005985,33.566,6,60,54
9,MCO,P008099,10.084,-17,10,27
9,MCO,P010588,32.249,11,60,49
9,MCO,P011196,10.101,-13,10,23
9,MCO,P011212,29.45,1,51,50
9,MCO,P011226,24.167,-13,33,46
9,MCO,P011231,18.0,-13,26,39
9,MCO,P012515,11.083,1,17,16
9,MCO,PLCZ,23.566,18,45,27
9,PAM,P000556,4.283,1,5,4
9,PAM,P003960,20.217,-9,26,35
9,PAM,P004863,19.4,16,40,24
9,PAM,P006643,15.4,-6,24,30
9,PAM,P007870,15.117,-2,22,24
9,PAM,P010393,9.484,8,21,13
9,PAM,P010568,25.134,-1,40,41
9,PAM,P011970,8.401,-1,17,18
9,PAM,P011982,21.735,6,43,37
9,PAM,P012738,17.017,13,39,26
9,PAM,P012739,18.434,-4,30,34
9,PAM,P012740,25.383,4,43,39
10,BAS,P004603,18.183,-6,43,49
10,BAS,P004761,22.583,2,54,52
10,BAS,P007230,28.949,12,67,55
10,BAS,P008072,14.316,15,33,18
10,BAS,P009048,26.85,1,53,52
10,BAS,P010444,24.516,11,52,41
10,BAS,P011064,16.183,2,44,42
10,BAS,P011085,4.85,1,15,14
10,BAS,P011948,20.949,-2,41,43
10,BAS,P012201,22.616,-11,53,64
10,BER,P003958,24.766,-7,47,54
10,BER,P006251,17.317,6,48,42
10,BER,P006819,4.033,-3,6,9
10,BER,P006919,23.966,-12,40,52
10,BER,P007550,17.049,-8,30,38
10,BER,P008173,22.951,3,56,53
10,BER,P008211,11.85,7,27,20
10,BER,P008384,19.467,8,52,44
10,BER,P008967,23.867,-9,49,58
10,BER,P012720,20.783,-13,38,51
10,BER,P012721,13.951,3,37,34
11,IST,P004554,23.133,0,53,53
11,IST,P004888,17.232,-30,26,56
11,IST,P006372,22.516,3,51,48
11,IST,P006590,21.883,4,53,49
11,IST,P007200,23.883,-45,33,78
11,IST,P009513,9.417,2,22,20
11,IST,P009664,21.616,-7,48,55
11,IST,P011078,32.482,-10,68,78
11,IST,P011981,15.166,-18,25,43
11,IST,P012415,1.517,0,2,2
11,IST,PLHK,11.15,-14,19,33
11,MAD,P001392,26.132,32,76,44
11,MAD,P003108,22.266,5,54,49
11,MAD,P004887,19.032,1,45,44
11,MAD,P005791,17.45,18,49,31
11,MAD,P005928,26.583,40,83,43
11,MAD,P006540,21.733,22,58,36
11,MAD,P009005,13.682,1,29,28
11,MAD,P009213,1.517,2,4,2
11,MAD,P010357,26.3,22,74,52
11,MAD,PCVM,11.433,-19,16,35
11,MAD,PTGB,13.867,-9,27,36
12,MIL,P000796,31.216,-6,74,80
12,MIL,P001518,5.45,-2,7,9
12,MIL,P002812,5.533,-6,4,10
12,MIL,P002849,23.666,-9,56,65
12,MIL,P006433,19.817,-1,40,41
12,MIL,P006509,6.616,-5,10,15
12,MIL,P007032,20.149,-5,50,55
12,MIL,P007201,30.666,-2,78,80
12,MIL,P007831,33.516,-12,80,92
12,MIL,P009960,13.383,8,33,25
12,MIL,P011205,9.983,0,18,18
12,TEL,P004233,8.483,5,18,13
12,TEL,P005145,11.266,-10,16,26
12,TEL,P007990,2.35,-3,5,8
12,TEL,P009622,30.565,6,76,70
12,TEL,P009783,31.249,6,82,76
12,TEL,P011193,19.798,7,43,36
12,TEL,P011199,23.033,3,62,59
12,TEL,P011214,19.415,12,45,33
12,TEL,P011219,6.116,-2,11,13
12,TEL,P011971,24.799,11,66,55
12,TEL,P012744,22.916,5,66,61
13,MUN,P001557,19.235,7,37,30
13,MUN,P003583,19.951,-4,35,39
13,MUN,P004508,17.884,-3,35,38
13,MUN,P006760,29.25,-7,55,62
13,MUN,P007056,30.284,-11,55,66
13,MUN,P007975,18.902,-3,32,35
13,MUN,P008985,27.384,6,55,49
13,MUN,P010391,13.352,-5,18,23
13,MUN,P011941,7.65,-6,11,17
13,MUN,P011987,16.118,-9,22,31
13,PAN,P002328,23.684,15,58,43
13,PAN,P003842,33.451,6,68,62
13,PAN,P005161,24.3,-2,42,44
13,PAN,P006544,1.467,-2,2,4
13,PAN,P007553,5.7,-4,4,8
13,PAN,P007947,29.817,3,56,53
13,PAN,P008084,15.351,0,32,32
13,PAN,P011204,33.535,9,65,56
13,PAN,P011221,1.117,-1,1,2
13,PAN,P011826,6.466,2,11,9
13,PAN,P012712,25.117,9,51,42
14,ASV,P000229,12.734,2,22,20
14,ASV,P002100,19.316,-12,28,40
14,ASV,P004194,20.183,-19,30,49
14,ASV,P011225,27.051,-21,38,59
14,ASV,P012080,31.25,-18,56,74
14,ASV,P012729,28.05,-26,43,69
14,ASV,P012730,19.434,-6,31,37
14,ASV,P012731,8.066,-1,10,11
14,ASV,P012732,21.583,-28,32,60
14,ASV,PKIR,12.333,-1,20,21
14,PAR,P000956,15.716,16,39,23
14,PAR,P003983,22.865,23,58,35
14,PAR,P004172,9.084,-1,16,17
14,PAR,P007400,32.116,22,71,49
14,PAR,P007673,13.916,3,27,24
14,PAR,P008987,27.982,26,67,41
14,PAR,P009862,22.848,9,45,36
14,PAR,P011050,8.617,1,16,15
14,PAR,P011051,15.282,15,36,21
14,PAR,P012742,15.465,6,29,23
14,PAR,P012743,16.099,10,36,26
15,MCO,P004197,18.5,-11,28,39
15,MCO,P004790,18.532,-6,31,37
15,MCO,P005985,29.85,-21,42,63
15,MCO,P008099,17.367,-2,30,32
15,MCO,P010588,14.284,-9,15,24
15,MCO,P011196,14.766,-9,24,33
15,MCO,P011212,27.633,-20,39,59
15,MCO,P011226,20.2,-12,28,40
15,MCO,P011231,17.185,-11,24,35
15,MCO,P012515,6.45,-6,10,16
15,MCO,PLCZ,15.233,-13,24,37
15,VIR,P001133,25.967,19,56,37
15,VIR,P001844,17.516,12,40,28
15,VIR,P003048,23.699,18,52,34
15,VIR,P003527,3.416,-3,4,7
15,VIR,P004007,20.781,13,43,30
15,VIR,P006739,10.916,2,19,17
15,VIR,P008847,20.848,12,43,31
15,VIR,P009549,16.05,13,35,22
15,VIR,P010781,22.248,8,42,34
15,VIR,P011192,13.266,13,30,17
15,VIR,P012714,5.633,0,9,9
15,VIR,PBCN,19.65,13,42,29
16,BAR,P000925,22.25,14,49,35
16,BAR,P002939,20.266,8,40,32
16,BAR,P003196,17.682,-5,28,33
16,BAR,P003478,14.983,13,34,21
16,BAR,P004866,26.933,10,56,46
16,BAR,P006435,27.999,10,58,48
16,BAR,P007464,12.233,2,21,19
16,BAR,P007519,20.733,0,37,37
16,BAR,P009992,2.75,-2,3,5
16,BAR,P010641,0.067,0,0,0
16,BAR,P011244,20.7,-1,39,40
16,BAR,P012745,13.399,-4,20,24
16,OLY,P001255,29.632,-12,49,61
16,OLY,P003941,27.166,-10,47,57
16,OLY,P006302,8.516,5,16,11
16,OLY,P008811,12.799,1,21,20
16,OLY,P008829,32.215,-7,56,63
16,OLY,P008855,35.582,-13,59,72
16,OLY,P010392,18.182,1,31,30
16,OLY,P010612,17.633,-10,31,41
16,OLY,P011983,18.265,0,30,30
17,PAM,P000556,16.683,4,37,33
17,PAM,P003960,20.616,8,45,37
17,PAM,P004863,5.516,8,15,7
17,PAM,P006643,12.067,1,27,26
17,PAM,P007870,21.283,10,46,36
17,PAM,P009101,9.967,-1,20,21
17,PAM,P010393,5.367,-7,8,15
17,PAM,P010568,27.266,0,48,48
17,PAM,P011982,23.901,-1,43,44
17,PAM,P012738,16.734,3,29,26
17,PAM,P012739,16.067,-8,26,34
17,PAM,P012740,24.533,-2,41,43
17,ULK,P001932,4.083,-6,2,8
17,ULK,P002968,15.768,-1,33,34
17,ULK,P002969,0.067,-2,0,2
17,ULK,P004004,21.418,-2,38,40
17,ULK,P005844,22.8,-6,36,42
17,ULK,P006661,21.369,-2,40,42
17,ULK,P008962,33.37,5,65,60
17,ULK,P009849,24.552,4,50,46
17,ULK,P010560,14.468,-6,21,27
17,ULK,P011052,22.035,2,46,44
17,ULK,P011157,6.251,-1,11,12
17,ULK,P011980,13.834,0,28,28
18,RED,P000848,23.335,5,51,46
18,RED,P002553,22.451,5,41,36
18,RED,P005099,20.367,11,38,27
18,RED,P006436,32.017,-16,56,72
18,RED,P007960,26.633,-5,55,60
18,RED,P008966,6.834,-2,14,16
18,RED,P009035,12.683,-6,23,29
18,RED,P011224,14.816,-6,22,28
18,RED,P011964,12.251,-9,13,22
18,RED,P012711,3.15,-4,4,8
18,RED,PJDR,25.468,2,53,51
18,ZAL,P002329,34.034,13,74,61
18,ZAL,P002676,19.884,-7,36,43
18,ZAL,P003210,3.016,3,6,3
18,ZAL,P003211,29.201,23,65,42
18,ZAL,P005504,11.283,-7,15,22
18,ZAL,P007109,25.635,18,59,41
18,ZAL,P007513,1.75,-7,0,7
18,ZAL,P010390,22.35,-1,43,44
18,ZAL,P011218,25.301,5,53,48
18,ZAL,P011965,11.351,-14,14,28
18,ZAL,P012715,16.2,-1,30,31
19,ASV,P000229,3.4,-8,2,10
19,ASV,P002100,26.583,19,70,51
19,ASV,P004194,23.498,-6,49,55
19,ASV,P006568,16.266,-10,29,39
19,ASV,P011225,31.382,-3,71,74
19,ASV,P011386,8.616,-2,13,15
19,ASV,P012080,15.2,-14,23,37
19,ASV,P012729,23.849,10,61,51
19,ASV,P012730,17.116,-6,31,37
19,ASV,P012731,15.532,9,42,33
19,ASV,P012732,18.548,-14,29,43
19,IST,P004554,24.184,10,55,45
19,IST,P004888,31.801,11,75,64
19,IST,P006372,8.833,-11,16,27
19,IST,P006590,28.867,7,69,62
19,IST,P007200,32.318,16,75,59
19,IST,P009513,2.2,-9,2,11
19,IST,P009664,31.584,4,65,61
19,IST,P011078,16.6,2,36,34
19,IST,P011981,11.85,-2,30,32
19,IST,P012415,2.084,-5,4,9
19,IST,P012710,5.717,5,14,9
19,IST,PLHK,3.967,-3,4,7
20,MIL,P000796,29.834,12,56,44
20,MIL,P002812,6.917,5,7,2
20,MIL,P002849,30.299,15,53,38
20,MIL,P005670,10.483,5,14,9
20,MIL,P006433,29.884,11,55,44
20,MIL,P006509,10.099,1,14,13
20,MIL,P007201,27.25,13,47,34
20,MIL,P007831,31.201,10,56,46
20,MIL,P009960,8.817,-8,10,18
20,MIL,P011205,12.233,-6,9,15
20,MIL,P011926,2.983,2,4,2
20,OLY,P001255,33.016,-13,45,58
20,OLY,P003941,28.383,-8,41,49
20,OLY,P006302,17.366,-15,17,32
20,OLY,P006589,10.232,-6,7,13
20,OLY,P008811,11.616,-4,12,16
20,OLY,P008829,22.333,-6,34,40
20,OLY,P008855,30.916,-3,46,49
20,OLY,P010392,15.167,-2,19,21
20,OLY,P010612,7.5,7,17,10
20,OLY,P011983,18.633,-6,19,25
20,OLY,P012023,4.833,-4,8,12
21,PAN,P001926,22.302,-25,28,53
21,PAN,P002328,22.068,-23,34,57
21,PAN,P003842,26.901,-10,48,58
21,PAN,P007553,4.167,-2,8,10
21,PAN,P007947,19.568,-9,34,43
21,PAN,P008084,19.301,2,39,37
21,PAN,P011204,26.101,8,55,47
21,PAN,P011209,11.235,1,20,19
21,PAN,P011221,8.935,-2,13,15
21,PAN,P011826,18.735,6,36,30
21,PAN,P012712,20.702,-16,30,46
21,ULK,P001932,29.284,22,69,47
21,ULK,P004004,23.183,8,48,40
21,ULK,P005844,21.083,-9,32,41
21,ULK,P006661,20.417,-3,37,40
21,ULK,P006961,12.55,-7,18,25
21,ULK,P008962,27.283,21,65,44
21,ULK,P010560,28.733,27,64,37
21,ULK,P011052,14.016,-8,23,31
21,ULK,P011157,18.917,23,51,28
21,ULK,P011980,4.534,-4,8,12
22,BAR,P000925,22.299,13,53,40
22,BAR,P002939,24.932,6,64,58
22,BAR,P003196,17.567,-4,39,43
22,BAR,P003478,18.883,-1,40,41
22,BAR,P004866,21.349,10,52,42
22,BAR,P006435,27.95,11,73,62
22,BAR,P007464,4.667,2,9,7
22,BAR,P007519,16.017,4,32,28
22,BAR,P009992,6.199,-5,6,11
22,BAR,P010641,0.133,0,0,0
22,BAR,P011244,21.2,13,54,41
22,BAR,P012745,18.799,-4,38,42
22,PAR,P000956,9.117,5,18,13
22,PAR,P003983,20.733,2,37,35
22,PAR,P004058,5.232,-4,7,11
22,PAR,P007400,25.416,-11,58,69
22,PAR,P007673,16.316,8,38,30
22,PAR,P008987,30.933,-11,58,69
22,PAR,P009862,27.032,-16,59,75
22,PAR,P011050,9.917,1,24,23
22,PAR,P011051,19.484,-7,42,49
22,PAR,P012742,21.916,-14,48,62
22,PAR,P012743,13.899,2,26,24
23,MAD,P001392,10.55,-6,17,23
23,MAD,P003108,7.784,6,23,17
23,MAD,P004887,20.751,8,53,45
23,MAD,P005791,19.25,6,40,34
23,MAD,P005928,23.3,5,52,47
23,MAD,P006540,13.383,0,23,23
23,MAD,P009005,22.817,2,51,49
23,MAD,P010357,23.834,0,46,46
23,MAD,PBMT,21.617,24,64,40
23,MAD,PCVM,16.701,9,41,32
23,MAD,PTGB,20.018,16,55,39
23,ZAL,P002329,28.215,-14,57,71
23,ZAL,P003210,16.649,-1,38,39
23,ZAL,P003211,10.166,-8,17,25
23,ZAL,P005504,12.867,2,29,27
23,ZAL,P006860,4.95,2,10,8
23,ZAL,P007109,24.265,-4,47,51
23,ZAL,P007513,21.582,3,41,38
23,ZAL,P010390,18.716,-11,32,43
23,ZAL,P011218,23.266,-13,41,54
23,ZAL,P011965,20.116,-9,43,52
23,ZAL,P012715,19.198,-17,40,57
24,BAS,P004603,22.317,-7,42,49
24,BAS,P004761,23.3,-5,40,45
24,BAS,P007230,28.984,-9,46,55
24,BAS,P008072,17.55,1,26,25
24,BAS,P008850,0.133,-2,0,2
24,BAS,P009048,22.383,-9,39,48
24,BAS,P010444,21.583,-9,42,51
24,BAS,P011064,17.617,1,29,28
24,BAS,P011085,7.25,4,15,11
24,BAS,P011948,20.333,-4,35,39
24,BAS,P012201,18.55,-1,26,27
24,MUN,P001557,22.282,17,43,26
24,MUN,P004508,20.899,14,39,25
24,MUN,P005478,4.117,-1,10,11
24,MUN,P006245,0.4,-3,0,3
24,MUN,P006760,13.2,-7,24,31
24,MUN,P007056,27.782,3,55,52
24,MUN,P007639,12.234,-2,18,20
24,MUN,P007975,23.099,11,46,35
24,MUN,P008985,16.5,0,30,30
24,MUN,P010391,27.432,13,51,38
24,MUN,P011941,13.133,-2,24,26
24,MUN,P011987,18.917,-3,40,43
25,MCO,P002581,6.084,-12,8,20
25,MCO,P004197,12.367,0,25,25
25,MCO,P004790,10.068,-16,13,29
25,MCO,P005985,35.752,6,78,72
25,MCO,P010588,24.251,17,53,36
25,MCO,P011196,13.834,-1,27,28
25,MCO,P011212,31.501,11,62,51
25,MCO,P011226,20.635,0,44,44
25,MCO,P011231,17.751,15,44,29
25,MCO,P012709,10.317,-9,14,23
25,MCO,PLCZ,17.45,19,42,23
25,RED,P000848,25.3,1,51,50
25,RED,P002553,12.583,-7,19,26
25,RED,P004720,6.25,-6,8,14
25,RED,P005099,24.766,-6,42,48
25,RED,P006436,29.716,-5,63,68
25,RED,P007960,21.551,10,43,33
25,RED,P008966,12.383,-5,22,27
25,RED,P009035,15.517,3,35,32
25,RED,P011224,21.933,-5,39,44
25,RED,P011964,1.65,-1,4,5
25,RED,P012711,10.433,-4,21,25
25,RED,PJDR,17.918,-5,33,38
26,PAM,P000556,22.8,12,48,36
26,PAM,P003960,20.166,-9,38,47
26,PAM,P004863,19.45,23,47,24
26,PAM,P006643,21.216,-5,36,41
26,PAM,P007870,17.801,-5,32,37
26,PAM,P009101,3.983,7,11,4
26,PAM,P010393,14.733,14,29,15
26,PAM,P010568,25.55,3,46,43
26,PAM,P010754,2.434,4,5,1
26,PAM,P012738,15.484,15,30,15
26,PAM,P012739,11.816,3,21,18
26,PAM,P012740,24.567,-17,32,49
26,TEL,P005145,13.283,8,35,27
26,TEL,P007990,20.184,-24,21,45
26,TEL,P009622,33.766,7,65,58
26,TEL,P009783,31.533,7,61,54
26,TEL,P011193,21.033,-8,34,42
26,TEL,P011199,21.267,3,34,31
26,TEL,P011214,20.9,-11,34,45
26,TEL,P011219,11.25,-12,10,22
26,TEL,P011971,14.617,-6,17,23
26,TEL,P012744,12.167,-9,19,28
27,BER,P003958,26.817,8,60,52
27,BER,P006251,14.867,-18,18,36
27,BER,P006819,1.0,0,2,2
27,BER,P006919,20.384,-4,45,49
27,BER,P007025,12.35,-9,19,28
27,BER,P007550,14.101,-18,17,35
27,BER,P008173,14.866,-4,30,34
27,BER,P008211,11.034,11,29,18
27,BER,P008384,13.467,-13,19,32
27,BER,P008967,27.651,-2,57,59
27,BER,P012720,26.534,2,57,55
27,BER,P012721,16.934,-8,27,35
27,VIR,P001133,27.366,14,68,54
27,VIR,P001844,20.7,-8,42,50
27,VIR,P003048,21.316,8,50,42
27,VIR,P003527,12.633,-3,19,22
27,VIR,P004007,14.899,5,31,26
27,VIR,P006739,19.299,19,45,26
27,VIR,P008847,18.683,3,37,34
27,VIR,P009549,25.517,0,54,54
27,VIR,P010781,6.183,6,14,8
27,VIR,P011192,8.999,4,19,15
27,VIR,PBCN,24.4,7,56,49
28,ASV,P000229,1.034,-4,1,5
28,ASV,P002100,24.814,-19,51,70
28,ASV,P004194,25.266,-10,57,67
28,ASV,P006568,24.699,-7,49,56
28,ASV,P011225,20.233,9,50,41
28,ASV,P011386,5.266,-6,11,17
28,ASV,P012729,18.265,-13,37,50
28,ASV,P012730,11.232,1,28,27
28,ASV,P012731,11.315,-5,25,30
28,ASV,P012732,28.383,-9,59,68
28,ASV,PKIR,29.483,-12,62,74
28,ULK,P001932,23.701,13,60,47
28,ULK,P002968,7.183,-11,11,22
28,ULK,P004004,20.967,5,48,43
28,ULK,P005844,10.0,1,27,26
28,ULK,P006661,20.066,6,51,45
28,ULK,P006961,22.234,27,67,40
28,ULK,P008962,27.882,22,76,54
28,ULK,P010560,22.651,-8,50,58
28,ULK,P011052,15.066,6,41,35
28,ULK,P011157,30.0,14,74,60
28,ULK,P011980,0.25,0,0,0
29,OLY,P001255,39.583,9,88,79
29,OLY,P003941,26.416,14,67,53
29,OLY,P006302,5.5,-4,8,12
29,OLY,P007982,31.15,8,71,63
29,OLY,P008811,18.583,-10,31,41
29,OLY,P008829,20.082,-13,33,46
29,OLY,P008855,37.266,7,84,77
29,OLY,P010392,21.999,14,57,43
29,OLY,P010612,24.416,-5,51,56
29,PAR,P000956,34.716,0,74,74
29,PAR,P003983,19.583,-6,33,39
29,PAR,P004058,3.217,-2,8,10
29,PAR,P007400,34.3,-7,70,77
29,PAR,P007673,3.183,-2,8,10
29,PAR,P008987,41.484,-5,86,91
29,PAR,P009862,36.517,3,76,73
29,PAR,P011050,10.016,-11,21,32
29,PAR,P011051,15.783,9,32,23
29,PAR,P012742,9.8,-5,25,30
29,PAR,P012743,16.401,6,37,31
30,MAD,P003108,21.368,7,41,34
30,MAD,P004887,18.084,11,38,27
30,MAD,P005791,11.017,3,27,24
30,MAD,P005928,19.851,6,46,40
30,MAD,P006540,17.683,6,41,35
30,MAD,P009005,20.567,14,53,39
30,MAD,P009213,7.584,-4,13,17
30,MAD,P010357,25.283,14,59,45
30,MAD,PBMT,19.051,2,35,33
30,MAD,PCVM,18.2,15,40,25
30,MAD,PTGB,21.317,11,47,36
30,MIL,P000796,26.683,-13,48,61
30,MIL,P001518,5.399,-5,9,14
30,MIL,P002812,4.05,-2,9,11
30,MIL,P002849,18.367,-7,33,40
30,MIL,P005670,18.783,-6,31,37
30,MIL,P006433,21.4,-7,41,48
30,MIL,P006509,9.417,-7,17,24
30,MIL,P007201,21.467,-12,37,49
30,MIL,P007831,32.432,-18,54,72
30,MIL,P009960,14.932,-4,30,34
30,MIL,P011205,24.282,-4,42,46
30,MIL,P011926,2.783,0,4,4
31,BAS,P003198,8.384,-10,14,24
31,BAS,P004603,13.717,-5,26,31
31,BAS,P004761,17.967,-22,31,53
31,BAS,P007230,26.751,-26,47,73
31,BAS,P009048,24.083,2,53,51
31,BAS,P010444,24.634,-11,52,63
31,BAS,P011064,15.085,-14,31,45
31,BAS,P011085,15.9,5,39,34
31,BAS,P011948,25.934,-9,53,62
31,BAS,P012201,27.55,5,64,59
31,ZAL,P002329,33.417,13,84,71
31,ZAL,P002676,15.302,3,36,33
31,ZAL,P003211,17.385,-7,32,39
31,ZAL,P005504,8.2,14,23,9
31,ZAL,P006860,0.533,1,1,0
31,ZAL,P007109,25.502,16,67,51
31,ZAL,P007513,22.617,24,67,43
31,ZAL,P010390,11.268,-10,19,29
31,ZAL,P011218,24.685,-1,55,56
31,ZAL,P011965,13.1,13,36,23
31,ZAL,P012715,28.001,19,75,56
32,IST,P004554,12.934,-7,21,28
32,IST,P004888,34.183,0,63,63
32,IST,P006372,9.65,-2,21,23
32,IST,P006590,23.434,12,51,39
32,IST,P007200,32.133,2,59,57
32,IST,P009664,24.417,10,49,39
32,IST,P011078,28.3,2,55,53
32,IST,P011981,26.899,9,54,45
32,IST,P012710,8.05,-6,12,18
32,PAM,P000556,20.617,-4,34,38
32,PAM,P003960,19.651,10,46,36
32,PAM,P004863,22.185,-12,36,48
32,PAM,P006643,18.734,-4,34,38
32,PAM,P007870,22.05,4,47,43
32,PAM,P009101,7.049,-10,11,21
32,PAM,P010393,17.767,-9,26,35
32,PAM,P010568,27.033,6,53,47
32,PAM,P012738,10.417,-6,14,20
32,PAM,P012739,10.734,-5,15,20
32,PAM,P012740,23.768,10,49,39
33,BER,P003958,25.101,-21,37,58
33,BER,P006251,15.367,-2,30,32
33,BER,P006819,11.866,9,26,17
33,BER,P006919,21.517,-7,34,41
33,BER,P007025,5.067,1,13,12
33,BER,P008173,19.867,-16,30,46
33,BER,P008211,20.134,5,45,40
33,BER,P008384,15.134,1,35,34
33,BER,P008967,26.667,-17,41,58
33,BER,P012720,24.334,-3,52,55
33,BER,P012721,14.951,-5,32,37
33,MCO,P002581,3.483,-7,6,13
33,MCO,P004197,13.833,1,41,40
33,MCO,P004790,13.633,-4,22,26
33,MCO,P005985,27.801,12,60,48
33,MCO,P008099,14.284,9,22,13
33,MCO,P010588,19.834,17,41,24
33,MCO,P011196,16.684,1,39,38
33,MCO,P011212,21.917,-1,44,45
33,MCO,P011226,29.401,7,60,53
33,MCO,P011231,11.601,-1,30,31
33,MCO,P012709,12.7,5,31,26
33,MCO,PLCZ,14.834,16,34,18
34,BAR,P000925,11.967,14,31,17
34,BAR,P002939,18.45,14,41,27
34,BAR,P003196,17.649,20,40,20
34,BAR,P003478,5.283,5,13,8
34,BAR,P004866,17.2,23,45,22
34,BAR,P006435,13.967,18,37,19
34,BAR,P007464,22.799,16,53,37
34,BAR,P007519,21.549,25,57,32
34,BAR,P009992,20.749,16,48,32
34,BAR,P010641,10.383,5,27,22
34,BAR,P011244,16.683,19,41,22
34,BAR,P012745,23.316,20,57,37
34,MUN,P001557,22.2,-18,30,48
34,MUN,P003583,22.517,-16,39,55
34,MUN,P004508,24.1,-15,37,52
34,MUN,P005460,10.233,-15,10,25
34,MUN,P006245,7.75,-2,19,21
34,MUN,P006760,15.351,-17,24,41
34,MUN,P007056,13.001,-16,20,36
34,MUN,P007975,17.55,-18,26,44
34,MUN,P008985,16.784,-19,21,40
34,MUN,P010391,24.117,-15,41,56
34,MUN,P011941,12.584,-20,13,33
34,MUN,P011987,13.818,-24,15,39
35,PAN,P001926,32.134,-4,53,57
35,PAN,P002328,34.418,6,71,65
35,PAN,P003842,23.052,-2,41,43
35,PAN,P007553,8.484,-1,16,17
35,PAN,P007866,26.068,8,43,35
35,PAN,P007947,27.802,-9,51,60
35,PAN,P008084,8.317,-6,12,18
35,PAN,P011204,21.269,1,35,34
35,PAN,P011209,9.702,3,23,20
35,PAN,P011221,13.484,-4,24,28
35,PAN,P011826,5.566,-6,6,12
35,PAN,P012712,14.719,-11,30,41
35,TEL,P004233,6.784,0,11,11
35,TEL,P005145,18.034,2,34,32
35,TEL,P007990,26.051,-1,49,50
35,TEL,P009622,36.468,8,69,61
35,TEL,P009783,35.968,2,68,66
35,TEL,P011193,23.402,4,48,44
35,TEL,P011199,28.833,7,52,45
35,TEL,P011214,14.884,1,30,29
35,TEL,P011219,14.602,-8,26,34
35,TEL,P011971,4.767,5,13,8
35,TEL,P012744,15.217,5,30,25
36,RED,P000848,9.166,-10,17,27
36,RED,P002553,22.582,-8,49,57
36,RED,P005099,18.382,-3,36,39
36,RED,P006436,21.366,-9,43,52
36,RED,P007960,16.517,0,25,25
36,RED,P009035,31.766,-1,62,63
36,RED,P011224,28.334,0,59,59
36,RED,P012044,4.149,0,7,7
36,RED,P012711,8.683,0,20,20
36,RED,PJDR,25.266,3,55,52
36,RED,PLUO,13.784,-2,22,24
36,VIR,P001133,29.548,-3,59,62
36,VIR,P001844,17.449,2,38,36
36,VIR,P003048,19.316,17,43,26
36,VIR,P004007,11.382,-2,22,24
36,VIR,P006739,14.867,2,34,32
36,VIR,P008847,27.215,-7,53,60
36,VIR,P009549,27.682,0,62,62
36,VIR,P010781,19.115,-2,36,38
36,VIR,P011192,6.483,11,17,6
36,VIR,P012714,3.384,2,10,8
36,VIR,PBCN,23.549,10,51,41
37,BER,P003958,29.766,15,70,55
37,BER,P006251,16.516,-17,29,46
37,BER,P006819,9.183,0,15,15
37,BER,P006919,25.667,14,62,48
37,BER,P007550,3.533,-11,2,13
37,BER,P008173,19.267,7,41,34
37,BER,P008211,17.2,7,42,35
37,BER,P008384,11.783,-13,18,31
37,BER,P008967,19.734,-5,40,45
37,BER,P010791,13.9,8,33,25
37,BER,P012720,27.8,21,69,48
37,BER,P012721,5.651,-11,4,15
37,MIL,P000796,30.751,7,68,61
37,MIL,P002812,11.483,-13,23,36
37,MIL,P002849,17.067,-4,31,35
37,MIL,P005670,2.383,-3,4,7
37,MIL,P006433,25.201,-8,47,55
37,MIL,P006509,10.95,-7,17,24
37,MIL,P007032,17.051,3,42,39
37,MIL,P007201,16.868,-1,31,32
37,MIL,P007831,33.251,-9,67,76
37,MIL,P009960,10.45,0,18,18
37,MIL,P011205,24.55,20,62,42
38,IST,P004554,16.649,-7,26,33
38,IST,P004888,25.833,-13,36,49
38,IST,P006372,10.1,-4,14,18
38,IST,P006590,23.115,-12,34,46
38,IST,P007200,29.117,-19,42,61
38,IST,P009513,3.65,5,9,4
38,IST,P009664,22.633,-11,35,46
38,IST,P009846,23.582,-12,31,43
38,IST,P011078,18.982,-3,27,30
38,IST,P011981,10.151,-4,8,12
38,IST,PLHK,16.183,-10,23,33
38,OLY,P001255,28.084,21,61,40
38,OLY,P003941,21.8,15,52,37
38,OLY,P006302,2.417,-5,0,5
38,OLY,P007982,23.851,20,49,29
38,OLY,P008811,18.2,3,23,20
38,OLY,P008829,19.399,8,31,23
38,OLY,P008855,21.816,8,45,37
38,OLY,P010392,18.5,10,30,20
38,OLY,P010612,26.233,13,54,41
38,OLY,P010631,1.083,-3,0,3
38,OLY,P011983,17.117,5,30,25
38,OLY,P012023,1.5,-5,0,5
39,PAR,P000956,11.268,-10,24,34
39,PAR,P003983,22.2,-3,52,55
39,PAR,P004058,25.818,10,60,50
39,PAR,P007400,28.151,11,71,60
39,PAR,P007673,0.85,-2,0,2
39,PAR,P008987,31.334,-5,58,63
39,PAR,P009862,27.95,-3,51,54
39,PAR,P011051,17.25,5,43,38
39,PAR,P012742,13.3,10,38,28
39,PAR,P012743,21.884,-3,43,46
39,RED,P002553,23.166,19,60,41
39,RED,P005099,27.851,3,57,54
39,RED,P006436,18.815,-18,31,49
39,RED,P007960,19.732,-16,34,50
39,RED,P008966,10.15,7,24,17
39,RED,P009035,26.967,-13,55,68
39,RED,P011224,28.233,-5,61,66
39,RED,P012044,20.783,11,49,38
39,RED,PJDR,24.298,2,59,57
40,BAR,P000925,24.3,13,46,33
40,BAR,P002939,26.1,8,43,35
40,BAR,P003196,15.633,-11,18,29
40,BAR,P003478,27.033,6,49,43
40,BAR,P004866,28.7,7,53,46
40,BAR,P007464,13.834,-10,13,23
40,BAR,P007519,22.35,1,41,40
40,BAR,P009992,13.383,-8,18,26
40,BAR,P010641,0.067,-3,0,3
40,BAR,P011244,18.3,-2,28,30
40,BAR,P012745,10.3,-6,11,17
40,MAD,P003108,21.234,10,42,32
40,MAD,P003733,7.2,-8,6,14
40,MAD,P004887,19.649,14,41,27
40,MAD,P005791,16.633,-20,17,37
40,MAD,P005928,23.367,5,41,36
40,MAD,P006540,18.6,11,34,23
40,MAD,P009005,28.566,-1,46,47
40,MAD,P009213,8.549,12,18,6
40,MAD,PBMT,18.632,-5,24,29
40,MAD,PCVM,16.682,-4,24,28
40,MAD,PTGB,20.883,-9,32,41
41,MCO,P002581,6.35,-3,13,16
41,MCO,P004197,14.35,17,38,21
41,MCO,P004790,17.883,1,47,46
41,MCO,P005985,21.383,24,58,34
41,MCO,P010588,24.484,27,64,37
41,MCO,P011196,11.366,4,34,30
41,MCO,P011212,25.8,12,66,54
41,MCO,P011226,25.517,28,68,40
41,MCO,P011231,12.466,4,37,33
41,MCO,P012515,5.667,-3,13,16
41,MCO,P012709,17.05,8,51,43
41,MCO,PLCZ,17.684,21,46,25
41,TEL,P004233,9.267,0,26,26
41,TEL,P005145,10.3,-6,19,25
41,TEL,P007990,18.966,-10,36,46
41,TEL,P009622,24.75,-22,38,60
41,TEL,P009783,19.65,-29,25,54
41,TEL,P011193,21.234,-10,53,63
41,TEL,P011199,22.466,-9,46,55
41,TEL,P011214,13.684,-22,16,38
41,TEL,P011219,19.4,-20,38,58
41,TEL,P011433,6.35,3,16,13
41,TEL,P011971,16.983,-3,43,46
41,TEL,P012744,16.95,-12,39,51
42,ASV,P000229,4.05,4,8,4
42,ASV,P002100,17.433,-6,35,41
42,ASV,P003274,3.617,-1,11,12
42,ASV,P003526,9.45,-8,16,24
42,ASV,P004194,24.467,7,53,46
42,ASV,P006568,24.417,3,53,50
42,ASV,P011225,29.05,7,66,59
42,ASV,P011386,10.933,-10,18,28
42,ASV,P012729,25.75,-4,55,59
42,ASV,P012730,7.833,-11,14,25
42,ASV,P012732,21.284,3,47,44
42,ASV,PKIR,21.716,1,44,43
42,VIR,P001133,34.299,11,79,68
42,VIR,P001844,24.167,0,52,52
42,VIR,P003048,16.667,0,40,40
42,VIR,P003527,2.6,-5,2,7
42,VIR,P004007,12.199,-7,20,27
42,VIR,P006739,16.015,3,35,32
42,VIR,P008847,20.799,6,47,41
42,VIR,P009549,29.966,12,72,60
42,VIR,P010781,11.083,-2,21,23
42,VIR,P011192,2.767,-3,2,5
42,VIR,P012714,5.45,-6,6,12
42,VIR,PBCN,23.983,6,59,53
43,MUN,P001557,4.633,-9,8,17
43,MUN,P003583,19.914,-5,31,36
43,MUN,P004508,18.183,5,31,26
43,MUN,P006245,3.4,-5,2,7
43,MUN,P006760,27.582,-2,43,45
43,MUN,P007056,24.249,3,37,34
43,MUN,P007975,22.698,-10,38,48
43,MUN,P008985,19.848,8,37,29
43,MUN,P010391,25.997,-9,48,57
43,MUN,P011941,16.099,-4,31,35
43,MUN,P011987,17.382,-17,29,46
43,ULK,P001932,19.549,-5,29,34
43,ULK,P004004,29.066,2,48,46
43,ULK,P005844,19.7,12,45,33
43,ULK,P006661,23.933,15,53,38
43,ULK,P006961,9.883,7,25,18
43,ULK,P008962,31.733,1,54,53
43,ULK,P009849,16.0,12,38,26
43,ULK,P010560,21.099,-9,31,40
43,ULK,P011157,20.299,-3,31,34
43,ULK,P011980,8.733,13,26,13
44,BAS,P004603,29.15,-17,55,72
44,BAS,P004761,22.9,-9,47,56
44,BAS,P007230,29.367,-12,55,67
44,BAS,P008850,22.168,-11,45,56
44,BAS,P009048,27.985,-8,60,68
44,BAS,P010444,17.45,0,37,37
44,BAS,P011064,21.85,-8,45,53
44,BAS,P011948,29.135,-5,61,66
44,PAN,P001926,25.818,0,56,56
44,PAN,P002328,31.068,17,74,57
44,PAN,P003842,28.434,19,77,58
44,PAN,P007553,4.784,-1,7,8
44,PAN,P007866,29.318,12,76,64
44,PAN,P007947,10.567,-9,17,26
44,PAN,P011204,28.385,24,75,51
44,PAN,P011209,1.484,-3,1,4
44,PAN,P011221,6.784,-4,11,15
44,PAN,P011826,19.867,15,55,40
44,PAN,P012712,13.501,0,26,26
45,PAM,P000556,17.917,4,33,29
45,PAM,P003960,16.082,-7,26,33
45,PAM,P004863,19.548,13,48,35
45,PAM,P006643,5.882,-3,13,16
45,PAM,P007870,23.249,-3,43,46
45,PAM,P010393,8.166,1,15,14
45,PAM,P010568,23.149,1,43,42
45,PAM,P011970,13.883,16,38,22
45,PAM,P011982,16.832,11,42,31
45,PAM,P012738,15.75,21,46,25
45,PAM,P012739,16.682,18,44,26
45,PAM,P012740,22.85,3,44,41
45,ZAL,P002329,22.251,-17,34,51
45,ZAL,P002676,24.066,-11,44,55
45,ZAL,P003210,11.182,-4,21,25
45,ZAL,P003211,18.483,1,39,38
45,ZAL,P005504,11.449,-4,19,23
45,ZAL,P007109,26.399,-9,49,58
45,ZAL,P007513,9.65,-2,16,18
45,ZAL,P010184,1.5,3,3,0
45,ZAL,P010390,18.666,-3,37,40
45,ZAL,P011218,26.116,-3,47,50
45,ZAL,P011965,10.333,-14,17,31
45,ZAL,P012715,19.9,-12,34,46
46,MCO,P002581,6.083,1,12,11
46,MCO,P004790,4.316,5,10,5
46,MCO,P005985,31.316,2,56,54
46,MCO,P008099,5.067,4,10,6
46,MCO,P009754,19.5,12,42,30
46,MCO,P010588,20.05,-6,34,40
46,MCO,P011196,13.55,8,31,23
46,MCO,P011212,29.517,2,51,49
46,MCO,P011226,30.55,11,60,49
46,MCO,P011231,21.217,-1,32,33
46,MCO,PLCZ,18.834,-8,22,30
46,MIL,P000796,28.966,2,47,45
46,MIL,P001518,3.4,2,6,4
46,MIL,P002812,4.932,-6,5,11
46,MIL,P002849,18.133,1,32,31
46,MIL,P005670,10.967,-3,18,21
46,MIL,P006509,29.883,-8,50,58
46,MIL,P007032,23.549,1,41,40
46,MIL,P007201,10.05,-4,19,23
46,MIL,P007831,30.565,-5,51,56
46,MIL,P009960,19.067,-2,32,34
46,MIL,P011205,20.483,-8,29,37
47,MUN,P001557,3.4,0,5,5
47,MUN,P003583,32.433,6,63,57
47,MUN,P004508,13.335,-13,17,30
47,MUN,P005460,5.318,-3,8,11
47,MUN,P006760,26.95,-7,43,50
47,MUN,P007056,29.983,7,59,52
47,MUN,P007975,24.101,-7,36,43
47,MUN,P008985,15.1,9,31,22
47,MUN,P010391,16.234,-16,25,41
47,MUN,P011941,7.251,-10,5,15
47,MUN,P011987,25.9,4,48,44
47,RED,P002553,24.018,-10,36,46
47,RED,P004720,0.417,0,0,0
47,RED,P005099,15.719,-13,22,35
47,RED,P006436,27.6,18,58,40
47,RED,P007960,20.268,10,42,32
47,RED,P008966,13.583,16,27,11
47,RED,P009035,26.285,-13,44,57
47,RED,P011224,21.301,-14,34,48
47,RED,P012044,18.2,14,36,22
47,RED,P012711,5.634,1,9,8
47,RED,PJDR,26.985,21,62,41
48,MAD,P003108,22.7,12,57,45
48,MAD,P003733,17.183,9,38,29
48,MAD,P004887,15.9,17,45,28
48,MAD,P005791,20.466,14,46,32
48,MAD,P005928,26.033,17,67,50
48,MAD,P006540,20.9,21,56,35
48,MAD,P009005,26.283,20,67,47
48,MAD,P009213,13.501,10,33,23
48,MAD,P011649,3.75,2,7,5
48,MAD,PBMT,15.467,14,40,26
48,MAD,PCVM,13.967,12,32,20
48,MAD,PTGB,3.85,-3,7,10
48,TEL,P004233,5.95,-11,5,16
48,TEL,P005145,9.65,-8,17,25
48,TEL,P009622,33.566,-7,64,71
48,TEL,P009783,23.65,-15,41,56
48,TEL,P009863,26.516,-28,40,68
48,TEL,P011193,13.582,-11,28,39
48,TEL,P011199,23.666,-11,39,50
48,TEL,P011214,16.333,-14,32,46
48,TEL,P011219,7.267,-10,12,22
48,TEL,P011433,2.617,-1,4,5
48,TEL,P011971,18.299,-9,38,47
48,TEL,P012744,18.899,-20,30,50
49,ASV,P000229,4.117,-2,9,11
49,ASV,P002100,22.366,9,60,51
49,ASV,P003526,9.9,-12,18,30
49,ASV,P004194,34.234,-1,73,74
49,ASV,P006568,19.316,-10,43,53
49,ASV,P011225,20.233,-12,45,57
49,ASV,P012080,25.983,14,60,46
49,ASV,P012729,26.45,17,66,49
49,ASV,P012731,3.367,-4,6,10
49,ASV,P012732,15.117,-3,29,32
49,ASV,PKIR,18.917,19,46,27
49,ZAL,P002329,27.116,-1,54,55
49,ZAL,P002676,18.25,-10,30,40
49,ZAL,P003210,15.167,17,46,29
49,ZAL,P003211,24.433,-2,53,55
49,ZAL,P005504,13.75,-6,32,38
49,ZAL,P007109,20.5,3,48,45
49,ZAL,P007513,6.95,-5,12,17
49,ZAL,P010390,21.533,14,54,40
49,ZAL,P011218,28.884,-10,59,69
49,ZAL,P011965,8.033,-7,18,25
49,ZAL,P012715,15.384,-8,34,42
50,OLY,P001255,35.066,-7,66,73
50,OLY,P003941,19.533,-3,38,41
50,OLY,P007982,23.799,-4,42,46
50,OLY,P008811,20.466,1,39,38
50,OLY,P008829,31.966,5,68,63
50,OLY,P008855,23.132,3,51,48
50,OLY,P010392,4.584,-2,5,7
50,OLY,P010612,29.599,-2,58,60
50,OLY,P011983,11.85,-1,18,19
50,ULK,P001932,19.85,2,38,36
50,ULK,P004004,20.5,7,44,37
50,ULK,P005844,24.35,1,48,47
50,ULK,P006661,24.9,-6,46,52
50,ULK,P008962,40.0,2,79,77
50,ULK,P009849,22.567,-7,40,47
50,ULK,P010560,8.333,14,27,13
50,ULK,P011052,12.616,2,29,27
50,ULK,P011157,15.65,1,31,30
50,ULK,P011980,11.234,-6,13,19
51,BAR,P000925,16.983,23,42,19
51,BAR,P002939,19.35,18,45,27
51,BAR,P003196,15.6,0,31,31
51,BAR,P003204,20.933,-8,35,43
51,BAR,P003478,14.049,6,27,21
51,BAR,P004866,25.134,11,57,46
51,BAR,P007464,14.866,-3,23,26
51,BAR,P009992,24.384,5,51,46
51,BAR,P010641,7.417,-15,7,22
51,BAR,P011244,13.767,-3,22,25
51,BAR,P011666,1.367,-6,2,8
51,BAR,P012745,26.15,12,58,46
51,PAN,P002328,24.567,-20,37,57
51,PAN,P003842,18.883,-11,31,42
51,PAN,P006544,10.567,17,28,11
51,PAN,P007553,17.118,11,39,28
51,PAN,P007866,30.517,-10,47,57
51,PAN,P008084,11.868,12,29,17
51,PAN,P011204,32.068,-19,53,72
51,PAN,P011209,14.884,-16,25,41
51,PAN,P011442,1.367,6,8,2
51,PAN,P011826,19.783,1,32,31
51,PAN,P012712,18.383,-11,31,42
52,BAS,P004603,23.251,1,49,48
52,BAS,P004761,30.1,5,60,55
52,BAS,P007230,31.433,-3,64,67
52,BAS,P008850,11.6,-9,24,33
52,BAS,P009048,29.917,3,66,63
52,BAS,P010444,15.682,-1,31,32
52,BAS,P011948,24.4,4,55,51
52,BAS,P012201,19.6,4,41,37
52,BAS,P012765,14.017,1,30,29
52,PAR,P000956,18.116,2,38,36
52,PAR,P003983,22.016,-5,40,45
52,PAR,P004058,20.733,1,45,44
52,PAR,P007400,29.116,2,63,61
52,PAR,P007673,21.066,-1,45,46
52,PAR,P008987,22.499,-3,51,54
52,PAR,P009212,18.733,0,35,35
52,PAR,P011051,15.151,-3,27,30
52,PAR,P012742,8.95,-2,18,20
52,PAR,P012743,23.615,4,53,49
53,BER,P003958,30.466,-12,50,62
53,BER,P006251,15.716,3,33,30
53,BER,P006819,5.117,1,9,8
53,BER,P006919,25.15,-11,39,50
53,BER,P008173,21.433,-4,37,41
53,BER,P008211,18.566,-4,34,38
53,BER,P008384,12.849,0,25,25
53,BER,P008967,21.183,-6,42,48
53,BER,P010791,11.299,-4,16,20
53,BER,P012720,26.8,-8,45,53
53,BER,P012721,11.416,5,25,20
53,PAM,P003960,21.716,6,44,38
53,PAM,P004863,14.467,0,27,27
53,PAM,P006643,13.716,-4,23,27
53,PAM,P007870,18.267,11,45,34
53,PAM,P009101,6.2,-1,14,15
53,PAM,P010393,8.084,-1,16,17
53,PAM,P010568,23.635,16,51,35
53,PAM,P011970,20.217,13,46,33
53,PAM,P011982,24.702,13,52,39
53,PAM,P012738,16.034,-5,24,29
53,PAM,P012739,15.4,-2,24,26
53,PAM,P012740,17.567,-6,29,35
54,IST,P004554,17.383,-1,37,38
54,IST,P004888,25.268,-12,53,65
54,IST,P006590,33.767,-8,70,78
54,IST,P007200,32.217,-11,65,76
54,IST,P009664,22.817,-8,41,49
54,IST,P009846,19.851,-5,44,49
54,IST,P011078,25.601,-4,51,55
54,IST,P011981,23.101,-11,44,55
54,VIR,P001133,31.183,12,74,62
54,VIR,P003048,20.75,3,48,45
54,VIR,P003527,5.35,-13,4,17
54,VIR,P004007,17.168,3,34,31
54,VIR,P006739,28.2,21,75,54
54,VIR,P008847,16.784,6,41,35
54,VIR,P009549,26.184,19,64,45
54,VIR,P010781,11.968,-7,20,27
54,VIR,P011192,17.834,1,41,40
54,VIR,P012714,5.201,6,11,5
54,VIR,PBCN,19.383,9,53,44
55,IST,P004554,22.833,3,47,44
55,IST,P004888,40.417,10,82,72
55,IST,P006372,4.583,-6,4,10
55,IST,P006590,24.233,7,45,38
55,IST,P007200,34.066,-4,66,70
55,IST,P009513,0.567,0,0,0
55,IST,P009664,39.65,-6,69,75
55,IST,P011078,33.667,15,71,56
55,IST,P011981,22.167,1,39,38
55,IST,P012710,2.817,0,7,7
55,ZAL,P002329,33.75,6,69,63
55,ZAL,P002676,18.499,-14,31,45
55,ZAL,P003210,4.65,-10,2,12
55,ZAL,P003211,27.316,0,55,55
55,ZAL,P005504,7.983,-2,12,14
55,ZAL,P007109,30.733,-1,52,53
55,ZAL,P007513,18.034,0,24,24
55,ZAL,P010390,31.701,4,63,59
55,ZAL,P011218,29.817,12,63,51
55,ZAL,P011965,5.317,-13,5,18
55,ZAL,P012715,17.2,-2,34,36
56,MIL,P000796,20.918,14,44,30
56,MIL,P001518,7.65,5,16,11
56,MIL,P002812,14.0,9,27,18
56,MIL,P002849,19.951,16,44,28
56,MIL,P005670,16.867,20,38,18
56,MIL,P006509,15.134,18,34,16
56,MIL,P006701,6.483,4,13,9
56,MIL,P007032,23.134,11,45,34
56,MIL,P007201,16.167,15,31,16
56,MIL,P007831,18.784,11,38,27
56,MIL,P009960,21.784,19,48,29
56,MIL,P011205,19.133,13,37,24
56,PAM,P000556,9.284,-21,5,26
56,PAM,P003960,16.799,-1,27,28
56,PAM,P004863,4.217,-3,5,8
56,PAM,P005356,24.134,-29,30,59
56,PAM,P006643,21.049,-16,25,41
56,PAM,P007870,25.417,-15,37,52
56,PAM,P009101,17.917,-15,21,36
56,PAM,P010393,11.033,-7,16,23
56,PAM,P011970,21.067,-16,29,45
56,PAM,P011982,18.05,-10,26,36
56,PAM,P012738,18.1,-18,19,37
56,PAM,P012740,12.933,-4,20,24
57,MUN,P001557,13.483,0,34,34
57,MUN,P003583,24.317,-7,50,57
57,MUN,P004508,24.017,-5,50,55
57,MUN,P005460,4.1,-2,11,13
57,MUN,P006760,23.283,8,50,42
57,MUN,P007056,26.65,-8,52,60
57,MUN,P007639,9.2,2,26,24
57,MUN,P007975,12.9,3,34,31
57,MUN,P008985,16.583,-5,41,46
57,MUN,P010391,23.268,-4,44,48
57,MUN,P011941,3.767,1,8,7
57,MUN,P011987,18.432,2,50,48
57,TEL,P005145,9.167,-5,14,19
57,TEL,P007990,11.366,-7,21,28
57,TEL,P009622,30.466,8,71,63
57,TEL,P009783,33.299,5,80,75
57,TEL,P009863,25.417,0,58,58
57,TEL,P011193,16.167,5,41,36
57,TEL,P011199,26.816,8,65,57
57,TEL,P011214,13.566,-9,30,39
57,TEL,P011219,9.633,-2,22,24
57,TEL,P011971,14.332,9,37,28
57,TEL,P012744,9.766,3,26,23
58,PAR,P000956,19.715,12,49,37
58,PAR,P003983,13.099,-3,26,29
58,PAR,P004058,14.349,-8,30,38
58,PAR,P004172,5.216,4,13,9
58,PAR,P007400,27.083,2,52,50
58,PAR,P007673,15.632,-10,32,42
58,PAR,P008987,32.099,5,68,63
58,PAR,P009212,7.866,-4,17,21
58,PAR,P011051,20.599,2,40,38
58,PAR,P012742,24.966,6,53,47
58,PAR,P012743,19.366,-1,45,46
58,ULK,P002969,0.1,0,0,0
58,ULK,P005844,25.966,-12,47,59
58,ULK,P006661,25.9,-8,55,63
58,ULK,P006961,18.516,-3,39,42
58,ULK,P008962,39.967,-1,84,85
58,ULK,P009849,28.267,4,61,57
58,ULK,P011052,27.75,-5,48,53
58,ULK,P011157,13.067,12,33,21
58,ULK,P011201,0.217,-2,0,2
58,ULK,P011980,20.25,10,53,43
59,MAD,P001392,18.067,4,44,40
59,MAD,P003108,14.533,6,34,28
59,MAD,P004887,15.017,4,32,28
59,MAD,P005791,24.984,22,68,46
59,MAD,P005928,28.484,27,87,60
59,MAD,P006540,18.333,14,51,37
59,MAD,P009005,16.167,23,53,30
59,MAD,P010357,23.301,3,45,42
59,MAD,PBMT,12.684,27,44,17
59,MAD,PCVM,11.517,-1,13,14
59,MAD,PTGB,16.918,1,29,28
59,VIR,P001133,30.751,-29,53,82
59,VIR,P001844,13.45,-1,27,28
59,VIR,P003048,23.75,-19,44,63
59,VIR,P003527,1.467,-7,0,7
59,VIR,P004007,15.082,-4,28,32
59,VIR,P006739,26.55,-25,47,72
59,VIR,P008847,25.099,1,51,50
59,VIR,P009549,18.15,-10,36,46
59,VIR,P010781,10.55,-8,17,25
59,VIR,P011192,11.3,-8,21,29
59,VIR,PBCN,23.851,-20,46,66
60,BAS,P004603,16.783,10,42,32
60,BAS,P004761,21.866,9,43,34
60,BAS,P007230,34.851,8,64,56
60,BAS,P008850,12.118,-17,21,38
60,BAS,P009048,21.885,-3,36,39
60,BAS,P010444,22.735,-13,29,42
60,BAS,P011948,24.067,-12,41,53
60,BAS,P012201,27.584,19,60,41
60,BAS,P012765,18.116,4,39,35
60,OLY,P001255,28.832,9,60,51
60,OLY,P003941,3.016,-5,6,11
60,OLY,P006302,2.949,-9,0,9
60,OLY,P007982,22.699,-10,35,45
60,OLY,P008811,36.983,4,68,64
60,OLY,P008829,31.616,6,66,60
60,OLY,P008855,16.217,14,39,25
60,OLY,P010392,16.284,-6,22,28
60,OLY,P010612,32.166,15,68,53
60,OLY,P011983,9.233,-23,6,29
61,BER,P003958,25.716,-10,52,62
61,BER,P006251,14.517,1,35,34
61,BER,P006919,19.933,-3,38,41
61,BER,P007025,3.2,-5,7,12
61,BER,P007550,9.284,-7,22,29
61,BER,P008211,19.433,-6,43,49
61,BER,P008384,25.2,0,60,60
61,BER,P008967,19.817,-12,40,52
61,BER,P010791,15.2,-5,31,36
61,BER,P011934,16.034,-11,34,45
61,BER,P012720,26.966,-12,50,62
61,BER,P012721,4.7,0,13,13
61,PAN,P001926,30.783,22,78,56
61,PAN,P002328,34.249,10,80,70
61,PAN,P003842,22.833,-2,45,47
61,PAN,P007553,17.466,10,53,43
61,PAN,P007866,36.099,12,85,73
61,PAN,P007947,17.133,10,51,41
61,PAN,P008084,3.9,2,14,12
61,PAN,P011204,29.783,13,74,61
61,PAN,P012774,7.749,-7,15,22
62,ASV,P002100,24.117,-4,41,45
62,ASV,P003526,18.95,-5,32,37
62,ASV,P004194,32.633,0,65,65
62,ASV,P006568,18.75,-3,36,39
62,ASV,P011225,30.733,-3,58,61
62,ASV,P011386,4.5,-3,9,12
62,ASV,P012080,34.5,-9,64,73
62,ASV,P012729,21.25,-7,34,41
62,ASV,P012730,7.367,-10,5,15
62,ASV,PKIR,7.2,-6,6,12
62,MCO,P002581,4.817,-2,10,12
62,MCO,P004197,11.967,-2,24,26
62,MCO,P005985,27.668,0,53,53
62,MCO,P009754,25.468,21,60,39
62,MCO,P010588,23.301,9,53,44
62,MCO,P011196,19.618,11,40,29
62,MCO,P011212,21.735,0,37,37
62,MCO,P011226,27.268,8,52,44
62,MCO,P011231,20.451,9,39,30
62,MCO,P012709,5.9,3,14,11
62,MCO,PLCZ,11.817,-7,18,25
63,BAR,P000925,22.366,2,43,41
63,BAR,P002939,26.516,4,54,50
63,BAR,P003196,17.634,3,43,40
63,BAR,P003478,20.95,0,45,45
63,BAR,P004866,26.967,7,61,54
63,BAR,P006435,18.033,4,41,37
63,BAR,P007519,21.534,1,45,44
63,BAR,P009992,6.0,-1,12,13
63,BAR,P011244,17.316,-8,31,39
63,BAR,P012745,22.684,13,55,42
63,RED,P000848,23.816,-3,45,48
63,RED,P002553,31.516,-19,54,73
63,RED,P003479,2.85,-6,5,11
63,RED,P006436,21.116,2,53,51
63,RED,P007960,23.083,2,44,42
63,RED,P008966,10.199,1,22,21
63,RED,P009035,26.367,0,51,51
63,RED,P011224,25.033,-16,43,59
63,RED,P011964,3.883,5,11,6
63,RED,P012044,8.749,4,20,16
63,RED,PJDR,23.383,5,57,52
64,IST,P004554,22.783,16,66,50
64,IST,P004888,21.969,-1,43,44
64,IST,P006372,10.017,-2,15,17
64,IST,P006590,30.851,-1,66,67
64,IST,P007200,35.652,12,85,73
64,IST,P009513,3.467,-2,9,11
64,IST,P009664,29.118,2,66,64
64,IST,P011078,32.534,16,75,59
64,IST,P011981,7.551,-6,9,15
64,IST,PLHK,6.068,1,11,10
64,MCO,P004197,7.483,-1,20,21
64,MCO,P004790,4.383,5,11,6
64,MCO,P005985,31.599,-9,68,77
64,MCO,P009754,30.999,-5,65,70
64,MCO,P010588,33.048,-5,71,76
64,MCO,P011196,7.549,-4,11,15
64,MCO,P011212,19.465,7,35,28
64,MCO,P011226,24.415,-14,45,59
64,MCO,P011231,16.5,1,30,29
64,MCO,P012709,5.566,-1,9,10
64,MCO,PLCZ,18.983,-9,45,54
65,RED,P000848,24.732,17,56,39
65,RED,P002553,21.367,10,37,27
65,RED,P003479,5.466,2,15,13
65,RED,P004720,19.234,20,43,23
65,RED,P006436,25.466,14,55,41
65,RED,P007960,18.666,19,48,29
65,RED,P008966,18.05,23,40,17
65,RED,P009035,16.483,6,32,26
65,RED,P011224,1.133,4,4,0
65,RED,P011964,3.85,1,9,8
65,RED,P012044,25.782,11,49,38
65,RED,PJDR,19.766,28,47,19
65,ULK,P002969,7.317,-7,12,19
65,ULK,P005844,22.4,-26,28,54
65,ULK,P006661,23.85,-17,31,48
65,ULK,P006961,15.45,-17,22,39
65,ULK,P008962,27.75,-21,40,61
65,ULK,P009849,22.299,-20,27,47
65,ULK,P011052,25.017,-11,42,53
65,ULK,P011157,22.0,-10,30,40
65,ULK,P011201,13.901,-15,19,34
65,ULK,P011980,20.016,-11,29,40
66,OLY,P001255,26.351,-3,40,43
66,OLY,P006302,12.933,8,30,22
66,OLY,P006589,10.649,-3,22,25
66,OLY,P007982,6.55,2,19,17
66,OLY,P008811,35.001,5,64,59
66,OLY,P008829,23.534,10,55,45
66,OLY,P008855,33.251,0,57,57
66,OLY,P010392,14.801,9,30,21
66,OLY,P010612,22.185,2,46,44
66,OLY,P011983,14.75,-5,32,37
66,TEL,P004233,8.283,4,25,21
66,TEL,P005145,3.533,-1,11,12
66,TEL,P007990,17.082,2,30,28
66,TEL,P009622,31.366,-6,51,57
66,TEL,P009783,32.033,-8,54,62
66,TEL,P011193,26.098,-7,50,57
66,TEL,P011199,21.283,-2,31,33
66,TEL,P011214,16.165,3,36,33
66,TEL,P011219,14.798,-4,30,34
66,TEL,P011971,16.75,0,26,26
66,TEL,P012744,12.599,-6,26,32
67,MAD,P001392,8.95,6,17,11
67,MAD,P003108,20.467,-7,31,38
67,MAD,P003733,5.767,-10,5,15
67,MAD,P004887,10.833,-5,17,22
67,MAD,P005791,29.166,8,59,51
67,MAD,P005928,29.849,12,64,52
67,MAD,P006540,17.333,8,41,33
67,MAD,P009005,23.0,5,47,42
67,MAD,P010357,18.883,0,38,38
67,MAD,PBMT,9.532,-2,19,21
67,MAD,PCVM,11.55,-6,15,21
67,MAD,PTGB,14.665,6,27,21
67,PAM,P000556,13.416,-11,25,36
67,PAM,P003960,25.382,-9,47,56
67,PAM,P004863,16.167,11,31,20
67,PAM,P005356,21.767,-11,41,52
67,PAM,P006643,9.151,8,21,13
67,PAM,P007870,28.633,-4,57,61
67,PAM,P010393,2.817,-2,5,7
67,PAM,P010568,27.449,-10,50,60
67,PAM,P011982,19.667,0,31,31
67,PAM,P012738,11.584,6,19,13
67,PAM,P012739,11.4,2,17,15
67,PAM,P012740,12.567,5,21,16
68,MIL,P000796,29.55,3,67,64
68,MIL,P001518,7.4,-8,6,14
68,MIL,P002812,15.067,-9,19,28
68,MIL,P002849,24.467,8,63,55
68,MIL,P005670,9.667,-8,11,19
68,MIL,P006509,13.7,-17,15,32
68,MIL,P007032,30.283,1,68,67
68,MIL,P007201,21.4,3,50,47
68,MIL,P007831,31.85,4,74,70
68,MIL,P009960,4.833,-1,10,11
68,MIL,P011205,11.783,-11,12,23
68,VIR,P001133,28.384,3,64,61
68,VIR,P001844,24.251,-9,53,62
68,VIR,P003048,24.367,-10,48,58
68,VIR,P003527,21.734,22,48,26
68,VIR,P004007,20.601,16,44,28
68,VIR,P006739,10.7,7,19,12
68,VIR,P009549,21.384,-5,48,53
68,VIR,P010781,15.134,11,37,26
68,VIR,P011192,8.766,8,16,8
68,VIR,P012714,6.934,-1,12,13
68,VIR,PBCN,17.75,-7,41,48
69,ASV,P002100,17.349,-10,27,37
69,ASV,P003526,21.6,2,42,40
69,ASV,P004194,27.35,-1,50,51
69,ASV,P006568,26.017,15,55,40
69,ASV,P011225,30.5,6,53,47
69,ASV,P012080,34.3,8,66,58
69,ASV,P012729,19.35,5,35,30
69,ASV,P012730,7.283,-9,6,15
69,ASV,PKIR,16.251,9,31,22
69,BER,P003958,25.852,0,48,48
69,BER,P006251,19.434,-2,31,33
69,BER,P006919,21.535,7,43,36
69,BER,P007550,4.933,5,10,5
69,BER,P008173,17.134,-14,26,40
69,BER,P008211,17.868,6,32,26
69,BER,P008384,17.1,-6,23,29
69,BER,P008967,16.368,-15,22,37
69,BER,P010791,9.517,-3,14,17
69,BER,P011934,17.268,-11,29,40
69,BER,P012720,25.068,2,48,46
69,BER,P012721,7.933,6,14,8
70,MUN,P001557,21.366,13,49,36
70,MUN,P003583,15.966,-3,30,33
70,MUN,P005478,11.601,9,27,18
70,MUN,P007056,28.399,0,67,67
70,MUN,P007639,6.017,-2,14,16
70,MUN,P007975,27.017,-8,66,74
70,MUN,P008985,19.583,27,52,25
70,MUN,P010391,23.567,0,52,52
70,MUN,P011941,14.667,7,38,31
70,MUN,P011987,27.283,7,67,60
70,MUN,P012123,4.534,-5,8,13
70,PAR,P000956,9.75,1,14,13
70,PAR,P003983,11.616,-3,27,30
70,PAR,P004058,13.967,-3,30,33
70,PAR,P004172,4.666,-11,3,14
70,PAR,P007400,33.2,-3,71,74
70,PAR,P007673,26.817,-7,64,71
70,PAR,P008987,35.25,-6,74,80
70,PAR,P011051,8.633,-3,22,25
70,PAR,P012096,19.85,-9,36,45
70,PAR,P012742,20.017,-1,46,47
70,PAR,P012743,16.234,0,38,38
71,PAN,P001926,29.333,6,59,53
71,PAN,P002328,35.083,8,67,59
71,PAN,P003842,29.883,7,59,52
71,PAN,P007553,6.934,-3,14,17
71,PAN,P007866,38.033,-2,66,68
71,PAN,P007947,15.134,-6,24,30
71,PAN,P008084,5.534,2,13,11
71,PAN,P011204,28.483,8,52,44
71,PAN,P011209,1.217,0,3,3
71,PAN,P011221,3.183,-2,0,2
71,PAN,P011826,1.35,-4,0,4
71,PAN,P012774,5.833,-4,8,12
71,ZAL,P002329,26.715,3,50,47
71,ZAL,P002676,33.033,-5,59,64
71,ZAL,P003210,4.983,-1,10,11
71,ZAL,P003211,23.682,0,42,42
71,ZAL,P005504,13.616,-1,24,25
71,ZAL,P007109,20.316,-2,33,35
71,ZAL,P010390,18.899,-7,27,34
71,ZAL,P011218,31.149,-4,56,60
71,ZAL,P011965,8.582,4,17,13
71,ZAL,P012715,19.015,3,37,34
72,BAR,P000925,16.2,-15,28,43
72,BAR,P002939,23.766,-13,44,57
72,BAR,P003196,20.117,-13,33,46
72,BAR,P003478,12.883,-1,24,25
72,BAR,P004866,22.384,-23,37,60
72,BAR,P006435,19.933,-6,41,47
72,BAR,P007464,20.267,-16,34,50
72,BAR,P007519,16.234,-10,27,37
72,BAR,P009992,11.95,-6,21,27
72,BAR,P010641,3.683,5,10,5
72,BAR,P011244,16.833,-17,26,43
72,BAR,P012745,15.75,0,30,30
72,BAS,P003198,28.8,15,67,52
72,BAS,P004603,16.5,7,38,31
72,BAS,P007230,29.832,20,69,49
72,BAS,P008072,2.283,-4,3,7
72,BAS,P008850,8.016,-5,13,18
72,BAS,P009048,27.882,20,69,49
72,BAS,P010444,21.216,20,53,33
72,BAS,P011948,24.65,24,65,41
72,BAS,P012201,24.983,15,59,44
72,BAS,P012765,15.833,3,34,31
73,IST,P004554,16.066,-2,29,31
73,IST,P004888,34.833,-10,68,78
73,IST,P006372,6.917,-8,12,20
73,IST,P006590,17.0,-8,30,38
73,IST,P007200,35.583,-17,69,86
73,IST,P009664,29.0,-14,50,64
73,IST,P011078,34.8,-12,69,81
73,IST,P011981,17.734,-6,39,45
73,IST,P012710,8.067,-3,14,17
73,MIL,P000796,25.849,2,58,56
73,MIL,P001518,5.8,4,10,6
73,MIL,P002812,3.967,0,9,9
73,MIL,P002849,28.566,17,73,56
73,MIL,P005670,3.133,2,4,2
73,MIL,P006509,22.516,20,55,35
73,MIL,P006701,0.633,2,5,3
73,MIL,P007032,22.4,-6,48,54
73,MIL,P007201,15.8,-6,31,37
73,MIL,P007831,31.499,19,80,61
73,MIL,P009960,18.733,13,40,27
73,MIL,P011205,21.099,13,47,34
74,TEL,P005145,7.85,-4,18,22
74,TEL,P007990,2.533,-3,0,3
74,TEL,P009622,28.452,0,55,55
74,TEL,P009783,28.134,-1,50,51
74,TEL,P009863,32.517,8,69,61
74,TEL,P011193,17.233,1,32,31
74,TEL,P011199,15.634,-3,22,25
74,TEL,P011214,23.25,10,54,44
74,TEL,P011219,16.567,6,36,30
74,TEL,P011971,17.751,4,36,32
74,TEL,P012744,10.084,7,18,11
74,ULK,P005844,18.451,-5,24,29
74,ULK,P006661,28.867,-7,53,60
74,ULK,P006961,28.151,-4,52,56
74,ULK,P008962,39.234,-5,73,78
74,ULK,P009849,14.084,0,20,20
74,ULK,P011052,17.551,-2,32,34
74,ULK,P011157,26.617,4,59,55
74,ULK,P011201,6.5,1,15,14
74,ULK,P011980,20.55,-7,37,44
75,OLY,P001255,30.767,3,65,62
75,OLY,P006302,15.217,5,39,34
75,OLY,P006589,6.317,3,15,12
75,OLY,P008811,33.567,2,73,71
75,OLY,P008829,39.118,3,86,83
75,OLY,P008855,28.334,-2,57,59
75,OLY,P010392,9.817,4,30,26
75,OLY,P010612,29.551,1,58,57
75,OLY,P011983,7.317,6,17,11
75,RED,P000848,31.466,-11,64,75
75,RED,P002553,21.333,5,52,47
75,RED,P004720,17.067,-11,21,32
75,RED,P006436,23.265,6,62,56
75,RED,P007960,18.483,-8,31,39
75,RED,P008966,14.516,-3,30,33
75,RED,P009035,22.633,-11,38,49
75,RED,P011964,0.333,0,0,0
75,RED,P012044,25.899,7,56,49
75,RED,PJDR,25.0,1,61,60
76,MAD,P001392,17.267,20,50,30
76,MAD,P003108,11.6,-21,11,32
76,MAD,P004887,21.9,2,39,37
76,MAD,P005791,15.45,22,47,25
76,MAD,P005928,20.501,26,62,36
76,MAD,P006540,22.3,23,62,39
76,MAD,P009005,19.267,33,60,27
76,MAD,P010357,12.433,-2,25,27
76,MAD,PBMT,20.35,-11,34,45
76,MAD,PCVM,17.732,-7,25,32
76,MAD,PTGB,21.2,5,40,35
76,MCO,P004790,12.416,-3,26,29
76,MCO,P005985,26.683,-1,54,55
76,MCO,P009754,16.683,7,36,29
76,MCO,P010588,23.616,-18,48,66
76,MCO,P011196,20.65,-17,30,47
76,MCO,P011212,25.866,-15,42,57
76,MCO,P011226,24.249,-15,42,57
76,MCO,P011231,15.7,-4,25,29
76,MCO,P012515,6.283,-3,14,17
76,MCO,P012709,12.583,-17,17,34
76,MCO,PLCZ,15.266,-4,31,35
77,BAR,P000925,21.967,9,48,39
77,BAR,P002939,28.099,11,57,46
77,BAR,P003196,16.917,1,29,28
77,BAR,P003478,22.316,-3,42,45
77,BAR,P004866,26.2,7,51,44
77,BAR,P006435,27.584,8,51,43
77,BAR,P007464,3.9,-4,4,8
77,BAR,P007519,11.901,-7,17,24
77,BAR,P010641,4.083,-8,0,8
77,BAR,P011244,11.65,0,19,19
77,BAR,P012745,25.383,6,52,46
77,PAM,P000556,16.867,-2,26,28
77,PAM,P003960,18.133,-4,30,34
77,PAM,P004863,14.749,-2,23,25
77,PAM,P005356,28.217,-8,50,58
77,PAM,P006643,6.516,-6,10,16
77,PAM,P007870,21.967,1,39,38
77,PAM,P009101,4.149,4,8,4
77,PAM,P010393,10.633,7,20,13
77,PAM,P010568,27.183,2,49,47
77,PAM,P011982,21.766,-2,41,43
77,PAM,P012738,15.716,-8,29,37
77,PAM,P012739,14.099,-2,25,27
78,ASV,P000229,9.632,-9,16,25
78,ASV,P003526,24.45,-8,52,60
78,ASV,P004194,31.766,-9,62,71
78,ASV,P006568,10.816,-5,22,27
78,ASV,P011225,33.899,3,71,68
78,ASV,P011386,3.65,-2,7,9
78,ASV,P012080,28.584,-7,60,67
78,ASV,P012729,22.766,5,49,44
78,ASV,P012730,12.233,-7,25,32
78,ASV,PKIR,22.199,4,41,37
78,BAS,P003198,27.349,2,52,50
78,BAS,P004603,14.383,-6,29,35
78,BAS,P008850,11.684,-3,29,32
78,BAS,P009048,26.2,-8,53,61
78,BAS,P010444,28.7,10,65,55
78,BAS,P011064,5.067,5,13,8
78,BAS,P011948,29.917,16,76,60
78,BAS,P012201,36.917,10,82,72
78,BAS,P012765,19.783,9,41,32
79,PAN,P001926,24.249,15,53,38
79,PAN,P002328,23.548,17,61,44
79,PAN,P003842,21.149,18,47,29
79,PAN,P007553,18.516,-4,41,45
79,PAN,P007866,35.081,16,83,67
79,PAN,P007947,19.149,-9,31,40
79,PAN,P008084,2.25,-2,2,4
79,PAN,P011204,30.733,18,72,54
79,PAN,P011209,0.533,2,4,2
79,PAN,P011221,2.667,0,5,5
79,PAN,P012774,22.115,-1,51,52
79,VIR,P001133,32.197,-7,65,72
79,VIR,P001844,16.449,-12,33,45
79,VIR,P003048,24.716,-2,52,54
79,VIR,P003527,11.849,-12,20,32
79,VIR,P004007,9.4,-5,14,19
79,VIR,P006739,20.516,2,36,34
79,VIR,P009549,15.782,-8,29,37
79,VIR,P010781,12.065,-14,26,40
79,VIR,P011192,17.315,-4,28,32
79,VIR,P012714,11.232,-7,15,22
79,VIR,PBCN,28.464,-1,62,63
80,BER,P003958,27.517,5,59,54
80,BER,P006251,18.286,-23,25,48
80,BER,P006819,0.967,-5,0,5
80,BER,P006919,26.584,1,54,53
80,BER,P007025,2.767,-9,3,12
80,BER,P007550,11.601,-5,15,20
80,BER,P008211,26.384,-6,56,62
80,BER,P008384,12.852,-19,19,38
80,BER,P008967,10.484,-9,16,25
80,BER,P010791,16.934,-6,37,43
80,BER,P011934,16.3,-1,27,28
80,BER,P012720,29.334,2,59,57
80,PAR,P000956,26.784,16,60,44
80,PAR,P003983,24.901,21,65,44
80,PAR,P004058,11.033,-6,16,22
80,PAR,P004172,9.017,2,20,18
80,PAR,P007400,20.434,1,46,45
80,PAR,P007673,8.067,-2,16,18
80,PAR,P008987,28.534,3,60,57
80,PAR,P009212,4.717,4,12,8
80,PAR,P012096,19.651,11,48,37
80,PAR,P012742,23.65,16,51,35
80,PAR,P012743,23.217,9,51,42
81,MUN,P001557,21.617,-10,35,45
81,MUN,P003583,23.717,-7,37,44
81,MUN,P005478,13.667,-9,24,33
81,MUN,P007056,30.749,9,58,49
81,MUN,P007639,8.066,12,22,10
81,MUN,P007975,10.584,-10,17,27
81,MUN,P008985,29.566,9,56,47
81,MUN,P010391,21.833,8,41,33
81,MUN,P011941,3.651,-7,5,12
81,MUN,P011987,28.734,-12,48,60
81,MUN,P012123,7.816,12,22,10
81,ZAL,P002329,20.466,10,45,35
81,ZAL,P002676,22.466,-11,31,42
81,ZAL,P003210,20.098,3,41,38
81,ZAL,P003211,20.117,8,45,37
81,ZAL,P005504,24.183,9,50,41
81,ZAL,P007109,29.465,-16,42,58
81,ZAL,P007513,15.783,-6,23,29
81,ZAL,P010390,8.0,4,15,11
81,ZAL,P011218,20.117,-3,30,33
81,ZAL,P011965,3.383,1,9,8
81,ZAL,P012715,15.917,6,39,33
82,ASV,P000229,19.317,-4,34,38
82,ASV,P003526,24.169,-1,65,66
82,ASV,P004194,32.985,-1,79,80
82,ASV,P006568,17.217,1,35,34
82,ASV,P011225,37.852,7,91,84
82,ASV,P011386,5.983,-1,10,11
82,ASV,P012080,32.268,-7,76,83
82,ASV,P012729,32.035,2,75,73
82,ASV,P012730,7.7,-5,9,14
82,ASV,PKIR,15.484,4,26,22
82,MUN,P001557,26.715,2,63,61
82,MUN,P003583,25.633,7,66,59
82,MUN,P004508,18.883,-3,30,33
82,MUN,P005478,0.1,-2,0,2
82,MUN,P006760,13.733,1,42,41
82,MUN,P007056,35.532,9,91,82
82,MUN,P007639,0.033,0,0,0
82,MUN,P007975,18.133,-8,33,41
82,MUN,P008985,22.833,10,50,40
82,MUN,P010391,30.216,-6,68,74
82,MUN,P011941,14.65,-5,22,27
82,MUN,P011987,18.534,0,40,40
83,BAR,P002939,26.033,1,53,52
83,BAR,P003196,18.648,-11,45,56
83,BAR,P003204,13.965,1,39,38
83,BAR,P003478,23.466,10,56,46
83,BAR,P004866,26.415,0,60,60
83,BAR,P006435,20.999,-13,46,59
83,BAR,P007464,15.2,-1,32,33
83,BAR,P009992,10.133,4,25,21
83,BAR,P010641,14.683,10,32,22
83,BAR,P011244,11.7,3,29,26
83,BAR,P012745,18.748,6,43,37
83,TEL,P004233,5.85,-4,11,15
83,TEL,P005145,15.6,-3,35,38
83,TEL,P009622,33.767,1,80,79
83,TEL,P009783,31.716,-1,69,70
83,TEL,P009863,29.05,-5,65,70
83,TEL,P011199,16.617,-8,37,45
83,TEL,P011214,20.0,7,44,37
83,TEL,P011219,20.05,7,48,41
83,TEL,P011971,7.75,-7,16,23
83,TEL,P012744,19.6,3,45,42
84,PAM,P000556,12.533,-6,25,31
84,PAM,P003960,11.584,-20,16,36
84,PAM,P005356,18.201,-8,33,41
84,PAM,P006643,16.184,-3,31,34
84,PAM,P007870,15.367,-13,27,40
84,PAM,P010393,8.017,6,18,12
84,PAM,P010568,26.968,-16,49,65
84,PAM,P011970,16.499,-5,30,35
84,PAM,P011982,19.967,-13,34,47
84,PAM,P012738,23.067,0,43,43
84,PAM,P012739,15.551,-4,28,32
84,PAM,P012740,16.067,-3,31,34
84,PAN,P001926,25.316,19,67,48
84,PAN,P002328,32.7,18,77,59
84,PAN,P003842,27.683,18,70,52
84,PAN,P007553,12.0,0,20,20
84,PAN,P007866,31.083,13,75,62
84,PAN,P007947,19.817,-5,34,39
84,PAN,P008084,10.767,4,21,17
84,PAN,P011204,23.067,19,56,37
84,PAN,P011209,4.034,-2,5,7
84,PAN,P012774,13.533,1,25,24
85,BER,P003958,18.618,-8,39,47
85,BER,P006251,16.433,-7,27,34
85,BER,P006819,7.766,2,17,15
85,BER,P007025,22.184,-11,41,52
85,BER,P007550,18.984,-11,35,46
85,BER,P008173,21.017,-13,40,53
85,BER,P008211,27.501,-19,56,75
85,BER,P008384,27.784,-14,49,63
85,BER,P010791,23.017,-23,45,68
85,BER,P011934,16.701,-16,26,42
85,MAD,P001392,18.118,17,49,32
85,MAD,P003108,22.969,21,70,49
85,MAD,P003733,10.4,6,17,11
85,MAD,P004887,17.084,7,37,30
85,MAD,P005791,22.852,17,62,45
85,MAD,P005928,23.419,18,61,43
85,MAD,P006540,13.968,6,36,30
85,MAD,P009005,11.751,7,20,13
85,MAD,P009213,20.101,16,54,38
85,MAD,PBMT,11.284,-2,18,20
85,MAD,PCVM,16.584,6,38,32
85,MAD,PTGB,11.485,1,33,32
86,ULK,P001932,21.783,-14,34,48
86,ULK,P002968,14.417,-9,23,32
86,ULK,P002969,9.55,-4,11,15
86,ULK,P004004,21.567,6,51,45
86,ULK,P005844,23.0,-1,54,55
86,ULK,P006661,28.983,0,64,64
86,ULK,P008962,33.05,-6,68,74
86,ULK,P011052,13.434,-3,21,24
86,ULK,P011157,25.599,-2,57,59
86,ULK,P011980,8.617,-7,12,19
86,VIR,P001133,28.949,13,71,58
86,VIR,P001844,28.716,4,63,59
86,VIR,P003048,17.549,-1,35,36
86,VIR,P003527,12.734,-2,20,22
86,VIR,P004007,17.966,9,35,26
86,VIR,P006739,11.733,4,24,20
86,VIR,P010781,20.916,5,51,46
86,VIR,P011192,20.933,1,41,40
86,VIR,P012714,20.483,8,48,40
86,VIR,PBCN,20.016,-1,47,48
87,IST,P004554,20.383,0,43,43
87,IST,P004888,36.383,7,90,83
87,IST,P006372,2.3,-4,5,9
87,IST,P006590,27.95,10,77,67
87,IST,P007200,33.233,11,87,76
87,IST,P009664,17.783,11,47,36
87,IST,P010516,2.184,-5,2,7
87,IST,P011078,33.8,0,83,83
87,IST,P011981,19.584,8,57,49
87,IST,P012710,6.4,-8,9,17
87,PAR,P000956,10.584,-15,18,33
87,PAR,P004058,18.201,-4,37,41
87,PAR,P004172,26.766,-5,64,69
87,PAR,P007400,28.566,0,75,75
87,PAR,P008987,26.383,-16,59,75
87,PAR,P011051,11.084,-5,21,26
87,PAR,P012096,20.3,3,46,43
87,PAR,P012742,30.799,10,81,71
87,PAR,P012743,27.317,2,69,67
88,MIL,P000796,29.45,27,72,45
88,MIL,P001518,0.683,-1,1,2
88,MIL,P002812,4.467,-5,8,13
88,MIL,P002849,27.183,32,71,39
88,MIL,P006509,12.533,-7,23,30
88,MIL,P006701,6.9,4,16,12
88,MIL,P007032,32.767,23,77,54
88,MIL,P007201,23.5,23,60,37
88,MIL,P007831,29.267,16,68,52
88,MIL,P009960,8.917,-7,15,22
88,MIL,P011205,23.65,6,53,47
88,MIL,P011926,0.683,-1,1,2
88,RED,P000848,25.916,-16,49,65
88,RED,P002553,28.284,-21,47,68
88,RED,P004720,8.466,-5,17,22
88,RED,P006436,28.717,-17,47,64
88,RED,P007960,26.333,-10,50,60
88,RED,P008966,12.5,1,24,23
88,RED,P009035,23.717,-12,43,55
88,RED,P011224,3.534,1,5,4
88,RED,P012044,17.9,-15,32,47
88,RED,P012711,4.783,-9,4,13
88,RED,PJDR,19.85,-7,37,44
89,OLY,P001255,18.334,2,36,34
89,OLY,P003941,14.199,7,32,25
89,OLY,P006302,14.499,3,35,32
89,OLY,P006589,9.799,4,21,17
89,OLY,P008811,23.282,11,52,41
89,OLY,P008829,30.199,13,68,55
89,OLY,P008855,25.499,14,54,40
89,OLY,P010392,17.15,3,31,28
89,OLY,P010612,27.948,17,69,52
89,OLY,P011983,19.081,11,47,36
89,ZAL,P002329,25.248,-17,46,63
89,ZAL,P002676,27.565,-13,46,59
89,ZAL,P003210,22.698,-13,45,58
89,ZAL,P003211,13.333,-9,19,28
89,ZAL,P005504,5.8,-15,8,23
89,ZAL,P006860,5.699,-2,13,15
89,ZAL,P007109,21.267,-11,35,46
89,ZAL,P007513,8.666,-1,17,18
89,ZAL,P010390,27.899,-4,48,52
89,ZAL,P011218,23.717,-3,41,44
89,ZAL,P012715,17.065,1,38,37
89,ZAL,P012784,1.033,2,4,2
90,BAS,P003198,15.566,7,35,28
90,BAS,P004603,8.5,-12,11,23
90,BAS,P004761,26.365,-5,45,50
90,BAS,P007230,35.215,-1,68,69
90,BAS,P008850,1.432,4,6,2
90,BAS,P009048,26.965,-1,49,50
90,BAS,P010444,31.232,6,60,54
90,BAS,P011948,19.967,6,41,35
90,BAS,P012201,21.715,-13,34,47
90,BAS,P012765,13.033,-1,26,27
90,MCO,P004197,13.299,4,31,27
90,MCO,P004790,7.183,-1,12,13
90,MCO,P005985,34.199,5,66,61
90,MCO,P010588,28.633,1,53,52
90,MCO,P011196,10.399,0,21,21
90,MCO,P011212,29.45,-2,52,54
90,MCO,P011226,28.616,-6,48,54
90,MCO,P011231,15.967,-9,22,31
90,MCO,P012709,14.433,5,34,29
90,MCO,PLCZ,17.816,13,46,33
91,MCO,P002581,3.95,-3,7,10
91,MCO,P004197,14.95,0,29,29
91,MCO,P004790,12.5,-2,21,23
91,MCO,P005985,30.032,12,69,57
91,MCO,P010588,26.299,13,64,51
91,MCO,P011196,16.2,-1,32,33
91,MCO,P011212,24.316,3,47,44
91,MCO,P011226,28.132,13,66,53
91,MCO,P011231,14.766,0,32,32
91,MCO,P012709,11.617,-5,19,24
91,MCO,PLCZ,17.233,10,39,29
91,OLY,P001255,23.7,-1,46,47
91,OLY,P003941,17.85,-17,29,46
91,OLY,P006302,5.716,3,10,7
91,OLY,P006589,8.916,-1,15,16
91,OLY,P007853,4.033,5,9,4
91,OLY,P008811,22.099,9,48,39
91,OLY,P008829,30.7,-7,62,69
91,OLY,P008855,34.15,-14,64,78
91,OLY,P010392,6.349,1,13,12
91,OLY,P010612,31.149,-12,59,71
91,OLY,P011983,15.333,-6,30,36
92,MUN,P001557,16.285,2,36,34
92,MUN,P003583,23.251,10,50,40
92,MUN,P005478,7.4,-3,12,15
92,MUN,P006245,3.55,-3,6,9
92,MUN,P006760,22.351,13,56,43
92,MUN,P007056,23.968,1,55,54
92,MUN,P007639,15.168,14,37,23
92,MUN,P007975,25.952,2,54,52
92,MUN,P010391,26.634,17,61,44
92,MUN,P011941,5.083,-3,12,15
92,MUN,P011987,30.368,20,71,51
92,VIR,P001133,33.866,-7,67,74
92,VIR,P001844,25.45,-11,43,54
92,VIR,P003048,21.583,-13,44,57
92,VIR,P004007,12.216,-4,20,24
92,VIR,P006739,14.416,-4,33,37
92,VIR,P008847,19.066,-4,31,35
92,VIR,P009549,15.967,-3,31,34
92,VIR,P010781,14.432,-4,27,31
92,VIR,P011192,7.849,-4,18,22
92,VIR,P012714,5.483,-4,10,14
92,VIR,PBCN,29.667,-12,56,68
93,MAD,P003108,15.967,-12,25,37
93,MAD,P003733,3.267,-3,2,5
93,MAD,P004887,23.766,-18,45,63
93,MAD,P005791,21.166,16,53,37
93,MAD,P005928,37.083,13,90,77
93,MAD,P006540,17.266,0,40,40
93,MAD,P009005,38.066,8,93,85
93,MAD,P009213,7.967,9,23,14
93,MAD,PBMT,21.932,-13,40,53
93,MAD,PCVM,7.199,-9,9,18
93,MAD,PTGB,31.316,4,75,71
93,ULK,P001932,20.7,3,53,50
93,ULK,P002968,14.149,-1,28,29
93,ULK,P004004,33.15,9,83,74
93,ULK,P005844,11.434,-16,18,34
93,ULK,P006661,25.233,12,60,48
93,ULK,P008962,37.167,-6,83,89
93,ULK,P009849,17.733,-6,33,39
93,ULK,P010560,14.267,-13,24,37
93,ULK,P011052,22.367,4,47,43
93,ULK,P011157,28.8,19,71,52
94,BER,P003958,20.883,0,53,53
94,BER,P006251,16.449,-17,23,40
94,BER,P006819,8.65,-11,17,28
94,BER,P007025,13.849,-21,16,37
94,BER,P008173,21.316,-22,45,67
94,BER,P008211,21.516,-6,40,46
94,BER,P008384,23.317,7,61,54
94,BER,P010791,17.033,1,34,33
94,BER,P011631,14.233,-5,29,34
94,BER,P011934,19.833,-17,41,58
94,BER,P012721,22.916,-14,46,60
94,TEL,P004233,22.268,23,62,39
94,TEL,P005145,15.3,4,40,36
94,TEL,P009622,20.0,10,57,47
94,TEL,P009783,20.784,4,45,41
94,TEL,P009863,23.484,14,61,47
94,TEL,P011193,22.584,14,59,45
94,TEL,P011214,18.366,3,43,40
94,TEL,P011219,22.069,18,59,41
94,TEL,P011433,5.966,-3,11,14
94,TEL,P011971,14.383,13,41,28
94,TEL,P012744,14.801,5,32,27
95,PAN,P001926,22.834,-9,39,48
95,PAN,P002328,39.433,0,79,79
95,PAN,P003842,33.167,-5,66,71
95,PAN,P007553,11.833,0,21,21
95,PAN,P007866,41.066,-1,80,81
95,PAN,P007947,10.083,-2,17,19
95,PAN,P008084,1.517,-5,0,5
95,PAN,P011204,38.817,-4,76,80
95,PAN,P012774,26.25,1,57,56
95,PAR,P000956,25.065,26,64,38
95,PAR,P003983,9.7,-1,15,16
95,PAR,P004058,3.667,-7,4,11
95,PAR,P004172,7.217,-6,13,19
95,PAR,P007400,25.899,-6,41,47
95,PAR,P008987,39.482,10,86,76
95,PAR,P009212,5.017,-5,6,11
95,PAR,P009862,26.366,-2,53,55
95,PAR,P011051,20.6,-3,41,44
95,PAR,P012096,19.916,15,49,34
95,PAR,P012742,31.249,15,73,58
95,PAR,P012743,10.817,-11,15,26
96,MIL,P000796,29.485,-13,52,65
96,MIL,P001518,4.25,2,8,6
96,MIL,P002812,13.317,0,27,27
96,MIL,P002849,27.984,-7,49,56
96,MIL,P006509,16.483,-6,26,32
96,MIL,P006701,4.167,4,8,4
96,MIL,P007032,28.217,-17,48,65
96,MIL,P007201,19.017,-15,32,47
96,MIL,P007831,31.801,-17,54,71
96,MIL,P009960,7.934,-1,12,13
96,MIL,P011205,17.35,5,34,29
96,ZAL,P002329,34.735,13,75,62
96,ZAL,P002676,17.184,15,39,24
96,ZAL,P003210,8.099,0,14,14
96,ZAL,P003211,11.167,-3,23,26
96,ZAL,P005504,7.134,-4,14,18
96,ZAL,P006860,13.934,6,28,22
96,ZAL,P007109,22.183,9,46,37
96,ZAL,P007513,21.434,0,40,40
96,ZAL,P010390,34.218,17,72,55
96,ZAL,P011218,29.917,12,64,52
97,IST,P004888,33.532,-13,67,80
97,IST,P006372,17.183,-7,32,39
97,IST,P006590,31.833,-5,65,70
97,IST,P007200,34.182,-19,71,90
97,IST,P009513,0.1,-3,0,3
97,IST,P011078,30.399,-15,58,73
97,IST,P011981,32.367,0,70,70
97,IST,P012710,5.182,-8,11,19
97,IST,P012786,15.217,0,41,41
97,RED,P000848,25.733,12,70,58
97,RED,P002553,26.2,5,65,60
97,RED,P004720,9.6,16,29,13
97,RED,P006436,15.967,-5,28,33
97,RED,P007960,13.7,6,29,23
97,RED,P008966,10.917,0,17,17
97,RED,P009035,28.766,14,80,66
97,RED,P011224,14.4,-5,28,33
97,RED,P012044,24.866,16,69,53
97,RED,PJDR,18.234,4,39,35
97,RED,PLUO,11.617,7,31,24
98,ASV,P000229,19.667,11,54,43
98,ASV,P002100,20.417,10,57,47
98,ASV,P003526,25.585,-18,52,70
98,ASV,P004194,29.617,-13,69,82
98,ASV,P006568,21.217,-13,45,58
98,ASV,P011225,23.234,-20,45,65
98,ASV,P011386,0.717,0,0,0
98,ASV,P012080,30.216,-7,68,75
98,ASV,P012729,24.401,4,58,54
98,ASV,P012730,4.767,4,12,8
98,ASV,P012731,0.167,-3,0,3
98,BAR,P000925,25.35,13,64,51
98,BAR,P002939,28.2,19,79,60
98,BAR,P003196,13.85,-4,35,39
98,BAR,P003204,1.983,-9,0,9
98,BAR,P003478,12.05,-13,24,37
98,BAR,P004866,26.751,11,66,55
98,BAR,P006435,25.75,28,78,50
98,BAR,P007464,9.716,2,26,24
98,BAR,P007519,10.067,-8,19,27
98,BAR,P009992,5.65,0,14,14
98,BAR,P011244,20.667,-10,42,52
98,BAR,P012745,19.966,16,58,42
99,BAS,P003198,8.6,-14,13,27
99,BAS,P004603,23.067,13,50,37
99,BAS,P004761,25.117,5,63,58
99,BAS,P007230,37.084,21,96,75
99,BAS,P008072,1.75,-1,5,6
99,BAS,P008850,0.317,0,0,0
99,BAS,P009048,30.534,18,75,57
99,BAS,P010444,14.851,3,42,39
99,BAS,P011064,7.467,-2,15,17
99,BAS,P011948,20.95,11,54,43
99,BAS,P012201,28.268,18,69,51
99,BAS,P012765,2.0,-2,8,10
99,PAM,P000556,8.283,7,23,16
99,PAM,P003960,23.333,-15,37,52
99,PAM,P005356,19.999,-9,45,54
99,PAM,P006643,2.35,-2,2,4
99,PAM,P007870,21.933,-11,41,52
99,PAM,P010568,26.865,-19,60,79
99,PAM,P011970,24.317,-6,50,56
99,PAM,P011982,31.183,-20,65,85
99,PAM,P012738,12.416,2,34,32
99,PAM,P012739,15.966,-4,36,40
99,PAM,P012740,13.35,7,27,20
100,BER,P003958,31.683,10,61,51
100,BER,P006251,22.2,2,35,33
100,BER,P007025,24.451,-1,39,40
100,BER,P008173,20.668,-4,30,34
100,BER,P008211,19.333,6,34,28
100,BER,P008384,18.201,0,28,28
100,BER,P010791,16.401,1,25,24
100,BER,P011934,29.068,-8,41,49
100,BER,P012721,18.0,4,27,23
100,ZAL,P002329,30.501,-9,49,58
100,ZAL,P003210,10.717,-2,13,15
100,ZAL,P003211,20.349,-6,30,36
100,ZAL,P005504,9.466,-13,7,20
100,ZAL,P006860,16.483,-10,18,28
100,ZAL,P007109,24.65,9,41,32
100,ZAL,P007513,23.834,-1,35,36
100,ZAL,P010390,27.617,12,55,43
100,ZAL,P011218,26.317,3,49,46
100,ZAL,P012784,0.4,0,0,0
100,ZAL,P012787,9.666,7,13,6
101,IST,P006372,12.616,10,25,15
101,IST,P007200,34.466,9,67,58
101,IST,P009513,21.066,-7,31,38
101,IST,P010516,15.782,-12,21,33
101,IST,P011078,29.417,7,59,52
101,IST,P011981,30.833,12,66,54
101,IST,P012710,23.366,6,40,34
101,IST,P012786,20.866,-3,37,40
101,IST,P012788,11.583,-7,9,16
101,PAN,P001926,27.633,1,49,48
101,PAN,P002328,20.9,-7,33,40
101,PAN,P003842,31.668,-2,54,56
101,PAN,P007553,4.216,2,8,6
101,PAN,P007866,33.767,-1,59,60
101,PAN,P007947,6.417,-1,8,9
101,PAN,P008084,1.733,-3,2,5
101,PAN,P011204,33.583,-2,60,62
101,PAN,P011221,8.616,-2,13,15
101,PAN,P011826,1.933,2,2,0
101,PAN,P012774,29.534,-2,52,54
102,MIL,P001518,0.317,2,2,0
102,MIL,P002812,17.834,3,34,31
102,MIL,P002849,30.816,-20,55,75
102,MIL,P005670,17.017,-1,31,32
102,MIL,P006509,24.55,-7,48,55
102,MIL,P006701,2.984,1,6,5
102,MIL,P007032,25.4,5,49,44
102,MIL,P007201,24.317,10,49,39
102,MIL,P007831,35.499,-15,63,78
102,MIL,P009960,16.716,-9,28,37
102,MIL,P011205,29.55,-4,55,59
102,MUN,P001557,13.935,-15,14,29
102,MUN,P003583,34.767,21,80,59
102,MUN,P006245,4.15,-2,11,13
102,MUN,P006543,6.767,5,14,9
102,MUN,P006760,30.967,13,71,58
102,MUN,P007056,34.534,11,74,63
102,MUN,P007639,5.017,-9,3,12
102,MUN,P007975,20.969,2,40,38
102,MUN,P010391,31.869,-4,57,61
102,MUN,P011941,5.218,-5,8,13
102,MUN,P011987,36.817,18,83,65
103,MAD,P001392,11.467,2,26,24
103,MAD,P003108,28.85,5,55,50
103,MAD,P004887,17.467,-5,29,34
103,MAD,P005791,22.533,11,48,37
103,MAD,P005928,27.683,13,58,45
103,MAD,P006540,25.583,5,54,49
103,MAD,P009005,27.083,6,51,45
103,MAD,P009213,10.433,-1,20,21
103,MAD,P010623,7.117,-1,12,13
103,MAD,PTGB,21.784,-5,32,37
103,OLY,P001255,29.085,-4,52,56
103,OLY,P003941,15.15,-3,28,31
103,OLY,P006302,10.617,-6,19,25
103,OLY,P006589,6.45,-2,8,10
103,OLY,P007853,17.467,2,28,26
103,OLY,P008811,24.851,-3,43,46
103,OLY,P008829,26.334,-5,52,57
103,OLY,P008855,31.9,-3,55,58
103,OLY,P010392,16.617,0,27,27
103,OLY,P010612,14.534,-4,28,32
103,OLY,P011983,7.0,-2,15,17
104,MCO,P004197,3.9,-9,2,11
104,MCO,P004790,2.7,3,6,3
104,MCO,P005985,38.916,0,74,74
104,MCO,P009754,22.916,-6,42,48
104,MCO,P010588,34.733,-6,67,73
104,MCO,P011196,14.016,-1,25,26
104,MCO,P011212,24.216,3,53,50
104,MCO,P011226,35.599,9,72,63
104,MCO,P011231,19.699,-2,34,36
104,MCO,P012709,6.066,-2,11,13
104,MCO,PLCZ,22.234,-9,39,48
104,PAR,P000956,8.716,2,15,13
104,PAR,P003983,7.25,-5,11,16
104,PAR,P004172,4.75,-3,8,11
104,PAR,P007400,39.516,-3,78,81
104,PAR,P008987,36.533,1,72,71
104,PAR,P009212,7.633,-4,13,17
104,PAR,P009862,38.899,10,80,70
104,PAR,P011050,5.883,2,12,10
104,PAR,P011051,21.066,-4,42,46
104,PAR,P012096,17.983,16,38,22
104,PAR,P012742,36.766,8,76,68
105,ASV,P000229,22.932,4,59,55
105,ASV,P002100,22.948,-4,60,64
105,ASV,P003526,12.25,-1,18,19
105,ASV,P004194,28.282,5,62,57
105,ASV,P006568,16.149,-3,30,33
105,ASV,P011225,29.399,10,71,61
105,ASV,P011386,1.316,-9,0,9
105,ASV,P012080,31.149,-9,65,74
105,ASV,P012729,27.282,1,73,72
105,ASV,P012730,8.283,-9,17,26
105,TEL,P004233,5.1,-1,11,12
105,TEL,P005145,9.534,0,18,18
105,TEL,P009622,28.518,-4,65,69
105,TEL,P009783,28.668,-2,64,66
105,TEL,P009863,34.551,7,84,77
105,TEL,P011193,14.884,4,38,34
105,TEL,P011199,18.201,-7,43,50
105,TEL,P011214,21.633,10,51,41
105,TEL,P011219,25.766,9,64,55
105,TEL,P011971,4.184,-7,8,15
105,TEL,P012744,8.966,6,24,18
106,BAS,P003198,5.567,-2,8,10
106,BAS,P004603,28.767,12,64,52
106,BAS,P004761,23.133,5,47,42
106,BAS,P007230,20.049,-5,35,40
106,BAS,P008072,11.0,-14,13,27
106,BAS,P009048,31.233,3,61,58
106,BAS,P011064,8.117,-5,14,19
106,BAS,P011085,17.3,-7,30,37
106,BAS,P011948,27.567,9,64,55
106,BAS,P012201,27.267,9,64,55
106,ULK,P001932,14.583,-6,24,30
106,ULK,P002968,16.384,2,35,33
106,ULK,P004004,25.717,-4,45,49
106,ULK,P006661,10.484,1,23,22
106,ULK,P008962,36.468,7,75,68
106,ULK,P009849,18.518,5,42,37
106,ULK,P010560,27.917,-3,51,54
106,ULK,P011052,22.784,4,52,48
106,ULK,P011157,23.617,-3,44,47
106,ULK,P011980,3.533,-8,4,12
107,PAM,P000556,25.199,6,58,52
107,PAM,P003960,12.984,1,25,24
107,PAM,P004863,22.533,14,47,33
107,PAM,P005356,12.333,2,35,33
107,PAM,P006643,18.85,-4,31,35
107,PAM,P007870,28.884,-1,59,60
107,PAM,P010568,24.184,-10,50,60
107,PAM,P011970,22.817,1,42,41
107,PAM,P011982,21.15,8,54,46
107,PAM,P012739,11.066,3,24,21
107,RED,P000848,18.318,-10,28,38
107,RED,P002553,21.784,8,44,36
107,RED,P004720,7.233,-8,15,23
107,RED,P006436,22.401,-14,37,51
107,RED,P007960,26.899,0,60,60
107,RED,P008966,13.633,-4,31,35
107,RED,P009035,26.317,2,50,48
107,RED,P011224,17.883,3,42,39
107,RED,P012044,10.167,-14,13,27
107,RED,P012711,0.65,-5,0,5
107,RED,PJDR,21.449,16,54,38
107,RED,PLUO,13.266,6,31,25
108,BAR,P000925,23.849,-3,39,42
108,BAR,P002939,27.532,-3,51,54
108,BAR,P003196,16.15,-2,36,38
108,BAR,P003204,0.367,2,2,0
108,BAR,P003478,16.083,8,37,29
108,BAR,P004866,25.749,-12,43,55
108,BAR,P006435,26.082,-13,41,54
108,BAR,P007519,12.467,-2,24,26
108,BAR,P009992,13.567,8,34,26
108,BAR,P011244,19.333,-7,29,36
108,BAR,P012745,18.816,-1,39,40
108,VIR,P001133,31.85,17,68,51
108,VIR,P001844,32.084,3,63,60
108,VIR,P003048,19.85,10,44,34
108,VIR,P003527,2.434,0,4,4
108,VIR,P004007,18.467,13,40,27
108,VIR,P008847,20.883,-11,34,45
108,VIR,P009549,20.784,2,37,35
108,VIR,P010781,19.499,4,44,40
108,VIR,P011192,3.866,-7,6,13
108,VIR,P012713,4.05,9,11,2
108,VIR,P012714,4.35,-10,6,16
108,VIR,PBCN,21.883,-5,43,48
109,BER,P003958,28.918,-4,65,69
109,BER,P006251,23.318,0,61,61
109,BER,P006819,8.867,1,19,18
109,BER,P007025,20.385,-11,44,55
109,BER,P008173,22.168,-1,51,52
109,BER,P008211,19.601,-5,45,50
109,BER,P008384,24.684,2,59,57
109,BER,P010791,11.001,-6,25,31
109,BER,P011631,0.45,0,2,2
109,BER,P011934,14.634,-4,23,27
109,BER,P012721,25.984,-12,51,63
109,IST,P007200,32.15,7,76,69
109,IST,P009513,35.867,11,93,82
109,IST,P010516,14.05,-4,26,30
109,IST,P011078,35.4,10,90,80
109,IST,P011981,24.25,3,58,55
109,IST,P012710,17.083,1,32,31
109,IST,P012786,22.833,12,66,54
109,IST,P012788,18.367,0,44,44
110,MAD,P001392,18.35,5,37,32
110,MAD,P003108,22.868,-2,52,54
110,MAD,P004887,16.051,-5,29,34
110,MAD,P005791,23.433,17,59,42
110,MAD,P005928,32.417,23,83,60
110,MAD,P006540,20.233,1,38,37
110,MAD,P009005,29.934,17,71,54
110,MAD,P009213,5.8,1,12,11
110,MAD,PBMT,15.501,8,41,33
110,MAD,PTGB,15.418,-5,28,33
110,PAN,P001926,12.601,-9,16,25
110,PAN,P002328,24.567,-5,45,50
110,PAN,P003842,30.051,-11,63,74
110,PAN,P007553,9.6,1,15,14
110,PAN,P007866,28.401,-12,55,67
110,PAN,P007947,32.467,2,70,68
110,PAN,P008084,11.95,-2,23,25
110,PAN,P011204,18.184,-11,37,48
110,PAN,P012774,32.184,-13,66,79
111,MIL,P001518,4.316,-1,8,9
111,MIL,P002812,25.284,-6,40,46
111,MIL,P002849,29.751,4,59,55
111,MIL,P005670,14.167,-6,25,31
111,MIL,P006509,21.116,-16,30,46
111,MIL,P007032,24.817,-5,44,49
111,MIL,P007201,18.5,-21,26,47
111,MIL,P007831,33.451,-3,65,68
111,MIL,P009960,2.784,3,8,5
111,MIL,P011205,23.469,-12,35,47
111,MIL,P011926,2.35,-2,5,7
111,PAR,P000956,12.451,10,24,14
111,PAR,P003983,5.116,-3,10,13
111,PAR,P004058,10.817,11,23,12
111,PAR,P004172,7.899,-2,15,17
111,PAR,P007400,29.484,10,59,49
111,PAR,P008987,35.284,13,75,62
111,PAR,P009862,29.45,10,61,51
111,PAR,P011051,24.966,8,47,39
111,PAR,P012096,22.966,0,49,49
111,PAR,P012742,21.567,8,47,39
112,MUN,P001557,15.033,-12,17,29
112,MUN,P005460,16.666,12,36,24
112,MUN,P006245,7.75,1,16,15
112,MUN,P006543,18.634,0,40,40
112,MUN,P006760,20.133,3,34,31
112,MUN,P007056,20.766,-6,29,35
112,MUN,P007639,15.367,-15,21,36
112,MUN,P007975,20.967,-2,42,44
112,MUN,P010391,18.717,-7,31,38
112,MUN,P011941,7.967,-5,12,17
112,MUN,P011987,22.233,-12,32,44
112,MUN,P012123,15.767,3,35,32
112,OLY,P001255,26.6,15,51,36
112,OLY,P003941,18.4,6,41,35
112,OLY,P006302,2.85,-2,4,6
112,OLY,P006589,8.4,5,17,12
112,OLY,P007853,6.083,1,11,10
112,OLY,P008811,21.6,2,36,34
112,OLY,P008829,31.6,3,60,57
112,OLY,P008855,30.0,12,60,48
112,OLY,P010392,20.0,-6,40,46
112,OLY,P010612,21.067,11,39,28
112,OLY,P011983,13.4,-7,26,33
113,BAR,P000925,19.051,14,40,26
113,BAR,P002939,27.267,11,62,51
113,BAR,P003196,20.949,-6,49,55
113,BAR,P003478,17.084,-3,43,46
113,BAR,P004866,22.834,8,53,45
113,BAR,P006435,20.35,18,42,24
113,BAR,P007464,16.216,1,35,34
113,BAR,P007519,12.733,-3,27,30
113,BAR,P009992,3.516,-8,5,13
113,BAR,P011244,15.583,-2,28,30
113,BAR,P012745,24.417,10,61,51
113,ULK,P001932,4.967,-4,4,8
113,ULK,P002968,12.016,4,30,26
113,ULK,P004004,13.049,-13,16,29
113,ULK,P006661,22.984,-2,55,57
113,ULK,P006961,7.883,4,19,15
113,ULK,P008962,38.667,-4,81,85
113,ULK,P009849,30.4,1,75,74
113,ULK,P010560,31.067,-12,58,70
113,ULK,P011052,9.65,2,16,14
113,ULK,P011157,27.934,-12,51,63
113,ULK,P011980,1.383,-4,0,4
114,ASV,P000229,7.683,-9,5,14
114,ASV,P002100,24.266,-18,34,52
114,ASV,P003526,16.183,-8,21,29
114,ASV,P004194,29.732,-26,40,66
114,ASV,P006568,24.983,-4,36,40
114,ASV,P011225,24.7,-16,36,52
114,ASV,P012080,30.382,-12,50,62
114,ASV,P012729,17.433,-6,27,33
114,ASV,P012730,6.0,-2,7,9
114,ASV,PKIR,18.633,-14,19,33
114,PAM,P000556,7.617,-6,9,15
114,PAM,P003960,20.632,15,40,25
114,PAM,P004863,18.9,22,42,20
114,PAM,P006643,18.966,17,40,23
114,PAM,P007870,17.5,26,42,16
114,PAM,P010393,4.5,9,12,3
114,PAM,P010568,23.981,12,48,36
114,PAM,P011970,12.517,3,24,21
114,PAM,P011982,21.881,14,43,29
114,PAM,P012738,17.732,3,32,29
114,PAM,P012739,19.632,-7,30,37
114,PAM,P012740,16.132,7,28,21
115,BAS,P003198,13.101,8,36,28
115,BAS,P004603,27.801,7,53,46
115,BAS,P004761,23.784,6,50,44
115,BAS,P007230,28.301,1,66,65
115,BAS,P008072,8.666,-4,21,25
115,BAS,P008850,1.833,-6,2,8
115,BAS,P009048,29.901,4,61,57
115,BAS,P011085,26.417,-2,49,51
115,BAS,P011948,13.767,0,39,39
115,BAS,P012201,16.334,-2,32,34
115,BAS,P012765,10.1,-2,26,28
115,RED,P000848,21.65,-14,33,47
115,RED,P002553,23.2,9,52,43
115,RED,P004720,7.166,-7,10,17
115,RED,P006436,33.266,5,74,69
115,RED,P007960,16.749,-9,33,42
115,RED,P008966,12.616,3,35,32
115,RED,P009035,27.383,-5,50,55
115,RED,P012044,12.316,-5,28,33
115,RED,PJDR,27.35,3,57,54
115,RED,PLUO,18.299,10,53,43
116,TEL,P004233,4.95,-2,9,11
116,TEL,P005145,7.533,-8,15,23
116,TEL,P009622,34.266,-7,80,87
116,TEL,P009783,26.8,-13,52,65
116,TEL,P009863,30.033,-12,65,77
116,TEL,P011193,22.183,5,51,46
116,TEL,P011199,23.268,-7,51,58
116,TEL,P011214,20.733,-3,50,53
116,TEL,P011219,16.849,-1,41,42
116,TEL,P012744,13.385,-2,36,38
116,VIR,P001133,33.865,16,86,70
116,VIR,P001844,29.348,7,78,71
116,VIR,P003048,25.132,5,68,63
116,VIR,P004007,16.849,4,37,33
116,VIR,P008847,14.599,0,33,33
116,VIR,P009549,13.5,9,39,30
116,VIR,P010781,21.149,-5,44,49
116,VIR,P011192,16.633,5,37,32
116,VIR,P012714,2.85,0,8,8
116,VIR,PBCN,26.065,9,70,61
117,MCO,P002581,9.267,-2,20,22
117,MCO,P004790,14.867,8,35,27
117,MCO,P005985,32.667,-1,66,67
117,MCO,P008099,11.417,6,24,18
117,MCO,P010588,25.301,-8,48,56
117,MCO,P011196,6.167,2,13,11
117,MCO,P011212,29.9,-3,63,66
117,MCO,P011226,26.334,5,61,56
117,MCO,P011231,21.667,3,43,40
117,MCO,P012709,7.334,5,17,12
117,MCO,PLCZ,15.084,5,25,20
117,ZAL,P002329,35.084,-6,67,73
117,ZAL,P003211,20.351,-2,46,48
117,ZAL,P005504,19.967,8,39,31
117,ZAL,P006860,10.001,-2,21,23
117,ZAL,P007109,27.467,2,56,54
117,ZAL,P007513,29.585,-1,54,55
117,ZAL,P010390,15.083,-10,21,31
117,ZAL,P011218,26.667,-1,56,57
117,ZAL,P012787,15.8,-8,35,43
118,ASV,P000229,14.733,2,31,29
118,ASV,P002100,22.967,-7,48,55
118,ASV,P003526,25.933,-2,54,56
118,ASV,P004194,26.533,-2,55,57
118,ASV,P006568,21.85,-3,45,48
118,ASV,P011225,18.033,-9,34,43
118,ASV,P012080,31.35,-1,65,66
118,ASV,P012729,16.4,-11,30,41
118,ASV,P012730,14.834,0,32,32
118,ASV,PKIR,7.367,-7,11,18
118,PAN,P001926,34.334,9,81,72
118,PAN,P002328,27.383,10,66,56
118,PAN,P003842,25.334,9,60,51
118,PAN,P007553,7.201,-3,12,15
118,PAN,P007866,28.234,0,61,61
118,PAN,P007947,7.268,-5,9,14
118,PAN,P011204,25.585,4,59,55
118,PAN,P011209,0.1,0,0,0
118,PAN,P011221,7.367,2,17,15
118,PAN,P012712,12.885,4,28,24
118,PAN,P012774,24.319,10,52,42
119,MAD,P001392,17.383,-4,34,38
119,MAD,P003108,20.266,6,46,40
119,MAD,P004887,18.534,12,44,32
119,MAD,P005791,21.467,3,44,41
119,MAD,P005928,23.95,8,48,40
119,MAD,P006540,15.05,3,31,28
119,MAD,P009005,18.617,15,48,33
119,MAD,P009213,14.701,1,27,26
119,MAD,PBMT,15.901,12,36,24
119,MAD,PCVM,14.634,6,36,30
119,MAD,PTGB,19.502,13,46,33
119,MUN,P001557,15.134,-13,22,35
119,MUN,P003583,29.067,-11,52,63
119,MUN,P006543,14.867,-6,26,32
119,MUN,P006760,27.017,-6,53,59
119,MUN,P007056,20.267,-6,39,45
119,MUN,P007639,5.001,-4,7,11
119,MUN,P007975,16.968,-4,33,37
119,MUN,P008985,23.033,-11,40,51
119,MUN,P010391,19.784,-12,34,46
119,MUN,P011987,28.867,-2,59,61
120,BAS,P003198,4.767,-7,6,13
120,BAS,P004603,22.966,-9,44,53
120,BAS,P004761,25.299,5,64,59
120,BAS,P007230,16.883,-12,33,45
120,BAS,P008072,14.849,0,29,29
120,BAS,P008850,6.25,-4,8,12
120,BAS,P009048,32.899,-5,68,73
120,BAS,P011085,22.882,-6,51,57
120,BAS,P011948,19.348,-7,32,39
120,BAS,P012201,26.748,0,57,57
120,BAS,P012765,7.099,-5,13,18
120,VIR,P001133,29.251,12,71,59
120,VIR,P001844,28.201,12,65,53
120,VIR,P002084,7.283,-6,11,17
120,VIR,P003048,21.083,1,41,40
120,VIR,P003527,9.751,7,25,18
120,VIR,P004007,7.2,-12,8,20
120,VIR,P006739,16.134,-3,37,40
120,VIR,P009549,23.417,17,59,42
120,VIR,P010781,12.25,-6,21,27
120,VIR,P012714,16.734,8,41,33
120,VIR,PBCN,28.701,20,76,56
121,PAR,P000956,0.05,0,0,0
121,PAR,P004172,11.583,0,23,23
121,PAR,P007400,29.482,5,71,66
121,PAR,P008987,30.999,0,63,63
121,PAR,P009212,6.75,8,25,17
121,PAR,P009862,35.116,11,84,73
121,PAR,P011050,6.366,8,22,14
121,PAR,P011051,22.35,9,46,37
121,PAR,P012096,23.617,-4,52,56
121,PAR,P012742,33.682,3,79,76
121,ZAL,P002329,26.733,-8,50,58
121,ZAL,P003211,29.699,8,71,63
121,ZAL,P005504,6.684,-15,8,23
121,ZAL,P006860,16.033,12,39,27
121,ZAL,P007109,34.283,-6,72,78
121,ZAL,P007513,17.733,-21,29,50
121,ZAL,P009917,10.732,-11,18,29
121,ZAL,P010390,15.799,-3,38,41
121,ZAL,P011218,35.266,3,79,76
121,ZAL,P012787,7.033,1,21,20
122,IST,P004093,1.55,-1,5,6
122,IST,P007200,33.699,0,71,71
122,IST,P009513,11.967,-10,29,39
122,IST,P010516,17.583,-19,33,52
122,IST,P011078,36.65,-5,83,88
122,IST,P011981,28.716,-4,57,61
122,IST,P012415,1.283,1,3,2
122,IST,P012710,27.949,-11,55,66
122,IST,P012786,27.465,5,60,55
122,IST,P012788,13.133,-1,34,35
122,TEL,P005145,11.767,-1,21,22
122,TEL,P009622,29.85,7,73,66
122,TEL,P009783,27.734,2,64,62
122,TEL,P009863,19.851,-10,36,46
122,TEL,P011193,24.168,11,66,55
122,TEL,P011199,22.684,9,55,46
122,TEL,P011214,16.751,4,40,36
122,TEL,P011219,16.001,4,31,27
122,TEL,P011971,20.936,14,61,47
122,TEL,P012744,10.268,5,28,23
123,MCO,P004790,3.933,-5,2,7
123,MCO,P005985,34.533,-13,58,71
123,MCO,P010588,21.667,-10,43,53
123,MCO,P011196,13.166,-5,25,30
123,MCO,P011212,27.182,-9,48,57
123,MCO,P011226,33.532,-6,65,71
123,MCO,P011231,22.766,-3,42,45
123,MCO,P012515,7.583,1,22,21
123,MCO,P012709,10.717,-4,20,24
123,MCO,PLCZ,24.916,-6,45,51
123,ULK,P001932,26.932,9,58,49
123,ULK,P002968,23.333,12,50,38
123,ULK,P004004,26.766,4,57,53
123,ULK,P006661,24.932,4,53,49
123,ULK,P008962,34.566,7,70,63
123,ULK,P009849,14.0,10,33,23
123,ULK,P010560,14.983,6,32,26
123,ULK,P011052,13.067,3,28,25
123,ULK,P011157,14.55,6,32,26
123,ULK,P011980,6.866,-1,17,18
124,BER,P003958,25.732,-14,41,55
124,BER,P006251,18.182,-4,36,40
124,BER,P006819,4.566,3,9,6
124,BER,P006919,17.616,-6,33,39
124,BER,P007025,4.617,-5,5,10
124,BER,P008173,20.266,-4,35,39
124,BER,P008211,19.732,-10,36,46
124,BER,P008384,16.499,-6,29,35
124,BER,P008967,19.366,-6,35,41
124,BER,P011934,22.499,-9,36,45
124,BER,P012720,19.065,-11,34,45
124,BER,P012721,11.85,2,26,24
124,RED,P000848,21.617,18,55,37
124,RED,P002553,14.917,7,33,26
124,RED,P006436,29.7,12,68,56
124,RED,P007960,20.833,3,42,39
124,RED,P008966,13.667,1,25,24
124,RED,P009035,23.5,19,60,41
124,RED,P011224,15.55,2,30,28
124,RED,P012044,21.933,6,44,38
124,RED,P012711,7.083,-2,10,12
124,RED,PJDR,18.067,8,41,33
124,RED,PLUO,13.133,-4,17,21
125,BAR,P000925,18.867,8,41,33
125,BAR,P002939,26.035,-4,59,63
125,BAR,P003196,14.751,-11,37,48
125,BAR,P003478,23.433,2,45,43
125,BAR,P004866,24.485,1,63,62
125,BAR,P006435,23.467,-1,46,47
125,BAR,P007464,21.666,2,42,40
125,BAR,P007519,13.683,-2,24,26
125,BAR,P009992,15.584,-4,45,49
125,BAR,P010641,6.383,-1,8,9
125,BAR,P011244,11.651,-10,20,30
125,MIL,P001518,17.033,5,30,25
125,MIL,P002812,11.8,0,27,27
125,MIL,P002849,28.668,3,69,66
125,MIL,P005670,32.699,8,72,64
125,MIL,P006509,13.166,-4,26,30
125,MIL,P006701,2.384,0,4,4
125,MIL,P007201,25.166,10,56,46
125,MIL,P007831,31.751,4,78,74
125,MIL,P009960,13.149,-3,26,29
125,MIL,P011205,24.184,-3,62,65
126,OLY,P001255,30.0,3,45,42
126,OLY,P003941,13.417,-13,10,23
126,OLY,P006589,16.183,2,24,22
126,OLY,P007853,12.25,-1,21,22
126,OLY,P007982,4.917,-6,6,12
126,OLY,P008811,26.583,6,46,40
126,OLY,P008855,35.083,-1,50,51
126,OLY,P010392,14.95,-13,14,27
126,OLY,P010612,30.0,3,45,42
126,OLY,P011194,8.017,-10,7,17
126,OLY,P011983,8.6,-5,12,17
126,PAM,P000556,25.117,-8,36,44
126,PAM,P003960,14.134,13,33,20
126,PAM,P004863,19.451,12,36,24
126,PAM,P006643,16.616,10,27,17
126,PAM,P007870,20.234,12,36,24
126,PAM,P008780,15.7,5,24,19
126,PAM,P010393,11.749,4,15,11
126,PAM,P010568,29.949,3,48,45
126,PAM,P012738,14.667,-5,20,25
126,PAM,P012739,17.55,-7,22,29
126,PAM,P012740,14.833,-4,18,22
127,BAR,P000925,24.199,7,51,44
127,BAR,P002939,26.316,3,50,47
127,BAR,P003196,14.367,-11,17,28
127,BAR,P003204,5.183,-4,10,14
127,BAR,P004866,22.966,13,46,33
127,BAR,P006435,25.499,-2,50,52
127,BAR,P007464,13.283,-13,16,29
127,BAR,P007519,13.383,-6,20,26
127,BAR,P009992,14.8,-3,20,23
127,BAR,P010641,1.383,0,2,2
127,BAR,P011244,18.983,-5,31,36
127,BAR,P012745,19.633,1,37,36
127,BER,P003958,29.301,3,58,55
127,BER,P006251,12.766,5,20,15
127,BER,P007025,12.049,1,20,19
127,BER,P008173,20.4,8,38,30
127,BER,P008211,19.6,-4,36,40
127,BER,P008384,20.867,-4,33,37
127,BER,P008967,25.434,9,54,45
127,BER,P010791,8.933,2,14,12
127,BER,P011934,24.217,3,49,46
127,BER,P012720,21.65,2,41,39
127,BER,P012721,4.783,-5,7,12
128,MAD,P001392,6.233,-6,8,14
128,MAD,P003108,30.9,25,62,37
128,MAD,P003733,18.4,11,36,25
128,MAD,P004887,18.249,12,36,24
128,MAD,P005791,19.917,5,36,31
128,MAD,P005928,24.233,1,36,35
128,MAD,P006540,19.05,-2,27,29
128,MAD,P009213,20.884,-1,35,36
128,MAD,P011649,1.717,-3,0,3
128,MAD,PCVM,18.417,12,38,26
128,MAD,PTGB,22.0,16,46,30
128,RED,P000848,17.066,-10,24,34
128,RED,P002553,24.083,-8,35,43
128,RED,P004720,1.917,5,5,0
128,RED,P005099,19.666,-1,32,33
128,RED,P006436,15.75,-10,21,31
128,RED,P007960,20.316,-10,27,37
128,RED,P008966,6.033,-5,12,17
128,RED,P009035,30.182,-9,39,48
128,RED,P012044,20.55,-2,31,33
128,RED,P012711,8.583,-4,15,19
128,RED,PJDR,20.316,-15,29,44
128,RED,PLUO,15.533,-1,20,21
129,BAS,P003198,5.667,-7,9,16
129,BAS,P004603,20.768,6,49,43
129,BAS,P004761,34.401,2,71,69
129,BAS,P007230,31.185,-5,62,67
129,BAS,P008072,9.383,-14,13,27
129,BAS,P009048,33.134,-15,61,76
129,BAS,P011085,5.767,-10,8,18
129,BAS,P011948,24.017,-6,50,56
129,BAS,P012201,22.483,3,50,47
129,BAS,P012765,13.2,6,32,26
129,TEL,P005145,7.583,2,17,15
129,TEL,P009622,31.199,-1,64,65
129,TEL,P009783,25.683,11,54,43
129,TEL,P009863,26.6,18,66,48
129,TEL,P011193,20.75,-1,48,49
129,TEL,P011199,19.251,1,37,36
129,TEL,P011214,15.35,-10,25,35
129,TEL,P011219,17.35,9,48,39
129,TEL,P011971,29.2,14,70,56
129,TEL,P012744,7.034,-3,16,19
130,PAM,P000556,15.818,-11,19,30
130,PAM,P003960,23.284,-14,35,49
130,PAM,P004863,19.167,-12,26,38
130,PAM,P005356,12.883,1,18,17
130,PAM,P006643,16.501,-4,28,32
130,PAM,P007870,28.834,0,53,53
130,PAM,P008780,2.1,-1,4,5
130,PAM,P010393,13.534,14,31,17
130,PAM,P010568,30.117,1,56,55
130,PAM,P012738,7.4,-4,10,14
130,PAM,P012739,11.167,-5,14,19
130,PAM,P012740,19.2,10,41,31
130,PAR,P000956,5.25,-5,10,15
130,PAR,P004058,4.8,-4,7,11
130,PAR,P004172,12.749,-2,21,23
130,PAR,P007400,30.583,2,55,53
130,PAR,P008987,32.134,7,61,54
130,PAR,P009212,7.866,-2,11,13
130,PAR,P009862,34.384,5,60,55
130,PAR,P011051,22.733,7,44,37
130,PAR,P012096,12.218,7,25,18
130,PAR,P012742,22.817,16,46,30
130,PAR,P012743,14.466,-6,20,26
131,OLY,P001255,20.0,-2,34,36
131,OLY,P003941,23.25,-2,38,40
131,OLY,P007853,3.534,2,5,3
131,OLY,P007982,20.617,-2,33,35
131,OLY,P008811,16.75,0,29,29
131,OLY,P008829,28.284,-3,45,48
131,OLY,P008855,25.0,-8,39,47
131,OLY,P010392,15.749,-1,26,27
131,OLY,P010612,20.717,-3,36,39
131,OLY,P011194,11.716,1,22,21
131,OLY,P011983,14.383,8,28,20
131,VIR,P001133,29.652,3,51,48
131,VIR,P001844,25.267,5,42,37
131,VIR,P002084,6.484,-6,8,14
131,VIR,P003048,24.667,-6,39,45
131,VIR,P003527,8.117,4,16,12
131,VIR,P004007,17.167,4,31,27
131,VIR,P006739,14.735,-3,27,30
131,VIR,P009549,28.718,9,51,42
131,VIR,P010781,13.234,-8,19,27
131,VIR,P012714,10.567,9,24,15
131,VIR,PBCN,21.402,-1,37,38
132,MCO,P004197,18.067,-10,31,41
132,MCO,P004790,13.617,10,36,26
132,MCO,P005985,30.901,-9,68,77
132,MCO,P010588,27.167,-8,57,65
132,MCO,P011196,18.601,1,46,45
132,MCO,P011212,25.267,10,66,56
132,MCO,P011226,31.084,-2,67,69
132,MCO,P011231,0.1,1,1,0
132,MCO,P012709,14.684,8,38,30
132,MCO,PLCZ,20.517,-6,40,46
132,PAN,P001926,31.433,16,80,64
132,PAN,P002328,24.517,6,58,52
132,PAN,P003842,28.199,4,67,63
132,PAN,P007553,4.317,-5,7,12
132,PAN,P007866,26.584,-4,53,57
132,PAN,P007947,24.533,-3,54,57
132,PAN,P011204,20.267,-4,42,46
132,PAN,P011221,7.084,0,14,14
132,PAN,P012712,12.883,1,34,33
132,PAN,P012774,20.183,-6,46,52
133,ASV,P000229,16.835,-2,28,30
133,ASV,P002100,3.467,3,10,7
133,ASV,P003526,23.55,-12,35,47
133,ASV,P004194,25.217,-33,32,65
133,ASV,P006568,16.816,-15,26,41
133,ASV,P011225,27.25,-20,40,60
133,ASV,P012080,28.2,-22,41,63
133,ASV,P012729,18.718,6,33,27
133,ASV,P012730,19.918,-6,31,37
133,ASV,PKIR,20.034,-14,29,43
133,MIL,P002812,15.285,12,35,23
133,MIL,P002849,21.799,8,43,35
133,MIL,P005670,23.866,12,45,33
133,MIL,P005775,19.05,7,40,33
133,MIL,P006509,17.667,2,30,28
133,MIL,P006701,3.25,6,8,2
133,MIL,P006721,2.833,4,6,2
133,MIL,P007201,20.984,26,53,27
133,MIL,P007831,27.851,20,62,42
133,MIL,P009960,10.666,-4,18,22
133,MIL,P011205,28.316,22,67,45
133,MIL,P011926,8.433,0,13,13
134,IST,P004554,2.767,-5,2,7
134,IST,P007200,33.3,-13,58,71
134,IST,P009513,11.517,-16,14,30
134,IST,P009846,24.751,-12,48,60
134,IST,P010516,12.449,-4,20,24
134,IST,P011078,28.367,-8,51,59
134,IST,P011981,24.333,-9,45,54
134,IST,P012786,35.367,-8,62,70
134,IST,P012788,27.149,0,55,55
134,MUN,P001288,13.134,10,35,25
134,MUN,P001557,6.05,-3,15,18
134,MUN,P003583,27.268,22,61,39
134,MUN,P004508,13.617,-5,28,33
134,MUN,P005460,7.251,-3,11,14
134,MUN,P006543,5.984,0,13,13
134,MUN,P006760,23.151,15,45,30
134,MUN,P007056,26.134,-2,49,51
134,MUN,P007975,18.501,3,46,43
134,MUN,P008985,21.734,15,43,28
134,MUN,P010391,14.351,8,33,25
134,MUN,P011987,22.835,15,51,36
135,ULK,P001932,20.366,-5,38,43
135,ULK,P002968,8.166,-5,15,20
135,ULK,P004004,22.716,6,49,43
135,ULK,P005844,4.366,-4,7,11
135,ULK,P006661,27.517,16,62,46
135,ULK,P006961,3.616,-3,5,8
135,ULK,P008962,32.15,7,69,62
135,ULK,P009849,23.316,3,48,45
135,ULK,P010560,23.383,-10,38,48
135,ULK,P011052,5.183,-7,7,14
135,ULK,P011157,25.433,17,58,41
135,ULK,P011980,3.783,-5,4,9
135,ZAL,P002329,28.766,-7,52,59
135,ZAL,P003211,20.2,11,44,33
135,ZAL,P005504,20.666,-18,32,50
135,ZAL,P006860,8.717,3,20,17
135,ZAL,P007109,33.782,-3,64,67
135,ZAL,P007513,9.934,9,24,15
135,ZAL,P009917,17.132,-13,29,42
135,ZAL,P010390,14.866,11,34,23
135,ZAL,P011218,32.982,-7,62,69
135,ZAL,P012787,12.95,4,29,25
136,RED,P000848,12.817,2,34,32
136,RED,P002553,15.633,1,38,37
136,RED,P005099,21.385,-6,53,59
136,RED,P006436,32.167,1,72,71
136,RED,P007960,15.618,4,40,36
136,RED,P008966,13.351,1,33,32
136,RED,P009035,26.65,5,65,60
136,RED,P012044,7.501,-12,8,20
136,RED,P012711,11.45,9,32,23
136,RED,PJDR,28.75,20,83,63
136,RED,PLUO,14.683,5,32,27
136,TEL,P004233,6.483,6,17,11
136,TEL,P005145,9.033,5,19,14
136,TEL,P009622,30.233,2,74,72
136,TEL,P009783,25.366,-2,54,56
136,TEL,P009863,27.817,-6,61,67
136,TEL,P011193,24.6,-4,59,63
136,TEL,P011199,25.35,-7,55,62
136,TEL,P011214,12.117,-5,29,34
136,TEL,P011219,13.084,-5,32,37
136,TEL,P011971,14.083,-10,31,41
136,TEL,P012744,11.834,-4,29,33
137,MAD,P001392,23.001,18,63,45
137,MAD,P003108,17.334,0,35,35
137,MAD,P004887,18.017,3,38,35
137,MAD,P005791,18.917,18,49,31
137,MAD,P005928,19.867,21,55,34
137,MAD,P006540,19.367,29,59,30
137,MAD,P009213,25.334,11,60,49
137,MAD,P010623,0.467,0,0,0
137,MAD,PBMT,20.634,-13,32,45
137,MAD,PCVM,23.567,-3,42,45
137,MAD,PTGB,13.5,-4,22,26
137,PAR,P000956,9.949,0,23,23
137,PAR,P004058,16.883,2,31,29
137,PAR,P004172,26.566,3,56,53
137,PAR,P007400,23.4,-9,45,54
137,PAR,P008987,19.6,-21,30,51
137,PAR,P009212,12.183,8,30,22
137,PAR,P009862,23.25,-27,36,63
137,PAR,P011050,7.633,9,22,13
137,PAR,P011051,22.832,-8,39,47
137,PAR,P012096,23.116,-12,44,56
137,PAR,P012742,13.433,-19,19,38
137,PAR,P012743,1.15,-6,0,6
138,PAM,P003960,18.199,19,43,24
138,PAM,P004863,21.034,12,44,32
138,PAM,P005356,22.55,11,50,39
138,PAM,P006643,14.166,-3,25,28
138,PAM,P007870,21.516,7,49,42
138,PAM,P008780,9.55,-10,14,24
138,PAM,P010393,15.716,-2,29,31
138,PAM,P010568,26.982,8,55,47
138,PAM,P012738,6.017,-9,7,16
138,PAM,P012739,18.483,1,30,29
138,PAM,P012740,25.782,6,49,43
138,VIR,P001133,31.933,4,60,56
138,VIR,P001844,30.551,-6,51,57
138,VIR,P002084,8.067,-12,11,23
138,VIR,P003048,21.3,-13,30,43
138,VIR,P004007,13.784,-3,25,28
138,VIR,P006739,8.366,-2,18,20
138,VIR,P009549,24.733,-4,44,48
138,VIR,P010781,20.283,-3,36,39
138,VIR,P012714,18.45,7,41,34
138,VIR,PBCN,22.533,-8,39,47
139,BER,P003958,27.167,-14,52,66
139,BER,P006251,15.65,3,37,34
139,BER,P008173,20.917,-11,36,47
139,BER,P008211,19.083,2,46,44
139,BER,P008384,18.55,4,43,39
139,BER,P008967,21.516,-3,45,48
139,BER,P010791,12.2,-7,22,29
139,BER,P011934,24.983,0,53,53
139,BER,P012720,27.167,-14,52,66
139,BER,P012721,12.767,-5,24,29
139,ULK,P001932,30.383,19,67,48
139,ULK,P002968,5.75,-1,13,14
139,ULK,P004004,8.017,0,20,20
139,ULK,P005844,13.383,7,35,28
139,ULK,P006661,26.35,12,60,48
139,ULK,P006961,0.6,-2,0,2
139,ULK,P008962,32.883,6,71,65
139,ULK,P009849,13.65,-3,31,34
139,ULK,P010560,31.983,9,71,62
139,ULK,P011052,9.617,-10,24,34
139,ULK,P011157,20.867,3,43,40
139,ULK,P011980,6.517,5,20,15
140,BAS,P004603,20.167,14,43,29
140,BAS,P004761,28.984,10,61,51
140,BAS,P007230,30.684,8,70,62
140,BAS,P008072,5.533,-4,7,11
140,BAS,P008850,11.367,1,17,16
140,BAS,P009048,36.317,8,80,72
140,BAS,P011085,15.699,-3,37,40
140,BAS,P011948,21.733,6,55,49
140,BAS,P012201,23.949,-6,54,60
140,BAS,P012765,5.567,1,11,10
140,IST,P004554,4.283,-1,7,8
140,IST,P006590,21.518,-9,46,55
140,IST,P007200,33.967,-4,70,74
140,IST,P009513,6.034,-3,10,13
140,IST,P009846,26.101,-9,44,53
140,IST,P010516,7.9,4,20,16
140,IST,P011078,29.317,-4,60,64
140,IST,P011981,13.085,5,34,29
140,IST,P012710,20.184,-13,38,51
140,IST,P012786,11.083,-6,18,24
140,IST,P012788,26.533,5,53,48
141,MIL,P002812,10.901,-2,20,22
141,MIL,P002849,26.984,-2,45,47
141,MIL,P005670,15.634,-9,20,29
141,MIL,P005775,13.05,-7,24,31
141,MIL,P006509,18.617,-2,33,35
141,MIL,P006701,9.284,10,22,12
141,MIL,P006721,2.183,-4,3,7
141,MIL,P007201,26.418,-1,48,49
141,MIL,P007831,31.351,-5,56,61
141,MIL,P009960,12.616,-4,20,24
141,MIL,P011205,32.067,-11,49,60
141,MIL,P011926,0.9,-3,0,3
141,PAN,P001926,32.1,3,57,54
141,PAN,P002328,22.466,-4,40,44
141,PAN,P003842,28.366,-8,46,54
141,PAN,P007866,24.566,-2,40,42
141,PAN,P007947,8.65,3,15,12
141,PAN,P011204,32.117,12,66,54
141,PAN,P011221,8.267,10,21,11
141,PAN,P012712,16.701,16,41,25
141,PAN,P012774,26.767,10,54,44
142,MCO,P004790,8.8,13,23,10
142,MCO,P005985,31.317,10,75,65
142,MCO,P008099,6.766,2,13,11
142,MCO,P010588,26.767,4,60,56
142,MCO,P011196,15.283,1,37,36
142,MCO,P011212,24.3,2,59,57
142,MCO,P011226,27.883,2,66,64
142,MCO,P011231,28.267,9,62,53
142,MCO,P012709,17.617,8,35,27
142,MCO,PLCZ,13.0,4,25,21
142,MUN,P001288,19.266,2,42,40
142,MUN,P001557,5.049,6,10,4
142,MUN,P003583,17.783,-10,24,34
142,MUN,P004508,16.35,-3,36,39
142,MUN,P005478,8.483,2,24,22
142,MUN,P006760,19.117,3,48,45
142,MUN,P007056,25.315,-19,43,62
142,MUN,P007639,6.733,0,16,16
142,MUN,P007975,22.866,-4,46,50
142,MUN,P008985,10.916,-13,19,32
142,MUN,P010391,25.297,-13,46,59
142,MUN,P011987,22.815,-6,46,52
143,ASV,P000229,11.851,-1,28,29
143,ASV,P003526,14.183,-8,21,29
143,ASV,P004194,31.132,-4,52,56
143,ASV,P006568,14.799,-1,25,26
143,ASV,P011225,35.683,-9,63,72
143,ASV,P011386,0.517,-3,0,3
143,ASV,P012080,27.716,-11,49,60
143,ASV,P012729,27.801,-9,54,63
143,ASV,P012730,19.301,-6,37,43
143,ASV,P012731,2.95,-5,5,10
143,ASV,PKIR,14.067,-3,31,34
143,OLY,P001255,18.95,5,43,38
143,OLY,P003941,1.033,-1,3,4
143,OLY,P006589,5.0,3,12,9
143,OLY,P007853,18.0,5,36,31
143,OLY,P007982,25.967,7,57,50
143,OLY,P008811,33.967,10,70,60
143,OLY,P008829,25.2,8,52,44
143,OLY,P008855,14.033,5,28,23
143,OLY,P010392,10.0,7,26,19
143,OLY,P010612,30.0,7,61,54
143,OLY,P011194,14.8,4,33,29
143,OLY,P011983,3.05,0,4,4
144,BAR,P000925,25.184,12,52,40
144,BAR,P002939,27.383,1,58,57
144,BAR,P003196,10.266,-8,23,31
144,BAR,P004866,36.199,4,72,68
144,BAR,P006435,28.734,9,64,55
144,BAR,P007464,1.55,3,8,5
144,BAR,P007519,14.866,2,32,30
144,BAR,P009992,11.265,-4,21,25
144,BAR,P010641,4.549,1,10,9
144,BAR,P011244,11.7,2,24,22
144,BAR,P012745,28.299,3,61,58
144,ZAL,P002329,29.482,-12,54,66
144,ZAL,P003210,2.483,-7,3,10
144,ZAL,P003211,22.667,-12,38,50
144,ZAL,P005504,24.349,-1,52,53
144,ZAL,P006860,6.716,-14,12,26
144,ZAL,P007109,31.516,10,67,57
144,ZAL,P007513,16.917,7,37,30
144,ZAL,P009917,15.45,-5,30,35
144,ZAL,P010390,14.483,0,28,28
144,ZAL,P011218,26.866,16,59,43
144,ZAL,P012787,9.066,-7,20,27
145,IST,P004554,4.883,-6,7,13
145,IST,P006590,25.75,-10,46,56
145,IST,P007200,35.333,-10,71,81
145,IST,P009513,1.633,0,2,2
145,IST,P009846,22.182,3,52,49
145,IST,P011078,27.699,-2,63,65
145,IST,P011981,15.883,-5,33,38
145,IST,P012710,7.95,5,23,18
145,IST,P012786,28.849,-1,60,61
145,IST,P012788,29.833,1,63,62
145,ULK,P001932,25.667,9,61,52
145,ULK,P002968,11.201,-10,22,32
145,ULK,P004004,17.4,7,40,33
145,ULK,P005844,18.55,12,41,29
145,ULK,P006661,28.517,13,69,56
145,ULK,P006961,21.667,11,43,32
145,ULK,P008962,36.301,5,83,78
145,ULK,P009849,11.401,-8,20,28
145,ULK,P010560,13.15,-3,33,36
145,ULK,P011052,4.084,-7,6,13
145,ULK,P011157,9.9,-1,24,25
145,ULK,P011980,2.167,-3,3,6
146,BAS,P003198,2.867,-7,2,9
146,BAS,P004603,12.817,-15,18,33
146,BAS,P004761,23.5,-12,42,54
146,BAS,P007230,36.034,-4,61,65
146,BAS,P008072,5.867,2,9,7
146,BAS,P009048,26.083,-20,40,60
146,BAS,P010444,19.417,0,34,34
146,BAS,P011085,13.801,5,30,25
146,BAS,P011948,16.867,-7,26,33
146,BAS,P012201,26.984,2,46,44
146,BAS,P012765,15.768,11,27,16
146,MIL,P002812,22.833,7,42,35
146,MIL,P002849,31.967,12,62,50
146,MIL,P005670,28.083,23,66,43
146,MIL,P005775,15.084,-12,17,29
146,MIL,P006509,21.983,-7,35,42
146,MIL,P006701,2.9,-6,0,6
146,MIL,P006721,0.867,-2,2,4
146,MIL,P007201,27.783,18,60,42
146,MIL,P009960,16.366,2,30,28
146,MIL,P011205,31.267,12,64,52
146,MIL,P011926,0.867,-2,2,4
147,MUN,P001288,25.85,2,60,58
147,MUN,P001557,7.95,-1,14,15
147,MUN,P004508,22.567,3,52,49
147,MUN,P005460,3.2,-4,6,10
147,MUN,P006543,4.266,-3,5,8
147,MUN,P006760,23.35,7,55,48
147,MUN,P007056,26.766,-11,49,60
147,MUN,P007639,19.233,17,47,30
147,MUN,P007975,12.816,-11,19,30
147,MUN,P008985,24.016,5,57,52
147,MUN,P010391,12.516,-3,25,28
147,MUN,P011987,17.465,4,36,32
147,PAM,P005356,13.783,1,29,28
147,PAM,P006643,20.549,-4,35,39
147,PAM,P007870,24.983,-7,52,59
147,PAM,P008780,13.184,3,30,27
147,PAM,P010393,21.817,-7,44,51
147,PAM,P010568,29.533,-4,61,65
147,PAM,P012738,19.25,11,44,33
147,PAM,P012739,13.367,4,28,24
147,PAM,P012740,23.767,0,51,51
147,PAM,P012795,19.767,-2,46,48
148,ASV,P000229,14.017,-13,17,30
148,ASV,P003526,8.084,-9,8,17
148,ASV,P004194,26.266,13,59,46
148,ASV,P006568,17.283,11,38,27
148,ASV,P011225,35.15,3,68,65
148,ASV,P012080,29.633,9,65,56
148,ASV,P012729,24.217,-16,38,54
148,ASV,P012730,16.717,-17,21,38
148,ASV,PKIR,28.633,14,66,52
148,MAD,P001392,23.0,-12,42,54
148,MAD,P003733,21.851,11,49,38
148,MAD,P004887,20.769,19,47,28
148,MAD,P005791,28.35,-14,50,64
148,MAD,P005928,23.816,-13,40,53
148,MAD,P006540,25.417,10,53,43
148,MAD,P009213,15.45,-21,21,42
148,MAD,P010868,0.033,0,0,0
148,MAD,P011649,7.467,4,12,8
148,MAD,PCVM,14.552,16,33,17
148,MAD,PTGB,19.3,5,38,33
149,TEL,P004233,10.232,15,25,10
149,TEL,P005145,4.916,2,9,7
149,TEL,P007990,18.299,-4,31,35
149,TEL,P009622,33.297,-2,60,62
149,TEL,P009783,27.965,2,55,53
149,TEL,P011193,26.981,20,62,42
149,TEL,P011199,25.282,1,50,49
149,TEL,P011214,14.632,7,28,21
149,TEL,P011219,21.882,-4,38,42
149,TEL,P011971,10.783,8,26,18
149,TEL,P012744,5.716,-5,6,11
149,ZAL,P002329,29.249,4,56,52
149,ZAL,P003210,5.233,-11,4,15
149,ZAL,P003211,9.532,-5,13,18
149,ZAL,P005504,18.2,-1,35,36
149,ZAL,P006860,7.75,-3,12,15
149,ZAL,P007109,27.016,6,54,48
149,ZAL,P007513,23.483,-1,41,42
149,ZAL,P009917,5.017,-11,6,17
149,ZAL,P010390,13.149,-7,22,29
149,ZAL,P011218,30.7,3,60,57
149,ZAL,P012715,13.8,-11,17,28
149,ZAL,P012787,16.866,-3,30,33
150,PAN,P001926,28.401,16,62,46
150,PAN,P002328,16.949,8,39,31
150,PAN,P003842,29.399,17,69,52
150,PAN,P007553,1.117,-3,0,3
150,PAN,P007866,23.317,10,55,45
150,PAN,P007947,15.133,3,26,23
150,PAN,P011204,25.866,16,60,44
150,PAN,P011209,9.35,-1,14,15
150,PAN,P011221,9.467,3,13,10
150,PAN,P012712,16.7,7,27,20
150,PAN,P012774,24.301,9,45,36
150,RED,P000848,25.284,-3,43,46
150,RED,P002553,20.783,-3,38,41
150,RED,P004720,3.517,0,6,6
150,RED,P005099,17.384,-5,26,31
150,RED,P006436,17.934,-16,24,40
150,RED,P007960,19.201,-5,27,32
150,RED,P008966,9.317,-3,15,18
150,RED,P009035,24.35,-13,40,53
150,RED,P012044,24.167,-11,44,55
150,RED,P012711,3.984,-5,6,11
150,RED,PJDR,19.417,-12,30,42
150,RED,PLUO,14.667,-9,26,35
151,BER,P003958,17.783,-14,32,46
151,BER,P006251,19.301,-8,31,39
151,BER,P007025,14.418,-1,24,25
151,BER,P008173,22.734,-25,39,64
151,BER,P008211,17.267,-2,28,30
151,BER,P008967,22.433,-20,43,63
151,BER,P010791,21.985,-8,36,44
151,BER,P011631,3.434,-2,6,8
151,BER,P011934,20.933,-24,35,59
151,BER,P012720,21.101,-6,34,40
151,BER,P012721,18.616,-25,27,52
151,OLY,P001255,23.067,13,52,39
151,OLY,P003941,20.701,8,47,39
151,OLY,P006589,13.617,4,31,27
151,OLY,P007853,13.65,1,27,26
151,OLY,P007982,20.734,14,48,34
151,OLY,P008811,19.3,19,47,28
151,OLY,P008829,26.101,23,63,40
151,OLY,P008855,24.134,21,61,40
151,OLY,P010392,20.001,14,48,34
151,OLY,P010612,18.7,18,46,28
152,BAR,P000925,22.651,-13,37,50
152,BAR,P002939,23.867,-16,39,55
152,BAR,P003196,7.1,2,16,14
152,BAR,P003204,8.334,11,24,13
152,BAR,P004866,18.534,-11,31,42
152,BAR,P006435,24.217,-18,40,58
152,BAR,P007464,19.317,-10,38,48
152,BAR,P007519,17.884,-3,34,37
152,BAR,P009992,11.7,-9,19,28
152,BAR,P010641,10.25,-9,18,27
152,BAR,P011244,9.417,-8,12,20
152,BAR,P012745,26.734,-16,47,63
152,MCO,P004790,19.466,15,52,37
152,MCO,P005985,27.866,13,66,53
152,MCO,P008099,16.933,-2,34,36
152,MCO,P010588,18.699,-2,32,34
152,MCO,P011196,19.983,24,56,32
152,MCO,P011212,23.066,22,57,35
152,MCO,P011226,22.933,21,61,40
152,MCO,P011231,24.083,-3,41,44
152,MCO,P012709,12.133,7,25,18
152,MCO,PLCZ,14.833,5,31,26
153,PAR,P000956,5.433,2,10,8
153,PAR,P004058,29.517,7,61,54
153,PAR,P004172,13.45,-3,21,24
153,PAR,P007400,32.017,7,65,58
153,PAR,P008987,26.584,5,55,50
153,PAR,P009212,7.983,-9,10,19
153,PAR,P009862,32.583,-17,53,70
153,PAR,P012096,24.417,-9,41,50
153,PAR,P012742,12.433,0,25,25
153,PAR,P012743,15.583,7,34,27
153,VIR,P001133,31.666,-5,57,62
153,VIR,P001844,25.617,4,49,45
153,VIR,P002084,6.75,2,13,11
153,VIR,P003048,21.149,-3,37,40
153,VIR,P003527,13.632,4,28,24
153,VIR,P004007,9.016,-11,12,23
153,VIR,P006739,14.532,-2,28,30
153,VIR,P009549,20.1,2,36,34
153,VIR,P010781,21.849,4,47,43
153,VIR,P012714,13.85,10,37,27
153,VIR,PBCN,21.834,5,41,36
154,RED,P000848,20.717,17,48,31
154,RED,P005099,19.033,0,38,38
154,RED,P006436,30.451,9,74,65
154,RED,P007960,17.883,-10,28,38
154,RED,P008966,12.633,6,29,23
154,RED,P009035,30.933,4,63,59
154,RED,P010985,19.233,-2,42,44
154,RED,P011941,2.8,-6,3,9
154,RED,P012044,12.899,3,26,23
154,RED,PJDR,21.1,14,48,34
154,RED,PLUO,12.318,10,26,16
154,ULK,P001932,25.999,-7,47,54
154,ULK,P002968,8.167,-9,12,21
154,ULK,P004004,23.433,-4,36,40
154,ULK,P005844,12.167,-2,23,25
154,ULK,P006661,23.883,-2,50,52
154,ULK,P006961,13.9,0,31,31
154,ULK,P008962,31.35,-17,60,77
154,ULK,P009849,18.767,-10,35,45
154,ULK,P011052,14.001,-2,29,31
154,ULK,P011157,19.683,0,41,41
154,ULK,P011980,8.65,8,16,8
155,MCO,P002581,11.667,4,28,24
155,MCO,P004197,5.217,-2,8,10
155,MCO,P004790,7.101,-6,9,15
155,MCO,P005985,32.234,-14,63,77
155,MCO,P010588,29.134,1,66,65
155,MCO,P011196,13.117,-8,24,32
155,MCO,P011212,21.234,-12,43,55
155,MCO,P011226,32.9,-4,74,78
155,MCO,P011231,17.517,-11,33,44
155,MCO,P012709,21.317,8,52,44
155,MCO,PLCZ,8.567,-6,15,21
155,TEL,P004233,8.734,5,21,16
155,TEL,P005145,4.851,0,7,7
155,TEL,P009622,33.584,6,80,74
155,TEL,P009783,24.984,8,62,54
155,TEL,P009863,27.467,7,63,56
155,TEL,P011193,20.101,5,47,42
155,TEL,P011199,20.5,-4,48,52
155,TEL,P011214,13.551,15,30,15
155,TEL,P011219,23.95,12,60,48
155,TEL,P011971,16.933,0,38,38
155,TEL,P012744,5.35,-4,9,13
156,MIL,P002812,21.516,9,47,38
156,MIL,P002849,25.734,-8,42,50
156,MIL,P005670,20.983,2,46,44
156,MIL,P006509,28.1,-1,53,54
156,MIL,P006701,10.766,8,27,19
156,MIL,P007201,22.117,-14,32,46
156,MIL,P009960,12.3,5,29,24
156,MIL,P011205,24.1,-13,38,51
156,MIL,P011224,30.517,-5,54,59
156,MIL,P011926,3.867,-8,2,10
156,OLY,P001255,20.0,7,41,34
156,OLY,P003941,18.333,-16,29,45
156,OLY,P007853,13.534,7,27,20
156,OLY,P007982,22.3,-8,42,50
156,OLY,P008811,21.618,21,50,29
156,OLY,P008829,30.05,-1,57,58
156,OLY,P008855,23.484,9,45,36
156,OLY,P010392,14.584,-4,27,31
156,OLY,P010612,26.101,4,55,51
156,OLY,P011194,10.001,6,22,16
157,ASV,P000229,18.933,6,43,37
157,ASV,P003526,15.25,2,38,36
157,ASV,P004194,19.549,-21,27,48
157,ASV,P006568,15.216,-14,23,37
157,ASV,P011225,33.599,-13,64,77
157,ASV,P012080,27.483,-19,47,66
157,ASV,P012729,26.366,3,59,56
157,ASV,P012730,13.4,1,26,25
157,ASV,PKIR,30.199,-10,58,68
157,PAR,P000956,20.0,-6,40,46
157,PAR,P004058,22.716,-6,46,52
157,PAR,P004172,11.267,4,30,26
157,PAR,P007400,21.083,-2,38,40
157,PAR,P009212,22.85,8,53,45
157,PAR,P009862,18.284,14,44,30
157,PAR,P011050,6.6,-9,9,18
157,PAR,P011051,10.5,14,28,14
157,PAR,P011192,18.233,28,51,23
157,PAR,P012096,20.05,11,44,33
157,PAR,P012742,8.517,7,21,14
157,PAR,P012743,19.9,2,46,44
158,BER,P003958,30.416,1,61,60
158,BER,P006251,11.683,-7,12,19
158,BER,P007025,11.949,-11,9,20
158,BER,P008173,24.499,-8,45,53
158,BER,P008211,15.667,0,26,26
158,BER,P008967,20.233,-5,28,33
158,BER,P010791,8.2,-8,6,14
158,BER,P011934,29.499,4,63,59
158,BER,P012720,31.133,2,66,64
158,BER,P012721,16.716,2,39,37
158,ZAL,P002329,28.985,7,59,52
158,ZAL,P003210,24.351,1,44,43
158,ZAL,P003211,23.001,10,36,26
158,ZAL,P005504,14.184,-6,31,37
158,ZAL,P007109,10.951,-4,13,17
158,ZAL,P007513,0.3,0,0,0
158,ZAL,P009917,18.568,-2,40,42
158,ZAL,P010390,21.234,11,40,29
158,ZAL,P011218,31.736,7,66,59
158,ZAL,P012715,17.067,2,37,35
158,ZAL,P012787,9.633,4,19,15
159,BAR,P000925,27.0,12,61,49
159,BAR,P002939,26.05,-2,48,50
159,BAR,P003196,12.983,-7,22,29
159,BAR,P003204,0.35,3,3,0
159,BAR,P004866,31.1,10,67,57
159,BAR,P006435,25.184,-4,50,54
159,BAR,P007464,15.9,-3,26,29
159,BAR,P007519,19.117,4,42,38
159,BAR,P009992,3.366,5,10,5
159,BAR,P011244,8.933,3,22,19
159,BAR,P012745,30.017,4,64,60
159,MAD,P001392,15.916,4,38,34
159,MAD,P003108,28.917,-9,51,60
159,MAD,P003733,15.467,3,30,27
159,MAD,P004887,15.683,-8,29,37
159,MAD,P005791,24.3,3,49,46
159,MAD,P005928,25.684,-1,52,53
159,MAD,P006540,29.317,-6,58,64
159,MAD,P009213,16.016,1,35,34
159,MAD,PCVM,13.783,-2,26,28
159,MAD,PTGB,14.917,-10,22,32
160,BAS,P003198,8.217,10,22,12
160,BAS,P004603,4.75,-6,2,8
160,BAS,P004761,29.284,-4,51,55
160,BAS,P007230,31.734,4,60,56
160,BAS,P008072,3.967,2,9,7
160,BAS,P008850,9.566,-5,9,14
160,BAS,P009048,24.717,1,43,42
160,BAS,P010444,21.917,-4,40,44
160,BAS,P011085,4.551,-3,6,9
160,BAS,P011948,21.267,-3,40,43
160,BAS,P012201,25.134,17,61,44
160,BAS,P012765,14.901,1,32,31
160,PAN,P001926,20.768,-10,38,48
160,PAN,P002328,30.634,4,58,54
160,PAN,P003842,24.8,-12,42,54
160,PAN,P007553,3.2,1,3,2
160,PAN,P007866,30.618,6,64,58
160,PAN,P007947,8.033,-10,8,18
160,PAN,P011204,26.284,4,52,48
160,PAN,P011221,10.134,11,25,14
160,PAN,P012712,10.533,-7,11,18
160,PAN,P012774,35.001,3,64,61
161,IST,P006590,31.734,6,73,67
161,IST,P007200,33.201,-2,73,75
161,IST,P009513,3.1,0,8,8
161,IST,P009846,27.484,-7,59,66
161,IST,P011078,25.901,-10,57,67
161,IST,P011981,19.7,-7,42,49
161,IST,P012786,10.617,1,27,26
161,IST,P012788,19.151,-9,37,46
161,IST,PLHK,29.117,3,64,61
161,PAM,P003960,23.201,9,61,52
161,PAM,P004863,16.5,7,46,39
161,PAM,P005356,14.601,0,34,34
161,PAM,P007870,19.985,10,53,43
161,PAM,P010568,27.819,0,59,59
161,PAM,P011970,13.767,7,38,31
161,PAM,P011982,25.085,5,60,55
161,PAM,P012738,16.401,-6,30,36
161,PAM,P012739,18.717,-4,38,42
161,PAM,P012740,7.684,-5,9,14
161,PAM,P012795,16.25,2,37,35
162,MUN,P001288,15.7,4,36,32
162,MUN,P001557,0.2,-3,0,3
162,MUN,P003583,28.051,-4,54,58
162,MUN,P004508,18.768,-4,41,45
162,MUN,P006543,2.867,0,7,7
162,MUN,P006760,15.334,1,32,31
162,MUN,P007056,27.0,0,54,54
162,MUN,P007639,6.117,-3,13,16
162,MUN,P007975,15.717,0,36,36
162,MUN,P008985,24.284,-2,47,49
162,MUN,P010391,24.734,-1,53,54
162,MUN,P011987,21.233,2,42,40
162,VIR,P001133,31.716,0,68,68
162,VIR,P001844,29.049,5,60,55
162,VIR,P002084,8.116,1,15,14
162,VIR,P003048,21.233,3,43,40
162,VIR,P003527,12.916,-12,23,35
162,VIR,P004554,12.466,6,34,28
162,VIR,P006739,11.833,-6,25,31
162,VIR,P009549,23.533,8,51,43
162,VIR,P010781,23.9,-5,50,55
162,VIR,PBCN,25.233,10,56,46
163,PAR,P000956,15.167,-7,31,38
163,PAR,P004058,8.9,-6,13,19
163,PAR,P004172,11.185,-3,19,22
163,PAR,P007400,31.033,-12,61,73
163,PAR,P009212,7.984,1,11,10
163,PAR,P009862,33.233,-7,64,71
163,PAR,P011051,11.083,-22,13,35
163,PAR,P011192,16.317,-9,33,42
163,PAR,P012096,24.501,-4,41,45
163,PAR,P012742,28.568,-9,46,55
163,PAR,P012743,12.034,-2,28,30
163,RED,P000848,24.084,8,51,43
163,RED,P005099,21.95,20,55,35
163,RED,P006436,25.834,12,64,52
163,RED,P007960,14.85,7,27,20
163,RED,P009035,21.001,5,40,35
163,RED,P010985,11.518,2,18,16
163,RED,P011941,19.0,11,48,37
163,RED,P012044,26.167,5,60,55
163,RED,PJDR,21.884,16,56,40
163,RED,PLUO,13.717,-6,21,27
164,ASV,P000229,9.151,-9,11,20
164,ASV,P003526,9.2,-9,15,24
164,ASV,P004194,27.033,17,66,49
164,ASV,P006568,28.5,23,73,50
164,ASV,P011225,35.617,21,86,65
164,ASV,P011386,3.666,-4,7,11
164,ASV,P012080,31.499,20,82,62
164,ASV,P012729,20.183,-7,38,45
164,ASV,P012730,4.167,-4,9,13
164,ASV,PKIR,30.984,22,78,56
164,ZAL,P002329,23.75,-16,44,60
164,ZAL,P003210,18.066,-16,30,46
164,ZAL,P003211,19.883,-7,41,48
164,ZAL,P005504,13.199,-15,20,35
164,ZAL,P006860,4.85,-5,6,11
164,ZAL,P007109,27.7,-12,58,70
164,ZAL,P009917,15.001,1,31,30
164,ZAL,P010390,12.051,4,26,22
164,ZAL,P011218,31.9,-6,64,70
164,ZAL,P012715,17.6,5,43,38
164,ZAL,P012787,16.0,-3,32,35
165,TEL,P004233,3.467,-5,7,12
165,TEL,P005145,7.017,-4,15,19
165,TEL,P007990,13.883,-8,30,38
165,TEL,P009622,27.784,-32,44,76
165,TEL,P009783,25.402,-19,46,65
165,TEL,P009863,27.451,-29,44,73
165,TEL,P011193,12.55,-6,30,36
165,TEL,P011199,22.034,-16,36,52
165,TEL,P011214,15.9,-14,36,50
165,TEL,P011219,17.217,-13,26,39
165,TEL,P011971,14.7,-17,33,50
165,TEL,P012744,12.6,-12,23,35
165,ULK,P001932,16.1,8,40,32
165,ULK,P002968,15.933,-1,37,38
165,ULK,P002969,5.334,7,17,10
165,ULK,P004004,22.551,28,68,40
165,ULK,P005844,16.017,30,49,19
165,ULK,P006661,23.0,27,61,34
165,ULK,P006961,14.283,2,32,30
165,ULK,P008962,24.834,30,71,41
165,ULK,P009849,17.001,8,48,40
165,ULK,P011052,23.901,27,69,42
165,ULK,P011157,14.351,4,37,33
165,ULK,P011980,6.7,5,16,11
166,MCO,P002581,18.767,5,37,32
166,MCO,P004197,13.983,7,32,25
166,MCO,P004790,4.3,-1,6,7
166,MCO,P005985,30.383,-3,59,62
166,MCO,P010588,31.666,2,62,60
166,MCO,P011196,3.25,-2,4,6
166,MCO,P011212,22.667,-7,37,44
166,MCO,P011226,25.25,0,50,50
166,MCO,P011231,18.984,-4,29,33
166,MCO,P012709,12.917,-1,18,19
166,MCO,PLCZ,17.833,-6,31,37
166,OLY,P001255,18.616,-8,38,46
166,OLY,P003941,15.6,1,23,22
166,OLY,P007853,19.782,9,36,27
166,OLY,P007982,13.165,0,18,18
166,OLY,P008811,24.265,0,51,51
166,OLY,P008829,26.065,3,49,46
166,OLY,P008855,33.349,1,65,64
166,OLY,P010392,3.399,1,6,5
166,OLY,P010612,25.466,1,54,53
166,OLY,P011194,13.666,1,24,23
166,OLY,P011983,6.617,1,11,10
167,BER,P003958,25.868,-17,44,61
167,BER,P006251,13.316,-5,22,27
167,BER,P007025,14.3,-8,24,32
167,BER,P008173,22.1,-8,36,44
167,BER,P008211,14.917,-6,27,33
167,BER,P008384,8.5,0,17,17
167,BER,P008967,20.65,3,45,42
167,BER,P010791,18.766,3,35,32
167,BER,P011934,22.05,-11,35,46
167,BER,P012720,26.483,-7,45,52
167,BER,P012721,13.05,-19,10,29
167,VIR,P001133,23.483,7,52,45
167,VIR,P001844,20.501,6,43,37
167,VIR,P002084,11.568,4,22,18
167,VIR,P003048,27.051,6,58,52
167,VIR,P003527,18.986,8,36,28
167,VIR,P004554,12.584,9,25,16
167,VIR,P005553,5.967,-5,11,16
167,VIR,P006739,14.151,12,30,18
167,VIR,P009549,25.967,11,56,45
167,VIR,P010781,18.752,19,41,22
167,VIR,P012713,5.717,-3,10,13
167,VIR,PBCN,15.283,1,31,30
168,MIL,P001518,13.584,8,32,24
168,MIL,P002812,15.284,-8,25,33
168,MIL,P002849,20.466,8,34,26
168,MIL,P005670,21.768,8,38,30
168,MIL,P006509,15.216,-10,24,34
168,MIL,P006701,17.917,18,40,22
168,MIL,P006721,0.783,1,2,1
168,MIL,P007201,18.068,-2,28,30
168,MIL,P009960,23.334,21,49,28
168,MIL,P011205,26.834,13,56,43
168,MIL,P011224,25.968,12,50,38
168,MIL,P011926,0.783,1,2,1
168,MUN,P001288,24.166,-10,36,46
168,MUN,P001557,5.9,-2,9,11
168,MUN,P003583,30.767,-7,45,52
168,MUN,P004508,15.817,-6,27,33
168,MUN,P006760,20.068,-11,33,44
168,MUN,P007056,24.983,-4,39,43
168,MUN,P007639,2.533,-1,5,6
168,MUN,P007975,18.784,-11,30,41
168,MUN,P008985,18.816,-1,32,33
168,MUN,P010391,9.999,-5,10,15
168,MUN,P011987,28.167,-12,44,56
169,BAR,P000925,21.632,11,53,42
169,BAR,P002939,27.517,-8,55,63
169,BAR,P003196,18.368,-7,36,43
169,BAR,P003204,7.65,4,17,13
169,BAR,P004866,30.867,12,74,62
169,BAR,P006435,23.183,0,51,51
169,BAR,P007464,26.633,7,61,54
169,BAR,P009992,13.183,-2,28,30
169,BAR,P012745,30.967,3,70,67
169,BAS,P003198,10.767,7,30,23
169,BAS,P004603,16.484,9,42,33
169,BAS,P004761,26.016,-4,56,60
169,BAS,P007230,31.266,-5,63,68
169,BAS,P008072,3.433,-5,5,10
169,BAS,P008850,4.434,-4,9,13
169,BAS,P009048,33.5,1,75,74
169,BAS,P010444,20.083,-8,38,46
169,BAS,P011948,25.4,8,54,46
169,BAS,P012201,22.117,-14,43,57
169,BAS,P012765,6.5,-5,10,15
170,IST,P006590,29.75,-18,81,99
170,IST,P007200,38.183,-9,109,118
170,IST,P009846,23.567,2,71,69
170,IST,P011078,34.217,19,110,91
170,IST,P011981,16.7,-10,37,47
170,IST,P012786,25.683,2,57,55
170,IST,P012788,19.683,-11,49,60
170,IST,PLHK,37.217,5,116,111
170,MAD,P001392,33.916,23,107,84
170,MAD,P003108,34.4,18,117,99
170,MAD,P003733,9.75,-5,13,18
170,MAD,P004887,10.849,-14,13,27
170,MAD,P005791,34.15,18,117,99
170,MAD,P005928,30.532,14,101,87
170,MAD,P006540,35.416,3,103,100
170,MAD,P009213,4.617,-12,6,18
170,MAD,P010357,12.482,-7,20,27
170,MAD,PCVM,12.183,-12,18,30
170,MAD,PTGB,6.7,-6,35,41
171,PAM,P003960,21.083,4,51,47
171,PAM,P004863,13.316,2,29,27
171,PAM,P005356,11.767,-3,16,19
171,PAM,P006643,4.317,1,11,10
171,PAM,P007870,21.218,-6,37,43
171,PAM,P010393,14.167,-5,26,31
171,PAM,P010568,28.668,-6,55,61
171,PAM,P011970,12.734,7,36,29
171,PAM,P011982,26.816,-7,50,57
171,PAM,P012738,15.467,11,35,24
171,PAM,P012740,13.534,-2,26,28
171,PAM,P012795,16.918,-1,33,34
171,PAN,P002328,29.583,7,62,55
171,PAN,P003842,27.416,6,53,47
171,PAN,P007866,23.117,-8,40,48
171,PAN,P007947,25.766,0,53,53
171,PAN,P011204,36.999,3,82,79
171,PAN,P011209,3.066,0,6,6
171,PAN,P011221,12.35,-7,27,34
171,PAN,P012712,16.882,9,42,33
171,PAN,P012774,24.816,-5,45,50
172,PAR,P000956,6.95,-8,10,18
172,PAR,P007400,31.567,-6,64,70
172,PAR,P007673,12.5,-8,19,27
172,PAR,P008987,25.599,0,51,51
172,PAR,P009212,2.35,-2,5,7
172,PAR,P009862,36.45,-9,73,82
172,PAR,P011192,28.233,-14,50,64
172,PAR,P012096,23.084,-3,48,51
172,PAR,P012742,20.85,-16,38,54
172,PAR,P012743,12.417,-9,22,31
172,ULK,P001932,24.265,7,59,52
172,ULK,P002968,5.3,-7,12,19
172,ULK,P004004,23.865,7,50,43
172,ULK,P005844,13.316,6,33,27
172,ULK,P006661,14.583,-9,31,40
172,ULK,P006961,0.7,-2,0,2
172,ULK,P008962,19.331,-2,42,44
172,ULK,P009849,23.265,28,57,29
172,ULK,P010560,22.334,21,56,35
172,ULK,P011052,18.699,10,41,31
172,ULK,P011157,6.482,-5,12,17
172,ULK,P011980,27.85,21,62,41
173,BAS,P003198,1.283,-4,0,4
173,BAS,P004603,23.017,5,54,49
173,BAS,P004761,34.534,-8,74,82
173,BAS,P007230,21.468,-23,30,53
173,BAS,P008850,4.467,-1,6,7
173,BAS,P009048,25.367,-10,48,58
173,BAS,P010444,15.184,-3,35,38
173,BAS,P011948,28.95,3,66,63
173,BAS,P012201,31.101,-9,67,76
173,BAS,P012765,14.634,0,35,35
173,MCO,P002581,15.583,-4,36,40
173,MCO,P004197,23.4,-3,52,55
173,MCO,P004790,5.317,2,10,8
173,MCO,P005985,32.8,20,82,62
173,MCO,P008099,6.0,-1,12,13
173,MCO,P009754,21.166,11,47,36
173,MCO,P010588,26.017,4,60,56
173,MCO,P011226,23.434,5,55,50
173,MCO,P011231,16.699,18,44,26
173,MCO,P012709,13.2,-2,31,33
173,MCO,PLCZ,16.384,0,36,36
174,IST,P006590,21.082,-4,40,44
174,IST,P007200,33.415,-12,61,73
174,IST,P009513,3.35,1,6,5
174,IST,P009664,28.499,2,59,57
174,IST,P009846,31.899,0,62,62
174,IST,P010516,3.283,-3,5,8
174,IST,P011078,29.998,1,60,59
174,IST,P012786,12.033,-20,13,33
174,IST,P012788,6.966,-3,12,15
174,IST,PLHK,29.465,3,62,59
174,PAN,P001926,21.849,3,47,44
174,PAN,P002328,35.033,12,75,63
174,PAN,P003842,29.966,17,73,56
174,PAN,P007866,36.183,14,81,67
174,PAN,P011204,35.966,-6,68,74
174,PAN,P011209,2.183,4,8,4
174,PAN,P011221,10.033,-10,10,20
174,PAN,P012712,3.816,-7,2,9
174,PAN,P012774,24.966,8,51,43
175,ASV,P000229,13.25,8,40,32
175,ASV,P003274,3.867,-3,9,12
175,ASV,P003526,9.733,-2,22,24
175,ASV,P004194,21.033,11,58,47
175,ASV,P006568,17.15,1,40,39
175,ASV,P011225,26.1,0,72,72
175,ASV,P011386,13.899,9,28,19
175,ASV,P012080,27.715,0,65,65
175,ASV,P012729,21.183,0,44,44
175,ASV,P012730,0.933,-5,0,5
175,ASV,P012731,21.066,11,60,49
175,ASV,PKIR,24.066,15,62,47
175,RED,P000848,25.416,-6,61,67
175,RED,P004720,5.866,6,20,14
175,RED,P005099,14.949,-16,25,41
175,RED,P006436,27.866,-13,64,77
175,RED,P007960,22.249,8,52,44
175,RED,P008966,9.133,2,18,16
175,RED,P009035,26.132,0,68,68
175,RED,P011941,4.733,-11,5,16
175,RED,P011964,3.849,-9,2,11
175,RED,P012044,28.216,2,71,69
175,RED,PJDR,16.799,-14,34,48
175,RED,PLUO,14.782,6,35,29
176,PAM,P003960,21.666,-4,51,55
176,PAM,P004863,15.617,-2,27,29
176,PAM,P005356,12.05,-10,14,24
176,PAM,P006433,16.032,5,36,31
176,PAM,P007870,25.533,1,60,59
176,PAM,P010393,11.716,2,19,17
176,PAM,P010568,25.582,-4,58,62
176,PAM,P011970,14.434,-3,25,28
176,PAM,P011982,20.617,13,49,36
176,PAM,P012738,15.416,-6,21,27
176,PAM,P012739,5.417,-1,7,8
176,PAM,P012795,15.915,-16,28,44
176,ZAL,P002329,30.949,11,77,66
176,ZAL,P003210,20.432,4,37,33
176,ZAL,P003211,16.282,12,35,23
176,ZAL,P005504,14.267,1,35,34
176,ZAL,P007109,30.598,4,68,64
176,ZAL,P007513,12.484,-8,27,35
176,ZAL,P009917,4.617,-6,3,9
176,ZAL,P010390,7.65,-1,12,13
176,ZAL,P011218,27.549,10,71,61
176,ZAL,P012715,24.667,3,46,43
176,ZAL,P012787,10.5,-5,9,14
177,BER,P003958,24.084,1,41,40
177,BER,P006251,15.917,-7,35,42
177,BER,P007025,8.683,5,19,14
177,BER,P008173,25.751,-9,49,58
177,BER,P008211,14.25,3,27,24
177,BER,P008384,15.334,-3,28,31
177,BER,P008967,28.401,-7,52,59
177,BER,P010791,17.217,-4,29,33
177,BER,P011934,22.567,-2,47,49
177,BER,P012720,27.801,-7,53,60
177,MIL,P001518,9.051,1,16,15
177,MIL,P002812,21.535,2,44,42
177,MIL,P002849,25.235,6,53,47
177,MIL,P005670,23.201,-1,47,48
177,MIL,P006509,11.602,4,23,19
177,MIL,P006701,22.385,8,52,44
177,MIL,P007201,21.735,-3,41,44
177,MIL,P009960,5.817,0,13,13
177,MIL,P011205,30.202,8,61,53
177,MIL,P011224,29.252,5,60,55
178,MAD,P001392,22.167,-2,41,43
178,MAD,P003108,21.4,13,53,40
178,MAD,P003733,19.568,13,49,36
178,MAD,P004887,20.868,14,53,39
178,MAD,P005791,19.133,7,39,32
178,MAD,P005928,24.218,16,58,42
178,MAD,P006540,20.433,8,43,35
178,MAD,P010357,16.701,7,35,28
178,MAD,P010623,15.783,5,34,29
178,MAD,P011649,1.9,1,4,3
178,MAD,PTGB,17.834,23,51,28
178,MUN,P001288,17.867,-18,30,48
178,MUN,P003583,23.366,-12,38,50
178,MUN,P004508,17.468,-8,33,41
178,MUN,P006760,18.334,-3,35,38
178,MUN,P007056,24.483,-11,44,55
178,MUN,P007639,14.284,-1,30,31
178,MUN,P007975,20.934,-13,33,46
178,MUN,P008985,15.899,-4,33,37
178,MUN,P010391,24.833,-22,41,63
178,MUN,P011987,22.532,-13,38,51
179,BAR,P000925,18.05,9,46,37
179,BAR,P002939,35.433,17,80,63
179,BAR,P003196,21.883,-1,40,41
179,BAR,P003204,0.067,0,0,0
179,BAR,P004866,26.9,17,65,48
179,BAR,P007464,16.65,-15,25,40
179,BAR,P007519,21.5,-3,41,44
179,BAR,P009992,19.517,8,47,39
179,BAR,P011244,9.5,-7,16,23
179,BAR,P012745,30.5,15,70,55
179,OLY,P001255,16.083,-15,33,48
179,OLY,P003941,19.168,12,41,29
179,OLY,P006589,11.3,0,21,21
179,OLY,P007853,22.55,11,45,34
179,OLY,P007982,23.383,9,46,37
179,OLY,P008811,20.765,-20,37,57
179,OLY,P008829,28.7,-8,57,65
179,OLY,P008855,16.617,-17,32,49
179,OLY,P010392,7.284,-3,9,12
179,OLY,P010612,30.067,-12,57,69
179,OLY,P011983,4.083,3,12,9
180,TEL,P004233,11.883,11,34,23
180,TEL,P007990,23.333,7,59,52
180,TEL,P009622,24.899,10,57,47
180,TEL,P009783,25.816,15,63,48
180,TEL,P009863,32.199,21,83,62
180,TEL,P011199,29.115,24,73,49
180,TEL,P011214,11.684,-7,22,29
180,TEL,P011219,27.616,9,54,45
180,TEL,P011433,0.15,-1,2,3
180,TEL,P011971,10.15,3,25,22
180,TEL,P012744,3.15,-7,3,10
180,VIR,P001133,28.166,-23,46,69
180,VIR,P001844,24.267,-17,44,61
180,VIR,P002084,7.55,9,25,16
180,VIR,P003048,25.583,-20,47,67
180,VIR,P003527,20.383,-17,26,43
180,VIR,P004554,13.716,5,30,25
180,VIR,P006739,16.715,-1,43,44
180,VIR,P009549,23.017,-18,34,52
180,VIR,P010781,16.582,0,38,38
180,VIR,PBCN,24.016,-3,57,60
181,MUN,P001288,30.916,-15,62,77
181,MUN,P001557,5.283,0,10,10
181,MUN,P004508,27.532,-2,56,58
181,MUN,P005460,13.215,7,25,18
181,MUN,P006543,11.332,-2,18,20
181,MUN,P006760,11.915,1,22,21
181,MUN,P007056,36.799,-2,80,82
181,MUN,P007639,12.767,-14,21,35
181,MUN,P007975,25.266,4,54,50
181,MUN,P008985,19.599,-11,37,48
181,MUN,P010391,19.599,0,45,45
181,MUN,P011987,10.767,-1,25,26
181,ULK,P001932,31.932,22,83,61
181,ULK,P002968,10.783,-4,14,18
181,ULK,P004004,20.799,-6,38,44
181,ULK,P005844,5.966,9,19,10
181,ULK,P006661,29.198,17,71,54
181,ULK,P006961,21.8,-10,41,51
181,ULK,P009849,23.549,-2,46,48
181,ULK,P010560,27.932,8,69,61
181,ULK,P011052,9.733,-10,11,21
181,ULK,P011157,28.249,2,65,63
181,ULK,P011980,15.049,9,33,24
182,MCO,P002581,4.667,-7,5,12
182,MCO,P004197,16.717,-8,26,34
182,MCO,P004790,14.168,1,33,32
182,MCO,P005985,36.219,-26,56,82
182,MCO,P008099,21.167,-18,36,54
182,MCO,P010588,23.385,-23,28,51
182,MCO,P011196,13.116,-7,24,31
182,MCO,P011226,19.301,-2,31,33
182,MCO,P011231,16.734,-23,20,43
182,MCO,P012709,14.701,-5,25,30
182,MCO,PLCZ,19.835,-7,31,38
182,PAN,P001926,17.632,-6,27,33
182,PAN,P002328,32.683,29,75,46
182,PAN,P003842,30.566,33,72,39
182,PAN,P006544,1.85,6,6,0
182,PAN,P007866,21.816,15,49,34
182,PAN,P011204,31.683,22,73,51
182,PAN,P011209,7.116,5,15,10
182,PAN,P011221,8.6,-6,16,22
182,PAN,P012712,18.183,10,39,29
182,PAN,P012774,29.866,17,68,51
183,MIL,P001518,3.9,-9,0,9
183,MIL,P002812,12.95,-4,25,29
183,MIL,P002849,24.733,-6,34,40
183,MIL,P005670,26.1,-5,33,38
183,MIL,P006509,13.484,-7,27,34
183,MIL,P006701,19.166,-16,32,48
183,MIL,P007201,22.767,-12,38,50
183,MIL,P009960,15.65,3,27,24
183,MIL,P011205,28.966,-9,37,46
183,MIL,P011224,32.284,-5,57,62
183,RED,P000848,7.683,1,14,13
183,RED,P002553,12.567,-7,20,27
183,RED,P005099,25.017,14,46,32
183,RED,P006436,28.334,19,59,40
183,RED,P007960,21.433,18,42,24
183,RED,P008966,0.45,2,2,0
183,RED,P009035,33.067,4,64,60
183,RED,P011941,6.933,10,12,2
183,RED,P011964,5.017,-1,10,11
183,RED,P012044,16.134,-1,34,35
183,RED,PJDR,22.916,19,44,25
183,RED,PLUO,20.449,-8,33,41
184,MAD,P001392,16.5,4,33,29
184,MAD,P003108,24.868,8,56,48
184,MAD,P003733,15.649,3,32,29
184,MAD,P005791,38.301,7,80,73
184,MAD,P005928,29.917,7,64,57
184,MAD,P006540,28.917,14,65,51
184,MAD,P009213,6.683,1,14,13
184,MAD,P010357,22.984,-3,45,48
184,MAD,P010623,0.85,-2,0,2
184,MAD,PCVM,14.251,7,34,27
184,MAD,PTGB,26.085,4,57,53
184,PAM,P003960,29.169,-1,66,67
184,PAM,P004863,18.918,4,47,43
184,PAM,P005356,5.151,-6,6,12
184,PAM,P006643,16.134,6,37,31
184,PAM,P007870,23.352,4,54,50
184,PAM,P010393,9.534,-6,13,19
184,PAM,P010568,29.569,-14,51,65
184,PAM,P011970,26.635,-10,44,54
184,PAM,P012738,18.284,-12,26,38
184,PAM,P012739,9.067,-5,11,16
184,PAM,P012740,17.067,1,35,34
184,PAM,P012795,22.135,-11,40,51
185,IST,P006590,22.551,7,48,41
185,IST,P007200,34.417,28,91,63
185,IST,P009664,30.15,24,80,56
185,IST,P009846,31.651,13,78,65
185,IST,P010400,9.617,6,20,14
185,IST,P011078,22.784,21,65,44
185,IST,P011981,17.917,6,43,37
185,IST,P012710,3.167,-1,4,5
185,IST,P012788,16.134,14,43,29
185,IST,PLHK,11.617,2,23,21
185,VIR,P001133,14.6,-14,24,38
185,VIR,P001844,26.616,-7,51,58
185,VIR,P002084,16.233,-4,32,36
185,VIR,P003048,24.649,-22,44,66
185,VIR,P003527,15.083,-21,27,48
185,VIR,P004554,8.216,-3,13,16
185,VIR,P005553,8.7,-4,21,25
185,VIR,P006739,10.716,-10,19,29
185,VIR,P008847,13.2,-1,30,31
185,VIR,P009549,22.5,-7,43,50
185,VIR,P010781,18.916,-21,31,52
185,VIR,PBCN,20.566,-6,40,46
186,ASV,P000229,15.784,-10,20,30
186,ASV,P003526,11.75,-14,14,28
186,ASV,P004194,24.017,-12,37,49
186,ASV,P006568,19.134,-16,33,49
186,ASV,P011225,29.668,-17,51,68
186,ASV,P011386,10.333,-8,12,20
186,ASV,P012080,29.351,-21,52,73
186,ASV,P012729,17.567,-26,21,47
186,ASV,P012731,19.284,4,35,31
186,ASV,PKIR,23.117,-5,40,45
186,BER,P003958,23.8,15,52,37
186,BER,P006251,19.768,7,38,31
186,BER,P006819,1.384,0,2,2
186,BER,P007025,1.384,0,2,2
186,BER,P008173,20.85,14,45,31
186,BER,P008211,19.151,11,43,32
186,BER,P008384,19.733,14,42,28
186,BER,P008967,20.634,14,49,35
186,BER,P010791,16.25,18,44,26
186,BER,P011934,18.8,10,40,30
186,BER,P012720,24.318,14,56,42
186,BER,P012721,13.933,8,27,19
187,BAR,P000925,17.717,5,41,36
187,BAR,P002939,25.4,6,55,49
187,BAR,P003196,21.45,13,48,35
187,BAR,P003204,2.734,-1,6,7
187,BAR,P004866,28.284,21,69,48
187,BAR,P007464,17.733,-9,30,39
187,BAR,P007519,15.766,4,34,30
187,BAR,P009992,27.899,30,71,41
187,BAR,P011244,13.25,-7,25,32
187,BAR,P011666,1.567,0,4,4
187,BAR,P012197,1.567,0,4,4
187,BAR,P012745,26.633,28,68,40
187,ZAL,P002329,29.167,-6,52,58
187,ZAL,P003210,13.85,-12,27,39
187,ZAL,P003211,17.016,-27,21,48
187,ZAL,P005504,26.517,-4,57,61
187,ZAL,P007109,21.349,-31,23,54
187,ZAL,P007513,2.083,3,7,4
187,ZAL,P009917,10.15,-11,14,25
187,ZAL,P010390,6.401,-8,13,21
187,ZAL,P011218,24.15,6,46,40
187,ZAL,P012715,24.983,1,55,54
187,ZAL,P012787,24.334,-1,50,51
188,BAS,P003198,20.667,10,44,34
188,BAS,P004603,32.067,10,62,52
188,BAS,P004761,21.45,-4,33,37
188,BAS,P007230,20.133,-2,31,33
188,BAS,P008850,0.1,0,0,0
188,BAS,P009048,26.95,8,59,51
188,BAS,P010444,7.833,1,18,17
188,BAS,P011085,9.9,4,19,15
188,BAS,P011948,22.7,12,54,42
188,BAS,P012201,25.15,13,59,46
188,BAS,P012765,13.05,3,21,18
188,OLY,P001255,16.616,-4,25,29
188,OLY,P003941,24.533,0,44,44
188,OLY,P007853,9.017,-13,13,26
188,OLY,P007982,32.899,-5,63,68
188,OLY,P008811,15.366,-11,25,36
188,OLY,P008829,22.1,-9,38,47
188,OLY,P008855,13.033,-3,19,22
188,OLY,P010392,9.55,-5,18,23
188,OLY,P010612,29.849,-4,55,59
188,OLY,P011194,17.999,-2,31,33
188,OLY,P011983,9.033,1,14,13
189,PAR,P004058,20.4,30,60,30
189,PAR,P004172,0.717,-3,3,6
189,PAR,P007400,26.767,13,67,54
189,PAR,P007673,27.85,11,62,51
189,PAR,P008987,30.699,3,64,61
189,PAR,P009862,21.15,-12,36,48
189,PAR,P011051,21.567,7,46,39
189,PAR,P011192,3.533,-13,0,13
189,PAR,P012096,24.75,6,56,50
189,PAR,P012742,22.567,3,46,43
189,TEL,P007990,13.8,-7,29,36
189,TEL,P009622,27.9,-10,47,57
189,TEL,P009783,26.483,-11,48,59
189,TEL,P009863,28.316,-2,53,55
189,TEL,P011193,16.484,-6,41,47
189,TEL,P011199,20.634,-1,39,40
189,TEL,P011214,14.25,-2,35,37
189,TEL,P011219,24.899,-8,44,52
189,TEL,P011971,19.218,-5,40,45
189,TEL,P012744,8.016,7,19,12
190,BER,P003958,24.934,5,51,46
190,BER,P006251,6.25,-13,4,17
190,BER,P008173,25.7,4,48,44
190,BER,P008211,5.749,-5,8,13
190,BER,P008384,12.299,-18,13,31
190,BER,P008780,14.3,-21,17,38
190,BER,P008967,23.101,-12,35,47
190,BER,P010791,16.733,-24,17,41
190,BER,P011934,23.267,7,48,41
190,BER,P012720,25.801,2,50,48
190,BER,P012721,21.866,-10,34,44
190,MUN,P001288,16.283,26,43,17
190,MUN,P001557,12.166,8,25,17
190,MUN,P003583,22.682,-10,37,47
190,MUN,P004508,16.549,22,39,17
190,MUN,P006543,3.783,4,8,4
190,MUN,P006760,6.183,-10,4,14
190,MUN,P007056,22.615,-7,40,47
190,MUN,P007639,17.316,27,45,18
190,MUN,P007975,16.766,26,43,17
190,MUN,P008985,23.232,-9,39,48
190,MUN,P010391,18.966,13,44,31
190,MUN,P011987,23.449,-5,43,48
191,BAS,P003198,7.5,0,19,19
191,BAS,P004603,6.6,-9,13,22
191,BAS,P004761,27.867,3,66,63
191,BAS,P007230,19.35,-19,38,57
191,BAS,P008850,3.733,-3,8,11
191,BAS,P009048,33.634,7,80,73
191,BAS,P010444,31.55,15,73,58
191,BAS,P011085,14.416,-1,30,31
191,BAS,P011948,22.867,4,53,49
191,BAS,P012201,32.483,8,75,67
191,RED,P002553,23.734,6,57,51
191,RED,P005099,17.683,-11,31,42
191,RED,P006436,35.183,-3,77,80
191,RED,P007960,16.033,-7,30,37
191,RED,P009035,31.516,-2,68,70
191,RED,P011941,8.484,1,22,21
191,RED,P012044,26.05,14,65,51
191,RED,P012801,16.883,-8,37,45
191,RED,PLUO,24.434,5,63,58
192,ASV,P000229,10.083,0,13,13
192,ASV,P003526,20.149,0,34,34
192,ASV,P004194,18.199,-11,22,33
192,ASV,P005094,24.816,-12,39,51
192,ASV,P006568,26.284,0,48,48
192,ASV,P011225,29.999,-9,52,61
192,ASV,P011386,9.617,-1,11,12
192,ASV,P012080,30.299,-10,50,60
192,ASV,P012729,10.649,3,19,16
192,ASV,P012731,19.9,-10,27,37
192,VIR,P001844,27.983,9,50,41
192,VIR,P002084,22.616,14,49,35
192,VIR,P003048,18.183,1,32,31
192,VIR,P003527,4.367,-3,6,9
192,VIR,P004554,16.65,10,36,26
192,VIR,P006739,18.949,18,44,26
192,VIR,P008847,21.899,-4,28,32
192,VIR,P009549,24.166,-5,39,44
192,VIR,P010781,15.733,11,28,17
192,VIR,PBCN,29.449,-1,53,54
193,BAR,P000925,19.266,-11,37,48
193,BAR,P002939,29.382,-16,58,74
193,BAR,P003196,20.482,-13,37,50
193,BAR,P004866,28.549,-23,51,74
193,BAR,P007464,11.116,4,27,23
193,BAR,P007519,24.348,-19,43,62
193,BAR,P009992,26.599,-18,43,61
193,BAR,P011244,13.116,-9,29,38
193,BAR,P012745,27.132,-15,45,60
193,IST,P004888,9.967,10,26,16
193,IST,P006590,18.1,13,49,36
193,IST,P007200,33.367,24,88,64
193,IST,P009664,26.633,21,64,43
193,IST,P009846,31.668,18,75,57
193,IST,P010400,0.567,0,0,0
193,IST,P011078,25.234,6,54,48
193,IST,P011981,5.101,3,13,10
193,IST,P012786,8.084,2,18,16
193,IST,P012788,21.8,21,65,44
193,IST,PLHK,19.484,2,38,36
194,OLY,P001255,25.35,11,59,48
194,OLY,P003941,31.517,28,81,53
194,OLY,P006589,4.183,-5,5,10
194,OLY,P007853,5.817,3,11,8
194,OLY,P007982,20.7,-3,39,42
194,OLY,P008829,19.916,24,51,27
194,OLY,P008855,23.833,20,58,38
194,OLY,P010392,20.0,3,36,33
194,OLY,P010612,25.467,19,65,46
194,OLY,P011194,19.034,-10,35,45
194,OLY,P011965,4.183,-5,5,10
194,TEL,P004233,13.5,9,30,21
194,TEL,P007990,27.633,2,56,54
194,TEL,P009783,25.051,-24,37,61
194,TEL,P009863,27.516,-20,44,64
194,TEL,P011193,23.784,-14,42,56
194,TEL,P011199,22.617,-12,33,45
194,TEL,P011214,12.05,-5,26,31
194,TEL,P011219,24.85,-23,38,61
194,TEL,P011433,0.2,0,0,0
194,TEL,P011971,15.516,4,36,32
194,TEL,P012744,7.283,-2,18,20
195,MAD,P001392,15.649,-11,34,45
195,MAD,P003108,18.266,-21,29,50
195,MAD,P003733,15.099,-10,26,36
195,MAD,P004887,23.765,-18,44,62
195,MAD,P005928,18.799,-16,36,52
195,MAD,P006540,17.466,-16,30,46
195,MAD,P009005,16.083,-12,24,36
195,MAD,P009213,10.483,-2,18,20
195,MAD,P010357,23.032,-5,48,53
195,MAD,P010623,9.099,5,20,15
195,MAD,PBMT,20.149,-1,43,44
195,MAD,PCVM,12.1,-13,18,31
195,MCO,P002581,9.333,12,24,12
195,MCO,P004197,18.482,13,42,29
195,MCO,P004790,18.349,17,51,34
195,MCO,P005985,32.616,27,84,57
195,MCO,P009754,18.5,8,49,41
195,MCO,P011196,16.766,5,37,32
195,MCO,P011212,24.549,10,56,46
195,MCO,P011226,25.85,14,63,49
195,MCO,P011231,21.65,7,47,40
195,MCO,PLCZ,13.9,7,37,30
196,PAN,P001926,26.768,15,62,47
196,PAN,P002328,25.083,3,49,46
196,PAN,P003842,30.917,14,67,53
196,PAN,P007866,33.834,10,70,60
196,PAN,P011204,35.635,14,75,61
196,PAN,P011209,0.833,2,2,0
196,PAN,P011221,7.384,-1,15,16
196,PAN,P012712,7.867,3,16,13
196,PAN,P012774,31.684,5,64,59
196,PAR,P000956,12.399,-3,22,25
196,PAR,P004058,9.35,-1,17,18
196,PAR,P004172,8.884,-5,13,18
196,PAR,P007400,24.7,-9,46,55
196,PAR,P007673,21.917,-7,37,44
196,PAR,P008987,24.899,-3,45,48
196,PAR,P011050,13.801,-4,24,28
196,PAR,P011051,21.734,-10,40,50
196,PAR,P011192,11.317,-10,19,29
196,PAR,P012096,16.216,-1,28,29
196,PAR,P012742,33.483,-8,62,70
196,PAR,P012743,1.3,-4,2,6
197,MIL,P001518,1.9,2,4,2
197,MIL,P002812,16.882,-3,27,30
197,MIL,P002849,27.45,3,51,48
197,MIL,P005670,8.683,-3,22,25
197,MIL,P006509,16.45,1,35,34
197,MIL,P007201,21.599,-16,37,53
197,MIL,P007831,13.399,-14,27,41
197,MIL,P009960,12.167,-10,25,35
197,MIL,P011205,33.216,-11,56,67
197,MIL,P011224,29.516,-7,47,54
197,MIL,P012800,18.733,-2,29,31
197,PAM,P003960,14.683,0,29,29
197,PAM,P005356,10.968,-10,15,25
197,PAM,P006433,11.201,-2,19,21
197,PAM,P007870,24.517,2,46,44
197,PAM,P010393,15.151,10,34,24
197,PAM,P010568,28.801,14,65,51
197,PAM,P011970,15.451,15,39,24
197,PAM,P011982,26.617,21,63,42
197,PAM,P012738,16.002,8,37,29
197,PAM,P012739,7.484,1,17,16
197,PAM,P012740,21.534,7,44,37
197,PAM,P012795,7.601,-6,12,18
198,ULK,P001932,19.783,-5,34,39
198,ULK,P002968,22.283,-15,32,47
198,ULK,P002969,8.583,-9,20,29
198,ULK,P004004,23.215,-1,56,57
198,ULK,P005844,20.4,-13,30,43
198,ULK,P006661,26.216,-16,50,66
198,ULK,P009849,23.849,-4,56,60
198,ULK,P010560,24.516,-25,33,58
198,ULK,P011052,13.166,-12,21,33
198,ULK,P011157,13.15,-3,37,40
198,ULK,P011201,2.417,-6,3,9
198,ULK,P012724,2.417,-6,3,9
198,ZAL,P002329,22.933,17,59,42
198,ZAL,P002676,14.551,3,39,36
198,ZAL,P003210,13.234,1,29,28
198,ZAL,P003211,13.901,11,36,25
198,ZAL,P005504,22.001,35,59,24
198,ZAL,P006860,1.6,6,6,0
198,ZAL,P007109,19.134,-8,42,50
198,ZAL,P007513,1.05,-3,2,5
198,ZAL,P010390,12.967,-15,25,40
198,ZAL,P011218,28.335,22,71,49
198,ZAL,P012715,32.169,28,80,52
198,ZAL,P012787,18.135,18,42,24
199,BER,P003958,16.034,11,41,30
199,BER,P006251,5.967,-6,9,15
199,BER,P008173,13.233,3,30,27
199,BER,P008211,13.667,-2,29,31
199,BER,P008384,16.983,3,42,39
199,BER,P008780,26.267,8,57,49
199,BER,P008967,26.9,11,62,51
199,BER,P010791,14.566,1,29,28
199,BER,P011934,25.434,8,60,52
199,BER,P012720,22.95,4,47,43
199,BER,P012721,17.999,4,39,35
199,RED,P000848,12.783,-7,22,29
199,RED,P002553,14.982,-3,28,31
199,RED,P005099,23.382,-2,48,50
199,RED,P006436,30.198,-8,60,68
199,RED,P007960,15.683,-12,25,37
199,RED,P008966,2.833,-3,8,11
199,RED,P009035,34.181,-2,71,73
199,RED,P011941,4.217,-5,6,11
199,RED,P012044,24.482,-10,47,57
199,RED,P012801,24.566,5,52,47
199,RED,PLUO,12.683,2,33,31
200,ASV,P000229,33.7,3,60,57
200,ASV,P003526,13.001,1,25,24
200,ASV,P004194,14.683,-1,24,25
200,ASV,P005094,15.149,0,26,26
200,ASV,P006568,25.317,13,52,39
200,ASV,P011225,34.399,23,72,49
200,ASV,P011386,7.584,-3,12,15
200,ASV,P012729,24.884,14,52,38
200,ASV,P012731,27.4,8,49,41
200,ASV,PKIR,3.883,2,8,6
200,MUN,P001288,30.718,-12,45,57
200,MUN,P001557,7.8,-1,15,16
200,MUN,P004508,19.535,-19,24,43
200,MUN,P005460,20.635,4,39,35
200,MUN,P006760,15.701,-2,28,30
200,MUN,P007056,10.418,1,21,20
200,MUN,P007639,16.734,-18,19,37
200,MUN,P007975,22.535,-2,37,39
200,MUN,P008985,12.133,-3,22,25
200,MUN,P010391,13.317,-8,16,24
200,MUN,P011987,30.484,0,54,54
201,ULK,P001932,23.032,20,58,38
201,ULK,P002968,11.466,10,27,17
201,ULK,P002969,6.267,-2,15,17
201,ULK,P004004,29.898,9,62,53
201,ULK,P005844,16.682,-6,30,36
201,ULK,P006068,21.233,20,53,33
201,ULK,P006661,30.798,21,73,52
201,ULK,P009849,16.016,-5,33,38
201,ULK,P011052,16.066,-5,28,33
201,ULK,P011157,28.532,3,61,58
201,VIR,P001844,30.2,-15,52,67
201,VIR,P002084,14.151,-10,22,32
201,VIR,P003048,14.966,-10,25,35
201,VIR,P003527,21.366,-6,37,43
201,VIR,P004554,21.234,2,43,41
201,VIR,P005553,2.601,-3,4,7
201,VIR,P006739,12.617,-2,24,26
201,VIR,P008847,19.516,-8,40,48
201,VIR,P009549,27.833,-7,58,65
201,VIR,P010781,35.516,-6,70,76
202,PAN,P002328,26.567,-13,49,62
202,PAN,P003842,23.666,-26,35,61
202,PAN,P005161,12.784,-7,23,30
202,PAN,P007866,27.05,-20,46,66
202,PAN,P011204,34.75,-10,67,77
202,PAN,P011209,20.699,4,45,41
202,PAN,P011221,16.334,11,40,29
202,PAN,P012712,16.583,4,35,31
202,PAN,P012774,21.567,-18,35,53
202,TEL,P004233,3.667,-5,5,10
202,TEL,P005145,9.25,5,19,14
202,TEL,P007990,4.567,13,14,1
202,TEL,P009622,32.35,19,72,53
202,TEL,P009783,33.784,26,83,57
202,TEL,P009863,30.668,14,74,60
202,TEL,P011193,12.417,-16,20,36
202,TEL,P011199,30.584,30,78,48
202,TEL,P011214,9.417,-15,12,27
202,TEL,P011219,10.667,-14,15,29
202,TEL,P011971,22.634,18,58,40
203,MAD,P001392,17.25,-11,35,46
203,MAD,P003108,17.067,0,36,36
203,MAD,P003733,21.584,15,53,38
203,MAD,P004887,28.8,9,73,64
203,MAD,P005928,26.55,9,66,57
203,MAD,P006540,23.166,1,53,52
203,MAD,P009005,25.85,2,61,59
203,MAD,P009213,11.2,-4,17,21
203,MAD,PBMT,15.15,6,32,26
203,MAD,PCVM,13.383,-2,24,26
203,OLY,P001255,25.567,14,66,52
203,OLY,P006589,24.034,-1,51,52
203,OLY,P007853,23.401,-9,49,58
203,OLY,P008829,27.134,-5,59,64
203,OLY,P008855,26.484,2,61,59
203,OLY,P010392,10.067,-3,19,22
203,OLY,P010612,19.934,-10,36,46
203,OLY,P011194,14.617,-7,27,34
203,OLY,P011965,18.267,1,42,41
203,OLY,P011983,10.5,-7,15,22
204,IST,P004888,23.768,-9,41,50
204,IST,P006590,29.117,9,63,54
204,IST,P007200,23.884,-3,44,47
204,IST,P009664,24.883,2,48,46
204,IST,P009846,27.417,13,63,50
204,IST,P011078,25.884,-12,47,59
204,IST,P011981,11.951,-2,16,18
204,IST,P012788,17.384,5,40,35
204,IST,PLHK,15.717,-13,28,41
204,MCO,P002581,10.35,2,26,24
204,MCO,P004197,5.083,3,12,9
204,MCO,P005985,33.233,1,66,65
204,MCO,P009754,22.149,4,48,44
204,MCO,P010588,25.467,-5,47,52
204,MCO,P011196,12.599,-11,15,26
204,MCO,P011212,22.066,6,45,39
204,MCO,P011226,29.799,-4,58,62
204,MCO,P011231,17.999,6,42,36
204,MCO,P012709,4.45,-7,3,10
204,MCO,PLCZ,16.8,15,38,23
205,BAR,P000925,26.749,13,58,45
205,BAR,P002939,28.967,0,57,57
205,BAR,P003196,13.25,-17,12,29
205,BAR,P004866,33.249,1,58,57
205,BAR,P006435,12.683,-7,10,17
205,BAR,P007464,3.016,-4,5,9
205,BAR,P007519,24.149,8,50,42
205,BAR,P009992,17.933,-10,30,40
205,BAR,P011244,12.016,-8,11,19
205,BAR,P012745,27.983,4,59,55
205,MIL,P001518,12.15,-2,17,19
205,MIL,P002812,11.417,0,20,20
205,MIL,P002849,26.899,0,53,53
205,MIL,P005670,8.734,5,13,8
205,MIL,P007032,1.9,-3,0,3
205,MIL,P007201,14.817,13,31,18
205,MIL,P007831,32.8,5,66,61
205,MIL,P009960,15.483,-4,26,30
205,MIL,P011205,26.5,-12,43,55
205,MIL,P011224,28.833,3,59,56
205,MIL,P012800,20.467,15,42,27
206,PAR,P003983,15.55,6,26,20
206,PAR,P007400,31.416,18,66,48
206,PAR,P007673,17.4,3,29,26
206,PAR,P008987,28.782,0,57,57
206,PAR,P009862,25.899,4,57,53
206,PAR,P011051,21.65,-1,40,41
206,PAR,P012096,16.833,-7,30,37
206,PAR,P012742,27.666,6,61,55
206,PAR,P012743,14.799,16,39,23
206,ZAL,P002329,17.132,0,32,32
206,ZAL,P002676,21.182,-5,43,48
206,ZAL,P003210,10.1,-13,13,26
206,ZAL,P003211,8.266,1,10,9
206,ZAL,P005504,16.616,-4,32,36
206,ZAL,P007109,25.299,-10,43,53
206,ZAL,P007513,25.565,-11,49,60
206,ZAL,P010390,21.932,-3,40,43
206,ZAL,P011218,31.632,4,61,57
206,ZAL,P012715,17.466,-1,31,32
206,ZAL,P012787,4.8,-3,6,9
207,BAS,P003198,4.833,1,8,7
207,BAS,P004603,16.316,-14,20,34
207,BAS,P004761,26.233,-10,35,45
207,BAS,P007230,32.416,-13,49,62
207,BAS,P007946,18.516,2,41,39
207,BAS,P008850,8.216,-6,14,20
207,BAS,P009048,25.433,-20,26,46
207,BAS,P010444,19.633,3,38,35
207,BAS,P011085,2.85,-4,4,8
207,BAS,P011948,17.866,-12,30,42
207,BAS,P012201,27.683,-2,45,47
207,PAM,P003960,22.582,25,46,21
207,PAM,P004863,16.599,2,33,31
207,PAM,P005356,22.832,10,45,35
207,PAM,P006433,11.816,6,18,12
207,PAM,P007870,28.715,7,51,44
207,PAM,P010393,11.316,0,22,22
207,PAM,P010568,27.799,14,51,37
207,PAM,P011970,11.899,-5,25,30
207,PAM,P011982,19.516,-4,37,41
207,PAM,P012740,5.3,3,11,8
207,PAM,P012795,21.616,17,46,29
208,PAM,P000556,9.967,-6,14,20
208,PAM,P003960,22.934,-1,38,39
208,PAM,P005356,13.184,-6,18,24
208,PAM,P006433,10.233,-15,13,28
208,PAM,P006643,11.3,-6,17,23
208,PAM,P010393,12.583,-19,17,36
208,PAM,P010568,25.45,0,46,46
208,PAM,P011970,21.7,-11,35,46
208,PAM,P011982,22.8,-11,36,47
208,PAM,P012738,21.833,-4,39,43
208,PAM,P012740,18.466,-6,34,40
208,PAM,P012795,9.55,-5,13,18
208,RED,P000848,18.449,9,46,37
208,RED,P002553,9.484,-3,12,15
208,RED,P005099,11.3,10,27,17
208,RED,P006436,24.1,12,48,36
208,RED,P007960,24.048,19,57,38
208,RED,P008966,22.75,16,50,34
208,RED,P009035,15.199,4,28,24
208,RED,P011941,2.05,-2,4,6
208,RED,P012044,20.717,2,37,35
208,RED,P012801,20.183,7,37,30
208,RED,PJDR,20.433,17,46,29
208,RED,PLUO,11.282,-1,18,19
209,BAS,P003198,33.168,-2,77,79
209,BAS,P004603,19.034,-6,42,48
209,BAS,P004761,26.635,-13,59,72
209,BAS,P007946,20.284,-2,48,50
209,BAS,P008850,5.634,5,21,16
209,BAS,P009048,39.885,-1,100,101
209,BAS,P010444,28.985,1,73,72
209,BAS,P011085,4.317,-4,7,11
209,BAS,P011948,28.217,7,73,66
209,BAS,P012201,18.851,0,45,45
209,MUN,P001288,34.101,-5,81,86
209,MUN,P001557,21.952,-6,46,52
209,MUN,P003583,31.634,-1,70,71
209,MUN,P004508,22.117,3,54,51
209,MUN,P005460,11.667,3,34,31
209,MUN,P006543,12.4,9,39,30
209,MUN,P007975,25.3,3,60,57
209,MUN,P008985,19.101,3,53,50
209,MUN,P010391,24.95,7,65,58
209,MUN,P011987,21.783,-1,58,59
210,ASV,P000229,26.916,-10,46,56
210,ASV,P003526,20.817,-8,31,39
210,ASV,P005094,19.166,-15,32,47
210,ASV,P006568,22.2,-11,36,47
210,ASV,P011225,30.916,-13,59,72
210,ASV,P011386,9.084,3,14,11
210,ASV,P012729,26.183,2,58,56
210,ASV,P012731,21.851,1,39,38
210,ASV,PKIR,22.867,1,50,49
210,ULK,P001932,27.633,9,53,44
210,ULK,P002968,16.734,10,36,26
210,ULK,P002969,3.55,-7,2,9
210,ULK,P004004,23.417,1,49,48
210,ULK,P005844,24.184,17,58,41
210,ULK,P006068,29.951,8,59,51
210,ULK,P006661,33.084,22,79,57
210,ULK,P006961,5.116,3,16,13
210,ULK,P009849,8.249,-11,9,20
210,ULK,P011157,23.266,0,47,47
210,ULK,P011980,4.816,-2,7,9
211,BER,P006251,18.866,-13,39,52
211,BER,P006819,4.3,5,13,8
211,BER,P007025,12.45,10,39,29
211,BER,P008173,25.149,4,64,60
211,BER,P008211,14.666,-8,28,36
211,BER,P008384,24.266,-6,54,60
211,BER,P008780,14.85,-18,23,41
211,BER,P008967,12.883,-16,20,36
211,BER,P010791,16.583,-9,32,41
211,BER,P011934,19.566,-10,42,52
211,BER,P012720,15.733,-8,33,41
211,BER,P012721,20.683,-1,48,49
211,OLY,P001255,25.15,10,71,61
211,OLY,P006589,15.7,-10,33,43
211,OLY,P007853,7.0,-1,20,21
211,OLY,P007982,22.601,0,56,56
211,OLY,P008829,18.55,4,41,37
211,OLY,P008855,13.316,24,40,16
211,OLY,P010392,14.3,-3,36,39
211,OLY,P010612,30.133,16,72,56
211,OLY,P011965,7.934,-15,13,28
211,OLY,P011983,21.016,21,55,34
211,OLY,P012878,24.3,24,68,44
212,MAD,P001392,8.183,-4,20,24
212,MAD,P003108,26.265,11,73,62
212,MAD,P003733,8.1,6,22,16
212,MAD,P004887,25.632,7,72,65
212,MAD,P005928,24.749,9,70,61
212,MAD,P006540,25.881,0,69,69
212,MAD,P009005,22.184,-2,59,61
212,MAD,P009213,6.633,4,16,12
212,MAD,P010357,17.149,0,41,41
212,MAD,P010623,0.45,0,0,0
212,MAD,PBMT,18.432,1,48,47
212,MAD,PCVM,16.332,-7,40,47
212,TEL,P005145,6.3,-7,11,18
212,TEL,P007990,6.883,-6,13,19
212,TEL,P009622,31.284,2,83,81
212,TEL,P009783,33.451,6,89,83
212,TEL,P009863,28.651,6,75,69
212,TEL,P011193,16.117,-10,37,47
212,TEL,P011199,23.15,0,54,54
212,TEL,P011214,8.001,-15,17,32
212,TEL,P011219,20.268,-7,53,60
212,TEL,P011971,25.5,8,73,65
212,TEL,P012744,0.4,-2,0,2
213,MCO,P002581,17.6,6,33,27
213,MCO,P004197,15.983,7,31,24
213,MCO,P005985,31.95,23,75,52
213,MCO,P009754,16.267,3,35,32
213,MCO,P010588,28.334,17,67,50
213,MCO,P011196,5.417,8,18,10
213,MCO,P011212,26.883,9,57,48
213,MCO,P011226,27.05,1,52,51
213,MCO,P011231,14.283,0,25,25
213,MCO,PLCZ,16.233,1,32,31
213,PAR,P003983,21.533,4,46,42
213,PAR,P004058,2.55,-4,0,4
213,PAR,P007400,35.617,-14,65,79
213,PAR,P007673,4.017,-4,2,6
213,PAR,P008987,36.85,-9,70,79
213,PAR,P009862,35.883,-8,70,78
213,PAR,P011051,5.283,-7,5,12
213,PAR,P012096,15.3,-20,19,39
213,PAR,P012742,20.634,-19,27,46
213,PAR,P012743,22.333,6,46,40
214,BAR,P000925,19.8,13,43,30
214,BAR,P002939,27.9,14,60,46
214,BAR,P003196,18.667,9,36,27
214,BAR,P003204,1.533,5,5,0
214,BAR,P004866,28.1,21,62,41
214,BAR,P006435,20.333,21,48,27
214,BAR,P007464,7.45,3,13,10
214,BAR,P007519,15.017,11,28,17
214,BAR,P009992,19.667,6,36,30
214,BAR,P010641,1.533,5,5,0
214,BAR,P011244,13.9,5,23,18
214,BAR,P012745,26.1,22,61,39
214,VIR,P001844,29.249,-22,40,62
214,VIR,P002084,16.968,-6,27,33
214,VIR,P003048,17.85,-14,26,40
214,VIR,P003527,14.315,-15,15,30
214,VIR,P004007,4.634,-1,10,11
214,VIR,P004554,15.567,-5,23,28
214,VIR,P005553,1.533,-5,0,5
214,VIR,P006739,8.868,-1,14,15
214,VIR,P008847,21.183,-18,30,48
214,VIR,P009549,25.416,-13,35,48
214,VIR,P010781,23.767,-26,31,57
214,VIR,PBCN,20.65,-9,34,43
215,MIL,P000796,15.167,-6,23,29
215,MIL,P002812,16.284,-3,25,28
215,MIL,P002849,20.116,-10,32,42
215,MIL,P005670,7.633,-3,8,11
215,MIL,P007032,10.716,-4,25,29
215,MIL,P007201,16.916,-9,25,34
215,MIL,P007831,27.633,-19,36,55
215,MIL,P009960,15.617,-8,21,29
215,MIL,P011205,23.551,-12,38,50
215,MIL,P011224,28.667,-13,45,58
215,MIL,P012800,17.7,2,32,30
215,PAN,P002328,31.933,15,61,46
215,PAN,P003842,23.817,15,51,36
215,PAN,P006544,1.817,-4,5,9
215,PAN,P007866,19.116,6,32,26
215,PAN,P007947,9.184,4,24,20
215,PAN,P011204,30.333,13,53,40
215,PAN,P011209,18.317,10,39,29
215,PAN,P011221,16.183,2,28,26
215,PAN,P012712,21.717,11,47,36
215,PAN,P012774,27.583,13,55,42
216,IST,P004888,35.831,-18,63,81
216,IST,P006590,20.9,1,51,50
216,IST,P007200,26.182,-38,32,70
216,IST,P009664,23.749,-5,52,57
216,IST,P009846,12.616,-18,15,33
216,IST,P010516,4.266,-5,3,8
216,IST,P011078,23.999,-8,46,54
216,IST,P011981,19.832,-2,43,45
216,IST,P012710,3.083,-6,0,6
216,IST,P012788,9.0,-16,10,26
216,IST,PLHK,20.532,-15,35,50
216,ZAL,P002329,20.55,20,51,31
216,ZAL,P002676,24.633,13,56,43
216,ZAL,P003210,1.933,1,8,7
216,ZAL,P003211,24.234,6,58,52
216,ZAL,P005504,23.6,19,59,40
216,ZAL,P006860,2.2,2,2,0
216,ZAL,P007109,15.901,17,41,24
216,ZAL,P007513,23.566,20,54,34
216,ZAL,P010390,16.317,9,37,28
216,ZAL,P011218,16.517,23,44,21
216,ZAL,P012715,16.799,-2,42,44
216,ZAL,P012787,13.75,2,28,26
217,BER,P006251,23.617,-20,29,49
217,BER,P006819,1.6,5,5,0
217,BER,P007025,12.699,8,29,21
217,BER,P008173,20.416,5,43,38
217,BER,P008211,11.866,6,23,17
217,BER,P008384,18.501,-9,29,38
217,BER,P008780,19.584,-20,23,43
217,BER,P008967,21.751,-18,33,51
217,BER,P010791,14.532,5,32,27
217,BER,P011934,18.017,-22,21,43
217,BER,P012720,15.183,-17,18,35
217,BER,P012721,22.234,2,45,43
217,PAM,P003960,18.385,4,33,29
217,PAM,P004863,13.534,7,25,18
217,PAM,P005356,19.868,0,41,41
217,PAM,P006433,16.05,-5,26,31
217,PAM,P010393,22.9,13,48,35
217,PAM,P010568,21.467,15,48,33
217,PAM,P011970,11.467,-6,21,27
217,PAM,P011982,18.733,18,43,25
217,PAM,P012738,19.751,-3,38,41
217,PAM,P012740,18.717,17,42,25
217,PAM,P012795,19.133,15,40,25
218,MUN,P001288,24.818,9,50,41
218,MUN,P001557,17.701,5,29,24
218,MUN,P003583,24.785,7,47,40
218,MUN,P004508,13.567,-5,28,33
218,MUN,P005460,8.95,-2,19,21
218,MUN,P006543,11.801,2,25,23
218,MUN,P006760,12.35,-11,19,30
218,MUN,P007639,6.267,-9,6,15
218,MUN,P007975,19.601,-4,39,43
218,MUN,P008985,19.668,-5,28,33
218,MUN,P010391,21.9,-4,44,48
218,MUN,P011987,18.602,-3,26,29
218,OLY,P001255,20.0,-6,39,45
218,OLY,P006589,4.3,-4,8,12
218,OLY,P007853,16.566,-6,32,38
218,OLY,P007982,16.667,10,44,34
218,OLY,P008829,20.0,10,37,27
218,OLY,P008855,28.334,10,52,42
218,OLY,P010392,19.483,-6,39,45
218,OLY,P010612,13.25,-3,15,18
218,OLY,P011194,18.95,5,42,37
218,OLY,P011965,5.7,-3,9,12
218,OLY,P011983,20.0,10,37,27
218,OLY,P012878,16.75,3,26,23
219,ASV,P000229,31.549,-7,60,67
219,ASV,P003526,24.05,-10,49,59
219,ASV,P005094,28.049,-8,56,64
219,ASV,P006568,15.2,-18,22,40
219,ASV,P011225,32.399,3,71,68
219,ASV,P011386,5.683,-8,4,12
219,ASV,P012729,24.866,11,57,46
219,ASV,P012731,26.316,1,53,52
219,ASV,PKIR,11.883,1,23,22
219,MAD,P001392,6.818,4,15,11
219,MAD,P003108,24.267,0,48,48
219,MAD,P003733,17.25,8,36,28
219,MAD,P004887,22.851,14,49,35
219,MAD,P005928,14.283,0,28,28
219,MAD,P006540,20.95,-2,47,49
219,MAD,P009005,23.267,9,51,42
219,MAD,P009213,5.067,-4,9,13
219,MAD,P010357,21.317,1,49,48
219,MAD,P010623,4.584,6,12,6
219,MAD,PBMT,18.217,-2,40,42
219,MAD,PCVM,21.134,1,46,45
220,BAS,P003198,4.15,-9,6,15
220,BAS,P004603,36.951,16,86,70
220,BAS,P004761,29.401,13,65,52
220,BAS,P007946,11.483,7,33,26
220,BAS,P008850,4.316,-11,8,19
220,BAS,P009048,31.867,-5,66,71
220,BAS,P011085,22.334,9,50,41
220,BAS,P011948,23.152,13,58,45
220,BAS,P012201,36.351,17,88,71
220,TEL,P005145,4.367,3,11,8
220,TEL,P007990,3.484,-8,4,12
220,TEL,P009622,28.151,-9,58,67
220,TEL,P009783,28.6,-6,55,61
220,TEL,P009863,29.368,-4,60,64
220,TEL,P011193,20.633,-3,44,47
220,TEL,P011199,26.484,-13,45,58
220,TEL,P011214,14.217,-8,32,40
220,TEL,P011219,12.683,5,35,30
220,TEL,P011971,17.284,-10,31,41
220,TEL,P012744,14.734,3,35,32
221,IST,P004888,32.133,6,65,59
221,IST,P006590,13.683,-11,25,36
221,IST,P007200,32.667,2,61,59
221,IST,P009664,34.184,17,68,51
221,IST,P009846,13.683,-11,25,36
221,IST,P010516,5.25,3,9,6
221,IST,P011078,28.4,18,63,45
221,IST,P011981,12.299,-8,23,31
221,IST,PLHK,27.701,14,56,42
221,MIL,P000796,15.317,-8,29,37
221,MIL,P002812,11.817,0,27,27
221,MIL,P002849,24.683,2,44,42
221,MIL,P006509,8.449,7,25,18
221,MIL,P007032,12.6,-5,27,32
221,MIL,P007201,24.199,-2,41,43
221,MIL,P007831,29.384,-11,46,57
221,MIL,P009960,3.767,-2,5,7
221,MIL,P011205,20.618,-19,25,44
221,MIL,P011224,27.4,-1,46,47
221,MIL,P012800,21.766,9,50,41
222,MCO,P002581,7.1,4,18,14
222,MCO,P004197,5.217,-5,8,13
222,MCO,P005985,33.6,4,61,57
222,MCO,P009754,19.401,1,35,34
222,MCO,P010588,36.184,8,68,60
222,MCO,P011196,12.717,6,25,19
222,MCO,P011212,27.084,19,57,38
222,MCO,P011226,29.268,3,58,55
222,MCO,P011231,9.25,-2,17,19
222,MCO,PLCZ,20.184,-3,33,36
222,ULK,P001932,25.184,-5,35,40
222,ULK,P002968,22.75,-9,40,49
222,ULK,P004004,22.384,-12,35,47
222,ULK,P005844,17.95,-2,30,32
222,ULK,P006068,21.251,4,42,38
222,ULK,P006661,32.434,-5,56,61
222,ULK,P006961,8.934,1,19,18
222,ULK,P008962,22.301,-4,40,44
222,ULK,P009849,7.983,-4,15,19
222,ULK,P011052,2.2,1,6,5
222,ULK,P011157,16.634,0,27,27
223,BAR,P000925,24.933,12,51,39
223,BAR,P002939,32.217,8,69,61
223,BAR,P003196,14.5,0,34,34
223,BAR,P003204,0.283,-3,0,3
223,BAR,P004866,26.549,2,49,47
223,BAR,P006435,22.116,6,44,38
223,BAR,P007464,7.283,1,16,15
223,BAR,P007519,18.349,8,45,37
223,BAR,P009992,17.883,3,41,38
223,BAR,P010641,0.566,-3,0,3
223,BAR,P011244,5.766,0,16,16
223,BAR,P012745,29.55,11,60,49
223,RED,P000848,29.417,4,63,59
223,RED,P002553,10.234,-7,20,27
223,RED,P005099,16.417,-5,33,38
223,RED,P006436,26.65,-2,49,51
223,RED,P007960,14.567,-10,23,33
223,RED,P008966,11.317,-7,20,27
223,RED,P009035,22.501,-10,33,43
223,RED,P011941,7.65,8,23,15
223,RED,P012044,23.634,-5,46,51
223,RED,P012801,12.284,2,32,30
223,RED,PJDR,18.717,-8,32,40
223,RED,PLUO,6.617,-5,6,11
224,PAR,P003983,23.233,1,56,55
224,PAR,P004172,13.3,-6,25,31
224,PAR,P007400,22.484,3,55,52
224,PAR,P008987,12.3,-10,20,30
224,PAR,P009862,29.317,1,63,62
224,PAR,P011050,19.016,3,35,32
224,PAR,P011051,19.517,-1,45,46
224,PAR,P011192,18.75,-6,33,39
224,PAR,P012096,2.1,3,5,2
224,PAR,P012742,26.7,2,59,57
224,PAR,P012743,13.283,-10,24,34
224,VIR,P001133,21.684,2,43,41
224,VIR,P001844,24.35,13,59,46
224,VIR,P003048,27.267,10,67,57
224,VIR,P003527,20.151,2,45,43
224,VIR,P004007,0.25,-3,1,4
224,VIR,P006739,15.651,-9,29,38
224,VIR,P008847,15.284,-3,30,33
224,VIR,P009549,26.467,6,58,52
224,VIR,P010781,21.551,0,49,49
224,VIR,PBCN,27.35,2,59,57
225,PAN,P002328,33.733,-4,64,68
225,PAN,P003842,34.367,-12,60,72
225,PAN,P005161,1.617,-2,2,4
225,PAN,P006544,0.117,0,0,0
225,PAN,P007866,25.266,-11,45,56
225,PAN,P007947,16.784,-2,24,26
225,PAN,P011204,30.216,-16,52,68
225,PAN,P011209,3.3,-2,2,4
225,PAN,P011221,4.2,-2,6,8
225,PAN,P012712,16.167,1,25,24
225,PAN,P012774,34.233,-10,60,70
225,ZAL,P002329,30.051,19,68,49
225,ZAL,P002676,21.068,3,32,29
225,ZAL,P003210,4.216,-5,7,12
225,ZAL,P003211,9.984,-1,14,15
225,ZAL,P005504,20.634,-1,45,46
225,ZAL,P006860,0.117,-1,0,1
225,ZAL,P007109,15.884,-2,26,28
225,ZAL,P007513,22.268,14,56,42
225,ZAL,P010390,14.368,5,23,18
225,ZAL,P011218,27.819,16,59,43
225,ZAL,P012715,18.951,13,46,33
225,ZAL,P012787,14.65,0,24,24
226,MAD,P001392,6.417,3,16,13
226,MAD,P003108,18.518,2,41,39
226,MAD,P004887,18.301,-6,33,39
226,MAD,P005791,21.7,1,43,42
226,MAD,P005928,18.634,-5,36,41
226,MAD,P006540,20.951,3,45,42
226,MAD,P009005,21.935,8,49,41
226,MAD,P010357,20.816,-5,35,40
226,MAD,PBMT,10.833,-23,7,30
226,MAD,PCVM,21.367,0,40,40
226,MAD,PTGB,20.533,-3,35,38
226,MIL,P000796,25.982,9,57,48
226,MIL,P001518,4.917,-4,8,12
226,MIL,P002812,16.383,17,37,20
226,MIL,P002849,22.517,-9,44,53
226,MIL,P007032,21.917,13,49,36
226,MIL,P007201,17.784,-12,27,39
226,MIL,P007831,30.5,-7,60,67
226,MIL,P011205,25.85,10,57,47
226,MIL,P011224,16.366,-8,28,36
226,MIL,P012800,17.784,16,38,22
227,IST,P004888,26.1,2,67,65
227,IST,P006590,14.85,17,50,33
227,IST,P007200,37.9,15,100,85
227,IST,P009664,21.033,5,58,53
227,IST,P009846,15.283,14,43,29
227,IST,P010516,4.717,-5,11,16
227,IST,P011078,21.15,-1,44,45
227,IST,P011981,18.717,13,47,34
227,IST,P012710,18.967,9,47,38
227,IST,PLHK,21.283,1,58,57
227,TEL,P004233,5.783,-2,17,19
227,TEL,P007990,20.734,-5,50,55
227,TEL,P009783,31.334,-17,71,88
227,TEL,P009863,31.434,-11,72,83
227,TEL,P011193,19.716,-11,41,52
227,TEL,P011199,25.251,-6,59,65
227,TEL,P011214,14.716,-4,34,38
227,TEL,P011219,16.817,-7,40,47
227,TEL,P011971,13.732,-6,28,34
227,TEL,P012744,20.483,-1,43,44
228,OLY,P001255,12.851,2,25,23
228,OLY,P007853,24.55,9,51,42
228,OLY,P007982,20.417,4,41,37
228,OLY,P008811,16.301,9,31,22
228,OLY,P008829,21.268,10,39,29
228,OLY,P008855,28.651,7,51,44
228,OLY,P010392,2.266,-2,4,6
228,OLY,P010612,22.751,14,45,31
228,OLY,P011194,18.916,3,39,36
228,OLY,P011983,8.517,5,17,12
228,OLY,P012878,23.517,4,47,43
228,PAM,P003960,26.1,5,47,42
228,PAM,P004863,16.134,-8,24,32
228,PAM,P005356,19.167,2,35,33
228,PAM,P006433,6.567,9,19,10
228,PAM,P006643,7.434,-9,10,19
228,PAM,P010393,13.184,-22,13,35
228,PAM,P010568,23.633,-4,40,44
228,PAM,P011970,15.651,-6,25,31
228,PAM,P011982,25.685,-6,44,50
228,PAM,P012738,13.967,-7,22,29
228,PAM,P012740,13.9,-11,17,28
228,PAM,P012795,18.583,-8,29,37
229,MUN,P001288,30.766,-3,62,65
229,MUN,P001557,14.266,-3,27,30
229,MUN,P003583,22.033,-4,45,49
229,MUN,P004508,12.749,6,24,18
229,MUN,P006543,8.283,3,14,11
229,MUN,P006760,24.55,-1,47,48
229,MUN,P007639,17.966,5,34,29
229,MUN,P007975,20.299,7,40,33
229,MUN,P010391,28.783,-3,59,62
229,MUN,P011987,20.3,-2,43,45
229,PAR,P003983,15.717,3,30,27
229,PAR,P004058,17.817,12,39,27
229,PAR,P004172,17.417,8,31,23
229,PAR,P007400,23.115,-9,47,56
229,PAR,P008987,29.583,-8,53,61
229,PAR,P009862,26.049,-4,54,58
229,PAR,P011050,3.683,-1,7,8
229,PAR,P011051,11.383,7,25,18
229,PAR,P012096,12.966,-8,21,29
229,PAR,P012742,20.415,-13,33,46
229,PAR,P012743,21.85,8,50,42
230,ASV,P000229,20.183,1,52,51
230,ASV,P003274,5.783,-1,5,6
230,ASV,P003526,19.249,-6,46,52
230,ASV,P004194,25.067,-4,59,63
230,ASV,P005094,17.649,-3,38,41
230,ASV,P011225,11.099,0,26,26
230,ASV,P011386,23.118,-13,49,62
230,ASV,P012080,19.817,-15,28,43
230,ASV,P012729,23.517,-13,42,55
230,ASV,P012731,19.651,-7,31,38
230,ASV,PKIR,14.867,-9,24,33
230,BAS,P003198,19.716,5,36,31
230,BAS,P004603,11.567,0,28,28
230,BAS,P004761,24.449,17,55,38
230,BAS,P007946,3.167,4,8,4
230,BAS,P008850,17.567,5,36,31
230,BAS,P009048,35.515,12,84,72
230,BAS,P010444,28.165,16,66,50
230,BAS,P011085,17.033,5,46,41
230,BAS,P011948,19.166,1,47,46
230,BAS,P012201,21.533,9,60,51
230,BAS,P012365,0.8,-2,2,4
230,BAS,P012765,1.317,-2,2,4
231,RED,P000848,24.049,-1,58,59
231,RED,P002553,19.016,-14,37,51
231,RED,P004720,9.267,-4,18,22
231,RED,P005099,9.783,-4,15,19
231,RED,P006436,29.533,-1,72,73
231,RED,P007960,20.75,12,52,40
231,RED,P008966,6.65,-2,12,14
231,RED,P009035,20.466,-3,51,54
231,RED,P011941,12.733,3,28,25
231,RED,P011964,0.567,0,0,0
231,RED,P012044,31.782,-1,78,79
231,RED,P012801,15.399,5,34,29
231,ZAL,P002329,27.499,4,68,64
231,ZAL,P002676,12.433,-7,19,26
231,ZAL,P003210,5.033,-4,9,13
231,ZAL,P003211,20.166,3,49,46
231,ZAL,P005504,28.682,0,71,71
231,ZAL,P007109,23.116,11,63,52
231,ZAL,P007513,26.199,4,66,62
231,ZAL,P010390,10.867,2,20,18
231,ZAL,P011218,25.333,10,66,56
231,ZAL,P012715,11.784,-5,19,24
231,ZAL,P012787,8.883,-8,15,23
232,BAR,P000925,12.166,18,40,22
232,BAR,P002939,18.132,19,54,35
232,BAR,P003196,19.1,14,42,28
232,BAR,P003204,17.517,-3,32,35
232,BAR,P004866,17.283,24,54,30
232,BAR,P006435,18.216,29,60,31
232,BAR,P007464,8.667,-13,11,24
232,BAR,P007519,21.868,-3,39,42
232,BAR,P009992,21.901,-13,33,46
232,BAR,P010641,8.617,-16,11,27
232,BAR,P011244,27.916,29,78,49
232,BAR,P012745,8.617,-5,11,16
232,BER,P003958,15.833,-10,27,37
232,BER,P006251,21.634,-13,40,53
232,BER,P006819,11.666,6,26,20
232,BER,P007025,18.517,6,41,35
232,BER,P008173,18.949,-10,27,37
232,BER,P008211,18.0,1,48,47
232,BER,P008384,22.383,2,45,43
232,BER,P008780,14.984,-19,28,47
232,BER,P008967,16.267,-21,28,49
232,BER,P010791,15.15,-6,27,33
232,BER,P011934,11.284,-16,20,36
232,BER,P012721,15.333,0,28,28
233,PAN,P002328,21.917,-10,36,46
233,PAN,P003842,34.033,9,62,53
233,PAN,P007866,18.15,-11,24,35
233,PAN,P007947,8.584,2,18,16
233,PAN,P011204,34.233,9,62,53
233,PAN,P011209,18.484,13,35,22
233,PAN,P011221,5.967,2,12,10
233,PAN,P012712,22.883,27,55,28
233,PAN,P012774,35.749,14,66,52
233,ULK,P001932,27.934,-12,39,51
233,ULK,P002968,17.583,1,28,27
233,ULK,P004004,11.701,-10,14,24
233,ULK,P005844,4.734,-7,4,11
233,ULK,P006068,16.749,14,34,20
233,ULK,P006661,27.05,0,46,46
233,ULK,P006961,24.101,-15,36,51
233,ULK,P008962,33.151,-12,50,62
233,ULK,P009849,7.918,-11,9,20
233,ULK,P011052,8.383,5,20,15
233,ULK,P011157,20.701,-8,35,43
234,MCO,P002581,16.333,8,36,28
234,MCO,P004197,8.95,13,27,14
234,MCO,P005985,33.366,1,63,62
234,MCO,P009754,25.699,-4,50,54
234,MCO,P010588,19.667,-7,31,38
234,MCO,P011196,6.183,2,19,17
234,MCO,P011212,22.8,6,47,41
234,MCO,P011226,30.282,-6,59,65
234,MCO,P011231,19.482,6,47,41
234,MCO,PLCZ,17.233,-4,26,30
234,VIR,P001133,26.667,7,55,48
234,VIR,P001844,26.201,7,51,44
234,VIR,P002084,5.733,-2,12,14
234,VIR,P003048,15.884,0,25,25
234,VIR,P003527,5.316,-6,8,14
234,VIR,P004007,4.083,-4,4,8
234,VIR,P004554,7.183,-3,13,16
234,VIR,P006739,15.816,-9,31,40
234,VIR,P008847,18.9,-2,43,45
234,VIR,P009549,24.551,-3,43,46
234,VIR,P010781,25.316,-4,53,57
234,VIR,PBCN,24.35,4,52,48
235,BER,P003958,23.95,-32,37,69
235,BER,P006251,14.55,1,34,33
235,BER,P006919,18.532,-17,26,43
235,BER,P007025,11.417,-1,28,29
235,BER,P008173,13.501,-6,27,33
235,BER,P008211,15.549,-9,32,41
235,BER,P008384,4.834,-4,8,12
235,BER,P008780,22.516,-29,36,65
235,BER,P008967,15.9,-21,19,40
235,BER,P011934,21.267,-24,37,61
235,BER,P012720,18.45,-26,29,55
235,BER,P012721,19.534,-7,42,49
235,TEL,P004233,5.067,0,8,8
235,TEL,P005145,17.617,15,46,31
235,TEL,P007990,12.184,7,27,20
235,TEL,P009622,21.917,16,61,45
235,TEL,P009783,17.85,26,55,29
235,TEL,P009863,21.901,22,63,41
235,TEL,P011193,16.6,21,46,25
235,TEL,P011199,20.367,30,60,30
235,TEL,P011214,17.067,9,42,33
235,TEL,P011971,22.384,20,60,40
235,TEL,P012095,7.4,4,15,11
235,TEL,P012744,19.651,5,47,42
236,IST,P004888,26.567,-8,68,76
236,IST,P006372,0.417,0,0,0
236,IST,P006590,25.567,4,73,69
236,IST,P007200,34.434,-8,78,86
236,IST,P009513,15.201,-3,24,27
236,IST,P009664,20.883,1,53,52
236,IST,P009846,12.184,-13,20,33
236,IST,P011078,8.767,-7,17,24
236,IST,P011981,13.634,-3,37,40
236,IST,P012710,14.784,-3,24,27
236,IST,P012788,4.133,-2,8,10
236,IST,PLHK,23.434,-8,48,56
236,PAR,P000956,20.767,7,63,56
236,PAR,P003983,21.534,13,65,52
236,PAR,P004172,25.6,4,60,56
236,PAR,P007673,19.917,0,49,49
236,PAR,P008987,40.001,10,100,90
236,PAR,P009862,25.968,12,65,53
236,PAR,P011051,2.233,-4,3,7
236,PAR,P012096,16.517,2,42,40
236,PAR,P012742,10.467,-1,17,18
236,PAR,P012743,17.001,7,36,29
237,MAD,P001392,22.95,6,58,52
237,MAD,P003108,24.716,-15,55,70
237,MAD,P003733,6.866,5,16,11
237,MAD,P004887,16.166,-11,30,41
237,MAD,P005791,21.717,3,50,47
237,MAD,P005928,27.317,-4,62,66
237,MAD,P006540,18.984,-22,35,57
237,MAD,P009005,14.117,-6,26,32
237,MAD,P010357,26.967,12,68,56
237,MAD,PCVM,12.683,-7,24,31
237,MAD,PTGB,7.517,-16,6,22
237,PAN,P001926,24.867,11,62,51
237,PAN,P002328,19.25,0,45,45
237,PAN,P003842,29.4,16,76,60
237,PAN,P005161,22.266,14,59,45
237,PAN,P007553,5.933,-6,12,18
237,PAN,P007866,27.25,3,65,62
237,PAN,P011204,19.867,0,45,45
237,PAN,P012712,17.767,10,44,34
237,PAN,P012774,33.4,7,77,70
238,PAM,P003960,13.849,-5,26,31
238,PAM,P004863,16.967,-13,28,41
238,PAM,P006433,20.898,8,46,38
238,PAM,P006643,5.75,-8,5,13
238,PAM,P007870,21.999,8,51,43
238,PAM,P010393,18.715,-14,36,50
238,PAM,P010568,22.499,-2,47,49
238,PAM,P011970,14.833,-13,18,31
238,PAM,P011982,22.366,-8,40,48
238,PAM,P012738,11.55,-7,18,25
238,PAM,P012740,7.665,-9,11,20
238,PAM,P012795,22.899,-2,44,46
238,VIR,P001133,6.25,-5,12,17
238,VIR,P001844,18.45,3,38,35
238,VIR,P002084,25.484,15,56,41
238,VIR,P003048,12.2,-4,21,25
238,VIR,P003527,16.35,10,35,25
238,VIR,P004554,7.95,0,16,16
238,VIR,P006739,21.884,8,49,41
238,VIR,P008847,27.468,19,66,47
238,VIR,P009549,24.6,1,50,49
238,VIR,P010781,16.118,13,38,25
238,VIR,PBCN,23.251,5,54,49
239,OLY,P001255,27.65,15,69,54
239,OLY,P006302,7.067,-4,13,17
239,OLY,P007853,23.634,7,53,46
239,OLY,P008811,21.001,15,52,37
239,OLY,P008829,27.534,15,69,54
239,OLY,P008855,29.301,21,73,52
239,OLY,P010612,20.067,16,53,37
239,OLY,P011194,20.551,6,45,39
239,OLY,P011983,9.934,-3,16,19
239,OLY,P012878,13.266,7,32,25
239,ZAL,P002329,25.467,-15,47,62
239,ZAL,P002676,19.418,-9,38,47
239,ZAL,P003210,19.95,-8,41,49
239,ZAL,P003211,23.601,-9,49,58
239,ZAL,P005504,15.718,-10,25,35
239,ZAL,P006158,11.683,0,24,24
239,ZAL,P007109,17.9,-7,36,43
239,ZAL,P010390,13.367,-4,29,33
239,ZAL,P011218,25.017,-17,44,61
239,ZAL,P012715,14.85,-9,24,33
239,ZAL,P012787,13.034,-7,23,30
240,BAR,P000925,26.383,0,50,50
240,BAR,P002939,23.217,2,47,45
240,BAR,P003196,13.617,-10,17,27
240,BAR,P003478,15.3,-4,20,24
240,BAR,P004866,20.95,-6,41,47
240,BAR,P006435,25.049,-2,48,50
240,BAR,P007519,12.451,-6,16,22
240,BAR,P009992,13.567,-5,20,25
240,BAR,P011244,7.749,-5,9,14
240,BAR,P012745,30.484,-5,54,59
240,BAR,PLFW,11.233,-9,13,22
240,MCO,P002581,4.816,-7,3,10
240,MCO,P004790,10.666,6,19,13
240,MCO,P005985,30.65,0,58,58
240,MCO,P008099,17.751,4,43,39
240,MCO,P010588,24.1,4,45,41
240,MCO,P011196,18.551,11,38,27
240,MCO,P011212,25.549,8,40,32
240,MCO,P011226,27.916,7,49,42
240,MCO,P011231,21.401,5,47,42
240,MCO,P012709,6.1,8,13,5
240,MCO,PLCZ,12.5,4,30,26
241,MUN,P001288,26.733,4,51,47
241,MUN,P001557,11.417,-5,13,18
241,MUN,P003583,24.216,-1,43,44
241,MUN,P004508,21.351,11,38,27
241,MUN,P006760,15.434,4,28,24
241,MUN,P007056,30.483,12,63,51
241,MUN,P007639,11.517,6,20,14
241,MUN,P008985,15.6,3,34,31
241,MUN,P010391,25.216,6,46,40
241,MUN,P011987,18.033,0,34,34
241,RED,P000848,21.118,-10,35,45
241,RED,P002553,18.417,1,40,39
241,RED,P004720,3.55,0,4,4
241,RED,P005099,15.983,-7,23,30
241,RED,P006436,21.467,-1,40,41
241,RED,P007960,17.201,-1,24,25
241,RED,P008966,12.168,-9,16,25
241,RED,P009035,24.767,2,48,46
241,RED,P011941,7.451,-9,4,13
241,RED,P012044,22.202,0,40,40
241,RED,P012801,22.002,1,39,38
241,RED,PLUO,13.684,-7,17,24
242,BAS,P003198,21.334,-5,60,65
242,BAS,P004603,10.151,-5,30,35
242,BAS,P004761,31.351,-13,70,83
242,BAS,P007230,26.034,-13,54,67
242,BAS,P007946,14.884,-3,32,35
242,BAS,P009048,28.834,-16,71,87
242,BAS,P010444,25.116,-7,56,63
242,BAS,P011085,6.933,2,14,12
242,BAS,P011948,8.65,-2,26,28
242,BAS,P012201,26.718,-13,67,80
242,ULK,P001932,29.75,20,88,68
242,ULK,P002968,8.484,1,22,21
242,ULK,P004004,19.718,14,59,45
242,ULK,P005844,6.3,0,12,12
242,ULK,P006068,15.9,-5,34,39
242,ULK,P006661,16.517,-1,43,44
242,ULK,P006961,23.8,23,77,54
242,ULK,P008962,25.917,9,68,59
242,ULK,P009849,14.318,-6,32,38
242,ULK,P011157,24.834,16,77,61
242,ULK,P011980,14.467,4,43,39
243,ASV,P000229,17.6,-2,36,38
243,ASV,P002100,27.132,9,56,47
243,ASV,P003526,12.083,3,24,21
243,ASV,P004194,20.516,7,43,36
243,ASV,P011225,16.249,3,32,29
243,ASV,P011386,18.267,0,37,37
243,ASV,P012080,27.916,1,57,56
243,ASV,P012729,22.649,2,46,44
243,ASV,P012731,15.383,-8,27,35
243,ASV,PKIR,22.2,5,47,42
243,MIL,P001518,14.183,-11,21,32
243,MIL,P002812,13.499,7,26,19
243,MIL,P002849,25.283,-5,51,56
243,MIL,P006701,6.7,-6,4,10
243,MIL,P007032,27.3,4,58,54
243,MIL,P007201,20.9,2,45,43
243,MIL,P007831,35.715,0,72,72
243,MIL,P009960,6.133,-1,11,12
243,MIL,P011205,26.649,9,57,48
243,MIL,P012800,23.633,-19,40,59
244,IST,P004888,28.882,18,80,62
244,IST,P006590,19.95,5,45,40
244,IST,P007200,26.365,21,82,61
244,IST,P009513,13.45,1,32,31
244,IST,P009664,17.516,10,46,36
244,IST,P009846,19.051,8,52,44
244,IST,P011078,20.233,19,59,40
244,IST,P011981,19.967,4,47,43
244,IST,P012710,14.549,10,40,30
244,IST,P012788,13.899,27,51,24
244,IST,PLHK,6.133,-8,11,19
244,MUN,P001288,28.666,0,70,70
244,MUN,P001557,7.983,-14,14,28
244,MUN,P003583,25.8,-14,62,76
244,MUN,P004508,14.915,-7,29,36
244,MUN,P005478,6.533,-8,8,16
244,MUN,P006760,11.333,-14,18,32
244,MUN,P007056,27.3,-6,63,69
244,MUN,P007639,4.65,-8,7,15
244,MUN,P007975,21.033,-12,42,54
244,MUN,P008985,22.783,-7,54,61
244,MUN,P010391,11.732,-11,20,31
244,MUN,P011987,17.267,-14,43,57
245,MCO,P002581,5.233,3,11,8
245,MCO,P004197,7.517,5,16,11
245,MCO,P004790,4.1,-2,6,8
245,MCO,P005985,30.151,12,73,61
245,MCO,P008099,18.583,-3,42,45
245,MCO,P010588,24.534,8,58,50
245,MCO,P011196,13.984,13,40,27
245,MCO,P011212,22.051,24,59,35
245,MCO,P011226,24.851,27,73,46
245,MCO,P011231,23.467,4,55,51
245,MCO,P012709,4.75,-3,10,13
245,MCO,PLCZ,20.784,2,47,45
245,RED,P000848,7.217,-9,9,18
245,RED,P002553,28.133,-5,64,69
245,RED,P004720,17.166,-4,33,37
245,RED,P005099,14.182,-17,22,39
245,RED,P006436,28.316,-6,65,71
245,RED,P008966,10.933,-17,14,31
245,RED,P009035,27.333,5,65,60
245,RED,P011941,10.933,-12,15,27
245,RED,P012044,31.716,1,73,72
245,RED,P012801,9.699,-22,9,31
245,RED,PLUO,14.367,-4,31,35
246,TEL,P005145,12.367,1,31,30
246,TEL,P007990,14.233,16,35,19
246,TEL,P009622,24.284,-2,56,58
246,TEL,P009783,26.168,-1,59,60
246,TEL,P009863,23.301,-8,43,51
246,TEL,P011193,18.617,8,32,24
246,TEL,P011199,22.751,3,53,50
246,TEL,P011214,22.083,-1,39,40
246,TEL,P011971,17.418,5,27,22
246,TEL,P012744,18.783,14,40,26
246,ZAL,P002329,30.499,-3,63,66
246,ZAL,P002676,21.549,5,40,35
246,ZAL,P003210,17.516,-8,20,28
246,ZAL,P003211,15.148,-17,17,34
246,ZAL,P005504,13.401,-13,26,39
246,ZAL,P007109,18.882,7,47,40
246,ZAL,P010390,22.565,6,40,34
246,ZAL,P011218,26.916,6,66,60
246,ZAL,P012715,18.682,-11,30,41
246,ZAL,P012787,14.832,-7,31,38
247,OLY,P001255,32.084,13,64,51
247,OLY,P006302,10.183,-3,18,21
247,OLY,P007853,25.05,-5,42,47
247,OLY,P007982,20.333,13,37,24
247,OLY,P008811,26.034,7,53,46
247,OLY,P008829,22.699,5,44,39
247,OLY,P010612,22.834,1,47,46
247,OLY,P011194,21.533,2,38,36
247,OLY,P011965,3.65,1,7,6
247,OLY,P011983,5.866,-5,7,12
247,OLY,P012878,9.734,-4,13,17
247,VIR,P001133,28.217,-1,48,49
247,VIR,P001844,22.533,-15,33,48
247,VIR,P003048,14.616,-1,28,29
247,VIR,P003527,7.033,5,16,11
247,VIR,P004007,14.801,-3,22,25
247,VIR,P004554,13.851,0,23,23
247,VIR,P006739,20.917,6,43,37
247,VIR,P008847,22.716,-7,37,44
247,VIR,P009549,17.05,-5,28,33
247,VIR,P010781,20.1,3,36,33
247,VIR,PBCN,18.166,-7,31,38
248,MAD,P001392,7.4,-4,10,14
248,MAD,P003108,29.867,-5,62,67
248,MAD,P004887,11.883,-10,24,34
248,MAD,P005791,25.849,3,53,50
248,MAD,P005928,22.933,-5,48,53
248,MAD,P006540,17.849,-4,35,39
248,MAD,P009005,17.383,-11,26,37
248,MAD,P010357,29.499,-5,62,67
248,MAD,PCVM,11.666,-10,16,26
248,MAD,PTGB,25.666,1,59,58
248,ULK,P001932,26.533,7,62,55
248,ULK,P002968,18.049,-11,35,46
248,ULK,P004004,17.833,8,36,28
248,ULK,P005844,10.6,5,22,17
248,ULK,P006068,10.9,-2,21,23
248,ULK,P006661,22.966,8,56,48
248,ULK,P006961,27.482,14,64,50
248,ULK,P008962,32.066,8,75,67
248,ULK,P009849,8.883,-5,16,21
248,ULK,P011052,5.4,0,12,12
248,ULK,P011157,11.35,16,32,16
248,ULK,P011980,7.933,2,14,12
249,BAR,P000925,27.217,10,57,47
249,BAR,P002939,25.267,11,53,42
249,BAR,P003196,12.783,0,31,31
249,BAR,P003478,5.05,-10,5,15
249,BAR,P004866,32.9,21,78,57
249,BAR,P006435,20.633,2,49,47
249,BAR,P007464,12.833,4,35,31
249,BAR,P007519,13.55,12,29,17
249,BAR,P009992,6.917,-2,12,14
249,BAR,P012745,29.217,5,58,53
249,BAR,PLFW,13.633,-3,33,36
249,PAM,P000556,10.699,-6,26,32
249,PAM,P003960,29.265,-4,52,56
249,PAM,P005356,16.615,3,40,37
249,PAM,P006433,15.549,-5,26,31
249,PAM,P006643,13.666,-13,20,33
249,PAM,P007870,23.482,-13,37,50
249,PAM,P010393,14.065,3,35,32
249,PAM,P010568,28.982,-13,47,60
249,PAM,P011970,8.316,-3,23,26
249,PAM,P011982,17.548,2,42,40
249,PAM,P012740,1.25,-1,1,2
249,PAM,P012795,20.548,0,41,41
250,MIL,P000796,20.866,-2,48,50
250,MIL,P001518,8.032,-9,15,24
250,MIL,P002812,11.35,-10,24,34
250,MIL,P002849,27.666,4,54,50
250,MIL,P007032,13.6,-8,29,37
250,MIL,P007201,20.483,10,44,34
250,MIL,P007831,33.166,13,73,60
250,MIL,P011205,29.449,7,63,56
250,MIL,P011224,28.566,14,62,48
250,MIL,P012800,6.817,-9,13,22
250,PAR,P000956,21.233,13,50,37
250,PAR,P003983,32.6,9,73,64
250,PAR,P004172,23.867,-18,48,66
250,PAR,P007673,10.717,-11,14,25
250,PAR,P008987,32.884,0,70,70
250,PAR,P009862,19.167,11,42,31
250,PAR,P011051,12.767,-7,24,31
250,PAR,P012096,20.083,10,47,37
250,PAR,P012742,12.933,-10,22,32
250,PAR,P012743,13.749,-7,25,32
251,ASV,P000229,18.984,-17,31,48
251,ASV,P002100,23.083,-3,42,45
251,ASV,P003526,16.25,-13,23,36
251,ASV,P004194,22.166,-9,40,49
251,ASV,P005094,19.65,-17,30,47
251,ASV,P006568,17.767,-11,25,36
251,ASV,P011386,22.517,-19,37,56
251,ASV,P012080,19.433,1,34,33
251,ASV,P012731,21.916,-4,41,45
251,ASV,PKIR,18.234,2,32,30
251,PAN,P001926,27.334,19,63,44
251,PAN,P002328,28.584,17,59,42
251,PAN,P003842,29.7,16,68,52
251,PAN,P005161,7.084,-3,9,12
251,PAN,P006544,1.134,2,2,0
251,PAN,P007553,5.15,2,8,6
251,PAN,P007866,21.834,-2,37,39
251,PAN,P008084,1.134,2,2,0
251,PAN,P011204,30.366,17,68,51
251,PAN,P011209,5.05,-6,7,13
251,PAN,P012712,20.901,20,53,33
251,PAN,P012774,21.734,6,49,43
252,BAS,P004603,20.134,6,44,38
252,BAS,P004761,26.451,25,62,37
252,BAS,P007230,26.234,9,60,51
252,BAS,P007946,9.168,3,19,16
252,BAS,P008850,10.3,-9,20,29
252,BAS,P009048,30.833,14,69,55
252,BAS,P010444,19.867,11,44,33
252,BAS,P011085,14.635,12,32,20
252,BAS,P011948,20.467,6,42,36
252,BAS,P012201,21.916,8,48,40
252,BER,P006251,9.766,-17,8,25
252,BER,P006919,24.883,-1,47,48
252,BER,P007025,16.566,-19,17,36
252,BER,P007550,16.199,-8,26,34
252,BER,P008211,19.183,-8,37,45
252,BER,P008780,23.8,-9,45,54
252,BER,P008967,22.15,3,53,50
252,BER,P010791,24.133,5,54,49
252,BER,P011631,5.35,1,16,15
252,BER,P011934,15.866,-22,17,39
252,BER,P012720,22.099,-10,35,45
253,BER,P003958,21.967,-4,44,48
253,BER,P006251,14.5,-4,29,33
253,BER,P006919,19.883,-3,41,44
253,BER,P007025,11.883,-3,23,26
253,BER,P007550,15.683,1,34,33
253,BER,P008211,24.317,-9,48,57
253,BER,P008967,25.884,1,55,54
253,BER,P010791,16.849,0,37,37
253,BER,P011631,0.117,0,0,0
253,BER,P011934,20.517,-8,41,49
253,BER,P012720,28.4,-11,58,69
253,MCO,P002581,4.75,-11,4,15
253,MCO,P004197,5.05,-10,8,18
253,MCO,P004790,12.816,14,33,19
253,MCO,P005985,29.216,0,62,62
253,MCO,P008099,12.15,2,30,28
253,MCO,P010588,18.099,-6,37,43
253,MCO,P011196,22.366,23,57,34
253,MCO,P011212,26.266,4,56,52
253,MCO,P011231,20.5,-3,43,46
253,MCO,P012515,22.833,18,56,38
253,MCO,P012709,13.066,13,35,22
253,MCO,PLCZ,12.883,-4,29,33
254,BAR,P000925,24.934,5,60,55
254,BAR,P002939,23.3,-1,50,51
254,BAR,P003196,13.816,11,30,19
254,BAR,P003478,13.75,8,29,21
254,BAR,P004866,23.6,6,59,53
254,BAR,P006435,23.667,1,49,48
254,BAR,P007519,18.983,21,51,30
254,BAR,P011244,19.383,11,41,30
254,BAR,P012745,21.867,9,57,48
254,BAR,PLFW,16.7,19,44,25
254,PAR,P000956,14.55,-5,24,29
254,PAR,P003983,30.517,3,66,63
254,PAR,P004172,13.984,-12,24,36
254,PAR,P007400,19.066,-10,40,50
254,PAR,P007673,12.717,-9,16,25
254,PAR,P008987,32.816,-7,68,75
254,PAR,P009862,24.983,-12,52,64
254,PAR,P011051,20.067,-7,34,41
254,PAR,P012096,5.883,-9,10,19
254,PAR,P012742,8.4,-18,10,28
254,PAR,P012743,17.017,-4,36,40
255,OLY,P001255,24.1,6,43,37
255,OLY,P007853,16.049,0,28,28
255,OLY,P007982,18.483,-3,33,36
255,OLY,P008811,24.449,-2,33,35
255,OLY,P008829,26.6,4,45,41
255,OLY,P008855,26.466,16,53,37
255,OLY,P010612,19.15,-4,22,26
255,OLY,P011194,21.099,0,41,41
255,OLY,P011965,5.816,4,11,7
255,OLY,P011983,2.233,1,8,7
255,OLY,P012878,15.55,8,38,30
255,PAN,P001926,20.6,-7,35,42
255,PAN,P002328,17.599,-7,25,32
255,PAN,P003842,32.733,-9,46,55
255,PAN,P005161,13.5,-1,21,22
255,PAN,P007553,4.733,5,9,4
255,PAN,P007866,34.665,-2,58,60
255,PAN,P011204,32.699,4,60,56
255,PAN,P012712,9.65,-7,16,23
255,PAN,P012774,33.816,-6,55,61
256,BAS,P003198,12.916,-1,30,31
256,BAS,P004603,21.383,8,45,37
256,BAS,P004761,29.749,12,60,48
256,BAS,P007230,27.433,16,58,42
256,BAS,P007946,14.466,5,25,20
256,BAS,P008850,1.117,0,4,4
256,BAS,P009048,25.533,10,63,53
256,BAS,P010444,18.616,7,43,36
256,BAS,P011948,24.816,5,56,51
256,BAS,P012201,23.966,13,56,43
256,MIL,P000796,30.1,0,61,61
256,MIL,P002812,8.366,-12,5,17
256,MIL,P002849,26.001,-10,44,54
256,MIL,P005670,11.083,-1,28,29
256,MIL,P006509,7.116,-3,12,15
256,MIL,P006721,4.05,7,14,7
256,MIL,P007032,6.933,-6,13,19
256,MIL,P007201,22.917,-17,44,61
256,MIL,P007831,31.133,-13,52,65
256,MIL,P011205,26.6,-3,53,56
256,MIL,P011224,25.701,-17,39,56
257,RED,P002553,18.717,-5,29,34
257,RED,P004720,3.049,-3,2,5
257,RED,P005099,18.366,7,46,39
257,RED,P006436,27.318,-10,52,62
257,RED,P007960,18.984,1,46,45
257,RED,P008966,6.1,3,14,11
257,RED,P009035,28.018,-1,59,60
257,RED,P011941,11.9,-2,21,23
257,RED,P011964,3.584,7,10,3
257,RED,P012044,31.068,-14,57,71
257,RED,P012801,32.901,-3,64,67
257,TEL,P005145,9.767,-2,17,19
257,TEL,P007990,14.598,-5,31,36
257,TEL,P009622,31.716,9,68,59
257,TEL,P009783,31.448,5,68,63
257,TEL,P009863,33.899,7,76,69
257,TEL,P011193,5.534,-5,9,14
257,TEL,P011199,29.9,7,67,60
257,TEL,P011214,12.699,-8,19,27
257,TEL,P011971,11.55,5,23,18
257,TEL,P012744,18.884,7,42,35
258,PAM,P003960,19.834,-13,38,51
258,PAM,P004863,12.833,-5,31,36
258,PAM,P005356,12.567,-14,32,46
258,PAM,P006433,16.584,-15,29,44
258,PAM,P006643,8.517,-6,25,31
258,PAM,P007870,24.95,-17,52,69
258,PAM,P010393,20.167,-17,50,67
258,PAM,P010568,16.267,-13,28,41
258,PAM,P011970,18.25,-15,44,59
258,PAM,P011982,15.184,-10,30,40
258,PAM,P012738,15.051,-13,36,49
258,PAM,P012795,19.801,-12,45,57
258,ULK,P001932,19.251,14,53,39
258,ULK,P002968,9.25,8,23,15
258,ULK,P004004,13.8,10,41,31
258,ULK,P005844,12.051,14,46,32
258,ULK,P006068,19.15,13,50,37
258,ULK,P006661,19.917,13,58,45
258,ULK,P006961,15.833,16,53,37
258,ULK,P008962,24.034,18,66,48
258,ULK,P009849,22.885,19,69,50
258,ULK,P011052,10.0,6,33,27
258,ULK,P011157,17.867,7,46,39
258,ULK,P011980,15.967,12,52,40
259,MAD,P003108,19.249,2,43,41
259,MAD,P003733,17.05,10,33,23
259,MAD,P004887,14.533,7,37,30
259,MAD,P005791,25.467,8,52,44
259,MAD,P005928,25.067,13,55,42
259,MAD,P006540,19.918,11,42,31
259,MAD,P009005,21.75,7,52,45
259,MAD,P010357,25.634,18,59,41
259,MAD,P010623,12.216,-4,26,30
259,MAD,PTGB,19.116,3,46,43
259,VIR,P001133,23.634,-21,34,55
259,VIR,P002084,8.232,5,23,18
259,VIR,P003048,6.867,-1,15,16
259,VIR,P003527,6.15,-3,12,15
259,VIR,P004007,16.182,-10,32,42
259,VIR,P004554,20.083,-10,30,40
259,VIR,P005553,5.584,2,13,11
259,VIR,P006739,23.433,-12,40,52
259,VIR,P008847,18.916,-4,40,44
259,VIR,P009549,26.732,-8,45,53
259,VIR,P010781,22.132,-6,48,54
259,VIR,PBCN,22.05,-7,38,45
260,MUN,P001288,25.517,6,43,37
260,MUN,P001557,12.483,0,21,21
260,MUN,P003583,19.25,1,33,32
260,MUN,P006760,18.6,-5,27,32
260,MUN,P007056,26.1,12,43,31
260,MUN,P007639,18.05,4,25,21
260,MUN,P007975,10.483,-10,10,20
260,MUN,P008985,20.416,10,37,27
260,MUN,P010391,26.667,7,44,37
260,MUN,P011987,22.434,5,37,32
260,ZAL,P002329,30.218,-14,37,51
260,ZAL,P002676,19.449,3,29,26
260,ZAL,P003210,21.833,4,40,36
260,ZAL,P003211,8.167,-11,6,17
260,ZAL,P005504,16.05,1,23,22
260,ZAL,P007109,8.517,2,11,9
260,ZAL,P007513,12.467,-5,15,20
260,ZAL,P010390,20.75,-10,30,40
260,ZAL,P011218,26.55,-1,38,39
260,ZAL,P012715,24.416,2,44,42
260,ZAL,P012787,11.583,-1,17,18
261,ASV,P000229,15.1,-1,26,27
261,ASV,P002100,24.933,5,58,53
261,ASV,P003526,13.466,7,25,18
261,ASV,P005094,31.65,10,66,56
261,ASV,P006568,20.316,5,39,34
261,ASV,P011225,22.217,0,49,49
261,ASV,P011386,17.783,4,35,31
261,ASV,P012080,25.584,-2,56,58
261,ASV,P012731,20.917,-3,47,50
261,ASV,PKIR,8.034,-5,19,24
261,IST,P004888,36.299,-1,72,73
261,IST,P006590,22.85,-1,53,54
261,IST,P007200,30.516,-10,56,66
261,IST,P009513,8.383,-5,11,16
261,IST,P009664,13.75,-8,24,32
261,IST,P009846,12.633,9,32,23
261,IST,P011078,26.533,3,61,58
261,IST,P011981,20.733,1,48,47
261,IST,P012710,11.149,-5,16,21
261,IST,P012788,3.683,4,9,5
261,IST,PLHK,13.466,-7,18,25
262,BER,P003958,26.849,4,55,51
262,BER,P006251,14.65,-14,27,41
262,BER,P006919,22.3,-2,39,41
262,BER,P007025,9.25,-17,16,33
262,BER,P007550,3.95,-12,2,14
262,BER,P008211,11.866,-1,28,29
262,BER,P008780,24.066,6,49,43
262,BER,P008967,25.699,11,55,44
262,BER,P010791,27.316,18,60,42
262,BER,P011934,11.05,-22,16,38
262,BER,P012720,22.999,-6,48,54
262,MAD,P001392,15.633,-3,30,33
262,MAD,P003108,26.649,6,60,54
262,MAD,P003733,21.716,7,50,43
262,MAD,P004887,16.55,4,36,32
262,MAD,P005791,23.316,3,50,47
262,MAD,P005928,25.199,3,55,52
262,MAD,P009005,16.133,4,32,28
262,MAD,P009213,11.367,-12,14,26
262,MAD,P010357,28.632,19,72,53
262,MAD,P010623,14.8,4,31,27
263,IST,P004888,25.267,7,57,50
263,IST,P006590,19.75,6,37,31
263,IST,P007200,26.551,8,60,52
263,IST,P009513,12.517,8,28,20
263,IST,P009664,20.451,10,43,33
263,IST,P009846,22.317,14,47,33
263,IST,P011078,18.617,-4,35,39
263,IST,P011981,3.233,4,8,4
263,IST,P012710,14.534,3,33,30
263,IST,P012788,20.4,1,37,36
263,IST,PLHK,16.368,8,40,32
263,OLY,P001255,28.55,7,60,53
263,OLY,P007853,6.767,-1,8,9
263,OLY,P007982,20.0,-14,27,41
263,OLY,P008811,26.1,-6,49,55
263,OLY,P008829,30.0,-7,56,63
263,OLY,P008855,27.283,-8,55,63
263,OLY,P010392,7.5,-10,10,20
263,OLY,P010612,25.95,-3,54,57
263,OLY,P011194,10.0,-6,16,22
263,OLY,P011983,3.95,-10,2,12
263,OLY,P012878,13.9,-7,23,30
264,ASV,P000229,15.634,-6,30,36
264,ASV,P002100,24.333,-2,60,62
264,ASV,P003526,12.851,-4,24,28
264,ASV,P004194,15.8,-3,33,36
264,ASV,P005094,26.983,-17,58,75
264,ASV,P006568,23.0,-5,54,59
264,ASV,P011225,25.017,-9,61,70
264,ASV,P011386,14.816,1,29,28
264,ASV,P012080,21.733,-10,48,58
264,ASV,P012731,14.134,10,35,25
264,ASV,PKIR,5.699,5,18,13
264,TEL,P005145,9.9,4,25,21
264,TEL,P007990,21.667,8,55,47
264,TEL,P009622,22.566,-1,51,52
264,TEL,P009783,34.733,9,89,80
264,TEL,P009863,32.849,15,89,74
264,TEL,P011193,6.766,-5,14,19
264,TEL,P011199,28.699,17,74,57
264,TEL,P011214,7.6,-11,10,21
264,TEL,P011971,11.4,-8,19,27
264,TEL,P012744,23.815,12,64,52
265,BAS,P003198,15.05,4,34,30
265,BAS,P004603,9.984,-6,19,25
265,BAS,P004761,29.018,-6,62,68
265,BAS,P007230,18.134,-15,31,46
265,BAS,P007946,11.418,-1,22,23
265,BAS,P008850,0.467,-1,1,2
265,BAS,P009048,27.401,-3,59,62
265,BAS,P010444,27.551,5,60,55
265,BAS,P011085,4.767,4,14,10
265,BAS,P011948,21.018,-1,42,43
265,BAS,P012201,24.935,-5,48,53
265,BAS,P012765,10.267,5,23,18
265,PAR,P000956,5.383,-1,14,15
265,PAR,P003983,13.483,-1,27,28
265,PAR,P004058,4.35,-2,7,9
265,PAR,P004172,23.316,4,52,48
265,PAR,P007400,22.133,0,44,44
265,PAR,P007673,11.416,-8,24,32
265,PAR,P009862,28.215,6,62,56
265,PAR,P011050,1.4,0,4,4
265,PAR,P011051,5.166,-3,7,10
265,PAR,P012096,38.366,4,83,79
265,PAR,P012742,22.083,7,52,45
265,PAR,P012743,24.684,14,59,45
266,VIR,P001133,29.183,-4,67,71
266,VIR,P003048,10.25,-3,14,17
266,VIR,P003527,25.917,-13,48,61
266,VIR,P004007,13.616,1,31,30
266,VIR,P004554,11.5,-5,27,32
266,VIR,P005553,20.8,-12,38,50
266,VIR,P006739,30.05,-6,65,71
266,VIR,P008847,16.833,-12,36,48
266,VIR,P010781,17.35,-12,34,46
266,VIR,PBCN,24.501,-9,45,54
266,ZAL,P002329,27.051,7,70,63
266,ZAL,P002676,26.334,21,64,43
266,ZAL,P003210,11.634,6,25,19
266,ZAL,P003211,10.518,0,22,22
266,ZAL,P005504,19.135,10,51,41
266,ZAL,P006860,9.434,8,26,18
266,ZAL,P007513,23.9,8,58,50
266,ZAL,P010390,20.784,8,45,37
266,ZAL,P011218,23.501,7,63,56
266,ZAL,P012715,11.017,-8,20,28
266,ZAL,P012784,0.8,1,3,2
266,ZAL,P012787,15.902,7,33,26
267,MCO,P002581,3.567,-2,10,12
267,MCO,P004197,9.999,-5,17,22
267,MCO,P005985,28.583,-19,56,75
267,MCO,P009754,17.449,-17,28,45
267,MCO,P010588,24.283,-21,44,65
267,MCO,P011196,20.166,4,41,37
267,MCO,P011212,22.833,2,52,50
267,MCO,P011226,24.784,-10,51,61
267,MCO,P011231,20.932,-2,46,48
267,MCO,P012709,16.349,-5,36,41
267,MCO,PLCZ,11.05,-15,19,34
267,MIL,P000796,29.5,18,78,60
267,MIL,P002812,12.717,4,27,23
267,MIL,P002849,20.167,11,57,46
267,MIL,P005670,0.55,0,0,0
267,MIL,P006509,26.617,10,62,52
267,MIL,P006701,0.55,0,0,0
267,MIL,P007032,15.483,-2,32,34
267,MIL,P007201,15.951,-1,28,29
267,MIL,P007831,28.751,28,79,51
267,MIL,P011205,22.918,7,56,49
267,MIL,P011224,26.801,15,71,56
268,PAN,P001926,27.151,10,65,55
268,PAN,P002328,24.484,11,53,42
268,PAN,P003842,36.8,16,81,65
268,PAN,P006544,0.067,0,0,0
268,PAN,P007553,2.667,-3,6,9
268,PAN,P007866,32.101,10,69,59
268,PAN,P011204,29.884,9,64,55
268,PAN,P011209,0.4,-1,1,2
268,PAN,P012712,8.7,1,20,19
268,PAN,P012774,37.751,12,86,74
268,RED,P000848,24.899,-4,53,57
268,RED,P002553,9.349,-7,17,24
268,RED,P004720,2.067,-2,6,8
268,RED,P005099,22.715,-6,37,43
268,RED,P006436,14.983,-6,31,37
268,RED,P007960,27.649,-6,50,56
268,RED,P008966,5.3,-9,11,20
268,RED,P009035,32.6,-7,64,71
268,RED,P011941,4.783,-4,6,10
268,RED,P011964,23.283,0,43,43
268,RED,P012801,15.15,-9,23,32
268,RED,PJDR,17.217,-5,39,44
269,BAR,P000925,19.516,-13,31,44
269,BAR,P002939,26.234,-15,45,60
269,BAR,P003196,17.833,-3,35,38
269,BAR,P003478,18.132,3,38,35
269,BAR,P004866,17.7,-11,27,38
269,BAR,P006435,19.35,-16,29,45
269,BAR,P007519,3.483,-5,5,10
269,BAR,P009992,13.883,7,36,29
269,BAR,P010641,2.65,2,8,6
269,BAR,P011244,16.049,4,33,29
269,BAR,P012745,23.95,-18,41,59
269,BAR,PLFW,21.215,-5,42,47
269,ULK,P001932,25.901,10,54,44
269,ULK,P002968,14.3,10,34,24
269,ULK,P004004,22.449,6,50,44
269,ULK,P005844,1.117,0,0,0
269,ULK,P006068,9.833,6,25,19
269,ULK,P006661,22.867,16,60,44
269,ULK,P006961,21.834,19,57,38
269,ULK,P008962,31.017,5,63,58
269,ULK,P009849,12.433,-1,20,21
269,ULK,P010560,13.666,-5,23,28
269,ULK,P011157,24.583,4,54,50
270,MUN,P001288,27.434,-4,45,49
270,MUN,P001557,10.983,3,21,18
270,MUN,P003583,20.516,2,35,33
270,MUN,P005460,8.65,7,20,13
270,MUN,P005478,4.767,0,11,11
270,MUN,P006543,8.65,4,16,12
270,MUN,P006760,7.867,-8,9,17
270,MUN,P007056,25.717,-13,39,52
270,MUN,P007975,21.666,1,37,36
270,MUN,P008985,18.283,-2,32,34
270,MUN,P010391,21.233,2,34,32
270,MUN,P011987,24.234,-2,41,43
270,PAM,P000556,13.033,-6,20,26
270,PAM,P003960,24.066,7,50,43
270,PAM,P004863,25.783,7,46,39
270,PAM,P005356,11.733,-4,17,21
270,PAM,P006433,9.183,-2,16,18
270,PAM,P010393,25.999,11,52,41
270,PAM,P010568,28.799,7,56,49
270,PAM,P011982,29.767,9,55,46
270,PAM,P012739,9.916,-13,9,22
270,PAM,P012740,4.667,0,8,8
270,PAM,P012795,17.049,-6,21,27
271,BER,P003958,24.55,9,54,45
271,BER,P006251,13.416,-9,26,35
271,BER,P006919,23.699,10,56,46
271,BER,P007025,14.216,-13,23,36
271,BER,P008211,15.599,-12,26,38
271,BER,P008780,24.4,11,58,47
271,BER,P008967,25.783,12,61,49
271,BER,P010791,21.866,-4,43,47
271,BER,P011934,18.133,3,41,38
271,BER,P012720,18.333,-12,32,44
271,IST,P004888,22.4,-15,38,53
271,IST,P006590,22.233,8,50,42
271,IST,P007200,14.133,-4,28,32
271,IST,P009513,12.949,-12,20,32
271,IST,P009664,22.35,10,53,43
271,IST,P009846,24.399,14,60,46
271,IST,P011078,23.883,12,59,47
271,IST,P011981,17.917,10,43,33
271,IST,P012710,17.649,-9,32,41
271,IST,P012788,7.233,-2,14,16
271,IST,PLHK,14.849,-7,28,35
272,ASV,P000229,13.833,2,29,27
272,ASV,P002100,23.083,-12,32,44
272,ASV,P004194,20.301,-1,33,34
272,ASV,P006568,19.699,-15,31,46
272,ASV,P011225,28.3,-18,44,62
272,ASV,P011386,11.7,2,20,18
272,ASV,P012080,26.934,-11,45,56
272,ASV,P012729,20.033,-17,32,49
272,ASV,P012731,19.967,1,32,31
272,ASV,PKIR,16.15,-11,22,33
272,OLY,P001255,20.0,-1,31,32
272,OLY,P007853,20.0,17,49,32
272,OLY,P007982,20.883,7,42,35
272,OLY,P008811,23.067,11,45,34
272,OLY,P008829,32.567,10,61,51
272,OLY,P008855,20.784,3,40,37
272,OLY,P010392,19.65,19,49,30
272,OLY,P010612,18.683,3,29,26
272,OLY,P011194,7.433,6,19,13
272,OLY,P012878,16.933,5,35,30
273,MAD,P001392,22.35,18,54,36
273,MAD,P003108,31.75,20,79,59
273,MAD,P003733,18.799,-7,38,45
273,MAD,P004887,19.684,16,43,27
273,MAD,P005791,17.082,-2,39,41
273,MAD,P005928,22.1,9,52,43
273,MAD,P006540,8.432,-4,14,18
273,MAD,P009005,19.033,4,35,31
273,MAD,P010357,26.132,5,61,56
273,MAD,P010623,11.866,-3,18,21
273,MAD,P011649,2.767,4,7,3
273,PAR,P000956,6.5,4,14,10
273,PAR,P003983,26.25,-9,60,69
273,PAR,P004058,3.533,-6,0,6
273,PAR,P004172,16.784,-4,24,28
273,PAR,P007400,32.401,-9,71,80
273,PAR,P009862,33.217,-2,67,69
273,PAR,P011051,18.935,-18,31,49
273,PAR,P012096,22.083,-14,36,50
273,PAR,P012742,12.235,-8,16,24
273,PAR,P012743,28.067,6,61,55
274,BAS,P003198,8.201,-8,11,19
274,BAS,P004603,12.633,-1,30,31
274,BAS,P004761,30.566,-2,66,68
274,BAS,P007230,18.334,-10,32,42
274,BAS,P007946,3.05,-7,2,9
274,BAS,P009048,30.633,-9,62,71
274,BAS,P010444,23.233,-9,42,51
274,BAS,P011085,10.849,-15,18,33
274,BAS,P011948,27.701,-11,53,64
274,BAS,P012201,26.35,-14,50,64
274,BAS,P012765,8.45,-4,14,18
274,ZAL,P002329,20.617,1,44,43
274,ZAL,P002676,22.484,17,56,39
274,ZAL,P003210,13.484,6,30,24
274,ZAL,P003211,16.734,13,44,31
274,ZAL,P005504,12.1,1,28,27
274,ZAL,P006860,5.516,-4,11,15
274,ZAL,P007513,23.168,3,53,50
274,ZAL,P010390,27.901,17,66,49
274,ZAL,P011218,24.902,2,55,53
274,ZAL,P012715,17.75,19,47,28
274,ZAL,P012784,1.133,-2,2,4
274,ZAL,P012787,14.216,17,34,17
275,MCO,P004790,9.35,-3,15,18
275,MCO,P005985,33.233,13,71,58
275,MCO,P008099,24.551,2,53,51
275,MCO,P010588,24.333,13,56,43
275,MCO,P011196,21.117,-6,39,45
275,MCO,P011212,12.966,2,24,22
275,MCO,P011226,25.867,-11,45,56
275,MCO,P011231,21.65,5,46,41
275,MCO,P012709,10.0,-15,10,25
275,MCO,PLCZ,16.933,5,36,31
275,PAM,P000556,17.434,1,32,31
275,PAM,P003960,24.483,-3,46,49
275,PAM,P004863,19.568,14,45,31
275,PAM,P005356,13.019,1,29,28
275,PAM,P006433,11.299,-12,19,31
275,PAM,P010393,13.85,-9,15,24
275,PAM,P010568,27.233,-4,51,55
275,PAM,P011982,24.935,17,61,44
275,PAM,P012738,11.601,-1,28,29
275,PAM,P012740,9.533,2,17,15
275,PAM,P012795,27.05,-11,47,58
276,MIL,P000796,26.717,7,55,48
276,MIL,P002812,3.05,-2,4,6
276,MIL,P002849,23.899,-1,47,48
276,MIL,P005670,8.667,3,16,13
276,MIL,P006509,21.349,-10,41,51
276,MIL,P006701,3.75,-2,5,7
276,MIL,P007201,14.55,-6,25,31
276,MIL,P007831,32.8,3,66,63
276,MIL,P009960,11.784,4,23,19
276,MIL,P011205,26.501,4,49,45
276,MIL,P011224,26.933,5,54,49
276,ULK,P001932,24.25,-10,42,52
276,ULK,P002968,6.034,1,10,9
276,ULK,P004004,26.266,2,49,47
276,ULK,P005844,6.633,-3,8,11
276,ULK,P006068,6.467,-8,10,18
276,ULK,P006661,27.85,10,57,47
276,ULK,P006961,26.799,-4,51,55
276,ULK,P008962,25.85,-1,52,53
276,ULK,P009849,17.701,12,43,31
276,ULK,P011157,21.85,-6,41,47
276,ULK,P011980,10.3,2,17,15
277,RED,P000848,23.6,10,60,50
277,RED,P002553,18.634,7,43,36
277,RED,P004720,0.35,0,0,0
277,RED,P005099,26.367,6,59,53
277,RED,P006436,20.185,11,48,37
277,RED,P007960,19.816,3,45,42
277,RED,P008966,17.45,9,48,39
277,RED,P009035,28.084,16,70,54
277,RED,P011964,15.684,-2,27,29
277,RED,P012801,13.217,1,27,26
277,RED,PJDR,16.618,14,43,29
277,VIR,P001133,29.349,-15,57,72
277,VIR,P002084,11.317,0,24,24
277,VIR,P003048,19.533,-5,42,47
277,VIR,P003527,23.433,-11,47,58
277,VIR,P004007,11.567,-15,24,39
277,VIR,P005553,10.55,-4,16,20
277,VIR,P006739,19.148,-5,42,47
277,VIR,P008847,18.066,-4,31,35
277,VIR,P010781,29.816,-9,58,67
277,VIR,PBCN,27.216,-7,54,61
278,MUN,P001288,29.751,-7,50,57
278,MUN,P001557,15.118,6,29,23
278,MUN,P003583,26.384,-8,43,51
278,MUN,P005460,10.751,6,29,23
278,MUN,P005478,4.9,-11,6,17
278,MUN,P006543,10.251,-8,24,32
278,MUN,P006760,16.785,-11,36,47
278,MUN,P007975,14.051,-17,23,40
278,MUN,P008985,25.967,-1,56,57
278,MUN,P010391,16.318,-6,23,29
278,MUN,P011987,29.734,-18,51,69
278,TEL,P005145,7.35,-4,9,13
278,TEL,P007990,12.001,14,38,24
278,TEL,P009622,27.733,15,58,43
278,TEL,P009783,34.351,17,75,58
278,TEL,P009863,28.233,3,53,50
278,TEL,P011193,12.268,0,31,31
278,TEL,P011199,28.117,14,60,46
278,TEL,P011214,11.884,1,29,28
278,TEL,P011971,20.751,6,51,45
278,TEL,P012744,17.317,9,41,32
279,BAR,P000925,25.3,-11,45,56
279,BAR,P002939,27.866,-5,58,63
279,BAR,P003196,14.699,3,36,33
279,BAR,P003478,15.915,4,39,35
279,BAR,P004866,24.084,-12,42,54
279,BAR,P006435,21.35,-7,41,48
279,BAR,P007519,15.683,-3,31,34
279,BAR,P011244,13.1,4,30,26
279,BAR,P012745,26.466,-9,51,60
279,BAR,PLFW,15.532,-4,32,36
279,PAN,P001926,33.517,21,81,60
279,PAN,P002328,29.217,1,62,61
279,PAN,P003842,35.068,6,78,72
279,PAN,P007553,3.367,-4,5,9
279,PAN,P007866,37.784,15,89,74
279,PAN,P007947,0.967,-2,2,4
279,PAN,P011204,24.068,6,54,48
279,PAN,P011209,3.067,-6,3,9
279,PAN,P012712,3.55,-5,4,9
279,PAN,P012774,29.4,8,67,59
280,BAR,P000925,20.55,-7,38,45
280,BAR,P002939,21.285,11,49,38
280,BAR,P003196,19.451,15,49,34
280,BAR,P003478,17.151,5,42,37
280,BAR,P004866,20.583,3,41,38
280,BAR,P006435,20.717,-2,43,45
280,BAR,P007519,8.149,-4,13,17
280,BAR,P009992,15.251,9,35,26
280,BAR,P011244,16.983,-1,32,33
280,BAR,P012745,23.018,9,55,46
280,BAR,PLFW,16.867,2,38,36
280,MUN,P001288,29.584,-9,55,64
280,MUN,P003583,26.05,-9,43,52
280,MUN,P005460,10.917,-5,27,32
280,MUN,P005478,6.266,-1,9,10
280,MUN,P006543,12.817,5,34,29
280,MUN,P006760,26.066,-7,49,56
280,MUN,P007975,20.617,3,47,44
280,MUN,P008985,17.0,-9,27,36
280,MUN,P010391,20.1,-2,46,48
280,MUN,P011987,23.617,-8,42,50
280,MUN,P012123,6.966,2,16,14
281,ASV,P000229,20.516,-10,37,47
281,ASV,P002100,21.334,-4,44,48
281,ASV,P003526,9.733,4,19,15
281,ASV,P004194,20.233,-8,43,51
281,ASV,P006568,18.834,4,34,30
281,ASV,P011225,25.967,-11,52,63
281,ASV,P011386,13.75,4,25,21
281,ASV,P012080,28.7,-13,54,67
281,ASV,P012729,5.133,-6,4,10
281,ASV,P012731,22.084,-1,40,41
281,ASV,PKIR,13.716,-9,33,42
281,MCO,P002581,5.384,-4,8,12
281,MCO,P004197,8.317,-7,10,17
281,MCO,P005985,28.6,20,73,53
281,MCO,P009754,20.817,-2,39,41
281,MCO,P010588,17.249,4,40,36
281,MCO,P011196,19.566,7,41,34
281,MCO,P011212,26.699,13,60,47
281,MCO,P011226,30.55,17,75,58
281,MCO,P011231,25.084,11,58,47
281,MCO,P012709,5.017,-11,4,15
281,MCO,PLCZ,12.717,2,27,25
282,BAS,P003198,11.483,1,25,24
282,BAS,P004603,23.133,-24,40,64
282,BAS,P004761,26.532,-20,44,64
282,BAS,P007230,24.284,-24,42,66
282,BAS,P009048,27.117,-6,54,60
282,BAS,P010444,15.633,0,29,29
282,BAS,P011085,18.617,-3,37,40
282,BAS,P011948,25.4,-10,53,63
282,BAS,P012201,14.501,-6,32,38
282,BAS,P012765,13.3,-13,24,37
282,IST,P004888,29.685,20,78,58
282,IST,P006372,0.417,-2,0,2
282,IST,P006590,15.484,-2,31,33
282,IST,P007200,28.351,28,79,51
282,IST,P009513,16.501,28,49,21
282,IST,P009664,10.784,-5,20,25
282,IST,P009846,15.434,-8,28,36
282,IST,P011078,19.568,-5,40,45
282,IST,P011981,17.75,16,43,27
282,IST,P012710,24.301,29,65,36
282,IST,P012788,8.001,-7,14,21
282,IST,PLHK,13.734,13,38,25
283,PAM,P000556,10.966,-1,24,25
283,PAM,P003960,24.199,-5,49,54
283,PAM,P004863,20.5,-1,40,41
283,PAM,P005356,19.582,-8,39,47
283,PAM,P006433,17.433,-12,36,48
283,PAM,P010393,17.333,-11,31,42
283,PAM,P010568,20.95,-7,40,47
283,PAM,P011982,24.7,-8,52,60
283,PAM,P012738,2.833,-5,4,9
283,PAM,P012740,18.616,-5,40,45
283,PAM,P012795,22.883,-12,45,57
283,TEL,P005145,12.734,11,31,20
283,TEL,P007990,11.482,0,27,27
283,TEL,P009622,27.683,13,65,52
283,TEL,P009783,31.616,5,68,63
283,TEL,P009863,28.517,15,68,53
283,TEL,P011193,12.25,3,30,27
283,TEL,P011199,27.149,16,67,51
283,TEL,P011214,15.799,-3,34,37
283,TEL,P011971,11.1,19,33,14
283,TEL,P012095,3.999,-3,7,10
283,TEL,P012744,17.666,-1,45,46
284,OLY,P001255,30.0,8,59,51
284,OLY,P006589,10.6,3,17,14
284,OLY,P007853,12.782,-4,20,24
284,OLY,P007982,23.749,15,52,37
284,OLY,P008811,30.0,8,59,51
284,OLY,P008829,13.783,-13,19,32
284,OLY,P008855,29.083,6,55,49
284,OLY,P010392,19.866,13,41,28
284,OLY,P010612,20.133,-8,33,41
284,OLY,P012878,9.999,-3,15,18
284,PAR,P003983,5.617,-6,5,11
284,PAR,P004172,27.25,9,56,47
284,PAR,P007400,15.75,-6,26,32
284,PAR,P007673,6.0,-9,7,16
284,PAR,P009862,37.45,-9,63,72
284,PAR,P011050,4.283,-1,5,6
284,PAR,P011051,9.433,-1,14,15
284,PAR,P012096,27.417,-10,43,53
284,PAR,P012742,32.483,6,64,58
284,PAR,P012743,34.317,2,62,60
285,MIL,P000796,25.566,-12,43,55
285,MIL,P002812,3.8,1,9,8
285,MIL,P002849,27.482,-11,46,57
285,MIL,P005670,1.617,-3,0,3
285,MIL,P006509,22.05,-12,33,45
285,MIL,P007032,17.499,-3,35,38
285,MIL,P007201,13.133,-1,27,28
285,MIL,P007831,31.816,-11,55,66
285,MIL,P009960,10.017,-5,21,26
285,MIL,P011205,20.799,-8,43,51
285,MIL,P011224,26.216,-5,53,58
285,ZAL,P002329,25.249,13,54,41
285,ZAL,P002676,30.5,13,64,51
285,ZAL,P003210,10.867,1,24,23
285,ZAL,P003211,11.082,2,26,24
285,ZAL,P005504,18.766,2,35,33
285,ZAL,P006860,0.6,1,1,0
285,ZAL,P007513,24.517,-1,41,42
285,ZAL,P010184,0.6,1,1,0
285,ZAL,P010390,20.633,11,51,40
285,ZAL,P011218,27.932,11,61,50
285,ZAL,P012715,14.15,0,32,32
285,ZAL,P012787,15.099,16,45,29
286,BER,P006251,19.167,-29,28,57
286,BER,P006819,12.685,-25,18,43
286,BER,P006919,19.968,-24,35,59
286,BER,P007025,16.951,-11,27,38
286,BER,P007550,10.085,-17,16,33
286,BER,P008211,13.019,-11,18,29
286,BER,P008780,20.417,-7,40,47
286,BER,P008967,21.551,-11,44,55
286,BER,P010791,23.752,-8,45,53
286,BER,P012720,20.168,-26,28,54
286,BER,P012721,22.252,-6,41,47
286,ULK,P001932,19.616,13,50,37
286,ULK,P002968,13.333,7,32,25
286,ULK,P005844,12.75,11,30,19
286,ULK,P006661,20.667,19,48,29
286,ULK,P006961,15.817,17,40,23
286,ULK,P008962,29.933,39,87,48
286,ULK,P009849,15.883,15,45,30
286,ULK,P010560,17.266,13,45,32
286,ULK,P011052,17.384,17,46,29
286,ULK,P011157,13.917,17,41,24
286,ULK,P011201,7.334,3,18,15
286,ULK,P011980,16.1,4,33,29
287,MAD,P001392,5.55,-7,9,16
287,MAD,P003108,26.25,22,80,58
287,MAD,P003733,5.55,-7,9,16
287,MAD,P005791,24.55,6,63,57
287,MAD,P006540,25.366,13,71,58
287,MAD,P009213,15.116,-5,32,37
287,MAD,P010357,29.717,7,78,71
287,MAD,P010623,8.433,1,20,19
287,MAD,P011649,8.883,-6,16,22
287,MAD,PBMT,19.101,6,49,43
287,MAD,PCVM,12.417,0,27,27
287,MAD,PTGB,19.067,5,51,46
287,RED,P000848,31.883,-1,78,79
287,RED,P002553,11.584,-3,27,30
287,RED,P004720,4.783,2,13,11
287,RED,P005099,30.082,-1,69,70
287,RED,P006436,15.983,-8,38,46
287,RED,P007960,15.933,-4,38,42
287,RED,P008966,7.132,-7,14,21
287,RED,P009035,19.783,-13,39,52
287,RED,P011941,16.033,15,45,30
287,RED,P011964,14.2,4,37,33
287,RED,P012801,17.316,-10,42,52
287,RED,PLUO,15.283,-9,30,39
288,PAN,P001926,32.317,14,73,59
288,PAN,P002328,15.434,6,33,27
288,PAN,P003842,34.584,-3,69,72
288,PAN,P005161,7.167,1,15,14
288,PAN,P007866,30.366,2,63,61
288,PAN,P011204,26.699,-5,52,57
288,PAN,P011209,1.533,-5,0,5
288,PAN,P011221,5.033,5,12,7
288,PAN,P012712,9.634,0,18,18
288,PAN,P012774,37.233,-5,70,75
288,VIR,P001133,29.216,-4,58,62
288,VIR,P001844,12.366,-7,20,27
288,VIR,P002084,8.35,-3,16,19
288,VIR,P003048,19.6,-2,41,43
288,VIR,P003527,8.417,-6,16,22
288,VIR,P004007,24.866,-3,46,49
288,VIR,P004554,13.817,2,28,26
288,VIR,P006739,27.267,6,59,53
288,VIR,P008847,8.867,3,15,12
288,VIR,P010781,22.734,2,46,44
288,VIR,PBCN,24.5,2,50,48
289,BER,P003958,26.967,4,69,65
289,BER,P006251,11.284,-15,14,29
289,BER,P007025,10.867,-7,17,24
289,BER,P007550,11.65,-7,17,24
289,BER,P008211,12.401,-8,17,25
289,BER,P008780,26.651,0,63,63
289,BER,P008967,26.984,-6,63,69
289,BER,P010791,13.066,-10,19,29
289,BER,P011934,25.018,-3,57,60
289,BER,P012720,25.983,-2,62,64
289,BER,P012721,9.134,-1,17,18
289,PAR,P000956,9.133,0,19,19
289,PAR,P003983,15.884,8,37,29
289,PAR,P007400,32.9,10,79,69
289,PAR,P008987,30.383,9,73,64
289,PAR,P009862,30.367,10,77,67
289,PAR,P011050,7.3,6,17,11
289,PAR,P011051,14.0,0,28,28
289,PAR,P012096,16.167,5,38,33
289,PAR,P012742,25.183,6,59,53
289,PAR,P012743,18.683,1,43,42
290,MCO,P005985,30.401,8,53,45
290,MCO,P008099,12.467,4,16,12
290,MCO,P009754,19.85,2,40,38
290,MCO,P010588,28.351,0,45,45
290,MCO,P011196,14.733,-4,26,30
290,MCO,P011212,23.834,1,43,42
290,MCO,P011226,24.618,-10,41,51
290,MCO,P011231,24.934,-2,45,47
290,MCO,PLCZ,20.817,16,36,20
290,ZAL,P002329,33.934,0,59,59
290,ZAL,P002676,10.666,-3,18,21
290,ZAL,P003210,14.367,6,28,22
290,ZAL,P003211,6.666,-4,7,11
290,ZAL,P005504,2.7,-5,2,7
290,ZAL,P006860,0.5,0,0,0
290,ZAL,P007109,8.0,-1,16,17
290,ZAL,P007513,24.55,0,39,39
290,ZAL,P010390,22.85,5,37,32
290,ZAL,P011218,32.233,-4,50,54
290,ZAL,P012715,25.017,-2,45,47
290,ZAL,P012787,18.517,-7,29,36
291,OLY,P001255,30.0,9,70,61
291,OLY,P006589,10.001,-6,19,25
291,OLY,P007853,10.118,-6,19,25
291,OLY,P007982,17.384,9,49,40
291,OLY,P008811,22.217,2,47,45
291,OLY,P008829,16.35,7,37,30
291,OLY,P008855,31.667,-3,66,69
291,OLY,P010392,12.75,2,26,24
291,OLY,P010612,14.85,4,31,27
291,OLY,P011965,12.467,1,31,30
291,OLY,P011983,5.634,-4,12,16
291,OLY,P012878,16.567,0,38,38
291,RED,P000848,29.217,-5,62,67
291,RED,P002553,14.934,-2,32,34
291,RED,P005099,29.517,-5,62,67
291,RED,P006436,29.201,13,76,63
291,RED,P007960,6.567,-5,11,16
291,RED,P009035,34.251,-1,76,77
291,RED,P011941,2.45,-4,3,7
291,RED,P011964,17.75,2,36,34
291,RED,P012044,6.767,-2,14,16
291,RED,PJDR,24.501,2,56,54
291,RED,PLUO,4.85,-8,2,10
292,BAR,P000925,26.367,13,62,49
292,BAR,P002939,28.334,15,65,50
292,BAR,P003196,11.282,-14,25,39
292,BAR,P003478,20.966,-4,48,52
292,BAR,P004866,25.8,5,54,49
292,BAR,P006435,26.366,24,71,47
292,BAR,P007519,5.183,-14,8,22
292,BAR,P010641,2.35,4,5,1
292,BAR,P011244,18.416,9,43,34
292,BAR,P012745,21.066,-5,49,54
292,BAR,PLFW,13.865,-18,30,48
292,TEL,P005145,6.317,-3,6,9
292,TEL,P007990,16.95,23,53,30
292,TEL,P009622,23.685,-24,36,60
292,TEL,P009783,30.167,-11,59,70
292,TEL,P009863,29.018,-11,58,69
292,TEL,P011193,19.116,21,60,39
292,TEL,P011199,22.785,-26,34,60
292,TEL,P011214,18.434,19,56,37
292,TEL,P011219,7.8,-8,16,24
292,TEL,P011971,11.8,3,33,30
292,TEL,P012744,13.933,2,34,32
293,ASV,P000229,20.016,3,46,43
293,ASV,P002100,19.983,26,52,26
293,ASV,P003526,18.216,3,39,36
293,ASV,P004194,22.182,17,55,38
293,ASV,P005094,29.132,34,80,46
293,ASV,P006568,20.934,9,43,34
293,ASV,P011225,26.65,23,72,49
293,ASV,P011386,18.016,8,40,32
293,ASV,P012731,2.533,-2,4,6
293,ASV,PKIR,22.333,24,59,35
293,PAM,P000556,11.717,-16,21,37
293,PAM,P003960,18.4,-27,24,51
293,PAM,P004863,13.968,-8,25,33
293,PAM,P005356,16.651,-19,28,47
293,PAM,P007870,24.151,-15,39,54
293,PAM,P010393,18.633,-14,33,47
293,PAM,P010568,25.317,-13,36,49
293,PAM,P011970,18.867,-12,41,53
293,PAM,P011982,21.034,-17,36,53
293,PAM,P012740,9.083,0,20,20
293,PAM,P012795,22.184,-4,42,46
294,MIL,P000796,27.116,26,66,40
294,MIL,P001518,9.866,-5,17,22
294,MIL,P002812,5.75,-2,12,14
294,MIL,P002849,16.617,11,40,29
294,MIL,P006509,23.483,15,57,42
294,MIL,P007032,14.782,-8,27,35
294,MIL,P007201,5.417,-7,9,16
294,MIL,P007831,29.716,22,70,48
294,MIL,P009960,17.632,6,38,32
294,MIL,P011205,24.399,-6,51,57
294,MIL,P011224,25.217,23,63,40
294,VIR,P001133,23.7,-28,39,67
294,VIR,P001844,16.7,-9,34,43
294,VIR,P002084,17.45,9,36,27
294,VIR,P003048,15.75,2,35,33
294,VIR,P003527,14.533,-7,25,32
294,VIR,P004007,13.151,-1,27,28
294,VIR,P004554,10.733,-8,18,26
294,VIR,P005553,6.867,1,16,15
294,VIR,P006739,25.35,-15,43,58
294,VIR,P008847,12.367,-5,22,27
294,VIR,P010781,18.716,-10,31,41
294,VIR,PBCN,24.683,-4,49,53
295,MUN,P001288,25.317,-8,45,53
295,MUN,P001557,13.0,0,26,26
295,MUN,P003583,26.301,0,53,53
295,MUN,P005460,9.966,-5,16,21
295,MUN,P006543,8.399,-2,14,16
295,MUN,P006760,28.334,-1,56,57
295,MUN,P007639,3.75,-2,6,8
295,MUN,P007975,12.133,-12,20,32
295,MUN,P008985,17.517,5,38,33
295,MUN,P010391,27.816,-7,51,58
295,MUN,P011987,27.467,-3,50,53
295,PAN,P001926,21.583,1,41,40
295,PAN,P002328,15.351,1,28,27
295,PAN,P003842,26.834,10,60,50
295,PAN,P005161,23.183,2,50,48
295,PAN,P007866,16.951,-8,23,31
295,PAN,P007947,5.25,10,19,9
295,PAN,P011204,25.401,6,53,47
295,PAN,P011221,10.267,-3,16,19
295,PAN,P012712,25.95,15,65,50
295,PAN,P012774,29.235,1,55,54
296,IST,P004888,32.9,9,74,65
296,IST,P006590,21.417,-3,48,51
296,IST,P007200,31.45,9,71,62
296,IST,P009513,16.55,12,34,22
296,IST,P009664,7.9,-10,8,18
296,IST,P009846,19.5,-5,42,47
296,IST,P011078,9.783,-11,11,22
296,IST,P011981,9.617,-9,11,20
296,IST,P012710,20.5,7,40,33
296,IST,P012788,12.917,2,37,35
296,IST,PLHK,17.466,9,34,25
296,ULK,P001932,24.433,-8,43,51
296,ULK,P002968,6.767,-3,5,8
296,ULK,P004004,19.383,0,45,45
296,ULK,P005844,16.932,3,41,38
296,ULK,P006661,28.716,6,69,63
296,ULK,P006961,17.95,-4,33,37
296,ULK,P008962,28.716,-10,59,69
296,ULK,P009849,8.9,-6,8,14
296,ULK,P010560,20.665,5,42,37
296,ULK,P011157,16.25,-1,34,35
296,ULK,P011980,11.283,8,21,13
297,BAS,P003198,10.0,-10,17,27
297,BAS,P004603,8.483,-15,14,29
297,BAS,P004761,4.05,-5,7,12
297,BAS,P007230,33.149,7,86,79
297,BAS,P009048,31.166,6,76,70
297,BAS,P010444,27.683,19,73,54
297,BAS,P011085,11.716,-5,28,33
297,BAS,P011948,29.799,17,76,59
297,BAS,P012201,35.116,8,79,71
297,BAS,P012765,8.833,-2,19,21
297,MAD,P001392,17.35,2,37,35
297,MAD,P003108,23.716,2,55,53
297,MAD,P004887,15.517,-6,34,40
297,MAD,P005791,19.333,3,44,41
297,MAD,P005928,26.367,10,70,60
297,MAD,P006540,21.917,-6,54,60
297,MAD,P009005,19.65,-16,36,52
297,MAD,P010357,25.5,11,68,57
297,MAD,PCVM,13.633,-14,21,35
297,MAD,PTGB,17.017,-6,36,42
298,IST,P004888,20.234,16,42,26
298,IST,P006372,8.55,8,19,11
298,IST,P006590,12.501,26,38,12
298,IST,P007200,19.6,13,45,32
298,IST,P009513,21.233,11,43,32
298,IST,P009664,18.25,25,49,24
298,IST,P009846,21.417,32,63,31
298,IST,P011078,16.518,29,50,21
298,IST,P011981,6.067,10,19,9
298,IST,P012710,21.751,20,51,31
298,IST,P012788,19.017,27,55,28
298,IST,PLHK,14.867,8,26,18
298,RED,P000848,19.283,-14,30,44
298,RED,P002553,23.733,-23,33,56
298,RED,P005099,18.567,-15,31,46
298,RED,P005836,10.167,-19,15,34
298,RED,P006436,25.568,-12,44,56
298,RED,P008966,12.668,-6,18,24
298,RED,P009035,21.534,-24,31,55
298,RED,P011964,11.902,-18,13,31
298,RED,P012044,21.702,-32,24,56
298,RED,P012801,10.534,-17,11,28
298,RED,PJDR,13.368,-19,19,38
298,RED,PLUO,10.984,-26,6,32
299,MCO,P002581,1.334,2,7,5
299,MCO,P004197,11.917,5,32,27
299,MCO,P004790,7.783,5,14,9
299,MCO,P005985,30.151,5,73,68
299,MCO,P009754,24.984,-5,51,56
299,MCO,P010588,20.534,9,57,48
299,MCO,P011196,14.9,0,27,27
299,MCO,P011212,15.95,-3,27,30
299,MCO,P011226,25.884,2,60,58
299,MCO,P011231,19.101,-5,35,40
299,MCO,P012709,6.017,4,16,12
299,MCO,PLCZ,21.45,1,46,45
299,MUN,P001288,26.334,4,68,64
299,MUN,P001557,8.584,-13,6,19
299,MUN,P005478,13.85,-2,29,31
299,MUN,P006543,2.817,-3,5,8
299,MUN,P006760,21.484,3,44,41
299,MUN,P007056,25.434,-5,54,59
299,MUN,P007639,12.067,-4,27,31
299,MUN,P007975,19.65,10,48,38
299,MUN,P008985,17.984,-8,32,40
299,MUN,P010391,19.584,-9,33,42
299,MUN,P011987,32.217,7,79,72
300,MIL,P000796,22.2,-6,52,58
300,MIL,P001518,13.518,-2,23,25
300,MIL,P002812,13.683,1,30,29
300,MIL,P002849,12.734,-9,28,37
300,MIL,P005670,2.733,3,7,4
300,MIL,P006509,19.416,-9,47,56
300,MIL,P006701,13.017,2,25,23
300,MIL,P007032,15.434,-5,28,33
300,MIL,P007201,16.751,-3,34,37
300,MIL,P007831,24.567,-1,58,59
300,MIL,P009960,21.151,-3,42,45
300,MIL,P011224,24.801,2,56,54
300,TEL,P004233,12.916,-5,24,29
300,TEL,P005145,11.001,8,33,25
300,TEL,P009622,23.15,0,50,50
300,TEL,P009783,20.083,10,56,46
300,TEL,P009863,25.9,7,63,56
300,TEL,P011193,18.2,5,44,39
300,TEL,P011199,19.35,7,48,41
300,TEL,P011214,15.766,-2,27,29
300,TEL,P011219,16.015,-3,36,39
300,TEL,P011971,15.099,5,35,30
300,TEL,P012095,13.432,0,29,29
300,TEL,P012744,9.083,-2,15,17
301,BER,P006251,19.633,0,36,36
301,BER,P006819,3.4,0,8,8
301,BER,P006919,17.501,-6,32,38
301,BER,P007550,20.284,-20,35,55
301,BER,P008211,14.584,6,30,24
301,BER,P008780,12.984,4,26,22
301,BER,P008967,26.366,-1,50,51
301,BER,P010791,21.983,-10,34,44
301,BER,P011631,2.901,4,13,9
301,BER,P011934,14.618,1,33,32
301,BER,P012720,28.583,-16,45,61
301,BER,P012721,17.168,-7,33,40
301,PAN,P001926,29.716,18,69,51
301,PAN,P002328,30.983,12,63,51
301,PAN,P003842,24.133,0,52,52
301,PAN,P005161,5.517,2,13,11
301,PAN,P007553,3.967,-5,5,10
301,PAN,P007866,18.55,1,39,38
301,PAN,P007947,9.767,-3,19,22
301,PAN,P011204,11.017,-7,21,28
301,PAN,P011209,1.717,1,3,2
301,PAN,P011221,11.9,14,27,13
301,PAN,P012712,21.467,8,45,37
301,PAN,P012774,31.266,4,64,60
302,MAD,P001392,14.8,0,28,28
302,MAD,P003108,25.383,0,42,42
302,MAD,P003733,14.899,-1,22,23
302,MAD,P004887,19.05,-4,32,36
302,MAD,P005791,20.949,6,32,26
302,MAD,P006540,23.299,8,34,26
302,MAD,P009005,20.8,3,32,29
302,MAD,P010357,19.199,-1,32,33
302,MAD,P010623,19.966,-6,32,38
302,MAD,PTGB,21.65,5,34,29
302,ZAL,P002329,33.819,-1,56,57
302,ZAL,P003210,10.066,-4,15,19
302,ZAL,P005504,11.967,-2,21,23
302,ZAL,P006860,4.75,-2,6,8
302,ZAL,P007109,16.934,-12,16,28
302,ZAL,P007513,27.151,3,44,41
302,ZAL,P010184,9.199,1,10,9
302,ZAL,P010390,20.234,5,35,30
302,ZAL,P011218,29.018,-3,42,45
302,ZAL,P012715,23.117,5,42,37
302,ZAL,P012787,13.75,0,23,23
303,BAS,P004603,14.483,-9,28,37
303,BAS,P004761,35.799,6,87,81
303,BAS,P007230,20.4,16,56,40
303,BAS,P007946,2.117,0,6,6
303,BAS,P008850,6.767,-4,14,18
303,BAS,P009048,33.799,7,80,73
303,BAS,P010444,25.516,13,67,54
303,BAS,P011085,1.6,-2,2,4
303,BAS,P011948,32.065,8,78,70
303,BAS,P012201,23.366,-12,48,60
303,BAS,P012765,4.083,-3,9,12
303,VIR,P001133,22.385,-6,45,51
303,VIR,P001844,25.518,-6,58,64
303,VIR,P002084,17.618,2,46,44
303,VIR,P003048,15.468,7,37,30
303,VIR,P003527,13.517,11,34,23
303,VIR,P004007,11.601,-17,24,41
303,VIR,P004554,11.935,-10,27,37
303,VIR,P006739,14.268,2,31,29
303,VIR,P008847,12.6,-1,27,28
303,VIR,P009549,11.767,1,26,25
303,VIR,P010781,25.119,8,64,56
303,VIR,PBCN,18.219,-11,36,47
304,ASV,P000229,15.049,7,30,23
304,ASV,P002100,23.901,-1,46,47
304,ASV,P003526,14.35,2,26,24
304,ASV,P004194,16.967,12,39,27
304,ASV,P005094,20.35,-2,35,37
304,ASV,P006568,20.55,-5,34,39
304,ASV,P011225,26.199,-4,51,55
304,ASV,P011386,13.801,8,25,17
304,ASV,P012080,25.65,2,50,48
304,ASV,P012731,22.15,3,44,41
304,ASV,PKIR,1.033,-2,0,2
304,BAR,P000925,16.2,5,34,29
304,BAR,P002939,11.616,-7,19,26
304,BAR,P003204,12.366,2,24,22
304,BAR,P003478,18.983,4,36,32
304,BAR,P004866,9.883,5,21,16
304,BAR,P007464,15.766,-14,25,39
304,BAR,P007519,18.033,-6,31,37
304,BAR,P009992,14.9,-3,28,31
304,BAR,P010641,23.766,-9,38,47
304,BAR,P011244,13.717,5,24,19
304,BAR,P012745,20.166,-5,36,41
304,BAR,PLFW,24.599,3,44,41
305,OLY,P001255,26.301,-7,44,51
305,OLY,P003941,4.45,-2,7,9
305,OLY,P006589,20.65,9,42,33
305,OLY,P007853,25.0,6,50,44
305,OLY,P007982,20.532,4,38,34
305,OLY,P008811,30.75,4,61,57
305,OLY,P008829,18.383,-10,26,36
305,OLY,P008855,31.101,0,59,59
305,OLY,P010392,11.216,9,25,16
305,OLY,P010612,27.267,1,54,53
305,OLY,P012878,9.35,1,14,13
305,ULK,P001932,30.067,0,55,55
305,ULK,P002968,21.85,5,38,33
305,ULK,P004004,17.516,0,37,37
305,ULK,P005844,22.3,-10,37,47
305,ULK,P006068,13.967,-8,21,29
305,ULK,P006661,25.483,-17,41,58
305,ULK,P006961,16.849,-5,31,36
305,ULK,P008962,31.033,5,60,55
305,ULK,P009849,18.201,13,37,24
305,ULK,P010560,19.784,3,35,32
305,ULK,P011052,7.2,-2,10,12
305,ULK,P011980,0.75,1,3,2
306,PAM,P000556,19.9,-2,37,39
306,PAM,P005356,16.8,-8,25,33
306,PAM,P006643,16.85,-13,24,37
306,PAM,P007870,15.117,-1,27,28
306,PAM,P010393,19.05,-13,25,38
306,PAM,P010568,17.433,-10,27,37
306,PAM,P010750,16.534,-1,28,29
306,PAM,P011970,18.267,5,37,32
306,PAM,P011982,16.717,2,32,30
306,PAM,P012738,15.716,-12,23,35
306,PAM,P012740,10.966,-12,15,27
306,PAM,P012795,16.65,0,30,30
306,PAR,P000956,6.317,-2,10,12
306,PAR,P003983,19.817,6,37,31
306,PAR,P004172,24.617,10,52,42
306,PAR,P007400,25.567,7,52,45
306,PAR,P008987,23.833,-3,39,42
306,PAR,P009862,30.983,13,64,51
306,PAR,P011051,3.167,-3,6,9
306,PAR,P011192,30.0,19,64,45
306,PAR,P012096,17.083,9,33,24
306,PAR,P012743,18.616,9,38,29
307,BAS,P003198,6.5,-3,15,18
307,BAS,P004603,25.666,-11,56,67
307,BAS,P004761,19.95,-31,32,63
307,BAS,P007230,34.016,-23,69,92
307,BAS,P007946,7.95,1,22,21
307,BAS,P008850,0.767,2,2,0
307,BAS,P009048,31.283,-15,70,85
307,BAS,P010444,14.334,-17,29,46
307,BAS,P011085,16.567,-8,38,46
307,BAS,P011948,27.633,-20,65,85
307,BAS,P012201,8.567,-8,15,23
307,BAS,P012765,6.767,-7,12,19
307,TEL,P005145,14.15,7,32,25
307,TEL,P009622,29.684,32,87,55
307,TEL,P009783,24.916,21,73,52
307,TEL,P009863,30.716,23,90,67
307,TEL,P011193,20.201,10,59,49
307,TEL,P011199,24.983,21,75,54
307,TEL,P011214,15.035,7,38,31
307,TEL,P011971,20.385,7,57,50
307,TEL,P012095,1.917,-1,2,3
307,TEL,P012744,18.018,13,52,39
308,IST,P004888,29.049,5,52,47
308,IST,P006590,21.3,-6,26,32
308,IST,P007200,30.199,0,53,53
308,IST,P009513,15.916,3,32,29
308,IST,P009664,12.499,0,16,16
308,IST,P009846,14.866,-6,19,25
308,IST,P011078,12.583,-3,17,20
308,IST,P011981,16.983,-8,25,33
308,IST,P012710,11.45,2,25,23
308,IST,P012788,9.983,-4,8,12
308,IST,PLHK,25.167,2,47,45
308,VIR,P001133,22.133,-4,38,42
308,VIR,P001844,24.999,-14,38,52
308,VIR,P002084,17.283,-4,23,27
308,VIR,P003048,20.017,2,39,37
308,VIR,P003527,23.517,10,38,28
308,VIR,P004554,12.5,5,23,18
308,VIR,P006739,16.551,9,32,23
308,VIR,P008847,5.35,1,5,4
308,VIR,P009549,7.433,-4,11,15
308,VIR,P010781,31.017,15,53,38
308,VIR,PBCN,19.2,-1,35,36
309,BAS,P003198,3.75,-5,5,10
309,BAS,P004603,17.433,16,46,30
309,BAS,P004761,23.083,-6,49,55
309,BAS,P007230,35.75,14,81,67
309,BAS,P008850,10.3,-5,15,20
309,BAS,P009048,35.333,11,81,70
309,BAS,P010444,23.067,-1,46,47
309,BAS,P011085,21.767,15,48,33
309,BAS,P011948,24.85,20,66,46
309,BAS,P012765,4.667,1,8,7
309,VIR,P001133,22.685,-17,37,54
309,VIR,P001844,23.702,-15,38,53
309,VIR,P002084,16.066,3,35,32
309,VIR,P003048,12.867,-11,21,32
309,VIR,P003527,21.084,5,46,41
309,VIR,P004007,0.483,-1,1,2
309,VIR,P004554,11.767,0,28,28
309,VIR,P006739,17.05,-4,33,37
309,VIR,P008847,10.517,-3,20,23
309,VIR,P009549,23.584,-13,41,54
309,VIR,P010781,20.216,1,45,44
309,VIR,PBCN,19.984,-5,40,45
310,BAS,P003198,13.766,-6,23,29
310,BAS,P004603,13.733,-4,22,26
310,BAS,P004761,28.333,-6,55,61
310,BAS,P007230,26.233,-10,51,61
310,BAS,P008850,7.567,3,14,11
310,BAS,P009048,27.566,-10,53,63
310,BAS,P010444,26.266,-12,52,64
310,BAS,P011085,22.532,-11,46,57
310,BAS,P011948,18.683,-20,28,48
310,BAS,P012765,15.316,-4,26,30
310,MAD,P001392,0.083,-2,0,2
310,MAD,P003108,14.3,8,32,24
310,MAD,P003733,13.134,-5,24,29
310,MAD,P004887,21.134,-4,40,44
310,MAD,P005791,18.6,20,50,30
310,MAD,P005928,18.25,19,46,27
310,MAD,P006540,17.35,21,47,26
310,MAD,P009005,21.867,9,42,33
310,MAD,P010357,28.134,13,70,57
310,MAD,PBMT,11.217,-2,25,27
310,MAD,PCVM,19.668,-2,41,43
310,MAD,PTGB,16.268,5,33,28
311,BAR,P000925,20.633,-9,32,41
311,BAR,P002939,21.899,-5,29,34
311,BAR,P003196,19.366,7,43,36
311,BAR,P003478,18.015,0,39,39
311,BAR,P004866,22.417,-2,36,38
311,BAR,P006435,25.567,0,43,43
311,BAR,P007519,13.999,-2,32,34
311,BAR,P011244,11.666,2,26,24
311,BAR,P012745,28.333,-4,49,53
311,BAR,PLFW,18.1,3,46,43
311,OLY,P003941,5.1,-3,10,13
311,OLY,P006589,17.417,4,31,27
311,OLY,P007853,21.815,-6,35,41
311,OLY,P007982,25.383,-10,53,63
311,OLY,P008811,21.499,6,41,35
311,OLY,P008829,16.049,5,29,24
311,OLY,P008855,18.432,6,31,25
311,OLY,P010392,6.699,7,19,12
311,OLY,P010612,31.414,8,63,55
311,OLY,P011194,15.632,1,32,31
311,OLY,P011983,7.884,-8,17,25
311,OLY,P012878,12.666,0,24,24
312,MCO,P004790,0.183,0,0,0
312,MCO,P005985,40.116,-7,79,86
312,MCO,P008099,4.25,1,8,7
312,MCO,P009754,24.967,-7,53,60
312,MCO,P010588,31.567,-4,66,70
312,MCO,P011196,7.733,-1,13,14
312,MCO,P011212,30.998,-4,62,66
312,MCO,P011226,27.782,-8,52,60
312,MCO,P011231,35.683,4,72,68
312,MCO,PLCZ,21.716,6,50,44
312,ULK,P001932,32.233,1,66,65
312,ULK,P002968,6.883,-6,13,19
312,ULK,P004004,29.416,21,66,45
312,ULK,P005844,9.166,-6,16,22
312,ULK,P006068,4.266,-3,7,10
312,ULK,P006661,12.649,-4,22,26
312,ULK,P006961,14.483,-8,31,39
312,ULK,P008962,38.216,5,79,74
312,ULK,P009849,31.033,6,71,65
312,ULK,P010560,10.833,-3,20,23
312,ULK,P011052,4.6,-1,9,10
312,ULK,P011980,31.217,18,75,57
313,PAN,P001926,32.301,-16,65,81
313,PAN,P002328,24.45,-1,55,56
313,PAN,P003842,33.984,-7,73,80
313,PAN,P005161,2.734,1,4,3
313,PAN,P007866,21.0,-13,46,59
313,PAN,P007947,9.967,6,27,21
313,PAN,P011204,25.234,11,55,44
313,PAN,P011209,4.55,-4,9,13
313,PAN,P011221,4.284,3,12,9
313,PAN,P012712,20.651,9,43,34
313,PAN,P012774,20.85,-9,46,55
313,TEL,P005145,12.733,-1,30,31
313,TEL,P007990,3.283,-7,3,10
313,TEL,P009622,33.866,-3,72,75
313,TEL,P009783,31.416,-2,67,69
313,TEL,P009863,25.916,-4,58,62
313,TEL,P011193,21.816,8,52,44
313,TEL,P011199,23.015,-9,48,57
313,TEL,P011214,15.317,13,42,29
313,TEL,P011219,4.4,3,10,7
313,TEL,P011971,10.916,5,24,19
313,TEL,P012744,17.317,17,49,32
314,BAS,P003198,10.7,6,30,24
314,BAS,P004603,18.634,-13,36,49
314,BAS,P004761,32.7,5,82,77
314,BAS,P007230,31.217,-16,64,80
314,BAS,P007946,1.467,-5,0,5
314,BAS,P008850,11.333,-14,21,35
314,BAS,P009048,34.483,-13,77,90
314,BAS,P010444,21.366,2,54,52
314,BAS,P011085,13.583,9,37,28
314,BAS,P011948,16.417,-20,30,50
314,BAS,P012765,8.1,4,19,15
314,MAD,P003108,27.317,10,67,57
314,MAD,P004887,18.9,-1,44,45
314,MAD,P005791,21.083,12,57,45
314,MAD,P005928,26.916,2,65,63
314,MAD,P006540,17.417,-4,37,41
314,MAD,P009005,16.45,0,42,42
314,MAD,P010357,24.6,18,67,49
314,MAD,PBMT,13.55,-13,28,41
314,MAD,PCVM,16.65,4,44,40
314,MAD,PTGB,17.117,27,54,27
315,BAR,P000925,22.617,2,40,38
315,BAR,P002939,22.267,7,48,41
315,BAR,P003196,17.384,6,37,31
315,BAR,P003478,16.851,7,30,23
315,BAR,P004866,22.9,6,47,41
315,BAR,P006435,18.767,-7,36,43
315,BAR,P007519,19.117,14,40,26
315,BAR,P011244,7.867,-2,12,14
315,BAR,P012745,32.134,10,65,55
315,BAR,PLFW,20.101,-3,30,33
315,OLY,P003941,7.834,-3,11,14
315,OLY,P006589,16.366,-2,32,34
315,OLY,P007853,18.717,-3,31,34
315,OLY,P007982,19.617,2,37,35
315,OLY,P008811,20.55,-10,33,43
315,OLY,P008829,29.433,-15,46,61
315,OLY,P008855,31.217,-8,51,59
315,OLY,P010392,6.85,4,16,12
315,OLY,P010612,17.799,-12,28,40
315,OLY,P011194,20.001,2,35,33
315,OLY,P012878,11.616,5,25,20
316,MCO,P002581,12.666,4,22,18
316,MCO,P005985,28.133,8,72,64
316,MCO,P008099,11.683,-3,31,34
316,MCO,P009754,24.566,18,59,41
316,MCO,P010588,23.483,0,59,59
316,MCO,P011196,5.45,-2,15,17
316,MCO,P011212,28.316,8,62,54
316,MCO,P011226,19.932,-11,41,52
316,MCO,P011231,26.033,-5,50,55
316,MCO,PLCZ,19.733,8,54,46
316,ULK,P001932,24.601,-5,55,60
316,ULK,P002968,3.767,-6,5,11
316,ULK,P004004,19.184,4,41,37
316,ULK,P005844,25.0,0,58,58
316,ULK,P006661,25.117,-1,57,58
316,ULK,P006961,10.3,5,28,23
316,ULK,P008962,29.151,-5,67,72
316,ULK,P009849,27.184,-16,60,76
316,ULK,P010560,15.134,1,29,28
316,ULK,P011980,20.567,-2,40,42
317,PAN,P001926,29.383,25,74,49
317,PAN,P002328,17.684,-6,34,40
317,PAN,P003842,31.933,23,81,58
317,PAN,P005161,27.867,23,74,51
317,PAN,P007866,34.55,12,81,69
317,PAN,P007947,7.4,-6,14,20
317,PAN,P008084,0.333,0,0,0
317,PAN,P011204,14.7,5,36,31
317,PAN,P011209,2.333,1,5,4
317,PAN,P011221,7.917,-5,14,19
317,PAN,P012774,25.9,8,62,54
317,TEL,P005145,11.133,-5,22,27
317,TEL,P007990,16.633,-8,28,36
317,TEL,P009622,29.148,-22,51,73
317,TEL,P009783,35.166,-12,71,83
317,TEL,P011193,24.516,-9,52,61
317,TEL,P011199,19.316,-15,35,50
317,TEL,P011214,19.8,5,44,39
317,TEL,P011219,7.567,-13,11,24
317,TEL,P011971,18.0,-8,38,46
317,TEL,P012744,18.716,7,43,36
318,BAS,P003198,16.984,7,44,37
318,BAS,P004603,12.384,3,33,30
318,BAS,P004761,26.633,-4,69,73
318,BAS,P007230,19.2,-15,39,54
318,BAS,P008850,3.817,4,15,11
318,BAS,P009048,35.984,1,88,87
318,BAS,P010444,27.616,-7,65,72
318,BAS,P011085,29.066,5,68,63
318,BAS,P011948,24.3,-9,59,68
318,BAS,P012765,4.016,-5,10,15
318,MAD,P003108,31.036,-3,75,78
318,MAD,P004887,8.95,-8,24,32
318,MAD,P005791,30.518,10,76,66
318,MAD,P005928,26.985,-4,59,63
318,MAD,P006540,12.267,-7,24,31
318,MAD,P009005,21.918,5,59,54
318,MAD,P010357,30.935,9,78,69
318,MAD,PBMT,6.85,4,23,19
318,MAD,PCVM,13.083,12,45,33
318,MAD,PTGB,17.468,2,47,45
319,BAR,P000925,31.049,1,57,56
319,BAR,P002939,28.183,2,53,51
319,BAR,P003196,13.949,1,25,24
319,BAR,P003478,24.915,3,49,46
319,BAR,P004866,22.916,-1,35,36
319,BAR,P006435,29.866,4,59,55
319,BAR,P007519,8.999,-2,14,16
319,BAR,P009992,3.45,0,7,7
319,BAR,P011244,7.1,0,14,14
319,BAR,P012745,37.898,2,68,66
319,BAR,PLFW,16.665,0,29,29
319,OLY,P006589,5.2,-4,4,8
319,OLY,P007853,26.534,7,53,46
319,OLY,P007982,29.868,1,56,55
319,OLY,P008811,22.801,-12,31,43
319,OLY,P008829,18.484,-9,27,36
319,OLY,P008855,36.119,-7,61,68
319,OLY,P010392,17.001,-4,33,37
319,OLY,P010612,17.017,-5,24,29
319,OLY,P011194,29.868,13,62,49
319,OLY,P012878,22.118,10,49,39
320,MCO,P002581,10.867,-8,21,29
320,MCO,P004790,11.55,0,20,20
320,MCO,P005985,31.966,-2,66,68
320,MCO,P008099,12.75,-6,25,31
320,MCO,P009754,25.733,-3,51,54
320,MCO,P011196,5.15,-2,9,11
320,MCO,P011212,17.667,-7,38,45
320,MCO,P011226,32.984,-15,58,73
320,MCO,P011231,27.35,-11,54,65
320,MCO,PLCZ,23.983,-1,48,49
320,ULK,P001932,27.684,4,57,53
320,ULK,P002968,3.583,-3,6,9
320,ULK,P004004,18.084,6,41,35
320,ULK,P005844,22.35,2,47,45
320,ULK,P006068,6.9,4,18,14
320,ULK,P006661,23.033,1,54,53
320,ULK,P006961,19.966,15,51,36
320,ULK,P008962,32.868,4,69,65
320,ULK,P009849,17.0,6,38,32
320,ULK,P010560,17.566,5,37,32
320,ULK,P011980,10.966,11,27,16
321,PAN,P001926,20.316,1,39,38
321,PAN,P002328,8.95,-10,12,22
321,PAN,P003842,32.649,0,70,70
321,PAN,P005161,28.567,9,61,52
321,PAN,P007553,6.3,-3,10,13
321,PAN,P007866,20.998,-18,35,53
321,PAN,P007947,18.684,8,48,40
321,PAN,P011204,29.665,1,65,64
321,PAN,P011209,0.75,3,3,0
321,PAN,P011221,0.9,-2,0,2
321,PAN,P012774,32.216,1,72,71
321,TEL,P005145,12.5,8,27,19
321,TEL,P007990,11.817,15,29,14
321,TEL,P009622,32.335,1,70,69
321,TEL,P009783,30.935,-6,66,72
321,TEL,P011193,18.851,-15,35,50
321,TEL,P011199,29.851,0,67,67
321,TEL,P011214,14.351,9,30,21
321,TEL,P011219,8.934,-3,14,17
321,TEL,P011971,15.251,7,35,28
321,TEL,P012744,25.185,-6,52,58
323,BAR,P000925,16.333,-13,27,40
323,BAR,P002939,15.766,-13,18,31
323,BAR,P003196,18.749,-18,23,41
323,BAR,P003478,15.466,-22,16,38
323,BAR,P004866,24.55,-12,42,54
323,BAR,P006435,16.082,-1,26,27
323,BAR,P007519,12.15,-22,12,34
323,BAR,P009992,19.683,-18,30,48
323,BAR,P010641,4.917,-3,8,11
323,BAR,P011244,21.115,-25,20,45
323,BAR,P012745,18.884,-9,38,47
323,BAR,PLFW,16.3,-14,30,44
323,OLY,P001255,19.416,8,38,30
323,OLY,P003941,21.782,31,60,29
323,OLY,P007853,27.198,36,70,34
323,OLY,P007982,22.732,28,54,26
323,OLY,P008811,18.216,3,32,29
323,OLY,P008829,22.616,0,43,43
323,OLY,P008855,19.716,19,48,29
323,OLY,P010392,1.817,8,8,0
323,OLY,P010612,20.349,1,37,36
323,OLY,P011194,17.382,34,49,15
323,OLY,P011965,8.766,2,21,19
324,MCO,P002581,5.484,-3,9,12
324,MCO,P004197,14.283,3,23,20
324,MCO,P005985,33.151,11,62,51
324,MCO,P009754,27.167,2,45,43
324,MCO,P011196,19.65,3,30,27
324,MCO,P011212,26.25,6,43,37
324,MCO,P011226,25.718,0,42,42
324,MCO,P011231,24.351,-2,38,40
324,MCO,PLCZ,23.951,-5,33,38
324,ULK,P001932,25.217,-8,39,47
324,ULK,P002968,4.817,2,9,7
324,ULK,P004004,18.734,5,34,29
324,ULK,P005844,32.534,2,53,51
324,ULK,P006661,25.901,-1,44,45
324,ULK,P006961,24.501,-2,34,36
324,ULK,P008962,33.184,-3,52,55
324,ULK,P009849,14.1,-2,18,20
324,ULK,P010560,13.133,-3,17,20
324,ULK,P011980,7.884,-5,10,15
325,PAN,P001926,33.951,12,87,75
325,PAN,P002328,14.618,-5,33,38
325,PAN,P003842,37.618,12,90,78
325,PAN,P005161,26.668,13,69,56
325,PAN,P007866,37.068,6,88,82
325,PAN,P011204,10.567,-10,15,25
325,PAN,P011209,4.718,1,6,5
325,PAN,P011221,2.167,-6,2,8
325,PAN,P012774,32.635,12,85,73
325,TEL,P005145,7.449,-8,16,24
325,TEL,P007990,14.184,-2,30,32
325,TEL,P009622,30.716,-16,58,74
325,TEL,P009783,31.916,-13,66,79
325,TEL,P009863,7.416,-7,16,23
325,TEL,P011193,26.716,8,63,55
325,TEL,P011199,29.349,-7,62,69
325,TEL,P011214,18.283,6,44,38
325,TEL,P011219,6.55,-1,17,18
325,TEL,P011971,13.567,5,31,26
325,TEL,P012744,13.849,0,37,37
327,BAR,P000925,27.617,-7,42,49
327,BAR,P002939,26.401,-10,38,48
327,BAR,P003196,12.384,3,17,14
327,BAR,P003478,22.668,-5,37,42
327,BAR,P004866,19.116,1,24,23
327,BAR,P006435,25.217,6,42,36
327,BAR,P007519,6.717,0,10,10
327,BAR,P011244,9.151,3,17,14
327,BAR,P012745,30.85,-7,42,49
327,BAR,PLFW,19.884,-4,26,30
327,OLY,P001255,28.451,2,44,42
327,OLY,P003941,25.267,4,44,40
327,OLY,P007853,24.234,6,44,38
327,OLY,P007982,27.751,4,48,44
327,OLY,P008811,12.3,-2,15,17
327,OLY,P008829,15.6,-3,18,21
327,OLY,P008855,19.967,7,36,29
327,OLY,P010392,5.833,-4,6,10
327,OLY,P010612,19.517,3,29,26
327,OLY,P011194,18.651,1,27,26
327,OLY,P012878,2.434,2,4,2
328,MCO,P004197,10.5,-6,10,16
328,MCO,P005985,38.369,-4,64,68
328,MCO,P009754,24.835,-8,35,43
328,MCO,P010588,28.635,-5,45,50
328,MCO,P011196,9.15,0,21,21
328,MCO,P011212,32.568,3,65,62
328,MCO,P011226,29.368,14,65,51
328,MCO,P011231,21.734,-2,42,44
328,MCO,PLCZ,29.851,3,48,45
328,ULK,P001932,37.818,1,65,64
328,ULK,P002968,4.467,0,11,11
328,ULK,P004004,27.618,-3,52,55
328,ULK,P005844,23.717,-4,37,41
328,ULK,P006661,34.768,9,65,56
328,ULK,P006961,19.618,0,34,34
328,ULK,P008962,36.485,-6,63,69
328,ULK,P009849,3.567,-6,5,11
328,ULK,P010560,12.217,2,19,17
328,ULK,P011157,9.934,4,16,12
328,ULK,P011980,14.801,8,33,25
329,PAN,P001926,19.633,-2,38,40
329,PAN,P002328,7.084,6,16,10
329,PAN,P003842,35.167,8,74,66
329,PAN,P005161,28.916,5,57,52
329,PAN,P007866,25.699,-3,49,52
329,PAN,P011204,14.001,6,30,24
329,PAN,P011209,12.816,4,26,22
329,PAN,P011221,3.933,3,7,4
329,PAN,P012712,14.418,8,30,22
329,PAN,P012774,38.333,10,78,68
329,TEL,P005145,16.116,4,31,27
329,TEL,P007990,25.95,-1,47,48
329,TEL,P009622,33.701,-7,59,66
329,TEL,P009783,30.767,-5,55,60
329,TEL,P011193,20.251,-13,35,48
329,TEL,P011199,30.316,0,57,57
329,TEL,P011214,14.552,-9,26,35
329,TEL,P011971,12.951,-4,23,27
329,TEL,P012744,15.401,-10,27,37
330,MAD,P001392,6.317,5,19,14
330,MAD,P003108,33.318,2,65,63
330,MAD,P003733,0.184,-3,0,3
330,MAD,P004887,17.501,1,42,41
330,MAD,P005791,22.5,10,45,35
330,MAD,P005928,29.917,11,65,54
330,MAD,P006540,26.15,13,54,41
330,MAD,P009213,10.567,-2,20,22
330,MAD,P010357,22.734,13,54,41
330,MAD,PBMT,5.533,5,19,14
330,MAD,PCVM,14.567,1,30,29
330,MAD,PTGB,10.717,-1,22,23
330,OLY,P001255,21.583,1,46,45
330,OLY,P003941,10.167,2,17,15
330,OLY,P007853,26.1,-11,47,58
330,OLY,P007982,29.9,-5,61,66
330,OLY,P008811,27.35,-9,53,62
330,OLY,P008829,28.667,0,57,57
330,OLY,P008855,26.701,-5,49,54
330,OLY,P010612,19.149,-15,33,48
330,OLY,P011194,7.9,-9,11,20
330,OLY,P012878,2.483,-4,6,10
331,PAN,P001926,17.749,5,33,28
331,PAN,P002328,17.533,6,33,27
331,PAN,P003842,31.783,14,58,44
331,PAN,P005161,22.884,13,43,30
331,PAN,P007866,26.417,9,48,39
331,PAN,P011204,27.034,20,49,29
331,PAN,P011209,8.218,1,11,10
331,PAN,P011221,7.2,-1,12,13
331,PAN,P012712,6.616,-1,12,13
331,PAN,P012774,34.566,14,66,52
331,ULK,P001932,33.7,-13,47,60
331,ULK,P002968,21.216,-1,39,40
331,ULK,P004004,24.915,-4,33,37
331,ULK,P005844,4.334,-2,8,10
331,ULK,P006661,23.951,-24,26,50
331,ULK,P006961,18.433,6,37,31
331,ULK,P008962,31.616,-9,47,56
331,ULK,P009849,9.867,-2,15,17
331,ULK,P010560,9.134,-11,13,24
331,ULK,P011157,3.367,-8,0,8
331,ULK,P011980,19.467,-12,20,32
332,OLY,P001255,17.417,2,37,35
332,OLY,P003941,20.217,12,54,42
332,OLY,P007853,16.417,7,44,37
332,OLY,P007982,26.517,5,64,59
332,OLY,P008811,11.533,-4,15,19
332,OLY,P008829,28.333,-2,59,61
332,OLY,P008855,16.066,-3,28,31
332,OLY,P010392,22.95,2,53,51
332,OLY,P010612,13.9,-8,20,28
332,OLY,P011194,5.917,1,16,15
332,OLY,P011965,6.833,7,18,11
332,OLY,P012878,13.9,-4,27,31
332,ULK,P001932,28.883,4,58,54
332,ULK,P002968,18.917,11,39,28
332,ULK,P004004,15.15,-3,37,40
332,ULK,P005844,5.85,-7,8,15
332,ULK,P006661,26.8,9,58,49
332,ULK,P008962,24.517,7,56,49
332,ULK,P009849,13.2,-12,26,38
332,ULK,P010560,24.3,12,55,43
332,ULK,P011052,6.984,-6,15,21
332,ULK,P011157,15.233,-7,37,44
332,ULK,P011201,3.7,-8,3,11
332,ULK,P011980,16.466,-15,28,43
333,MAD,P001392,4.417,2,11,9
333,MAD,P003108,31.816,-4,68,72
333,MAD,P004887,16.3,1,41,40
333,MAD,P005791,21.433,-13,34,47
333,MAD,P005928,22.167,0,52,52
333,MAD,P006540,28.484,-7,61,68
333,MAD,P009213,7.183,8,27,19
333,MAD,P010357,19.884,-22,25,47
333,MAD,PBMT,10.266,-7,17,24
333,MAD,PCVM,17.45,-15,26,41
333,MAD,PTGB,20.6,-18,38,56
333,PAN,P001926,25.001,9,56,47
333,PAN,P002328,6.667,-5,12,17
333,PAN,P003842,33.217,15,81,66
333,PAN,P005161,18.384,4,43,39
333,PAN,P007866,17.584,5,50,45
333,PAN,P007947,13.267,12,30,18
333,PAN,P011204,32.634,18,81,63
333,PAN,P011209,6.067,2,15,13
333,PAN,P011221,3.167,-2,5,7
333,PAN,P012712,19.817,8,41,33
333,PAN,P012774,24.2,9,61,52
