GAMECODE,CODETEAM,joueur_1,TIME,DELTA_SCORE,OFF,DEF
1,PMT,P002644,0 days 00:25:35,9,54,45
1,PMT,P011066,0 days 00:24:09,15,64,49
1,PMT,P012599,0 days 00:23:38,13,56,43
1,PMT,P002020,0 days 00:23:33,7,50,43
1,PMT,P011944,0 days 00:20:38,10,49,39
1,PMT,P011966,0 days 00:15:51,5,33,28
1,PMT,P012600,0 days 00:15:42,15,41,26
1,PMT,P001686,0 days 00:15:05,10,42,32
1,PMT,P011823,0 days 00:14:25,11,43,32
1,PMT,P011943,0 days 00:13:17,6,34,28
1,PMT,P011947,0 days 00:06:45,-4,14,18
1,PMT,P012601,0 days 00:01:22,3,5,2
1,HAM,P011168,0 days 00:26:04,-24,52,76
1,HAM,P012580,0 days 00:26:00,-11,49,60
1,HAM,P012581,0 days 00:24:05,-13,41,54
1,HAM,P011187,0 days 00:22:50,-11,46,57
1,HAM,P012582,0 days 00:22:06,-14,53,67
1,HAM,P012578,0 days 00:19:12,-4,36,40
1,HAM,P012579,0 days 00:17:35,-12,29,41
1,HAM,P009663,0 days 00:17:10,-9,31,40
1,HAM,P001990,0 days 00:13:56,4,25,21
1,HAM,P012648,0 days 00:08:34,-7,16,23
1,HAM,P012694,0 days 00:02:28,1,7,6
2,LLI,P012586,0 days 00:30:11,3,57,54
2,LLI,P004479,0 days 00:25:06,11,48,37
2,LLI,P009649,0 days 00:23:42,0,40,40
2,LLI,P005247,0 days 00:22:57,15,52,37
2,LLI,P006600,0 days 00:21:22,-7,33,40
2,LLI,P012585,0 days 00:20:24,7,42,35
2,LLI,P009680,0 days 00:20:24,-1,38,39
2,LLI,P012020,0 days 00:18:38,14,43,29
2,LLI,P004773,0 days 00:17:16,-7,27,34
2,VNC,P011928,0 days 00:37:47,-5,65,70
2,VNC,P011909,0 days 00:30:47,11,62,51
2,VNC,P004381,0 days 00:27:10,2,49,47
2,VNC,P012591,0 days 00:24:16,6,46,40
2,VNC,P003759,0 days 00:23:08,8,48,40
2,VNC,P004117,0 days 00:18:09,-15,25,40
2,VNC,P012590,0 days 00:15:49,-10,23,33
2,VNC,P009400,0 days 00:12:44,-22,12,34
2,VNC,P012587,0 days 00:10:10,-10,15,25
3,PRS,P012608,0 days 00:22:44,19,61,42
3,PRS,P005793,0 days 00:22:02,13,61,48
3,PRS,P012611,0 days 00:21:45,12,54,42
3,PRS,P012609,0 days 00:21:15,7,56,49
3,PRS,P012610,0 days 00:20:55,22,55,33
3,PRS,P012640,0 days 00:20:38,12,53,41
3,PRS,P012613,0 days 00:19:04,20,51,31
3,PRS,P004512,0 days 00:16:59,20,49,29
3,PRS,P003481,0 days 00:16:22,7,41,34
3,PRS,P011887,0 days 00:13:39,10,38,28
3,PRS,P010801,0 days 00:03:05,-4,6,10
3,PRS,P011551,0 days 00:01:32,-3,0,3
3,WOL,P011150,0 days 00:32:04,-24,61,85
3,WOL,P002387,0 days 00:29:55,-33,55,88
3,WOL,P005516,0 days 00:24:01,-12,45,57
3,WOL,P008104,0 days 00:23:33,-23,47,70
3,WOL,P006154,0 days 00:23:16,-1,55,56
3,WOL,P012577,0 days 00:21:44,-18,33,51
3,WOL,P012576,0 days 00:20:10,-18,40,58
3,WOL,P002333,0 days 00:13:28,-3,31,34
3,WOL,P004229,0 days 00:05:42,-4,7,11
3,WOL,P006907,0 days 00:03:05,4,10,6
3,WOL,P004645,0 days 00:03:02,-3,6,9
4,HTA,P011991,0 days 00:31:07,24,80,56
4,HTA,P007759,0 days 00:28:09,23,74,51
4,HTA,P010550,0 days 00:27:38,15,71,56
4,HTA,P003533,0 days 00:25:23,25,63,38
4,HTA,P010465,0 days 00:24:44,14,59,45
4,HTA,P006835,0 days 00:24:09,19,63,44
4,HTA,P004846,0 days 00:17:45,10,47,37
4,HTA,P011990,0 days 00:16:26,12,40,28
4,HTA,P012592,0 days 00:01:59,-3,3,6
4,HTA,P012706,0 days 00:01:48,-2,0,2
4,HTA,P012028,0 days 00:00:52,-2,0,2
4,LJU,P005969,0 days 00:33:37,-15,68,83
4,LJU,P009395,0 days 00:29:14,-21,54,75
4,LJU,P003452,0 days 00:26:03,-22,51,73
4,LJU,P012598,0 days 00:24:44,-19,48,67
4,LJU,P012700,0 days 00:21:31,-16,38,54
4,LJU,P008883,0 days 00:19:41,-8,34,42
4,LJU,P011261,0 days 00:16:17,-16,28,44
4,LJU,P007066,0 days 00:13:01,-8,21,29
4,LJU,P010594,0 days 00:11:50,-2,22,24
4,LJU,P002561,0 days 00:02:51,-4,0,4
4,LJU,P010771,0 days 00:01:11,-4,1,5
5,JOV,P011247,0 days 00:24:54,-4,36,40
5,JOV,P002361,0 days 00:23:12,0,37,37
5,JOV,P002507,0 days 00:22:52,3,34,31
5,JOV,P005094,0 days 00:22:07,4,32,28
5,JOV,P011248,0 days 00:18:02,7,30,23
5,JOV,PJUG,0 days 00:17:49,-9,25,34
5,JOV,P006771,0 days 00:16:49,-2,20,22
5,JOV,P012076,0 days 00:15:58,0,28,28
5,JOV,P010166,0 days 00:12:53,12,25,13
5,JOV,P010458,0 days 00:12:39,-14,17,31
5,JOV,P010161,0 days 00:12:32,-4,24,28
5,JOV,P010709,0 days 00:00:13,2,2,0
5,BES,P003783,0 days 00:33:34,9,54,45
5,BES,P007917,0 days 00:30:18,-3,47,50
5,BES,P007914,0 days 00:30:10,8,52,44
5,BES,P011936,0 days 00:28:07,2,42,40
5,BES,P009582,0 days 00:26:33,-3,43,46
5,BES,P012647,0 days 00:21:48,-5,27,32
5,BES,P011357,0 days 00:10:59,-1,21,22
5,BES,P011379,0 days 00:10:23,4,17,13
5,BES,P008945,0 days 00:08:08,-6,12,18
6,BOU,P010449,0 days 00:24:39,13,63,50
6,BOU,P012628,0 days 00:23:03,6,52,46
6,BOU,P010431,0 days 00:21:28,3,52,49
6,BOU,P012619,0 days 00:21:27,8,44,36
6,BOU,P010718,0 days 00:20:36,16,47,31
6,BOU,P004525,0 days 00:20:10,19,46,27
6,BOU,P011836,0 days 00:19:50,-3,44,47
6,BOU,P011837,0 days 00:18:33,8,46,38
6,BOU,P010450,0 days 00:17:10,5,33,28
6,BOU,P011161,0 days 00:13:04,5,23,18
6,WRO,P009896,0 days 00:33:02,-10,63,73
6,WRO,P001694,0 days 00:29:44,-1,58,59
6,WRO,P012735,0 days 00:28:29,-14,50,64
6,WRO,P005531,0 days 00:27:55,-5,60,65
6,WRO,P012699,0 days 00:21:27,-6,41,47
6,WRO,P012736,0 days 00:21:21,-11,38,49
6,WRO,P011900,0 days 00:21:10,-14,37,51
6,WRO,P003034,0 days 00:15:10,-18,21,39
6,WRO,P012308,0 days 00:01:42,-1,2,3
7,CLU,P004862,0 days 00:29:09,2,59,57
7,CLU,P010569,0 days 00:28:35,4,57,53
7,CLU,P012621,0 days 00:28:27,15,64,49
7,CLU,P011801,0 days 00:23:29,9,48,39
7,CLU,P011797,0 days 00:23:18,9,44,35
7,CLU,P005714,0 days 00:19:00,11,39,28
7,CLU,P005113,0 days 00:16:30,10,40,30
7,CLU,P005373,0 days 00:15:55,-7,24,31
7,CLU,P012698,0 days 00:14:06,-5,25,30
7,CLU,P012620,0 days 00:01:31,-3,0,3
7,TTK,P011834,0 days 00:30:44,2,56,54
7,TTK,P005000,0 days 00:30:30,-14,53,67
7,TTK,P011925,0 days 00:27:38,-2,48,50
7,TTK,P012056,0 days 00:21:53,-2,42,44
7,TTK,P012697,0 days 00:19:55,3,45,42
7,TTK,P006693,0 days 00:16:27,-8,25,33
7,TTK,P011239,0 days 00:14:28,-16,16,32
7,TTK,P004801,0 days 00:12:19,-7,23,30
7,TTK,P005685,0 days 00:12:09,9,26,17
7,TTK,P009845,0 days 00:11:46,-5,21,26
7,TTK,P000497,0 days 00:02:11,-5,0,5
8,BUD,P012606,0 days 00:24:34,10,48,38
8,BUD,P004945,0 days 00:24:31,14,50,36
8,BUD,P011935,0 days 00:23:07,-4,39,43
8,BUD,P002740,0 days 00:22:48,9,44,35
8,BUD,P010432,0 days 00:20:52,10,44,34
8,BUD,P010248,0 days 00:18:07,4,32,28
8,BUD,P007398,0 days 00:17:12,2,32,30
8,BUD,P012630,0 days 00:15:29,-3,26,29
8,BUD,P012605,0 days 00:15:26,1,28,27
8,BUD,P006566,0 days 00:09:05,17,25,8
8,BUD,P004397,0 days 00:04:33,-1,7,8
8,BUD,P006561,0 days 00:04:16,-4,5,9
8,LKB,P007029,0 days 00:32:22,-15,47,62
8,LKB,P002012,0 days 00:31:46,-13,52,65
8,LKB,P004664,0 days 00:28:43,-11,43,54
8,LKB,P005521,0 days 00:22:46,-18,34,52
8,LKB,P010461,0 days 00:21:47,-7,30,37
8,LKB,PLXI,0 days 00:21:40,14,48,34
8,LKB,P006230,0 days 00:17:57,-4,35,39
8,LKB,P008856,0 days 00:14:45,-3,23,26
8,LKB,P012583,0 days 00:08:14,2,13,11
9,ARI,P012708,0 days 00:31:00,-6,52,58
9,ARI,P003240,0 days 00:28:39,-14,44,58
9,ARI,P012716,0 days 00:25:03,-14,41,55
9,ARI,P012615,0 days 00:23:38,-9,37,46
9,ARI,P004292,0 days 00:22:13,-4,41,45
9,ARI,P012702,0 days 00:17:51,-11,27,38
9,ARI,P012722,0 days 00:17:11,-8,28,36
9,ARI,P002867,0 days 00:12:25,-10,19,29
9,ARI,P012707,0 days 00:11:24,-1,25,26
9,ARI,P012717,0 days 00:09:30,-5,14,19
9,ARI,P012616,0 days 00:01:06,2,2,0
9,CAN,P003425,0 days 00:26:17,30,62,32
9,CAN,P010385,0 days 00:22:16,21,46,25
9,CAN,P010452,0 days 00:20:03,19,46,27
9,CAN,P005005,0 days 00:19:35,14,48,34
9,CAN,P003637,0 days 00:19:17,13,47,34
9,CAN,P006588,0 days 00:19:01,3,40,37
9,CAN,P008121,0 days 00:16:30,-2,24,26
9,CAN,P007644,0 days 00:16:17,-6,30,36
9,CAN,P007560,0 days 00:15:34,7,28,21
9,CAN,P001607,0 days 00:13:43,-14,20,34
9,CAN,P004160,0 days 00:09:04,0,17,17
9,CAN,P010484,0 days 00:02:23,-5,2,7
10,ULM,P010582,0 days 00:28:58,5,56,51
10,ULM,P012603,0 days 00:28:18,13,59,46
10,ULM,P012604,0 days 00:26:23,6,48,42
10,ULM,P005422,0 days 00:23:28,2,44,42
10,ULM,P010106,0 days 00:22:25,-7,38,45
10,ULM,P012629,0 days 00:22:05,9,47,38
10,ULM,P012703,0 days 00:17:35,17,42,25
10,ULM,P011457,0 days 00:13:07,1,25,24
10,ULM,P011391,0 days 00:10:00,9,24,15
10,ULM,P010726,0 days 00:04:04,0,9,9
10,ULM,P007952,0 days 00:03:37,-5,8,13
10,TRN,P005059,0 days 00:30:31,-2,56,58
10,TRN,P005738,0 days 00:26:30,-7,47,54
10,TRN,P012595,0 days 00:24:26,2,49,47
10,TRN,P012597,0 days 00:23:50,-10,41,51
10,TRN,P009903,0 days 00:23:44,-2,43,45
10,TRN,P012596,0 days 00:16:16,-8,27,35
10,TRN,P012593,0 days 00:15:44,-2,24,26
10,TRN,P006382,0 days 00:13:55,-12,23,35
10,TRN,P001479,0 days 00:13:22,-3,23,26
10,TRN,P012594,0 days 00:11:42,-6,17,23
11,BES,P011936,0 days 00:30:52,9,61,52
11,BES,P003783,0 days 00:28:21,12,66,54
11,BES,P007914,0 days 00:27:56,17,68,51
11,BES,P009582,0 days 00:26:47,2,52,50
11,BES,P012622,0 days 00:24:20,11,52,41
11,BES,P012647,0 days 00:20:07,10,46,36
11,BES,P011357,0 days 00:17:58,13,41,28
11,BES,P007917,0 days 00:16:50,23,52,29
11,BES,P011379,0 days 00:04:41,6,13,7
11,BES,P012233,0 days 00:01:27,5,6,1
11,BES,P012624,0 days 00:00:41,2,3,1
11,PMT,P001686,0 days 00:23:41,-5,44,49
11,PMT,P011823,0 days 00:22:58,-5,37,42
11,PMT,P011944,0 days 00:21:53,8,42,34
11,PMT,P009559,0 days 00:20:41,-19,34,53
11,PMT,P011066,0 days 00:19:30,-3,32,35
11,PMT,P011966,0 days 00:17:21,-15,35,50
11,PMT,P002644,0 days 00:17:02,-17,33,50
11,PMT,P011947,0 days 00:16:18,-14,28,42
11,PMT,P012599,0 days 00:15:27,-4,23,27
11,PMT,P012600,0 days 00:13:54,-21,25,46
11,PMT,P011943,0 days 00:11:15,-15,17,32
12,LJU,P005969,0 days 00:40:37,2,84,82
12,LJU,P012598,0 days 00:36:42,-5,74,79
12,LJU,P009395,0 days 00:35:13,0,71,71
12,LJU,P003452,0 days 00:33:23,-7,66,73
12,LJU,P008883,0 days 00:30:48,3,61,58
12,LJU,P012700,0 days 00:18:15,-3,35,38
12,LJU,P007066,0 days 00:15:03,-2,22,24
12,LJU,P002561,0 days 00:06:24,8,12,4
12,LJU,P010594,0 days 00:04:26,6,10,4
12,LJU,P011261,0 days 00:04:08,-7,0,7
12,LJU,P001235,0 days 00:00:01,0,0,0
12,JOV,P010458,0 days 00:36:45,5,76,71
12,JOV,P005094,0 days 00:34:08,7,68,61
12,JOV,P002361,0 days 00:33:41,3,68,65
12,JOV,P011247,0 days 00:32:54,9,66,57
12,JOV,P012076,0 days 00:23:14,3,48,45
12,JOV,P002507,0 days 00:21:47,-2,40,42
12,JOV,PJUG,0 days 00:21:25,-7,41,48
12,JOV,P006771,0 days 00:08:26,-4,14,18
12,JOV,P010166,0 days 00:08:14,-4,12,16
12,JOV,P010161,0 days 00:02:22,-1,6,7
12,JOV,P010709,0 days 00:02:04,-4,1,5
13,HTA,P004267,0 days 00:36:07,17,85,68
13,HTA,P007759,0 days 00:35:18,7,77,70
13,HTA,P004846,0 days 00:34:07,11,77,66
13,HTA,P010550,0 days 00:31:23,9,73,64
13,HTA,P011973,0 days 00:29:24,11,64,53
13,HTA,P003533,0 days 00:15:28,4,35,31
13,HTA,P011990,0 days 00:11:31,-4,24,28
13,HTA,P012706,0 days 00:04:43,-4,10,14
13,HTA,P012592,0 days 00:01:59,-6,0,6
13,WOL,P011150,0 days 00:30:48,-3,66,69
13,WOL,P006546,0 days 00:30:22,-4,60,64
13,WOL,P012576,0 days 00:25:54,1,53,52
13,WOL,P002387,0 days 00:23:26,-1,47,48
13,WOL,P005516,0 days 00:21:30,-3,43,46
13,WOL,P012577,0 days 00:20:08,-8,39,47
13,WOL,P003212,0 days 00:19:30,-8,37,45
13,WOL,P004229,0 days 00:12:53,-11,22,33
13,WOL,P006907,0 days 00:07:11,-8,13,21
13,WOL,P006154,0 days 00:04:58,-1,10,11
13,WOL,PLCT,0 days 00:03:20,1,10,9
14,VNC,P012591,0 days 00:34:55,-2,66,68
14,VNC,P011928,0 days 00:33:29,3,73,70
14,VNC,P003759,0 days 00:33:10,2,65,63
14,VNC,P000968,0 days 00:29:16,-3,62,65
14,VNC,P011909,0 days 00:25:41,2,53,51
14,VNC,P009400,0 days 00:18:43,-12,29,41
14,VNC,P004117,0 days 00:13:21,-17,12,29
14,VNC,P012590,0 days 00:11:07,-5,13,18
14,VNC,P012587,0 days 00:00:18,2,2,0
14,PRS,P012608,0 days 00:27:29,1,54,53
14,PRS,P012610,0 days 00:25:33,3,55,52
14,PRS,P012613,0 days 00:25:17,9,48,39
14,PRS,P012609,0 days 00:25:05,14,58,44
14,PRS,P012611,0 days 00:21:33,3,48,45
14,PRS,P012640,0 days 00:21:30,1,41,40
14,PRS,P005793,0 days 00:21:25,-4,43,47
14,PRS,P003481,0 days 00:13:33,6,29,23
14,PRS,P004512,0 days 00:13:11,-2,24,26
14,PRS,P011887,0 days 00:05:24,-1,5,6
15,HAM,P011168,0 days 00:30:12,-16,72,88
15,HAM,P011187,0 days 00:27:05,5,63,58
15,HAM,P012580,0 days 00:24:36,-6,56,62
15,HAM,P009663,0 days 00:23:21,-2,56,58
15,HAM,P012582,0 days 00:22:59,-2,57,59
15,HAM,P012579,0 days 00:19:06,-3,49,52
15,HAM,P012581,0 days 00:15:46,-5,37,42
15,HAM,P012648,0 days 00:14:24,-4,32,36
15,HAM,P012694,0 days 00:10:28,-8,22,30
15,HAM,P012578,0 days 00:09:46,7,22,15
15,HAM,P010070,0 days 00:01:09,0,0,0
15,HAM,P012695,0 days 00:01:08,4,4,0
15,LLI,P012585,0 days 00:33:40,13,93,80
15,LLI,P006600,0 days 00:30:46,4,77,73
15,LLI,P009649,0 days 00:28:31,4,71,67
15,LLI,P012586,0 days 00:27:09,5,71,66
15,LLI,P009680,0 days 00:23:01,11,63,52
15,LLI,P005247,0 days 00:20:07,-1,48,49
15,LLI,P004773,0 days 00:14:46,-3,28,31
15,LLI,P004479,0 days 00:12:46,-5,26,31
15,LLI,P012020,0 days 00:09:14,2,23,21
16,TRN,P012595,0 days 00:30:12,1,59,58
16,TRN,P005738,0 days 00:28:35,-11,55,66
16,TRN,P009903,0 days 00:27:09,-3,53,56
16,TRN,P005059,0 days 00:26:35,-7,49,56
16,TRN,P012593,0 days 00:20:17,-6,38,44
16,TRN,P012594,0 days 00:17:34,-7,27,34
16,TRN,P006382,0 days 00:15:05,-3,20,23
16,TRN,P012596,0 days 00:12:51,-4,19,23
16,TRN,P001479,0 days 00:11:25,4,17,13
16,TRN,P012597,0 days 00:10:17,1,23,22
16,BOU,P011836,0 days 00:30:43,20,66,46
16,BOU,P012628,0 days 00:26:00,18,65,47
16,BOU,P010449,0 days 00:25:19,15,50,35
16,BOU,P004525,0 days 00:21:00,0,33,33
16,BOU,P010450,0 days 00:19:19,1,30,29
16,BOU,P011837,0 days 00:19:01,6,48,42
16,BOU,P010431,0 days 00:18:50,4,40,36
16,BOU,P010718,0 days 00:17:26,-12,25,37
16,BOU,P011161,0 days 00:14:41,-8,29,37
16,BOU,P012619,0 days 00:07:41,-9,9,18
17,CAN,P005005,0 days 00:25:14,16,75,59
17,CAN,P007560,0 days 00:24:27,13,65,52
17,CAN,P006588,0 days 00:21:49,20,67,47
17,CAN,P001607,0 days 00:20:39,3,57,54
17,CAN,P003425,0 days 00:18:11,22,48,26
17,CAN,P009864,0 days 00:16:17,14,48,34
17,CAN,P010452,0 days 00:15:18,2,36,34
17,CAN,P008121,0 days 00:14:44,17,45,28
17,CAN,P010385,0 days 00:13:49,14,34,20
17,CAN,P003637,0 days 00:13:34,18,37,19
17,CAN,P007644,0 days 00:09:47,2,27,25
17,CAN,P010484,0 days 00:06:11,4,16,12
17,ULM,P012603,0 days 00:30:50,-19,66,85
17,ULM,P005422,0 days 00:26:08,-6,64,70
17,ULM,P012703,0 days 00:25:04,-15,52,67
17,ULM,P012629,0 days 00:22:28,-19,46,65
17,ULM,P010582,0 days 00:22:24,-18,44,62
17,ULM,P010106,0 days 00:19:06,-21,33,54
17,ULM,P007952,0 days 00:17:54,-16,34,50
17,ULM,P011391,0 days 00:17:17,-13,38,51
17,ULM,P011457,0 days 00:07:29,-9,13,22
17,ULM,P010726,0 days 00:06:31,-9,10,19
17,ULM,P004744,0 days 00:04:49,0,10,10
18,LKB,P007029,0 days 00:33:45,20,80,60
18,LKB,P002012,0 days 00:32:36,10,73,63
18,LKB,PLXI,0 days 00:27:00,-2,50,52
18,LKB,P004664,0 days 00:22:07,8,50,42
18,LKB,P008856,0 days 00:19:24,3,39,36
18,LKB,P005521,0 days 00:18:36,2,35,33
18,LKB,P006230,0 days 00:17:19,10,37,27
18,LKB,P010461,0 days 00:16:19,12,38,26
18,LKB,P012583,0 days 00:09:50,-13,12,25
18,LKB,P006901,0 days 00:01:34,2,4,2
18,LKB,P010190,0 days 00:01:29,-2,2,4
18,LKB,P011329,0 days 00:00:01,0,0,0
18,ARI,P012708,0 days 00:29:29,-13,60,73
18,ARI,P004292,0 days 00:27:01,9,56,47
18,ARI,P003240,0 days 00:25:12,-17,45,62
18,ARI,P012716,0 days 00:24:34,-3,43,46
18,ARI,P012702,0 days 00:22:33,-2,48,50
18,ARI,P012707,0 days 00:17:25,-10,29,39
18,ARI,P012615,0 days 00:16:27,-3,27,30
18,ARI,P012722,0 days 00:13:29,-4,22,26
18,ARI,P002867,0 days 00:13:10,4,22,18
18,ARI,P012717,0 days 00:10:40,-11,18,29
19,TTK,P011925,0 days 00:30:52,-1,56,57
19,TTK,P011834,0 days 00:30:04,6,61,55
19,TTK,P011239,0 days 00:29:13,-4,52,56
19,TTK,P012697,0 days 00:25:16,-4,47,51
19,TTK,P012056,0 days 00:22:44,0,46,46
19,TTK,P005000,0 days 00:22:30,3,46,43
19,TTK,P006693,0 days 00:14:44,6,32,26
19,TTK,P004801,0 days 00:13:50,-2,28,30
19,TTK,P005685,0 days 00:10:47,6,27,21
19,BUD,P004945,0 days 00:27:29,-5,50,55
19,BUD,P012606,0 days 00:25:32,-1,49,50
19,BUD,P010432,0 days 00:23:12,0,47,47
19,BUD,P012630,0 days 00:19:01,8,42,34
19,BUD,P011935,0 days 00:18:17,-4,35,39
19,BUD,P006561,0 days 00:17:44,2,34,32
19,BUD,P007398,0 days 00:17:09,-2,33,35
19,BUD,P002740,0 days 00:16:52,-5,29,34
19,BUD,P010248,0 days 00:15:08,-1,27,28
19,BUD,P012605,0 days 00:14:28,-1,28,29
19,BUD,P009214,0 days 00:05:08,-1,11,12
20,WRO,P001694,0 days 00:35:27,-9,59,68
20,WRO,P009896,0 days 00:30:45,4,54,50
20,WRO,P005531,0 days 00:30:42,-5,55,60
20,WRO,P012699,0 days 00:27:32,1,45,44
20,WRO,P012735,0 days 00:22:34,12,47,35
20,WRO,P011900,0 days 00:18:37,-9,29,38
20,WRO,P012736,0 days 00:13:42,-2,18,20
20,WRO,P003034,0 days 00:13:16,-3,19,22
20,WRO,P012749,0 days 00:07:25,-4,9,13
20,CLU,P004862,0 days 00:31:25,8,60,52
20,CLU,P012621,0 days 00:27:54,7,57,50
20,CLU,P011797,0 days 00:25:36,5,48,43
20,CLU,P005113,0 days 00:23:24,12,51,39
20,CLU,P012698,0 days 00:21:58,-2,32,34
20,CLU,P010569,0 days 00:19:51,-2,36,38
20,CLU,P005714,0 days 00:19:47,1,30,29
20,CLU,P005373,0 days 00:13:23,-5,17,22
20,CLU,P011801,0 days 00:12:41,-3,17,20
20,CLU,P012620,0 days 00:04:01,-6,2,8
21,PMT,P011066,0 days 00:28:04,-12,64,76
21,PMT,P002644,0 days 00:25:07,-11,52,63
21,PMT,P011823,0 days 00:23:55,2,55,53
21,PMT,P011944,0 days 00:22:30,2,52,50
21,PMT,P011943,0 days 00:21:11,-15,40,55
21,PMT,P012600,0 days 00:19:08,4,48,44
21,PMT,P009559,0 days 00:17:58,-13,40,53
21,PMT,P001686,0 days 00:17:13,-2,36,38
21,PMT,P011966,0 days 00:15:50,-9,31,40
21,PMT,P002020,0 days 00:06:48,-4,15,19
21,PMT,P011946,0 days 00:02:16,-2,2,4
21,LLI,P012586,0 days 00:33:09,23,91,68
21,LLI,P006600,0 days 00:31:24,11,76,65
21,LLI,P009649,0 days 00:29:26,26,85,59
21,LLI,P012585,0 days 00:29:16,23,81,58
21,LLI,P009672,0 days 00:22:03,0,52,52
21,LLI,P009680,0 days 00:20:41,10,51,41
21,LLI,P004773,0 days 00:10:44,-11,18,29
21,LLI,P005247,0 days 00:10:34,-14,14,28
21,LLI,P012020,0 days 00:07:12,3,21,18
21,LLI,P004479,0 days 00:05:31,-11,6,17
22,HAM,P011187,0 days 00:30:14,-17,55,72
22,HAM,P012580,0 days 00:27:59,-31,38,69
22,HAM,P011168,0 days 00:23:54,-17,48,65
22,HAM,P012582,0 days 00:22:46,-10,43,53
22,HAM,P009663,0 days 00:19:35,-32,29,61
22,HAM,P012579,0 days 00:17:26,-15,37,52
22,HAM,P012648,0 days 00:16:22,-4,36,40
22,HAM,P012578,0 days 00:12:20,-16,20,36
22,HAM,P010070,0 days 00:11:38,-18,20,38
22,HAM,P012581,0 days 00:11:23,-10,13,23
22,HAM,P001990,0 days 00:06:23,-10,6,16
22,PRS,P012610,0 days 00:22:37,34,65,31
22,PRS,P012613,0 days 00:22:37,34,65,31
22,PRS,P012608,0 days 00:21:41,34,62,28
22,PRS,P012640,0 days 00:20:39,-1,49,50
22,PRS,P012611,0 days 00:19:20,33,52,19
22,PRS,P012609,0 days 00:18:24,4,48,44
22,PRS,P009556,0 days 00:18:19,2,43,41
22,PRS,P004512,0 days 00:16:27,29,46,17
22,PRS,P005793,0 days 00:16:04,-1,37,38
22,PRS,P003481,0 days 00:15:02,6,40,34
22,PRS,P010801,0 days 00:04:46,4,10,6
22,PRS,P012612,0 days 00:04:04,2,8,6
23,VNC,P012591,0 days 00:29:56,-17,59,76
23,VNC,P003759,0 days 00:27:02,-1,61,62
23,VNC,P004381,0 days 00:26:04,-17,50,67
23,VNC,P011928,0 days 00:25:04,-19,44,63
23,VNC,P011909,0 days 00:22:55,-11,38,49
23,VNC,P012590,0 days 00:22:54,-9,49,58
23,VNC,P008052,0 days 00:20:22,-11,44,55
23,VNC,P000968,0 days 00:11:12,5,29,24
23,VNC,P009400,0 days 00:09:36,1,22,21
23,VNC,P004117,0 days 00:04:55,-1,9,10
23,HTA,P010465,0 days 00:31:25,14,71,57
23,HTA,P007759,0 days 00:30:44,17,79,62
23,HTA,P010550,0 days 00:24:29,1,56,55
23,HTA,P006835,0 days 00:22:50,21,63,42
23,HTA,P004846,0 days 00:22:32,10,60,50
23,HTA,P011991,0 days 00:20:59,-5,39,44
23,HTA,P011973,0 days 00:20:24,11,46,35
23,HTA,P004267,0 days 00:14:20,12,42,30
23,HTA,P003533,0 days 00:12:17,-1,29,30
24,JOV,P010458,0 days 00:34:34,17,84,67
24,JOV,P002361,0 days 00:33:16,12,72,60
24,JOV,P010161,0 days 00:28:50,6,70,64
24,JOV,P002507,0 days 00:28:02,-8,59,67
24,JOV,P005094,0 days 00:24:59,18,64,46
24,JOV,P006771,0 days 00:24:09,-9,56,65
24,JOV,PJUG,0 days 00:19:22,6,50,44
24,JOV,P012076,0 days 00:16:35,16,44,28
24,JOV,P010709,0 days 00:08:21,-6,16,22
24,JOV,P010166,0 days 00:06:29,-8,16,24
24,JOV,P010708,0 days 00:00:23,1,4,3
24,WOL,P011150,0 days 00:34:30,-5,81,86
24,WOL,P005516,0 days 00:30:23,2,68,66
24,WOL,P002387,0 days 00:30:05,8,68,60
24,WOL,P012576,0 days 00:29:45,10,70,60
24,WOL,P012577,0 days 00:29:44,-15,61,76
24,WOL,P003212,0 days 00:26:57,-13,58,71
24,WOL,P004645,0 days 00:20:10,-16,41,57
24,WOL,P002333,0 days 00:14:52,-16,25,41
24,WOL,P006154,0 days 00:08:34,0,18,18
25,BES,P011936,0 days 00:33:09,9,62,53
25,BES,P012622,0 days 00:27:00,11,47,36
25,BES,P008945,0 days 00:25:48,7,42,35
25,BES,P012647,0 days 00:22:41,-6,30,36
25,BES,P007914,0 days 00:20:23,-2,35,37
25,BES,P003783,0 days 00:19:06,2,41,39
25,BES,P009582,0 days 00:17:33,-7,35,42
25,BES,P007917,0 days 00:17:01,8,30,22
25,BES,P011379,0 days 00:10:26,11,25,14
25,BES,P011357,0 days 00:06:53,2,18,16
25,LJU,P012598,0 days 00:33:22,-7,60,67
25,LJU,P012700,0 days 00:32:49,-4,57,61
25,LJU,P005969,0 days 00:28:28,-10,43,53
25,LJU,P008883,0 days 00:25:47,-2,50,52
25,LJU,P007066,0 days 00:23:42,-8,32,40
25,LJU,P009395,0 days 00:22:03,-3,39,42
25,LJU,P010594,0 days 00:20:20,4,36,32
25,LJU,P003452,0 days 00:13:29,-5,13,18
26,BOU,P012628,0 days 00:28:41,-5,63,68
26,BOU,P010449,0 days 00:28:04,12,72,60
26,BOU,P011161,0 days 00:20:31,10,48,38
26,BOU,P011836,0 days 00:20:23,13,55,42
26,BOU,P010431,0 days 00:19:59,1,48,47
26,BOU,P011837,0 days 00:17:22,7,40,33
26,BOU,P010450,0 days 00:16:11,-9,28,37
26,BOU,P010718,0 days 00:15:54,-1,38,39
26,BOU,P004525,0 days 00:15:40,-1,31,32
26,BOU,P000498,0 days 00:12:13,-8,23,31
26,BOU,P012755,0 days 00:05:02,1,14,13
26,CLU,P011797,0 days 00:30:52,0,68,68
26,CLU,P011801,0 days 00:28:10,0,69,69
26,CLU,P010569,0 days 00:26:32,-9,59,68
26,CLU,P004862,0 days 00:25:36,-1,57,58
26,CLU,P012621,0 days 00:23:00,-6,46,52
26,CLU,P012698,0 days 00:20:19,-1,45,46
26,CLU,P005113,0 days 00:19:51,-8,37,45
26,CLU,P005373,0 days 00:19:14,3,42,39
26,CLU,P012620,0 days 00:06:26,2,17,15
27,BUD,P010432,0 days 00:25:04,16,61,45
27,BUD,P002740,0 days 00:22:52,7,55,48
27,BUD,P011935,0 days 00:22:06,10,54,44
27,BUD,P012606,0 days 00:21:24,2,46,44
27,BUD,P007398,0 days 00:20:31,16,64,48
27,BUD,P004945,0 days 00:20:11,1,44,43
27,BUD,P012605,0 days 00:18:36,12,57,45
27,BUD,P009214,0 days 00:16:41,3,47,44
27,BUD,P006561,0 days 00:14:56,-2,42,44
27,BUD,P012630,0 days 00:12:57,7,37,30
27,BUD,P006566,0 days 00:04:42,-2,8,10
27,WRO,P001694,0 days 00:28:28,-11,61,72
27,WRO,P005531,0 days 00:28:00,-13,59,72
27,WRO,P011165,0 days 00:23:42,-6,56,62
27,WRO,P012699,0 days 00:23:18,5,62,57
27,WRO,P009896,0 days 00:21:28,-10,49,59
27,WRO,P011900,0 days 00:20:42,-10,40,50
27,WRO,P003034,0 days 00:18:32,-4,40,44
27,WRO,P012749,0 days 00:12:48,-7,28,35
27,WRO,P011902,0 days 00:11:32,-3,28,31
27,WRO,P012736,0 days 00:11:30,-11,22,33
28,ARI,P012615,0 days 00:32:15,15,62,47
28,ARI,P004292,0 days 00:28:29,-5,52,57
28,ARI,P012708,0 days 00:25:47,-3,44,47
28,ARI,P012716,0 days 00:25:24,4,45,41
28,ARI,P012707,0 days 00:22:07,8,32,24
28,ARI,P012702,0 days 00:19:55,3,39,36
28,ARI,P002867,0 days 00:19:38,-1,31,32
28,ARI,P012722,0 days 00:18:40,2,29,27
28,ARI,P010387,0 days 00:07:45,-13,6,19
28,TTK,P012056,0 days 00:33:09,1,59,58
28,TTK,P011925,0 days 00:32:59,-9,52,61
28,TTK,P005000,0 days 00:25:50,-4,40,44
28,TTK,P006693,0 days 00:24:50,-6,40,46
28,TTK,P011239,0 days 00:23:38,1,47,46
28,TTK,P011834,0 days 00:23:26,1,37,36
28,TTK,P012697,0 days 00:21:10,2,31,29
28,TTK,P005685,0 days 00:06:59,3,12,9
28,TTK,P000497,0 days 00:05:23,5,10,5
28,TTK,P009845,0 days 00:02:36,-4,2,6
29,ULM,P012703,0 days 00:29:22,23,73,50
29,ULM,P012629,0 days 00:25:43,24,66,42
29,ULM,P012604,0 days 00:25:10,26,70,44
29,ULM,P012603,0 days 00:20:26,18,53,35
29,ULM,P011457,0 days 00:19:34,7,46,39
29,ULM,P005422,0 days 00:18:18,9,39,30
29,ULM,P010582,0 days 00:17:28,5,42,37
29,ULM,P010726,0 days 00:14:24,4,34,30
29,ULM,P007952,0 days 00:12:58,-4,22,26
29,ULM,P012066,0 days 00:12:53,7,36,29
29,ULM,P011391,0 days 00:01:52,3,7,4
29,ULM,P012602,0 days 00:01:52,3,7,4
29,LKB,P005521,0 days 00:27:28,-17,54,71
29,LKB,P002012,0 days 00:25:41,-13,49,62
29,LKB,PLXI,0 days 00:25:11,-13,49,62
29,LKB,P010190,0 days 00:20:33,-17,30,47
29,LKB,P004664,0 days 00:20:30,-15,35,50
29,LKB,P008856,0 days 00:19:49,-11,39,50
29,LKB,P010461,0 days 00:19:12,-6,32,38
29,LKB,P006230,0 days 00:15:35,-12,34,46
29,LKB,P012583,0 days 00:13:34,-10,27,37
29,LKB,P006901,0 days 00:10:35,-8,17,25
29,LKB,P011329,0 days 00:01:52,-3,4,7
30,TRN,P005059,0 days 00:25:27,-10,44,54
30,TRN,P012593,0 days 00:23:44,-7,49,56
30,TRN,P005738,0 days 00:23:19,-20,35,55
30,TRN,P009903,0 days 00:22:55,-9,42,51
30,TRN,P006382,0 days 00:21:17,-5,41,46
30,TRN,P012594,0 days 00:18:43,-9,29,38
30,TRN,P012595,0 days 00:18:30,-18,25,43
30,TRN,P001479,0 days 00:16:41,6,38,32
30,TRN,P012596,0 days 00:14:55,2,31,29
30,TRN,P007828,0 days 00:14:29,0,31,31
30,CAN,P006588,0 days 00:25:30,16,55,39
30,CAN,P008121,0 days 00:22:57,15,54,39
30,CAN,P003425,0 days 00:21:41,14,48,34
30,CAN,P004160,0 days 00:21:13,6,44,38
30,CAN,P001607,0 days 00:18:19,0,39,39
30,CAN,P005005,0 days 00:16:36,-3,31,34
30,CAN,P009864,0 days 00:15:25,-7,30,37
30,CAN,P010452,0 days 00:14:30,-2,32,34
30,CAN,P010385,0 days 00:14:04,10,32,22
30,CAN,P007560,0 days 00:12:30,11,32,21
30,CAN,P007644,0 days 00:10:31,11,25,14
30,CAN,P003637,0 days 00:06:44,-1,13,14
31,LJU,P003452,0 days 00:35:22,-15,68,83
31,LJU,P012700,0 days 00:34:50,-2,72,74
31,LJU,P002661,0 days 00:30:59,-5,71,76
31,LJU,P009395,0 days 00:30:14,-4,61,65
31,LJU,P012598,0 days 00:20:28,-9,37,46
31,LJU,P007066,0 days 00:18:36,-1,46,47
31,LJU,P010594,0 days 00:14:28,4,32,28
31,LJU,P011261,0 days 00:09:27,-2,14,16
31,LJU,P005969,0 days 00:03:16,1,6,5
31,LJU,P010771,0 days 00:02:20,-2,8,10
31,PMT,P011066,0 days 00:32:54,13,78,65
31,PMT,P002644,0 days 00:30:59,5,71,66
31,PMT,P009559,0 days 00:28:53,2,60,58
31,PMT,P012600,0 days 00:27:07,13,71,58
31,PMT,P011944,0 days 00:20:46,1,36,35
31,PMT,P001686,0 days 00:20:29,4,49,45
31,PMT,P011943,0 days 00:14:21,3,40,37
31,PMT,P011823,0 days 00:13:37,8,28,20
31,PMT,P011966,0 days 00:06:58,-6,12,18
31,PMT,P002020,0 days 00:03:56,-8,5,13
32,WOL,P002387,0 days 00:32:51,-6,68,74
32,WOL,P012577,0 days 00:31:22,11,81,70
32,WOL,P005516,0 days 00:28:18,9,72,63
32,WOL,P011150,0 days 00:27:20,-4,62,66
32,WOL,P004645,0 days 00:25:17,-6,51,57
32,WOL,P012576,0 days 00:18:14,10,43,33
32,WOL,P003212,0 days 00:14:51,-2,29,31
32,WOL,PLCT,0 days 00:10:14,11,28,17
32,WOL,P002333,0 days 00:06:55,-11,10,21
32,WOL,P006154,0 days 00:04:38,-2,6,8
32,BES,P012622,0 days 00:34:06,0,79,79
32,BES,P011936,0 days 00:32:52,-2,71,73
32,BES,P012647,0 days 00:29:17,-2,61,63
32,BES,P009582,0 days 00:25:49,4,56,52
32,BES,P008945,0 days 00:20:24,9,53,44
32,BES,P007914,0 days 00:17:11,-9,30,39
32,BES,P007917,0 days 00:15:52,-12,36,48
32,BES,P003783,0 days 00:14:44,-6,29,35
32,BES,P011357,0 days 00:06:47,8,17,9
32,BES,P011379,0 days 00:02:58,0,8,8
33,VNC,P004381,0 days 00:31:26,17,65,48
33,VNC,P003759,0 days 00:31:03,16,64,48
33,VNC,P012591,0 days 00:25:46,10,46,36
33,VNC,P011928,0 days 00:22:17,3,38,35
33,VNC,P011909,0 days 00:21:35,9,47,38
33,VNC,P000968,0 days 00:19:12,11,45,34
33,VNC,P012590,0 days 00:14:17,3,25,22
33,VNC,P004117,0 days 00:11:43,-8,16,24
33,VNC,P008052,0 days 00:11:05,14,32,18
33,VNC,P012587,0 days 00:06:13,-1,9,10
33,VNC,P009400,0 days 00:05:02,-1,6,7
33,VNC,P012588,0 days 00:00:21,2,2,0
33,JOV,P005094,0 days 00:30:56,-6,52,58
33,JOV,P011248,0 days 00:27:38,-10,42,52
33,JOV,P010161,0 days 00:23:43,-9,38,47
33,JOV,P002361,0 days 00:23:38,-3,39,42
33,JOV,P006771,0 days 00:20:34,-3,38,41
33,JOV,PJUG,0 days 00:19:23,-21,29,50
33,JOV,P002507,0 days 00:17:46,-6,26,32
33,JOV,P012076,0 days 00:16:56,0,35,35
33,JOV,P010458,0 days 00:09:16,0,14,14
33,JOV,P010166,0 days 00:07:29,-8,7,15
33,JOV,P010708,0 days 00:02:41,-9,0,9
34,HAM,P012581,0 days 00:29:36,-31,55,86
34,HAM,P009663,0 days 00:29:05,-30,57,87
34,HAM,P012580,0 days 00:25:37,-36,43,79
34,HAM,P012578,0 days 00:25:14,-28,47,75
34,HAM,P011168,0 days 00:19:51,-27,30,57
34,HAM,P001990,0 days 00:18:42,-6,44,50
34,HAM,P012694,0 days 00:14:46,-11,25,36
34,HAM,P012648,0 days 00:12:11,-4,22,26
34,HAM,P012579,0 days 00:11:22,-4,20,24
34,HAM,P010070,0 days 00:08:52,-7,15,22
34,HAM,P012695,0 days 00:02:51,-5,0,5
34,HAM,P011187,0 days 00:01:53,-6,2,8
34,HTA,P007759,0 days 00:23:52,43,80,37
34,HTA,P011973,0 days 00:22:31,27,65,38
34,HTA,P004846,0 days 00:22:08,10,56,46
34,HTA,P006835,0 days 00:22:04,18,60,42
34,HTA,P010465,0 days 00:22:01,34,71,37
34,HTA,P010550,0 days 00:19:29,14,49,35
34,HTA,P011991,0 days 00:16:28,20,54,34
34,HTA,P004267,0 days 00:14:13,-10,19,29
34,HTA,P003533,0 days 00:13:58,20,46,26
34,HTA,P011990,0 days 00:13:29,17,39,22
34,HTA,P012592,0 days 00:05:38,3,10,7
34,HTA,P012706,0 days 00:04:09,-1,6,7
35,LLI,P012585,0 days 00:38:04,0,84,84
35,LLI,P006600,0 days 00:35:24,4,87,83
35,LLI,P009672,0 days 00:34:59,6,81,75
35,LLI,P012586,0 days 00:34:59,-2,73,75
35,LLI,P009649,0 days 00:30:30,12,78,66
35,LLI,P009680,0 days 00:19:37,-10,44,54
35,LLI,P005247,0 days 00:13:52,-12,24,36
35,LLI,P004479,0 days 00:10:01,-10,21,31
35,LLI,P004773,0 days 00:07:34,-8,18,26
35,PRS,P012609,0 days 00:30:07,7,75,68
35,PRS,P012613,0 days 00:29:55,-3,68,71
35,PRS,P012608,0 days 00:27:34,5,75,70
35,PRS,P012640,0 days 00:26:54,2,63,61
35,PRS,P012610,0 days 00:25:44,9,64,55
35,PRS,P004512,0 days 00:25:10,1,57,56
35,PRS,P005793,0 days 00:19:46,7,52,45
35,PRS,P012611,0 days 00:15:43,-2,31,33
35,PRS,P003481,0 days 00:12:16,-2,23,25
35,PRS,P009556,0 days 00:11:51,-4,22,26
36,CAN,P003425,0 days 00:24:33,6,51,45
36,CAN,P006588,0 days 00:23:33,-3,47,50
36,CAN,P008121,0 days 00:22:20,-1,45,46
36,CAN,P005005,0 days 00:22:04,14,46,32
36,CAN,P010385,0 days 00:17:13,10,36,26
36,CAN,P009864,0 days 00:17:12,-4,33,37
36,CAN,P010452,0 days 00:17:05,11,39,28
36,CAN,P001607,0 days 00:16:21,3,37,34
36,CAN,P003637,0 days 00:15:36,-4,31,35
36,CAN,P007560,0 days 00:14:49,-1,31,32
36,CAN,P007644,0 days 00:04:57,2,13,11
36,CAN,P004160,0 days 00:04:17,7,11,4
36,BOU,P004525,0 days 00:23:11,-17,32,49
36,BOU,P010431,0 days 00:21:49,14,54,40
36,BOU,P010718,0 days 00:21:38,12,51,39
36,BOU,P011837,0 days 00:21:07,1,50,49
36,BOU,P012628,0 days 00:20:08,-23,27,50
36,BOU,P011836,0 days 00:20:01,5,49,44
36,BOU,P000498,0 days 00:19:44,-7,35,42
36,BOU,P012619,0 days 00:15:41,-5,21,26
36,BOU,P010449,0 days 00:15:01,-3,33,36
36,BOU,P011161,0 days 00:14:44,-13,21,34
36,BOU,P010450,0 days 00:06:56,-4,7,11
37,LKB,P007029,0 days 00:32:49,10,87,77
37,LKB,P002012,0 days 00:29:45,6,71,65
37,LKB,P008856,0 days 00:29:13,-1,69,70
37,LKB,PLXI,0 days 00:26:59,8,64,56
37,LKB,P005521,0 days 00:18:44,-17,33,50
37,LKB,P006230,0 days 00:14:56,1,32,31
37,LKB,P010461,0 days 00:14:10,-4,28,32
37,LKB,P012583,0 days 00:14:07,-3,34,37
37,LKB,P010190,0 days 00:12:15,-3,23,26
37,LKB,P006901,0 days 00:07:02,-2,19,21
37,TRN,P012595,0 days 00:25:59,-12,52,64
37,TRN,P005059,0 days 00:25:35,6,63,57
37,TRN,P012593,0 days 00:24:30,-1,60,61
37,TRN,P005738,0 days 00:23:24,-8,46,54
37,TRN,P009903,0 days 00:22:00,-3,43,46
37,TRN,P012594,0 days 00:20:04,0,43,43
37,TRN,P012596,0 days 00:18:00,4,50,46
37,TRN,P001479,0 days 00:16:36,9,47,38
37,TRN,P007828,0 days 00:15:27,1,39,38
37,TRN,P006382,0 days 00:08:25,9,22,13
38,TTK,P011925,0 days 00:31:46,2,64,62
38,TTK,P012056,0 days 00:29:05,-21,53,74
38,TTK,P011239,0 days 00:25:32,-1,54,55
38,TTK,P005000,0 days 00:23:30,-1,54,55
38,TTK,P012697,0 days 00:22:55,-8,43,51
38,TTK,P011834,0 days 00:22:27,-16,39,55
38,TTK,P006693,0 days 00:18:55,-15,37,52
38,TTK,P005685,0 days 00:12:26,-1,22,23
38,TTK,P004801,0 days 00:11:16,-5,18,23
38,TTK,P000497,0 days 00:02:08,1,6,5
38,ULM,P012703,0 days 00:30:11,15,75,60
38,ULM,P005422,0 days 00:26:48,9,63,54
38,ULM,P012603,0 days 00:25:17,15,65,50
38,ULM,P010582,0 days 00:24:18,16,57,41
38,ULM,P012629,0 days 00:23:00,7,54,47
38,ULM,P012604,0 days 00:21:11,22,59,37
38,ULM,P007952,0 days 00:15:24,-7,28,35
38,ULM,P011457,0 days 00:12:38,-7,21,28
38,ULM,P006997,0 days 00:11:24,-3,17,20
38,ULM,P010726,0 days 00:09:49,-2,16,18
39,WRO,P001694,0 days 00:30:37,-9,46,55
39,WRO,P005531,0 days 00:23:45,-8,41,49
39,WRO,P011165,0 days 00:22:40,-9,39,48
39,WRO,P012699,0 days 00:22:40,-8,39,47
39,WRO,P009896,0 days 00:20:47,-16,33,49
39,WRO,P003034,0 days 00:19:13,-1,30,31
39,WRO,P012736,0 days 00:18:14,-5,24,29
39,WRO,P011901,0 days 00:13:53,0,22,22
39,WRO,P011902,0 days 00:09:23,-8,17,25
39,WRO,P011900,0 days 00:08:02,-8,11,19
39,WRO,P012749,0 days 00:07:17,-12,7,19
39,WRO,P012308,0 days 00:03:29,-1,6,7
39,ARI,P012716,0 days 00:31:23,16,66,50
39,ARI,P012708,0 days 00:25:54,24,54,30
39,ARI,P004292,0 days 00:23:59,13,53,40
39,ARI,P012615,0 days 00:23:56,9,46,37
39,ARI,P003240,0 days 00:23:18,4,40,36
39,ARI,P012707,0 days 00:19:52,-1,32,33
39,ARI,P012760,0 days 00:14:54,9,30,21
39,ARI,P012702,0 days 00:12:23,4,27,23
39,ARI,P012722,0 days 00:11:11,4,21,17
39,ARI,P002867,0 days 00:10:27,-3,19,22
39,ARI,P012616,0 days 00:01:57,3,7,4
39,ARI,P010387,0 days 00:00:46,3,5,2
40,CLU,P012621,0 days 00:31:15,13,72,59
40,CLU,P011801,0 days 00:27:54,13,64,51
40,CLU,P010569,0 days 00:25:10,12,57,45
40,CLU,P005714,0 days 00:21:13,9,49,40
40,CLU,P012698,0 days 00:21:02,7,47,40
40,CLU,P011797,0 days 00:20:12,5,42,37
40,CLU,P004862,0 days 00:19:52,5,42,37
40,CLU,P005113,0 days 00:19:10,7,39,32
40,CLU,P005373,0 days 00:14:12,4,33,29
40,BUD,P010432,0 days 00:34:11,-10,62,72
40,BUD,P011935,0 days 00:32:22,-4,65,69
40,BUD,P012606,0 days 00:30:07,-6,59,65
40,BUD,P004945,0 days 00:23:50,-7,42,49
40,BUD,P007398,0 days 00:20:33,-11,36,47
40,BUD,P012630,0 days 00:18:38,-7,37,44
40,BUD,P002740,0 days 00:15:33,-6,28,34
40,BUD,P012605,0 days 00:11:51,-8,20,28
40,BUD,P006566,0 days 00:10:32,-13,16,29
40,BUD,P006561,0 days 00:02:23,-3,5,8
41,PMT,P011944,0 days 00:31:53,-18,55,73
41,PMT,P011823,0 days 00:27:23,-9,50,59
41,PMT,P012600,0 days 00:26:22,-11,56,67
41,PMT,P009559,0 days 00:23:08,-3,45,48
41,PMT,P011066,0 days 00:20:00,-9,37,46
41,PMT,P011947,0 days 00:18:46,1,47,46
41,PMT,P011943,0 days 00:14:41,-4,25,29
41,PMT,P002644,0 days 00:14:32,-13,32,45
41,PMT,P011966,0 days 00:11:27,-5,25,30
41,PMT,P011946,0 days 00:06:52,-2,14,16
41,PMT,P002020,0 days 00:03:27,-12,4,16
41,PMT,P012601,0 days 00:01:29,0,5,5
41,PRS,P012610,0 days 00:25:09,15,58,43
41,PRS,P012613,0 days 00:25:09,15,58,43
41,PRS,P012608,0 days 00:25:08,15,58,43
41,PRS,P012640,0 days 00:20:24,3,51,48
41,PRS,P012609,0 days 00:20:10,1,49,48
41,PRS,P004512,0 days 00:18:47,16,42,26
41,PRS,P012611,0 days 00:18:21,16,42,26
41,PRS,P005793,0 days 00:14:52,2,38,36
41,PRS,P009556,0 days 00:14:51,2,38,36
41,PRS,P003481,0 days 00:14:11,0,36,36
41,PRS,P010801,0 days 00:01:29,0,5,5
41,PRS,P011887,0 days 00:01:29,0,5,5
42,LLI,P006600,0 days 00:31:57,1,79,78
42,LLI,P012586,0 days 00:29:20,-11,61,72
42,LLI,P012585,0 days 00:28:59,0,70,70
42,LLI,P005247,0 days 00:26:37,9,72,63
42,LLI,P009680,0 days 00:25:14,5,65,60
42,LLI,P009649,0 days 00:22:42,-5,51,56
42,LLI,P004479,0 days 00:16:31,-22,25,47
42,LLI,P004773,0 days 00:08:06,-7,12,19
42,LLI,P003850,0 days 00:08:03,-9,11,20
42,LLI,P008274,0 days 00:02:31,-1,4,5
42,HTA,P010465,0 days 00:33:25,8,82,74
42,HTA,P007759,0 days 00:31:12,8,79,71
42,HTA,P010550,0 days 00:30:19,10,76,66
42,HTA,P011991,0 days 00:29:06,1,66,65
42,HTA,P011973,0 days 00:26:57,11,68,57
42,HTA,P004846,0 days 00:22:46,7,56,49
42,HTA,P006835,0 days 00:16:03,-4,41,45
42,HTA,P003533,0 days 00:06:58,1,16,15
42,HTA,P004267,0 days 00:03:14,-2,6,8
43,JOV,P010161,0 days 00:25:19,12,73,61
43,JOV,P011248,0 days 00:22:58,15,63,48
43,JOV,P010166,0 days 00:20:50,18,70,52
43,JOV,P006771,0 days 00:20:17,18,50,32
43,JOV,P005094,0 days 00:20:00,19,52,33
43,JOV,P010708,0 days 00:19:52,16,41,25
43,JOV,P002361,0 days 00:18:57,7,47,40
43,JOV,P009572,0 days 00:18:33,19,51,32
43,JOV,PJUG,0 days 00:16:27,19,47,28
43,JOV,P010709,0 days 00:11:36,11,32,21
43,JOV,P012349,0 days 00:05:11,6,14,8
43,HAM,P012580,0 days 00:27:23,-18,54,72
43,HAM,P009663,0 days 00:24:23,-9,47,56
43,HAM,P012579,0 days 00:22:22,-12,42,54
43,HAM,P011168,0 days 00:22:19,-24,38,62
43,HAM,P012581,0 days 00:21:56,-27,46,73
43,HAM,P012582,0 days 00:20:10,-9,43,52
43,HAM,P012694,0 days 00:16:37,-18,28,46
43,HAM,P012695,0 days 00:14:01,-7,29,36
43,HAM,P010070,0 days 00:13:22,-11,26,37
43,HAM,P012648,0 days 00:10:34,-19,13,32
43,HAM,P001990,0 days 00:03:40,-1,9,10
43,HAM,P012578,0 days 00:03:13,-5,5,10
44,BES,P012622,0 days 00:31:27,-3,53,56
44,BES,P008945,0 days 00:30:40,1,52,51
44,BES,P011936,0 days 00:30:34,2,54,52
44,BES,P012647,0 days 00:28:11,-3,45,48
44,BES,P009582,0 days 00:24:17,7,49,42
44,BES,P007914,0 days 00:17:10,5,36,31
44,BES,P003783,0 days 00:16:28,4,33,29
44,BES,P007917,0 days 00:09:24,8,19,11
44,BES,P011379,0 days 00:06:53,3,13,10
44,BES,P011357,0 days 00:04:56,6,16,10
44,VNC,P004381,0 days 00:30:42,9,57,48
44,VNC,P012591,0 days 00:28:51,2,49,47
44,VNC,P003759,0 days 00:24:59,-4,43,47
44,VNC,P008052,0 days 00:23:43,-6,39,45
44,VNC,P011928,0 days 00:21:56,-8,34,42
44,VNC,P012590,0 days 00:18:42,-8,31,39
44,VNC,P000968,0 days 00:17:50,-5,33,38
44,VNC,P009400,0 days 00:14:38,-6,23,29
44,VNC,P004117,0 days 00:09:22,6,20,14
44,VNC,P012587,0 days 00:09:17,-10,11,21
45,LJU,P012700,0 days 00:35:40,-3,74,77
45,LJU,P002661,0 days 00:30:59,-10,61,71
45,LJU,P012598,0 days 00:29:28,4,60,56
45,LJU,P003452,0 days 00:27:38,-14,50,64
45,LJU,P009395,0 days 00:25:04,-4,47,51
45,LJU,P001235,0 days 00:18:59,6,42,36
45,LJU,P007066,0 days 00:17:43,-7,34,41
45,LJU,P011261,0 days 00:11:32,-2,20,22
45,LJU,P010594,0 days 00:02:57,-10,2,12
45,WOL,P012577,0 days 00:33:12,-2,69,71
45,WOL,P005516,0 days 00:32:14,5,68,63
45,WOL,P011150,0 days 00:31:24,15,76,61
45,WOL,P004645,0 days 00:24:13,14,57,43
45,WOL,P012576,0 days 00:20:24,-1,40,41
45,WOL,P003212,0 days 00:17:11,16,43,27
45,WOL,P006154,0 days 00:15:29,7,35,28
45,WOL,P004229,0 days 00:09:44,-4,16,20
45,WOL,PLCT,0 days 00:08:09,-7,11,18
45,WOL,P006907,0 days 00:08:00,-3,15,18
46,BOU,P010718,0 days 00:30:18,2,57,55
46,BOU,P011837,0 days 00:24:06,13,56,43
46,BOU,P011161,0 days 00:24:01,10,47,37
46,BOU,P004525,0 days 00:22:13,-4,42,46
46,BOU,P011836,0 days 00:17:47,9,36,27
46,BOU,P010431,0 days 00:16:52,3,33,30
46,BOU,P012628,0 days 00:16:48,14,40,26
46,BOU,P010450,0 days 00:16:02,-9,26,35
46,BOU,P000498,0 days 00:15:59,-5,31,36
46,BOU,P012619,0 days 00:15:54,-8,22,30
46,BUD,P011935,0 days 00:32:52,-7,58,65
46,BUD,P004945,0 days 00:30:05,-4,53,57
46,BUD,P012606,0 days 00:24:32,-2,46,48
46,BUD,P010248,0 days 00:23:10,4,47,43
46,BUD,P007398,0 days 00:21:00,0,39,39
46,BUD,P002740,0 days 00:17:24,-5,30,35
46,BUD,P010432,0 days 00:16:50,-9,26,35
46,BUD,P012605,0 days 00:15:28,-3,27,30
46,BUD,P012630,0 days 00:12:27,1,29,28
46,BUD,P009214,0 days 00:06:12,0,10,10
47,ARI,P012716,0 days 00:31:05,-5,44,49
47,ARI,P012708,0 days 00:29:08,-3,42,45
47,ARI,P003240,0 days 00:29:00,-5,41,46
47,ARI,P012707,0 days 00:27:27,-3,37,40
47,ARI,P002867,0 days 00:25:14,12,45,33
47,ARI,P012615,0 days 00:19:37,8,33,25
47,ARI,P012702,0 days 00:15:51,7,31,24
47,ARI,P012760,0 days 00:14:55,-15,14,29
47,ARI,P010387,0 days 00:04:18,-5,6,11
47,ARI,P012616,0 days 00:03:25,-1,2,3
47,CLU,P011801,0 days 00:29:33,10,48,38
47,CLU,P011797,0 days 00:28:24,6,48,42
47,CLU,P005714,0 days 00:23:51,10,44,34
47,CLU,P012698,0 days 00:22:40,11,39,28
47,CLU,P004862,0 days 00:22:07,-7,31,38
47,CLU,P005113,0 days 00:21:35,-2,31,33
47,CLU,P010569,0 days 00:19:55,-5,24,29
47,CLU,P012621,0 days 00:18:24,-10,22,32
47,CLU,P005373,0 days 00:13:25,-2,18,20
47,CLU,P012620,0 days 00:00:06,-1,0,1
48,ULM,P012604,0 days 00:35:40,3,85,82
48,ULM,P005422,0 days 00:31:24,-2,71,73
48,ULM,P012703,0 days 00:29:15,-1,71,72
48,ULM,P012629,0 days 00:27:20,3,69,66
48,ULM,P010106,0 days 00:24:54,10,62,52
48,ULM,P010582,0 days 00:24:27,20,63,43
48,ULM,P012603,0 days 00:16:49,-23,32,55
48,ULM,P011457,0 days 00:13:06,7,32,25
48,ULM,P006997,0 days 00:09:20,2,23,21
48,ULM,P010726,0 days 00:08:30,5,22,17
48,ULM,P012066,0 days 00:04:15,1,10,9
48,WRO,P011165,0 days 00:35:48,-17,77,94
48,WRO,P009896,0 days 00:28:25,10,70,60
48,WRO,P012736,0 days 00:27:32,0,67,67
48,WRO,P012699,0 days 00:27:20,-13,58,71
48,WRO,P001694,0 days 00:27:02,-14,55,69
48,WRO,P011901,0 days 00:21:03,16,58,42
48,WRO,P011278,0 days 00:20:09,7,49,42
48,WRO,P011902,0 days 00:16:54,5,40,35
48,WRO,P003034,0 days 00:16:36,-12,36,48
48,WRO,P012749,0 days 00:04:11,-7,5,12
49,TRN,P005738,0 days 00:33:22,16,84,68
49,TRN,P009903,0 days 00:30:42,9,75,66
49,TRN,P012597,0 days 00:28:21,-1,60,61
49,TRN,P012594,0 days 00:27:40,9,66,57
49,TRN,P012595,0 days 00:24:20,-1,54,55
49,TRN,P012593,0 days 00:21:27,13,55,42
49,TRN,P005059,0 days 00:17:20,-4,35,39
49,TRN,P006382,0 days 00:15:52,-1,33,34
49,TRN,P001479,0 days 00:15:05,-8,30,38
49,TRN,P012596,0 days 00:10:51,-7,13,20
49,TTK,P005000,0 days 00:37:41,-2,83,85
49,TTK,P011239,0 days 00:34:51,-6,72,78
49,TTK,P011925,0 days 00:33:39,-5,72,77
49,TTK,P012056,0 days 00:30:39,2,68,66
49,TTK,P011834,0 days 00:28:46,-5,61,66
49,TTK,P012697,0 days 00:27:57,-4,63,67
49,TTK,P006693,0 days 00:17:50,-1,35,36
49,TTK,P005685,0 days 00:06:26,0,14,14
49,TTK,P000497,0 days 00:04:15,-5,4,9
49,TTK,P009845,0 days 00:02:56,1,8,7
50,CAN,P006588,0 days 00:23:30,18,53,35
50,CAN,P003425,0 days 00:22:45,19,53,34
50,CAN,P008121,0 days 00:21:47,11,47,36
50,CAN,P009864,0 days 00:19:37,13,46,33
50,CAN,P005005,0 days 00:18:47,9,49,40
50,CAN,P001607,0 days 00:17:15,-8,35,43
50,CAN,P003637,0 days 00:16:37,-2,38,40
50,CAN,P010452,0 days 00:16:30,-7,35,42
50,CAN,P010385,0 days 00:14:18,4,35,31
50,CAN,P007560,0 days 00:13:10,5,30,25
50,CAN,P004160,0 days 00:09:39,-1,12,13
50,CAN,P007644,0 days 00:06:05,-6,7,13
50,LKB,PLXI,0 days 00:26:45,-14,43,57
50,LKB,P004664,0 days 00:26:22,-1,61,62
50,LKB,P002012,0 days 00:25:09,-6,46,52
50,LKB,P007029,0 days 00:23:26,-13,43,56
50,LKB,P005521,0 days 00:22:41,4,49,45
50,LKB,P010461,0 days 00:20:44,-1,39,40
50,LKB,P006230,0 days 00:15:50,-10,33,43
50,LKB,P012583,0 days 00:15:38,-8,30,38
50,LKB,P008856,0 days 00:13:38,-10,16,26
50,LKB,P010190,0 days 00:07:08,1,19,18
50,LKB,P006901,0 days 00:02:39,3,6,3
51,WOL,P005516,0 days 00:30:06,3,53,50
51,WOL,P011150,0 days 00:28:59,19,72,53
51,WOL,P012577,0 days 00:26:21,8,54,46
51,WOL,P002387,0 days 00:25:54,8,52,44
51,WOL,P012576,0 days 00:25:34,25,63,38
51,WOL,P003212,0 days 00:20:16,8,45,37
51,WOL,P004229,0 days 00:14:20,-11,22,33
51,WOL,P006154,0 days 00:13:14,6,30,24
51,WOL,P004645,0 days 00:10:28,7,27,20
51,WOL,PLCT,0 days 00:03:25,0,7,7
51,WOL,P006907,0 days 00:01:23,-3,0,3
51,PMT,P011066,0 days 00:30:13,-15,53,68
51,PMT,P012599,0 days 00:29:12,-8,53,61
51,PMT,P011944,0 days 00:27:44,-11,46,57
51,PMT,P002644,0 days 00:21:26,-2,39,41
51,PMT,P011823,0 days 00:20:50,-15,37,52
51,PMT,P011947,0 days 00:19:49,0,30,30
51,PMT,P009559,0 days 00:17:09,-13,29,42
51,PMT,P001686,0 days 00:10:32,2,24,22
51,PMT,P012600,0 days 00:08:57,-11,19,30
51,PMT,P011946,0 days 00:05:36,-1,9,10
51,PMT,P011943,0 days 00:04:32,2,8,6
51,PMT,P011966,0 days 00:04:00,2,8,6
52,VNC,P012591,0 days 00:32:08,17,78,61
52,VNC,P004381,0 days 00:30:20,14,76,62
52,VNC,P011928,0 days 00:28:21,0,61,61
52,VNC,P008052,0 days 00:26:05,2,65,63
52,VNC,P012590,0 days 00:24:41,6,63,57
52,VNC,P009400,0 days 00:21:01,12,52,40
52,VNC,P003759,0 days 00:19:47,4,44,40
52,VNC,P012587,0 days 00:11:08,-11,23,34
52,VNC,P000968,0 days 00:06:29,-4,13,17
52,LJU,P012700,0 days 00:35:45,-13,72,85
52,LJU,P012598,0 days 00:32:06,-9,68,77
52,LJU,P003452,0 days 00:31:29,-14,68,82
52,LJU,P002661,0 days 00:30:27,-2,72,74
52,LJU,P009395,0 days 00:24:21,1,51,50
52,LJU,P007066,0 days 00:15:27,-9,36,45
52,LJU,P001235,0 days 00:12:13,3,24,21
52,LJU,P009392,0 days 00:10:26,2,26,24
52,LJU,P011261,0 days 00:04:35,2,12,10
52,LJU,P010594,0 days 00:03:11,-1,6,7
53,BES,P011936,0 days 00:27:16,3,60,57
53,BES,P009582,0 days 00:26:43,13,63,50
53,BES,P008945,0 days 00:25:34,16,61,45
53,BES,P012647,0 days 00:25:21,13,63,50
53,BES,P012622,0 days 00:22:24,8,46,38
53,BES,P007914,0 days 00:22:16,4,47,43
53,BES,P003783,0 days 00:19:52,5,46,41
53,BES,P011379,0 days 00:11:25,-1,21,22
53,BES,P007917,0 days 00:09:36,-3,20,23
53,BES,P005348,0 days 00:06:19,2,17,15
53,BES,P011357,0 days 00:03:14,0,6,6
53,HAM,P011168,0 days 00:28:35,-7,59,66
53,HAM,P009663,0 days 00:27:47,-18,52,70
53,HAM,P012579,0 days 00:24:20,-8,45,53
53,HAM,P012580,0 days 00:24:03,-3,46,49
53,HAM,P012582,0 days 00:23:53,-16,43,59
53,HAM,P012581,0 days 00:23:49,-20,44,64
53,HAM,P012694,0 days 00:16:07,4,35,31
53,HAM,P011187,0 days 00:12:13,6,26,20
53,HAM,P012648,0 days 00:10:11,1,24,23
53,HAM,P012695,0 days 00:09:02,1,16,15
54,JOV,P005094,0 days 00:33:01,-6,60,66
54,JOV,P011248,0 days 00:28:49,1,61,60
54,JOV,P010161,0 days 00:28:48,-10,56,66
54,JOV,P006771,0 days 00:23:51,-5,45,50
54,JOV,P010708,0 days 00:21:16,4,45,41
54,JOV,P002361,0 days 00:18:31,-14,31,45
54,JOV,P009572,0 days 00:15:09,1,32,31
54,JOV,P010166,0 days 00:10:44,1,27,26
54,JOV,PJUG,0 days 00:10:37,-12,15,27
54,JOV,P012349,0 days 00:09:14,-15,8,23
54,LLI,P006600,0 days 00:32:59,24,81,57
54,LLI,P009680,0 days 00:29:42,13,71,58
54,LLI,P012586,0 days 00:25:11,-4,52,56
54,LLI,P004479,0 days 00:24:36,5,44,39
54,LLI,P009649,0 days 00:24:02,0,50,50
54,LLI,P012585,0 days 00:23:49,7,56,49
54,LLI,P005247,0 days 00:21:02,17,52,35
54,LLI,P004773,0 days 00:11:57,4,23,19
54,LLI,P003850,0 days 00:06:42,-11,6,17
55,PRS,P012608,0 days 00:24:10,23,73,50
55,PRS,P012610,0 days 00:24:10,23,73,50
55,PRS,P012613,0 days 00:24:10,23,73,50
55,PRS,P012640,0 days 00:22:46,9,61,52
55,PRS,P012609,0 days 00:19:40,8,51,43
55,PRS,P005793,0 days 00:18:17,4,43,39
55,PRS,P004512,0 days 00:17:00,17,51,34
55,PRS,P012611,0 days 00:16:22,19,56,37
55,PRS,P009556,0 days 00:15:50,4,41,37
55,PRS,P003481,0 days 00:13:36,5,35,30
55,PRS,P010801,0 days 00:02:26,2,9,7
55,PRS,P011551,0 days 00:01:33,-2,4,6
55,HTA,P010465,0 days 00:29:22,-17,68,85
55,HTA,P007759,0 days 00:28:42,-19,64,83
55,HTA,P010550,0 days 00:28:00,-17,68,85
55,HTA,P011973,0 days 00:25:37,-13,58,71
55,HTA,P004846,0 days 00:25:23,-18,53,71
55,HTA,P006835,0 days 00:25:11,-18,51,69
55,HTA,P004267,0 days 00:17:21,-14,31,45
55,HTA,P003533,0 days 00:12:18,-12,23,35
55,HTA,P011990,0 days 00:07:30,-7,17,24
55,HTA,P012592,0 days 00:00:36,0,2,2
56,LKB,PLXI,0 days 00:32:53,6,76,70
56,LKB,P007029,0 days 00:30:23,13,84,71
56,LKB,P002012,0 days 00:27:26,-3,61,64
56,LKB,P006230,0 days 00:24:35,6,64,58
56,LKB,P004664,0 days 00:24:13,-4,62,66
56,LKB,P005521,0 days 00:18:59,9,56,47
56,LKB,P010461,0 days 00:14:48,-5,33,38
56,LKB,P008856,0 days 00:14:45,5,33,28
56,LKB,P006901,0 days 00:07:38,2,26,24
56,LKB,P010190,0 days 00:04:20,-9,5,14
56,BOU,P010718,0 days 00:27:07,-3,67,70
56,BOU,P010431,0 days 00:26:27,-7,61,68
56,BOU,P011836,0 days 00:24:55,-4,55,59
56,BOU,P011837,0 days 00:20:54,22,55,33
56,BOU,P012628,0 days 00:20:51,15,63,48
56,BOU,P000498,0 days 00:20:21,16,60,44
56,BOU,P011161,0 days 00:19:39,-20,36,56
56,BOU,P012619,0 days 00:17:02,-18,37,55
56,BOU,P010450,0 days 00:12:09,-16,22,38
56,BOU,P004525,0 days 00:10:35,-5,24,29
57,TTK,P011925,0 days 00:39:09,-13,69,82
57,TTK,P005000,0 days 00:31:07,-7,53,60
57,TTK,P012056,0 days 00:31:02,-13,53,66
57,TTK,P011239,0 days 00:30:14,-8,53,61
57,TTK,P006693,0 days 00:24:54,-7,45,52
57,TTK,P012697,0 days 00:21:15,-4,38,42
57,TTK,P009845,0 days 00:08:29,-8,12,20
57,TTK,P011975,0 days 00:07:48,-1,12,13
57,TTK,P005685,0 days 00:06:02,-4,10,14
57,CAN,P010452,0 days 00:27:21,19,66,47
57,CAN,P001607,0 days 00:23:48,7,48,41
57,CAN,P005005,0 days 00:21:31,1,36,35
57,CAN,P004160,0 days 00:19:20,15,45,30
57,CAN,P008121,0 days 00:18:29,12,46,34
57,CAN,P009864,0 days 00:17:40,14,40,26
57,CAN,P010385,0 days 00:16:39,-1,30,31
57,CAN,P007644,0 days 00:16:23,-3,27,30
57,CAN,P003425,0 days 00:16:12,6,34,28
57,CAN,P007560,0 days 00:16:05,3,31,28
57,CAN,P003637,0 days 00:05:24,-7,6,13
57,CAN,P010484,0 days 00:01:08,-1,1,2
58,WRO,P012010,0 days 00:31:19,-3,62,65
58,WRO,P005531,0 days 00:30:03,-4,57,61
58,WRO,P009896,0 days 00:26:33,4,51,47
58,WRO,P012699,0 days 00:23:08,-8,48,56
58,WRO,P011165,0 days 00:22:38,-4,46,50
58,WRO,P011900,0 days 00:19:23,-12,31,43
58,WRO,P012736,0 days 00:18:42,3,36,33
58,WRO,P003034,0 days 00:12:46,-10,22,32
58,WRO,P011902,0 days 00:08:13,-4,12,16
58,WRO,P011901,0 days 00:07:15,-7,10,17
58,TRN,P012597,0 days 00:29:44,13,68,55
58,TRN,P005738,0 days 00:26:59,4,51,47
58,TRN,P005059,0 days 00:26:21,15,65,50
58,TRN,P012595,0 days 00:25:59,5,47,42
58,TRN,P009903,0 days 00:23:50,5,42,37
58,TRN,P012596,0 days 00:15:53,4,42,38
58,TRN,P012594,0 days 00:14:04,-5,22,27
58,TRN,P012593,0 days 00:13:54,3,29,26
58,TRN,P001479,0 days 00:13:01,5,33,28
58,TRN,P006382,0 days 00:07:25,3,19,16
58,TRN,P007828,0 days 00:02:50,-7,2,9
59,CLU,P004862,0 days 00:31:56,3,66,63
59,CLU,P011797,0 days 00:28:02,12,62,50
59,CLU,P012698,0 days 00:24:13,8,55,47
59,CLU,P010569,0 days 00:22:23,12,51,39
59,CLU,P005113,0 days 00:21:14,12,47,35
59,CLU,P011801,0 days 00:18:47,5,38,33
59,CLU,P005373,0 days 00:18:33,-1,37,38
59,CLU,P005714,0 days 00:17:50,-1,37,38
59,CLU,P012621,0 days 00:14:07,-3,24,27
59,CLU,P012620,0 days 00:02:55,8,13,5
59,ULM,P012604,0 days 00:31:06,6,62,56
59,ULM,P012603,0 days 00:27:57,5,58,53
59,ULM,P010582,0 days 00:24:49,2,50,48
59,ULM,P010106,0 days 00:24:40,15,55,40
59,ULM,P005422,0 days 00:20:50,-18,31,49
59,ULM,P011457,0 days 00:18:47,17,51,34
59,ULM,P012629,0 days 00:15:24,-14,25,39
59,ULM,P012703,0 days 00:15:19,-26,20,46
59,ULM,P007952,0 days 00:08:42,-15,13,28
59,ULM,P006997,0 days 00:07:20,-16,6,22
59,ULM,P010726,0 days 00:05:06,-11,4,15
60,BUD,P011935,0 days 00:36:16,2,56,54
60,BUD,P004945,0 days 00:31:21,15,57,42
60,BUD,P012606,0 days 00:28:32,-5,44,49
60,BUD,P010432,0 days 00:26:01,-5,42,47
60,BUD,P007398,0 days 00:22:54,1,38,37
60,BUD,P012630,0 days 00:19:50,-10,25,35
60,BUD,P012605,0 days 00:14:14,0,19,19
60,BUD,P010248,0 days 00:13:28,3,21,18
60,BUD,P009214,0 days 00:03:44,-4,7,11
60,BUD,P006566,0 days 00:03:40,-7,6,13
60,ARI,P003240,0 days 00:29:35,3,56,53
60,ARI,P012708,0 days 00:27:07,12,54,42
60,ARI,P002867,0 days 00:26:22,-6,31,37
60,ARI,P012615,0 days 00:21:45,15,44,29
60,ARI,P012702,0 days 00:20:42,7,27,20
60,ARI,P012716,0 days 00:20:22,-10,21,31
60,ARI,P012760,0 days 00:19:18,-5,38,43
60,ARI,P012707,0 days 00:13:20,-12,15,27
60,ARI,P012616,0 days 00:12:11,9,29,20
60,ARI,P004292,0 days 00:06:53,-6,4,10
60,ARI,P010387,0 days 00:02:25,3,6,3
61,PMT,P012600,0 days 00:31:06,4,78,74
61,PMT,P012599,0 days 00:28:43,-1,61,62
61,PMT,P011966,0 days 00:23:42,8,58,50
61,PMT,P011944,0 days 00:22:58,12,61,49
61,PMT,P011823,0 days 00:21:33,3,59,56
61,PMT,P001686,0 days 00:21:21,16,58,42
61,PMT,P002644,0 days 00:18:27,6,39,33
61,PMT,P011947,0 days 00:18:09,-3,40,43
61,PMT,P002020,0 days 00:08:04,5,21,16
61,PMT,P011943,0 days 00:05:57,-5,15,20
61,HTA,P006835,0 days 00:32:49,-8,73,81
61,HTA,P011991,0 days 00:30:14,-11,61,72
61,HTA,P004846,0 days 00:27:45,-8,62,70
61,HTA,P007759,0 days 00:27:08,-4,65,69
61,HTA,P010465,0 days 00:24:27,-3,59,62
61,HTA,P011973,0 days 00:22:21,0,57,57
61,HTA,P003533,0 days 00:16:23,-5,30,35
61,HTA,P004267,0 days 00:13:13,-6,28,34
61,HTA,P011990,0 days 00:05:40,0,10,10
62,JOV,P002361,0 days 00:35:39,1,73,72
62,JOV,P005094,0 days 00:28:47,-20,54,74
62,JOV,P011248,0 days 00:27:12,-23,50,73
62,JOV,P006771,0 days 00:24:50,-10,49,59
62,JOV,P009572,0 days 00:24:24,4,57,53
62,JOV,P012349,0 days 00:24:15,-8,48,56
62,JOV,P010161,0 days 00:23:32,-1,52,53
62,JOV,P010708,0 days 00:19:42,3,44,41
62,JOV,P010709,0 days 00:16:39,19,43,24
62,PRS,P012609,0 days 00:31:05,9,76,67
62,PRS,P012610,0 days 00:30:54,8,64,56
62,PRS,P012608,0 days 00:30:47,8,64,56
62,PRS,P012640,0 days 00:26:11,12,69,57
62,PRS,P004512,0 days 00:23:02,4,44,40
62,PRS,P005793,0 days 00:20:25,-1,49,50
62,PRS,P012611,0 days 00:19:52,-4,36,40
62,PRS,P009556,0 days 00:14:13,-1,37,38
62,PRS,P003481,0 days 00:12:02,-11,27,38
62,PRS,P012612,0 days 00:08:53,13,26,13
62,PRS,P012613,0 days 00:07:36,-2,13,15
63,BES,P008945,0 days 00:29:17,14,73,59
63,BES,P009582,0 days 00:29:13,17,72,55
63,BES,P011936,0 days 00:28:26,4,58,54
63,BES,P012647,0 days 00:27:04,0,58,58
63,BES,P012622,0 days 00:23:57,-6,45,51
63,BES,P007914,0 days 00:19:45,-10,37,47
63,BES,P005348,0 days 00:18:16,1,34,33
63,BES,P003783,0 days 00:11:19,-17,9,26
63,BES,P011379,0 days 00:08:24,-8,12,20
63,BES,P011357,0 days 00:02:25,-2,2,4
63,BES,P007917,0 days 00:01:54,-8,0,8
63,LLI,P005247,0 days 00:32:35,1,65,64
63,LLI,P009680,0 days 00:31:05,-1,64,65
63,LLI,P012585,0 days 00:30:03,-1,65,66
63,LLI,P012586,0 days 00:28:45,-5,57,62
63,LLI,P006600,0 days 00:27:48,-3,55,58
63,LLI,P004479,0 days 00:21:24,9,47,38
63,LLI,P004773,0 days 00:16:09,9,34,25
63,LLI,P012020,0 days 00:12:11,6,28,22
64,LJU,P003452,0 days 00:35:57,-8,72,80
64,LJU,P012700,0 days 00:32:31,-5,71,76
64,LJU,P002661,0 days 00:27:01,-10,59,69
64,LJU,P011261,0 days 00:20:08,31,53,22
64,LJU,P001235,0 days 00:17:31,13,33,20
64,LJU,P010771,0 days 00:15:25,23,46,23
64,LJU,P009395,0 days 00:14:44,-9,22,31
64,LJU,P009392,0 days 00:12:54,-17,24,41
64,LJU,P012598,0 days 00:11:28,-6,21,27
64,LJU,P007066,0 days 00:09:48,-18,14,32
64,LJU,P010594,0 days 00:02:33,-9,0,9
64,HAM,P012582,0 days 00:29:00,5,66,61
64,HAM,P009663,0 days 00:23:45,6,54,48
64,HAM,P012581,0 days 00:22:47,12,52,40
64,HAM,P011168,0 days 00:22:27,4,51,47
64,HAM,P012580,0 days 00:21:06,8,46,38
64,HAM,P012579,0 days 00:20:19,-9,40,49
64,HAM,P011187,0 days 00:18:44,-2,39,41
64,HAM,P012648,0 days 00:12:34,-6,26,32
64,HAM,P010070,0 days 00:11:54,-3,23,26
64,HAM,P012695,0 days 00:11:38,4,19,15
64,HAM,P001990,0 days 00:05:46,-4,14,18
65,WOL,P012577,0 days 00:31:19,-11,64,75
65,WOL,P002387,0 days 00:31:16,-14,56,70
65,WOL,PLCT,0 days 00:27:28,-3,55,58
65,WOL,P005516,0 days 00:25:55,-16,44,60
65,WOL,P006154,0 days 00:24:29,-10,50,60
65,WOL,P012576,0 days 00:22:17,-10,43,53
65,WOL,P004645,0 days 00:15:20,-6,34,40
65,WOL,P004229,0 days 00:11:58,-5,19,24
65,WOL,P006907,0 days 00:09:58,-5,20,25
65,VNC,P012591,0 days 00:31:57,11,78,67
65,VNC,P011928,0 days 00:31:23,8,74,66
65,VNC,P004381,0 days 00:31:20,11,73,62
65,VNC,P009400,0 days 00:27:20,16,62,46
65,VNC,P012590,0 days 00:23:30,11,52,41
65,VNC,P008052,0 days 00:22:58,11,51,40
65,VNC,P003759,0 days 00:15:00,4,38,34
65,VNC,P004117,0 days 00:10:39,9,23,14
65,VNC,P012587,0 days 00:05:53,-1,14,15
66,BOU,P011836,0 days 00:29:50,14,62,48
66,BOU,P010431,0 days 00:27:41,4,48,44
66,BOU,P010718,0 days 00:25:50,6,44,38
66,BOU,P012617,0 days 00:24:41,20,54,34
66,BOU,P004525,0 days 00:21:59,3,45,42
66,BOU,P011161,0 days 00:19:01,-5,33,38
66,BOU,P011837,0 days 00:18:01,4,27,23
66,BOU,P012628,0 days 00:17:33,6,33,27
66,BOU,P010450,0 days 00:10:13,-10,10,20
66,BOU,P000498,0 days 00:05:11,-7,4,11
66,ARI,P012707,0 days 00:30:15,-6,51,57
66,ARI,P004292,0 days 00:27:26,0,51,51
66,ARI,P012716,0 days 00:25:46,-10,43,53
66,ARI,P012615,0 days 00:23:59,-15,34,49
66,ARI,P012760,0 days 00:23:34,3,46,43
66,ARI,P012708,0 days 00:19:02,-3,28,31
66,ARI,P012702,0 days 00:15:04,-6,19,25
66,ARI,P002867,0 days 00:14:30,-2,19,21
66,ARI,P012616,0 days 00:11:08,11,25,14
66,ARI,P003240,0 days 00:09:16,-7,9,16
67,ULM,P010106,0 days 00:26:12,14,53,39
67,ULM,P005422,0 days 00:25:44,18,61,43
67,ULM,P010582,0 days 00:25:16,10,50,40
67,ULM,P006997,0 days 00:24:05,15,58,43
67,ULM,P012603,0 days 00:23:34,11,52,41
67,ULM,P012629,0 days 00:20:20,7,47,40
67,ULM,P012604,0 days 00:18:42,5,31,26
67,ULM,P012703,0 days 00:16:14,3,34,31
67,ULM,P011457,0 days 00:15:38,2,29,27
67,ULM,P010726,0 days 00:04:15,0,5,5
67,BUD,P011935,0 days 00:32:26,-12,52,64
67,BUD,P004945,0 days 00:31:51,-15,53,68
67,BUD,P012606,0 days 00:28:40,-5,53,58
67,BUD,P002740,0 days 00:22:09,-8,33,41
67,BUD,P010248,0 days 00:21:34,-9,39,48
67,BUD,P010432,0 days 00:18:26,-8,28,36
67,BUD,P007398,0 days 00:16:11,0,26,26
67,BUD,P012605,0 days 00:11:41,-13,16,29
67,BUD,P012630,0 days 00:09:28,-10,20,30
67,BUD,P009214,0 days 00:07:34,-5,15,20
68,TRN,P012593,0 days 00:26:19,-23,44,67
68,TRN,P005738,0 days 00:23:53,-32,39,71
68,TRN,P009903,0 days 00:22:00,-27,30,57
68,TRN,P012597,0 days 00:21:50,-32,34,66
68,TRN,P001479,0 days 00:20:16,-8,32,40
68,TRN,P006382,0 days 00:17:53,-3,27,30
68,TRN,P007828,0 days 00:16:00,-1,33,34
68,TRN,P005059,0 days 00:14:25,-18,15,33
68,TRN,P012595,0 days 00:13:58,-18,15,33
68,TRN,P012596,0 days 00:13:51,-9,19,28
68,TRN,P012594,0 days 00:09:35,-19,12,31
68,CLU,P004862,0 days 00:27:44,25,67,42
68,CLU,P011797,0 days 00:26:54,33,67,34
68,CLU,P012621,0 days 00:24:44,18,55,37
68,CLU,P011801,0 days 00:19:11,22,50,28
68,CLU,P005113,0 days 00:18:16,14,35,21
68,CLU,P005373,0 days 00:17:35,22,50,28
68,CLU,P010569,0 days 00:17:05,10,41,31
68,CLU,P005714,0 days 00:16:14,12,41,29
68,CLU,P012698,0 days 00:15:04,16,36,20
68,CLU,P012620,0 days 00:13:21,10,34,24
68,CLU,P010997,0 days 00:01:56,4,7,3
68,CLU,P011907,0 days 00:01:56,4,7,3
69,CAN,P005005,0 days 00:24:51,-12,51,63
69,CAN,P001607,0 days 00:22:55,13,56,43
69,CAN,P003637,0 days 00:18:57,-1,44,45
69,CAN,P010484,0 days 00:18:10,-5,38,43
69,CAN,P007644,0 days 00:18:01,14,47,33
69,CAN,P010452,0 days 00:17:40,2,34,32
69,CAN,P007560,0 days 00:17:32,-1,30,31
69,CAN,P003425,0 days 00:15:19,-1,25,26
69,CAN,P010385,0 days 00:13:40,13,32,19
69,CAN,P008121,0 days 00:12:41,11,25,14
69,CAN,P009864,0 days 00:12:29,-16,11,27
69,CAN,P004160,0 days 00:07:45,3,12,9
69,WRO,P011165,0 days 00:32:13,3,69,66
69,WRO,P012010,0 days 00:27:22,-13,46,59
69,WRO,P009896,0 days 00:25:21,12,52,40
69,WRO,P005531,0 days 00:22:39,-19,30,49
69,WRO,P011900,0 days 00:20:38,-4,41,45
69,WRO,P003034,0 days 00:18:26,-15,29,44
69,WRO,P011902,0 days 00:18:17,11,45,34
69,WRO,P012699,0 days 00:16:03,2,36,34
69,WRO,P012736,0 days 00:10:38,-13,11,24
69,WRO,P011901,0 days 00:08:23,16,26,10
70,LKB,PLXI,0 days 00:40:39,5,81,76
70,LKB,P008856,0 days 00:40:25,17,85,68
70,LKB,P005521,0 days 00:36:01,19,83,64
70,LKB,P002012,0 days 00:32:44,19,79,60
70,LKB,P006230,0 days 00:30:20,9,63,54
70,LKB,P010461,0 days 00:14:04,3,30,27
70,LKB,P010190,0 days 00:13:34,-22,18,40
70,LKB,P004868,0 days 00:12:52,-17,14,31
70,LKB,P006901,0 days 00:04:21,2,12,10
70,TTK,P011925,0 days 00:41:21,-6,80,86
70,TTK,P005000,0 days 00:38:12,-11,73,84
70,TTK,P011239,0 days 00:37:53,-3,70,73
70,TTK,P012056,0 days 00:35:29,0,70,70
70,TTK,P006693,0 days 00:20:59,1,43,42
70,TTK,P011834,0 days 00:18:45,-7,25,32
70,TTK,P012697,0 days 00:14:24,-5,25,30
70,TTK,P005685,0 days 00:07:07,-4,16,20
70,TTK,P009845,0 days 00:06:59,6,20,14
70,TTK,P011975,0 days 00:03:51,-6,8,14
71,PMT,P002644,0 days 00:30:39,11,71,60
71,PMT,P011947,0 days 00:26:08,6,59,53
71,PMT,P001686,0 days 00:25:37,2,52,50
71,PMT,P011966,0 days 00:24:50,0,53,53
71,PMT,P011944,0 days 00:23:57,4,51,47
71,PMT,P011943,0 days 00:20:10,8,46,38
71,PMT,P011823,0 days 00:16:07,2,38,36
71,PMT,P010549,0 days 00:12:54,-2,29,31
71,PMT,P012600,0 days 00:12:01,5,29,24
71,PMT,P002020,0 days 00:07:37,-1,17,18
71,VNC,P012591,0 days 00:34:16,-13,66,79
71,VNC,P012587,0 days 00:27:13,-4,57,61
71,VNC,P008052,0 days 00:26:43,-3,56,59
71,VNC,P009400,0 days 00:26:25,-2,54,56
71,VNC,P003759,0 days 00:25:31,-6,51,57
71,VNC,P000968,0 days 00:24:03,-7,48,55
71,VNC,P011928,0 days 00:22:50,-1,49,50
71,VNC,P004117,0 days 00:12:59,1,29,28
72,HAM,P009663,0 days 00:27:37,-11,47,58
72,HAM,P011187,0 days 00:24:28,2,47,45
72,HAM,P012580,0 days 00:23:45,-7,40,47
72,HAM,P012579,0 days 00:23:42,-1,45,46
72,HAM,P010070,0 days 00:22:46,-2,42,44
72,HAM,P012581,0 days 00:19:25,-9,36,45
72,HAM,P001990,0 days 00:15:55,-11,26,37
72,HAM,P012582,0 days 00:14:22,-12,22,34
72,HAM,P012648,0 days 00:12:26,-7,21,28
72,HAM,P012695,0 days 00:12:00,-6,22,28
72,HAM,P012694,0 days 00:03:34,-1,7,8
72,WOL,P012577,0 days 00:30:39,13,64,51
72,WOL,P004645,0 days 00:26:34,18,59,41
72,WOL,P005516,0 days 00:25:40,2,49,47
72,WOL,P002387,0 days 00:22:19,1,43,42
72,WOL,P006154,0 days 00:21:17,17,55,38
72,WOL,P003212,0 days 00:18:50,8,37,29
72,WOL,P012576,0 days 00:18:40,11,40,29
72,WOL,PLCT,0 days 00:13:40,1,29,28
72,WOL,P006907,0 days 00:11:40,-4,19,23
72,WOL,P004229,0 days 00:10:41,-2,25,27
73,LLI,P009680,0 days 00:34:16,8,89,81
73,LLI,P012586,0 days 00:31:29,12,85,73
73,LLI,P005247,0 days 00:28:54,-7,59,66
73,LLI,P006600,0 days 00:27:42,11,77,66
73,LLI,P012585,0 days 00:26:10,13,79,66
73,LLI,P004773,0 days 00:25:58,2,64,62
73,LLI,P012020,0 days 00:10:13,0,21,21
73,LLI,P008274,0 days 00:10:05,-2,22,24
73,LLI,P003850,0 days 00:05:10,-7,9,16
73,LLI,P012584,0 days 00:00:03,0,0,0
73,LJU,P003452,0 days 00:34:43,2,83,81
73,LJU,P002661,0 days 00:31:01,-3,82,85
73,LJU,P005969,0 days 00:30:57,-4,75,79
73,LJU,P012700,0 days 00:28:25,-9,67,76
73,LJU,P007066,0 days 00:25:31,-1,62,63
73,LJU,P012598,0 days 00:20:02,-11,43,54
73,LJU,P010594,0 days 00:11:54,1,28,27
73,LJU,P009392,0 days 00:10:23,-3,19,22
73,LJU,P011261,0 days 00:05:01,-3,13,16
73,LJU,P001235,0 days 00:02:03,1,3,2
74,PRS,P012609,0 days 00:29:03,-5,45,50
74,PRS,P012608,0 days 00:27:18,-11,35,46
74,PRS,P012610,0 days 00:25:37,-11,33,44
74,PRS,P012640,0 days 00:22:45,0,38,38
74,PRS,P012613,0 days 00:20:38,-3,30,33
74,PRS,P005793,0 days 00:19:49,-1,34,35
74,PRS,P012611,0 days 00:18:54,3,38,35
74,PRS,P004512,0 days 00:16:50,-5,25,30
74,PRS,P003481,0 days 00:12:50,4,28,24
74,PRS,P012612,0 days 00:06:16,4,9,5
74,BES,P011936,0 days 00:27:20,-7,45,52
74,BES,P012622,0 days 00:26:56,7,47,40
74,BES,P007914,0 days 00:26:34,8,55,47
74,BES,P009582,0 days 00:23:55,6,34,28
74,BES,P008945,0 days 00:20:11,6,31,25
74,BES,P003783,0 days 00:19:49,-1,37,38
74,BES,P012647,0 days 00:18:39,3,32,29
74,BES,P005348,0 days 00:15:13,6,23,17
74,BES,P011379,0 days 00:10:31,-5,13,18
74,BES,P011357,0 days 00:09:13,5,21,16
74,BES,P007917,0 days 00:01:39,-3,2,5
75,HTA,P011991,0 days 00:34:37,1,89,88
75,HTA,P007759,0 days 00:34:07,5,89,84
75,HTA,P011973,0 days 00:30:52,10,83,73
75,HTA,P006835,0 days 00:29:21,7,78,71
75,HTA,P010465,0 days 00:26:58,-4,67,71
75,HTA,P004846,0 days 00:23:53,7,64,57
75,HTA,P003533,0 days 00:09:08,-6,20,26
75,HTA,P004267,0 days 00:07:33,0,16,16
75,HTA,P011990,0 days 00:03:31,0,9,9
75,JOV,P005094,0 days 00:34:48,-8,81,89
75,JOV,P011247,0 days 00:32:43,0,77,77
75,JOV,P011248,0 days 00:31:13,-4,75,79
75,JOV,P012780,0 days 00:29:26,12,80,68
75,JOV,P006771,0 days 00:19:35,12,54,42
75,JOV,PJUG,0 days 00:14:47,-4,40,44
75,JOV,P010161,0 days 00:13:23,-12,27,39
75,JOV,P012349,0 days 00:10:45,-10,26,36
75,JOV,P009572,0 days 00:08:32,-4,24,28
75,JOV,P010708,0 days 00:04:48,-2,11,13
76,BOU,P011837,0 days 00:30:09,24,64,40
76,BOU,P010718,0 days 00:28:51,24,64,40
76,BOU,P011836,0 days 00:23:41,22,52,30
76,BOU,P010431,0 days 00:23:06,16,45,29
76,BOU,P012617,0 days 00:21:35,12,42,30
76,BOU,P011161,0 days 00:19:47,-5,44,49
76,BOU,P000498,0 days 00:18:25,7,44,37
76,BOU,P004525,0 days 00:16:19,-3,34,37
76,BOU,P012619,0 days 00:09:51,-5,22,27
76,BOU,P012628,0 days 00:06:23,-3,13,16
76,BOU,P010450,0 days 00:01:53,6,6,0
76,TTK,P005000,0 days 00:37:22,-10,67,77
76,TTK,P011239,0 days 00:34:56,-3,61,64
76,TTK,P006693,0 days 00:29:49,-2,59,61
76,TTK,P011925,0 days 00:29:27,-10,41,51
76,TTK,P011834,0 days 00:23:58,-8,46,54
76,TTK,P004801,0 days 00:22:48,-14,35,49
76,TTK,P012697,0 days 00:07:45,-17,2,19
76,TTK,P009845,0 days 00:07:18,-15,12,27
76,TTK,P000497,0 days 00:04:20,-11,7,18
76,TTK,P011975,0 days 00:02:17,-5,5,10
77,WRO,P005531,0 days 00:34:17,-3,67,70
77,WRO,P012010,0 days 00:32:26,-6,61,67
77,WRO,P012699,0 days 00:28:52,-3,55,58
77,WRO,P011900,0 days 00:28:39,5,56,51
77,WRO,P009896,0 days 00:22:55,0,47,47
77,WRO,P012736,0 days 00:18:25,-4,26,30
77,WRO,P003034,0 days 00:16:57,-4,24,28
77,WRO,P011902,0 days 00:09:55,-7,9,16
77,WRO,P011901,0 days 00:07:34,2,10,8
77,LKB,PLXI,0 days 00:31:08,6,60,54
77,LKB,P008856,0 days 00:28:15,9,59,50
77,LKB,P002012,0 days 00:25:07,18,59,41
77,LKB,P007029,0 days 00:23:18,-15,32,47
77,LKB,P005521,0 days 00:22:56,18,55,37
77,LKB,P010461,0 days 00:20:24,-6,37,43
77,LKB,P004868,0 days 00:19:31,10,38,28
77,LKB,P006901,0 days 00:14:53,-14,16,30
77,LKB,P010190,0 days 00:14:28,-6,19,25
78,CLU,P012698,0 days 00:28:02,-11,52,63
78,CLU,P004862,0 days 00:26:06,-27,40,67
78,CLU,P012621,0 days 00:25:45,-1,51,52
78,CLU,P011801,0 days 00:25:24,-15,45,60
78,CLU,P005113,0 days 00:24:44,-2,48,50
78,CLU,P005714,0 days 00:23:16,-15,40,55
78,CLU,P010569,0 days 00:21:49,-16,36,52
78,CLU,P011797,0 days 00:14:56,-7,25,32
78,CLU,P005373,0 days 00:09:54,-14,13,27
78,CLU,P012620,0 days 00:00:04,-2,0,2
78,CAN,P003425,0 days 00:26:01,17,58,41
78,CAN,P007644,0 days 00:25:44,22,66,44
78,CAN,P004160,0 days 00:25:12,19,54,35
78,CAN,P003637,0 days 00:21:32,-1,40,41
78,CAN,P007560,0 days 00:19:05,23,54,31
78,CAN,P010452,0 days 00:18:36,-1,33,34
78,CAN,P005005,0 days 00:16:53,2,40,38
78,CAN,P009864,0 days 00:16:37,6,43,37
78,CAN,P010385,0 days 00:14:36,20,34,14
78,CAN,P001607,0 days 00:13:59,5,34,29
78,CAN,P010484,0 days 00:01:45,-2,4,6
79,BUD,P010248,0 days 00:33:08,-2,73,75
79,BUD,P011935,0 days 00:30:09,10,68,58
79,BUD,P012606,0 days 00:28:35,-8,64,72
79,BUD,P007398,0 days 00:24:07,-2,52,54
79,BUD,P012630,0 days 00:22:40,17,48,31
79,BUD,P002740,0 days 00:21:54,1,48,47
79,BUD,P012605,0 days 00:16:25,10,34,24
79,BUD,P004945,0 days 00:16:20,-1,42,43
79,BUD,P010432,0 days 00:11:52,4,25,21
79,BUD,P009214,0 days 00:10:40,-3,24,27
79,BUD,P006566,0 days 00:04:59,-11,6,17
79,BUD,P004397,0 days 00:04:11,-5,6,11
79,TRN,P012597,0 days 00:37:03,4,83,79
79,TRN,P012595,0 days 00:31:26,-15,61,76
79,TRN,P009903,0 days 00:29:50,9,74,65
79,TRN,P005738,0 days 00:27:55,12,76,64
79,TRN,P012594,0 days 00:26:11,15,62,47
79,TRN,P001479,0 days 00:17:05,-14,20,34
79,TRN,P006382,0 days 00:16:18,-14,27,41
79,TRN,P012593,0 days 00:15:58,13,40,27
79,TRN,P012596,0 days 00:15:10,-11,22,33
79,TRN,P007828,0 days 00:08:04,-9,15,24
80,ARI,P012707,0 days 00:35:08,1,76,75
80,ARI,P003240,0 days 00:30:58,-11,63,74
80,ARI,P012708,0 days 00:28:34,-21,49,70
80,ARI,P012716,0 days 00:26:54,-4,53,57
80,ARI,P004292,0 days 00:25:47,-5,49,54
80,ARI,P012702,0 days 00:25:36,-12,46,58
80,ARI,P002867,0 days 00:22:21,-6,41,47
80,ARI,P010387,0 days 00:10:52,2,23,21
80,ARI,P012722,0 days 00:10:23,3,22,19
80,ARI,P012760,0 days 00:08:27,-2,18,20
80,ULM,P010106,0 days 00:35:36,11,82,71
80,ULM,P010582,0 days 00:33:48,13,79,66
80,ULM,P005422,0 days 00:29:35,9,64,55
80,ULM,P012603,0 days 00:26:51,19,67,48
80,ULM,P012604,0 days 00:25:25,8,59,51
80,ULM,P011457,0 days 00:20:03,-9,32,41
80,ULM,P007952,0 days 00:17:41,8,39,31
80,ULM,P006997,0 days 00:13:22,-5,29,34
80,ULM,P010726,0 days 00:13:15,1,27,26
80,ULM,P012703,0 days 00:09:24,0,17,17
81,JOV,P011248,0 days 00:29:30,-6,49,55
81,JOV,P002361,0 days 00:26:10,15,59,44
81,JOV,P012349,0 days 00:23:04,11,50,39
81,JOV,P011247,0 days 00:20:05,-13,28,41
81,JOV,P012780,0 days 00:17:39,-17,25,42
81,JOV,P005094,0 days 00:16:56,-8,29,37
81,JOV,P010708,0 days 00:15:35,23,43,20
81,JOV,P006771,0 days 00:14:03,12,34,22
81,JOV,P010161,0 days 00:13:49,-11,20,31
81,JOV,PJUG,0 days 00:10:38,12,32,20
81,JOV,P002507,0 days 00:06:46,-3,11,14
81,JOV,P009572,0 days 00:05:45,0,15,15
81,PMT,P002644,0 days 00:30:00,2,56,54
81,PMT,P012600,0 days 00:26:14,-4,48,52
81,PMT,P011947,0 days 00:25:09,0,50,50
81,PMT,P011944,0 days 00:23:30,4,45,41
81,PMT,P001686,0 days 00:20:17,-7,34,41
81,PMT,P011966,0 days 00:18:05,-5,35,40
81,PMT,P010549,0 days 00:17:59,-1,30,31
81,PMT,P011823,0 days 00:17:45,-9,35,44
81,PMT,P002020,0 days 00:11:58,8,27,19
81,PMT,P011943,0 days 00:09:03,-3,20,23
82,HTA,P011991,0 days 00:29:44,6,64,58
82,HTA,P007759,0 days 00:28:54,5,63,58
82,HTA,P011973,0 days 00:28:08,-1,52,53
82,HTA,P010465,0 days 00:26:30,-1,48,49
82,HTA,P004846,0 days 00:22:15,1,47,46
82,HTA,P010550,0 days 00:20:43,10,40,30
82,HTA,P006835,0 days 00:20:41,-6,43,49
82,HTA,P003533,0 days 00:11:52,7,29,22
82,HTA,P004267,0 days 00:11:13,9,19,10
82,BES,P012622,0 days 00:31:20,-4,56,60
82,BES,P012647,0 days 00:29:02,0,54,54
82,BES,P008945,0 days 00:28:24,-5,53,58
82,BES,P009582,0 days 00:23:05,-10,39,49
82,BES,P011936,0 days 00:22:24,-2,40,42
82,BES,P007914,0 days 00:19:10,-7,40,47
82,BES,P003783,0 days 00:19:01,-1,36,37
82,BES,P007917,0 days 00:11:06,1,23,22
82,BES,P011379,0 days 00:09:02,-1,21,22
82,BES,P005348,0 days 00:05:55,1,13,12
82,BES,P011357,0 days 00:01:31,-2,0,2
83,LJU,P003452,0 days 00:35:24,-11,68,79
83,LJU,P012700,0 days 00:30:38,-15,63,78
83,LJU,P005969,0 days 00:29:31,-9,61,70
83,LJU,P002661,0 days 00:28:41,-12,58,70
83,LJU,P007066,0 days 00:24:42,-3,47,50
83,LJU,P012598,0 days 00:17:41,-4,35,39
83,LJU,P011261,0 days 00:12:30,-8,18,26
83,LJU,P009392,0 days 00:11:23,-5,19,24
83,LJU,P003042,0 days 00:06:24,-9,8,17
83,LJU,P010594,0 days 00:03:06,-4,8,12
83,PRS,P012609,0 days 00:29:47,7,62,55
83,PRS,P012608,0 days 00:25:34,16,59,43
83,PRS,P012610,0 days 00:25:34,16,59,43
83,PRS,P005793,0 days 00:23:31,4,54,50
83,PRS,P012613,0 days 00:22:22,-2,43,45
83,PRS,P012640,0 days 00:19:07,17,50,33
83,PRS,P011887,0 days 00:16:57,5,48,43
83,PRS,P009556,0 days 00:14:26,0,34,34
83,PRS,P004512,0 days 00:13:38,5,24,19
83,PRS,P012612,0 days 00:08:12,12,29,17
83,PRS,P010801,0 days 00:00:52,0,3,3
84,WOL,P012577,0 days 00:32:57,-14,73,87
84,WOL,P012576,0 days 00:31:19,-3,72,75
84,WOL,P005516,0 days 00:26:36,-4,54,58
84,WOL,PLCT,0 days 00:24:36,5,57,52
84,WOL,P006907,0 days 00:21:18,-21,38,59
84,WOL,P006154,0 days 00:21:09,-18,45,63
84,WOL,P003212,0 days 00:17:55,-14,43,57
84,WOL,P004645,0 days 00:15:29,10,38,28
84,WOL,P004229,0 days 00:08:41,-11,15,26
84,LLI,P012586,0 days 00:29:04,5,70,65
84,LLI,P006600,0 days 00:25:50,19,75,56
84,LLI,P009680,0 days 00:25:43,20,67,47
84,LLI,P005247,0 days 00:24:54,18,67,49
84,LLI,P012585,0 days 00:21:15,3,55,52
84,LLI,P009649,0 days 00:17:52,2,45,43
84,LLI,P004773,0 days 00:15:59,5,35,30
84,LLI,P009672,0 days 00:15:31,-10,37,47
84,LLI,P012020,0 days 00:14:07,-5,26,31
84,LLI,P004479,0 days 00:05:16,7,16,9
84,LLI,P008274,0 days 00:04:26,6,12,6
84,LLI,P012584,0 days 00:00:03,0,0,0
85,VNC,P012591,0 days 00:26:56,16,63,47
85,VNC,P011928,0 days 00:26:46,6,56,50
85,VNC,P004381,0 days 00:25:10,17,63,46
85,VNC,P008052,0 days 00:24:46,19,63,44
85,VNC,P011909,0 days 00:24:45,14,54,40
85,VNC,P009400,0 days 00:18:54,11,48,37
85,VNC,P012587,0 days 00:18:48,1,44,43
85,VNC,P003759,0 days 00:15:51,4,40,36
85,VNC,P000968,0 days 00:14:50,0,31,31
85,VNC,P012588,0 days 00:02:15,-2,4,6
85,VNC,P012493,0 days 00:00:59,-1,4,5
85,HAM,P012582,0 days 00:31:47,-8,67,75
85,HAM,P009663,0 days 00:24:50,-14,47,61
85,HAM,P011168,0 days 00:23:49,-24,40,64
85,HAM,P012580,0 days 00:21:36,-22,36,58
85,HAM,P012581,0 days 00:18:57,-16,31,47
85,HAM,P010070,0 days 00:17:59,2,44,42
85,HAM,P012579,0 days 00:15:08,-3,33,36
85,HAM,P011187,0 days 00:14:34,-1,30,31
85,HAM,P001990,0 days 00:12:26,1,25,24
85,HAM,P012648,0 days 00:09:19,2,16,14
85,HAM,P012694,0 days 00:06:03,-6,6,12
85,HAM,P012695,0 days 00:03:32,4,10,6
86,ULM,P012604,0 days 00:33:57,-3,71,74
86,ULM,P010582,0 days 00:28:28,-8,55,63
86,ULM,P005422,0 days 00:28:06,-3,54,57
86,ULM,P012603,0 days 00:26:47,-2,65,67
86,ULM,P010106,0 days 00:26:45,-11,55,66
86,ULM,P011457,0 days 00:18:33,11,42,31
86,ULM,P012703,0 days 00:16:31,0,31,31
86,ULM,P012629,0 days 00:12:58,-2,32,34
86,ULM,P011391,0 days 00:05:31,-2,11,13
86,ULM,P010726,0 days 00:02:24,-5,4,9
86,BOU,P010718,0 days 00:26:12,-8,54,62
86,BOU,P011836,0 days 00:25:52,-5,53,58
86,BOU,P012617,0 days 00:25:17,7,58,51
86,BOU,P010431,0 days 00:24:54,20,65,45
86,BOU,P011837,0 days 00:22:24,5,52,47
86,BOU,P004525,0 days 00:21:38,9,57,48
86,BOU,P011161,0 days 00:16:35,-4,34,38
86,BOU,P000498,0 days 00:13:56,-2,31,33
86,BOU,P012628,0 days 00:13:06,2,25,23
86,BOU,P012619,0 days 00:10:06,1,16,15
87,TRN,P012597,0 days 00:31:13,5,59,54
87,TRN,P012595,0 days 00:26:06,3,43,40
87,TRN,P005738,0 days 00:23:33,1,41,40
87,TRN,P009903,0 days 00:23:17,1,37,36
87,TRN,P012593,0 days 00:22:45,-2,38,40
87,TRN,P007828,0 days 00:19:25,7,36,29
87,TRN,P006382,0 days 00:17:26,-3,31,34
87,TRN,P012596,0 days 00:16:43,1,32,31
87,TRN,P001479,0 days 00:16:27,1,28,27
87,TRN,P012687,0 days 00:03:05,-4,0,4
87,ARI,P003240,0 days 00:33:45,-4,58,62
87,ARI,P012716,0 days 00:33:43,1,61,60
87,ARI,P012707,0 days 00:29:37,0,47,47
87,ARI,P002867,0 days 00:24:13,-2,45,47
87,ARI,P012702,0 days 00:17:30,6,37,31
87,ARI,P012717,0 days 00:15:36,-5,21,26
87,ARI,P012722,0 days 00:12:50,0,21,21
87,ARI,P012616,0 days 00:12:07,-8,12,20
87,ARI,P012760,0 days 00:09:40,-8,9,17
87,ARI,P010387,0 days 00:07:19,2,14,12
87,ARI,P010177,0 days 00:03:40,8,10,2
88,CAN,P004160,0 days 00:24:07,22,60,38
88,CAN,P001607,0 days 00:22:40,23,58,35
88,CAN,P007644,0 days 00:21:23,16,54,38
88,CAN,P009864,0 days 00:20:58,10,46,36
88,CAN,P008121,0 days 00:18:36,8,44,36
88,CAN,P003425,0 days 00:17:03,7,39,32
88,CAN,P010385,0 days 00:16:48,20,47,27
88,CAN,P010452,0 days 00:16:11,10,38,28
88,CAN,P003637,0 days 00:15:53,5,37,32
88,CAN,P005005,0 days 00:14:05,16,36,20
88,CAN,P007560,0 days 00:07:36,0,17,17
88,CAN,P010484,0 days 00:04:40,-2,9,11
88,BUD,P010248,0 days 00:28:37,-10,54,64
88,BUD,P002740,0 days 00:21:42,-13,43,56
88,BUD,P004397,0 days 00:21:30,4,43,39
88,BUD,P012606,0 days 00:21:17,-10,41,51
88,BUD,P007398,0 days 00:20:13,-12,36,48
88,BUD,P012605,0 days 00:20:10,-16,32,48
88,BUD,P004945,0 days 00:19:26,-14,32,46
88,BUD,P006566,0 days 00:17:20,-19,26,45
88,BUD,P011935,0 days 00:13:44,-22,20,42
88,BUD,P010432,0 days 00:11:23,-17,16,33
88,BUD,P009214,0 days 00:04:38,-6,7,13
89,CLU,P010569,0 days 00:32:50,21,97,76
89,CLU,P004862,0 days 00:30:01,6,88,82
89,CLU,P011801,0 days 00:29:54,0,79,79
89,CLU,P012698,0 days 00:27:08,-2,70,72
89,CLU,P011797,0 days 00:26:24,16,79,63
89,CLU,P005113,0 days 00:21:57,2,57,55
89,CLU,P005373,0 days 00:20:33,10,56,46
89,CLU,P005714,0 days 00:13:54,-11,30,41
89,CLU,P012621,0 days 00:13:07,5,28,23
89,CLU,P012620,0 days 00:09:12,-2,16,18
89,LKB,P007029,0 days 00:36:39,6,101,95
89,LKB,PLXI,0 days 00:35:09,-13,87,100
89,LKB,P002012,0 days 00:33:50,-1,87,88
89,LKB,P005521,0 days 00:30:33,-9,78,87
89,LKB,P010461,0 days 00:26:31,2,69,67
89,LKB,P008856,0 days 00:19:30,-13,40,53
89,LKB,P004868,0 days 00:16:23,-11,32,43
89,LKB,P010190,0 days 00:15:39,-1,37,38
89,LKB,P006901,0 days 00:10:46,-5,24,29
90,TTK,P011925,0 days 00:33:11,-6,61,67
90,TTK,P011239,0 days 00:30:28,-3,55,58
90,TTK,P006693,0 days 00:26:05,10,50,40
90,TTK,P004801,0 days 00:25:40,-12,36,48
90,TTK,P012697,0 days 00:23:19,-7,47,54
90,TTK,P005000,0 days 00:22:18,-14,32,46
90,TTK,P011834,0 days 00:18:09,-14,29,43
90,TTK,P000497,0 days 00:07:24,2,15,13
90,TTK,P009845,0 days 00:04:49,0,9,9
90,TTK,P005685,0 days 00:04:43,-6,7,13
90,TTK,P011975,0 days 00:03:54,5,14,9
90,WRO,P005531,0 days 00:35:32,14,71,57
90,WRO,P011900,0 days 00:33:19,5,69,64
90,WRO,P012699,0 days 00:33:16,-1,59,60
90,WRO,P003034,0 days 00:22:39,19,56,37
90,WRO,P011901,0 days 00:21:24,14,50,36
90,WRO,P009896,0 days 00:17:11,-10,24,34
90,WRO,P007472,0 days 00:13:45,-4,23,27
90,WRO,P012736,0 days 00:10:52,-1,15,16
90,WRO,P012749,0 days 00:07:32,4,19,15
90,WRO,P011902,0 days 00:04:30,5,14,9
91,HAM,P012580,0 days 00:25:02,-13,42,55
91,HAM,P012581,0 days 00:23:37,-1,52,53
91,HAM,P011168,0 days 00:22:32,-12,40,52
91,HAM,P009663,0 days 00:21:08,-7,38,45
91,HAM,P010070,0 days 00:20:22,0,49,49
91,HAM,P012579,0 days 00:19:49,-4,48,52
91,HAM,P012582,0 days 00:19:10,-9,35,44
91,HAM,P011187,0 days 00:18:52,-7,45,52
91,HAM,P001990,0 days 00:17:28,-2,43,45
91,HAM,P012648,0 days 00:07:20,-14,13,27
91,HAM,P012694,0 days 00:04:40,-1,10,11
91,PMT,P012600,0 days 00:28:03,23,74,51
91,PMT,P001686,0 days 00:26:06,3,64,61
91,PMT,P011966,0 days 00:24:32,1,54,53
91,PMT,P002644,0 days 00:22:11,7,61,54
91,PMT,P010549,0 days 00:22:04,18,55,37
91,PMT,P011944,0 days 00:22:02,8,54,46
91,PMT,P011823,0 days 00:17:49,7,36,29
91,PMT,P011942,0 days 00:14:51,-8,35,43
91,PMT,P002020,0 days 00:13:54,11,33,22
91,PMT,P011947,0 days 00:08:28,0,19,19
92,VNC,P011928,0 days 00:31:10,2,81,79
92,VNC,P004381,0 days 00:26:36,-5,65,70
92,VNC,P012591,0 days 00:25:07,13,70,57
92,VNC,P008052,0 days 00:24:03,0,59,59
92,VNC,P012590,0 days 00:19:23,-13,38,51
92,VNC,P009400,0 days 00:19:15,-5,40,45
92,VNC,P011909,0 days 00:16:15,-3,34,37
92,VNC,P004117,0 days 00:13:42,-7,25,32
92,VNC,P000968,0 days 00:13:24,1,26,25
92,VNC,P003759,0 days 00:11:05,-3,17,20
92,LLI,P012585,0 days 00:31:22,-4,75,79
92,LLI,P009680,0 days 00:30:52,5,78,73
92,LLI,P006600,0 days 00:27:13,4,71,67
92,LLI,P005247,0 days 00:25:55,11,65,54
92,LLI,P009649,0 days 00:24:57,-2,59,61
92,LLI,P012586,0 days 00:22:24,-6,49,55
92,LLI,P008274,0 days 00:14:33,7,26,19
92,LLI,P012020,0 days 00:12:47,0,24,24
92,LLI,P009672,0 days 00:09:57,5,28,23
93,WOL,P005516,0 days 00:27:05,-18,57,75
93,WOL,P006154,0 days 00:23:56,-14,48,62
93,WOL,P012577,0 days 00:23:08,-23,42,65
93,WOL,P003212,0 days 00:22:04,-19,41,60
93,WOL,P004645,0 days 00:21:35,-11,44,55
93,WOL,P002387,0 days 00:19:52,-15,39,54
93,WOL,P004229,0 days 00:17:30,-20,31,51
93,WOL,PLCT,0 days 00:15:54,-13,35,48
93,WOL,P012576,0 days 00:15:26,-9,33,42
93,WOL,P012789,0 days 00:07:04,-2,15,17
93,WOL,P006907,0 days 00:06:26,-11,10,21
93,PRS,P012608,0 days 00:26:10,27,78,51
93,PRS,P012610,0 days 00:26:10,27,78,51
93,PRS,P005793,0 days 00:24:20,16,66,50
93,PRS,P012640,0 days 00:23:47,13,64,51
93,PRS,P012613,0 days 00:22:36,10,57,47
93,PRS,P011887,0 days 00:18:16,17,49,32
93,PRS,P004512,0 days 00:17:11,21,51,30
93,PRS,P009556,0 days 00:13:50,4,32,28
93,PRS,P011232,0 days 00:12:10,4,28,24
93,PRS,P012609,0 days 00:11:16,10,29,19
93,PRS,P010801,0 days 00:02:07,3,9,6
93,PRS,P011551,0 days 00:02:07,3,9,6
94,LJU,P003452,0 days 00:36:58,-16,74,90
94,LJU,P012700,0 days 00:36:21,-13,73,86
94,LJU,P009395,0 days 00:34:48,-3,70,73
94,LJU,P005969,0 days 00:26:36,-11,51,62
94,LJU,P011261,0 days 00:23:27,-10,51,61
94,LJU,P012598,0 days 00:18:36,-5,35,40
94,LJU,P010594,0 days 00:12:21,-1,31,32
94,LJU,P009392,0 days 00:08:28,-8,13,21
94,LJU,P003042,0 days 00:02:25,-8,2,10
94,HTA,P011991,0 days 00:30:53,19,77,58
94,HTA,P010465,0 days 00:26:11,11,61,50
94,HTA,P011973,0 days 00:25:04,-1,50,51
94,HTA,P007759,0 days 00:23:38,-1,48,49
94,HTA,P004846,0 days 00:22:28,7,53,46
94,HTA,P006835,0 days 00:20:49,20,57,37
94,HTA,P010550,0 days 00:20:22,-3,43,46
94,HTA,P004267,0 days 00:16:50,9,46,37
94,HTA,P003533,0 days 00:13:45,14,40,26
95,BES,P011936,0 days 00:31:35,2,72,70
95,BES,P008945,0 days 00:29:37,2,69,67
95,BES,P012647,0 days 00:25:35,-7,44,51
95,BES,P012622,0 days 00:25:24,1,49,48
95,BES,P009582,0 days 00:24:24,0,56,56
95,BES,P005348,0 days 00:16:29,-8,32,40
95,BES,P011379,0 days 00:14:29,1,25,24
95,BES,P007914,0 days 00:12:56,-3,24,27
95,BES,P003783,0 days 00:11:52,-13,12,25
95,BES,P011357,0 days 00:07:39,5,22,17
95,JOV,P011247,0 days 00:29:22,0,66,66
95,JOV,P011248,0 days 00:26:42,5,61,56
95,JOV,P005094,0 days 00:25:28,-1,54,55
95,JOV,P006771,0 days 00:24:09,-2,46,48
95,JOV,P002507,0 days 00:20:11,5,43,38
95,JOV,P012780,0 days 00:18:26,7,43,36
95,JOV,P012349,0 days 00:14:32,5,31,26
95,JOV,PJUG,0 days 00:14:22,5,33,28
95,JOV,P009572,0 days 00:11:44,2,19,17
95,JOV,P010708,0 days 00:09:53,-3,18,21
95,JOV,P010709,0 days 00:05:10,-3,11,14
95,JOV,P010161,0 days 00:00:01,0,0,0
96,WRO,P011900,0 days 00:33:08,-4,57,61
96,WRO,P012601,0 days 00:31:16,-7,47,54
96,WRO,P012699,0 days 00:31:05,-6,53,59
96,WRO,P011901,0 days 00:27:19,2,51,49
96,WRO,P009896,0 days 00:23:01,2,45,43
96,WRO,P012736,0 days 00:20:33,-14,22,36
96,WRO,P003034,0 days 00:16:51,-12,17,29
96,WRO,P007472,0 days 00:07:20,-2,13,15
96,WRO,P011278,0 days 00:05:49,-2,5,7
96,WRO,P012749,0 days 00:03:38,-2,5,7
96,BOU,P012617,0 days 00:25:14,8,55,47
96,BOU,P012628,0 days 00:22:34,-9,31,40
96,BOU,P000498,0 days 00:21:15,-5,28,33
96,BOU,P010718,0 days 00:20:45,8,48,40
96,BOU,P010450,0 days 00:19:58,-1,26,27
96,BOU,P004525,0 days 00:19:29,8,31,23
96,BOU,P010431,0 days 00:18:21,17,41,24
96,BOU,P012618,0 days 00:17:15,6,33,27
96,BOU,P011837,0 days 00:12:50,2,29,27
96,BOU,P011836,0 days 00:12:24,10,28,18
96,BOU,P012619,0 days 00:09:55,1,10,9
97,TTK,P011834,0 days 00:37:57,10,94,84
97,TTK,P011925,0 days 00:34:14,0,73,73
97,TTK,P006693,0 days 00:31:48,9,71,62
97,TTK,P004801,0 days 00:29:40,18,67,49
97,TTK,P011239,0 days 00:25:56,10,65,55
97,TTK,P005000,0 days 00:21:15,12,60,48
97,TTK,P005685,0 days 00:14:03,1,30,29
97,TTK,P009845,0 days 00:04:15,2,13,11
97,TTK,P011975,0 days 00:00:52,-7,2,9
97,CLU,P011801,0 days 00:27:57,-4,61,65
97,CLU,P010569,0 days 00:26:53,-3,60,63
97,CLU,P011797,0 days 00:25:57,-16,47,63
97,CLU,P012698,0 days 00:25:43,5,57,52
97,CLU,P004862,0 days 00:23:11,-14,48,62
97,CLU,P005373,0 days 00:21:43,0,44,44
97,CLU,P012621,0 days 00:19:30,-8,44,52
97,CLU,P005113,0 days 00:17:22,-11,36,47
97,CLU,P005714,0 days 00:11:44,-4,23,27
98,LKB,PLXI,0 days 00:30:25,-5,62,67
98,LKB,P007029,0 days 00:30:03,-3,58,61
98,LKB,P002012,0 days 00:28:54,6,61,55
98,LKB,P005521,0 days 00:28:10,-5,61,66
98,LKB,P008856,0 days 00:26:22,0,46,46
98,LKB,P006230,0 days 00:20:05,12,42,30
98,LKB,P010461,0 days 00:17:53,-11,37,48
98,LKB,P004868,0 days 00:09:49,-2,20,22
98,LKB,P010190,0 days 00:06:47,-2,16,18
98,LKB,P006901,0 days 00:01:32,0,2,2
98,BUD,P004945,0 days 00:27:19,2,58,56
98,BUD,P006566,0 days 00:26:30,2,62,60
98,BUD,P002740,0 days 00:26:07,5,57,52
98,BUD,P010248,0 days 00:25:10,3,58,55
98,BUD,P011281,0 days 00:22:02,3,46,43
98,BUD,P007398,0 days 00:15:18,-2,30,32
98,BUD,P010432,0 days 00:14:51,-4,25,29
98,BUD,P012606,0 days 00:14:26,1,28,27
98,BUD,P004397,0 days 00:13:42,-5,19,24
98,BUD,P011935,0 days 00:10:46,4,22,18
98,BUD,P012605,0 days 00:03:49,1,10,9
99,CAN,P007644,0 days 00:28:43,21,65,44
99,CAN,P004160,0 days 00:22:15,18,50,32
99,CAN,P008121,0 days 00:19:41,15,47,32
99,CAN,P003425,0 days 00:18:37,13,44,31
99,CAN,P001607,0 days 00:18:21,12,39,27
99,CAN,P003637,0 days 00:16:57,9,41,32
99,CAN,P010452,0 days 00:16:51,8,38,30
99,CAN,P005005,0 days 00:15:40,6,37,31
99,CAN,P010385,0 days 00:15:23,18,37,19
99,CAN,P009864,0 days 00:12:38,4,31,27
99,CAN,P007560,0 days 00:08:29,11,21,10
99,CAN,P010484,0 days 00:06:25,5,15,10
99,ARI,P012708,0 days 00:23:22,-13,41,54
99,ARI,P012717,0 days 00:22:58,-15,42,57
99,ARI,P004292,0 days 00:20:52,-18,39,57
99,ARI,P012702,0 days 00:20:12,-8,36,44
99,ARI,P012616,0 days 00:19:24,-19,30,49
99,ARI,P012707,0 days 00:19:10,-10,30,40
99,ARI,P012716,0 days 00:18:23,-7,31,38
99,ARI,P010387,0 days 00:17:02,-13,23,36
99,ARI,P002867,0 days 00:16:58,-17,20,37
99,ARI,P012722,0 days 00:14:50,-14,25,39
99,ARI,P012760,0 days 00:04:58,-6,4,10
99,ARI,P010177,0 days 00:01:51,0,4,4
100,TRN,P012597,0 days 00:31:35,-1,74,75
100,TRN,P012595,0 days 00:31:01,4,71,67
100,TRN,P005738,0 days 00:29:35,1,57,56
100,TRN,P009903,0 days 00:28:07,-11,57,68
100,TRN,P001479,0 days 00:22:18,6,52,46
100,TRN,P012593,0 days 00:21:48,-10,36,46
100,TRN,P012687,0 days 00:16:21,3,36,33
100,TRN,P006382,0 days 00:12:15,5,27,22
100,TRN,P007828,0 days 00:07:00,-7,5,12
100,ULM,P012603,0 days 00:29:05,6,71,65
100,ULM,P012604,0 days 00:26:24,3,54,51
100,ULM,P010106,0 days 00:22:42,-15,43,58
100,ULM,P005422,0 days 00:22:13,-3,55,58
100,ULM,P012629,0 days 00:20:30,1,40,39
100,ULM,P012703,0 days 00:19:49,18,47,29
100,ULM,P010582,0 days 00:18:49,11,39,28
100,ULM,P006997,0 days 00:15:27,-6,33,39
100,ULM,P010726,0 days 00:14:47,-5,29,34
100,ULM,P011457,0 days 00:10:14,0,14,14
101,PMT,P011943,0 days 00:30:07,24,67,43
101,PMT,P012600,0 days 00:27:58,2,57,55
101,PMT,P011966,0 days 00:26:48,29,73,44
101,PMT,P002644,0 days 00:22:45,11,49,38
101,PMT,P010549,0 days 00:22:21,23,53,30
101,PMT,P011947,0 days 00:19:16,17,48,31
101,PMT,P011823,0 days 00:17:38,10,42,32
101,PMT,P011944,0 days 00:16:11,-9,24,33
101,PMT,P001686,0 days 00:10:46,4,28,24
101,PMT,P002020,0 days 00:03:05,-8,2,10
101,PMT,P011942,0 days 00:03:05,-8,2,10
101,BES,P012622,0 days 00:28:38,-9,53,62
101,BES,P007914,0 days 00:28:04,-2,54,56
101,BES,P003783,0 days 00:25:30,-21,40,61
101,BES,P011936,0 days 00:22:16,-5,38,43
101,BES,P012647,0 days 00:20:52,3,39,36
101,BES,P008945,0 days 00:19:40,6,40,34
101,BES,P011924,0 days 00:17:52,-23,27,50
101,BES,P011379,0 days 00:15:02,-12,23,35
101,BES,P009582,0 days 00:13:09,-11,20,31
101,BES,P005348,0 days 00:05:07,-8,11,19
101,BES,P011357,0 days 00:03:50,-13,5,18
102,JOV,P011248,0 days 00:28:30,13,63,50
102,JOV,P011247,0 days 00:27:00,-8,50,58
102,JOV,P002507,0 days 00:22:06,4,41,37
102,JOV,P006771,0 days 00:20:30,3,43,40
102,JOV,P012349,0 days 00:19:40,2,38,36
102,JOV,P002361,0 days 00:17:40,13,44,31
102,JOV,P005094,0 days 00:16:55,-6,31,37
102,JOV,P010458,0 days 00:15:04,-2,36,38
102,JOV,PJUG,0 days 00:14:51,-4,30,34
102,JOV,P010708,0 days 00:13:03,1,29,28
102,JOV,P012780,0 days 00:04:41,-6,10,16
102,LJU,P009395,0 days 00:36:29,0,73,73
102,LJU,P005969,0 days 00:35:41,-1,72,73
102,LJU,P012700,0 days 00:32:23,5,68,63
102,LJU,P003452,0 days 00:30:28,-2,62,64
102,LJU,P010594,0 days 00:27:40,-3,55,58
102,LJU,P012598,0 days 00:13:54,1,32,31
102,LJU,P011261,0 days 00:13:08,-4,24,28
102,LJU,P009392,0 days 00:05:29,-5,10,15
102,LJU,P002561,0 days 00:04:48,-1,9,10
103,WOL,P005516,0 days 00:30:58,7,69,62
103,WOL,P012576,0 days 00:30:31,-2,66,68
103,WOL,P006546,0 days 00:25:38,-3,59,62
103,WOL,P012577,0 days 00:25:30,-9,47,56
103,WOL,P002387,0 days 00:25:06,-6,56,62
103,WOL,P003212,0 days 00:20:19,-13,39,52
103,WOL,P006154,0 days 00:15:57,0,27,27
103,WOL,P004645,0 days 00:12:35,-3,19,22
103,WOL,P012789,0 days 00:09:29,-6,15,21
103,WOL,PLCT,0 days 00:03:57,-5,8,13
103,HTA,P011991,0 days 00:34:38,15,81,66
103,HTA,P010465,0 days 00:31:40,18,77,59
103,HTA,P007759,0 days 00:29:20,6,62,56
103,HTA,P006835,0 days 00:24:18,8,61,53
103,HTA,P010550,0 days 00:22:05,3,44,41
103,HTA,P004846,0 days 00:18:25,2,44,42
103,HTA,P011973,0 days 00:17:28,-3,36,39
103,HTA,P004267,0 days 00:13:39,-1,28,29
103,HTA,P003533,0 days 00:08:27,-8,12,20
104,PRS,P012610,0 days 00:23:26,5,52,47
104,PRS,P012608,0 days 00:23:22,7,52,45
104,PRS,P012613,0 days 00:22:17,31,70,39
104,PRS,P012609,0 days 00:21:08,19,56,37
104,PRS,P011232,0 days 00:19:22,29,56,27
104,PRS,P012640,0 days 00:18:53,32,65,33
104,PRS,P005793,0 days 00:17:37,3,41,38
104,PRS,P009556,0 days 00:17:14,27,50,23
104,PRS,P004512,0 days 00:14:54,-5,28,33
104,PRS,P010801,0 days 00:10:00,4,13,9
104,PRS,P011887,0 days 00:07:50,-5,12,17
104,PRS,P011551,0 days 00:03:57,3,5,2
104,VNC,P011928,0 days 00:32:36,-28,56,84
104,VNC,P011909,0 days 00:30:41,-19,51,70
104,VNC,P012590,0 days 00:29:47,-25,50,75
104,VNC,P012591,0 days 00:28:14,-25,45,70
104,VNC,P012587,0 days 00:18:13,-10,36,46
104,VNC,P004381,0 days 00:16:07,-19,27,46
104,VNC,P003759,0 days 00:15:58,-8,27,35
104,VNC,P008052,0 days 00:14:58,-8,31,39
104,VNC,P009400,0 days 00:13:26,-8,27,35
105,LLI,P009680,0 days 00:31:36,-2,65,67
105,LLI,P006600,0 days 00:27:52,-6,56,62
105,LLI,P009649,0 days 00:26:42,-4,50,54
105,LLI,P009672,0 days 00:24:51,5,59,54
105,LLI,P012585,0 days 00:21:14,-7,42,49
105,LLI,P005247,0 days 00:20:49,5,42,37
105,LLI,P004773,0 days 00:19:37,-3,39,42
105,LLI,P008274,0 days 00:15:11,-2,27,29
105,LLI,P012020,0 days 00:12:08,4,25,21
105,HAM,P012582,0 days 00:28:42,13,66,53
105,HAM,P011168,0 days 00:25:11,9,46,37
105,HAM,P012581,0 days 00:24:47,7,52,45
105,HAM,P009663,0 days 00:24:02,9,57,48
105,HAM,P012580,0 days 00:23:23,0,47,47
105,HAM,P012579,0 days 00:20:19,-2,41,43
105,HAM,P011187,0 days 00:15:58,-7,26,33
105,HAM,P001990,0 days 00:13:24,1,37,36
105,HAM,P012648,0 days 00:10:58,1,26,25
105,HAM,P010070,0 days 00:10:34,-9,17,26
105,HAM,P012695,0 days 00:01:25,-8,0,8
105,HAM,P012694,0 days 00:01:17,-4,0,4
106,BOU,P011161,0 days 00:23:11,0,46,46
106,BOU,P012617,0 days 00:22:32,7,39,32
106,BOU,P010718,0 days 00:22:22,8,42,34
106,BOU,P011836,0 days 00:21:30,2,39,37
106,BOU,P010431,0 days 00:19:48,11,41,30
106,BOU,P004525,0 days 00:18:30,10,40,30
106,BOU,P010450,0 days 00:17:38,4,37,33
106,BOU,P011837,0 days 00:17:31,7,28,21
106,BOU,P012618,0 days 00:17:12,5,41,36
106,BOU,P000498,0 days 00:14:29,6,32,26
106,BOU,P012619,0 days 00:05:17,0,10,10
106,TRN,P012595,0 days 00:27:17,-3,49,52
106,TRN,P012597,0 days 00:25:30,1,43,42
106,TRN,P005738,0 days 00:25:23,-1,45,46
106,TRN,P009903,0 days 00:24:58,-15,31,46
106,TRN,P005059,0 days 00:19:24,-4,30,34
106,TRN,P012593,0 days 00:18:11,-11,33,44
106,TRN,P012594,0 days 00:16:33,-11,25,36
106,TRN,P012596,0 days 00:15:02,3,36,33
106,TRN,P001479,0 days 00:14:32,-9,22,31
106,TRN,P006382,0 days 00:10:49,-14,12,26
106,TRN,P007828,0 days 00:02:21,4,9,5
107,ULM,P012604,0 days 00:34:42,-1,76,77
107,ULM,P005422,0 days 00:32:28,-7,71,78
107,ULM,P010106,0 days 00:32:22,0,76,76
107,ULM,P010582,0 days 00:31:12,22,82,60
107,ULM,P012603,0 days 00:29:33,8,77,69
107,ULM,P012703,0 days 00:18:13,6,37,31
107,ULM,P006997,0 days 00:15:27,-4,26,30
107,ULM,P011457,0 days 00:12:55,6,33,27
107,ULM,P007952,0 days 00:10:18,5,27,22
107,ULM,P010726,0 days 00:07:50,-15,10,25
107,CAN,P008121,0 days 00:28:14,3,62,59
107,CAN,P001607,0 days 00:25:00,7,60,53
107,CAN,P010452,0 days 00:23:17,-14,39,53
107,CAN,P010385,0 days 00:23:04,0,51,51
107,CAN,P003637,0 days 00:22:44,-3,50,53
107,CAN,P009864,0 days 00:21:56,-4,48,52
107,CAN,P003425,0 days 00:18:58,-18,31,49
107,CAN,P005005,0 days 00:16:54,-7,37,44
107,CAN,P006588,0 days 00:16:30,11,48,37
107,CAN,P004160,0 days 00:14:41,5,35,30
107,CAN,P007560,0 days 00:08:37,1,22,21
107,CAN,P007644,0 days 00:05:05,-1,12,13
108,ARI,P003240,0 days 00:28:14,9,49,40
108,ARI,P004292,0 days 00:24:51,10,50,40
108,ARI,P012708,0 days 00:24:26,11,48,37
108,ARI,P012716,0 days 00:23:46,10,45,35
108,ARI,P012707,0 days 00:22:48,1,33,32
108,ARI,P012702,0 days 00:19:43,12,43,31
108,ARI,P012717,0 days 00:18:45,-9,27,36
108,ARI,P012616,0 days 00:14:43,3,19,16
108,ARI,P012760,0 days 00:14:30,-1,18,19
108,ARI,P012722,0 days 00:05:47,-2,8,10
108,ARI,P010387,0 days 00:02:27,1,5,4
108,LKB,P005521,0 days 00:34:23,2,58,56
108,LKB,P007029,0 days 00:29:42,-4,47,51
108,LKB,P002012,0 days 00:27:35,0,48,48
108,LKB,P010190,0 days 00:26:45,-9,34,43
108,LKB,P006230,0 days 00:20:37,2,33,31
108,LKB,P010461,0 days 00:19:23,-11,27,38
108,LKB,P006901,0 days 00:18:31,-11,21,32
108,LKB,P004868,0 days 00:15:21,-11,19,30
108,LKB,P011329,0 days 00:07:43,-3,13,16
109,BUD,P012606,0 days 00:28:42,-1,54,55
109,BUD,P010248,0 days 00:24:09,-27,41,68
109,BUD,P006566,0 days 00:23:21,-13,44,57
109,BUD,P004945,0 days 00:22:56,-18,37,55
109,BUD,P011935,0 days 00:22:01,-5,38,43
109,BUD,P007398,0 days 00:20:34,-13,38,51
109,BUD,P002740,0 days 00:20:32,-12,42,54
109,BUD,P010432,0 days 00:15:51,4,32,28
109,BUD,P009214,0 days 00:12:29,-13,26,39
109,BUD,P011281,0 days 00:09:25,-17,13,30
109,TTK,P006693,0 days 00:35:53,23,89,66
109,TTK,P011239,0 days 00:35:24,23,89,66
109,TTK,P011925,0 days 00:33:51,22,80,58
109,TTK,P011834,0 days 00:33:05,23,84,61
109,TTK,P004801,0 days 00:21:49,5,45,40
109,TTK,P005000,0 days 00:18:23,8,41,33
109,TTK,P000497,0 days 00:11:21,11,30,19
109,TTK,P005685,0 days 00:04:36,0,7,7
109,TTK,P009845,0 days 00:04:07,0,7,7
109,TTK,P011975,0 days 00:01:02,1,5,4
109,TTK,P012771,0 days 00:00:29,-1,3,4
110,CLU,P011801,0 days 00:25:12,1,51,50
110,CLU,P012621,0 days 00:24:59,-1,49,50
110,CLU,P004862,0 days 00:23:21,5,52,47
110,CLU,P012698,0 days 00:22:54,0,42,42
110,CLU,P010569,0 days 00:21:11,10,47,37
110,CLU,P005113,0 days 00:20:59,6,48,42
110,CLU,P005373,0 days 00:18:54,0,32,32
110,CLU,P005714,0 days 00:18:49,-6,33,39
110,CLU,P012620,0 days 00:13:30,1,22,21
110,CLU,P011797,0 days 00:10:11,4,24,20
110,WRO,P012699,0 days 00:33:10,-8,56,64
110,WRO,P012601,0 days 00:26:16,-1,56,57
110,WRO,P011900,0 days 00:26:11,2,61,59
110,WRO,P011901,0 days 00:25:13,8,60,52
110,WRO,P012736,0 days 00:24:44,-16,32,48
110,WRO,P009896,0 days 00:24:10,-6,44,50
110,WRO,P003034,0 days 00:19:01,6,38,32
110,WRO,P011278,0 days 00:09:12,-4,13,17
110,WRO,P012308,0 days 00:09:05,7,20,13
110,WRO,P007472,0 days 00:02:58,-8,0,8
111,LLI,P009680,0 days 00:32:16,7,79,72
111,LLI,P006600,0 days 00:30:07,4,72,68
111,LLI,P012585,0 days 00:28:15,6,69,63
111,LLI,P009672,0 days 00:27:25,5,65,60
111,LLI,P005247,0 days 00:26:57,-10,52,62
111,LLI,P009649,0 days 00:23:54,6,57,51
111,LLI,P004773,0 days 00:17:37,-8,30,38
111,LLI,P012020,0 days 00:09:41,-6,14,20
111,LLI,P008274,0 days 00:03:48,1,7,6
111,PMT,P002644,0 days 00:30:44,7,65,58
111,PMT,P012600,0 days 00:29:41,6,62,56
111,PMT,P001686,0 days 00:28:18,-1,72,73
111,PMT,P011944,0 days 00:27:33,-8,54,62
111,PMT,P010549,0 days 00:25:58,0,61,61
111,PMT,P011942,0 days 00:18:46,3,45,42
111,PMT,P002020,0 days 00:15:08,-3,30,33
111,PMT,P011966,0 days 00:14:35,-8,26,34
111,PMT,P011823,0 days 00:09:17,-1,25,26
112,PRS,P012609,0 days 00:24:22,25,70,45
112,PRS,P012640,0 days 00:23:21,22,67,45
112,PRS,P012608,0 days 00:22:26,9,69,60
112,PRS,P012610,0 days 00:22:26,9,69,60
112,PRS,P005793,0 days 00:20:02,4,56,52
112,PRS,P011232,0 days 00:19:58,25,64,39
112,PRS,P009556,0 days 00:17:34,20,51,31
112,PRS,P012613,0 days 00:15:31,14,41,27
112,PRS,P004512,0 days 00:15:10,13,51,38
112,PRS,P011887,0 days 00:09:51,2,34,32
112,PRS,P011551,0 days 00:09:19,2,28,26
112,HAM,P011168,0 days 00:25:15,-14,65,79
112,HAM,P012581,0 days 00:24:39,-27,55,82
112,HAM,P009663,0 days 00:23:45,-12,61,73
112,HAM,P012582,0 days 00:23:45,-11,56,67
112,HAM,P012580,0 days 00:22:49,-7,55,62
112,HAM,P012579,0 days 00:22:39,-7,53,60
112,HAM,P001990,0 days 00:16:35,-16,29,45
112,HAM,P011187,0 days 00:14:25,-16,27,43
112,HAM,P010070,0 days 00:12:37,-21,24,45
112,HAM,P012648,0 days 00:09:53,-17,19,36
112,HAM,P012694,0 days 00:03:38,3,11,8
113,HTA,P007759,0 days 00:33:20,9,79,70
113,HTA,P006835,0 days 00:32:32,8,75,67
113,HTA,P004846,0 days 00:30:56,27,86,59
113,HTA,P010465,0 days 00:29:06,1,64,63
113,HTA,P011973,0 days 00:26:06,30,77,47
113,HTA,P004267,0 days 00:17:47,29,61,32
113,HTA,P003533,0 days 00:13:54,-11,23,34
113,HTA,P011990,0 days 00:13:41,-4,29,33
113,HTA,P012028,0 days 00:01:19,3,3,0
113,HTA,P012706,0 days 00:01:05,3,3,0
113,HTA,P012793,0 days 00:00:14,0,0,0
113,VNC,P012590,0 days 00:31:34,-17,65,82
113,VNC,P012591,0 days 00:30:37,-6,65,71
113,VNC,P012587,0 days 00:26:45,-10,56,66
113,VNC,P003759,0 days 00:25:52,-10,52,62
113,VNC,P004117,0 days 00:25:22,-17,47,64
113,VNC,P011909,0 days 00:24:15,-14,47,61
113,VNC,P009400,0 days 00:22:48,-16,41,57
113,VNC,P008052,0 days 00:12:47,-5,32,37
114,WOL,P012577,0 days 00:34:13,-17,68,85
114,WOL,P004645,0 days 00:29:43,-23,53,76
114,WOL,P003212,0 days 00:23:57,-8,53,61
114,WOL,P006154,0 days 00:23:35,5,54,49
114,WOL,P005516,0 days 00:22:56,-12,37,49
114,WOL,P004229,0 days 00:20:01,6,49,43
114,WOL,P012576,0 days 00:18:00,-17,28,45
114,WOL,P006907,0 days 00:15:05,7,34,27
114,WOL,PLCT,0 days 00:09:08,-15,14,29
114,WOL,P012789,0 days 00:03:22,-1,5,6
114,JOV,P011247,0 days 00:28:43,22,78,56
114,JOV,P011248,0 days 00:25:42,11,57,46
114,JOV,P006771,0 days 00:24:40,14,59,45
114,JOV,P002361,0 days 00:24:17,-2,51,53
114,JOV,P002507,0 days 00:21:59,3,52,49
114,JOV,P010458,0 days 00:20:28,6,48,42
114,JOV,P012780,0 days 00:20:24,12,50,38
114,JOV,P012349,0 days 00:16:45,9,38,29
114,JOV,P010161,0 days 00:14:36,2,34,32
114,JOV,P010709,0 days 00:02:26,-2,3,5
115,LJU,P009395,0 days 00:36:17,-1,77,78
115,LJU,P005969,0 days 00:34:45,-5,71,76
115,LJU,P012700,0 days 00:34:00,-8,67,75
115,LJU,P003452,0 days 00:31:00,-3,67,70
115,LJU,P010594,0 days 00:21:34,-9,48,57
115,LJU,P009392,0 days 00:14:51,4,33,29
115,LJU,P011261,0 days 00:12:45,0,24,24
115,LJU,P002561,0 days 00:08:58,-2,17,19
115,LJU,P007066,0 days 00:05:50,-1,11,12
115,BES,P011936,0 days 00:32:38,4,71,67
115,BES,P012622,0 days 00:29:19,5,65,60
115,BES,P012647,0 days 00:29:10,-1,65,66
115,BES,P011924,0 days 00:21:22,-7,42,49
115,BES,P008945,0 days 00:20:57,14,53,39
115,BES,P007914,0 days 00:17:49,-3,32,35
115,BES,P009582,0 days 00:16:19,-10,30,40
115,BES,P005348,0 days 00:11:34,6,31,25
115,BES,P011379,0 days 00:10:50,6,23,17
115,BES,P007917,0 days 00:10:02,11,28,17
116,CLU,P011801,0 days 00:29:49,15,73,58
116,CLU,P004862,0 days 00:27:20,-17,64,81
116,CLU,P005714,0 days 00:24:27,-1,53,54
116,CLU,P011797,0 days 00:23:04,-6,54,60
116,CLU,P005373,0 days 00:22:22,8,58,50
116,CLU,P012621,0 days 00:20:58,-13,39,52
116,CLU,P010569,0 days 00:19:32,-7,42,49
116,CLU,P012698,0 days 00:18:21,-6,38,44
116,CLU,P005113,0 days 00:09:50,-21,16,37
116,CLU,P012620,0 days 00:04:17,3,8,5
116,BOU,P011836,0 days 00:26:14,11,66,55
116,BOU,P010431,0 days 00:25:21,8,60,52
116,BOU,P010450,0 days 00:21:18,2,53,51
116,BOU,P012628,0 days 00:20:37,-1,47,48
116,BOU,P012617,0 days 00:20:10,16,53,37
116,BOU,P012618,0 days 00:19:58,9,51,42
116,BOU,P000498,0 days 00:16:29,-1,38,39
116,BOU,P011161,0 days 00:16:05,3,43,40
116,BOU,P011837,0 days 00:15:27,-2,37,39
116,BOU,P004525,0 days 00:13:46,-2,32,34
116,BOU,P012619,0 days 00:04:35,2,10,8
117,WRO,P009896,0 days 00:31:16,9,69,60
117,WRO,P012699,0 days 00:30:07,3,68,65
117,WRO,P012601,0 days 00:28:13,2,58,56
117,WRO,P011900,0 days 00:27:04,-4,48,52
117,WRO,P011278,0 days 00:22:34,4,50,46
117,WRO,P012749,0 days 00:20:12,11,46,35
117,WRO,P011901,0 days 00:19:48,-12,33,45
117,WRO,P012736,0 days 00:07:52,-8,9,17
117,WRO,P003034,0 days 00:06:39,-10,6,16
117,WRO,P012308,0 days 00:03:52,2,4,2
117,WRO,P007472,0 days 00:02:23,-2,4,6
117,BUD,P011281,0 days 00:29:25,1,56,55
117,BUD,P010248,0 days 00:28:34,-2,53,55
117,BUD,P012606,0 days 00:22:43,17,57,40
117,BUD,P004397,0 days 00:22:43,3,45,42
117,BUD,P002740,0 days 00:20:03,14,45,31
117,BUD,P004945,0 days 00:17:49,-6,31,37
117,BUD,P011935,0 days 00:17:21,-5,35,40
117,BUD,P006566,0 days 00:15:37,-16,26,42
117,BUD,P007398,0 days 00:14:19,-4,25,29
117,BUD,P010432,0 days 00:11:26,3,27,24
118,TTK,P011834,0 days 00:33:35,-4,74,78
118,TTK,P011925,0 days 00:33:24,-7,72,79
118,TTK,P011239,0 days 00:31:56,-8,61,69
118,TTK,P005000,0 days 00:30:42,5,71,66
118,TTK,P006693,0 days 00:28:57,-8,60,68
118,TTK,P004801,0 days 00:22:50,-17,50,67
118,TTK,P000497,0 days 00:08:11,1,18,17
118,TTK,P011975,0 days 00:05:21,-4,11,15
118,TTK,P009845,0 days 00:02:55,-5,3,8
118,TTK,P005685,0 days 00:02:02,-1,5,6
118,TTK,P011978,0 days 00:00:07,-2,0,2
118,ARI,P012716,0 days 00:28:24,8,72,64
118,ARI,P004292,0 days 00:27:44,15,74,59
118,ARI,P012708,0 days 00:25:38,2,57,55
118,ARI,P012717,0 days 00:23:52,12,57,45
118,ARI,P003240,0 days 00:21:31,5,50,45
118,ARI,P012792,0 days 00:18:57,-2,40,42
118,ARI,P012760,0 days 00:17:21,6,46,40
118,ARI,P012702,0 days 00:14:12,7,36,29
118,ARI,P010387,0 days 00:11:58,1,23,22
118,ARI,P012722,0 days 00:08:27,-3,13,16
118,ARI,P012616,0 days 00:01:56,-1,7,8
119,LKB,P004664,0 days 00:33:16,11,82,71
119,LKB,P007029,0 days 00:32:12,2,75,73
119,LKB,P002012,0 days 00:27:06,-5,63,68
119,LKB,P006230,0 days 00:23:51,15,62,47
119,LKB,P006901,0 days 00:23:48,7,58,51
119,LKB,P010190,0 days 00:21:50,-9,47,56
119,LKB,P010461,0 days 00:16:05,-13,30,43
119,LKB,P004868,0 days 00:15:44,6,37,31
119,LKB,P005521,0 days 00:06:08,6,16,10
119,ULM,P005422,0 days 00:29:28,8,76,68
119,ULM,P012603,0 days 00:28:39,1,69,68
119,ULM,P010582,0 days 00:24:52,5,56,51
119,ULM,P012604,0 days 00:23:40,8,61,53
119,ULM,P012703,0 days 00:18:45,-6,42,48
119,ULM,P010726,0 days 00:18:11,-9,37,46
119,ULM,P010106,0 days 00:16:53,4,42,38
119,ULM,P006997,0 days 00:15:25,-12,25,37
119,ULM,P007952,0 days 00:12:06,-3,25,28
119,ULM,P011457,0 days 00:12:01,-16,17,33
120,CAN,P003425,0 days 00:24:55,-20,43,63
120,CAN,P006588,0 days 00:20:57,-4,44,48
120,CAN,P007560,0 days 00:19:35,-5,44,49
120,CAN,P008121,0 days 00:19:00,-13,43,56
120,CAN,P010385,0 days 00:17:11,0,40,40
120,CAN,P005005,0 days 00:16:58,-2,31,33
120,CAN,P007644,0 days 00:16:58,-18,22,40
120,CAN,P004160,0 days 00:16:25,-17,25,42
120,CAN,P001607,0 days 00:14:45,1,33,32
120,CAN,P009864,0 days 00:13:30,-15,23,38
120,CAN,P010452,0 days 00:11:24,-7,23,30
120,CAN,P003637,0 days 00:08:22,-10,9,19
120,TRN,P012593,0 days 00:24:41,7,55,48
120,TRN,P012595,0 days 00:23:33,18,63,45
120,TRN,P005738,0 days 00:22:54,17,63,46
120,TRN,P012596,0 days 00:21:22,9,46,37
120,TRN,P009903,0 days 00:18:38,13,52,39
120,TRN,P012597,0 days 00:17:56,4,47,43
120,TRN,P001479,0 days 00:17:06,5,35,30
120,TRN,P012594,0 days 00:15:23,4,42,38
120,TRN,P007828,0 days 00:15:06,18,34,16
120,TRN,P006382,0 days 00:11:54,16,28,12
120,TRN,P005059,0 days 00:08:43,6,22,16
120,TRN,P012687,0 days 00:02:44,-7,3,10
121,PMT,P011823,0 days 00:27:24,9,69,60
121,PMT,P011942,0 days 00:25:55,13,75,62
121,PMT,P002644,0 days 00:24:11,-4,64,68
121,PMT,P011944,0 days 00:22:37,2,62,60
121,PMT,P001686,0 days 00:22:09,-1,59,60
121,PMT,P012600,0 days 00:19:12,3,58,55
121,PMT,P011947,0 days 00:16:13,-3,40,43
121,PMT,P010549,0 days 00:15:55,5,34,29
121,PMT,P011943,0 days 00:12:11,0,26,26
121,PMT,P011966,0 days 00:07:57,-5,20,25
121,PMT,P002020,0 days 00:06:16,6,18,12
121,LJU,P009395,0 days 00:38:14,0,98,98
121,LJU,P005969,0 days 00:36:02,-4,91,95
121,LJU,P003452,0 days 00:35:26,-6,90,96
121,LJU,P011261,0 days 00:31:54,1,83,82
121,LJU,P007066,0 days 00:24:59,6,71,65
121,LJU,P009392,0 days 00:16:47,-16,31,47
121,LJU,P002561,0 days 00:16:38,-6,36,42
122,BES,P012647,0 days 00:25:58,22,53,31
122,BES,P009582,0 days 00:24:55,14,47,33
122,BES,P011936,0 days 00:24:53,4,47,43
122,BES,P011924,0 days 00:23:03,1,41,40
122,BES,P012622,0 days 00:22:29,13,39,26
122,BES,P008945,0 days 00:22:26,20,42,22
122,BES,P007914,0 days 00:19:38,-5,32,37
122,BES,P005348,0 days 00:19:23,8,35,27
122,BES,P011357,0 days 00:13:12,-7,19,26
122,BES,P011379,0 days 00:04:02,-3,5,8
122,BES,P012233,0 days 00:00:01,-2,0,2
122,WOL,P012577,0 days 00:28:40,-7,42,49
122,WOL,P006546,0 days 00:26:56,-16,34,50
122,WOL,P003212,0 days 00:21:31,-9,36,45
122,WOL,P012789,0 days 00:21:17,3,40,37
122,WOL,P005516,0 days 00:20:37,-6,26,32
122,WOL,PLCT,0 days 00:19:52,5,38,33
122,WOL,P004645,0 days 00:12:45,-5,20,25
122,WOL,P012576,0 days 00:11:10,-14,7,21
122,WOL,P002387,0 days 00:10:52,-19,7,26
122,WOL,P006154,0 days 00:09:52,1,17,16
122,WOL,P006907,0 days 00:08:55,4,16,12
122,WOL,P004229,0 days 00:07:33,-2,12,14
123,JOV,P011248,0 days 00:31:20,-4,62,66
123,JOV,P011247,0 days 00:25:53,12,65,53
123,JOV,P010161,0 days 00:24:14,12,60,48
123,JOV,P012349,0 days 00:24:04,7,53,46
123,JOV,P012780,0 days 00:23:20,6,54,48
123,JOV,PJUG,0 days 00:19:36,11,49,38
123,JOV,P002507,0 days 00:18:52,-2,37,39
123,JOV,P006771,0 days 00:13:11,-3,22,25
123,JOV,P010458,0 days 00:12:48,2,31,29
123,JOV,P010709,0 days 00:05:46,-4,9,13
123,JOV,P010708,0 days 00:00:56,3,3,0
123,VNC,P012591,0 days 00:34:12,1,70,69
123,VNC,P011909,0 days 00:30:27,-5,64,69
123,VNC,P003759,0 days 00:27:13,11,62,51
123,VNC,P008052,0 days 00:26:50,-7,58,65
123,VNC,P000968,0 days 00:26:47,10,62,52
123,VNC,P004117,0 days 00:20:21,-15,31,46
123,VNC,P012590,0 days 00:12:50,-18,19,37
123,VNC,P009400,0 days 00:09:56,-3,17,20
123,VNC,P012587,0 days 00:05:48,-9,11,20
123,VNC,P011928,0 days 00:05:36,-5,11,16
124,HTA,P011990,0 days 00:31:47,15,95,80
124,HTA,P004267,0 days 00:31:43,29,99,70
124,HTA,P004846,0 days 00:29:45,19,89,70
124,HTA,P011973,0 days 00:25:57,-1,72,73
124,HTA,P012794,0 days 00:24:37,15,80,65
124,HTA,P007759,0 days 00:23:04,8,65,57
124,HTA,P003533,0 days 00:22:35,13,69,56
124,HTA,P012028,0 days 00:05:01,-7,9,16
124,HTA,P012706,0 days 00:02:22,0,6,6
124,HTA,P012592,0 days 00:02:18,-6,4,10
124,HTA,P012793,0 days 00:00:51,0,2,2
124,HAM,P011168,0 days 00:32:01,2,83,81
124,HAM,P012581,0 days 00:28:33,-7,71,78
124,HAM,P012580,0 days 00:26:38,-9,64,73
124,HAM,P009663,0 days 00:24:56,-17,59,76
124,HAM,P012582,0 days 00:21:29,-7,56,63
124,HAM,P012579,0 days 00:17:35,-12,41,53
124,HAM,P011187,0 days 00:14:04,-3,38,41
124,HAM,P012694,0 days 00:12:04,9,38,29
124,HAM,P012648,0 days 00:11:45,-10,32,42
124,HAM,P012695,0 days 00:06:15,-16,16,32
124,HAM,P010070,0 days 00:04:40,-15,7,22
125,PRS,P012608,0 days 00:27:15,3,58,55
125,PRS,P012609,0 days 00:24:42,32,68,36
125,PRS,P012610,0 days 00:24:42,2,51,49
125,PRS,P012640,0 days 00:24:21,15,59,44
125,PRS,P005793,0 days 00:21:44,2,48,46
125,PRS,P004512,0 days 00:18:28,5,42,37
125,PRS,P011232,0 days 00:17:13,17,45,28
125,PRS,P012613,0 days 00:15:00,0,31,31
125,PRS,P003481,0 days 00:11:25,11,27,16
125,PRS,P011887,0 days 00:07:39,-10,16,26
125,PRS,P009556,0 days 00:05:56,14,23,9
125,PRS,P011551,0 days 00:01:35,-6,2,8
125,LLI,P012585,0 days 00:31:37,-21,56,77
125,LLI,P009680,0 days 00:28:24,-18,52,70
125,LLI,P009649,0 days 00:27:57,-13,51,64
125,LLI,P006600,0 days 00:26:58,-17,47,64
125,LLI,P005247,0 days 00:25:00,-14,46,60
125,LLI,P004773,0 days 00:23:08,-7,46,53
125,LLI,P009672,0 days 00:14:57,-10,31,41
125,LLI,P012020,0 days 00:13:02,0,30,30
125,LLI,P008274,0 days 00:07:41,11,20,9
125,LLI,P012584,0 days 00:01:16,4,6,2
126,BOU,P010718,0 days 00:32:02,9,66,57
126,BOU,P011836,0 days 00:31:02,8,62,54
126,BOU,P012617,0 days 00:28:40,-3,57,60
126,BOU,P012618,0 days 00:23:48,6,52,46
126,BOU,P010431,0 days 00:22:30,-3,41,44
126,BOU,P011837,0 days 00:21:12,2,40,38
126,BOU,P012628,0 days 00:18:13,7,42,35
126,BOU,P011161,0 days 00:17:36,5,37,32
126,BOU,P000498,0 days 00:15:59,9,33,24
126,BOU,P004525,0 days 00:13:58,0,30,30
126,CAN,P008121,0 days 00:33:48,3,67,64
126,CAN,P006588,0 days 00:30:29,-1,59,60
126,CAN,P009864,0 days 00:29:09,-2,54,56
126,CAN,P003637,0 days 00:29:01,-1,55,56
126,CAN,P003425,0 days 00:26:44,-3,54,57
126,CAN,P001607,0 days 00:18:16,-5,30,35
126,CAN,P004160,0 days 00:15:59,-7,29,36
126,CAN,P010385,0 days 00:15:51,-6,30,36
126,CAN,P010452,0 days 00:14:31,-7,25,32
126,CAN,P005005,0 days 00:09:26,-12,13,25
126,CAN,P007560,0 days 00:01:46,1,4,3
127,TRN,P005059,0 days 00:25:33,6,50,44
127,TRN,P012593,0 days 00:24:42,5,48,43
127,TRN,P005738,0 days 00:24:22,1,48,47
127,TRN,P009903,0 days 00:22:40,4,49,45
127,TRN,P012597,0 days 00:20:31,1,43,42
127,TRN,P012594,0 days 00:18:12,-6,33,39
127,TRN,P012596,0 days 00:17:20,2,27,25
127,TRN,P001479,0 days 00:15:38,5,28,23
127,TRN,P006382,0 days 00:15:37,3,27,24
127,TRN,P007828,0 days 00:13:14,7,22,15
127,TRN,P012595,0 days 00:02:11,2,5,3
127,LKB,P007029,0 days 00:32:40,-1,58,59
127,LKB,P004664,0 days 00:27:37,-1,56,57
127,LKB,P010190,0 days 00:27:37,-9,46,55
127,LKB,P002012,0 days 00:26:50,-1,52,53
127,LKB,P006230,0 days 00:21:46,-7,36,43
127,LKB,P009898,0 days 00:20:51,-8,37,45
127,LKB,P010461,0 days 00:18:14,1,34,33
127,LKB,P004868,0 days 00:13:10,-5,18,23
127,LKB,P006901,0 days 00:11:15,1,13,12
128,ULM,P012604,0 days 00:32:32,3,70,67
128,ULM,P010582,0 days 00:28:26,-3,55,58
128,ULM,P010106,0 days 00:26:58,7,62,55
128,ULM,P005422,0 days 00:26:00,14,60,46
128,ULM,P006997,0 days 00:21:56,0,44,44
128,ULM,P012603,0 days 00:17:36,-4,35,39
128,ULM,P012703,0 days 00:15:42,-16,26,42
128,ULM,P011457,0 days 00:11:24,-15,14,29
128,ULM,P010726,0 days 00:08:54,0,15,15
128,ULM,P007952,0 days 00:07:28,-9,9,18
128,ULM,P012066,0 days 00:03:04,-7,5,12
128,TTK,P011925,0 days 00:34:27,6,74,68
128,TTK,P006693,0 days 00:32:34,-2,61,63
128,TTK,P011239,0 days 00:30:46,14,75,61
128,TTK,P011834,0 days 00:27:17,1,56,55
128,TTK,P005000,0 days 00:24:38,11,57,46
128,TTK,P004801,0 days 00:18:00,2,42,40
128,TTK,P010477,0 days 00:17:07,-4,30,34
128,TTK,P009845,0 days 00:07:15,0,12,12
128,TTK,P000497,0 days 00:04:03,8,13,5
128,TTK,P005685,0 days 00:03:53,-6,5,11
129,ARI,P012717,0 days 00:27:45,18,63,45
129,ARI,P012708,0 days 00:26:07,22,61,39
129,ARI,P012716,0 days 00:25:59,21,64,43
129,ARI,P004292,0 days 00:25:32,21,63,42
129,ARI,P003240,0 days 00:17:34,5,38,33
129,ARI,P012760,0 days 00:16:06,16,44,28
129,ARI,P012792,0 days 00:15:28,8,37,29
129,ARI,P012702,0 days 00:14:04,0,24,24
129,ARI,P012615,0 days 00:13:52,8,36,28
129,ARI,P012722,0 days 00:08:12,-1,16,17
129,ARI,P010387,0 days 00:07:48,-12,13,25
129,ARI,P012638,0 days 00:01:33,4,6,2
129,WRO,P012699,0 days 00:31:48,-28,54,82
129,WRO,P009896,0 days 00:31:00,-27,52,79
129,WRO,P012749,0 days 00:30:07,-12,59,71
129,WRO,P011900,0 days 00:27:19,-6,48,54
129,WRO,P012601,0 days 00:23:55,-15,40,55
129,WRO,P011901,0 days 00:22:06,-10,39,49
129,WRO,P003034,0 days 00:18:08,-2,33,35
129,WRO,P011278,0 days 00:15:37,-10,30,40
130,BUD,P006566,0 days 00:30:51,4,62,58
130,BUD,P012606,0 days 00:29:19,-2,56,58
130,BUD,P011281,0 days 00:25:41,2,56,54
130,BUD,P007398,0 days 00:22:30,3,45,42
130,BUD,P008325,0 days 00:20:10,4,44,40
130,BUD,P010248,0 days 00:19:50,-6,33,39
130,BUD,P005637,0 days 00:19:27,-10,26,36
130,BUD,P004945,0 days 00:17:14,6,43,37
130,BUD,P002740,0 days 00:14:58,-11,20,31
130,CLU,P011801,0 days 00:28:37,0,55,55
130,CLU,P011797,0 days 00:27:30,3,57,54
130,CLU,P012621,0 days 00:26:50,8,61,53
130,CLU,P004862,0 days 00:24:25,7,53,46
130,CLU,P005113,0 days 00:24:18,11,57,46
130,CLU,P010569,0 days 00:17:57,-3,26,29
130,CLU,P005373,0 days 00:15:25,-4,22,26
130,CLU,P005714,0 days 00:14:48,-8,29,37
130,CLU,P012698,0 days 00:12:28,-3,21,24
130,CLU,P012620,0 days 00:05:30,-2,11,13
130,CLU,P010997,0 days 00:02:12,1,3,2
131,PRS,P012640,0 days 00:25:20,15,53,38
131,PRS,P012608,0 days 00:23:29,11,61,50
131,PRS,P012610,0 days 00:23:26,9,59,50
131,PRS,P012609,0 days 00:21:51,16,52,36
131,PRS,P011232,0 days 00:17:55,13,38,25
131,PRS,P004512,0 days 00:16:16,11,48,37
131,PRS,P009556,0 days 00:15:44,10,30,20
131,PRS,P012613,0 days 00:15:20,15,38,23
131,PRS,P005793,0 days 00:12:30,0,31,31
131,PRS,P012612,0 days 00:10:57,3,23,20
131,PRS,P003481,0 days 00:09:13,3,16,13
131,PRS,P011887,0 days 00:07:59,-1,16,17
131,PMT,P001686,0 days 00:27:48,-17,48,65
131,PMT,P011823,0 days 00:27:02,-20,52,72
131,PMT,P011943,0 days 00:26:41,-19,41,60
131,PMT,P011944,0 days 00:19:25,-18,37,55
131,PMT,P011966,0 days 00:18:12,0,36,36
131,PMT,P011947,0 days 00:17:46,-6,33,39
131,PMT,P011942,0 days 00:15:57,6,32,26
131,PMT,P012600,0 days 00:15:37,-22,28,50
131,PMT,P005301,0 days 00:14:35,-5,28,33
131,PMT,P002020,0 days 00:12:58,-1,20,21
131,PMT,P002691,0 days 00:03:59,-3,5,8
132,HTA,P011973,0 days 00:35:13,-1,86,87
132,HTA,P012794,0 days 00:30:48,5,74,69
132,HTA,P004846,0 days 00:29:27,4,82,78
132,HTA,P010550,0 days 00:28:41,0,69,69
132,HTA,P007759,0 days 00:28:35,-6,72,78
132,HTA,P007867,0 days 00:15:13,-12,23,35
132,HTA,P011990,0 days 00:12:46,3,27,24
132,HTA,P003533,0 days 00:10:45,-7,18,25
132,HTA,P004267,0 days 00:08:32,-6,29,35
132,LLI,P012586,0 days 00:31:30,8,76,68
132,LLI,P012585,0 days 00:27:46,-4,68,72
132,LLI,P009649,0 days 00:27:32,9,73,64
132,LLI,P006600,0 days 00:26:38,-3,68,71
132,LLI,P004773,0 days 00:24:42,3,59,56
132,LLI,P009680,0 days 00:22:43,3,59,56
132,LLI,P012797,0 days 00:22:25,-5,55,60
132,LLI,P012020,0 days 00:13:22,7,32,25
132,LLI,P012584,0 days 00:03:22,2,10,8
133,HAM,P012581,0 days 00:31:22,-4,76,80
133,HAM,P009663,0 days 00:28:50,-10,64,74
133,HAM,P011168,0 days 00:26:57,-7,56,63
133,HAM,P012582,0 days 00:25:16,-6,59,65
133,HAM,P012580,0 days 00:23:37,-4,47,51
133,HAM,P012648,0 days 00:18:42,7,49,42
133,HAM,P012579,0 days 00:17:46,-10,34,44
133,HAM,P001990,0 days 00:10:31,3,27,24
133,HAM,P010070,0 days 00:09:40,0,21,21
133,HAM,P012696,0 days 00:05:04,0,10,10
133,HAM,P012695,0 days 00:02:15,1,7,6
133,JOV,P011248,0 days 00:32:22,6,79,73
133,JOV,P010458,0 days 00:26:50,7,66,59
133,JOV,P011247,0 days 00:26:10,6,62,56
133,JOV,P006771,0 days 00:24:49,11,63,52
133,JOV,P002507,0 days 00:21:56,9,60,51
133,JOV,P012780,0 days 00:19:30,4,43,39
133,JOV,PJUG,0 days 00:15:43,-2,34,36
133,JOV,P010161,0 days 00:14:44,-5,33,38
133,JOV,P012349,0 days 00:11:36,-8,23,31
133,JOV,P010709,0 days 00:06:20,2,17,15
134,VNC,P004381,0 days 00:34:39,1,76,75
134,VNC,P012591,0 days 00:33:29,3,75,72
134,VNC,P008052,0 days 00:31:10,15,85,70
134,VNC,P011909,0 days 00:30:05,8,69,61
134,VNC,P012796,0 days 00:22:10,22,71,49
134,VNC,P003759,0 days 00:18:16,-6,26,32
134,VNC,P011928,0 days 00:17:28,-11,28,39
134,VNC,P009400,0 days 00:16:55,4,41,37
134,VNC,P012587,0 days 00:10:46,5,29,24
134,VNC,P000968,0 days 00:10:02,9,30,21
134,BES,P008945,0 days 00:37:39,-4,81,85
134,BES,P012647,0 days 00:36:14,-10,74,84
134,BES,P012622,0 days 00:32:25,2,69,67
134,BES,P011936,0 days 00:29:23,1,62,61
134,BES,P007914,0 days 00:26:51,0,68,68
134,BES,P011924,0 days 00:21:43,-6,50,56
134,BES,P012711,0 days 00:17:02,-19,38,57
134,BES,P011379,0 days 00:14:31,-9,18,27
134,BES,P011357,0 days 00:07:10,3,20,17
134,BES,P005348,0 days 00:02:02,-8,0,8
135,WOL,P011150,0 days 00:31:34,5,77,72
135,WOL,P006546,0 days 00:30:30,-2,67,69
135,WOL,P012576,0 days 00:25:54,0,56,56
135,WOL,P002387,0 days 00:23:45,-3,53,56
135,WOL,P005516,0 days 00:20:14,5,47,42
135,WOL,P012577,0 days 00:19:26,1,45,44
135,WOL,P003212,0 days 00:18:09,1,41,40
135,WOL,P012789,0 days 00:10:20,0,25,25
135,WOL,P006154,0 days 00:09:57,-2,19,21
135,WOL,P006907,0 days 00:06:30,1,15,14
135,WOL,P004645,0 days 00:03:41,4,10,6
135,LJU,P005969,0 days 00:28:15,2,66,64
135,LJU,P009395,0 days 00:23:36,5,55,50
135,LJU,P009392,0 days 00:23:06,-5,53,58
135,LJU,P012700,0 days 00:19:56,-1,47,48
135,LJU,P011261,0 days 00:19:10,-1,43,44
135,LJU,P010594,0 days 00:16:54,3,36,33
135,LJU,P007066,0 days 00:16:24,-7,34,41
135,LJU,P003514,0 days 00:16:13,-1,32,33
135,LJU,P001235,0 days 00:15:12,6,38,32
135,LJU,P003452,0 days 00:13:02,-4,26,30
135,LJU,P002561,0 days 00:08:12,-7,15,22
136,BUD,P010248,0 days 00:27:30,14,56,42
136,BUD,P004945,0 days 00:24:29,2,52,50
136,BUD,P011281,0 days 00:23:54,4,49,45
136,BUD,P012606,0 days 00:23:54,-2,45,47
136,BUD,P002740,0 days 00:20:56,4,40,36
136,BUD,P011935,0 days 00:20:31,-3,39,42
136,BUD,P005637,0 days 00:20:04,5,45,40
136,BUD,P012630,0 days 00:15:40,0,24,24
136,BUD,P007398,0 days 00:11:39,2,22,20
136,BUD,P008325,0 days 00:10:51,-8,16,24
136,BUD,P006566,0 days 00:00:32,2,2,0
136,BOU,P010718,0 days 00:24:32,-7,46,53
136,BOU,P010431,0 days 00:24:19,-5,48,53
136,BOU,P004525,0 days 00:22:10,8,48,40
136,BOU,P000498,0 days 00:19:44,3,36,33
136,BOU,P012617,0 days 00:19:25,-7,34,41
136,BOU,P012618,0 days 00:19:09,-1,34,35
136,BOU,P011837,0 days 00:18:50,-6,29,35
136,BOU,P011836,0 days 00:18:27,-8,35,43
136,BOU,P010450,0 days 00:16:52,2,30,28
136,BOU,P011161,0 days 00:16:32,1,30,29
137,CLU,P012621,0 days 00:30:37,15,68,53
137,CLU,P004862,0 days 00:27:20,14,67,53
137,CLU,P011801,0 days 00:25:49,4,48,44
137,CLU,P012698,0 days 00:23:44,15,60,45
137,CLU,P010569,0 days 00:22:49,9,54,45
137,CLU,P005113,0 days 00:20:38,9,50,41
137,CLU,P005373,0 days 00:18:55,9,40,31
137,CLU,P005714,0 days 00:17:38,5,36,31
137,CLU,P011797,0 days 00:07:58,0,18,18
137,CLU,P012620,0 days 00:04:32,0,9,9
137,ARI,P012708,0 days 00:29:02,-10,56,66
137,ARI,P012717,0 days 00:27:20,-5,59,64
137,ARI,P012792,0 days 00:25:46,-3,54,57
137,ARI,P003240,0 days 00:24:04,-15,39,54
137,ARI,P012716,0 days 00:23:40,-6,45,51
137,ARI,P012702,0 days 00:22:06,5,46,41
137,ARI,P004292,0 days 00:17:28,-14,28,42
137,ARI,P012615,0 days 00:15:03,-13,17,30
137,ARI,P012760,0 days 00:11:38,-14,22,36
137,ARI,P012722,0 days 00:03:53,-5,4,9
138,WRO,P012094,0 days 00:28:10,13,77,64
138,WRO,P012699,0 days 00:27:50,15,71,56
138,WRO,P012601,0 days 00:25:28,4,65,61
138,WRO,P012010,0 days 00:25:17,7,61,54
138,WRO,P009896,0 days 00:23:15,5,60,55
138,WRO,P012736,0 days 00:22:10,-4,51,55
138,WRO,P003034,0 days 00:16:41,7,40,33
138,WRO,P011901,0 days 00:16:33,5,40,35
138,WRO,P011278,0 days 00:14:36,8,35,27
138,ULM,P005422,0 days 00:33:38,-5,73,78
138,ULM,P012604,0 days 00:32:01,-2,74,76
138,ULM,P010582,0 days 00:30:20,-6,69,75
138,ULM,P012603,0 days 00:26:28,-8,62,70
138,ULM,P012703,0 days 00:25:14,-18,53,71
138,ULM,P010106,0 days 00:24:24,-6,52,58
138,ULM,P011457,0 days 00:13:32,-4,26,30
138,ULM,P010726,0 days 00:06:24,-1,17,18
138,ULM,P007952,0 days 00:05:08,-9,5,14
138,ULM,P011391,0 days 00:02:51,-1,9,10
139,TTK,P006693,0 days 00:33:07,24,72,48
139,TTK,P011925,0 days 00:31:51,8,65,57
139,TTK,P011239,0 days 00:29:58,12,64,52
139,TTK,P005000,0 days 00:23:03,-3,40,43
139,TTK,P004801,0 days 00:22:44,12,52,40
139,TTK,P011834,0 days 00:21:29,1,38,37
139,TTK,P010477,0 days 00:19:46,-2,32,34
139,TTK,P006883,0 days 00:09:24,-12,9,21
139,TTK,P009845,0 days 00:04:33,-2,9,11
139,TTK,P011975,0 days 00:04:05,2,9,7
139,TRN,P012597,0 days 00:31:42,-11,58,69
139,TRN,P012593,0 days 00:30:17,-15,49,64
139,TRN,P005059,0 days 00:26:11,6,50,44
139,TRN,P005738,0 days 00:23:58,-19,35,54
139,TRN,P009903,0 days 00:20:41,-6,37,43
139,TRN,P001479,0 days 00:19:15,5,38,33
139,TRN,P012596,0 days 00:16:06,4,30,26
139,TRN,P012594,0 days 00:13:58,-9,21,30
139,TRN,P006382,0 days 00:12:16,9,23,14
139,TRN,P012687,0 days 00:05:36,-4,9,13
140,LKB,P009898,0 days 00:32:23,2,75,73
140,LKB,P007029,0 days 00:32:07,-1,70,71
140,LKB,P002012,0 days 00:24:05,-4,58,62
140,LKB,P010461,0 days 00:23:40,7,53,46
140,LKB,PLXI,0 days 00:20:37,-12,35,47
140,LKB,P006901,0 days 00:19:24,-1,46,47
140,LKB,P004868,0 days 00:17:24,-11,32,43
140,LKB,P010190,0 days 00:15:58,-12,26,38
140,LKB,P006230,0 days 00:14:22,-8,25,33
140,CAN,P003425,0 days 00:26:50,19,73,54
140,CAN,P008121,0 days 00:24:22,7,63,56
140,CAN,P009864,0 days 00:21:44,9,59,50
140,CAN,P006588,0 days 00:20:20,10,52,42
140,CAN,P005005,0 days 00:17:59,12,43,31
140,CAN,P004160,0 days 00:16:43,-5,30,35
140,CAN,P010452,0 days 00:15:39,5,33,28
140,CAN,P010385,0 days 00:15:00,-5,21,26
140,CAN,P001607,0 days 00:13:18,-11,21,32
140,CAN,P003637,0 days 00:10:59,6,25,19
140,CAN,P004466,0 days 00:09:54,-7,20,27
140,CAN,P007644,0 days 00:07:12,0,20,20
141,PMT,P001686,0 days 00:27:16,19,63,44
141,PMT,P011942,0 days 00:25:46,10,56,46
141,PMT,P002644,0 days 00:25:02,19,55,36
141,PMT,P011966,0 days 00:19:59,33,57,24
141,PMT,P011947,0 days 00:18:21,18,41,23
141,PMT,P005301,0 days 00:17:49,7,41,34
141,PMT,P012600,0 days 00:17:00,25,45,20
141,PMT,P011944,0 days 00:16:30,-6,29,35
141,PMT,P011823,0 days 00:14:58,8,36,28
141,PMT,P011943,0 days 00:10:34,4,22,18
141,PMT,P002020,0 days 00:03:40,-2,5,7
141,PMT,P002691,0 days 00:03:05,0,5,5
141,WOL,P006546,0 days 00:30:45,-13,54,67
141,WOL,P012577,0 days 00:30:01,-25,49,74
141,WOL,P012789,0 days 00:28:55,-7,53,60
141,WOL,P002387,0 days 00:23:49,-6,40,46
141,WOL,P006154,0 days 00:23:06,-14,32,46
141,WOL,P005516,0 days 00:18:18,-10,32,42
141,WOL,P011150,0 days 00:13:12,-15,23,38
141,WOL,P006907,0 days 00:12:54,-13,19,32
141,WOL,P012576,0 days 00:11:05,-20,11,31
141,WOL,P004645,0 days 00:04:08,-4,3,7
141,WOL,P003212,0 days 00:03:47,-8,4,12
142,LJU,P003452,0 days 00:34:17,-2,85,87
142,LJU,P005969,0 days 00:32:28,-8,76,84
142,LJU,P009395,0 days 00:30:19,-10,70,80
142,LJU,P002561,0 days 00:23:02,5,63,58
142,LJU,P010594,0 days 00:17:16,-9,37,46
142,LJU,P003514,0 days 00:16:13,-19,25,44
142,LJU,P007066,0 days 00:14:56,-9,33,42
142,LJU,P009392,0 days 00:12:11,4,32,28
142,LJU,P011261,0 days 00:07:32,-3,17,20
142,LJU,P001235,0 days 00:06:28,-6,13,19
142,LJU,P010771,0 days 00:05:18,2,14,12
142,VNC,P012591,0 days 00:34:28,5,86,81
142,VNC,P004381,0 days 00:30:08,16,80,64
142,VNC,P011928,0 days 00:23:52,4,61,57
142,VNC,P012796,0 days 00:22:17,1,59,58
142,VNC,P003759,0 days 00:17:43,10,45,35
142,VNC,P008052,0 days 00:16:08,7,43,36
142,VNC,P009400,0 days 00:15:38,3,38,35
142,VNC,P000968,0 days 00:13:39,-2,37,39
142,VNC,P012259,0 days 00:13:18,7,37,30
142,VNC,P011909,0 days 00:07:57,13,23,10
142,VNC,P012587,0 days 00:04:52,-9,11,20
143,HAM,P012581,0 days 00:31:47,-20,54,74
143,HAM,P012580,0 days 00:31:14,-12,53,65
143,HAM,P012579,0 days 00:27:51,4,60,56
143,HAM,P011187,0 days 00:23:47,-3,48,51
143,HAM,P011168,0 days 00:23:10,-7,44,51
143,HAM,P009663,0 days 00:22:24,-13,32,45
143,HAM,P012582,0 days 00:20:22,-8,36,44
143,HAM,P010070,0 days 00:17:50,4,38,34
143,HAM,P001990,0 days 00:16:01,3,31,28
143,HAM,P012648,0 days 00:07:11,-5,12,17
143,HAM,P012694,0 days 00:03:23,2,7,5
143,BES,P012647,0 days 00:34:19,22,81,59
143,BES,P012622,0 days 00:33:37,20,74,54
143,BES,P011936,0 days 00:29:03,16,62,46
143,BES,P008945,0 days 00:28:20,6,56,50
143,BES,P011924,0 days 00:25:51,0,57,57
143,BES,P011379,0 days 00:25:42,11,49,38
143,BES,P012711,0 days 00:20:42,-8,38,46
143,BES,P003783,0 days 00:17:42,3,41,38
143,BES,P007917,0 days 00:06:43,-11,8,19
143,BES,P011357,0 days 00:03:01,-4,4,8
144,LLI,P009649,0 days 00:31:30,-13,59,72
144,LLI,P009680,0 days 00:30:00,-17,46,63
144,LLI,P012797,0 days 00:29:06,23,67,44
144,LLI,P006600,0 days 00:28:28,-12,45,57
144,LLI,P012585,0 days 00:27:19,8,64,56
144,LLI,P012586,0 days 00:26:13,-4,53,57
144,LLI,P004773,0 days 00:15:52,-5,31,36
144,LLI,P012020,0 days 00:11:32,10,35,25
144,JOV,P010677,0 days 00:29:26,5,61,56
144,JOV,P006771,0 days 00:28:52,3,56,53
144,JOV,P010458,0 days 00:27:57,11,59,48
144,JOV,P002507,0 days 00:26:47,10,56,46
144,JOV,P011247,0 days 00:24:55,9,59,50
144,JOV,P011248,0 days 00:23:39,-6,47,53
144,JOV,P012780,0 days 00:13:13,-8,26,34
144,JOV,P012349,0 days 00:12:03,-9,23,32
144,JOV,PJUG,0 days 00:10:47,-5,21,26
144,JOV,P010161,0 days 00:01:18,1,2,1
144,JOV,P010709,0 days 00:01:03,-1,0,1
145,HTA,P012794,0 days 00:31:02,-8,70,78
145,HTA,P007759,0 days 00:30:20,-12,63,75
145,HTA,P007867,0 days 00:29:16,-18,62,80
145,HTA,P010550,0 days 00:29:05,-11,58,69
145,HTA,P004846,0 days 00:26:11,-15,52,67
145,HTA,P011973,0 days 00:19:16,-16,41,57
145,HTA,P003533,0 days 00:17:39,4,42,38
145,HTA,P010465,0 days 00:15:27,-10,34,44
145,HTA,P012028,0 days 00:00:52,-2,4,6
145,HTA,P012706,0 days 00:00:52,-2,4,6
145,PRS,P012608,0 days 00:28:03,29,74,45
145,PRS,P012610,0 days 00:28:03,29,74,45
145,PRS,P012609,0 days 00:23:48,-2,59,61
145,PRS,P012613,0 days 00:21:41,9,57,48
145,PRS,P011232,0 days 00:16:48,-13,40,53
145,PRS,P004512,0 days 00:16:34,26,52,26
145,PRS,P012611,0 days 00:15:37,17,46,29
145,PRS,P012640,0 days 00:14:37,-11,27,38
145,PRS,P012612,0 days 00:12:41,4,34,30
145,PRS,P009556,0 days 00:11:57,-11,30,41
145,PRS,P005793,0 days 00:10:11,13,27,14
146,BOU,P004525,0 days 00:22:34,20,58,38
146,BOU,P010718,0 days 00:20:55,21,60,39
146,BOU,P000498,0 days 00:20:49,7,44,37
146,BOU,P012628,0 days 00:19:25,12,46,34
146,BOU,P012618,0 days 00:18:51,9,43,34
146,BOU,P011161,0 days 00:18:07,10,40,30
146,BOU,P011836,0 days 00:17:26,13,46,33
146,BOU,P012617,0 days 00:16:58,24,54,30
146,BOU,P010431,0 days 00:16:55,10,44,34
146,BOU,P011837,0 days 00:13:51,16,40,24
146,BOU,P012619,0 days 00:07:18,8,21,13
146,BOU,P010450,0 days 00:06:51,15,24,9
146,LKB,P007029,0 days 00:30:38,-20,57,77
146,LKB,P009898,0 days 00:28:26,-16,50,66
146,LKB,P002012,0 days 00:28:25,-32,52,84
146,LKB,P006901,0 days 00:21:00,-31,33,64
146,LKB,P010461,0 days 00:20:10,-15,34,49
146,LKB,P006230,0 days 00:19:50,-18,37,55
146,LKB,P010190,0 days 00:17:23,-19,30,49
146,LKB,P004868,0 days 00:14:41,-5,23,28
146,LKB,PLXI,0 days 00:11:47,3,24,21
146,LKB,P011329,0 days 00:07:40,-12,15,27
147,CAN,P003425,0 days 00:30:03,10,66,56
147,CAN,P008121,0 days 00:26:21,9,62,53
147,CAN,P009864,0 days 00:21:20,4,47,43
147,CAN,P003637,0 days 00:21:18,5,44,39
147,CAN,P006588,0 days 00:21:03,7,48,41
147,CAN,P010385,0 days 00:16:57,-17,18,35
147,CAN,P005005,0 days 00:13:39,-19,11,30
147,CAN,P010452,0 days 00:11:33,-14,14,28
147,CAN,P004160,0 days 00:10:47,-5,14,19
147,CAN,P001607,0 days 00:09:57,-20,7,27
147,CAN,P007644,0 days 00:09:07,0,19,19
147,CAN,P004466,0 days 00:07:55,-10,15,25
147,TTK,P006693,0 days 00:31:56,9,66,57
147,TTK,P011925,0 days 00:31:50,7,63,56
147,TTK,P011834,0 days 00:30:56,5,68,63
147,TTK,P006883,0 days 00:25:53,20,64,44
147,TTK,P005000,0 days 00:25:05,4,51,47
147,TTK,P004801,0 days 00:19:50,12,42,30
147,TTK,P010477,0 days 00:12:52,2,25,23
147,TTK,P011239,0 days 00:12:22,-10,21,31
147,TTK,P009845,0 days 00:09:16,1,15,14
148,TRN,P012597,0 days 00:31:51,3,71,68
148,TRN,P009903,0 days 00:27:07,6,57,51
148,TRN,P005738,0 days 00:25:06,-3,53,56
148,TRN,P005059,0 days 00:25:00,7,50,43
148,TRN,P012593,0 days 00:20:29,6,42,36
148,TRN,P006382,0 days 00:19:21,4,39,35
148,TRN,P001479,0 days 00:14:54,9,32,23
148,TRN,P012596,0 days 00:12:53,0,28,28
148,TRN,P012594,0 days 00:12:07,1,27,26
148,TRN,P012687,0 days 00:11:12,-3,26,29
148,WRO,P012601,0 days 00:32:42,-1,70,71
148,WRO,P005531,0 days 00:28:35,-3,52,55
148,WRO,P009896,0 days 00:27:08,9,59,50
148,WRO,P012699,0 days 00:26:32,-8,48,56
148,WRO,P012094,0 days 00:23:52,-7,47,54
148,WRO,P012010,0 days 00:18:38,-7,32,39
148,WRO,P012736,0 days 00:14:28,5,36,31
148,WRO,P003034,0 days 00:11:40,-13,18,31
148,WRO,P011901,0 days 00:11:02,3,26,23
148,WRO,P011278,0 days 00:05:23,-8,7,15
149,ULM,P010582,0 days 00:31:05,-9,64,73
149,ULM,P010106,0 days 00:30:24,6,72,66
149,ULM,P012604,0 days 00:27:13,-8,52,60
149,ULM,P012603,0 days 00:26:49,5,61,56
149,ULM,P005422,0 days 00:23:15,-11,39,50
149,ULM,P012703,0 days 00:22:22,3,46,43
149,ULM,P011457,0 days 00:17:16,0,33,33
149,ULM,P007952,0 days 00:12:31,4,29,25
149,ULM,P010726,0 days 00:08:49,-10,9,19
149,ULM,P011391,0 days 00:00:16,0,0,0
149,CLU,P012621,0 days 00:32:32,10,77,67
149,CLU,P011801,0 days 00:25:21,7,56,49
149,CLU,P011797,0 days 00:24:48,-4,48,52
149,CLU,P005714,0 days 00:22:15,9,50,41
149,CLU,P005373,0 days 00:20:41,17,51,34
149,CLU,P010569,0 days 00:19:14,-8,36,44
149,CLU,P005113,0 days 00:17:24,-11,31,42
149,CLU,P012620,0 days 00:15:39,13,39,26
149,CLU,P012698,0 days 00:10:33,-8,13,21
149,CLU,P004862,0 days 00:10:32,-4,22,26
149,CLU,P010997,0 days 00:01:01,-1,2,3
150,ARI,P012708,0 days 00:33:12,-3,66,69
150,ARI,P004292,0 days 00:25:41,0,51,51
150,ARI,P012760,0 days 00:25:21,10,49,39
150,ARI,P003240,0 days 00:24:13,-2,40,42
150,ARI,P012717,0 days 00:20:24,-2,36,38
150,ARI,P012716,0 days 00:19:48,5,39,34
150,ARI,P012615,0 days 00:19:36,3,40,37
150,ARI,P012702,0 days 00:13:46,-9,25,34
150,ARI,P012792,0 days 00:12:18,0,22,22
150,ARI,P002867,0 days 00:04:48,3,10,7
150,ARI,P012722,0 days 00:00:53,0,2,2
150,BUD,P012606,0 days 00:31:24,-3,56,59
150,BUD,P005637,0 days 00:24:44,-5,42,47
150,BUD,P010248,0 days 00:24:24,-13,40,53
150,BUD,P011281,0 days 00:22:58,3,47,44
150,BUD,P004945,0 days 00:22:37,6,43,37
150,BUD,P002740,0 days 00:21:30,4,45,41
150,BUD,P012630,0 days 00:18:31,-9,34,43
150,BUD,P011935,0 days 00:15:43,4,33,29
150,BUD,P008325,0 days 00:15:34,12,35,23
150,BUD,P009214,0 days 00:02:35,-4,0,4
151,HTA,P010550,0 days 00:29:34,0,79,79
151,HTA,P011973,0 days 00:28:01,-2,76,78
151,HTA,P010465,0 days 00:27:42,-5,71,76
151,HTA,P007759,0 days 00:25:58,-9,65,74
151,HTA,P012794,0 days 00:25:39,-3,73,76
151,HTA,P004846,0 days 00:23:44,-14,54,68
151,HTA,P007867,0 days 00:22:11,0,63,63
151,HTA,P003533,0 days 00:14:05,-9,35,44
151,HTA,P011990,0 days 00:03:06,2,9,7
151,PMT,P001686,0 days 00:34:00,5,92,87
151,PMT,P012600,0 days 00:32:11,6,92,86
151,PMT,P011944,0 days 00:27:04,12,75,63
151,PMT,P011942,0 days 00:24:53,16,76,60
151,PMT,P002644,0 days 00:22:44,13,74,61
151,PMT,P011823,0 days 00:17:16,-5,39,44
151,PMT,P005301,0 days 00:13:52,-2,32,34
151,PMT,P011966,0 days 00:12:56,-4,38,42
151,PMT,P011947,0 days 00:09:49,-3,29,32
151,PMT,P011943,0 days 00:03:34,2,13,11
151,PMT,P010549,0 days 00:01:41,0,5,5
152,PRS,P012610,0 days 00:26:24,7,55,48
152,PRS,P012608,0 days 00:26:14,9,55,46
152,PRS,P012609,0 days 00:24:55,8,61,53
152,PRS,P012613,0 days 00:21:49,-8,43,51
152,PRS,P012640,0 days 00:21:27,16,59,43
152,PRS,P005793,0 days 00:18:21,3,37,34
152,PRS,P011232,0 days 00:17:29,1,41,40
152,PRS,P012611,0 days 00:16:29,-12,29,41
152,PRS,P012612,0 days 00:14:04,4,38,34
152,PRS,P004512,0 days 00:12:48,7,27,20
152,JOV,P011247,0 days 00:32:35,-1,67,68
152,JOV,P010677,0 days 00:27:10,-4,60,64
152,JOV,P006771,0 days 00:24:41,-17,45,62
152,JOV,P002507,0 days 00:22:45,-12,47,59
152,JOV,P012349,0 days 00:21:32,6,50,44
152,JOV,P012780,0 days 00:19:25,-2,36,38
152,JOV,PJUG,0 days 00:19:11,2,44,42
152,JOV,P010458,0 days 00:15:47,-6,31,37
152,JOV,P010161,0 days 00:10:12,-1,19,20
152,JOV,P011248,0 days 00:06:40,0,11,11
152,JOV,P010708,0 days 00:00:02,0,0,0
153,LLI,P012797,0 days 00:27:59,23,72,49
153,LLI,P012585,0 days 00:24:36,22,64,42
153,LLI,P009649,0 days 00:24:26,-2,46,48
153,LLI,P006600,0 days 00:21:56,3,46,43
153,LLI,P012586,0 days 00:21:21,32,65,33
153,LLI,P009680,0 days 00:18:39,-11,28,39
153,LLI,P012020,0 days 00:18:04,18,47,29
153,LLI,P005247,0 days 00:16:02,27,50,23
153,LLI,P004773,0 days 00:14:56,-5,26,31
153,LLI,P004479,0 days 00:10:54,1,19,18
153,LLI,P012584,0 days 00:01:07,-3,2,5
153,BES,P012622,0 days 00:25:06,2,50,48
153,BES,P008945,0 days 00:24:02,-13,43,56
153,BES,P012711,0 days 00:23:25,-9,45,54
153,BES,P011936,0 days 00:22:25,-20,39,59
153,BES,P007914,0 days 00:20:05,-15,35,50
153,BES,P012647,0 days 00:19:58,-13,34,47
153,BES,P003783,0 days 00:17:19,-9,32,41
153,BES,P011924,0 days 00:16:16,-2,30,32
153,BES,P011379,0 days 00:14:27,-11,23,34
153,BES,P007917,0 days 00:10:01,-14,15,29
153,BES,P011357,0 days 00:06:56,-1,14,15
154,HAM,P012581,0 days 00:30:46,-26,59,85
154,HAM,P012580,0 days 00:28:23,-29,58,87
154,HAM,P011168,0 days 00:23:16,-8,49,57
154,HAM,P012648,0 days 00:22:17,-16,48,64
154,HAM,P009663,0 days 00:21:46,-19,47,66
154,HAM,P011187,0 days 00:18:14,-12,36,48
154,HAM,P012579,0 days 00:15:28,-9,36,45
154,HAM,P010070,0 days 00:12:29,-8,31,39
154,HAM,P001990,0 days 00:12:15,-19,25,44
154,HAM,P012582,0 days 00:10:37,-5,17,22
154,HAM,P012695,0 days 00:04:29,-4,9,13
154,LJU,P010594,0 days 00:25:14,21,75,54
154,LJU,P005969,0 days 00:24:52,26,76,50
154,LJU,P003452,0 days 00:24:40,35,80,45
154,LJU,P012700,0 days 00:23:31,28,72,44
154,LJU,P009395,0 days 00:18:55,18,56,38
154,LJU,P003514,0 days 00:17:10,0,43,43
154,LJU,P007066,0 days 00:15:37,11,43,32
154,LJU,P009392,0 days 00:14:46,10,39,29
154,LJU,P002561,0 days 00:14:15,3,36,33
154,LJU,P011261,0 days 00:11:21,-1,23,24
154,LJU,P010771,0 days 00:05:28,2,15,13
154,LJU,P010912,0 days 00:04:11,2,12,10
155,VNC,P004381,0 days 00:35:20,-13,52,65
155,VNC,P012259,0 days 00:30:44,-18,44,62
155,VNC,P009400,0 days 00:27:35,2,47,45
155,VNC,P003759,0 days 00:26:14,2,46,44
155,VNC,P004117,0 days 00:22:51,-31,21,52
155,VNC,P008052,0 days 00:21:32,-9,27,36
155,VNC,P011928,0 days 00:21:17,-16,30,46
155,VNC,P012587,0 days 00:13:56,-5,18,23
155,VNC,P012588,0 days 00:00:31,-2,0,2
155,WOL,P005516,0 days 00:34:11,15,66,51
155,WOL,P002387,0 days 00:26:09,18,56,38
155,WOL,P006154,0 days 00:25:27,4,39,35
155,WOL,P012577,0 days 00:23:58,16,44,28
155,WOL,P012576,0 days 00:22:24,7,42,35
155,WOL,P006546,0 days 00:21:46,1,39,38
155,WOL,P012789,0 days 00:17:36,11,33,22
155,WOL,P006907,0 days 00:14:38,18,37,19
155,WOL,P004645,0 days 00:13:51,0,19,19
156,ARI,P004292,0 days 00:31:06,-2,53,55
156,ARI,P012716,0 days 00:29:08,-7,47,54
156,ARI,P012708,0 days 00:26:24,-8,45,53
156,ARI,P012717,0 days 00:23:20,-6,34,40
156,ARI,P012615,0 days 00:21:21,-5,39,44
156,ARI,P012702,0 days 00:20:30,-12,35,47
156,ARI,P012792,0 days 00:20:01,-5,39,44
156,ARI,P012760,0 days 00:17:59,5,31,26
156,ARI,P002867,0 days 00:10:11,0,17,17
156,BOU,P010718,0 days 00:25:03,7,46,39
156,BOU,P012617,0 days 00:23:56,5,44,39
156,BOU,P010431,0 days 00:23:48,9,47,38
156,BOU,P011836,0 days 00:22:45,6,41,35
156,BOU,P011837,0 days 00:20:57,0,37,37
156,BOU,P012618,0 days 00:19:03,8,39,31
156,BOU,P004525,0 days 00:17:15,2,35,33
156,BOU,P011161,0 days 00:16:12,-1,29,30
156,BOU,P000498,0 days 00:16:04,3,32,29
156,BOU,P012628,0 days 00:14:57,1,30,29
157,BUD,P011281,0 days 00:34:19,1,66,65
157,BUD,P002740,0 days 00:29:23,-3,50,53
157,BUD,P012606,0 days 00:27:07,1,49,48
157,BUD,P008325,0 days 00:26:45,4,49,45
157,BUD,P005637,0 days 00:22:38,7,45,38
157,BUD,P011935,0 days 00:22:08,-11,35,46
157,BUD,P004945,0 days 00:21:25,-9,36,45
157,BUD,P012630,0 days 00:20:39,6,39,33
157,BUD,P010248,0 days 00:18:15,-8,31,39
157,BUD,P009214,0 days 00:02:21,-8,0,8
157,ULM,P012603,0 days 00:34:44,3,68,65
157,ULM,P012604,0 days 00:32:29,-7,56,63
157,ULM,P010106,0 days 00:29:40,-3,57,60
157,ULM,P010582,0 days 00:29:24,-1,50,51
157,ULM,P012703,0 days 00:28:32,4,55,51
157,ULM,P005422,0 days 00:27:20,6,46,40
157,ULM,P011457,0 days 00:17:41,-7,31,38
157,ULM,P010726,0 days 00:12:39,14,29,15
157,ULM,P007952,0 days 00:12:31,11,28,17
158,CLU,P011797,0 days 00:32:58,10,75,65
158,CLU,P011801,0 days 00:32:40,16,79,63
158,CLU,P012698,0 days 00:26:20,-3,60,63
158,CLU,P012621,0 days 00:25:41,1,54,53
158,CLU,P005113,0 days 00:22:47,0,45,45
158,CLU,P010569,0 days 00:20:07,10,45,35
158,CLU,P005714,0 days 00:19:53,-5,43,48
158,CLU,P005373,0 days 00:16:32,4,39,35
158,CLU,P012620,0 days 00:03:02,-8,0,8
158,TRN,P012597,0 days 00:30:51,-9,60,69
158,TRN,P005738,0 days 00:27:26,-2,60,62
158,TRN,P005059,0 days 00:22:58,-1,51,52
158,TRN,P012595,0 days 00:22:25,-9,44,53
158,TRN,P009903,0 days 00:21:33,0,52,52
158,TRN,P012593,0 days 00:18:30,4,45,41
158,TRN,P012596,0 days 00:17:41,-4,28,32
158,TRN,P012594,0 days 00:14:23,-2,30,32
158,TRN,P001479,0 days 00:12:34,-3,23,26
158,TRN,P006382,0 days 00:11:37,1,22,21
158,TRN,P007828,0 days 00:00:02,0,0,0
159,WRO,P005531,0 days 00:24:13,-21,40,61
159,WRO,P012601,0 days 00:21:36,-18,35,53
159,WRO,P012699,0 days 00:21:12,-12,39,51
159,WRO,P012094,0 days 00:21:01,-17,40,57
159,WRO,P012736,0 days 00:20:47,-6,37,43
159,WRO,P003034,0 days 00:20:28,-5,37,42
159,WRO,P011900,0 days 00:20:06,-12,31,43
159,WRO,P009896,0 days 00:19:32,-19,31,50
159,WRO,P011901,0 days 00:18:40,-11,26,37
159,WRO,P012308,0 days 00:06:25,-2,11,13
159,WRO,P011902,0 days 00:06:00,3,13,10
159,CAN,P004160,0 days 00:23:41,12,51,39
159,CAN,P010385,0 days 00:18:50,16,43,27
159,CAN,P003425,0 days 00:17:40,13,45,32
159,CAN,P007644,0 days 00:16:54,6,33,27
159,CAN,P005005,0 days 00:16:46,22,49,27
159,CAN,P009864,0 days 00:16:35,13,43,30
159,CAN,P003637,0 days 00:16:19,12,41,29
159,CAN,P004466,0 days 00:15:57,0,31,31
159,CAN,P001607,0 days 00:15:38,11,33,22
159,CAN,P010452,0 days 00:14:52,-1,27,28
159,CAN,P007560,0 days 00:13:59,2,26,24
159,CAN,P006588,0 days 00:12:49,14,38,24
160,TTK,P011925,0 days 00:36:14,18,81,63
160,TTK,P006883,0 days 00:33:45,24,81,57
160,TTK,P006693,0 days 00:31:54,11,72,61
160,TTK,P011834,0 days 00:27:30,14,61,47
160,TTK,P005000,0 days 00:26:45,14,65,51
160,TTK,P004801,0 days 00:21:45,-1,37,38
160,TTK,P010477,0 days 00:11:57,3,27,24
160,TTK,P009845,0 days 00:10:07,-7,16,23
160,TTK,P011272,0 days 00:00:03,-1,0,1
160,LKB,P007029,0 days 00:35:06,-16,61,77
160,LKB,PLXI,0 days 00:33:18,-16,58,74
160,LKB,P004868,0 days 00:29:02,-1,55,56
160,LKB,P009898,0 days 00:27:17,-7,53,60
160,LKB,P010461,0 days 00:26:39,-6,47,53
160,LKB,P005521,0 days 00:16:58,-14,33,47
160,LKB,P006230,0 days 00:13:21,-9,26,35
160,LKB,P010190,0 days 00:11:05,-4,18,22
160,LKB,P006901,0 days 00:07:14,-2,14,16
161,VNC,P003759,0 days 00:25:44,-4,60,64
161,VNC,P004381,0 days 00:24:23,-7,55,62
161,VNC,P008052,0 days 00:24:00,22,80,58
161,VNC,P012259,0 days 00:23:54,23,74,51
161,VNC,P012591,0 days 00:22:14,19,65,46
161,VNC,P004117,0 days 00:19:49,-2,41,43
161,VNC,P009400,0 days 00:19:29,0,44,44
161,VNC,P011928,0 days 00:18:37,14,55,41
161,VNC,P000968,0 days 00:14:30,18,48,30
161,VNC,P012587,0 days 00:06:52,-1,18,19
161,VNC,P012290,0 days 00:00:28,-2,0,2
161,PMT,P005301,0 days 00:25:02,-1,60,61
161,PMT,P002644,0 days 00:21:06,-12,48,60
161,PMT,P011942,0 days 00:20:51,-15,49,64
161,PMT,P011944,0 days 00:20:45,0,44,44
161,PMT,P011823,0 days 00:19:45,-6,44,50
161,PMT,P001686,0 days 00:19:03,-28,37,65
161,PMT,P011966,0 days 00:16:59,-11,42,53
161,PMT,P012600,0 days 00:12:39,-6,32,38
161,PMT,P011947,0 days 00:12:00,-2,30,32
161,PMT,P002020,0 days 00:10:56,12,32,20
161,PMT,P010549,0 days 00:10:44,-7,21,28
161,PMT,P011943,0 days 00:10:10,-4,21,25
162,WOL,P006546,0 days 00:27:47,2,64,62
162,WOL,P012577,0 days 00:27:22,23,77,54
162,WOL,P005516,0 days 00:24:29,14,59,45
162,WOL,P004645,0 days 00:22:27,7,55,48
162,WOL,P012576,0 days 00:19:57,-3,42,45
162,WOL,P006154,0 days 00:19:51,-3,38,41
162,WOL,P012789,0 days 00:19:36,15,49,34
162,WOL,P002387,0 days 00:17:53,2,40,38
162,WOL,P003212,0 days 00:15:31,-4,35,39
162,WOL,P006907,0 days 00:05:07,-3,11,14
162,HAM,P012581,0 days 00:30:33,-9,67,76
162,HAM,P011168,0 days 00:29:58,-6,64,70
162,HAM,P012580,0 days 00:26:40,9,59,50
162,HAM,P012579,0 days 00:22:04,-9,43,52
162,HAM,P009663,0 days 00:20:48,2,46,44
162,HAM,P010070,0 days 00:19:41,5,44,39
162,HAM,P012582,0 days 00:18:17,-14,35,49
162,HAM,P011187,0 days 00:14:16,-14,25,39
162,HAM,P012695,0 days 00:10:02,-4,20,24
162,HAM,P012648,0 days 00:07:41,-10,17,27
163,LJU,P009395,0 days 00:32:22,0,75,75
163,LJU,P012700,0 days 00:31:08,-9,65,74
163,LJU,P003452,0 days 00:29:37,2,68,66
163,LJU,P005969,0 days 00:29:37,-1,65,66
163,LJU,P007066,0 days 00:18:32,-14,31,45
163,LJU,P010594,0 days 00:17:52,7,38,31
163,LJU,P003514,0 days 00:11:28,-7,23,30
163,LJU,P002561,0 days 00:10:23,-6,20,26
163,LJU,P011261,0 days 00:08:44,0,20,20
163,LJU,P009392,0 days 00:07:53,-8,15,23
163,LJU,P010771,0 days 00:02:24,1,5,4
163,LLI,P012585,0 days 00:32:19,11,79,68
163,LLI,P006600,0 days 00:25:35,1,56,55
163,LLI,P009680,0 days 00:24:34,7,63,56
163,LLI,P009649,0 days 00:24:08,-15,40,55
163,LLI,P004773,0 days 00:21:24,24,66,42
163,LLI,P012797,0 days 00:20:46,-12,41,53
163,LLI,P012586,0 days 00:17:53,-1,34,35
163,LLI,P012020,0 days 00:14:25,6,36,30
163,LLI,P004479,0 days 00:12:52,8,32,24
163,LLI,P008274,0 days 00:06:04,6,13,7
164,BES,P011936,0 days 00:30:48,-7,62,69
164,BES,P012647,0 days 00:30:23,-10,57,67
164,BES,P012622,0 days 00:28:30,-1,60,61
164,BES,P008945,0 days 00:25:56,-7,48,55
164,BES,P011379,0 days 00:18:19,-21,31,52
164,BES,P007914,0 days 00:16:42,-25,20,45
164,BES,P003783,0 days 00:15:53,-26,19,45
164,BES,P007917,0 days 00:12:42,1,29,28
164,BES,P011924,0 days 00:12:33,-6,24,30
164,BES,P012711,0 days 00:06:12,-14,5,19
164,BES,P011357,0 days 00:02:02,1,5,4
164,PRS,P012608,0 days 00:25:24,11,60,49
164,PRS,P012610,0 days 00:25:03,10,59,49
164,PRS,P012613,0 days 00:22:21,11,52,41
164,PRS,P012609,0 days 00:21:46,14,55,41
164,PRS,P012611,0 days 00:21:39,19,51,32
164,PRS,P004512,0 days 00:19:41,17,53,36
164,PRS,P012640,0 days 00:18:46,0,36,36
164,PRS,P011232,0 days 00:17:39,12,43,31
164,PRS,P012612,0 days 00:14:36,12,35,23
164,PRS,P005793,0 days 00:11:32,3,25,22
164,PRS,P009556,0 days 00:01:33,6,6,0
165,JOV,P010677,0 days 00:28:26,4,64,60
165,JOV,P002507,0 days 00:26:01,5,57,52
165,JOV,P011247,0 days 00:25:57,0,59,59
165,JOV,P006771,0 days 00:24:07,-21,43,64
165,JOV,PJUG,0 days 00:23:33,-3,49,52
165,JOV,P012780,0 days 00:20:48,3,51,48
165,JOV,P012349,0 days 00:19:18,-2,44,46
165,JOV,P010161,0 days 00:18:00,0,40,40
165,JOV,P010458,0 days 00:13:50,-16,18,34
165,HTA,P007759,0 days 00:30:38,-1,70,71
165,HTA,P007867,0 days 00:28:56,17,71,54
165,HTA,P011973,0 days 00:28:20,7,64,57
165,HTA,P012794,0 days 00:23:16,17,58,41
165,HTA,P010550,0 days 00:21:48,4,45,41
165,HTA,P006835,0 days 00:21:40,0,51,51
165,HTA,P011991,0 days 00:18:51,-7,35,42
165,HTA,P004846,0 days 00:17:08,-14,33,47
165,HTA,P003533,0 days 00:08:22,2,23,21
165,HTA,P010465,0 days 00:01:01,5,5,0
166,TTK,P011925,0 days 00:36:51,2,64,62
166,TTK,P011834,0 days 00:27:34,-6,42,48
166,TTK,P006883,0 days 00:27:21,4,45,41
166,TTK,P005000,0 days 00:22:57,-4,34,38
166,TTK,P006693,0 days 00:20:50,-10,32,42
166,TTK,P010477,0 days 00:20:38,1,36,35
166,TTK,P004801,0 days 00:19:09,-1,30,31
166,TTK,P011239,0 days 00:11:57,-5,16,21
166,TTK,P009845,0 days 00:05:13,-5,7,12
166,TTK,P011975,0 days 00:03:47,5,7,2
166,TTK,P011272,0 days 00:03:43,-1,7,8
166,BOU,P012617,0 days 00:24:58,0,39,39
166,BOU,P010718,0 days 00:24:29,0,41,41
166,BOU,P011836,0 days 00:23:27,0,42,42
166,BOU,P010431,0 days 00:23:20,4,38,34
166,BOU,P012618,0 days 00:22:13,4,33,29
166,BOU,P011837,0 days 00:17:42,0,35,35
166,BOU,P012628,0 days 00:17:08,2,29,27
166,BOU,P004525,0 days 00:16:38,4,26,22
166,BOU,P011161,0 days 00:15:03,2,28,26
166,BOU,P000498,0 days 00:15:02,4,29,25
167,LKB,P007029,0 days 00:30:15,7,65,58
167,LKB,P009898,0 days 00:28:24,6,63,57
167,LKB,P002012,0 days 00:27:49,15,63,48
167,LKB,P010461,0 days 00:26:44,4,60,56
167,LKB,PLXI,0 days 00:26:13,10,59,49
167,LKB,P010190,0 days 00:24:54,21,64,43
167,LKB,P006901,0 days 00:21:02,5,48,43
167,LKB,P004868,0 days 00:13:16,12,31,19
167,LKB,P011329,0 days 00:01:23,0,2,2
167,WRO,P012094,0 days 00:28:08,-2,62,64
167,WRO,P012601,0 days 00:27:44,-15,49,64
167,WRO,P012699,0 days 00:26:03,-3,54,57
167,WRO,P011900,0 days 00:25:49,-13,52,65
167,WRO,P005531,0 days 00:23:55,-1,47,48
167,WRO,P009896,0 days 00:22:50,-16,35,51
167,WRO,P003034,0 days 00:16:51,3,40,37
167,WRO,P011901,0 days 00:14:39,-12,22,34
167,WRO,P012736,0 days 00:10:38,-14,11,25
167,WRO,P011902,0 days 00:03:23,-7,3,10
168,CAN,P008121,0 days 00:34:09,-4,88,92
168,CAN,P003425,0 days 00:29:26,-5,76,81
168,CAN,P006588,0 days 00:28:46,-7,72,79
168,CAN,P009864,0 days 00:25:20,-13,54,67
168,CAN,P003637,0 days 00:24:37,-7,59,66
168,CAN,P010385,0 days 00:19:40,11,57,46
168,CAN,P010452,0 days 00:16:14,5,39,34
168,CAN,P005005,0 days 00:15:53,4,39,35
168,CAN,P001607,0 days 00:15:34,3,35,32
168,CAN,P007560,0 days 00:10:39,7,28,21
168,CAN,P004160,0 days 00:04:42,-4,8,12
168,CLU,P010569,0 days 00:39:40,1,95,94
168,CLU,P011801,0 days 00:37:44,12,98,86
168,CLU,P012621,0 days 00:35:13,-4,88,92
168,CLU,P012698,0 days 00:33:34,5,87,82
168,CLU,P005373,0 days 00:29:53,18,88,70
168,CLU,P005714,0 days 00:18:56,-4,47,51
168,CLU,P005113,0 days 00:15:53,-16,28,44
168,CLU,P012620,0 days 00:11:29,-1,29,30
168,CLU,P010997,0 days 00:02:38,-1,5,6
169,TRN,P012595,0 days 00:32:13,-12,69,81
169,TRN,P005738,0 days 00:27:21,-8,55,63
169,TRN,P012597,0 days 00:25:59,-12,48,60
169,TRN,P005059,0 days 00:23:17,-20,44,64
169,TRN,P006382,0 days 00:22:24,-10,37,47
169,TRN,P012596,0 days 00:18:59,-9,37,46
169,TRN,P009903,0 days 00:17:31,-15,32,47
169,TRN,P001479,0 days 00:09:00,1,18,17
169,TRN,P012594,0 days 00:08:54,-11,16,27
169,TRN,P012687,0 days 00:07:34,-4,16,20
169,TRN,P007828,0 days 00:06:48,5,18,13
169,BUD,P011281,0 days 00:21:30,23,58,35
169,BUD,P010248,0 days 00:20:57,21,56,35
169,BUD,P011935,0 days 00:20:36,-12,42,54
169,BUD,P012606,0 days 00:20:33,2,49,47
169,BUD,P005637,0 days 00:19:24,31,55,24
169,BUD,P012630,0 days 00:19:18,0,43,43
169,BUD,P004945,0 days 00:17:35,14,43,29
169,BUD,P006566,0 days 00:17:10,15,43,28
169,BUD,P008325,0 days 00:15:36,3,37,34
169,BUD,P002740,0 days 00:14:47,11,38,27
169,BUD,P010389,0 days 00:09:11,-8,17,25
169,BUD,P009214,0 days 00:03:23,-5,4,9
170,ULM,P010582,0 days 00:27:39,-7,52,59
170,ULM,P012603,0 days 00:23:57,-7,48,55
170,ULM,P012604,0 days 00:23:32,-12,44,56
170,ULM,P012703,0 days 00:23:17,-13,43,56
170,ULM,P010726,0 days 00:22:25,-9,34,43
170,ULM,P005422,0 days 00:22:16,-13,43,56
170,ULM,P011457,0 days 00:17:58,-13,23,36
170,ULM,P007952,0 days 00:16:28,-8,22,30
170,ULM,P011188,0 days 00:15:55,-10,18,28
170,ULM,P012704,0 days 00:06:33,-8,3,11
170,ARI,P012716,0 days 00:34:34,26,78,52
170,ARI,P004292,0 days 00:28:03,19,70,51
170,ARI,P012792,0 days 00:22:40,4,39,35
170,ARI,P012717,0 days 00:22:36,11,56,45
170,ARI,P010387,0 days 00:19:43,26,46,20
170,ARI,P012615,0 days 00:17:24,9,30,21
170,ARI,P012760,0 days 00:15:47,10,32,22
170,ARI,P012702,0 days 00:13:01,9,32,23
170,ARI,P012722,0 days 00:11:05,-2,19,21
170,ARI,P012708,0 days 00:07:15,-5,15,20
170,ARI,P002867,0 days 00:06:46,-9,9,18
170,ARI,P010177,0 days 00:01:06,2,4,2
171,PMT,P011942,0 days 00:34:13,24,88,64
171,PMT,P011944,0 days 00:29:55,16,76,60
171,PMT,P002644,0 days 00:29:07,21,71,50
171,PMT,P012600,0 days 00:28:51,11,69,58
171,PMT,P011947,0 days 00:26:16,23,66,43
171,PMT,P001686,0 days 00:15:59,-5,27,32
171,PMT,P011823,0 days 00:10:53,-7,23,30
171,PMT,P002020,0 days 00:10:50,-3,28,31
171,PMT,P011966,0 days 00:10:05,-2,18,20
171,PMT,P010549,0 days 00:03:51,-8,4,12
171,JOV,P010677,0 days 00:27:11,-23,52,75
171,JOV,P006771,0 days 00:26:20,-8,48,56
171,JOV,P011247,0 days 00:21:26,3,45,42
171,JOV,P012349,0 days 00:19:34,0,47,47
171,JOV,P002507,0 days 00:19:22,-2,40,42
171,JOV,P012780,0 days 00:19:14,-10,37,47
171,JOV,P010458,0 days 00:18:30,-11,32,43
171,JOV,P002361,0 days 00:18:01,-9,32,41
171,JOV,PJUG,0 days 00:17:57,-9,35,44
171,JOV,P010161,0 days 00:12:25,-1,32,33
172,BES,P012647,0 days 00:31:22,-13,60,73
172,BES,P011936,0 days 00:28:46,-20,47,67
172,BES,P011924,0 days 00:27:02,-11,53,64
172,BES,P003783,0 days 00:22:16,-19,39,58
172,BES,P012711,0 days 00:21:16,-11,40,51
172,BES,P012622,0 days 00:20:40,-7,41,48
172,BES,P007914,0 days 00:16:40,-11,24,35
172,BES,P008945,0 days 00:15:06,-2,30,32
172,BES,P007917,0 days 00:10:23,-5,22,27
172,BES,P011357,0 days 00:06:29,-6,9,15
172,HTA,P011973,0 days 00:26:47,10,65,55
172,HTA,P007867,0 days 00:25:25,12,63,51
172,HTA,P011991,0 days 00:24:49,16,62,46
172,HTA,P010550,0 days 00:23:38,14,58,44
172,HTA,P007759,0 days 00:22:20,11,56,45
172,HTA,P006835,0 days 00:20:09,15,45,30
172,HTA,P004846,0 days 00:20:08,11,44,33
172,HTA,P012794,0 days 00:15:06,11,33,22
172,HTA,P010465,0 days 00:12:22,4,26,22
172,HTA,P003533,0 days 00:08:37,0,15,15
172,HTA,P012592,0 days 00:00:39,1,3,2
173,PRS,P012608,0 days 00:22:07,33,70,37
173,PRS,P011232,0 days 00:22:06,20,60,40
173,PRS,P012610,0 days 00:21:58,35,70,35
173,PRS,P012640,0 days 00:21:48,20,60,40
173,PRS,P005793,0 days 00:20:51,23,59,36
173,PRS,P012611,0 days 00:19:48,35,65,30
173,PRS,P012612,0 days 00:18:02,18,49,31
173,PRS,P004512,0 days 00:17:54,33,59,26
173,PRS,P009556,0 days 00:17:53,20,49,29
173,PRS,P012613,0 days 00:17:33,28,54,26
173,LJU,P005969,0 days 00:29:53,-30,56,86
173,LJU,P003514,0 days 00:25:45,-37,35,72
173,LJU,P012700,0 days 00:23:18,-31,36,67
173,LJU,P003452,0 days 00:20:15,-20,42,62
173,LJU,P009392,0 days 00:19:45,-18,37,55
173,LJU,P010594,0 days 00:19:01,-37,22,59
173,LJU,P011261,0 days 00:18:02,-25,32,57
173,LJU,P010771,0 days 00:17:36,-21,31,52
173,LJU,P007066,0 days 00:16:18,-23,29,52
173,LJU,P002561,0 days 00:10:07,-23,10,33
174,LLI,P012586,0 days 00:28:02,-9,54,63
174,LLI,P012797,0 days 00:27:28,-10,51,61
174,LLI,P009680,0 days 00:24:20,2,54,52
174,LLI,P005247,0 days 00:23:32,3,50,47
174,LLI,P006600,0 days 00:23:24,-8,46,54
174,LLI,P012585,0 days 00:21:02,11,46,35
174,LLI,P004773,0 days 00:19:05,-10,33,43
174,LLI,P012020,0 days 00:15:15,2,32,30
174,LLI,P009649,0 days 00:13:04,-12,23,35
174,LLI,P008274,0 days 00:04:48,6,11,5
174,WOL,P005516,0 days 00:28:47,8,60,52
174,WOL,P006546,0 days 00:28:47,6,64,58
174,WOL,P006154,0 days 00:25:41,4,56,52
174,WOL,P004645,0 days 00:23:24,6,48,42
174,WOL,P012576,0 days 00:22:09,10,52,42
174,WOL,P012789,0 days 00:16:16,-7,31,38
174,WOL,P012577,0 days 00:15:02,-10,25,35
174,WOL,P003212,0 days 00:14:48,2,34,32
174,WOL,P006907,0 days 00:12:53,6,27,21
174,WOL,P002387,0 days 00:12:13,0,28,28
175,HAM,P012581,0 days 00:27:37,-4,64,68
175,HAM,P009663,0 days 00:26:15,-2,61,63
175,HAM,P012579,0 days 00:23:30,3,49,46
175,HAM,P012580,0 days 00:22:36,-15,41,56
175,HAM,P012694,0 days 00:17:45,1,37,36
175,HAM,P001990,0 days 00:16:12,-6,30,36
175,HAM,P011168,0 days 00:14:23,-2,35,37
175,HAM,P011187,0 days 00:13:45,-5,22,27
175,HAM,P012648,0 days 00:11:44,-2,21,23
175,HAM,P010070,0 days 00:10:09,1,23,22
175,HAM,P012695,0 days 00:09:25,1,18,17
175,HAM,P012582,0 days 00:06:39,-5,14,19
175,VNC,P004381,0 days 00:26:22,14,64,50
175,VNC,P004117,0 days 00:23:09,9,53,44
175,VNC,P008052,0 days 00:22:38,10,53,43
175,VNC,P011928,0 days 00:22:08,-5,42,47
175,VNC,P003759,0 days 00:21:30,12,56,44
175,VNC,P012591,0 days 00:21:21,3,49,46
175,VNC,P012587,0 days 00:20:51,7,48,41
175,VNC,P009400,0 days 00:14:39,-5,30,35
175,VNC,P012588,0 days 00:13:44,-3,29,32
175,VNC,P012259,0 days 00:13:38,-7,26,33
176,BOU,P010449,0 days 00:25:32,-3,52,55
176,BOU,P010718,0 days 00:24:25,0,52,52
176,BOU,P012628,0 days 00:22:44,1,47,46
176,BOU,P010450,0 days 00:21:25,-1,45,46
176,BOU,P011161,0 days 00:18:38,4,41,37
176,BOU,P011836,0 days 00:18:32,-2,35,37
176,BOU,P012619,0 days 00:14:45,-10,28,38
176,BOU,P012618,0 days 00:14:41,14,40,26
176,BOU,P012617,0 days 00:14:28,-1,29,30
176,BOU,P000498,0 days 00:14:13,-13,22,35
176,BOU,P011837,0 days 00:10:37,-9,14,23
176,ULM,P012703,0 days 00:31:18,-9,59,68
176,ULM,P010582,0 days 00:27:37,13,60,47
176,ULM,P012603,0 days 00:25:38,4,53,49
176,ULM,P012604,0 days 00:22:27,-1,48,49
176,ULM,P005422,0 days 00:22:18,9,49,40
176,ULM,P010726,0 days 00:18:44,2,43,41
176,ULM,P011457,0 days 00:16:32,-4,35,39
176,ULM,P011188,0 days 00:14:22,0,32,32
176,ULM,P007952,0 days 00:13:38,1,25,24
176,ULM,P011391,0 days 00:03:55,4,12,8
176,ULM,P012066,0 days 00:03:31,1,9,8
177,ARI,P003240,0 days 00:25:57,8,54,46
177,ARI,P012716,0 days 00:25:54,6,58,52
177,ARI,P004292,0 days 00:23:58,6,52,46
177,ARI,P012792,0 days 00:23:36,1,51,50
177,ARI,P012615,0 days 00:21:25,23,55,32
177,ARI,P012717,0 days 00:18:35,-16,29,45
177,ARI,P012702,0 days 00:16:43,-6,29,35
177,ARI,P002867,0 days 00:15:10,3,27,24
177,ARI,P010387,0 days 00:12:36,10,36,26
177,ARI,P012760,0 days 00:08:18,-6,12,18
177,ARI,P012722,0 days 00:07:33,5,16,11
177,ARI,P010177,0 days 00:00:15,1,1,0
177,TRN,P012597,0 days 00:33:38,-5,69,74
177,TRN,P012595,0 days 00:30:00,-13,58,71
177,TRN,P005059,0 days 00:24:17,-6,47,53
177,TRN,P009903,0 days 00:20:18,-13,39,52
177,TRN,P012596,0 days 00:19:43,6,38,32
177,TRN,P001479,0 days 00:19:33,-6,33,39
177,TRN,P005738,0 days 00:19:25,4,42,38
177,TRN,P006382,0 days 00:17:24,-1,29,30
177,TRN,P007828,0 days 00:15:42,-1,30,31
178,BUD,P011281,0 days 00:23:01,12,52,40
178,BUD,P007398,0 days 00:21:28,11,51,40
178,BUD,P008325,0 days 00:21:03,26,59,33
178,BUD,P011935,0 days 00:21:01,23,56,33
178,BUD,P010389,0 days 00:20:52,5,47,42
178,BUD,P010248,0 days 00:18:57,-13,31,44
178,BUD,P006566,0 days 00:18:49,4,39,35
178,BUD,P012630,0 days 00:14:50,-4,32,36
178,BUD,P012606,0 days 00:13:30,11,35,24
178,BUD,P005637,0 days 00:12:19,-1,23,24
178,BUD,P004945,0 days 00:07:30,0,14,14
178,BUD,P009214,0 days 00:06:40,-9,11,20
178,CAN,P008121,0 days 00:27:17,-9,53,62
178,CAN,P006588,0 days 00:26:04,-9,50,59
178,CAN,P003425,0 days 00:24:10,-3,49,52
178,CAN,P007644,0 days 00:20:33,-6,37,43
178,CAN,P010385,0 days 00:18:32,-3,40,43
178,CAN,P010452,0 days 00:14:51,-8,27,35
178,CAN,P005005,0 days 00:14:15,1,31,30
178,CAN,P001607,0 days 00:13:36,-13,23,36
178,CAN,P003637,0 days 00:12:36,-10,17,27
178,CAN,P007560,0 days 00:11:44,0,24,24
178,CAN,P004466,0 days 00:08:11,6,20,14
178,CAN,P004160,0 days 00:08:11,-11,14,25
179,LKB,PLXI,0 days 00:33:53,-1,73,74
179,LKB,P007029,0 days 00:33:17,-5,70,75
179,LKB,P009898,0 days 00:31:56,6,74,68
179,LKB,P010461,0 days 00:31:27,14,75,61
179,LKB,P006901,0 days 00:18:12,-3,43,46
179,LKB,P011329,0 days 00:18:10,6,45,39
179,LKB,P005521,0 days 00:17:14,-6,35,41
179,LKB,P010190,0 days 00:15:51,14,45,31
179,CLU,P004862,0 days 00:34:21,-3,74,77
179,CLU,P012621,0 days 00:31:49,-13,67,80
179,CLU,P011801,0 days 00:30:33,13,72,59
179,CLU,P010569,0 days 00:27:38,9,68,59
179,CLU,P005113,0 days 00:24:10,1,55,54
179,CLU,P012698,0 days 00:17:53,-2,40,42
179,CLU,P005714,0 days 00:15:46,-8,26,34
179,CLU,P005373,0 days 00:13:32,-8,28,36
179,CLU,P012620,0 days 00:04:18,-14,5,19
180,WRO,P005531,0 days 00:34:38,-12,63,75
180,WRO,P009896,0 days 00:33:01,-10,61,71
180,WRO,P012094,0 days 00:32:38,-13,65,78
180,WRO,P012699,0 days 00:29:56,-16,52,68
180,WRO,P011900,0 days 00:25:57,-15,43,58
180,WRO,P012736,0 days 00:25:03,-4,42,46
180,WRO,P011902,0 days 00:13:40,-9,19,28
180,WRO,P012308,0 days 00:04:17,1,5,4
180,WRO,P007472,0 days 00:00:50,-2,0,2
180,TTK,P011925,0 days 00:36:22,11,79,68
180,TTK,P006693,0 days 00:34:07,7,72,65
180,TTK,P011834,0 days 00:29:36,15,67,52
180,TTK,P004801,0 days 00:29:12,14,64,50
180,TTK,P011239,0 days 00:28:29,18,70,52
180,TTK,P006883,0 days 00:15:19,5,26,21
180,TTK,P005000,0 days 00:13:12,4,24,20
180,TTK,P010477,0 days 00:10:48,2,22,20
180,TTK,P009845,0 days 00:01:15,0,2,2
180,TTK,P011272,0 days 00:00:50,2,2,0
180,TTK,P011975,0 days 00:00:50,2,2,0
181,LLI,P012797,0 days 00:26:02,22,69,47
181,LLI,P012586,0 days 00:23:00,14,61,47
181,LLI,P012585,0 days 00:22:05,16,58,42
181,LLI,P006600,0 days 00:21:41,15,60,45
181,LLI,P005247,0 days 00:20:05,12,48,36
181,LLI,P009649,0 days 00:19:55,11,52,41
181,LLI,P012020,0 days 00:18:19,8,40,32
181,LLI,P009672,0 days 00:17:00,10,44,34
181,LLI,P009680,0 days 00:17:00,9,39,30
181,LLI,P004773,0 days 00:13:30,0,29,29
181,LLI,P008274,0 days 00:01:23,-2,0,2
181,TTK,P011925,0 days 00:34:39,-14,73,87
181,TTK,P006693,0 days 00:27:53,-23,52,75
181,TTK,P011239,0 days 00:26:50,-16,46,62
181,TTK,P011834,0 days 00:25:46,-17,50,67
181,TTK,P005000,0 days 00:21:00,-14,36,50
181,TTK,P010477,0 days 00:20:28,-20,34,54
181,TTK,P004801,0 days 00:19:32,-3,43,46
181,TTK,P006883,0 days 00:16:15,-4,37,41
181,TTK,P009845,0 days 00:06:14,-6,12,18
181,TTK,P011975,0 days 00:01:23,2,2,0
182,ULM,P010582,0 days 00:30:53,-5,62,67
182,ULM,P012604,0 days 00:26:40,-3,58,61
182,ULM,P012603,0 days 00:25:19,7,56,49
182,ULM,P010106,0 days 00:24:04,1,52,51
182,ULM,P005422,0 days 00:23:57,7,48,41
182,ULM,P012703,0 days 00:19:18,-11,33,44
182,ULM,P011457,0 days 00:17:28,-12,36,48
182,ULM,P011188,0 days 00:13:00,-8,23,31
182,ULM,P006997,0 days 00:08:32,-7,12,19
182,ULM,P007952,0 days 00:06:29,-7,9,16
182,ULM,P010726,0 days 00:04:20,-7,6,13
182,JOV,P011247,0 days 00:31:25,7,74,67
182,JOV,P010458,0 days 00:27:35,11,62,51
182,JOV,P011248,0 days 00:26:42,20,67,47
182,JOV,P002507,0 days 00:23:52,3,46,43
182,JOV,P002361,0 days 00:23:51,12,56,44
182,JOV,P010677,0 days 00:18:30,-1,36,37
182,JOV,P012780,0 days 00:15:59,4,40,36
182,JOV,P010161,0 days 00:12:32,-2,26,28
182,JOV,P006771,0 days 00:11:42,-10,18,28
182,JOV,PJUG,0 days 00:07:52,1,15,14
183,CAN,P003425,0 days 00:29:37,7,61,54
183,CAN,P008121,0 days 00:28:41,2,57,55
183,CAN,P003637,0 days 00:23:52,5,51,46
183,CAN,P010385,0 days 00:22:01,3,45,42
183,CAN,P006588,0 days 00:20:37,3,39,36
183,CAN,P010452,0 days 00:19:08,-3,39,42
183,CAN,P009864,0 days 00:17:44,-3,33,36
183,CAN,P005005,0 days 00:13:36,-6,21,27
183,CAN,P001607,0 days 00:11:09,-10,19,29
183,CAN,P004160,0 days 00:10:08,-2,18,20
183,CAN,P007560,0 days 00:03:12,-4,7,11
183,CAN,P007644,0 days 00:00:15,-2,0,2
183,BES,P012622,0 days 00:36:08,0,73,73
183,BES,P008945,0 days 00:27:14,6,58,52
183,BES,P012711,0 days 00:25:14,7,50,43
183,BES,P011936,0 days 00:22:20,8,46,38
183,BES,P012647,0 days 00:21:57,-2,42,44
183,BES,P003783,0 days 00:18:01,-3,39,42
183,BES,P011379,0 days 00:16:33,3,29,26
183,BES,P011924,0 days 00:14:45,-6,27,33
183,BES,P007914,0 days 00:13:00,5,29,24
183,BES,P007917,0 days 00:04:48,-8,7,15
184,PMT,P011944,0 days 00:27:40,24,68,44
184,PMT,P005301,0 days 00:25:43,19,62,43
184,PMT,P002644,0 days 00:23:39,10,52,42
184,PMT,P011943,0 days 00:23:21,13,54,41
184,PMT,P012600,0 days 00:23:03,21,57,36
184,PMT,P011942,0 days 00:22:50,20,59,39
184,PMT,P011947,0 days 00:19:05,9,42,33
184,PMT,P011823,0 days 00:14:16,16,39,23
184,PMT,P001686,0 days 00:13:54,7,30,23
184,PMT,P002691,0 days 00:04:24,-1,8,9
184,PMT,P002020,0 days 00:02:05,2,4,2
184,ARI,P003240,0 days 00:28:47,-17,48,65
184,ARI,P012716,0 days 00:27:49,-18,46,64
184,ARI,P012717,0 days 00:27:06,-18,49,67
184,ARI,P004292,0 days 00:26:38,-12,47,59
184,ARI,P012615,0 days 00:19:02,-15,29,44
184,ARI,P012792,0 days 00:18:39,-18,32,50
184,ARI,P012760,0 days 00:12:56,-12,19,31
184,ARI,P012702,0 days 00:12:02,-10,22,32
184,ARI,P002867,0 days 00:08:46,-11,11,22
184,ARI,P010387,0 days 00:08:14,-6,15,21
184,ARI,P012722,0 days 00:07:56,-1,15,16
184,ARI,P010177,0 days 00:02:05,-2,2,4
185,PRS,P011232,0 days 00:28:43,14,60,46
185,PRS,P012608,0 days 00:28:01,23,69,46
185,PRS,P012610,0 days 00:25:16,13,56,43
185,PRS,P012613,0 days 00:23:50,15,57,42
185,PRS,P012640,0 days 00:21:37,10,49,39
185,PRS,P012609,0 days 00:20:43,14,48,34
185,PRS,P003481,0 days 00:17:45,5,37,32
185,PRS,P005793,0 days 00:15:13,-3,26,29
185,PRS,P009556,0 days 00:11:59,-7,17,24
185,PRS,P004512,0 days 00:06:53,-4,11,15
185,JOV,P011248,0 days 00:34:52,-15,63,78
185,JOV,P011247,0 days 00:31:28,-9,61,70
185,JOV,P002361,0 days 00:23:39,-5,44,49
185,JOV,P002507,0 days 00:23:31,-11,45,56
185,JOV,P010458,0 days 00:22:21,-6,42,48
185,JOV,P012780,0 days 00:19:51,-13,28,41
185,JOV,P010677,0 days 00:19:39,-16,29,45
185,JOV,P012349,0 days 00:14:31,-2,25,27
185,JOV,P010161,0 days 00:05:26,-5,7,12
185,JOV,P006771,0 days 00:04:42,2,6,4
186,CLU,P012621,0 days 00:31:23,-7,62,69
186,CLU,P012698,0 days 00:28:18,-1,60,61
186,CLU,P005714,0 days 00:27:05,0,59,59
186,CLU,P004862,0 days 00:23:20,-12,42,54
186,CLU,P010569,0 days 00:21:23,-12,38,50
186,CLU,P011801,0 days 00:17:17,-10,35,45
186,CLU,P011797,0 days 00:16:49,-11,30,41
186,CLU,P005113,0 days 00:15:48,-13,26,39
186,CLU,P005373,0 days 00:13:25,3,32,29
186,CLU,P012620,0 days 00:05:12,3,11,8
186,LLI,P012585,0 days 00:27:24,1,63,62
186,LLI,P005247,0 days 00:24:08,9,53,44
186,LLI,P009672,0 days 00:23:47,2,53,51
186,LLI,P009680,0 days 00:23:38,8,52,44
186,LLI,P012586,0 days 00:22:38,2,50,48
186,LLI,P012020,0 days 00:22:23,9,52,43
186,LLI,P009649,0 days 00:21:43,3,49,46
186,LLI,P012797,0 days 00:20:39,8,43,35
186,LLI,P004773,0 days 00:10:49,15,31,16
186,LLI,P004479,0 days 00:02:51,3,9,6
187,BOU,P011836,0 days 00:26:33,13,66,53
187,BOU,P010431,0 days 00:24:43,5,60,55
187,BOU,P012617,0 days 00:22:47,20,61,41
187,BOU,P011837,0 days 00:21:51,14,57,43
187,BOU,P012628,0 days 00:20:44,16,54,38
187,BOU,P010718,0 days 00:20:07,-1,45,46
187,BOU,P004525,0 days 00:18:29,-3,43,46
187,BOU,P010449,0 days 00:17:13,-7,34,41
187,BOU,P011161,0 days 00:14:26,6,31,25
187,BOU,P012618,0 days 00:13:07,2,24,22
187,PMT,P012600,0 days 00:30:08,1,68,67
187,PMT,P002644,0 days 00:26:26,-1,60,61
187,PMT,P011944,0 days 00:25:28,-15,46,61
187,PMT,P005301,0 days 00:23:03,-8,45,53
187,PMT,P011942,0 days 00:19:42,-8,39,47
187,PMT,P011943,0 days 00:18:28,-5,39,44
187,PMT,P002691,0 days 00:14:36,-1,35,36
187,PMT,P011823,0 days 00:13:34,-12,22,34
187,PMT,P001686,0 days 00:12:38,-3,23,26
187,PMT,P011966,0 days 00:12:28,-9,22,31
187,PMT,P002020,0 days 00:03:29,-4,11,15
188,HTA,P007867,0 days 00:32:47,-2,76,78
188,HTA,P004846,0 days 00:29:02,-1,68,69
188,HTA,P010550,0 days 00:27:56,-4,62,66
188,HTA,P006835,0 days 00:26:38,6,61,55
188,HTA,P011973,0 days 00:21:26,-15,45,60
188,HTA,P010465,0 days 00:16:55,-9,37,46
188,HTA,P007759,0 days 00:16:36,-4,30,34
188,HTA,P004267,0 days 00:10:16,3,26,23
188,HTA,P011991,0 days 00:08:38,9,19,10
188,HTA,P012794,0 days 00:05:46,-11,11,22
188,HTA,P003533,0 days 00:04:00,3,10,7
188,BES,P011936,0 days 00:32:36,13,84,71
188,BES,P012647,0 days 00:29:49,16,84,68
188,BES,P012622,0 days 00:26:12,18,63,45
188,BES,P012711,0 days 00:25:39,7,60,53
188,BES,P008945,0 days 00:21:31,7,54,47
188,BES,P003783,0 days 00:20:23,-6,40,46
188,BES,P011379,0 days 00:17:30,-13,29,42
188,BES,P011924,0 days 00:17:18,-10,36,46
188,BES,P007914,0 days 00:08:07,-7,16,23
188,BES,P007917,0 days 00:00:55,0,4,4
189,PRS,P012608,0 days 00:26:33,16,65,49
189,PRS,P012610,0 days 00:26:24,13,68,55
189,PRS,P011232,0 days 00:23:44,5,64,59
189,PRS,P012613,0 days 00:23:02,2,52,50
189,PRS,P012640,0 days 00:22:59,6,63,57
189,PRS,P012609,0 days 00:22:36,9,58,49
189,PRS,P012611,0 days 00:15:02,4,32,28
189,PRS,P004512,0 days 00:14:47,10,32,22
189,PRS,P009556,0 days 00:13:27,-3,34,37
189,PRS,P005793,0 days 00:11:26,3,27,24
189,LLI,P012797,0 days 00:24:40,-4,52,56
189,LLI,P009649,0 days 00:24:28,-2,51,53
189,LLI,P012585,0 days 00:24:25,-9,53,62
189,LLI,P012586,0 days 00:23:51,-4,49,53
189,LLI,P006600,0 days 00:23:04,-2,55,57
189,LLI,P009672,0 days 00:22:35,-15,44,59
189,LLI,P009680,0 days 00:17:31,-10,36,46
189,LLI,P005247,0 days 00:14:02,-12,30,42
189,LLI,P004773,0 days 00:13:00,-4,25,29
189,LLI,P012020,0 days 00:06:39,-3,16,19
189,LLI,P004479,0 days 00:05:45,0,19,19
190,BOU,P011836,0 days 00:29:23,-1,61,62
190,BOU,P012617,0 days 00:26:03,8,62,54
190,BOU,P010718,0 days 00:23:26,4,55,51
190,BOU,P011837,0 days 00:21:44,10,47,37
190,BOU,P010431,0 days 00:21:07,2,42,40
190,BOU,P011161,0 days 00:18:47,8,38,30
190,BOU,P012628,0 days 00:16:55,10,37,27
190,BOU,P004525,0 days 00:15:07,7,35,28
190,BOU,P010449,0 days 00:13:57,4,24,20
190,BOU,P012618,0 days 00:13:31,8,29,21
190,BES,P012647,0 days 00:29:28,-8,52,60
190,BES,P008945,0 days 00:29:19,-10,54,64
190,BES,P011379,0 days 00:23:10,0,49,49
190,BES,P011936,0 days 00:21:45,-13,35,48
190,BES,P012622,0 days 00:21:38,-8,33,41
190,BES,P007914,0 days 00:19:26,-7,36,43
190,BES,P011924,0 days 00:18:43,-7,38,45
190,BES,P003783,0 days 00:17:56,-1,37,38
190,BES,P012711,0 days 00:16:58,-1,35,36
190,BES,P007917,0 days 00:01:15,-5,1,6
190,BES,P011357,0 days 00:00:22,0,0,0
191,LLI,P012585,0 days 00:27:51,-13,58,71
191,LLI,P009680,0 days 00:25:18,-13,53,66
191,LLI,P009672,0 days 00:24:53,5,62,57
191,LLI,P006600,0 days 00:21:58,-14,37,51
191,LLI,P012797,0 days 00:21:04,-9,39,48
191,LLI,P005247,0 days 00:19:58,14,54,40
191,LLI,P004773,0 days 00:18:18,-2,40,42
191,LLI,P009649,0 days 00:15:25,-15,25,40
191,LLI,P012020,0 days 00:15:16,4,36,32
191,LLI,P012586,0 days 00:09:59,3,21,18
191,PRS,P012608,0 days 00:27:15,4,65,61
191,PRS,P012610,0 days 00:27:01,4,65,61
191,PRS,P011232,0 days 00:22:09,3,52,49
191,PRS,P012613,0 days 00:22:01,8,51,43
191,PRS,P012609,0 days 00:21:00,0,44,44
191,PRS,P004512,0 days 00:20:25,8,50,42
191,PRS,P012640,0 days 00:20:12,5,47,42
191,PRS,P012611,0 days 00:19:17,3,46,43
191,PRS,P009556,0 days 00:12:45,4,28,24
191,PRS,P005793,0 days 00:07:55,1,17,16
192,BES,P011936,0 days 00:32:46,9,68,59
192,BES,P012647,0 days 00:30:48,8,60,52
192,BES,P012622,0 days 00:30:32,3,58,55
192,BES,P008945,0 days 00:27:15,-6,46,52
192,BES,P007914,0 days 00:23:06,0,44,44
192,BES,P012711,0 days 00:17:23,6,38,32
192,BES,P003783,0 days 00:16:47,22,48,26
192,BES,P011379,0 days 00:15:17,12,37,25
192,BES,P011924,0 days 00:06:06,1,11,10
192,BOU,P010431,0 days 00:24:23,-5,46,51
192,BOU,P011836,0 days 00:23:30,-8,42,50
192,BOU,P010718,0 days 00:21:37,1,41,40
192,BOU,P012618,0 days 00:21:31,1,40,39
192,BOU,P012617,0 days 00:21:14,-16,31,47
192,BOU,P010449,0 days 00:18:46,5,40,35
192,BOU,P011837,0 days 00:18:29,-12,31,43
192,BOU,P011161,0 days 00:17:32,-11,27,38
192,BOU,P012628,0 days 00:16:56,-9,30,39
192,BOU,P004525,0 days 00:16:02,-1,27,28
194,BOU,P011161,0 days 00:24:24,17,55,38
194,BOU,P011836,0 days 00:23:29,5,53,48
194,BOU,P010718,0 days 00:21:59,15,50,35
194,BOU,P010449,0 days 00:21:37,18,48,30
194,BOU,P004525,0 days 00:18:59,12,42,30
194,BOU,P010431,0 days 00:17:35,14,44,30
194,BOU,P011837,0 days 00:16:57,24,42,18
194,BOU,P012617,0 days 00:16:35,7,37,30
194,BOU,P012628,0 days 00:16:06,6,29,23
194,BOU,P010450,0 days 00:10:37,19,25,6
194,BOU,P012618,0 days 00:09:35,-8,16,24
194,BOU,P000498,0 days 00:02:07,1,4,3
194,BES,P008945,0 days 00:31:50,-22,50,72
194,BES,P011379,0 days 00:28:31,-20,46,66
194,BES,P007914,0 days 00:28:19,-7,50,57
194,BES,P011924,0 days 00:26:09,-28,33,61
194,BES,P003783,0 days 00:20:52,-14,34,48
194,BES,P012711,0 days 00:20:01,-12,31,43
194,BES,P011936,0 days 00:15:32,-6,26,32
194,BES,P012647,0 days 00:12:26,2,31,29
194,BES,P011357,0 days 00:10:34,-15,10,25
194,BES,P007917,0 days 00:05:46,-8,4,12
195,PRS,P012608,0 days 00:24:29,17,49,32
195,PRS,P011232,0 days 00:23:10,4,43,39
195,PRS,P012610,0 days 00:22:19,19,45,26
195,PRS,P012611,0 days 00:20:49,5,36,31
195,PRS,P012640,0 days 00:19:37,3,41,38
195,PRS,P012609,0 days 00:18:06,8,38,30
195,PRS,P004512,0 days 00:17:54,4,31,27
195,PRS,P012613,0 days 00:17:43,13,37,24
195,PRS,P009556,0 days 00:15:31,-4,28,32
195,PRS,P003481,0 days 00:14:00,1,25,24
195,PRS,P005793,0 days 00:05:17,-5,9,14
195,PRS,P011887,0 days 00:01:05,0,3,3
195,BOU,P011836,0 days 00:24:37,-11,39,50
195,BOU,P010718,0 days 00:23:51,-16,36,52
195,BOU,P012618,0 days 00:20:36,-5,30,35
195,BOU,P012628,0 days 00:19:48,-1,30,31
195,BOU,P012617,0 days 00:19:25,-6,28,34
195,BOU,P011161,0 days 00:19:05,-10,25,35
195,BOU,P004525,0 days 00:18:20,-5,31,36
195,BOU,P011837,0 days 00:16:27,-5,28,33
195,BOU,P010449,0 days 00:14:57,2,24,22
195,BOU,P000498,0 days 00:12:27,1,28,27
195,BOU,P010431,0 days 00:10:27,-9,21,30
196,BOU,P011836,0 days 00:27:44,-13,53,66
196,BOU,P012617,0 days 00:24:25,-6,50,56
196,BOU,P010449,0 days 00:23:20,-3,46,49
196,BOU,P010718,0 days 00:21:34,2,48,46
196,BOU,P011837,0 days 00:20:25,-4,40,44
196,BOU,P012618,0 days 00:17:39,-4,36,40
196,BOU,P011161,0 days 00:17:00,4,35,31
196,BOU,P012628,0 days 00:16:15,-16,27,43
196,BOU,P010431,0 days 00:15:12,-2,34,36
196,BOU,P004525,0 days 00:14:12,5,33,28
196,BOU,P010450,0 days 00:02:14,-3,3,6
196,PRS,P012608,0 days 00:30:16,2,70,68
196,PRS,P012610,0 days 00:26:12,-2,56,58
196,PRS,P012613,0 days 00:25:31,2,56,54
196,PRS,P012640,0 days 00:22:28,12,53,41
196,PRS,P012609,0 days 00:20:06,16,47,31
196,PRS,P004512,0 days 00:18:13,-8,36,44
196,PRS,P012611,0 days 00:17:24,-6,35,41
196,PRS,P011232,0 days 00:16:21,6,40,34
196,PRS,P003481,0 days 00:13:48,10,33,23
196,PRS,P009556,0 days 00:09:41,8,19,11
