GAMECODE,CODETEAM,joueur_1,joueur_2,TIME,DELTA_SCORE,OFF,DEF
1,RED,P006436,P011224,0 days 00:20:40,20,58,38
1,RED,P002553,P006436,0 days 00:19:19,14,51,37
1,RED,P006436,P012711,0 days 00:15:08,14,44,30
1,RED,P005099,P011964,0 days 00:14:33,-1,25,26
1,RED,P002553,P011224,0 days 00:13:49,10,34,24
1,RED,P011224,P012711,0 days 00:13:27,14,42,28
1,RED,P012711,PLUO,0 days 00:12:46,7,36,29
1,RED,P005099,PJDR,0 days 00:12:28,7,25,18
1,RED,P002553,P005099,0 days 00:11:39,10,30,20
1,RED,P005099,P008966,0 days 00:11:27,0,17,17
1,RED,P005099,P006436,0 days 00:11:23,4,25,21
1,RED,P006436,PLUO,0 days 00:10:25,11,34,23
1,RED,P011224,PLUO,0 days 00:10:25,11,34,23
1,RED,P011964,PJDR,0 days 00:10:05,4,20,16
1,RED,P000848,P005099,0 days 00:09:43,-3,13,16
1,RED,P003479,P006436,0 days 00:09:10,13,34,21
1,RED,P003479,PLUO,0 days 00:08:56,6,26,20
1,RED,P003479,P012711,0 days 00:08:56,6,26,20
1,RED,P000848,P008966,0 days 00:08:35,0,11,11
1,RED,P003479,P011224,0 days 00:08:12,11,30,19
1,RED,P002553,PJDR,0 days 00:07:43,10,24,14
1,RED,P000848,P011964,0 days 00:07:35,-5,8,13
1,RED,P006436,PJDR,0 days 00:07:11,4,19,15
1,RED,P002553,P011964,0 days 00:06:58,4,17,13
1,RED,P000848,PJDR,0 days 00:06:53,1,10,9
1,RED,P002553,P012711,0 days 00:06:52,4,18,14
1,RED,P000848,P002553,0 days 00:06:45,12,21,9
1,RED,P008966,P011964,0 days 00:06:42,-3,8,11
1,RED,P006436,P008966,0 days 00:06:22,6,12,6
1,RED,P000848,P006436,0 days 00:06:19,9,18,9
1,RED,P008966,PJDR,0 days 00:05:43,-1,5,6
1,RED,P000848,P003479,0 days 00:05:38,2,15,13
1,RED,P006436,P011964,0 days 00:05:27,1,13,12
1,RED,P000848,P011224,0 days 00:05:21,7,14,7
1,RED,P005099,P011224,0 days 00:05:10,2,10,8
1,RED,P000848,P012711,0 days 00:05:05,-3,7,10
1,RED,P004720,P011964,0 days 00:05:04,-1,9,10
1,RED,P004720,P005099,0 days 00:05:04,-1,9,10
1,RED,P005099,P012711,0 days 00:04:55,-3,7,10
1,RED,P008966,P011224,0 days 00:04:41,6,10,4
1,RED,P002553,P008966,0 days 00:04:25,6,10,4
1,RED,P002553,PLUO,0 days 00:03:50,1,10,9
1,RED,P000848,P004720,0 days 00:03:33,-4,5,9
1,RED,P002553,P003479,0 days 00:03:17,6,13,7
1,RED,P012711,PJDR,0 days 00:02:52,-3,2,5
1,RED,P003479,PJDR,0 days 00:02:51,2,7,5
1,RED,P004720,P008966,0 days 00:02:40,-2,5,7
1,RED,P000848,PLUO,0 days 00:02:21,-4,2,6
1,RED,P003479,P005099,0 days 00:01:52,2,5,3
1,RED,P008966,P012711,0 days 00:01:41,0,2,2
1,RED,P002553,P004720,0 days 00:01:31,3,4,1
1,RED,P004720,PJDR,0 days 00:01:31,3,4,1
1,RED,PJDR,PLUO,0 days 00:01:11,-3,0,3
1,RED,P005099,PLUO,0 days 00:01:10,-1,2,3
1,RED,P011224,P011964,0 days 00:00:55,-1,0,1
1,RED,P004720,P012711,0 days 00:00:53,-2,0,2
1,RED,P011964,P012711,0 days 00:00:53,-2,0,2
1,ASV,P011225,P012080,0 days 00:27:03,-17,51,68
1,ASV,P002100,P012080,0 days 00:24:01,-22,47,69
1,ASV,P002100,P004194,0 days 00:22:39,-17,45,62
1,ASV,P004194,P012080,0 days 00:22:39,-17,45,62
1,ASV,P002100,P011225,0 days 00:21:36,-21,40,61
1,ASV,P004194,P011225,0 days 00:21:02,-16,40,56
1,ASV,P012080,P012730,0 days 00:19:25,-17,37,54
1,ASV,P011225,P012730,0 days 00:19:10,-11,36,47
1,ASV,P012729,P012732,0 days 00:15:59,1,26,25
1,ASV,P002100,P012730,0 days 00:15:10,-19,28,47
1,ASV,P004194,P012730,0 days 00:13:48,-14,26,40
1,ASV,P011225,P012729,0 days 00:13:41,0,27,27
1,ASV,P012080,P012729,0 days 00:12:19,-5,23,28
1,ASV,P012729,P012731,0 days 00:10:51,-1,17,18
1,ASV,P012729,P012730,0 days 00:10:46,0,22,22
1,ASV,P012731,P012732,0 days 00:10:03,-1,15,16
1,ASV,P012730,P012732,0 days 00:09:24,5,20,15
1,ASV,P011225,P012732,0 days 00:08:06,7,17,10
1,ASV,P002100,P012729,0 days 00:07:59,-10,14,24
1,ASV,P012730,P012731,0 days 00:07:34,2,18,16
1,ASV,P006568,P012732,0 days 00:06:35,-4,6,10
1,ASV,P006568,P012729,0 days 00:06:35,-4,6,10
1,ASV,P011386,P012732,0 days 00:06:17,-3,7,10
1,ASV,P011386,P012729,0 days 00:06:17,-3,7,10
1,ASV,P012080,P012732,0 days 00:05:56,2,11,9
1,ASV,P011386,P012731,0 days 00:05:48,-1,7,8
1,ASV,P006568,P011225,0 days 00:05:31,-1,11,12
1,ASV,P006568,P012080,0 days 00:05:31,-1,11,12
1,ASV,P002100,P006568,0 days 00:05:26,-4,11,15
1,ASV,P004194,P012729,0 days 00:05:01,-2,10,12
1,ASV,P006568,P012731,0 days 00:04:54,-4,4,8
1,ASV,P002100,P012731,0 days 00:04:01,-4,9,13
1,ASV,P004194,P006568,0 days 00:03:50,-1,9,10
1,ASV,P006568,P011386,0 days 00:03:18,-1,2,3
1,ASV,P011386,P012730,0 days 00:02:59,-2,5,7
1,ASV,P011225,P012731,0 days 00:02:39,3,6,3
1,ASV,P012080,P012731,0 days 00:02:25,-1,7,8
1,ASV,P004194,P012731,0 days 00:01:37,-1,5,6
1,ASV,P002100,P012732,0 days 00:01:36,-3,2,5
1,ASV,P011386,P012080,0 days 00:00:29,-2,0,2
2,BAR,P002939,P006435,0 days 00:23:26,7,54,47
2,BAR,P002939,P004866,0 days 00:21:30,6,48,42
2,BAR,P004866,P006435,0 days 00:21:30,6,48,42
2,BAR,P002939,P011244,0 days 00:18:27,1,46,45
2,BAR,P006435,P011244,0 days 00:18:27,1,46,45
2,BAR,P004866,P011244,0 days 00:17:06,2,42,40
2,BAR,P007519,P012745,0 days 00:14:53,8,32,24
2,BAR,P007519,P009992,0 days 00:14:00,13,35,22
2,BAR,P000925,P006435,0 days 00:13:31,5,24,19
2,BAR,P000925,P003478,0 days 00:12:41,13,27,14
2,BAR,P009992,P012745,0 days 00:12:19,11,30,19
2,BAR,P000925,P002939,0 days 00:12:14,5,24,19
2,BAR,P000925,P004866,0 days 00:11:39,3,22,19
2,BAR,P000925,P011244,0 days 00:10:15,1,23,22
2,BAR,P003478,P007519,0 days 00:10:05,6,23,17
2,BAR,P000925,P007519,0 days 00:09:44,9,23,14
2,BAR,P003478,P012745,0 days 00:09:42,8,22,14
2,BAR,P000925,P012745,0 days 00:09:21,11,22,11
2,BAR,P003196,P006435,0 days 00:09:15,0,24,24
2,BAR,P002939,P003196,0 days 00:09:15,0,24,24
2,BAR,P003196,P012745,0 days 00:08:09,1,16,15
2,BAR,P003196,P011244,0 days 00:07:56,0,22,22
2,BAR,P003196,P004866,0 days 00:07:54,1,20,19
2,BAR,P007464,P007519,0 days 00:07:46,1,16,15
2,BAR,P000925,P009992,0 days 00:07:31,9,21,12
2,BAR,P003478,P009992,0 days 00:07:31,9,21,12
2,BAR,P003478,P006435,0 days 00:07:08,9,14,5
2,BAR,P007464,P012745,0 days 00:07:03,-1,14,15
2,BAR,P003196,P007464,0 days 00:06:50,1,14,13
2,BAR,P003196,P007519,0 days 00:06:50,1,14,13
2,BAR,P003196,P009992,0 days 00:06:29,4,14,10
2,BAR,P007464,P009992,0 days 00:06:29,4,14,10
2,BAR,P002939,P003478,0 days 00:05:51,9,14,5
2,BAR,P006435,P012745,0 days 00:04:18,0,6,6
2,BAR,P003478,P004866,0 days 00:03:55,8,8,0
2,BAR,P003478,P011244,0 days 00:03:52,5,13,8
2,BAR,P002939,P012745,0 days 00:03:01,0,6,6
2,BAR,P004866,P012745,0 days 00:02:26,-2,4,6
2,BAR,P003196,P003478,0 days 00:01:42,-4,4,8
2,BAR,P007519,P011244,0 days 00:01:41,2,5,3
2,BAR,P009992,P011244,0 days 00:01:41,2,5,3
2,BAR,P006435,P007519,0 days 00:01:17,0,0,0
2,BAR,P003478,P007464,0 days 00:01:17,-3,2,5
2,BAR,P000925,P007464,0 days 00:00:56,0,2,2
2,BAR,P007464,P011244,0 days 00:00:43,2,2,0
2,BAR,P011244,P012745,0 days 00:00:24,-4,0,4
2,IST,P007200,P011078,0 days 00:26:18,-2,56,58
2,IST,P007200,P009664,0 days 00:22:37,-13,32,45
2,IST,P004888,P007200,0 days 00:20:01,-7,38,45
2,IST,P004888,P011981,0 days 00:17:33,-14,29,43
2,IST,P004554,P007200,0 days 00:16:55,0,34,34
2,IST,P009664,P011078,0 days 00:16:27,-5,29,34
2,IST,P004554,P011078,0 days 00:16:12,2,34,32
2,IST,P004554,P009664,0 days 00:15:43,2,32,30
2,IST,P004888,P009846,0 days 00:14:32,-11,27,38
2,IST,P004888,P009664,0 days 00:14:30,-10,24,34
2,IST,P004888,P006590,0 days 00:14:13,-15,21,36
2,IST,P004888,P011078,0 days 00:13:51,1,35,34
2,IST,P007200,P011981,0 days 00:13:27,-8,21,29
2,IST,P009846,P011981,0 days 00:12:24,-15,17,32
2,IST,P009664,P011981,0 days 00:11:14,-15,13,28
2,IST,P006372,P009664,0 days 00:10:02,-3,21,24
2,IST,P009664,P009846,0 days 00:09:26,-6,18,24
2,IST,P006372,P011078,0 days 00:09:17,-1,19,20
2,IST,P006372,P007200,0 days 00:09:17,-1,19,20
2,IST,P004554,P006372,0 days 00:09:17,-1,19,20
2,IST,P006590,P009846,0 days 00:08:53,-7,17,24
2,IST,P007200,P009846,0 days 00:08:53,-6,14,20
2,IST,P006590,P007200,0 days 00:08:43,-10,8,18
2,IST,P011078,P011981,0 days 00:08:00,-2,18,20
2,IST,P004554,P004888,0 days 00:07:54,2,20,18
2,IST,P006590,P009664,0 days 00:07:49,-2,11,13
2,IST,P006590,P011981,0 days 00:07:28,-8,8,16
2,IST,P004554,P006590,0 days 00:05:56,-5,9,14
2,IST,P006590,P011078,0 days 00:05:46,-6,8,14
2,IST,P009846,P011078,0 days 00:05:40,-2,11,13
2,IST,P011078,PLHK,0 days 00:03:41,7,14,7
2,IST,P011981,PLHK,0 days 00:03:41,7,14,7
2,IST,P004888,PLHK,0 days 00:03:41,7,14,7
2,IST,P007200,PLHK,0 days 00:03:41,7,14,7
2,IST,P009513,P011981,0 days 00:03:12,-7,2,9
2,IST,P009513,P009846,0 days 00:03:12,-7,2,9
2,IST,P006590,P009513,0 days 00:03:12,-7,2,9
2,IST,P004888,P009513,0 days 00:03:12,-7,2,9
2,IST,P004554,P009846,0 days 00:01:55,4,8,4
2,IST,P004888,P006372,0 days 00:00:45,-2,2,4
2,IST,P006372,P009846,0 days 00:00:45,-2,2,4
2,IST,P006372,P011981,0 days 00:00:45,-2,2,4
3,MUN,P007056,P010391,0 days 00:23:16,20,51,31
3,MUN,P006760,P007056,0 days 00:20:03,-2,30,32
3,MUN,P003583,P006760,0 days 00:17:31,6,32,26
3,MUN,P006760,P008985,0 days 00:17:12,8,31,23
3,MUN,P007056,P008985,0 days 00:16:45,13,34,21
3,MUN,P003583,P007056,0 days 00:14:42,4,26,22
3,MUN,P006760,P010391,0 days 00:14:41,10,26,16
3,MUN,P003583,P008985,0 days 00:14:32,12,31,19
3,MUN,P007056,P007975,0 days 00:14:12,-5,23,28
3,MUN,P003583,P010391,0 days 00:14:00,10,26,16
3,MUN,P008985,P010391,0 days 00:13:16,23,32,9
3,MUN,P007975,P010391,0 days 00:12:19,-1,24,25
3,MUN,P004508,P007056,0 days 00:11:16,6,21,15
3,MUN,P007056,P011987,0 days 00:11:14,-14,14,28
3,MUN,P006760,P011987,0 days 00:11:11,-10,18,28
3,MUN,P004508,P011987,0 days 00:10:43,-9,17,26
3,MUN,P005478,P007975,0 days 00:10:10,10,28,18
3,MUN,P004508,P007975,0 days 00:09:58,4,22,18
3,MUN,P007975,P011987,0 days 00:09:57,-2,22,24
3,MUN,P004508,P008985,0 days 00:09:41,3,19,16
3,MUN,P004508,P006760,0 days 00:09:04,-7,13,20
3,MUN,P004508,P010391,0 days 00:08:56,16,24,8
3,MUN,P006760,P007975,0 days 00:08:40,-8,13,21
3,MUN,P008985,P011987,0 days 00:08:01,-10,10,20
3,MUN,P005478,P010391,0 days 00:07:59,5,21,16
3,MUN,P005478,P007056,0 days 00:07:59,3,18,15
3,MUN,P004508,P005478,0 days 00:07:40,7,19,12
3,MUN,P005478,P011987,0 days 00:07:27,1,17,16
3,MUN,P004508,P011941,0 days 00:05:43,9,16,7
3,MUN,P007056,P011941,0 days 00:04:21,7,11,4
3,MUN,P010391,P011941,0 days 00:04:20,7,12,5
3,MUN,P008985,P011941,0 days 00:03:58,5,9,4
3,MUN,P003583,P011987,0 days 00:03:57,-4,8,12
3,MUN,P007975,P011941,0 days 00:03:51,7,12,5
3,MUN,P010391,P011987,0 days 00:03:33,-2,8,10
3,MUN,P011941,P011987,0 days 00:03:29,5,9,4
3,MUN,P005478,P011941,0 days 00:03:28,5,10,5
3,MUN,P003583,P007975,0 days 00:03:25,-6,3,9
3,MUN,P003583,P004508,0 days 00:03:15,2,8,6
3,MUN,P007639,P011987,0 days 00:02:20,-3,5,8
3,MUN,P007639,P007975,0 days 00:02:20,-3,5,8
3,MUN,P006760,P007639,0 days 00:02:20,-3,5,8
3,MUN,P004508,P007639,0 days 00:02:20,-3,5,8
3,MUN,P006760,P011941,0 days 00:02:06,3,5,2
3,MUN,P005478,P008985,0 days 00:01:43,-2,2,4
3,MUN,P005478,P006760,0 days 00:00:40,3,3,0
3,MUN,P003583,P005478,0 days 00:00:26,0,2,2
3,BER,P003958,P006919,0 days 00:22:28,-2,35,37
3,BER,P006919,P008967,0 days 00:22:22,7,45,38
3,BER,P006919,P012720,0 days 00:22:03,7,45,38
3,BER,P008967,P012720,0 days 00:22:03,6,45,39
3,BER,P003958,P012720,0 days 00:20:15,-8,30,38
3,BER,P003958,P008967,0 days 00:19:45,-8,28,36
3,BER,P006919,P007550,0 days 00:16:53,-7,26,33
3,BER,P003958,P007550,0 days 00:16:29,-10,23,33
3,BER,P007550,P008967,0 days 00:14:59,-8,23,31
3,BER,P008173,P012721,0 days 00:13:57,-15,24,39
3,BER,P007550,P012720,0 days 00:13:44,-6,23,29
3,BER,P008384,P012721,0 days 00:11:55,-19,14,33
3,BER,P008173,P012720,0 days 00:11:39,-2,23,25
3,BER,P008173,P008384,0 days 00:10:47,-19,14,33
3,BER,P008211,P008384,0 days 00:10:47,-6,18,24
3,BER,P008211,P012721,0 days 00:09:33,-12,12,24
3,BER,P012720,P012721,0 days 00:08:49,0,21,21
3,BER,P008211,P012720,0 days 00:07:36,-2,13,15
3,BER,P008173,P008211,0 days 00:07:36,-12,10,22
3,BER,P007025,P008384,0 days 00:07:02,-2,11,13
3,BER,P006819,P008384,0 days 00:06:54,-12,8,20
3,BER,P006819,P008173,0 days 00:06:40,-12,8,20
3,BER,P006819,P012721,0 days 00:06:24,-12,6,18
3,BER,P003958,P007025,0 days 00:06:18,1,9,8
3,BER,P008384,P012720,0 days 00:05:40,-5,10,15
3,BER,P006919,P008173,0 days 00:05:09,8,15,7
3,BER,P008173,P008967,0 days 00:05:09,7,15,8
3,BER,P003958,P008211,0 days 00:04:58,7,11,4
3,BER,P003958,P008384,0 days 00:04:56,5,11,6
3,BER,P006919,P007025,0 days 00:04:54,1,7,6
3,BER,P007025,P012721,0 days 00:04:38,-7,4,11
3,BER,P003958,P008173,0 days 00:04:10,-2,5,7
3,BER,P008967,P012721,0 days 00:04:04,7,15,8
3,BER,P006919,P008211,0 days 00:03:59,9,11,2
3,BER,P006819,P008211,0 days 00:03:43,-5,4,9
3,BER,P007025,P008173,0 days 00:03:37,-9,2,11
3,BER,P006819,P007025,0 days 00:03:14,-7,2,9
3,BER,P008211,P008967,0 days 00:03:10,5,7,2
3,BER,P007025,P007550,0 days 00:03:09,-1,3,4
3,BER,P006919,P012721,0 days 00:03:08,10,15,5
3,BER,P006919,P008384,0 days 00:03:08,7,9,2
3,BER,P007025,P008211,0 days 00:02:46,4,6,2
3,BER,P003958,P012721,0 days 00:02:20,-3,2,5
3,BER,P007550,P008384,0 days 00:01:54,1,3,2
3,BER,P007025,P008967,0 days 00:01:15,-2,0,2
3,BER,P007025,P012720,0 days 00:01:15,-2,0,2
3,BER,P006819,P012720,0 days 00:01:08,0,2,2
3,BER,P003958,P006819,0 days 00:00:49,0,2,2
3,BER,P008384,P008967,0 days 00:00:25,2,2,0
3,BER,P007550,P012721,0 days 00:00:24,3,3,0
4,TEL,P009622,P009783,0 days 00:17:09,13,42,29
4,TEL,P009622,P012744,0 days 00:16:43,9,37,28
4,TEL,P009783,P011199,0 days 00:15:12,9,35,26
4,TEL,P005145,P009622,0 days 00:15:11,14,39,25
4,TEL,P011193,P011219,0 days 00:14:53,-9,31,40
4,TEL,P007990,P011219,0 days 00:14:32,12,38,26
4,TEL,P009783,P012744,0 days 00:12:58,7,30,23
4,TEL,P009622,P011199,0 days 00:12:55,6,30,24
4,TEL,P011199,P012744,0 days 00:12:17,7,28,21
4,TEL,P005145,P009783,0 days 00:11:57,12,29,17
4,TEL,P011193,P011971,0 days 00:11:29,3,27,24
4,TEL,P007990,P011193,0 days 00:11:28,9,30,21
4,TEL,P009622,P011219,0 days 00:11:10,3,27,24
4,TEL,P007990,P011971,0 days 00:11:02,9,29,20
4,TEL,P011193,P011214,0 days 00:10:44,-4,24,28
4,TEL,P011219,P011971,0 days 00:10:30,-1,21,22
4,TEL,P007990,P012744,0 days 00:10:22,3,27,24
4,TEL,P011214,P011219,0 days 00:10:17,-8,20,28
4,TEL,P007990,P009783,0 days 00:10:17,13,29,16
4,TEL,P007990,P011214,0 days 00:09:29,-3,23,26
4,TEL,P005145,P012744,0 days 00:09:18,3,19,16
4,TEL,P009622,P011193,0 days 00:08:21,1,22,21
4,TEL,P009783,P011193,0 days 00:08:14,10,22,12
4,TEL,P007990,P009622,0 days 00:08:03,13,26,13
4,TEL,P005145,P011199,0 days 00:08:00,2,15,13
4,TEL,P011219,P012744,0 days 00:07:50,2,15,13
4,TEL,P011214,P011971,0 days 00:06:49,-6,16,22
4,TEL,P005145,P011219,0 days 00:05:53,10,20,10
4,TEL,P009783,P011219,0 days 00:05:46,5,15,10
4,TEL,P007990,P011199,0 days 00:05:38,6,16,10
4,TEL,P011214,P012744,0 days 00:05:37,-2,13,15
4,TEL,P011193,P012744,0 days 00:05:19,6,14,8
4,TEL,P004233,P007990,0 days 00:05:16,-7,12,19
4,TEL,P004233,P011214,0 days 00:05:16,-7,12,19
4,TEL,P009622,P011971,0 days 00:05:04,2,13,11
4,TEL,P011971,P012744,0 days 00:04:56,-1,10,11
4,TEL,P004233,P012744,0 days 00:04:32,-6,7,13
4,TEL,P011193,P011199,0 days 00:04:27,10,15,5
4,TEL,P009622,P011214,0 days 00:04:27,-5,8,13
4,TEL,P004233,P011219,0 days 00:04:15,-7,5,12
4,TEL,P009783,P011971,0 days 00:04:00,6,10,4
4,TEL,P005145,P007990,0 days 00:03:57,9,14,5
4,TEL,P004233,P011971,0 days 00:03:41,-4,7,11
4,TEL,P005145,P011193,0 days 00:03:14,3,10,7
4,TEL,P011199,P011971,0 days 00:02:41,7,9,2
4,TEL,P004233,P011193,0 days 00:02:39,-5,5,10
4,TEL,P005145,P011971,0 days 00:01:56,1,6,5
4,TEL,P009783,P011214,0 days 00:01:47,1,4,3
4,TEL,P005145,P011214,0 days 00:01:18,2,4,2
4,TEL,P004233,P009622,0 days 00:00:45,0,0,0
4,TEL,P011199,P011219,0 days 00:00:26,-3,0,3
4,PAR,P003983,P007400,0 days 00:23:49,-5,54,59
4,PAR,P008987,P009862,0 days 00:21:57,-18,35,53
4,PAR,P003983,P011051,0 days 00:17:43,4,40,36
4,PAR,P007400,P011051,0 days 00:16:47,6,40,34
4,PAR,P009862,P011051,0 days 00:15:45,-10,23,33
4,PAR,P008987,P011051,0 days 00:14:07,-5,22,27
4,PAR,P003983,P008987,0 days 00:13:45,-13,24,37
4,PAR,P011051,P012742,0 days 00:13:27,6,34,28
4,PAR,P004058,P012742,0 days 00:13:14,-7,22,29
4,PAR,P007400,P008987,0 days 00:11:42,-11,22,33
4,PAR,P003983,P009862,0 days 00:10:23,-13,13,26
4,PAR,P004058,P009862,0 days 00:09:59,-2,18,20
4,PAR,P009862,P012742,0 days 00:09:59,-2,18,20
4,PAR,P007673,P011051,0 days 00:09:21,4,24,20
4,PAR,P003983,P012742,0 days 00:09:06,4,25,21
4,PAR,P007400,P009862,0 days 00:08:51,-13,11,24
4,PAR,P004058,P008987,0 days 00:08:41,-1,15,16
4,PAR,P008987,P012742,0 days 00:08:41,-1,15,16
4,PAR,P007400,P012742,0 days 00:08:35,6,25,19
4,PAR,P008987,P011050,0 days 00:08:25,-8,16,24
4,PAR,P007673,P009862,0 days 00:08:15,-9,12,21
4,PAR,P003983,P007673,0 days 00:08:08,9,23,14
4,PAR,P007673,P012742,0 days 00:07:40,6,24,18
4,PAR,P004058,P011051,0 days 00:07:36,-3,13,16
4,PAR,P009862,P011050,0 days 00:07:08,-3,14,17
4,PAR,P007400,P007673,0 days 00:06:36,9,21,12
4,PAR,P003983,P012743,0 days 00:06:19,-5,15,20
4,PAR,P007400,P012743,0 days 00:06:19,-5,15,20
4,PAR,P007673,P008987,0 days 00:05:41,-6,9,15
4,PAR,P011050,P012742,0 days 00:05:38,-4,9,13
4,PAR,P004058,P011050,0 days 00:05:38,-4,9,13
4,PAR,P000956,P003983,0 days 00:05:37,5,16,11
4,PAR,P000956,P007400,0 days 00:05:37,5,16,11
4,PAR,P004172,P008987,0 days 00:04:55,-9,9,18
4,PAR,P004172,P011050,0 days 00:04:55,-9,9,18
4,PAR,P007673,P011050,0 days 00:04:45,-4,9,13
4,PAR,P000956,P012743,0 days 00:04:41,3,14,11
4,PAR,P003983,P011050,0 days 00:04:37,-6,8,14
4,PAR,P004172,P009862,0 days 00:04:09,-6,7,13
4,PAR,P004172,P007673,0 days 00:04:09,-6,7,13
4,PAR,P000956,P011051,0 days 00:03:43,2,9,7
4,PAR,P008987,P012743,0 days 00:03:32,-5,8,13
4,PAR,P007400,P011050,0 days 00:03:30,-6,6,12
4,PAR,P003983,P004058,0 days 00:03:15,-5,4,9
4,PAR,P000956,P008987,0 days 00:02:50,5,9,4
4,PAR,P011051,P012743,0 days 00:02:47,0,7,7
4,PAR,P004058,P007400,0 days 00:02:44,-3,4,7
4,PAR,P004058,P007673,0 days 00:01:49,-3,3,6
4,PAR,P009862,P012743,0 days 00:01:38,-8,1,9
4,PAR,P003983,P004172,0 days 00:00:46,-3,2,5
4,PAR,P004172,P007400,0 days 00:00:46,-3,2,5
5,VIR,P001133,P009549,0 days 00:28:53,-7,58,65
5,VIR,P001133,P001844,0 days 00:24:14,-22,38,60
5,VIR,P001844,P009549,0 days 00:22:56,-25,33,58
5,VIR,P001133,P008847,0 days 00:19:28,14,51,37
5,VIR,P001133,P004007,0 days 00:18:49,10,47,37
5,VIR,P008847,P009549,0 days 00:18:38,11,48,37
5,VIR,P004007,P009549,0 days 00:17:59,7,44,37
5,VIR,P004007,P008847,0 days 00:17:46,18,45,27
5,VIR,P001844,P008847,0 days 00:16:26,-11,27,38
5,VIR,P001844,PBCN,0 days 00:14:40,-9,23,32
5,VIR,P001844,P004007,0 days 00:13:22,-7,23,30
5,VIR,P001133,PBCN,0 days 00:11:36,-8,19,27
5,VIR,P004007,P006739,0 days 00:11:22,16,33,17
5,VIR,P009549,PBCN,0 days 00:10:18,-11,14,25
5,VIR,P002084,P011192,0 days 00:09:53,-5,13,18
5,VIR,P006739,P008847,0 days 00:08:48,22,31,9
5,VIR,P003048,P009549,0 days 00:07:42,-3,10,13
5,VIR,P001133,P003048,0 days 00:07:42,-3,10,13
5,VIR,P001844,P003048,0 days 00:07:42,-3,10,13
5,VIR,P008847,PBCN,0 days 00:07:28,-7,13,20
5,VIR,P004007,P011192,0 days 00:06:48,1,12,11
5,VIR,P001133,P006739,0 days 00:06:47,21,28,7
5,VIR,P002084,P004007,0 days 00:06:42,-4,9,13
5,VIR,P008847,P011192,0 days 00:06:36,0,10,10
5,VIR,P001844,P011192,0 days 00:06:21,2,13,11
5,VIR,P001844,P002084,0 days 00:06:05,-3,8,11
5,VIR,P006739,P009549,0 days 00:05:57,18,25,7
5,VIR,P003048,PBCN,0 days 00:05:54,-5,5,10
5,VIR,P002084,P008847,0 days 00:05:46,-3,7,10
5,VIR,P006739,P011192,0 days 00:05:25,-2,8,10
5,VIR,P002084,P006739,0 days 00:04:35,-5,5,10
5,VIR,P011192,PBCN,0 days 00:04:22,2,9,7
5,VIR,P004007,P012714,0 days 00:04:20,-7,6,13
5,VIR,P011192,P012714,0 days 00:04:13,4,11,7
5,VIR,P002084,PBCN,0 days 00:03:22,-1,4,5
5,VIR,P002084,P012714,0 days 00:03:13,1,6,5
5,VIR,P001133,P011192,0 days 00:02:47,2,8,6
5,VIR,P001844,P012714,0 days 00:02:46,2,9,7
5,VIR,P006739,P012714,0 days 00:02:34,-6,2,8
5,VIR,P001133,P012714,0 days 00:02:07,-5,5,10
5,VIR,P003048,P004007,0 days 00:01:48,2,5,3
5,VIR,P001133,P002084,0 days 00:01:41,-6,0,6
5,VIR,P002084,P009549,0 days 00:01:23,-6,0,6
5,VIR,P009549,P012714,0 days 00:01:07,-8,0,8
5,VIR,P012714,PBCN,0 days 00:01:00,3,5,2
5,VIR,P009549,P011192,0 days 00:00:39,-4,0,4
5,ZAL,P003211,P010390,0 days 00:23:51,17,55,38
5,ZAL,P002329,P007109,0 days 00:23:36,4,47,43
5,ZAL,P010390,P011218,0 days 00:23:28,16,53,37
5,ZAL,P002329,P003211,0 days 00:21:21,22,53,31
5,ZAL,P007109,P011218,0 days 00:21:08,12,46,34
5,ZAL,P003211,P011218,0 days 00:21:02,15,50,35
5,ZAL,P002329,P010390,0 days 00:20:21,18,47,29
5,ZAL,P002329,P011218,0 days 00:19:46,8,43,35
5,ZAL,P007109,P010390,0 days 00:18:51,13,40,27
5,ZAL,P003211,P007109,0 days 00:17:58,14,41,27
5,ZAL,P002676,P012715,0 days 00:13:15,-10,23,33
5,ZAL,P002676,P010390,0 days 00:11:47,3,22,19
5,ZAL,P002676,P003211,0 days 00:10:41,6,23,17
5,ZAL,P002676,P011218,0 days 00:10:32,-1,21,22
5,ZAL,P003211,P012715,0 days 00:09:12,8,23,15
5,ZAL,P002329,P002676,0 days 00:08:23,-5,13,18
5,ZAL,P002676,P011965,0 days 00:07:33,1,16,15
5,ZAL,P005504,P011965,0 days 00:07:28,-14,9,23
5,ZAL,P011218,P012715,0 days 00:07:16,-3,14,17
5,ZAL,P002676,P007109,0 days 00:07:04,3,12,9
5,ZAL,P003210,P005504,0 days 00:07:02,-14,9,23
5,ZAL,P010390,P012715,0 days 00:06:49,6,17,11
5,ZAL,P002329,P012715,0 days 00:06:09,-1,13,14
5,ZAL,P003210,P011965,0 days 00:05:57,-8,9,17
5,ZAL,P002676,P005504,0 days 00:05:51,-12,7,19
5,ZAL,P007109,P011965,0 days 00:05:37,-8,7,15
5,ZAL,P002329,P011965,0 days 00:05:32,-2,12,14
5,ZAL,P011965,P012715,0 days 00:05:31,3,13,10
5,ZAL,P005504,P012715,0 days 00:05:25,-11,7,18
5,ZAL,P003210,P012715,0 days 00:05:10,-9,7,16
5,ZAL,P002676,P003210,0 days 00:05:10,-9,7,16
5,ZAL,P002329,P005504,0 days 00:04:17,-18,2,20
5,ZAL,P010390,P011965,0 days 00:04:07,11,15,4
5,ZAL,P011218,P011965,0 days 00:03:45,-3,5,8
5,ZAL,P002329,P003210,0 days 00:03:42,-7,6,13
5,ZAL,P005504,P007109,0 days 00:03:23,-11,2,13
5,ZAL,P007109,P012715,0 days 00:03:17,1,7,6
5,ZAL,P003210,P007109,0 days 00:02:37,-1,6,7
5,ZAL,P003211,P011965,0 days 00:02:14,8,10,2
5,ZAL,P005504,P011218,0 days 00:01:46,-8,0,8
5,ZAL,P003210,P011218,0 days 00:00:45,4,4,0
5,ZAL,P003210,P010390,0 days 00:00:41,3,3,0
5,ZAL,P002329,P007513,0 days 00:00:09,-3,0,3
5,ZAL,P003211,P007513,0 days 00:00:09,-3,0,3
5,ZAL,P007109,P007513,0 days 00:00:09,-3,0,3
5,ZAL,P007513,P010390,0 days 00:00:09,-3,0,3
5,ZAL,P003210,P003211,0 days 00:00:04,1,1,0
6,ULK,P008962,P009849,0 days 00:27:03,3,55,52
6,ULK,P005844,P006661,0 days 00:26:40,5,50,45
6,ULK,P009849,P010560,0 days 00:24:55,1,48,47
6,ULK,P008962,P010560,0 days 00:24:45,-1,50,51
6,ULK,P005844,P008962,0 days 00:23:44,2,49,47
6,ULK,P005844,P009849,0 days 00:21:32,6,45,39
6,ULK,P005844,P010560,0 days 00:19:43,3,41,38
6,ULK,P006661,P010560,0 days 00:19:15,2,36,34
6,ULK,P006661,P008962,0 days 00:18:51,2,38,36
6,ULK,P004004,P006661,0 days 00:18:31,-1,32,33
6,ULK,P006661,P009849,0 days 00:16:49,6,34,28
6,ULK,P004004,P005844,0 days 00:14:04,-2,24,26
6,ULK,P009849,P011052,0 days 00:13:37,-4,26,30
6,ULK,P010560,P011052,0 days 00:13:36,-5,25,30
6,ULK,P010560,P011157,0 days 00:13:18,-6,20,26
6,ULK,P008962,P011052,0 days 00:11:35,-2,24,26
6,ULK,P011052,P011157,0 days 00:08:52,-6,13,19
6,ULK,P009849,P011157,0 days 00:08:52,-6,13,19
6,ULK,P010560,P011980,0 days 00:08:26,-2,11,13
6,ULK,P001932,P005844,0 days 00:07:49,5,14,9
6,ULK,P004004,P008962,0 days 00:07:42,-3,16,19
6,ULK,P001932,P006661,0 days 00:07:39,5,14,9
6,ULK,P008962,P011157,0 days 00:06:50,-4,11,15
6,ULK,P004004,P010560,0 days 00:06:39,-5,10,15
6,ULK,P001932,P004004,0 days 00:06:29,6,13,7
6,ULK,P011157,P011980,0 days 00:06:28,-2,9,11
6,ULK,P006661,P011980,0 days 00:06:14,0,9,9
6,ULK,P002968,P005844,0 days 00:06:02,4,11,7
6,ULK,P002968,P004004,0 days 00:06:02,4,11,7
6,ULK,P001932,P002968,0 days 00:06:02,4,11,7
6,ULK,P002968,P006661,0 days 00:06:02,4,11,7
6,ULK,P004004,P009849,0 days 00:05:30,0,11,11
6,ULK,P004004,P011980,0 days 00:05:01,2,9,7
6,ULK,P005844,P011052,0 days 00:04:44,1,12,11
6,ULK,P004004,P011157,0 days 00:04:26,0,7,7
6,ULK,P006661,P011157,0 days 00:04:26,0,7,7
6,ULK,P009849,P011980,0 days 00:03:22,-2,4,6
6,ULK,P011052,P011980,0 days 00:02:02,-2,2,4
6,ULK,P005844,P011980,0 days 00:01:58,0,2,2
6,ULK,P001932,P008962,0 days 00:01:54,3,5,2
6,ULK,P001932,P010560,0 days 00:01:27,1,3,2
6,ULK,P001932,P011980,0 days 00:00:17,2,2,0
6,ULK,P008962,P011980,0 days 00:00:17,2,2,0
6,ULK,P001932,P002969,0 days 00:00:07,2,2,0
6,ULK,P002969,P004004,0 days 00:00:07,2,2,0
6,ULK,P002969,P008962,0 days 00:00:07,2,2,0
6,ULK,P002969,P011980,0 days 00:00:07,2,2,0
6,ULK,P004004,P011052,0 days 00:00:01,1,1,0
6,ULK,P006661,P011052,0 days 00:00:01,1,1,0
6,MIL,P000796,P007201,0 days 00:32:45,-2,63,65
6,MIL,P000796,P007831,0 days 00:30:22,-4,57,61
6,MIL,P007201,P007831,0 days 00:27:35,3,55,52
6,MIL,P002849,P007831,0 days 00:26:23,10,51,41
6,MIL,P000796,P002849,0 days 00:24:00,-1,43,44
6,MIL,P002849,P007201,0 days 00:23:35,0,43,43
6,MIL,P006433,P007831,0 days 00:20:58,2,35,33
6,MIL,P000796,P006433,0 days 00:18:15,-8,29,37
6,MIL,P002849,P005670,0 days 00:15:53,-1,33,34
6,MIL,P005670,P007201,0 days 00:15:53,-1,33,34
6,MIL,P000796,P005670,0 days 00:15:53,-1,33,34
6,MIL,P006433,P007201,0 days 00:15:39,-1,27,28
6,MIL,P006433,P006509,0 days 00:14:06,4,25,21
6,MIL,P005670,P007831,0 days 00:14:04,3,31,28
6,MIL,P002812,P006433,0 days 00:12:56,1,26,25
6,MIL,P006433,P009960,0 days 00:12:50,-4,17,21
6,MIL,P002812,P007831,0 days 00:12:10,2,26,24
6,MIL,P002849,P006433,0 days 00:12:08,7,20,13
6,MIL,P006509,P009960,0 days 00:12:00,-3,17,20
6,MIL,P006509,P007831,0 days 00:10:31,8,21,13
6,MIL,P002812,P006509,0 days 00:08:52,6,18,12
6,MIL,P000796,P006509,0 days 00:08:14,-10,13,23
6,MIL,P000796,P002812,0 days 00:07:11,-5,14,19
6,MIL,P007831,P009960,0 days 00:07:05,-2,8,10
6,MIL,P006509,P007201,0 days 00:06:23,-5,11,16
6,MIL,P002849,P006509,0 days 00:06:11,3,12,9
6,MIL,P002812,P009960,0 days 00:06:02,-2,7,9
6,MIL,P000796,P009960,0 days 00:05:54,-9,8,17
6,MIL,P002812,P007201,0 days 00:05:49,-1,14,15
6,MIL,P007201,P009960,0 days 00:03:21,-1,6,7
6,MIL,P002812,P002849,0 days 00:02:39,4,8,4
6,MIL,P006433,P006701,0 days 00:02:31,-3,3,6
6,MIL,P006509,P006701,0 days 00:02:31,-3,3,6
6,MIL,P006701,P009960,0 days 00:02:31,-3,3,6
6,MIL,P002812,P006701,0 days 00:02:20,-1,3,4
6,MIL,P002849,P009960,0 days 00:01:58,2,2,0
6,MIL,P005670,P006509,0 days 00:01:08,-6,0,6
6,MIL,P005670,P006433,0 days 00:00:41,2,2,0
6,MIL,P000796,P006701,0 days 00:00:11,-2,0,2
6,MIL,P001518,P006509,0 days 00:00:08,-2,0,2
6,MIL,P001518,P007831,0 days 00:00:08,-2,0,2
6,MIL,P000796,P001518,0 days 00:00:07,-2,0,2
6,MIL,P001518,P009960,0 days 00:00:07,-2,0,2
6,MIL,P001518,P002812,0 days 00:00:01,0,0,0
6,MIL,P001518,P002849,0 days 00:00:01,0,0,0
7,PAN,P003842,P012712,0 days 00:31:52,-11,53,64
7,PAN,P011204,P012712,0 days 00:30:42,-12,52,64
7,PAN,P001926,P012712,0 days 00:29:24,-6,50,56
7,PAN,P002328,P012712,0 days 00:28:35,-15,50,65
7,PAN,P001926,P003842,0 days 00:28:16,-3,50,53
7,PAN,P007947,P012712,0 days 00:21:13,-17,27,44
7,PAN,P003842,P011204,0 days 00:21:10,-3,37,40
7,PAN,P002328,P011204,0 days 00:19:46,-3,38,41
7,PAN,P002328,P003842,0 days 00:19:29,-6,35,41
7,PAN,P001926,P002328,0 days 00:18:49,-4,32,36
7,PAN,P001926,P011204,0 days 00:18:42,2,34,32
7,PAN,P007947,P011204,0 days 00:15:51,-14,23,37
7,PAN,P002328,P007947,0 days 00:15:03,-13,23,36
7,PAN,P003842,P007947,0 days 00:12:49,-11,12,23
7,PAN,P007553,P012712,0 days 00:12:27,-9,20,29
7,PAN,P007553,P011204,0 days 00:12:27,-9,20,29
7,PAN,P001926,P011826,0 days 00:11:28,5,28,23
7,PAN,P003842,P011826,0 days 00:11:28,5,28,23
7,PAN,P011826,P012712,0 days 00:11:28,5,28,23
7,PAN,P002328,P007553,0 days 00:10:54,-4,20,24
7,PAN,P003842,P008084,0 days 00:08:03,10,17,7
7,PAN,P007553,P007947,0 days 00:07:58,-6,15,21
7,PAN,P001926,P007947,0 days 00:07:25,-8,4,12
7,PAN,P002328,P011826,0 days 00:07:08,0,17,17
7,PAN,P001926,P008084,0 days 00:06:15,13,17,4
7,PAN,P008084,P012712,0 days 00:06:15,5,12,7
7,PAN,P008084,P011204,0 days 00:06:10,6,13,7
7,PAN,P001926,P007553,0 days 00:04:29,-3,5,8
7,PAN,P011204,P011826,0 days 00:04:20,5,11,6
7,PAN,P007947,P008084,0 days 00:03:41,1,4,3
7,PAN,P002328,P008084,0 days 00:01:48,5,5,0
7,PAN,P003842,P007553,0 days 00:01:33,-5,0,5
7,PAN,P007947,P011209,0 days 00:00:26,0,0,0
7,PAN,P007947,P011221,0 days 00:00:26,0,0,0
7,PAN,P011204,P011209,0 days 00:00:26,0,0,0
7,PAN,P011204,P011221,0 days 00:00:26,0,0,0
7,PAN,P011209,P011221,0 days 00:00:26,0,0,0
7,PAN,P011209,P012712,0 days 00:00:26,0,0,0
7,PAN,P011221,P012712,0 days 00:00:26,0,0,0
7,OLY,P008829,P008855,0 days 00:36:50,21,78,57
7,OLY,P003941,P008829,0 days 00:35:00,18,75,57
7,OLY,P003941,P008855,0 days 00:35:00,18,75,57
7,OLY,P008855,P010612,0 days 00:31:49,18,69,51
7,OLY,P008829,P010612,0 days 00:29:54,19,65,46
7,OLY,P003941,P010612,0 days 00:28:25,16,62,46
7,OLY,P007982,P008855,0 days 00:20:58,15,43,28
7,OLY,P001255,P008855,0 days 00:20:37,2,45,43
7,OLY,P001255,P010612,0 days 00:19:42,4,43,39
7,OLY,P007982,P008829,0 days 00:19:03,16,39,23
7,OLY,P001255,P003941,0 days 00:18:42,3,41,38
7,OLY,P001255,P008829,0 days 00:18:42,3,41,38
7,OLY,P003941,P007982,0 days 00:17:47,13,36,23
7,OLY,P007982,P010612,0 days 00:14:02,13,30,17
7,OLY,P007982,P010392,0 days 00:11:55,-6,17,23
7,OLY,P006589,P007982,0 days 00:10:00,-8,13,21
7,OLY,P001255,P007982,0 days 00:08:31,-13,12,25
7,OLY,P001255,P006589,0 days 00:07:36,-11,10,21
7,OLY,P007853,P010392,0 days 00:06:15,-10,6,16
7,OLY,P007853,P007982,0 days 00:06:15,-10,6,16
7,OLY,P006589,P007853,0 days 00:06:15,-10,6,16
7,OLY,P006589,P010392,0 days 00:06:15,-10,6,16
7,OLY,P003941,P010392,0 days 00:06:14,4,11,7
7,OLY,P001255,P010392,0 days 00:05:41,-10,6,16
7,OLY,P001255,P007853,0 days 00:05:41,-10,6,16
7,OLY,P008829,P010392,0 days 00:05:40,4,11,7
7,OLY,P008855,P010392,0 days 00:05:40,4,11,7
7,OLY,P006589,P008855,0 days 00:03:45,2,7,5
7,OLY,P006589,P010612,0 days 00:03:24,2,7,5
7,OLY,P006589,P008829,0 days 00:01:50,3,3,0
7,OLY,P003941,P006589,0 days 00:00:34,0,0,0
7,OLY,P003941,P007853,0 days 00:00:34,0,0,0
7,OLY,P006302,P006589,0 days 00:00:21,0,0,0
7,OLY,P006302,P007982,0 days 00:00:21,0,0,0
7,OLY,P006302,P008829,0 days 00:00:21,0,0,0
7,OLY,P006302,P008855,0 days 00:00:21,0,0,0
8,BAS,P007230,P010444,0 days 00:19:03,3,38,35
8,BAS,P007230,P009048,0 days 00:18:30,-5,34,39
8,BAS,P008072,P012201,0 days 00:16:41,-2,32,34
8,BAS,P011064,P012201,0 days 00:16:08,3,32,29
8,BAS,P011948,P012201,0 days 00:15:50,2,32,30
8,BAS,P008072,P011064,0 days 00:14:57,12,36,24
8,BAS,P007230,P008072,0 days 00:14:42,8,29,21
8,BAS,P009048,P010444,0 days 00:14:19,2,32,30
8,BAS,P007230,P011948,0 days 00:13:33,5,26,21
8,BAS,P004761,P007230,0 days 00:13:17,-5,22,27
8,BAS,P011064,P011948,0 days 00:12:42,5,27,22
8,BAS,P011085,P012201,0 days 00:12:35,-2,29,31
8,BAS,P008072,P011948,0 days 00:12:23,7,27,20
8,BAS,P004761,P008072,0 days 00:11:33,0,24,24
8,BAS,P004603,P009048,0 days 00:11:14,-5,22,27
8,BAS,P007230,P012201,0 days 00:10:54,-3,12,15
8,BAS,P004761,P010444,0 days 00:10:48,-2,20,22
8,BAS,P009048,P011948,0 days 00:10:43,0,21,21
8,BAS,P010444,P011948,0 days 00:10:05,1,20,19
8,BAS,P011064,P011085,0 days 00:10:05,1,24,23
8,BAS,P004603,P007230,0 days 00:09:57,-8,17,25
8,BAS,P011085,P011948,0 days 00:09:45,0,22,22
8,BAS,P008072,P011085,0 days 00:09:14,-1,22,23
8,BAS,P004603,P010444,0 days 00:09:09,-6,17,23
8,BAS,P007230,P011064,0 days 00:08:48,5,14,9
8,BAS,P004761,P009048,0 days 00:08:36,-2,18,20
8,BAS,P004603,P011948,0 days 00:08:32,0,17,17
8,BAS,P008072,P009048,0 days 00:07:46,1,15,14
8,BAS,P004761,P012201,0 days 00:07:25,-7,9,16
8,BAS,P008072,P010444,0 days 00:07:15,9,19,10
8,BAS,P010444,P011064,0 days 00:06:55,-3,8,11
8,BAS,P004761,P011064,0 days 00:06:25,1,11,10
8,BAS,P009048,P012201,0 days 00:06:15,-2,9,11
8,BAS,P010444,P012201,0 days 00:04:50,-4,4,8
8,BAS,P004761,P011085,0 days 00:02:50,-2,7,9
8,BAS,P004603,P004761,0 days 00:02:42,-5,5,10
8,BAS,P004603,P012201,0 days 00:02:05,1,5,4
8,BAS,P010444,P011085,0 days 00:02:04,-4,2,6
8,BAS,P008850,P012201,0 days 00:01:41,-6,0,6
8,BAS,P004603,P011085,0 days 00:01:17,3,5,2
8,BAS,P009048,P011085,0 days 00:01:17,3,5,2
8,BAS,P004761,P008850,0 days 00:01:13,-6,0,6
8,BAS,P008072,P008850,0 days 00:01:13,-6,0,6
8,BAS,P008850,P011085,0 days 00:01:13,-6,0,6
8,BAS,P007230,P008850,0 days 00:00:28,0,0,0
8,BAS,P008850,P009048,0 days 00:00:28,0,0,0
8,BAS,P008850,P010444,0 days 00:00:28,0,0,0
8,BAS,P004761,P011948,0 days 00:00:07,0,0,0
8,MAD,P004887,P010357,0 days 00:21:51,9,42,33
8,MAD,P005928,P006540,0 days 00:19:36,1,39,38
8,MAD,P005928,P010357,0 days 00:19:22,4,35,31
8,MAD,P006540,P010357,0 days 00:18:29,-3,33,36
8,MAD,P001392,P010357,0 days 00:17:44,7,33,26
8,MAD,P010357,PTGB,0 days 00:17:34,2,37,35
8,MAD,P010357,PBMT,0 days 00:16:21,12,37,25
8,MAD,P010357,PCVM,0 days 00:15:28,5,35,30
8,MAD,P004887,P006540,0 days 00:15:10,-1,31,32
8,MAD,P004887,PTGB,0 days 00:15:10,-8,24,32
8,MAD,P004887,P005928,0 days 00:14:42,10,33,23
8,MAD,P006540,PTGB,0 days 00:13:24,-10,21,31
8,MAD,PBMT,PCVM,0 days 00:13:23,9,32,23
8,MAD,P001392,P005928,0 days 00:12:45,3,24,21
8,MAD,P001392,P006540,0 days 00:10:33,0,21,21
8,MAD,P005928,PTGB,0 days 00:10:27,1,20,19
8,MAD,P001392,PBMT,0 days 00:10:23,5,18,13
8,MAD,P004887,PCVM,0 days 00:10:14,-7,14,21
8,MAD,PCVM,PTGB,0 days 00:10:12,-5,22,27
8,MAD,P001392,P004887,0 days 00:09:46,11,23,12
8,MAD,P004887,PBMT,0 days 00:09:46,4,16,12
8,MAD,P003108,PCVM,0 days 00:08:50,-2,21,23
8,MAD,P003108,PTGB,0 days 00:08:06,-2,23,25
8,MAD,PBMT,PTGB,0 days 00:07:15,6,21,15
8,MAD,P001392,PCVM,0 days 00:07:04,3,13,10
8,MAD,P003108,P010357,0 days 00:07:02,5,21,16
8,MAD,P003108,PBMT,0 days 00:06:45,8,21,13
8,MAD,P001392,P010868,0 days 00:06:09,-2,9,11
8,MAD,P005928,P010868,0 days 00:06:09,-2,9,11
8,MAD,P006540,P010868,0 days 00:05:59,-2,9,11
8,MAD,P005928,PBMT,0 days 00:04:15,2,7,5
8,MAD,P010357,P010868,0 days 00:04:04,-1,5,6
8,MAD,P006540,PCVM,0 days 00:03:53,-11,3,14
8,MAD,P003108,P006540,0 days 00:03:32,-9,5,14
8,MAD,P003108,P004887,0 days 00:03:05,-6,5,11
8,MAD,P001392,P003733,0 days 00:02:13,-4,4,8
8,MAD,P003733,P005928,0 days 00:02:13,-4,4,8
8,MAD,P003733,P006540,0 days 00:02:13,-4,4,8
8,MAD,P001392,P003108,0 days 00:02:11,1,3,2
8,MAD,P003108,P005928,0 days 00:01:27,1,5,4
8,MAD,P003733,P010357,0 days 00:01:25,-4,2,6
8,MAD,P010868,PBMT,0 days 00:01:17,-1,2,3
8,MAD,P006540,PBMT,0 days 00:01:07,-1,2,3
8,MAD,P003733,P010868,0 days 00:00:48,0,2,2
8,MAD,P001392,PTGB,0 days 00:00:28,0,0,0
8,MAD,P003108,P010868,0 days 00:00:10,0,0,0
9,PAM,P010568,P012740,0 days 00:17:46,-1,29,30
9,PAM,P003960,P010568,0 days 00:17:39,-4,24,28
9,PAM,P003960,P012740,0 days 00:15:20,-13,18,31
9,PAM,P006643,P010568,0 days 00:14:46,-6,22,28
9,PAM,P007870,P010568,0 days 00:14:28,-1,20,21
9,PAM,P012738,P012739,0 days 00:13:36,6,30,24
9,PAM,P004863,P011982,0 days 00:13:25,7,27,20
9,PAM,P003960,P006643,0 days 00:12:32,-7,17,24
9,PAM,P004863,P012738,0 days 00:12:30,11,28,17
9,PAM,P004863,P012739,0 days 00:12:15,3,22,19
9,PAM,P003960,P007870,0 days 00:12:09,-3,17,20
9,PAM,P012739,P012740,0 days 00:11:48,1,19,18
9,PAM,P006643,P012740,0 days 00:11:41,-10,14,24
9,PAM,P010568,P011982,0 days 00:11:22,3,20,17
9,PAM,P011982,P012738,0 days 00:11:16,9,29,20
9,PAM,P011982,P012739,0 days 00:11:03,0,22,22
9,PAM,P007870,P012740,0 days 00:10:35,2,18,16
9,PAM,P011982,P012740,0 days 00:09:25,13,24,11
9,PAM,P012738,P012740,0 days 00:08:41,14,22,8
9,PAM,P007870,P011982,0 days 00:08:29,1,14,13
9,PAM,P006643,P007870,0 days 00:08:15,-7,10,17
9,PAM,P011970,P012738,0 days 00:08:08,-1,17,18
9,PAM,P011970,P011982,0 days 00:07:47,-3,15,18
9,PAM,P004863,P012740,0 days 00:07:46,7,16,9
9,PAM,P003960,P011982,0 days 00:07:30,-4,9,13
9,PAM,P010393,P010568,0 days 00:07:18,6,15,9
9,PAM,P004863,P011970,0 days 00:07:02,3,16,13
9,PAM,P003960,P004863,0 days 00:06:57,3,10,7
9,PAM,P011970,P012739,0 days 00:06:26,-5,11,16
9,PAM,P010568,P012739,0 days 00:06:11,-7,8,15
9,PAM,P006643,P010393,0 days 00:05:16,2,13,11
9,PAM,P010393,P011982,0 days 00:05:02,2,10,8
9,PAM,P003960,P012739,0 days 00:05:02,-10,0,10
9,PAM,P004863,P010568,0 days 00:04:33,8,10,2
9,PAM,P010568,P012738,0 days 00:04:31,2,11,9
9,PAM,P000556,P012740,0 days 00:04:17,1,5,4
9,PAM,P000556,P012738,0 days 00:04:17,1,5,4
9,PAM,P010393,P012740,0 days 00:04:13,2,7,5
9,PAM,P004863,P007870,0 days 00:03:42,3,6,3
9,PAM,P000556,P012739,0 days 00:03:41,1,5,4
9,PAM,P000556,P004863,0 days 00:03:41,1,5,4
9,PAM,P004863,P010393,0 days 00:03:39,10,12,2
9,PAM,P010393,P012738,0 days 00:03:37,7,9,2
9,PAM,P006643,P012739,0 days 00:03:30,-5,3,8
9,PAM,P003960,P010393,0 days 00:03:15,2,9,7
9,PAM,P007870,P010393,0 days 00:02:50,-3,3,6
9,PAM,P004863,P006643,0 days 00:02:06,8,8,0
9,PAM,P010393,P011970,0 days 00:01:58,4,6,2
9,PAM,P006643,P011982,0 days 00:01:37,-4,2,6
9,PAM,P010568,P011970,0 days 00:01:22,-4,1,5
9,PAM,P006643,P012738,0 days 00:01:16,3,5,2
9,PAM,P006643,P011970,0 days 00:00:37,2,2,0
9,PAM,P000556,P010393,0 days 00:00:36,0,0,0
9,PAM,P000556,P010568,0 days 00:00:36,0,0,0
9,PAM,P003960,P011970,0 days 00:00:16,0,0,0
9,PAM,P003960,P012738,0 days 00:00:12,0,0,0
9,PAM,P010393,P012739,0 days 00:00:12,0,0,0
9,MCO,P005985,P010588,0 days 00:32:15,11,60,49
9,MCO,P005985,PLCZ,0 days 00:23:34,18,45,27
9,MCO,P010588,PLCZ,0 days 00:23:34,18,45,27
9,MCO,P010588,P011212,0 days 00:23:01,12,46,34
9,MCO,P005985,P011212,0 days 00:23:01,12,46,34
9,MCO,P005985,P011226,0 days 00:21:39,-3,33,36
9,MCO,P010588,P011226,0 days 00:20:20,2,33,31
9,MCO,P011212,P011231,0 days 00:16:51,-8,26,34
9,MCO,P011212,PLCZ,0 days 00:15:29,14,31,17
9,MCO,P011226,PLCZ,0 days 00:14:21,9,26,17
9,MCO,P011212,P011226,0 days 00:13:37,-7,19,26
9,MCO,P010588,P011231,0 days 00:11:34,-2,21,23
9,MCO,P005985,P011231,0 days 00:11:34,-2,21,23
9,MCO,P005985,P012515,0 days 00:11:05,1,17,16
9,MCO,P010588,P012515,0 days 00:11:05,1,17,16
9,MCO,P012515,PLCZ,0 days 00:09:44,6,17,11
9,MCO,P011196,P011212,0 days 00:08:47,-8,10,18
9,MCO,P008099,P011196,0 days 00:07:45,-16,5,21
9,MCO,P011226,P012515,0 days 00:06:54,0,9,9
9,MCO,P011196,P011231,0 days 00:06:26,-11,5,16
9,MCO,P008099,P011212,0 days 00:06:26,-11,5,16
9,MCO,P008099,P011231,0 days 00:06:26,-11,5,16
9,MCO,P004790,P011212,0 days 00:06:25,-1,13,14
9,MCO,P004790,P011231,0 days 00:06:25,-1,13,14
9,MCO,P011196,P011226,0 days 00:06:11,-12,5,17
9,MCO,P008099,P011226,0 days 00:06:10,-16,5,21
9,MCO,P011226,P011231,0 days 00:06:09,-20,2,22
9,MCO,P004790,P011196,0 days 00:05:14,-6,5,11
9,MCO,P004790,P008099,0 days 00:05:14,-6,5,11
9,MCO,P011231,PLCZ,0 days 00:05:14,8,11,3
9,MCO,P011212,P012515,0 days 00:04:11,1,8,7
9,MCO,P004790,P005985,0 days 00:03:49,-5,8,13
9,MCO,P005985,P011196,0 days 00:03:40,-2,5,7
9,MCO,P005985,P008099,0 days 00:03:39,-6,5,11
9,MCO,P004790,P010588,0 days 00:02:30,0,8,8
9,MCO,P010588,P011196,0 days 00:02:21,3,5,2
9,MCO,P008099,P010588,0 days 00:02:20,-1,5,6
9,MCO,P008099,PLCZ,0 days 00:02:20,-1,5,6
9,MCO,P011231,P012515,0 days 00:01:21,-5,0,5
9,MCO,P004790,P011226,0 days 00:01:19,-5,0,5
10,BER,P003958,P006919,0 days 00:22:41,-11,38,49
10,BER,P003958,P012720,0 days 00:17:10,-14,26,40
10,BER,P006919,P012720,0 days 00:17:10,-14,26,40
10,BER,P003958,P007550,0 days 00:17:03,-8,30,38
10,BER,P008173,P008384,0 days 00:15:38,4,37,33
10,BER,P003958,P008967,0 days 00:15:35,-4,27,31
10,BER,P006251,P008173,0 days 00:15:14,2,39,37
10,BER,P006919,P007550,0 days 00:14:58,-12,21,33
10,BER,P007550,P012720,0 days 00:14:58,-12,21,33
10,BER,P008173,P008967,0 days 00:14:54,-1,36,37
10,BER,P006251,P012721,0 days 00:13:57,3,37,34
10,BER,P008173,P012721,0 days 00:13:57,3,37,34
10,BER,P006251,P008384,0 days 00:13:42,5,36,31
10,BER,P006919,P008967,0 days 00:13:30,-8,18,26
10,BER,P008967,P012720,0 days 00:11:36,-10,18,28
10,BER,P008384,P008967,0 days 00:10:46,1,29,28
10,BER,P006251,P008967,0 days 00:10:22,-1,31,32
10,BER,P008384,P012721,0 days 00:10:20,2,25,23
10,BER,P008173,P008211,0 days 00:09:33,4,22,18
10,BER,P006919,P008173,0 days 00:09:00,0,19,19
10,BER,P007550,P008967,0 days 00:08:58,-8,13,21
10,BER,P008967,P012721,0 days 00:08:17,-5,22,27
10,BER,P003958,P008384,0 days 00:07:51,7,25,18
10,BER,P003958,P008173,0 days 00:07:43,1,17,16
10,BER,P006919,P008384,0 days 00:07:03,2,18,16
10,BER,P008211,P008384,0 days 00:06:57,7,17,10
10,BER,P006251,P008211,0 days 00:06:57,7,17,10
10,BER,P006919,P008211,0 days 00:06:11,-1,12,13
10,BER,P008173,P012720,0 days 00:05:49,-1,17,18
10,BER,P008211,P012721,0 days 00:05:40,8,15,7
10,BER,P003958,P008211,0 days 00:04:54,0,10,10
10,BER,P003958,P006819,0 days 00:04:02,-3,6,9
10,BER,P006819,P006919,0 days 00:04:02,-3,6,9
10,BER,P006819,P007550,0 days 00:04:02,-3,6,9
10,BER,P006819,P012720,0 days 00:04:02,-3,6,9
10,BER,P007550,P008384,0 days 00:03:50,4,15,11
10,BER,P006251,P012720,0 days 00:03:37,1,12,11
10,BER,P012720,P012721,0 days 00:03:37,1,12,11
10,BER,P008211,P012720,0 days 00:03:24,0,8,8
10,BER,P007550,P008211,0 days 00:02:18,3,5,2
10,BER,P003958,P006251,0 days 00:02:05,4,9,5
10,BER,P006251,P007550,0 days 00:02:05,4,9,5
10,BER,P008384,P012720,0 days 00:01:45,0,6,6
10,BER,P008211,P008967,0 days 00:01:30,0,2,2
10,BER,P006251,P006919,0 days 00:01:17,-1,2,3
10,BAS,P007230,P010444,0 days 00:24:25,11,52,41
10,BAS,P007230,P009048,0 days 00:21:33,11,48,37
10,BAS,P009048,P010444,0 days 00:20:51,7,44,37
10,BAS,P009048,P011948,0 days 00:18:49,-2,35,37
10,BAS,P004761,P012201,0 days 00:18:37,-2,46,48
10,BAS,P007230,P011948,0 days 00:17:25,3,37,34
10,BAS,P010444,P011948,0 days 00:16:34,5,35,30
10,BAS,P004603,P004761,0 days 00:15:20,-6,35,41
10,BAS,P004761,P011064,0 days 00:14:57,4,42,38
10,BAS,P007230,P008072,0 days 00:13:25,13,29,16
10,BAS,P004603,P012201,0 days 00:13:22,-7,32,39
10,BAS,P011064,P012201,0 days 00:13:20,-2,38,40
10,BAS,P008072,P010444,0 days 00:12:34,15,27,12
10,BAS,P008072,P011948,0 days 00:12:19,12,28,16
10,BAS,P009048,P012201,0 days 00:11:51,-12,20,32
10,BAS,P007230,P012201,0 days 00:11:40,-4,29,33
10,BAS,P004761,P007230,0 days 00:11:32,9,30,21
10,BAS,P004603,P011064,0 days 00:10:46,-2,30,32
10,BAS,P004761,P009048,0 days 00:10:40,-4,18,22
10,BAS,P004603,P009048,0 days 00:10:27,-6,19,25
10,BAS,P008072,P009048,0 days 00:10:11,12,22,10
10,BAS,P004603,P007230,0 days 00:08:02,3,23,20
10,BAS,P004761,P010444,0 days 00:07:57,6,17,11
10,BAS,P007230,P011064,0 days 00:07:46,2,20,18
10,BAS,P011948,P012201,0 days 00:07:32,-14,11,25
10,BAS,P010444,P012201,0 days 00:07:30,-4,15,19
10,BAS,P004603,P011948,0 days 00:05:29,-7,8,15
10,BAS,P011085,P012201,0 days 00:04:51,1,15,14
10,BAS,P011064,P011085,0 days 00:04:51,1,15,14
10,BAS,P004761,P011085,0 days 00:04:51,1,15,14
10,BAS,P004603,P011085,0 days 00:04:51,1,15,14
10,BAS,P004603,P010444,0 days 00:04:27,0,10,10
10,BAS,P008072,P011064,0 days 00:04:08,3,11,8
10,BAS,P010444,P011064,0 days 00:03:46,4,8,4
10,BAS,P004761,P011948,0 days 00:03:32,-5,4,9
10,BAS,P009048,P011064,0 days 00:03:02,-2,6,8
10,BAS,P004761,P008072,0 days 00:02:54,5,9,4
10,BAS,P011064,P011948,0 days 00:02:08,0,6,6
10,BAS,P008072,P012201,0 days 00:01:45,0,6,6
11,IST,P004554,P011078,0 days 00:21:22,4,50,46
11,IST,P007200,P011078,0 days 00:19:40,-32,29,61
11,IST,P006372,P011078,0 days 00:16:56,12,43,31
11,IST,P004888,P007200,0 days 00:16:25,-29,25,54
11,IST,P004554,P006590,0 days 00:16:10,14,43,29
11,IST,P006590,P011078,0 days 00:15:53,17,43,26
11,IST,P004888,P011078,0 days 00:15:18,-26,22,48
11,IST,P006372,P006590,0 days 00:15:03,11,39,28
11,IST,P004554,P006372,0 days 00:14:33,9,38,29
11,IST,P011078,P011981,0 days 00:14:08,-13,24,37
11,IST,P009664,P011078,0 days 00:14:06,6,36,30
11,IST,P006372,P009664,0 days 00:13:51,10,36,26
11,IST,P004554,P009664,0 days 00:13:29,8,35,27
11,IST,P006590,P009664,0 days 00:12:37,6,36,30
11,IST,P007200,P009664,0 days 00:12:06,-26,16,42
11,IST,P004888,P011981,0 days 00:11:16,-17,17,34
11,IST,P004554,P007200,0 days 00:11:08,-23,15,38
11,IST,P007200,P011981,0 days 00:10:27,-16,16,32
11,IST,P006372,P007200,0 days 00:10:18,-20,12,32
11,IST,P006590,P009513,0 days 00:07:54,2,20,18
11,IST,P007200,PLHK,0 days 00:07:51,-14,11,25
11,IST,P006590,P007200,0 days 00:07:37,-20,8,28
11,IST,P004888,P009664,0 days 00:07:22,-17,10,27
11,IST,P011078,PLHK,0 days 00:06:26,-10,11,21
11,IST,P004554,P009513,0 days 00:06:07,2,14,12
11,IST,P009513,P011078,0 days 00:06:07,2,14,12
11,IST,P004554,P004888,0 days 00:05:49,-13,9,22
11,IST,P004888,PLHK,0 days 00:05:42,-8,9,17
11,IST,P011981,PLHK,0 days 00:05:33,-8,9,17
11,IST,P006590,P011981,0 days 00:05:32,-5,10,15
11,IST,P006372,P009513,0 days 00:05:31,3,14,11
11,IST,P009664,PLHK,0 days 00:05:27,-6,10,16
11,IST,P006372,PLHK,0 days 00:04:43,-4,8,12
11,IST,P004888,P006372,0 days 00:04:23,-7,7,14
11,IST,P006590,PLHK,0 days 00:04:05,-6,8,14
11,IST,P009513,P011981,0 days 00:03:54,-1,8,9
11,IST,P004554,P011981,0 days 00:03:54,-1,8,9
11,IST,P009513,P009664,0 days 00:03:18,0,8,8
11,IST,P009513,PLHK,0 days 00:03:18,0,8,8
11,IST,P006372,P011981,0 days 00:03:15,-2,5,7
11,IST,P009664,P011981,0 days 00:02:41,-9,3,12
11,IST,P004888,P006590,0 days 00:02:41,-3,5,8
11,IST,P006372,P012415,0 days 00:01:31,0,2,2
11,IST,P009513,P012415,0 days 00:01:31,0,2,2
11,IST,P009664,P012415,0 days 00:01:31,0,2,2
11,IST,P012415,PLHK,0 days 00:01:31,0,2,2
11,MAD,P005928,P010357,0 days 00:21:57,33,68,35
11,MAD,P001392,P005928,0 days 00:21:53,32,67,35
11,MAD,P006540,P010357,0 days 00:19:27,20,54,34
11,MAD,P001392,P010357,0 days 00:18:56,27,56,29
11,MAD,P003108,P004887,0 days 00:18:45,1,45,44
11,MAD,P001392,P006540,0 days 00:17:56,23,50,27
11,MAD,P005791,P006540,0 days 00:17:27,18,49,31
11,MAD,P005791,P010357,0 days 00:17:27,18,49,31
11,MAD,P005928,P006540,0 days 00:16:33,23,48,25
11,MAD,P001392,P005791,0 days 00:15:59,23,47,24
11,MAD,P005791,P005928,0 days 00:14:33,21,43,22
11,MAD,P003108,P009005,0 days 00:13:24,1,29,28
11,MAD,P003108,PTGB,0 days 00:12:24,-4,25,29
11,MAD,P004887,P009005,0 days 00:12:10,-1,25,26
11,MAD,P003108,P005928,0 days 00:12:02,19,40,21
11,MAD,P004887,PTGB,0 days 00:10:33,-8,19,27
11,MAD,P004887,P005928,0 days 00:10:02,17,35,18
11,MAD,P001392,P003108,0 days 00:09:52,9,29,20
11,MAD,P003108,P010357,0 days 00:08:51,4,25,21
11,MAD,P004887,PCVM,0 days 00:08:32,-16,10,26
11,MAD,P001392,P004887,0 days 00:08:29,9,26,17
11,MAD,P003108,PCVM,0 days 00:08:15,-16,10,26
11,MAD,P010357,PTGB,0 days 00:07:22,-5,18,23
11,MAD,P001392,P009005,0 days 00:07:12,5,20,15
11,MAD,PCVM,PTGB,0 days 00:07:11,-19,7,26
11,MAD,P009005,PCVM,0 days 00:07:04,-8,10,18
11,MAD,P004887,P010357,0 days 00:06:51,2,20,18
11,MAD,P009005,PTGB,0 days 00:06:29,-4,9,13
11,MAD,P005928,PTGB,0 days 00:04:42,8,16,8
11,MAD,P005928,P009005,0 days 00:04:37,7,15,8
11,MAD,P010357,PCVM,0 days 00:04:21,-11,6,17
11,MAD,P001392,PCVM,0 days 00:04:15,0,9,9
11,MAD,P003108,P006540,0 days 00:04:00,4,9,5
11,MAD,P006540,PTGB,0 days 00:03:48,-1,8,9
11,MAD,P006540,PCVM,0 days 00:03:11,-3,6,9
11,MAD,P005791,PCVM,0 days 00:02:54,-3,6,9
11,MAD,P006540,P009005,0 days 00:02:17,2,4,2
11,MAD,P003108,P009213,0 days 00:01:31,2,4,2
11,MAD,P006540,P009213,0 days 00:01:31,2,4,2
11,MAD,P009005,P009213,0 days 00:01:31,2,4,2
11,MAD,P009213,PTGB,0 days 00:01:31,2,4,2
11,MAD,P005791,PTGB,0 days 00:01:28,-5,2,7
11,MAD,P004887,P006540,0 days 00:00:46,0,0,0
11,MAD,P005928,PCVM,0 days 00:00:01,0,0,0
12,MIL,P007201,P007831,0 days 00:29:40,-4,75,79
12,MIL,P000796,P007831,0 days 00:28:06,-6,70,76
12,MIL,P000796,P007201,0 days 00:27:09,-2,68,70
12,MIL,P000796,P002849,0 days 00:21:05,-10,53,63
12,MIL,P002849,P007831,0 days 00:21:05,-10,53,63
12,MIL,P000796,P007032,0 days 00:20:09,-5,50,55
12,MIL,P007032,P007201,0 days 00:19:55,-3,50,53
12,MIL,P007032,P007831,0 days 00:19:48,-4,50,54
12,MIL,P002849,P007201,0 days 00:19:47,-5,51,56
12,MIL,P002849,P007032,0 days 00:14:01,-7,35,42
12,MIL,P006433,P007831,0 days 00:13:41,-6,30,36
12,MIL,P000796,P006433,0 days 00:11:04,-1,24,25
12,MIL,P006433,P007201,0 days 00:10:45,1,28,27
12,MIL,P007831,P009960,0 days 00:10:01,4,27,23
12,MIL,P006433,P011205,0 days 00:09:57,2,18,16
12,MIL,P002849,P006433,0 days 00:09:39,-2,21,23
12,MIL,P007201,P009960,0 days 00:09:39,6,27,21
12,MIL,P006433,P009960,0 days 00:08:29,3,18,15
12,MIL,P009960,P011205,0 days 00:07:15,2,16,14
12,MIL,P000796,P009960,0 days 00:06:08,6,17,11
12,MIL,P006433,P006509,0 days 00:06:00,0,10,10
12,MIL,P007831,P011205,0 days 00:05:25,-6,10,16
12,MIL,P001518,P006433,0 days 00:05:25,0,7,7
12,MIL,P007032,P009960,0 days 00:04:54,5,15,10
12,MIL,P001518,P002812,0 days 00:04:18,-3,4,7
12,MIL,P002812,P006433,0 days 00:04:16,-1,4,5
12,MIL,P000796,P002812,0 days 00:04:00,-2,4,6
12,MIL,P002849,P006509,0 days 00:03:53,-4,5,9
12,MIL,P001518,P011205,0 days 00:03:53,-1,5,6
12,MIL,P007201,P011205,0 days 00:03:31,0,10,10
12,MIL,P006509,P011205,0 days 00:03:24,2,6,4
12,MIL,P006509,P009960,0 days 00:03:22,4,6,2
12,MIL,P000796,P006509,0 days 00:03:13,-7,4,11
12,MIL,P000796,P001518,0 days 00:02:46,1,4,3
12,MIL,P002812,P011205,0 days 00:02:44,-2,2,4
12,MIL,P002849,P009960,0 days 00:02:35,1,3,2
12,MIL,P002849,P011205,0 days 00:02:35,1,3,2
12,MIL,P001518,P007831,0 days 00:02:33,-3,3,6
12,MIL,P002812,P007831,0 days 00:02:25,-6,0,6
12,MIL,P002812,P006509,0 days 00:01:57,-4,2,6
12,MIL,P001518,P006509,0 days 00:01:44,-3,2,5
12,MIL,P006509,P007831,0 days 00:01:20,-7,2,9
12,MIL,P002812,P007032,0 days 00:01:14,-3,0,3
12,MIL,P002812,P007201,0 days 00:01:14,-3,0,3
12,MIL,P000796,P011205,0 days 00:01:12,2,2,0
12,MIL,P001518,P009960,0 days 00:01:09,1,3,2
12,MIL,P006509,P007201,0 days 00:01:00,2,3,1
12,MIL,P006509,P007032,0 days 00:00:35,-3,0,3
12,TEL,P009622,P009783,0 days 00:25:41,2,66,64
12,TEL,P009622,P011199,0 days 00:22:05,4,60,56
12,TEL,P009622,P011971,0 days 00:20:56,9,59,50
12,TEL,P009622,P012744,0 days 00:20:02,1,55,54
12,TEL,P009783,P011971,0 days 00:20:02,13,62,49
12,TEL,P009783,P011199,0 days 00:19:03,-1,50,51
12,TEL,P009783,P012744,0 days 00:18:56,1,54,53
12,TEL,P011199,P012744,0 days 00:16:59,-3,45,48
12,TEL,P011971,P012744,0 days 00:15:58,3,47,44
12,TEL,P011199,P011971,0 days 00:14:57,8,46,38
12,TEL,P009783,P011193,0 days 00:14:15,10,37,27
12,TEL,P009622,P011214,0 days 00:13:09,6,30,24
12,TEL,P011193,P011214,0 days 00:12:13,4,23,19
12,TEL,P009783,P011214,0 days 00:11:56,6,31,25
12,TEL,P009622,P011193,0 days 00:10:32,5,21,16
12,TEL,P005145,P011193,0 days 00:09:37,-6,15,21
12,TEL,P011193,P011971,0 days 00:09:27,11,22,11
12,TEL,P011214,P011971,0 days 00:09:22,6,20,14
12,TEL,P011214,P012744,0 days 00:09:08,13,31,18
12,TEL,P004233,P011214,0 days 00:07:32,6,16,10
12,TEL,P005145,P009783,0 days 00:07:16,-8,10,18
12,TEL,P011193,P011199,0 days 00:06:50,5,19,14
12,TEL,P011193,P011219,0 days 00:06:07,-2,11,13
12,TEL,P005145,P011214,0 days 00:05:38,2,9,7
12,TEL,P004233,P011193,0 days 00:05:07,0,8,8
12,TEL,P011199,P011214,0 days 00:04:48,4,14,10
12,TEL,P005145,P009622,0 days 00:04:26,-5,3,8
12,TEL,P004233,P005145,0 days 00:04:14,0,8,8
12,TEL,P009783,P011219,0 days 00:04:13,2,11,9
12,TEL,P004233,P011199,0 days 00:04:09,4,12,8
12,TEL,P004233,P012744,0 days 00:04:09,4,12,8
12,TEL,P011214,P011219,0 days 00:03:54,1,6,5
12,TEL,P005145,P011199,0 days 00:03:17,-9,2,11
12,TEL,P005145,P011971,0 days 00:03:13,-1,4,5
12,TEL,P004233,P009622,0 days 00:03:12,5,10,5
12,TEL,P004233,P011971,0 days 00:02:54,2,4,2
12,TEL,P005145,P012744,0 days 00:02:49,-7,3,10
12,TEL,P011193,P012744,0 days 00:02:43,4,11,7
12,TEL,P007990,P011193,0 days 00:02:21,-3,5,8
12,TEL,P005145,P007990,0 days 00:02:21,-3,5,8
12,TEL,P007990,P011219,0 days 00:02:13,-3,5,8
12,TEL,P005145,P011219,0 days 00:02:13,-3,5,8
12,TEL,P009622,P011219,0 days 00:02:05,-3,0,3
12,TEL,P011219,P011971,0 days 00:01:54,-4,0,4
12,TEL,P007990,P009783,0 days 00:01:52,0,5,5
12,TEL,P004233,P009783,0 days 00:01:46,-1,2,3
12,TEL,P011219,P012744,0 days 00:00:56,4,6,2
12,TEL,P004233,P011219,0 days 00:00:53,0,0,0
12,TEL,P007990,P011971,0 days 00:00:29,-3,0,3
12,TEL,P007990,P009622,0 days 00:00:08,0,0,0
13,PAN,P003842,P011204,0 days 00:27:24,8,55,47
13,PAN,P003842,P007947,0 days 00:27:03,3,51,48
13,PAN,P007947,P012712,0 days 00:24:35,9,49,40
13,PAN,P007947,P011204,0 days 00:23:21,5,43,38
13,PAN,P003842,P012712,0 days 00:22:59,9,46,37
13,PAN,P002328,P003842,0 days 00:22:50,10,52,42
13,PAN,P011204,P012712,0 days 00:22:15,9,45,36
13,PAN,P005161,P011204,0 days 00:19:55,-2,33,35
13,PAN,P002328,P011204,0 days 00:19:49,19,50,31
13,PAN,P003842,P005161,0 days 00:18:04,1,37,36
13,PAN,P002328,P007947,0 days 00:17:07,9,40,31
13,PAN,P005161,P007947,0 days 00:14:29,-8,20,28
13,PAN,P002328,P012712,0 days 00:13:52,17,38,21
13,PAN,P005161,P008084,0 days 00:13:15,2,27,25
13,PAN,P008084,P011204,0 days 00:11:45,2,25,23
13,PAN,P005161,P012712,0 days 00:11:03,-4,15,19
13,PAN,P003842,P008084,0 days 00:10:50,-5,22,27
13,PAN,P002328,P008084,0 days 00:09:55,2,25,23
13,PAN,P002328,P005161,0 days 00:08:21,4,22,18
13,PAN,P005161,P007553,0 days 00:05:42,-4,4,8
13,PAN,P007947,P008084,0 days 00:05:20,-2,12,14
13,PAN,P007553,P011204,0 days 00:05:17,-4,4,8
13,PAN,P007947,P011826,0 days 00:04:41,0,9,9
13,PAN,P005161,P011826,0 days 00:04:23,4,7,3
13,PAN,P003842,P011826,0 days 00:04:16,0,9,9
13,PAN,P007553,P008084,0 days 00:03:40,0,4,4
13,PAN,P008084,P011826,0 days 00:03:36,2,5,3
13,PAN,P011826,P012712,0 days 00:02:52,0,6,6
13,PAN,P007553,P007947,0 days 00:02:27,-4,0,4
13,PAN,P007553,P011826,0 days 00:02:12,2,2,0
13,PAN,P002328,P011826,0 days 00:02:05,-2,4,6
13,PAN,P007553,P012712,0 days 00:02:02,-4,0,4
13,PAN,P011204,P011826,0 days 00:01:47,2,2,0
13,PAN,P006544,P008084,0 days 00:01:28,-2,2,4
13,PAN,P006544,P011204,0 days 00:01:28,-2,2,4
13,PAN,P006544,P007553,0 days 00:01:28,-2,2,4
13,PAN,P005161,P006544,0 days 00:01:28,-2,2,4
13,PAN,P008084,P011221,0 days 00:01:07,-1,1,2
13,PAN,P011204,P011221,0 days 00:01:07,-1,1,2
13,PAN,P002328,P011221,0 days 00:00:45,1,1,0
13,PAN,P005161,P011221,0 days 00:00:32,1,1,0
13,PAN,P008084,P012712,0 days 00:00:28,2,5,3
13,PAN,P003842,P011221,0 days 00:00:22,-2,0,2
13,PAN,P011221,P012712,0 days 00:00:22,-2,0,2
13,PAN,P007947,P011221,0 days 00:00:13,0,0,0
13,MUN,P006760,P007056,0 days 00:24:38,-13,44,57
13,MUN,P006760,P008985,0 days 00:23:54,4,49,45
13,MUN,P007056,P008985,0 days 00:21:18,0,42,42
13,MUN,P003583,P008985,0 days 00:18:05,-2,35,37
13,MUN,P004508,P008985,0 days 00:17:33,0,35,35
13,MUN,P004508,P006760,0 days 00:17:31,-5,33,38
13,MUN,P003583,P006760,0 days 00:16:15,-4,31,35
13,MUN,P004508,P007056,0 days 00:15:38,-3,30,33
13,MUN,P001557,P007975,0 days 00:13:04,-2,20,22
13,MUN,P007056,P011987,0 days 00:12:29,-7,19,26
13,MUN,P007975,P011987,0 days 00:12:17,-10,16,26
13,MUN,P003583,P004508,0 days 00:12:05,-7,21,28
13,MUN,P003583,P007056,0 days 00:12:00,-8,22,30
13,MUN,P010391,P011987,0 days 00:11:53,-5,16,21
13,MUN,P007975,P010391,0 days 00:11:42,-5,16,21
13,MUN,P007056,P007975,0 days 00:11:26,-7,21,28
13,MUN,P001557,P006760,0 days 00:10:55,7,25,18
13,MUN,P001557,P008985,0 days 00:10:00,15,25,10
13,MUN,P006760,P007975,0 days 00:09:48,-3,18,21
13,MUN,P001557,P011987,0 days 00:09:39,-4,14,18
13,MUN,P001557,P007056,0 days 00:09:31,3,21,18
13,MUN,P001557,P010391,0 days 00:08:19,0,12,12
13,MUN,P007056,P010391,0 days 00:08:15,-3,13,16
13,MUN,P003583,P007975,0 days 00:08:09,8,16,8
13,MUN,P001557,P003583,0 days 00:07:57,4,13,9
13,MUN,P006760,P011987,0 days 00:07:12,-7,10,17
13,MUN,P007975,P008985,0 days 00:06:17,10,16,6
13,MUN,P007056,P011941,0 days 00:05:53,-6,8,14
13,MUN,P001557,P004508,0 days 00:05:45,5,15,10
13,MUN,P008985,P011941,0 days 00:05:28,-4,8,12
13,MUN,P011941,P011987,0 days 00:05:16,-2,7,9
13,MUN,P010391,P011941,0 days 00:03:50,-2,5,7
13,MUN,P008985,P011987,0 days 00:03:50,1,6,5
13,MUN,P006760,P011941,0 days 00:03:49,-4,6,10
13,MUN,P003583,P010391,0 days 00:03:20,-2,2,4
13,MUN,P008985,P010391,0 days 00:03:07,0,4,4
13,MUN,P006760,P010391,0 days 00:02:58,-3,4,7
13,MUN,P004508,P011941,0 days 00:02:18,-1,4,5
13,MUN,P007975,P011941,0 days 00:02:11,-2,3,5
13,MUN,P003583,P011987,0 days 00:01:52,-2,0,2
13,MUN,P001557,P011941,0 days 00:01:46,0,3,3
13,MUN,P004508,P007975,0 days 00:00:42,-1,2,3
13,MUN,P003583,P011941,0 days 00:00:05,-3,0,3
14,ASV,P011225,P012729,0 days 00:22:24,-21,33,54
14,ASV,P012080,P012729,0 days 00:22:17,-17,40,57
14,ASV,P012729,P012732,0 days 00:20:51,-28,32,60
14,ASV,P011225,P012080,0 days 00:18:18,-13,32,45
14,ASV,P012080,P012732,0 days 00:17:42,-18,32,50
14,ASV,P004194,P012729,0 days 00:17:37,-15,30,45
14,ASV,P011225,P012732,0 days 00:17:24,-20,25,45
14,ASV,P004194,P011225,0 days 00:15:57,-13,23,36
14,ASV,P004194,P012080,0 days 00:15:47,-18,27,45
14,ASV,P012080,P012730,0 days 00:15:05,1,28,27
14,ASV,P002100,P012730,0 days 00:13:18,-4,21,25
14,ASV,P002100,P012080,0 days 00:13:11,-3,25,28
14,ASV,P004194,P012732,0 days 00:12:11,-15,21,36
14,ASV,P011225,P012730,0 days 00:11:06,-8,15,23
14,ASV,P002100,PKIR,0 days 00:10:54,2,19,17
14,ASV,P000229,P012080,0 days 00:10:07,1,19,18
14,ASV,P012729,P012730,0 days 00:10:03,-10,12,22
14,ASV,P012730,PKIR,0 days 00:09:23,4,19,15
14,ASV,P012080,PKIR,0 days 00:09:21,-2,17,19
14,ASV,P012730,P012732,0 days 00:09:01,-12,10,22
14,ASV,P002100,P012729,0 days 00:08:25,-14,9,23
14,ASV,P002100,P012732,0 days 00:07:41,-17,6,23
14,ASV,P000229,PKIR,0 days 00:07:00,3,14,11
14,ASV,P000229,P011225,0 days 00:06:47,-3,8,11
14,ASV,P002100,P011225,0 days 00:06:45,-8,5,13
14,ASV,P000229,P004194,0 days 00:06:31,-3,8,11
14,ASV,P000229,P012730,0 days 00:06:13,5,14,9
14,ASV,P002100,P004194,0 days 00:06:01,-8,7,15
14,ASV,P000229,P002100,0 days 00:05:57,5,14,9
14,ASV,P000229,P012729,0 days 00:05:44,-1,8,9
14,ASV,P002100,P012731,0 days 00:05:04,-1,6,7
14,ASV,P011225,P012731,0 days 00:04:52,2,6,4
14,ASV,P011225,PKIR,0 days 00:04:39,0,5,5
14,ASV,P012729,P012731,0 days 00:04:28,3,7,4
14,ASV,P004194,P012731,0 days 00:04:06,0,4,4
14,ASV,P012731,PKIR,0 days 00:03:59,-5,4,9
14,ASV,P012730,P012731,0 days 00:03:35,0,5,5
14,ASV,P012080,P012731,0 days 00:03:12,-3,4,7
14,ASV,P000229,P012731,0 days 00:02:37,1,3,2
14,ASV,P004194,PKIR,0 days 00:02:34,-4,0,4
14,ASV,P012732,PKIR,0 days 00:01:07,-1,1,2
14,ASV,P012729,PKIR,0 days 00:00:23,-1,1,2
14,ASV,P012731,P012732,0 days 00:00:23,-1,1,2
14,PAR,P007400,P008987,0 days 00:24:18,20,57,37
14,PAR,P003983,P008987,0 days 00:21:53,26,58,32
14,PAR,P003983,P007400,0 days 00:18:42,20,50,30
14,PAR,P007400,P009862,0 days 00:16:31,9,34,25
14,PAR,P008987,P009862,0 days 00:15:06,10,31,21
14,PAR,P008987,P011051,0 days 00:14:18,18,36,18
14,PAR,P008987,P012743,0 days 00:13:11,8,29,21
14,PAR,P003983,P009862,0 days 00:12:50,8,27,19
14,PAR,P007400,P011051,0 days 00:12:40,16,34,18
14,PAR,P003983,P012743,0 days 00:12:39,10,29,19
14,PAR,P007400,P012743,0 days 00:12:04,3,23,20
14,PAR,P007400,P012742,0 days 00:11:49,3,20,17
14,PAR,P000956,P008987,0 days 00:11:49,17,32,15
14,PAR,P009862,P012743,0 days 00:11:19,9,24,15
14,PAR,P000956,P011051,0 days 00:10:43,14,26,12
14,PAR,P003983,P011051,0 days 00:10:13,13,29,16
14,PAR,P000956,P003983,0 days 00:09:53,15,27,12
14,PAR,P000956,P007400,0 days 00:09:00,12,24,12
14,PAR,P004172,P011050,0 days 00:08:37,1,16,15
14,PAR,P007400,P007673,0 days 00:08:10,1,14,13
14,PAR,P007673,P011050,0 days 00:08:07,1,14,13
14,PAR,P004172,P007673,0 days 00:08:07,1,14,13
14,PAR,P004172,P007400,0 days 00:07:51,1,14,13
14,PAR,P008987,P012742,0 days 00:07:33,5,15,10
14,PAR,P007673,P012742,0 days 00:07:29,2,14,12
14,PAR,P007400,P011050,0 days 00:07:23,3,14,11
14,PAR,P007673,P009862,0 days 00:07:19,0,14,14
14,PAR,P009862,P011051,0 days 00:07:11,0,12,12
14,PAR,P009862,P012742,0 days 00:06:50,1,11,10
14,PAR,P000956,P009862,0 days 00:05:36,-1,9,10
14,PAR,P004172,P012742,0 days 00:05:26,1,9,8
14,PAR,P011050,P012742,0 days 00:05:26,1,9,8
14,PAR,P000956,P012742,0 days 00:05:18,5,12,7
14,PAR,P011051,P012742,0 days 00:05:04,2,7,5
14,PAR,P000956,P007673,0 days 00:05:01,4,13,9
14,PAR,P012742,P012743,0 days 00:04:58,3,13,10
14,PAR,P000956,P012743,0 days 00:04:56,4,13,9
14,PAR,P007673,P012743,0 days 00:04:49,5,13,8
14,PAR,P009862,P011050,0 days 00:04:21,0,9,9
14,PAR,P004172,P009862,0 days 00:04:21,0,9,9
14,PAR,P003983,P007673,0 days 00:03:19,-1,6,7
14,PAR,P007673,P008987,0 days 00:02:20,2,6,4
14,PAR,P003983,P012742,0 days 00:01:59,1,6,5
14,PAR,P007673,P011051,0 days 00:00:59,-3,0,3
14,PAR,P004172,P008987,0 days 00:00:58,-2,2,4
14,PAR,P000956,P004172,0 days 00:00:32,-4,0,4
14,PAR,P008987,P011050,0 days 00:00:30,0,2,2
14,PAR,P004172,P012743,0 days 00:00:28,-2,0,2
14,PAR,P000956,P011050,0 days 00:00:04,-2,0,2
15,MCO,P004197,P005985,0 days 00:18:30,-11,28,39
15,MCO,P005985,P011212,0 days 00:17:29,-17,22,39
15,MCO,P004790,P005985,0 days 00:15:42,-6,26,32
15,MCO,P005985,PLCZ,0 days 00:15:14,-13,24,37
15,MCO,P005985,P011226,0 days 00:13:29,-12,15,27
15,MCO,P011212,P011231,0 days 00:13:05,-13,16,29
15,MCO,P004197,PLCZ,0 days 00:12:59,-12,21,33
15,MCO,P010588,P011212,0 days 00:11:59,-11,11,22
15,MCO,P008099,P011231,0 days 00:11:25,-1,20,21
15,MCO,P011196,P011212,0 days 00:11:23,-8,19,27
15,MCO,P004197,P004790,0 days 00:11:22,-5,19,24
15,MCO,P011212,P011226,0 days 00:11:15,-5,15,20
15,MCO,P005985,P010588,0 days 00:10:40,-9,11,20
15,MCO,P004790,P011226,0 days 00:10:38,-8,15,23
15,MCO,P008099,P011226,0 days 00:10:31,-2,19,21
15,MCO,P008099,P011212,0 days 00:10:09,-3,17,20
15,MCO,P004197,P011212,0 days 00:09:56,-9,14,23
15,MCO,P008099,P011196,0 days 00:09:55,-4,18,22
15,MCO,P005985,P011231,0 days 00:09:52,-8,12,20
15,MCO,P004790,PLCZ,0 days 00:09:45,-8,14,22
15,MCO,P011212,PLCZ,0 days 00:09:40,-7,16,23
15,MCO,P004790,P011212,0 days 00:09:09,-1,16,17
15,MCO,P010588,P011226,0 days 00:08:37,-3,8,11
15,MCO,P004790,P008099,0 days 00:08:32,0,15,15
15,MCO,P005985,P011196,0 days 00:08:14,-6,11,17
15,MCO,P011196,P011231,0 days 00:08:07,-8,14,22
15,MCO,P011226,PLCZ,0 days 00:07:24,-6,10,16
15,MCO,P011196,P011226,0 days 00:07:16,-3,14,17
15,MCO,P005985,P008099,0 days 00:07:13,1,13,12
15,MCO,P004197,P010588,0 days 00:07:08,-6,9,15
15,MCO,P011226,P011231,0 days 00:06:29,-4,9,13
15,MCO,P011196,P012515,0 days 00:06:27,-6,10,16
15,MCO,P011212,P012515,0 days 00:06:27,-6,10,16
15,MCO,P011231,P012515,0 days 00:06:14,-8,8,16
15,MCO,P010588,P011231,0 days 00:05:14,-5,2,7
15,MCO,P004197,P011226,0 days 00:05:09,-5,7,12
15,MCO,P010588,PLCZ,0 days 00:05:04,-4,9,13
15,MCO,P004197,P011231,0 days 00:04:28,1,7,6
15,MCO,P008099,P010588,0 days 00:04:27,2,6,4
15,MCO,P004790,P011196,0 days 00:04:01,-1,8,9
15,MCO,P008099,P012515,0 days 00:03:26,-3,4,7
15,MCO,P004790,P011231,0 days 00:03:25,3,7,4
15,MCO,P004197,P008099,0 days 00:03:25,3,7,4
15,MCO,P005985,P012515,0 days 00:03:01,-3,6,9
15,MCO,P010588,P011196,0 days 00:02:38,0,2,2
15,MCO,P004790,P010588,0 days 00:01:21,0,2,2
15,MCO,P004197,P011196,0 days 00:01:03,0,0,0
15,MCO,P008099,PLCZ,0 days 00:00:25,-1,1,2
15,MCO,P011231,PLCZ,0 days 00:00:25,-1,1,2
15,MCO,P004790,P012515,0 days 00:00:13,2,2,0
15,VIR,P001133,PBCN,0 days 00:18:59,11,40,29
15,VIR,P001844,P003048,0 days 00:17:31,12,40,28
15,VIR,P004007,P008847,0 days 00:17:26,11,36,25
15,VIR,P001133,P003048,0 days 00:16:13,13,36,23
15,VIR,P004007,P010781,0 days 00:16:03,9,32,23
15,VIR,P003048,PBCN,0 days 00:16:02,10,33,23
15,VIR,P008847,P010781,0 days 00:16:01,11,33,22
15,VIR,P001133,P009549,0 days 00:15:25,13,35,22
15,VIR,P001133,P001844,0 days 00:13:49,12,31,19
15,VIR,P003048,P009549,0 days 00:13:44,11,31,20
15,VIR,P001844,PBCN,0 days 00:13:38,9,28,19
15,VIR,P009549,PBCN,0 days 00:13:37,11,33,22
15,VIR,P001844,P009549,0 days 00:11:29,12,28,16
15,VIR,P008847,P011192,0 days 00:11:03,8,25,17
15,VIR,P004007,P011192,0 days 00:10:52,11,28,17
15,VIR,P001133,P010781,0 days 00:10:44,2,21,19
15,VIR,P010781,P011192,0 days 00:09:57,11,21,10
15,VIR,P001133,P008847,0 days 00:09:45,6,20,14
15,VIR,P004007,P006739,0 days 00:08:20,1,12,11
15,VIR,P003048,P010781,0 days 00:08:16,4,15,11
15,VIR,P006739,P008847,0 days 00:07:59,3,15,12
15,VIR,P006739,P010781,0 days 00:07:58,0,15,15
15,VIR,P003048,P004007,0 days 00:07:40,8,19,11
15,VIR,P003048,P008847,0 days 00:07:29,5,16,11
15,VIR,P003048,P011192,0 days 00:07:15,9,18,9
15,VIR,P001133,P004007,0 days 00:06:59,8,16,8
15,VIR,P001133,P011192,0 days 00:06:51,6,14,8
15,VIR,P010781,PBCN,0 days 00:06:38,1,12,11
15,VIR,P004007,P012714,0 days 00:05:38,0,9,9
15,VIR,P010781,P012714,0 days 00:05:38,0,9,9
15,VIR,P001133,P006739,0 days 00:05:07,5,11,6
15,VIR,P006739,P012714,0 days 00:04:15,-3,6,9
15,VIR,P001844,P004007,0 days 00:03:53,3,12,9
15,VIR,P008847,PBCN,0 days 00:03:51,3,9,6
15,VIR,P001844,P008847,0 days 00:03:42,0,9,9
15,VIR,P003527,P010781,0 days 00:03:25,-3,4,7
15,VIR,P003527,P006739,0 days 00:03:25,-3,4,7
15,VIR,P003527,P004007,0 days 00:03:25,-3,4,7
15,VIR,P001844,P011192,0 days 00:03:19,2,9,7
15,VIR,P006739,PBCN,0 days 00:03:01,3,9,6
15,VIR,P006739,P009549,0 days 00:02:57,2,4,2
15,VIR,P008847,P009549,0 days 00:02:57,2,4,2
15,VIR,P003527,P012714,0 days 00:02:56,-1,4,5
15,VIR,P001844,P010781,0 days 00:02:43,-2,3,5
15,VIR,P008847,P012714,0 days 00:02:42,1,5,4
15,VIR,P004007,P009549,0 days 00:02:26,2,2,0
15,VIR,P011192,PBCN,0 days 00:02:24,2,2,0
15,VIR,P009549,P010781,0 days 00:01:37,-1,3,4
15,VIR,P011192,P012714,0 days 00:01:23,3,3,0
15,VIR,P003048,P006739,0 days 00:00:38,0,0,0
15,VIR,P003527,P008847,0 days 00:00:29,-2,0,2
15,VIR,P004007,PBCN,0 days 00:00:26,2,2,0
16,OLY,P008829,P008855,0 days 00:29:45,-11,49,60
16,OLY,P001255,P008855,0 days 00:27:39,-12,47,59
16,OLY,P003941,P008829,0 days 00:25:12,-11,44,55
16,OLY,P001255,P003941,0 days 00:23:47,-9,40,49
16,OLY,P003941,P008855,0 days 00:23:01,-14,38,52
16,OLY,P001255,P008829,0 days 00:21:51,-10,37,47
16,OLY,P010392,P011983,0 days 00:17:56,0,30,30
16,OLY,P001255,P010612,0 days 00:17:38,-10,31,41
16,OLY,P003941,P010612,0 days 00:17:38,-10,31,41
16,OLY,P008855,P010612,0 days 00:17:38,-10,31,41
16,OLY,P008829,P010612,0 days 00:17:23,-11,30,41
16,OLY,P008855,P011983,0 days 00:13:51,-4,21,25
16,OLY,P008855,P010392,0 days 00:13:46,-3,22,25
16,OLY,P008811,P011983,0 days 00:12:48,1,21,20
16,OLY,P008811,P010392,0 days 00:12:48,1,21,20
16,OLY,P008811,P008855,0 days 00:12:34,1,21,20
16,OLY,P008829,P011983,0 days 00:10:44,3,19,16
16,OLY,P008829,P010392,0 days 00:10:24,3,19,16
16,OLY,P003941,P006302,0 days 00:08:15,5,16,11
16,OLY,P001255,P011983,0 days 00:07:54,-3,11,14
16,OLY,P001255,P010392,0 days 00:07:49,-2,12,14
16,OLY,P008811,P008829,0 days 00:06:59,4,12,8
16,OLY,P006302,P008829,0 days 00:06:34,5,14,9
16,OLY,P001255,P006302,0 days 00:06:05,1,9,8
16,OLY,P001255,P008811,0 days 00:05:49,-3,9,12
16,OLY,P003941,P011983,0 days 00:05:26,-1,9,10
16,OLY,P003941,P010392,0 days 00:05:21,0,10,10
16,OLY,P006302,P010392,0 days 00:04:25,4,9,5
16,OLY,P006302,P011983,0 days 00:04:25,4,9,5
16,OLY,P006302,P008855,0 days 00:04:06,1,7,6
16,OLY,P010392,P010612,0 days 00:00:15,1,1,0
16,OLY,P006302,P008811,0 days 00:00:14,0,0,0
16,BAR,P004866,P006435,0 days 00:21:53,12,49,37
16,BAR,P000925,P004866,0 days 00:21:25,17,49,32
16,BAR,P000925,P006435,0 days 00:19:56,17,47,30
16,BAR,P000925,P002939,0 days 00:18:50,10,40,30
16,BAR,P006435,P011244,0 days 00:18:23,2,37,35
16,BAR,P004866,P011244,0 days 00:18:18,-5,33,38
16,BAR,P002939,P004866,0 days 00:18:11,13,40,27
16,BAR,P003196,P007519,0 days 00:17:15,-4,28,32
16,BAR,P002939,P006435,0 days 00:16:31,13,38,25
16,BAR,P000925,P011244,0 days 00:15:31,3,31,28
16,BAR,P003196,P012745,0 days 00:12:30,-1,20,21
16,BAR,P003196,P007464,0 days 00:12:10,2,21,19
16,BAR,P007519,P012745,0 days 00:12:08,0,20,20
16,BAR,P002939,P011244,0 days 00:12:06,-1,22,23
16,BAR,P007464,P007519,0 days 00:11:59,3,21,18
16,BAR,P006435,P007519,0 days 00:11:14,-2,20,22
16,BAR,P003478,P004866,0 days 00:10:57,12,25,13
16,BAR,P007464,P012745,0 days 00:09:50,-2,15,17
16,BAR,P002939,P003478,0 days 00:09:14,8,20,12
16,BAR,P000925,P003478,0 days 00:09:03,8,20,12
16,BAR,P004866,P007519,0 days 00:08:45,-3,16,19
16,BAR,P007519,P011244,0 days 00:08:36,0,17,17
16,BAR,P003196,P006435,0 days 00:08:04,-7,11,18
16,BAR,P003478,P006435,0 days 00:06:59,10,18,8
16,BAR,P003478,P012745,0 days 00:06:46,2,14,12
16,BAR,P003196,P003478,0 days 00:05:56,5,14,9
16,BAR,P003196,P004866,0 days 00:05:31,-7,7,14
16,BAR,P003478,P007519,0 days 00:05:30,6,14,8
16,BAR,P006435,P007464,0 days 00:05:17,1,9,8
16,BAR,P003196,P011244,0 days 00:05:11,-4,8,12
16,BAR,P006435,P012745,0 days 00:03:43,-6,3,9
16,BAR,P000925,P007519,0 days 00:03:25,4,9,5
16,BAR,P003478,P007464,0 days 00:03:12,4,9,5
16,BAR,P007464,P009992,0 days 00:02:45,-2,3,5
16,BAR,P007519,P009992,0 days 00:02:45,-2,3,5
16,BAR,P009992,P012745,0 days 00:02:45,-2,3,5
16,BAR,P004866,P012745,0 days 00:02:44,1,5,4
16,BAR,P003196,P009992,0 days 00:02:41,-2,3,5
16,BAR,P007464,P011244,0 days 00:02:24,4,6,2
16,BAR,P003478,P011244,0 days 00:02:19,-3,2,5
16,BAR,P002939,P012745,0 days 00:02:16,-5,0,5
16,BAR,P002939,P003196,0 days 00:01:26,-2,0,2
16,BAR,P002939,P007464,0 days 00:01:15,-2,0,2
16,BAR,P002939,P007519,0 days 00:01:15,-2,0,2
16,BAR,P000925,P012745,0 days 00:00:50,-3,0,3
16,BAR,P007464,P010641,0 days 00:00:04,0,0,0
16,BAR,P007519,P010641,0 days 00:00:04,0,0,0
16,BAR,P009992,P010641,0 days 00:00:04,0,0,0
16,BAR,P010641,P012745,0 days 00:00:04,0,0,0
17,PAM,P010568,P012740,0 days 00:23:56,-4,39,43
17,PAM,P003960,P007870,0 days 00:20:25,9,45,36
17,PAM,P010568,P011982,0 days 00:19:20,-2,34,36
17,PAM,P011982,P012740,0 days 00:17:48,-2,29,31
17,PAM,P011982,P012738,0 days 00:16:44,3,29,26
17,PAM,P000556,P003960,0 days 00:16:22,3,36,33
17,PAM,P000556,P007870,0 days 00:16:22,3,36,33
17,PAM,P011982,P012739,0 days 00:16:04,-8,26,34
17,PAM,P012738,P012739,0 days 00:13:43,1,23,22
17,PAM,P010568,P012738,0 days 00:12:59,7,25,18
17,PAM,P010568,P012739,0 days 00:12:39,-4,22,26
17,PAM,P007870,P010568,0 days 00:11:58,3,21,18
17,PAM,P003960,P010568,0 days 00:11:34,1,20,19
17,PAM,P007870,P012740,0 days 00:11:08,4,19,15
17,PAM,P012738,P012740,0 days 00:11:05,4,20,16
17,PAM,P012739,P012740,0 days 00:10:45,-7,17,24
17,PAM,P003960,P012740,0 days 00:10:44,2,18,16
17,PAM,P006643,P009101,0 days 00:09:22,-3,18,21
17,PAM,P006643,P007870,0 days 00:08:41,5,23,18
17,PAM,P000556,P006643,0 days 00:08:29,3,21,18
17,PAM,P003960,P006643,0 days 00:08:25,5,23,18
17,PAM,P000556,P010568,0 days 00:08:08,1,16,15
17,PAM,P007870,P009101,0 days 00:06:52,4,17,13
17,PAM,P000556,P012740,0 days 00:06:44,0,12,12
17,PAM,P003960,P009101,0 days 00:06:36,4,17,13
17,PAM,P000556,P009101,0 days 00:05:47,-1,12,13
17,PAM,P010393,P010568,0 days 00:05:22,-7,8,15
17,PAM,P010393,P012740,0 days 00:05:22,-7,8,15
17,PAM,P010393,P011982,0 days 00:05:22,-7,8,15
17,PAM,P007870,P011982,0 days 00:05:11,6,12,6
17,PAM,P003960,P011982,0 days 00:04:31,4,11,7
17,PAM,P009101,P011982,0 days 00:04:11,0,8,8
17,PAM,P006643,P011982,0 days 00:03:54,-1,7,8
17,PAM,P006643,P012738,0 days 00:03:39,-4,4,8
17,PAM,P000556,P004863,0 days 00:03:35,5,10,5
17,PAM,P003960,P004863,0 days 00:03:35,5,10,5
17,PAM,P004863,P007870,0 days 00:03:35,5,10,5
17,PAM,P006643,P012739,0 days 00:03:23,-4,4,8
17,PAM,P009101,P012738,0 days 00:03:22,-5,3,8
17,PAM,P004863,P010568,0 days 00:03:08,5,7,2
17,PAM,P009101,P012739,0 days 00:03:06,-5,3,8
17,PAM,P010393,P012738,0 days 00:02:39,1,5,4
17,PAM,P004863,P006643,0 days 00:02:23,3,8,5
17,PAM,P010393,P012739,0 days 00:02:09,-8,3,11
17,PAM,P004863,P011982,0 days 00:01:56,3,5,2
17,PAM,P004863,P012738,0 days 00:01:56,3,5,2
17,PAM,P004863,P012739,0 days 00:01:56,3,5,2
17,PAM,P009101,P012740,0 days 00:00:36,2,2,0
17,PAM,P000556,P011982,0 days 00:00:35,0,3,3
17,PAM,P007870,P010393,0 days 00:00:34,0,0,0
17,PAM,P000556,P012738,0 days 00:00:23,1,1,0
17,PAM,P007870,P012738,0 days 00:00:22,1,1,0
17,PAM,P000556,P012739,0 days 00:00:19,1,1,0
17,PAM,P003960,P012739,0 days 00:00:12,-1,0,1
17,PAM,P003960,P012738,0 days 00:00:04,0,0,0
17,ULK,P008962,P009849,0 days 00:23:49,6,50,44
17,ULK,P004004,P006661,0 days 00:20:17,2,38,36
17,ULK,P005844,P008962,0 days 00:18:47,0,32,32
17,ULK,P004004,P005844,0 days 00:17:08,0,30,30
17,ULK,P008962,P011052,0 days 00:16:40,7,37,30
17,ULK,P005844,P006661,0 days 00:16:01,4,30,26
17,ULK,P006661,P008962,0 days 00:15:28,4,31,27
17,ULK,P009849,P011052,0 days 00:15:04,9,36,27
17,ULK,P004004,P008962,0 days 00:14:47,6,29,23
17,ULK,P002968,P011052,0 days 00:14:41,4,33,29
17,ULK,P008962,P010560,0 days 00:14:28,-6,21,27
17,ULK,P005844,P010560,0 days 00:12:42,-6,18,24
17,ULK,P008962,P011980,0 days 00:12:19,3,28,25
17,ULK,P009849,P011980,0 days 00:11:39,1,25,24
17,ULK,P005844,P009849,0 days 00:11:31,-3,18,21
17,ULK,P002968,P011980,0 days 00:10:39,4,24,20
17,ULK,P002968,P008962,0 days 00:10:39,4,24,20
17,ULK,P011052,P011980,0 days 00:10:27,9,26,17
17,ULK,P002968,P009849,0 days 00:10:23,4,24,20
17,ULK,P009849,P010560,0 days 00:07:25,-5,9,14
17,ULK,P004004,P011052,0 days 00:07:05,-5,12,17
17,ULK,P004004,P010560,0 days 00:07:04,-1,12,13
17,ULK,P006661,P011052,0 days 00:06:57,-2,14,16
17,ULK,P006661,P010560,0 days 00:06:40,1,12,11
17,ULK,P005844,P011052,0 days 00:06:33,-8,8,16
17,ULK,P006661,P009849,0 days 00:06:18,3,16,13
17,ULK,P002968,P006661,0 days 00:06:12,-10,9,19
17,ULK,P004004,P009849,0 days 00:05:58,5,14,9
17,ULK,P011052,P011157,0 days 00:05:41,-1,11,12
17,ULK,P002968,P004004,0 days 00:05:23,-5,9,14
17,ULK,P010560,P011052,0 days 00:05:00,-5,7,12
17,ULK,P006661,P011157,0 days 00:03:59,-1,7,8
17,ULK,P004004,P011157,0 days 00:03:43,-2,5,7
17,ULK,P008962,P011157,0 days 00:03:38,1,6,5
17,ULK,P001932,P009849,0 days 00:03:33,-5,2,7
17,ULK,P001932,P005844,0 days 00:03:31,-6,2,8
17,ULK,P006661,P011980,0 days 00:03:00,-6,3,9
17,ULK,P004004,P011980,0 days 00:02:55,-3,3,6
17,ULK,P001932,P008962,0 days 00:02:49,-3,2,5
17,ULK,P001932,P010560,0 days 00:02:49,-3,2,5
17,ULK,P002968,P011157,0 days 00:02:37,-2,5,7
17,ULK,P009849,P011157,0 days 00:02:32,1,6,5
17,ULK,P002968,P005844,0 days 00:02:30,-3,4,7
17,ULK,P005844,P011980,0 days 00:02:29,-2,2,4
17,ULK,P010560,P011157,0 days 00:01:44,1,3,2
17,ULK,P001932,P004004,0 days 00:01:16,-3,0,3
17,ULK,P001932,P011980,0 days 00:01:16,-3,0,3
17,ULK,P001932,P011157,0 days 00:00:34,0,0,0
17,ULK,P001932,P006661,0 days 00:00:32,-1,0,1
17,ULK,P011157,P011980,0 days 00:00:32,-1,1,2
17,ULK,P002969,P004004,0 days 00:00:04,-2,0,2
17,ULK,P002969,P006661,0 days 00:00:04,-2,0,2
17,ULK,P002969,P008962,0 days 00:00:04,-2,0,2
17,ULK,P002969,P011980,0 days 00:00:04,-2,0,2
18,ZAL,P002329,P003211,0 days 00:26:35,25,65,40
18,ZAL,P002329,P011218,0 days 00:23:24,6,48,42
18,ZAL,P002329,P007109,0 days 00:22:39,19,54,35
18,ZAL,P002329,P010390,0 days 00:22:21,-1,43,44
18,ZAL,P003211,P007109,0 days 00:20:41,21,49,28
18,ZAL,P003211,P010390,0 days 00:19:18,8,42,34
18,ZAL,P007109,P011218,0 days 00:18:57,11,43,32
18,ZAL,P003211,P011218,0 days 00:18:36,13,42,29
18,ZAL,P010390,P011218,0 days 00:17:05,5,33,28
18,ZAL,P002329,P002676,0 days 00:13:55,1,31,30
18,ZAL,P007109,P010390,0 days 00:13:40,9,31,22
18,ZAL,P002329,P012715,0 days 00:12:33,6,30,24
18,ZAL,P002676,P012715,0 days 00:11:22,-4,18,22
18,ZAL,P003211,P012715,0 days 00:10:00,9,22,13
18,ZAL,P002676,P005504,0 days 00:09:33,-7,13,20
18,ZAL,P002676,P003211,0 days 00:09:05,11,22,11
18,ZAL,P002676,P011218,0 days 00:08:42,-8,16,24
18,ZAL,P002676,P007109,0 days 00:08:07,5,20,15
18,ZAL,P002676,P011965,0 days 00:07:50,-13,8,21
18,ZAL,P011218,P012715,0 days 00:07:11,1,17,16
18,ZAL,P007109,P011965,0 days 00:06:30,-2,11,13
18,ZAL,P005504,P011965,0 days 00:06:27,-6,7,13
18,ZAL,P007109,P012715,0 days 00:06:20,14,21,7
18,ZAL,P002676,P010390,0 days 00:06:12,-9,10,19
18,ZAL,P003211,P011965,0 days 00:06:08,-3,6,9
18,ZAL,P002329,P005504,0 days 00:05:59,1,10,9
18,ZAL,P005504,P007109,0 days 00:05:38,-5,7,12
18,ZAL,P010390,P012715,0 days 00:05:32,-7,6,13
18,ZAL,P002329,P011965,0 days 00:05:23,-6,9,15
18,ZAL,P003211,P005504,0 days 00:05:02,3,7,4
18,ZAL,P005504,P011218,0 days 00:04:30,-5,7,12
18,ZAL,P011965,P012715,0 days 00:04:24,-9,2,11
18,ZAL,P005504,P012715,0 days 00:04:18,-7,3,10
18,ZAL,P010390,P011965,0 days 00:04:12,-7,7,14
18,ZAL,P002329,P003210,0 days 00:03:01,3,6,3
18,ZAL,P002676,P003210,0 days 00:03:01,3,6,3
18,ZAL,P011218,P011965,0 days 00:02:47,-3,6,9
18,ZAL,P003210,P005504,0 days 00:02:14,3,6,3
18,ZAL,P002676,P007513,0 days 00:01:45,-7,0,7
18,ZAL,P007513,P011965,0 days 00:01:43,-7,0,7
18,ZAL,P003210,P012715,0 days 00:01:40,-2,1,3
18,ZAL,P007513,P012715,0 days 00:01:28,-5,0,5
18,ZAL,P005504,P007513,0 days 00:01:27,-5,0,5
18,ZAL,P003210,P003211,0 days 00:01:21,5,5,0
18,ZAL,P003210,P010390,0 days 00:00:47,0,0,0
18,ZAL,P002329,P007513,0 days 00:00:18,-2,0,2
18,ZAL,P007513,P010390,0 days 00:00:17,-2,0,2
18,ZAL,P003211,P007513,0 days 00:00:02,0,0,0
18,RED,P006436,P007960,0 days 00:24:38,-5,50,55
18,RED,P000848,PJDR,0 days 00:23:04,3,49,46
18,RED,P006436,PJDR,0 days 00:17:29,-9,35,44
18,RED,P002553,P006436,0 days 00:16:28,-6,28,34
18,RED,P000848,P006436,0 days 00:15:21,-6,33,39
18,RED,P002553,PJDR,0 days 00:15:00,11,32,21
18,RED,P002553,P005099,0 days 00:14:51,8,25,17
18,RED,P006436,P011224,0 days 00:14:33,-8,20,28
18,RED,P007960,PJDR,0 days 00:14:20,-2,34,36
18,RED,P000848,P007960,0 days 00:13:52,5,36,31
18,RED,P000848,P002553,0 days 00:13:36,9,30,21
18,RED,P005099,P006436,0 days 00:12:23,0,20,20
18,RED,P007960,P011224,0 days 00:12:19,-4,20,24
18,RED,P002553,P007960,0 days 00:11:09,-3,22,25
18,RED,P005099,P011224,0 days 00:10:44,-1,17,18
18,RED,P006436,P009035,0 days 00:10:41,-6,18,24
18,RED,P005099,P007960,0 days 00:10:29,0,21,21
18,RED,P005099,PJDR,0 days 00:09:55,13,22,9
18,RED,P009035,PJDR,0 days 00:09:44,-4,20,24
18,RED,P011964,PJDR,0 days 00:09:40,-5,13,18
18,RED,P007960,P009035,0 days 00:09:13,-2,19,21
18,RED,P000848,P011964,0 days 00:09:12,-2,13,15
18,RED,P002553,P011964,0 days 00:09:02,4,13,9
18,RED,P000848,P005099,0 days 00:08:00,12,19,7
18,RED,P002553,P011224,0 days 00:07:42,-5,10,15
18,RED,P005099,P011964,0 days 00:07:37,7,11,4
18,RED,P000848,P009035,0 days 00:07:22,-3,16,19
18,RED,P006436,P008966,0 days 00:06:50,-2,14,16
18,RED,P006436,P011964,0 days 00:06:32,-18,2,20
18,RED,P007960,P008966,0 days 00:06:14,0,14,14
18,RED,P005099,P009035,0 days 00:06:10,2,12,10
18,RED,P008966,P011224,0 days 00:04:28,-1,9,10
18,RED,P007960,P012711,0 days 00:03:09,-4,4,8
18,RED,P008966,P012711,0 days 00:03:09,-4,4,8
18,RED,P011224,P012711,0 days 00:03:09,-4,4,8
18,RED,P006436,P012711,0 days 00:03:09,-4,4,8
18,RED,P009035,P011224,0 days 00:02:57,-2,3,5
18,RED,P009035,P011964,0 days 00:02:37,-11,0,11
18,RED,P011224,P011964,0 days 00:02:35,-4,0,4
18,RED,P008966,PJDR,0 days 00:02:22,-1,5,6
18,RED,P000848,P008966,0 days 00:02:22,-1,5,6
18,RED,P002553,P009035,0 days 00:02:00,2,4,2
18,RED,P005099,P008966,0 days 00:01:19,3,5,2
18,RED,P007960,P011964,0 days 00:01:09,-5,0,5
18,RED,P008966,P011964,0 days 00:00:36,-2,0,2
18,RED,P000848,P011224,0 days 00:00:31,3,3,0
18,RED,P011224,PJDR,0 days 00:00:18,2,2,0
19,IST,P004888,P009664,0 days 00:25:30,8,56,48
19,IST,P004888,P007200,0 days 00:24:39,20,61,41
19,IST,P007200,P009664,0 days 00:24:14,10,53,43
19,IST,P006590,P007200,0 days 00:23:05,18,57,39
19,IST,P004554,P004888,0 days 00:21:32,10,53,43
19,IST,P004888,P006590,0 days 00:20:50,11,55,44
19,IST,P006590,P009664,0 days 00:20:27,6,45,39
19,IST,P004554,P007200,0 days 00:19:52,16,50,34
19,IST,P004554,P009664,0 days 00:18:14,4,40,36
19,IST,P004554,P006590,0 days 00:14:47,8,35,27
19,IST,P009664,P011078,0 days 00:14:47,1,30,29
19,IST,P004554,P011078,0 days 00:13:39,-3,26,29
19,IST,P004888,P011078,0 days 00:12:09,4,31,27
19,IST,P007200,P011078,0 days 00:11:34,3,26,23
19,IST,P006590,P011981,0 days 00:10:07,2,30,28
19,IST,P009664,P011981,0 days 00:09:23,3,21,18
19,IST,P007200,P011981,0 days 00:08:29,3,21,18
19,IST,P006590,P011078,0 days 00:07:36,0,16,16
19,IST,P006372,P009664,0 days 00:06:23,-4,9,13
19,IST,P006372,P006590,0 days 00:06:22,-9,14,23
19,IST,P004888,P011981,0 days 00:06:18,4,18,14
19,IST,P006372,P011981,0 days 00:05:53,-11,14,25
19,IST,P007200,P012710,0 days 00:05:43,5,14,9
19,IST,P006590,P012710,0 days 00:05:43,5,14,9
19,IST,P004554,P012710,0 days 00:05:43,5,14,9
19,IST,P004888,P012710,0 days 00:05:43,5,14,9
19,IST,P006372,P007200,0 days 00:05:25,-4,12,16
19,IST,P009664,PLHK,0 days 00:03:58,-3,4,7
19,IST,P006590,PLHK,0 days 00:03:58,-3,4,7
19,IST,P004888,PLHK,0 days 00:03:58,-3,4,7
19,IST,P007200,PLHK,0 days 00:03:58,-3,4,7
19,IST,P006372,P011078,0 days 00:03:42,-2,5,7
19,IST,P004888,P006372,0 days 00:03:17,-5,4,9
19,IST,P004554,P006372,0 days 00:02:57,0,2,2
19,IST,P011078,P011981,0 days 00:02:57,5,10,5
19,IST,P009513,P011981,0 days 00:02:12,-9,2,11
19,IST,P011981,P012415,0 days 00:02:05,-5,4,9
19,IST,P006590,P012415,0 days 00:01:55,-3,4,7
19,IST,P004888,P009513,0 days 00:01:54,-7,2,9
19,IST,P009513,P009664,0 days 00:01:52,-4,0,4
19,IST,P007200,P009513,0 days 00:01:34,-2,0,2
19,IST,P009664,P012415,0 days 00:01:32,-5,2,7
19,IST,P004888,P012415,0 days 00:01:22,-3,2,5
19,IST,P006372,P012415,0 days 00:00:43,-2,2,4
19,IST,P007200,P012415,0 days 00:00:43,-2,2,4
19,IST,P006372,P009513,0 days 00:00:38,-7,2,9
19,IST,P006590,P009513,0 days 00:00:38,-7,2,9
19,ASV,P004194,P011225,0 days 00:23:16,-5,49,54
19,ASV,P002100,P011225,0 days 00:19:51,14,57,43
19,ASV,P002100,P012729,0 days 00:19:12,17,56,39
19,ASV,P006568,P011225,0 days 00:16:16,-10,29,39
19,ASV,P012729,P012731,0 days 00:15:32,9,42,33
19,ASV,P012729,P012730,0 days 00:15:29,-2,29,31
19,ASV,P004194,P006568,0 days 00:15:15,-13,23,36
19,ASV,P011225,P012729,0 days 00:15:14,12,48,36
19,ASV,P011225,P012080,0 days 00:15:12,-14,23,37
19,ASV,P011225,P012732,0 days 00:15:06,-9,27,36
19,ASV,P002100,P004194,0 days 00:13:18,10,37,27
19,ASV,P002100,P012730,0 days 00:12:16,6,27,21
19,ASV,P002100,P012731,0 days 00:12:13,15,39,24
19,ASV,P006568,P012080,0 days 00:11:36,-6,21,27
19,ASV,P004194,P012080,0 days 00:11:29,-11,15,26
19,ASV,P004194,P012732,0 days 00:10:44,-10,16,26
19,ASV,P012730,P012732,0 days 00:09:27,-8,15,23
19,ASV,P012729,P012732,0 days 00:09:15,-3,16,19
19,ASV,P011225,P012730,0 days 00:08:44,-5,18,23
19,ASV,P011386,P012729,0 days 00:08:37,-2,13,15
19,ASV,P002100,P012732,0 days 00:08:32,2,17,15
19,ASV,P011225,P012731,0 days 00:08:29,13,31,18
19,ASV,P006568,P012732,0 days 00:08:24,-9,13,22
19,ASV,P002100,P006568,0 days 00:08:24,5,20,15
19,ASV,P011386,P012730,0 days 00:08:23,-1,13,14
19,ASV,P012730,P012731,0 days 00:08:11,0,16,16
19,ASV,P004194,P012729,0 days 00:07:21,9,26,17
19,ASV,P004194,P012731,0 days 00:07:21,9,26,17
19,ASV,P011386,P012731,0 days 00:07:03,-4,11,15
19,ASV,P002100,P011386,0 days 00:06:44,5,13,8
19,ASV,P012080,P012732,0 days 00:05:58,-8,7,15
19,ASV,P002100,P012080,0 days 00:05:50,2,14,12
19,ASV,P012080,P012729,0 days 00:03:43,-3,8,11
19,ASV,P012080,P012730,0 days 00:03:36,-8,2,10
19,ASV,P011386,P012732,0 days 00:03:27,-5,2,7
19,ASV,P000229,P006568,0 days 00:03:24,-8,2,10
19,ASV,P000229,P011225,0 days 00:03:24,-8,2,10
19,ASV,P000229,P012080,0 days 00:03:24,-8,2,10
19,ASV,P000229,P004194,0 days 00:03:24,-8,2,10
19,ASV,P012731,P012732,0 days 00:03:19,-6,3,9
19,ASV,P004194,P012730,0 days 00:01:38,-4,2,6
19,ASV,P006568,P012729,0 days 00:01:01,3,6,3
19,ASV,P006568,P012730,0 days 00:00:44,-2,2,4
19,ASV,P004194,P011386,0 days 00:00:14,-1,0,1
20,MIL,P006433,P007831,0 days 00:29:53,11,55,44
20,MIL,P000796,P007831,0 days 00:29:24,12,56,44
20,MIL,P000796,P006433,0 days 00:28:17,13,55,42
20,MIL,P000796,P007201,0 days 00:25:40,15,47,32
20,MIL,P007201,P007831,0 days 00:25:40,15,47,32
20,MIL,P006433,P007201,0 days 00:24:33,16,46,30
20,MIL,P002849,P007831,0 days 00:21:30,13,44,31
20,MIL,P002849,P006433,0 days 00:21:18,13,44,31
20,MIL,P000796,P002849,0 days 00:21:09,13,44,31
20,MIL,P002849,P007201,0 days 00:20:38,8,35,27
20,MIL,P002849,P006509,0 days 00:10:06,1,14,13
20,MIL,P002849,P005670,0 days 00:09:22,6,13,7
20,MIL,P002849,P011205,0 days 00:09:09,2,9,7
20,MIL,P005670,P006509,0 days 00:08:48,2,9,7
20,MIL,P006509,P011205,0 days 00:08:34,2,9,7
20,MIL,P005670,P011205,0 days 00:08:22,2,9,7
20,MIL,P007831,P009960,0 days 00:07:16,-5,10,15
20,MIL,P000796,P009960,0 days 00:06:41,-3,10,13
20,MIL,P006433,P009960,0 days 00:06:09,-4,9,13
20,MIL,P002812,P011205,0 days 00:05:33,3,5,2
20,MIL,P007201,P009960,0 days 00:05:15,3,10,7
20,MIL,P002812,P006509,0 days 00:04:32,5,5,0
20,MIL,P002812,P002849,0 days 00:04:32,5,5,0
20,MIL,P002812,P005670,0 days 00:04:20,5,5,0
20,MIL,P007831,P011205,0 days 00:03:52,-8,0,8
20,MIL,P006433,P011205,0 days 00:03:40,-8,0,8
20,MIL,P009960,P011205,0 days 00:03:08,-11,0,11
20,MIL,P011205,P011926,0 days 00:02:59,2,4,2
20,MIL,P005670,P007201,0 days 00:02:42,-3,1,4
20,MIL,P005670,P009960,0 days 00:02:40,-4,1,5
20,MIL,P002812,P007831,0 days 00:02:35,0,2,2
20,MIL,P002812,P006433,0 days 00:02:23,0,2,2
20,MIL,P000796,P005670,0 days 00:02:07,3,5,2
20,MIL,P000796,P011205,0 days 00:02:04,-6,0,6
20,MIL,P002849,P011926,0 days 00:01:55,2,4,2
20,MIL,P005670,P007831,0 days 00:01:41,3,5,2
20,MIL,P007831,P011926,0 days 00:01:39,0,0,0
20,MIL,P006433,P011926,0 days 00:01:39,0,0,0
20,MIL,P007201,P011205,0 days 00:01:35,-2,0,2
20,MIL,P006509,P007201,0 days 00:01:35,-2,0,2
20,MIL,P006509,P009960,0 days 00:01:33,-3,0,3
20,MIL,P002849,P009960,0 days 00:01:33,-3,0,3
20,MIL,P000796,P006509,0 days 00:01:32,-1,5,6
20,MIL,P002812,P007201,0 days 00:01:22,2,2,0
20,MIL,P000796,P002812,0 days 00:01:22,2,2,0
20,MIL,P006509,P011926,0 days 00:01:20,2,4,2
20,MIL,P005670,P011926,0 days 00:01:20,2,4,2
20,MIL,P006509,P007831,0 days 00:01:18,-1,5,6
20,MIL,P006433,P006509,0 days 00:01:06,-1,5,6
20,MIL,P000796,P011926,0 days 00:01:04,0,0,0
20,MIL,P002812,P009960,0 days 00:01:01,-2,0,2
20,MIL,P005670,P006433,0 days 00:00:34,4,4,0
20,OLY,P001255,P003941,0 days 00:26:52,-8,41,49
20,OLY,P001255,P008855,0 days 00:25:25,-7,38,45
20,OLY,P003941,P008855,0 days 00:25:20,-7,38,45
20,OLY,P008829,P008855,0 days 00:18:41,3,32,29
20,OLY,P001255,P008829,0 days 00:18:25,-12,28,40
20,OLY,P003941,P008829,0 days 00:17:36,-3,28,31
20,OLY,P001255,P011983,0 days 00:17:09,-3,19,22
20,OLY,P003941,P011983,0 days 00:13:20,-7,15,22
20,OLY,P008855,P011983,0 days 00:13:12,-6,14,20
20,OLY,P001255,P006302,0 days 00:13:03,-10,15,25
20,OLY,P006302,P010392,0 days 00:10:48,-10,8,18
20,OLY,P008811,P010392,0 days 00:10:01,-4,12,16
20,OLY,P008829,P010392,0 days 00:09:16,-1,13,14
20,OLY,P006302,P008811,0 days 00:08:52,-10,6,16
20,OLY,P003941,P006302,0 days 00:08:30,-5,11,16
20,OLY,P006589,P011983,0 days 00:08:25,-4,5,9
20,OLY,P006302,P008855,0 days 00:08:17,-6,10,16
20,OLY,P001255,P010392,0 days 00:08:11,-3,11,14
20,OLY,P008829,P011983,0 days 00:08:00,-6,10,16
20,OLY,P008855,P010392,0 days 00:07:49,6,13,7
20,OLY,P008829,P010612,0 days 00:07:30,7,17,10
20,OLY,P008855,P010612,0 days 00:07:30,7,17,10
20,OLY,P001255,P006589,0 days 00:07:10,-1,5,6
20,OLY,P006589,P008855,0 days 00:07:01,-2,6,8
20,OLY,P003941,P010612,0 days 00:06:21,1,11,10
20,OLY,P001255,P008811,0 days 00:06:09,-5,4,9
20,OLY,P008811,P008855,0 days 00:05:35,4,8,4
20,OLY,P003941,P006589,0 days 00:05:34,-1,5,6
20,OLY,P006302,P011983,0 days 00:05:26,0,5,5
20,OLY,P008811,P011983,0 days 00:05:18,1,4,3
20,OLY,P003941,P010392,0 days 00:05:09,2,7,5
20,OLY,P006302,P008829,0 days 00:04:54,-9,2,11
20,OLY,P001255,P010612,0 days 00:04:50,1,11,10
20,OLY,P006302,P012023,0 days 00:04:50,-4,8,12
20,OLY,P003941,P012023,0 days 00:04:50,-4,8,12
20,OLY,P001255,P012023,0 days 00:04:50,-4,8,12
20,OLY,P008855,P012023,0 days 00:04:50,-4,8,12
20,OLY,P006302,P006589,0 days 00:04:48,-6,3,9
20,OLY,P008811,P008829,0 days 00:04:44,-3,6,9
20,OLY,P006589,P008811,0 days 00:04:40,-5,2,7
20,OLY,P010392,P011983,0 days 00:03:42,1,4,3
20,OLY,P006589,P010392,0 days 00:03:04,-5,2,7
20,OLY,P010392,P010612,0 days 00:02:40,6,6,0
20,OLY,P008811,P010612,0 days 00:01:09,6,6,0
20,OLY,P006589,P008829,0 days 00:00:14,0,0,0
21,ULK,P001932,P008962,0 days 00:24:45,26,61,35
21,ULK,P008962,P010560,0 days 00:22:29,23,54,31
21,ULK,P001932,P010560,0 days 00:21:37,26,52,26
21,ULK,P004004,P010560,0 days 00:19:35,17,46,29
21,ULK,P008962,P011157,0 days 00:18:55,23,51,28
21,ULK,P001932,P011157,0 days 00:18:01,23,49,26
21,ULK,P004004,P008962,0 days 00:16:21,12,41,29
21,ULK,P010560,P011157,0 days 00:16:10,23,43,20
21,ULK,P001932,P006661,0 days 00:15:28,5,32,27
21,ULK,P005844,P006661,0 days 00:15:19,-9,23,32
21,ULK,P004004,P011157,0 days 00:14:43,17,39,22
21,ULK,P001932,P004004,0 days 00:13:49,17,37,20
21,ULK,P005844,P010560,0 days 00:12:34,4,21,17
21,ULK,P005844,P006961,0 days 00:12:33,-7,18,25
21,ULK,P006661,P008962,0 days 00:12:26,7,26,19
21,ULK,P001932,P005844,0 days 00:11:16,-1,20,21
21,ULK,P005844,P011052,0 days 00:11:16,-8,15,23
21,ULK,P004004,P011052,0 days 00:09:22,-9,11,20
21,ULK,P006661,P010560,0 days 00:09:09,10,18,8
21,ULK,P004004,P005844,0 days 00:08:28,-9,9,18
21,ULK,P005844,P008962,0 days 00:08:22,-2,14,16
21,ULK,P006661,P011052,0 days 00:08:15,-8,14,22
21,ULK,P006961,P011052,0 days 00:08:11,-3,10,13
21,ULK,P006661,P006961,0 days 00:07:49,-10,11,21
21,ULK,P010560,P011052,0 days 00:07:07,1,12,11
21,ULK,P004004,P006961,0 days 00:06:50,-4,7,11
21,ULK,P006961,P010560,0 days 00:06:05,4,10,6
21,ULK,P008962,P011052,0 days 00:05:50,-5,13,18
21,ULK,P006661,P011157,0 days 00:05:06,6,14,8
21,ULK,P001932,P011980,0 days 00:04:32,-4,8,12
21,ULK,P005844,P011980,0 days 00:04:32,-4,8,12
21,ULK,P006661,P011980,0 days 00:04:32,-4,8,12
21,ULK,P001932,P006961,0 days 00:04:22,-4,8,12
21,ULK,P006961,P011980,0 days 00:04:22,-4,8,12
21,ULK,P004004,P006661,0 days 00:03:36,-9,2,11
21,ULK,P001932,P011052,0 days 00:03:18,0,9,9
21,ULK,P011052,P011157,0 days 00:02:45,0,8,8
21,ULK,P010560,P011980,0 days 00:00:10,0,0,0
21,PAN,P003842,P011204,0 days 00:20:40,6,43,37
21,PAN,P003842,P007947,0 days 00:18:48,-7,34,41
21,PAN,P001926,P002328,0 days 00:18:46,-23,25,48
21,PAN,P002328,P003842,0 days 00:16:58,-18,27,45
21,PAN,P003842,P008084,0 days 00:16:37,4,36,32
21,PAN,P008084,P011204,0 days 00:16:08,4,34,30
21,PAN,P001926,P003842,0 days 00:14:20,-19,19,38
21,PAN,P001926,P012712,0 days 00:14:07,-18,15,33
21,PAN,P007947,P008084,0 days 00:12:40,7,28,21
21,PAN,P007947,P011204,0 days 00:12:34,9,29,20
21,PAN,P002328,P011204,0 days 00:12:28,-5,23,28
21,PAN,P002328,P012712,0 days 00:12:02,-16,15,31
21,PAN,P011204,P011826,0 days 00:11:04,12,27,15
21,PAN,P011826,P012712,0 days 00:10:25,-2,18,20
21,PAN,P003842,P012712,0 days 00:10:17,-14,12,26
21,PAN,P002328,P008084,0 days 00:10:02,-7,19,26
21,PAN,P011204,P012712,0 days 00:09:58,4,21,17
21,PAN,P001926,P011204,0 days 00:09:10,-5,14,19
21,PAN,P002328,P007947,0 days 00:08:52,-15,13,28
21,PAN,P011209,P012712,0 days 00:08:40,0,15,15
21,PAN,P008084,P011826,0 days 00:08:19,8,18,10
21,PAN,P001926,P008084,0 days 00:08:11,-7,13,20
21,PAN,P011209,P011826,0 days 00:08:00,1,14,13
21,PAN,P001926,P011221,0 days 00:07:58,-6,9,15
21,PAN,P011221,P011826,0 days 00:07:52,0,13,13
21,PAN,P007947,P011826,0 days 00:07:28,6,15,9
21,PAN,P011204,P011209,0 days 00:06:56,5,17,12
21,PAN,P007947,P012712,0 days 00:06:54,-16,6,22
21,PAN,P001926,P011826,0 days 00:06:54,-4,9,13
21,PAN,P003842,P011826,0 days 00:06:42,8,15,7
21,PAN,P011221,P012712,0 days 00:06:15,0,10,10
21,PAN,P001926,P007947,0 days 00:06:14,-16,5,21
21,PAN,P002328,P011221,0 days 00:05:06,-5,7,12
21,PAN,P007553,P012712,0 days 00:04:10,-2,8,10
21,PAN,P007553,P011826,0 days 00:04:10,-2,8,10
21,PAN,P007553,P011209,0 days 00:04:10,-2,8,10
21,PAN,P002328,P011826,0 days 00:04:02,-3,7,10
21,PAN,P007947,P011209,0 days 00:04:00,-2,6,8
21,PAN,P011209,P011221,0 days 00:03:50,3,6,3
21,PAN,P001926,P011209,0 days 00:03:32,-2,3,5
21,PAN,P007553,P011204,0 days 00:03:24,0,8,8
21,PAN,P003842,P011209,0 days 00:03:14,0,6,6
21,PAN,P008084,P011221,0 days 00:02:41,-2,3,5
21,PAN,P008084,P011209,0 days 00:02:34,1,5,4
21,PAN,P011204,P011221,0 days 00:02:02,2,4,2
21,PAN,P007553,P007947,0 days 00:00:46,-2,0,2
22,PAR,P007400,P009862,0 days 00:24:09,-13,54,67
22,PAR,P008987,P009862,0 days 00:21:02,-13,43,56
22,PAR,P009862,P012742,0 days 00:19:33,-16,44,60
22,PAR,P007400,P008987,0 days 00:19:25,-8,42,50
22,PAR,P007400,P012742,0 days 00:19:13,-11,46,57
22,PAR,P003983,P008987,0 days 00:17:38,-3,28,31
22,PAR,P008987,P012742,0 days 00:16:24,-11,32,43
22,PAR,P009862,P011051,0 days 00:15:41,-12,31,43
22,PAR,P007400,P011051,0 days 00:13:24,-7,30,37
22,PAR,P003983,P012743,0 days 00:12:14,7,22,15
22,PAR,P003983,P011051,0 days 00:11:22,0,24,24
22,PAR,P008987,P011051,0 days 00:11:20,-12,19,31
22,PAR,P008987,P012743,0 days 00:10:50,-3,17,20
22,PAR,P003983,P007673,0 days 00:10:38,5,20,15
22,PAR,P007673,P012743,0 days 00:10:16,7,20,13
22,PAR,P011050,P012742,0 days 00:09:45,1,24,23
22,PAR,P009862,P011050,0 days 00:09:39,1,24,23
22,PAR,P007400,P011050,0 days 00:09:39,1,24,23
22,PAR,P000956,P003983,0 days 00:09:07,5,18,13
22,PAR,P008987,P011050,0 days 00:09:02,4,22,18
22,PAR,P011051,P012742,0 days 00:08:48,-10,18,28
22,PAR,P007673,P011051,0 days 00:08:12,9,25,16
22,PAR,P003983,P009862,0 days 00:08:02,-5,13,18
22,PAR,P007673,P008987,0 days 00:07:56,2,13,11
22,PAR,P000956,P012743,0 days 00:07:30,7,15,8
22,PAR,P003983,P007400,0 days 00:06:33,2,14,12
22,PAR,P000956,P007673,0 days 00:06:12,7,13,6
22,PAR,P000956,P008987,0 days 00:06:03,0,9,9
22,PAR,P007400,P007673,0 days 00:05:47,1,18,17
22,PAR,P007673,P009862,0 days 00:05:27,3,18,15
22,PAR,P007673,P012742,0 days 00:05:06,1,16,15
22,PAR,P000956,P011051,0 days 00:04:41,3,12,9
22,PAR,P004058,P007673,0 days 00:04:33,0,7,7
22,PAR,P004058,P012743,0 days 00:04:04,0,7,7
22,PAR,P004058,P008987,0 days 00:04:04,0,7,7
22,PAR,P003983,P004058,0 days 00:03:58,-2,5,7
22,PAR,P012742,P012743,0 days 00:03:38,-5,6,11
22,PAR,P003983,P012742,0 days 00:03:14,-1,4,5
22,PAR,P011051,P012743,0 days 00:03:04,5,9,4
22,PAR,P007400,P012743,0 days 00:02:20,-5,4,9
22,PAR,P009862,P012743,0 days 00:01:40,-5,4,9
22,PAR,P000956,P009862,0 days 00:01:37,-2,3,5
22,PAR,P004058,P009862,0 days 00:01:18,-2,2,4
22,PAR,P000956,P012742,0 days 00:01:18,0,2,2
22,PAR,P004058,P007400,0 days 00:01:10,-4,0,4
22,PAR,P007673,P011050,0 days 00:01:09,-3,2,5
22,PAR,P004058,P011051,0 days 00:01:08,-4,0,4
22,PAR,P004058,P012742,0 days 00:00:41,-4,0,4
22,PAR,P011050,P011051,0 days 00:00:16,0,0,0
22,PAR,P003983,P011050,0 days 00:00:10,0,0,0
22,BAR,P002939,P006435,0 days 00:20:51,8,56,48
22,BAR,P004866,P006435,0 days 00:20:36,9,50,41
22,BAR,P006435,P011244,0 days 00:19:36,10,50,40
22,BAR,P004866,P011244,0 days 00:18:14,13,47,34
22,BAR,P002939,P004866,0 days 00:18:01,5,43,38
22,BAR,P002939,P011244,0 days 00:17:36,10,45,35
22,BAR,P003478,P012745,0 days 00:15:55,-1,33,34
22,BAR,P000925,P002939,0 days 00:15:37,6,35,29
22,BAR,P000925,P006435,0 days 00:15:06,10,38,28
22,BAR,P000925,P011244,0 days 00:14:36,12,35,23
22,BAR,P000925,P004866,0 days 00:13:58,9,33,24
22,BAR,P003196,P006435,0 days 00:12:51,1,35,34
22,BAR,P003478,P007519,0 days 00:12:10,-2,21,23
22,BAR,P007519,P012745,0 days 00:11:54,0,21,21
22,BAR,P003196,P012745,0 days 00:10:58,-5,20,25
22,BAR,P003196,P003478,0 days 00:10:11,-5,20,25
22,BAR,P002939,P003196,0 days 00:09:19,0,29,29
22,BAR,P000925,P003478,0 days 00:08:34,4,20,16
22,BAR,P006435,P012745,0 days 00:08:21,1,23,22
22,BAR,P003196,P007519,0 days 00:08:15,-4,10,14
22,BAR,P000925,P012745,0 days 00:07:42,1,18,17
22,BAR,P000925,P007519,0 days 00:07:38,8,22,14
22,BAR,P003196,P004866,0 days 00:07:23,1,19,18
22,BAR,P003478,P006435,0 days 00:07:21,2,23,21
22,BAR,P002939,P012745,0 days 00:07:20,-4,19,23
22,BAR,P002939,P003478,0 days 00:07:09,1,21,20
22,BAR,P006435,P007519,0 days 00:07:06,3,17,14
22,BAR,P003196,P011244,0 days 00:06:36,1,19,18
22,BAR,P003478,P009992,0 days 00:06:12,-5,6,11
22,BAR,P009992,P012745,0 days 00:05:07,-7,4,11
22,BAR,P003478,P007464,0 days 00:04:40,2,9,7
22,BAR,P007464,P007519,0 days 00:04:40,2,9,7
22,BAR,P007464,P012745,0 days 00:04:40,2,9,7
22,BAR,P003196,P009992,0 days 00:04:12,-5,4,9
22,BAR,P000925,P007464,0 days 00:04:09,2,9,7
22,BAR,P007519,P011244,0 days 00:04:07,4,11,7
22,BAR,P004866,P007519,0 days 00:03:51,6,11,5
22,BAR,P007519,P009992,0 days 00:03:18,-2,2,4
22,BAR,P004866,P012745,0 days 00:03:07,-3,5,8
22,BAR,P003478,P011244,0 days 00:02:58,0,7,7
22,BAR,P002939,P009992,0 days 00:02:54,-3,4,7
22,BAR,P000925,P009992,0 days 00:01:52,0,2,2
22,BAR,P009992,P011244,0 days 00:01:05,2,2,0
22,BAR,P002939,P007519,0 days 00:00:57,1,4,3
22,BAR,P003196,P007464,0 days 00:00:31,0,0,0
22,BAR,P003478,P004866,0 days 00:00:14,0,0,0
22,BAR,P003478,P010641,0 days 00:00:08,0,0,0
22,BAR,P007519,P010641,0 days 00:00:08,0,0,0
22,BAR,P009992,P010641,0 days 00:00:08,0,0,0
22,BAR,P010641,P012745,0 days 00:00:08,0,0,0
23,MAD,P005791,P005928,0 days 00:19:15,6,40,34
23,MAD,P004887,PTGB,0 days 00:18:25,9,46,37
23,MAD,PBMT,PTGB,0 days 00:17:21,19,52,33
23,MAD,P004887,PBMT,0 days 00:17:02,14,48,34
23,MAD,P004887,PCVM,0 days 00:16:42,9,41,32
23,MAD,PCVM,PTGB,0 days 00:16:42,9,41,32
23,MAD,P005791,P010357,0 days 00:16:15,3,33,30
23,MAD,P005928,P010357,0 days 00:16:15,3,33,30
23,MAD,P005928,P009005,0 days 00:15:42,-1,34,35
23,MAD,PBMT,PCVM,0 days 00:14:02,12,38,26
23,MAD,P005928,P006540,0 days 00:13:23,0,23,23
23,MAD,P005791,P006540,0 days 00:12:06,-2,18,20
23,MAD,P005791,P009005,0 days 00:11:39,0,22,22
23,MAD,P006540,P010357,0 days 00:11:10,-2,18,20
23,MAD,P004887,P009005,0 days 00:11:10,2,29,27
23,MAD,P001392,P005928,0 days 00:10:33,-6,17,23
23,MAD,P009005,P010357,0 days 00:10:07,-3,17,20
23,MAD,P010357,PBMT,0 days 00:09:46,7,27,20
23,MAD,P001392,P005791,0 days 00:09:30,-3,15,18
23,MAD,P010357,PTGB,0 days 00:09:11,4,22,18
23,MAD,P009005,PTGB,0 days 00:08:50,3,22,19
23,MAD,P009005,PBMT,0 days 00:08:23,8,24,16
23,MAD,P004887,P010357,0 days 00:07:35,-3,13,16
23,MAD,P010357,PCVM,0 days 00:07:35,-3,13,16
23,MAD,P005928,PBMT,0 days 00:07:35,12,26,14
23,MAD,P001392,P010357,0 days 00:07:26,-6,8,14
23,MAD,P006540,P009005,0 days 00:07:23,1,14,13
23,MAD,P009005,PCVM,0 days 00:07:07,3,17,14
23,MAD,P001392,P009005,0 days 00:06:36,-2,15,17
23,MAD,P003108,P004887,0 days 00:05:43,3,16,13
23,MAD,P003108,PCVM,0 days 00:04:40,6,14,8
23,MAD,P003108,PTGB,0 days 00:04:40,6,14,8
23,MAD,P005791,PBMT,0 days 00:04:35,10,16,6
23,MAD,P003108,P009005,0 days 00:04:19,-3,10,13
23,MAD,P006540,PBMT,0 days 00:04:16,5,12,7
23,MAD,P004887,P005928,0 days 00:04:03,-1,12,13
23,MAD,P001392,P006540,0 days 00:03:57,-4,2,6
23,MAD,P003108,PBMT,0 days 00:03:28,9,13,4
23,MAD,P005928,PTGB,0 days 00:03:19,7,14,7
23,MAD,P003108,P005928,0 days 00:03:07,0,9,9
23,MAD,P001392,P003108,0 days 00:03:07,0,9,9
23,MAD,P003108,P005791,0 days 00:02:04,3,7,4
23,MAD,P005791,PTGB,0 days 00:01:36,7,9,2
23,MAD,P004887,P006540,0 days 00:01:17,2,5,3
23,MAD,P001392,P004887,0 days 00:01:03,-3,2,5
23,ZAL,P002329,P007109,0 days 00:21:11,-9,40,49
23,ZAL,P007109,P011218,0 days 00:19:43,0,39,39
23,ZAL,P002329,P011218,0 days 00:19:18,-6,36,42
23,ZAL,P007109,P007513,0 days 00:16:33,1,31,30
23,ZAL,P002329,P010390,0 days 00:16:16,-4,30,34
23,ZAL,P003210,P011965,0 days 00:15:37,3,38,35
23,ZAL,P011965,P012715,0 days 00:15:36,-11,37,48
23,ZAL,P010390,P011218,0 days 00:15:10,-12,22,34
23,ZAL,P002329,P007513,0 days 00:14:43,-1,27,28
23,ZAL,P007513,P011218,0 days 00:13:50,3,27,24
23,ZAL,P003210,P012715,0 days 00:12:45,-3,32,35
23,ZAL,P007109,P010390,0 days 00:12:35,-2,20,22
23,ZAL,P002329,P012715,0 days 00:12:05,-15,24,39
23,ZAL,P007513,P010390,0 days 00:10:16,5,20,15
23,ZAL,P003211,P011218,0 days 00:08:59,-11,14,25
23,ZAL,P002329,P003210,0 days 00:08:55,-8,21,29
23,ZAL,P005504,P011965,0 days 00:08:33,-1,16,17
23,ZAL,P002329,P011965,0 days 00:08:29,-9,21,30
23,ZAL,P003210,P007513,0 days 00:07:40,0,14,14
23,ZAL,P003210,P005504,0 days 00:07:35,2,16,14
23,ZAL,P002329,P005504,0 days 00:06:54,0,20,20
23,ZAL,P007513,P011965,0 days 00:06:43,4,14,10
23,ZAL,P011218,P012715,0 days 00:06:22,-14,8,22
23,ZAL,P010390,P012715,0 days 00:06:08,-9,12,21
23,ZAL,P005504,P007109,0 days 00:06:00,5,17,12
23,ZAL,P005504,P007513,0 days 00:05:58,-1,10,11
23,ZAL,P010390,P011965,0 days 00:05:46,-6,12,18
23,ZAL,P007109,P012715,0 days 00:05:41,-7,10,17
23,ZAL,P007513,P012715,0 days 00:05:26,-1,11,12
23,ZAL,P003211,P007109,0 days 00:05:26,2,12,10
23,ZAL,P003211,P012715,0 days 00:05:22,-7,8,15
23,ZAL,P007109,P011965,0 days 00:05:22,-2,11,13
23,ZAL,P005504,P011218,0 days 00:05:17,0,13,13
23,ZAL,P003211,P010390,0 days 00:05:13,-17,2,19
23,ZAL,P002329,P003211,0 days 00:05:01,-4,9,13
23,ZAL,P003211,P011965,0 days 00:05:00,-4,8,12
23,ZAL,P006860,P011965,0 days 00:04:57,2,10,8
23,ZAL,P003210,P006860,0 days 00:04:57,2,10,8
23,ZAL,P006860,P007513,0 days 00:04:57,2,10,8
23,ZAL,P005504,P012715,0 days 00:04:39,-3,10,13
23,ZAL,P003210,P007109,0 days 00:04:33,-4,8,12
23,ZAL,P011218,P011965,0 days 00:04:25,-12,5,17
23,ZAL,P003211,P005504,0 days 00:04:19,6,12,6
23,ZAL,P003210,P010390,0 days 00:03:28,1,10,9
23,ZAL,P006860,P012715,0 days 00:02:44,2,8,6
23,ZAL,P005504,P006860,0 days 00:02:13,0,2,2
23,ZAL,P003210,P003211,0 days 00:01:06,3,3,0
23,ZAL,P003211,P007513,0 days 00:00:14,0,0,0
24,BAS,P004603,P010444,0 days 00:21:27,-7,42,49
24,BAS,P007230,P009048,0 days 00:19:12,-11,32,43
24,BAS,P004603,P007230,0 days 00:18:41,-6,35,41
24,BAS,P004603,P009048,0 days 00:18:06,-8,33,41
24,BAS,P007230,P010444,0 days 00:17:49,-6,35,41
24,BAS,P008072,P012201,0 days 00:17:33,1,26,25
24,BAS,P009048,P010444,0 days 00:17:22,-10,33,43
24,BAS,P007230,P011948,0 days 00:15:30,-6,25,31
24,BAS,P004761,P007230,0 days 00:13:29,-3,21,24
24,BAS,P010444,P011948,0 days 00:13:26,-4,28,32
24,BAS,P004603,P011948,0 days 00:13:26,-4,28,32
24,BAS,P011064,P012201,0 days 00:13:24,0,20,20
24,BAS,P008072,P011064,0 days 00:13:24,0,20,20
24,BAS,P004761,P009048,0 days 00:12:53,-10,17,27
24,BAS,P004603,P004761,0 days 00:12:31,-4,21,25
24,BAS,P004761,P010444,0 days 00:11:47,-6,21,27
24,BAS,P004761,P012201,0 days 00:11:39,-1,19,20
24,BAS,P007230,P012201,0 days 00:11:10,-3,11,14
24,BAS,P009048,P011948,0 days 00:11:02,1,25,24
24,BAS,P004761,P008072,0 days 00:10:39,1,19,18
24,BAS,P004761,P011064,0 days 00:10:25,5,23,18
24,BAS,P007230,P008072,0 days 00:10:18,-3,11,14
24,BAS,P007230,P011064,0 days 00:09:47,2,14,12
24,BAS,P011064,P011948,0 days 00:09:18,-5,10,15
24,BAS,P008072,P011085,0 days 00:07:15,4,15,11
24,BAS,P011085,P012201,0 days 00:07:15,4,15,11
24,BAS,P011948,P012201,0 days 00:06:54,0,7,7
24,BAS,P008072,P011948,0 days 00:06:54,0,7,7
24,BAS,P004761,P011085,0 days 00:06:03,1,12,11
24,BAS,P011064,P011085,0 days 00:05:44,0,11,11
24,BAS,P009048,P012201,0 days 00:05:09,-1,6,7
24,BAS,P004603,P011064,0 days 00:04:13,1,9,8
24,BAS,P010444,P011064,0 days 00:04:13,1,9,8
24,BAS,P008072,P009048,0 days 00:04:09,1,6,5
24,BAS,P004761,P011948,0 days 00:03:38,-1,7,8
24,BAS,P009048,P011085,0 days 00:01:31,4,4,0
24,BAS,P011085,P011948,0 days 00:01:12,3,3,0
24,BAS,P004603,P012201,0 days 00:00:52,0,0,0
24,BAS,P004761,P008850,0 days 00:00:08,-2,0,2
24,BAS,P008850,P009048,0 days 00:00:08,-2,0,2
24,BAS,P008850,P010444,0 days 00:00:08,-2,0,2
24,BAS,P008850,P012201,0 days 00:00:08,-2,0,2
24,BAS,P010444,P012201,0 days 00:00:08,-2,0,2
24,MUN,P007975,P010391,0 days 00:20:46,7,38,31
24,MUN,P004508,P010391,0 days 00:20:29,13,38,25
24,MUN,P001557,P010391,0 days 00:19:11,14,35,21
24,MUN,P007056,P011987,0 days 00:17:44,-3,37,40
24,MUN,P001557,P004508,0 days 00:16:42,15,32,17
24,MUN,P007056,P008985,0 days 00:16:30,0,30,30
24,MUN,P007056,P010391,0 days 00:15:13,8,30,22
24,MUN,P004508,P007975,0 days 00:14:58,8,26,18
24,MUN,P001557,P007975,0 days 00:13:39,8,25,17
24,MUN,P006760,P007056,0 days 00:12:53,-6,24,30
24,MUN,P006760,P011987,0 days 00:12:28,-7,24,31
24,MUN,P007639,P010391,0 days 00:11:10,4,18,14
24,MUN,P007639,P007975,0 days 00:11:10,4,18,14
24,MUN,P006760,P008985,0 days 00:10:58,-9,17,26
24,MUN,P007056,P007975,0 days 00:10:53,6,25,19
24,MUN,P001557,P007056,0 days 00:10:23,11,22,11
24,MUN,P004508,P007639,0 days 00:10:18,3,15,12
24,MUN,P008985,P011987,0 days 00:10:14,-9,17,26
24,MUN,P004508,P007056,0 days 00:09:52,9,21,12
24,MUN,P007056,P011941,0 days 00:09:25,-2,17,19
24,MUN,P011941,P011987,0 days 00:09:09,-3,17,20
24,MUN,P007975,P011987,0 days 00:08:41,6,23,17
24,MUN,P001557,P008985,0 days 00:08:38,9,18,9
24,MUN,P001557,P007639,0 days 00:08:30,5,14,9
24,MUN,P006760,P011941,0 days 00:08:18,-4,16,20
24,MUN,P008985,P011941,0 days 00:06:48,-3,12,15
24,MUN,P010391,P011987,0 days 00:06:21,2,15,13
24,MUN,P007975,P011941,0 days 00:06:20,1,12,11
24,MUN,P008985,P010391,0 days 00:06:16,9,13,4
24,MUN,P004508,P008985,0 days 00:05:32,9,13,4
24,MUN,P001557,P011987,0 days 00:04:51,2,11,9
24,MUN,P010391,P011941,0 days 00:04:44,0,7,7
24,MUN,P004508,P011941,0 days 00:04:24,2,8,6
24,MUN,P005478,P010391,0 days 00:04:07,-1,10,11
24,MUN,P005478,P007056,0 days 00:04:07,-1,10,11
24,MUN,P001557,P006760,0 days 00:03:50,3,8,5
24,MUN,P007056,P007639,0 days 00:03:44,-7,4,11
24,MUN,P005478,P011987,0 days 00:03:43,2,10,8
24,MUN,P005478,P007975,0 days 00:03:43,2,10,8
24,MUN,P001557,P011941,0 days 00:03:24,1,7,6
24,MUN,P006760,P007975,0 days 00:02:14,2,7,5
24,MUN,P007639,P011987,0 days 00:01:56,-5,3,8
24,MUN,P006760,P007639,0 days 00:01:04,-6,0,6
24,MUN,P007639,P008985,0 days 00:01:04,-6,0,6
24,MUN,P006760,P010391,0 days 00:01:03,-1,0,1
24,MUN,P004508,P011987,0 days 00:00:33,3,3,0
24,MUN,P004508,P005478,0 days 00:00:24,-3,0,3
24,MUN,P004508,P006245,0 days 00:00:24,-3,0,3
24,MUN,P005478,P006245,0 days 00:00:24,-3,0,3
24,MUN,P006245,P007056,0 days 00:00:24,-3,0,3
24,MUN,P006245,P010391,0 days 00:00:24,-3,0,3
25,RED,P005099,P006436,0 days 00:19:31,-6,35,41
25,RED,P006436,P011224,0 days 00:16:17,-6,31,37
25,RED,P000848,P007960,0 days 00:15:23,9,30,21
25,RED,P000848,P006436,0 days 00:15:01,2,38,36
25,RED,P005099,P011224,0 days 00:13:40,-8,21,29
25,RED,P006436,P007960,0 days 00:13:24,7,34,27
25,RED,P006436,PJDR,0 days 00:13:07,-3,28,31
25,RED,P000848,P002553,0 days 00:12:35,-7,19,26
25,RED,P006436,P008966,0 days 00:12:23,-5,22,27
25,RED,P000848,P011224,0 days 00:12:14,0,21,21
25,RED,P000848,PJDR,0 days 00:11:42,-4,23,27
25,RED,P007960,P011224,0 days 00:11:37,9,25,16
25,RED,P000848,P009035,0 days 00:11:28,2,26,24
25,RED,P007960,PJDR,0 days 00:11:19,2,21,19
25,RED,P000848,P005099,0 days 00:11:17,2,20,18
25,RED,P005099,P009035,0 days 00:10:35,8,23,15
25,RED,P006436,P012711,0 days 00:10:26,-4,21,25
25,RED,P007960,P009035,0 days 00:10:20,3,20,17
25,RED,P006436,P009035,0 days 00:10:06,3,28,25
25,RED,P005099,P012711,0 days 00:09:49,-1,19,20
25,RED,P005099,P007960,0 days 00:09:43,3,17,14
25,RED,P005099,PJDR,0 days 00:09:34,-3,14,17
25,RED,P005099,P008966,0 days 00:09:26,-9,13,22
25,RED,P009035,P011224,0 days 00:08:12,-4,17,21
25,RED,P011224,P012711,0 days 00:07:29,-8,14,22
25,RED,P008966,P011224,0 days 00:07:23,-3,15,18
25,RED,P002553,P006436,0 days 00:07:14,-3,13,16
25,RED,P002553,P011224,0 days 00:06:50,-1,7,8
25,RED,P007960,P008966,0 days 00:06:39,2,16,14
25,RED,P000848,P004720,0 days 00:06:15,-6,8,14
25,RED,P002553,P004720,0 days 00:06:15,-6,8,14
25,RED,P008966,PJDR,0 days 00:06:13,-1,10,11
25,RED,P009035,PJDR,0 days 00:06:12,0,11,11
25,RED,P008966,P012711,0 days 00:05:44,-7,6,13
25,RED,P002553,PJDR,0 days 00:05:30,-4,12,16
25,RED,P002553,P005099,0 days 00:05:14,-8,6,14
25,RED,P009035,P012711,0 days 00:04:42,3,15,12
25,RED,P002553,P007960,0 days 00:04:34,5,7,2
25,RED,P004720,PJDR,0 days 00:03:21,-4,6,10
25,RED,P004720,P007960,0 days 00:03:13,0,2,2
25,RED,P004720,P011224,0 days 00:02:39,0,2,2
25,RED,P000848,P012711,0 days 00:01:54,4,9,5
25,RED,P000848,P008966,0 days 00:01:44,3,6,3
25,RED,P012711,PJDR,0 days 00:01:40,-3,0,3
25,RED,P000848,P011964,0 days 00:01:39,-1,4,5
25,RED,P002553,P011964,0 days 00:01:39,-1,4,5
25,RED,P004720,P011964,0 days 00:01:39,-1,4,5
25,RED,P011964,PJDR,0 days 00:01:39,-1,4,5
25,RED,P011224,PJDR,0 days 00:01:23,1,3,2
25,RED,P004720,P006436,0 days 00:01:23,-5,2,7
25,RED,P002553,P009035,0 days 00:00:29,-3,0,3
25,RED,P004720,P005099,0 days 00:00:15,-2,0,2
25,MCO,P005985,P011212,0 days 00:27:15,11,58,47
25,MCO,P005985,P010588,0 days 00:22:18,15,51,36
25,MCO,P010588,P011212,0 days 00:18:38,17,38,21
25,MCO,P005985,PLCZ,0 days 00:17:27,19,42,23
25,MCO,P010588,PLCZ,0 days 00:17:27,19,42,23
25,MCO,P011212,P011231,0 days 00:17:08,12,39,27
25,MCO,P005985,P011226,0 days 00:16:23,0,40,40
25,MCO,P005985,P011231,0 days 00:16:09,15,42,27
25,MCO,P011212,PLCZ,0 days 00:13:29,15,31,16
25,MCO,P004197,P005985,0 days 00:12:22,0,25,25
25,MCO,P011212,P011226,0 days 00:12:08,5,24,19
25,MCO,P011196,P011212,0 days 00:11:34,0,18,18
25,MCO,P011196,P011226,0 days 00:11:05,6,25,19
25,MCO,P011226,P012709,0 days 00:10:19,-9,14,23
25,MCO,P005985,P011196,0 days 00:10:17,-3,23,26
25,MCO,P004197,P011212,0 days 00:09:56,-4,15,19
25,MCO,P010588,P011226,0 days 00:09:56,2,22,20
25,MCO,P010588,P011231,0 days 00:09:26,10,23,13
25,MCO,P004790,P005985,0 days 00:09:22,-14,13,27
25,MCO,P011196,P011231,0 days 00:08:19,5,21,16
25,MCO,P011231,PLCZ,0 days 00:08:01,9,20,11
25,MCO,P004790,P011212,0 days 00:07:48,-8,13,21
25,MCO,P004197,PLCZ,0 days 00:06:42,6,13,7
25,MCO,P004197,P010588,0 days 00:06:42,6,13,7
25,MCO,P011226,P011231,0 days 00:06:32,9,19,10
25,MCO,P002581,P004790,0 days 00:06:05,-12,8,20
25,MCO,P005985,P012709,0 days 00:06:04,-9,10,19
25,MCO,P010588,P012709,0 days 00:05:45,1,12,11
25,MCO,P004790,P011226,0 days 00:05:23,-12,5,17
25,MCO,P002581,P005985,0 days 00:05:23,-10,8,18
25,MCO,P011196,P012709,0 days 00:05:12,-2,8,10
25,MCO,P011226,PLCZ,0 days 00:04:33,5,14,9
25,MCO,P011212,P012709,0 days 00:04:15,0,4,4
25,MCO,P010588,P011196,0 days 00:04:10,-2,6,8
25,MCO,P002581,P011212,0 days 00:03:49,-4,8,12
25,MCO,P002581,P011226,0 days 00:03:47,-10,3,13
25,MCO,P004197,P011196,0 days 00:03:22,-4,7,11
25,MCO,P004197,P004790,0 days 00:03:16,-5,5,10
25,MCO,P004790,P012709,0 days 00:02:58,-10,0,10
25,MCO,P002581,P012709,0 days 00:02:58,-10,0,10
25,MCO,P004790,P010588,0 days 00:02:38,0,5,5
25,MCO,P004197,P011226,0 days 00:02:26,4,10,6
25,MCO,P004197,P011231,0 days 00:02:24,-1,7,8
25,MCO,P002581,P004197,0 days 00:02:18,-2,5,7
25,MCO,P012709,PLCZ,0 days 00:02:09,3,6,3
25,MCO,P011231,P012709,0 days 00:01:36,0,2,2
25,MCO,P004790,P011231,0 days 00:01:25,1,3,2
25,MCO,P004790,P011196,0 days 00:01:21,-4,0,4
26,PAM,P010568,P012740,0 days 00:19:25,-11,27,38
26,PAM,P003960,P007870,0 days 00:15:39,-7,30,37
26,PAM,P006643,P012740,0 days 00:15:35,-8,22,30
26,PAM,P000556,P004863,0 days 00:15:02,24,40,16
26,PAM,P003960,P012740,0 days 00:14:57,-15,20,35
26,PAM,P007870,P010568,0 days 00:14:52,-2,30,32
26,PAM,P006643,P010568,0 days 00:14:24,3,25,22
26,PAM,P007870,P012740,0 days 00:14:05,-9,20,29
26,PAM,P003960,P006643,0 days 00:13:31,-7,23,30
26,PAM,P003960,P010568,0 days 00:13:30,-4,28,32
26,PAM,P000556,P012738,0 days 00:13:16,13,25,12
26,PAM,P006643,P007870,0 days 00:11:44,-6,17,23
26,PAM,P000556,P010568,0 days 00:11:09,0,21,21
26,PAM,P004863,P010393,0 days 00:09:45,14,25,11
26,PAM,P000556,P003960,0 days 00:09:32,-1,23,24
26,PAM,P000556,P010393,0 days 00:09:18,12,20,8
26,PAM,P003960,P004863,0 days 00:09:00,0,20,20
26,PAM,P000556,P012740,0 days 00:08:59,-9,10,19
26,PAM,P010393,P012740,0 days 00:08:35,-4,9,13
26,PAM,P012738,P012739,0 days 00:08:27,3,15,12
26,PAM,P004863,P012738,0 days 00:08:27,21,22,1
26,PAM,P010568,P012738,0 days 00:08:05,1,11,10
26,PAM,P010568,P012739,0 days 00:08:03,6,14,8
26,PAM,P004863,P006643,0 days 00:07:18,0,15,15
26,PAM,P006643,P010393,0 days 00:07:07,5,14,9
26,PAM,P012738,P012740,0 days 00:06:53,0,10,10
26,PAM,P000556,P007870,0 days 00:06:53,0,17,17
26,PAM,P006643,P012739,0 days 00:06:43,-1,12,13
26,PAM,P000556,P012739,0 days 00:06:37,0,11,11
26,PAM,P010393,P010568,0 days 00:06:36,5,9,4
26,PAM,P004863,P012739,0 days 00:06:26,9,15,6
26,PAM,P010393,P012738,0 days 00:06:15,12,15,3
26,PAM,P004863,P010568,0 days 00:06:08,14,19,5
26,PAM,P004863,P007870,0 days 00:05:16,2,12,10
26,PAM,P004863,P012740,0 days 00:05:09,-6,5,11
26,PAM,P012739,P012740,0 days 00:04:38,-6,5,11
26,PAM,P003960,P010393,0 days 00:04:08,-1,7,8
26,PAM,P000556,P006643,0 days 00:04:01,-2,9,11
26,PAM,P000556,P009101,0 days 00:03:59,7,11,4
26,PAM,P009101,P012738,0 days 00:03:59,7,11,4
26,PAM,P006643,P012738,0 days 00:03:21,-1,6,7
26,PAM,P010393,P012739,0 days 00:02:59,1,5,4
26,PAM,P004863,P009101,0 days 00:02:51,10,10,0
26,PAM,P009101,P010393,0 days 00:02:51,10,10,0
26,PAM,P010754,P012738,0 days 00:02:26,4,5,1
26,PAM,P004863,P010754,0 days 00:02:26,4,5,1
26,PAM,P000556,P010754,0 days 00:02:26,4,5,1
26,PAM,P010754,P012739,0 days 00:01:52,4,5,1
26,PAM,P007870,P010393,0 days 00:01:22,2,2,0
26,PAM,P006643,P009101,0 days 00:01:08,-3,1,4
26,PAM,P009101,P012739,0 days 00:01:08,-3,1,4
26,PAM,P007870,P012738,0 days 00:00:47,0,0,0
26,PAM,P007870,P010754,0 days 00:00:34,0,0,0
26,PAM,P003960,P012739,0 days 00:00:23,-1,1,2
26,TEL,P009622,P009783,0 days 00:30:28,9,60,51
26,TEL,P009622,P011199,0 days 00:19:31,6,34,28
26,TEL,P009783,P011214,0 days 00:17:29,0,34,34
26,TEL,P011193,P011214,0 days 00:17:12,-9,30,39
26,TEL,P009783,P011199,0 days 00:17:01,8,31,23
26,TEL,P009622,P011214,0 days 00:16:25,2,33,31
26,TEL,P009783,P011193,0 days 00:15:52,6,34,28
26,TEL,P009622,P011193,0 days 00:14:48,8,33,25
26,TEL,P007990,P009622,0 days 00:13:57,-8,20,28
26,TEL,P005145,P009622,0 days 00:13:17,8,35,27
26,TEL,P009622,P011971,0 days 00:12:18,-2,17,19
26,TEL,P007990,P009783,0 days 00:11:43,-8,16,24
26,TEL,P009783,P011971,0 days 00:11:30,-2,15,17
26,TEL,P005145,P009783,0 days 00:10:47,10,32,22
26,TEL,P011199,P012744,0 days 00:10:16,-2,17,19
26,TEL,P007990,P011971,0 days 00:10:15,-3,13,16
26,TEL,P007990,P011199,0 days 00:10:12,-5,12,17
26,TEL,P009622,P012744,0 days 00:09:19,1,19,18
26,TEL,P007990,P011214,0 days 00:09:11,-19,7,26
26,TEL,P005145,P011199,0 days 00:09:06,1,19,18
26,TEL,P007990,P011219,0 days 00:08:58,-19,3,22
26,TEL,P011214,P011219,0 days 00:08:42,-9,8,17
26,TEL,P005145,P012744,0 days 00:08:31,1,17,16
26,TEL,P011193,P011219,0 days 00:08:31,-9,8,17
26,TEL,P011199,P011971,0 days 00:07:27,4,11,7
26,TEL,P007990,P011193,0 days 00:07:14,-20,3,23
26,TEL,P011193,P011199,0 days 00:06:48,2,8,6
26,TEL,P011193,P011971,0 days 00:06:41,-7,4,11
26,TEL,P011214,P011971,0 days 00:06:22,-10,4,14
26,TEL,P007990,P012744,0 days 00:06:09,-12,5,17
26,TEL,P009783,P012744,0 days 00:06:01,3,14,11
26,TEL,P009783,P011219,0 days 00:05:17,2,8,6
26,TEL,P009622,P011219,0 days 00:05:01,4,9,5
26,TEL,P005145,P011214,0 days 00:04:11,7,16,9
26,TEL,P005145,P011193,0 days 00:04:11,7,16,9
26,TEL,P011219,P012744,0 days 00:03:39,-10,2,12
26,TEL,P011219,P011971,0 days 00:03:07,-4,2,6
26,TEL,P005145,P007990,0 days 00:03:05,-2,5,7
26,TEL,P011199,P011214,0 days 00:02:58,1,4,3
26,TEL,P011193,P012744,0 days 00:02:51,-10,0,10
26,TEL,P011199,P011219,0 days 00:01:45,-3,0,3
26,TEL,P011214,P012744,0 days 00:01:06,-7,0,7
26,TEL,P011971,P012744,0 days 00:00:48,0,2,2
27,VIR,P001133,PBCN,0 days 00:24:24,7,56,49
27,VIR,P001133,P009549,0 days 00:22:24,3,50,47
27,VIR,P009549,PBCN,0 days 00:22:09,3,50,47
27,VIR,P001133,P003048,0 days 00:21:19,8,50,42
27,VIR,P003048,PBCN,0 days 00:20:41,7,47,40
27,VIR,P001844,P009549,0 days 00:19:09,-4,42,46
27,VIR,P003048,P009549,0 days 00:18:26,3,41,38
27,VIR,P001133,P001844,0 days 00:16:02,-1,38,39
27,VIR,P001844,PBCN,0 days 00:15:47,-1,38,39
27,VIR,P004007,P008847,0 days 00:14:16,4,28,24
27,VIR,P003527,P008847,0 days 00:12:38,-3,19,22
27,VIR,P001844,P003048,0 days 00:12:32,-1,29,30
27,VIR,P003527,P004007,0 days 00:11:56,-2,19,21
27,VIR,P001133,P006739,0 days 00:11:20,15,30,15
27,VIR,P004007,P006739,0 days 00:10:41,11,27,16
27,VIR,P006739,P008847,0 days 00:10:31,10,24,14
27,VIR,P003048,P006739,0 days 00:08:47,9,21,12
27,VIR,P006739,PBCN,0 days 00:08:37,8,18,10
27,VIR,P001844,P008847,0 days 00:08:10,-7,13,20
27,VIR,P003527,P006739,0 days 00:07:58,4,15,11
27,VIR,P008847,P011192,0 days 00:07:52,4,17,13
27,VIR,P004007,P011192,0 days 00:07:10,5,17,12
27,VIR,P008847,P009549,0 days 00:07:05,-3,13,16
27,VIR,P006739,P011192,0 days 00:06:45,9,19,10
27,VIR,P006739,P009549,0 days 00:06:22,4,12,8
27,VIR,P006739,P010781,0 days 00:06:11,6,14,8
27,VIR,P001133,P008847,0 days 00:06:03,6,18,12
27,VIR,P003527,P011192,0 days 00:05:47,-2,8,10
27,VIR,P004007,P010781,0 days 00:05:04,2,10,8
27,VIR,P001844,P003527,0 days 00:04:40,-7,4,11
27,VIR,P008847,P010781,0 days 00:04:26,1,7,6
27,VIR,P003527,P010781,0 days 00:04:26,1,7,6
27,VIR,P001844,P004007,0 days 00:04:13,-6,4,10
27,VIR,P008847,PBCN,0 days 00:03:43,0,9,9
27,VIR,P001133,P011192,0 days 00:03:13,6,11,5
27,VIR,P003527,P009549,0 days 00:03:07,-3,4,7
27,VIR,P001133,P004007,0 days 00:02:58,7,12,5
27,VIR,P004007,P009549,0 days 00:02:40,-2,4,6
27,VIR,P001844,P011192,0 days 00:02:15,-5,0,5
27,VIR,P001133,P010781,0 days 00:01:45,5,7,2
27,VIR,P003048,P010781,0 days 00:01:45,5,7,2
27,VIR,P003048,P011192,0 days 00:01:08,0,2,2
27,VIR,P011192,PBCN,0 days 00:01:08,0,2,2
27,VIR,P010781,PBCN,0 days 00:01:07,4,4,0
27,VIR,P009549,P011192,0 days 00:00:42,-1,0,1
27,VIR,P003048,P004007,0 days 00:00:38,1,3,2
27,BER,P008967,P012720,0 days 00:26:32,2,57,55
27,BER,P003958,P008967,0 days 00:23:01,6,52,46
27,BER,P003958,P012720,0 days 00:23:01,6,52,46
27,BER,P006919,P008967,0 days 00:20:23,-4,45,49
27,BER,P006919,P012720,0 days 00:20:23,-4,45,49
27,BER,P003958,P006919,0 days 00:16:52,0,40,40
27,BER,P008384,P012721,0 days 00:13:28,-13,19,32
27,BER,P007025,P008384,0 days 00:12:21,-9,19,28
27,BER,P007025,P012721,0 days 00:12:21,-9,19,28
27,BER,P007550,P008967,0 days 00:12:02,-16,13,29
27,BER,P003958,P008211,0 days 00:11:02,11,29,18
27,BER,P008211,P008967,0 days 00:11:02,11,29,18
27,BER,P008211,P012720,0 days 00:11:02,11,29,18
27,BER,P007550,P012720,0 days 00:10:55,-12,13,25
27,BER,P007025,P008173,0 days 00:10:17,-7,15,22
27,BER,P008173,P008384,0 days 00:10:17,-7,15,22
27,BER,P008173,P012721,0 days 00:10:17,-7,15,22
27,BER,P006251,P012721,0 days 00:09:40,-15,11,26
27,BER,P006251,P008384,0 days 00:09:40,-15,11,26
27,BER,P006251,P007025,0 days 00:08:33,-11,11,22
27,BER,P003958,P007550,0 days 00:08:24,-8,10,18
27,BER,P006251,P007550,0 days 00:08:23,-9,11,20
27,BER,P006919,P007550,0 days 00:08:14,-13,9,22
27,BER,P006919,P008211,0 days 00:07:34,6,21,15
27,BER,P003958,P008173,0 days 00:07:23,5,21,16
27,BER,P003958,P012721,0 days 00:07:16,7,16,9
27,BER,P006251,P008173,0 days 00:06:29,-9,7,16
27,BER,P006251,P008967,0 days 00:06:19,-7,7,14
27,BER,P006251,P012720,0 days 00:05:12,-3,7,10
27,BER,P008967,P012721,0 days 00:04:35,1,8,7
27,BER,P008173,P012720,0 days 00:04:35,3,15,12
27,BER,P008173,P008967,0 days 00:04:35,3,15,12
27,BER,P006919,P008173,0 days 00:04:35,3,15,12
27,BER,P003958,P008384,0 days 00:03:48,2,8,6
27,BER,P003958,P007025,0 days 00:03:48,2,8,6
27,BER,P008211,P012721,0 days 00:03:28,5,8,3
27,BER,P012720,P012721,0 days 00:03:28,5,8,3
27,BER,P007550,P008384,0 days 00:03:11,-6,4,10
27,BER,P007550,P012721,0 days 00:03:11,-6,4,10
27,BER,P003958,P006251,0 days 00:02:41,1,4,3
27,BER,P006251,P006919,0 days 00:02:31,-4,3,7
27,BER,P007025,P007550,0 days 00:02:04,-2,4,6
27,BER,P008384,P008967,0 days 00:01:07,-4,0,4
27,BER,P006819,P006919,0 days 00:01:00,0,2,2
27,BER,P006819,P008173,0 days 00:01:00,0,2,2
27,BER,P006819,P008967,0 days 00:01:00,0,2,2
27,BER,P006819,P012720,0 days 00:01:00,0,2,2
28,ULK,P001932,P011157,0 days 00:23:05,10,57,47
28,ULK,P004004,P011157,0 days 00:20:54,3,46,43
28,ULK,P001932,P004004,0 days 00:19:40,7,46,39
28,ULK,P008962,P011157,0 days 00:19:29,23,54,31
28,ULK,P006961,P011157,0 days 00:19:27,22,57,35
28,ULK,P006961,P008962,0 days 00:16:19,25,50,25
28,ULK,P010560,P011157,0 days 00:15:04,-8,31,39
28,ULK,P006661,P011052,0 days 00:15:00,4,39,35
28,ULK,P001932,P006961,0 days 00:14:59,17,43,26
28,ULK,P001932,P008962,0 days 00:14:24,15,37,22
28,ULK,P006661,P008962,0 days 00:14:09,9,41,32
28,ULK,P001932,P010560,0 days 00:13:51,-1,34,35
28,ULK,P004004,P008962,0 days 00:13:32,13,33,20
28,ULK,P008962,P011052,0 days 00:13:29,7,39,32
28,ULK,P006661,P010560,0 days 00:11:54,-5,24,29
28,ULK,P004004,P010560,0 days 00:11:47,-7,24,31
28,ULK,P006661,P006961,0 days 00:11:01,14,34,20
28,ULK,P004004,P006961,0 days 00:11:01,13,31,18
28,ULK,P008962,P010560,0 days 00:10:47,-1,25,26
28,ULK,P006661,P011157,0 days 00:10:08,7,26,19
28,ULK,P005844,P006661,0 days 00:09:56,-1,25,26
28,ULK,P005844,P011052,0 days 00:09:23,-2,24,26
28,ULK,P005844,P008962,0 days 00:08:24,-1,22,23
28,ULK,P005844,P010560,0 days 00:07:35,0,19,19
28,ULK,P010560,P011052,0 days 00:07:34,-3,16,19
28,ULK,P006961,P011052,0 days 00:07:15,10,24,14
28,ULK,P002968,P010560,0 days 00:06:12,-9,8,17
28,ULK,P002968,P011157,0 days 00:06:12,-9,8,17
28,ULK,P006961,P010560,0 days 00:05:52,2,19,17
28,ULK,P011052,P011157,0 days 00:05:41,8,17,9
28,ULK,P002968,P004004,0 days 00:05:36,-9,8,17
28,ULK,P001932,P002968,0 days 00:04:22,-5,8,13
28,ULK,P001932,P006661,0 days 00:03:50,6,12,6
28,ULK,P002968,P006661,0 days 00:02:49,-6,3,9
28,ULK,P005844,P006961,0 days 00:02:47,5,10,5
28,ULK,P002968,P011052,0 days 00:01:35,-2,3,5
28,ULK,P004004,P006661,0 days 00:01:14,-4,0,4
28,ULK,P002968,P005844,0 days 00:00:59,-2,3,5
28,ULK,P002968,P008962,0 days 00:00:59,-2,3,5
28,ULK,P001932,P005844,0 days 00:00:37,3,3,0
28,ULK,P005844,P011980,0 days 00:00:15,0,0,0
28,ULK,P006661,P011980,0 days 00:00:15,0,0,0
28,ULK,P006961,P011980,0 days 00:00:15,0,0,0
28,ULK,P011052,P011980,0 days 00:00:15,0,0,0
28,ULK,P004004,P005844,0 days 00:00:04,2,2,0
28,ULK,P004004,P011052,0 days 00:00:04,2,2,0
28,ASV,P012732,PKIR,0 days 00:24:52,-7,52,59
28,ASV,P004194,P012732,0 days 00:24:17,-10,54,64
28,ASV,P004194,PKIR,0 days 00:23:41,-8,52,60
28,ASV,P006568,P012732,0 days 00:23:19,-3,47,50
28,ASV,P004194,P006568,0 days 00:20:17,-3,45,48
28,ASV,P006568,PKIR,0 days 00:20:00,1,42,41
28,ASV,P002100,P012729,0 days 00:17:46,-10,37,47
28,ASV,P011225,PKIR,0 days 00:15:51,7,39,32
28,ASV,P004194,P011225,0 days 00:15:12,6,37,31
28,ASV,P002100,PKIR,0 days 00:14:48,-20,27,47
28,ASV,P011225,P012732,0 days 00:14:13,6,34,28
28,ASV,P006568,P011225,0 days 00:14:13,6,34,28
28,ASV,P002100,P012732,0 days 00:13:42,-16,24,40
28,ASV,P002100,P004194,0 days 00:11:03,-16,23,39
28,ASV,P002100,P006568,0 days 00:10:29,-13,15,28
28,ASV,P002100,P012730,0 days 00:10:16,3,27,24
28,ASV,P002100,P012731,0 days 00:10:01,1,24,23
28,ASV,P012729,P012730,0 days 00:09:47,0,24,24
28,ASV,P012729,PKIR,0 days 00:09:20,-12,18,30
28,ASV,P012729,P012731,0 days 00:09:16,-4,19,23
28,ASV,P012729,P012732,0 days 00:07:38,-7,13,20
28,ASV,P012730,P012731,0 days 00:06:37,3,18,15
28,ASV,P002100,P011225,0 days 00:06:01,3,16,13
28,ASV,P011225,P012730,0 days 00:06:01,3,16,13
28,ASV,P012730,PKIR,0 days 00:05:25,-4,11,15
28,ASV,P011386,P012729,0 days 00:05:16,-6,11,17
28,ASV,P002100,P011386,0 days 00:05:06,-6,11,17
28,ASV,P011225,P012729,0 days 00:05:02,3,13,10
28,ASV,P006568,P012731,0 days 00:04:42,-8,7,15
28,ASV,P006568,P012729,0 days 00:04:25,-4,4,8
28,ASV,P011225,P012731,0 days 00:04:23,2,11,9
28,ASV,P004194,P012729,0 days 00:04:00,-7,9,16
28,ASV,P012731,P012732,0 days 00:03:59,-1,8,9
28,ASV,P011386,P012730,0 days 00:03:53,-2,9,11
28,ASV,P011386,P012731,0 days 00:03:07,-7,6,13
28,ASV,P011386,PKIR,0 days 00:02:09,1,5,4
28,ASV,P004194,P012731,0 days 00:01:35,-2,5,7
28,ASV,P006568,P011386,0 days 00:01:23,-4,2,6
28,ASV,P000229,PKIR,0 days 00:01:02,-4,1,5
28,ASV,P012730,P012732,0 days 00:01:00,3,3,0
28,ASV,P004194,P012730,0 days 00:00:59,0,3,3
28,ASV,P000229,P012730,0 days 00:00:58,-2,1,3
28,ASV,P000229,P012731,0 days 00:00:48,-2,1,3
28,ASV,P012731,PKIR,0 days 00:00:48,-2,1,3
28,ASV,P000229,P012729,0 days 00:00:34,-5,0,5
28,ASV,P000229,P012732,0 days 00:00:32,-1,1,2
28,ASV,P000229,P011386,0 days 00:00:10,0,0,0
28,ASV,P000229,P002100,0 days 00:00:04,-2,0,2
29,OLY,P001255,P008855,0 days 00:32:51,10,74,64
29,OLY,P001255,P007982,0 days 00:27:22,13,65,52
29,OLY,P003941,P007982,0 days 00:23:27,15,61,46
29,OLY,P007982,P008855,0 days 00:23:25,11,57,46
29,OLY,P001255,P010612,0 days 00:21:47,-3,47,50
29,OLY,P007982,P010392,0 days 00:21:24,15,55,40
29,OLY,P001255,P003941,0 days 00:21:00,19,57,38
29,OLY,P001255,P010392,0 days 00:19:19,16,51,35
29,OLY,P003941,P008855,0 days 00:18:41,17,53,36
29,OLY,P001255,P008811,0 days 00:18:35,-10,31,41
29,OLY,P008811,P008855,0 days 00:18:35,-10,31,41
29,OLY,P008855,P010612,0 days 00:17:04,-2,37,39
29,OLY,P008855,P010392,0 days 00:17:01,12,45,33
29,OLY,P008829,P010612,0 days 00:16:55,-10,27,37
29,OLY,P008829,P008855,0 days 00:16:02,-6,31,37
29,OLY,P003941,P010392,0 days 00:15:49,16,47,31
29,OLY,P001255,P008829,0 days 00:14:45,-8,23,31
29,OLY,P003941,P010612,0 days 00:13:32,-2,30,32
29,OLY,P008811,P010612,0 days 00:10:53,-3,21,24
29,OLY,P008811,P008829,0 days 00:10:53,-3,21,24
29,OLY,P007982,P010612,0 days 00:10:34,-1,24,25
29,OLY,P003941,P008829,0 days 00:09:12,-10,12,22
29,OLY,P007982,P008811,0 days 00:07:42,-7,10,17
29,OLY,P007982,P008829,0 days 00:06:50,-10,8,18
29,OLY,P008811,P010392,0 days 00:06:11,-2,10,12
29,OLY,P006302,P008855,0 days 00:05:25,-4,8,12
29,OLY,P010392,P010612,0 days 00:05:12,1,14,13
29,OLY,P003941,P006302,0 days 00:03:59,1,8,7
29,OLY,P006302,P007982,0 days 00:03:52,-4,4,8
29,OLY,P008829,P010392,0 days 00:02:59,-2,6,8
29,OLY,P006302,P008829,0 days 00:02:44,-3,4,7
29,OLY,P001255,P006302,0 days 00:02:41,-1,4,5
29,OLY,P006302,P010612,0 days 00:01:43,0,4,4
29,OLY,P006302,P008811,0 days 00:01:31,-5,0,5
29,OLY,P006302,P010392,0 days 00:00:05,0,0,0
29,PAR,P000956,P008987,0 days 00:34:33,2,74,72
29,PAR,P008987,P009862,0 days 00:33:00,2,68,66
29,PAR,P007400,P008987,0 days 00:30:47,-8,62,70
29,PAR,P007400,P009862,0 days 00:28:49,-2,60,62
29,PAR,P000956,P009862,0 days 00:26:14,7,56,49
29,PAR,P000956,P007400,0 days 00:26:07,-2,54,56
29,PAR,P003983,P009862,0 days 00:18:21,-4,33,37
29,PAR,P003983,P008987,0 days 00:16:04,-7,25,32
29,PAR,P009862,P012743,0 days 00:15:42,6,34,28
29,PAR,P009862,P011051,0 days 00:14:33,11,32,21
29,PAR,P007400,P011051,0 days 00:13:41,8,28,20
29,PAR,P008987,P012743,0 days 00:13:03,3,29,26
29,PAR,P008987,P011051,0 days 00:12:26,6,24,18
29,PAR,P003983,P007400,0 days 00:11:56,-11,17,28
29,PAR,P003983,P012743,0 days 00:11:50,-1,22,23
29,PAR,P000956,P003983,0 days 00:11:04,-2,19,21
29,PAR,P007400,P012743,0 days 00:10:59,2,25,23
29,PAR,P000956,P011050,0 days 00:10:01,-11,21,32
29,PAR,P008987,P011050,0 days 00:09:56,-9,21,30
29,PAR,P008987,P012742,0 days 00:09:43,-5,25,30
29,PAR,P000956,P012743,0 days 00:09:20,11,24,13
29,PAR,P000956,P011051,0 days 00:09:13,5,17,12
29,PAR,P007400,P012742,0 days 00:07:42,-6,21,27
29,PAR,P007400,P011050,0 days 00:06:58,-9,13,22
29,PAR,P003983,P011051,0 days 00:06:41,2,12,10
29,PAR,P000956,P012742,0 days 00:05:56,-6,15,21
29,PAR,P009862,P012742,0 days 00:05:46,-2,15,17
29,PAR,P009862,P011050,0 days 00:03:28,-6,6,12
29,PAR,P011051,P012743,0 days 00:03:21,3,8,5
29,PAR,P011050,P012742,0 days 00:03:20,-3,7,10
29,PAR,P000956,P004058,0 days 00:03:13,-2,8,10
29,PAR,P011051,P012742,0 days 00:03:13,1,7,6
29,PAR,P004058,P008987,0 days 00:03:13,-2,8,10
29,PAR,P004058,P011050,0 days 00:03:13,-2,8,10
29,PAR,P000956,P007673,0 days 00:03:11,-2,8,10
29,PAR,P007673,P008987,0 days 00:03:11,-2,8,10
29,PAR,P007673,P011050,0 days 00:03:03,-2,8,10
29,PAR,P004058,P007673,0 days 00:03:00,-2,8,10
29,PAR,P003983,P012742,0 days 00:02:11,1,4,3
29,PAR,P012742,P012743,0 days 00:01:21,0,6,6
29,PAR,P004058,P007400,0 days 00:00:13,0,0,0
29,PAR,P007673,P009862,0 days 00:00:11,0,0,0
29,PAR,P003983,P007673,0 days 00:00:08,0,0,0
29,PAR,P003983,P011050,0 days 00:00:05,-2,0,2
30,MAD,P005928,P009005,0 days 00:17:51,11,44,33
30,MAD,P006540,P010357,0 days 00:17:41,6,41,35
30,MAD,P003108,PTGB,0 days 00:17:37,5,35,30
30,MAD,P009005,P010357,0 days 00:17:04,15,47,32
30,MAD,PBMT,PTGB,0 days 00:16:53,5,33,28
30,MAD,P003108,PBMT,0 days 00:15:41,6,30,24
30,MAD,PCVM,PTGB,0 days 00:15:39,17,38,21
30,MAD,P003108,PCVM,0 days 00:15:36,14,33,19
30,MAD,PBMT,PCVM,0 days 00:15:36,8,31,23
30,MAD,P006540,P009005,0 days 00:15:08,8,39,31
30,MAD,P005928,P010357,0 days 00:14:21,12,38,26
30,MAD,P003108,P004887,0 days 00:12:58,11,27,16
30,MAD,P005928,P006540,0 days 00:12:46,7,33,26
30,MAD,P004887,PCVM,0 days 00:12:06,8,26,18
30,MAD,P005791,P010357,0 days 00:11:01,3,27,24
30,MAD,P005791,P009005,0 days 00:11:01,3,27,24
30,MAD,P005791,P006540,0 days 00:11:01,3,27,24
30,MAD,P004887,PTGB,0 days 00:10:25,8,24,16
30,MAD,P004887,PBMT,0 days 00:10:16,8,24,16
30,MAD,P005791,P005928,0 days 00:09:34,4,25,21
30,MAD,P010357,PCVM,0 days 00:08:59,6,19,13
30,MAD,P010357,PTGB,0 days 00:08:31,10,22,12
30,MAD,P010357,PBMT,0 days 00:07:50,-2,12,14
30,MAD,P004887,P010357,0 days 00:06:57,0,13,13
30,MAD,P003108,P010357,0 days 00:06:39,4,12,8
30,MAD,P005928,P009213,0 days 00:06:13,1,13,12
30,MAD,P004887,P005928,0 days 00:05:59,3,12,9
30,MAD,P004887,P009005,0 days 00:05:59,3,12,9
30,MAD,P003108,P009213,0 days 00:05:46,-7,8,15
30,MAD,P004887,P006540,0 days 00:05:45,1,10,9
30,MAD,P009213,PTGB,0 days 00:05:40,-6,9,15
30,MAD,P003108,P005928,0 days 00:05:30,-6,8,14
30,MAD,P005928,PTGB,0 days 00:05:10,-3,9,12
30,MAD,P009005,P009213,0 days 00:04:43,3,11,8
30,MAD,P009005,PTGB,0 days 00:04:26,6,14,8
30,MAD,P003108,P009005,0 days 00:03:51,1,9,8
30,MAD,P006540,PCVM,0 days 00:03:14,2,6,4
30,MAD,P009213,PBMT,0 days 00:02:52,-7,2,9
30,MAD,P006540,PBMT,0 days 00:02:10,-3,2,5
30,MAD,P009213,P010357,0 days 00:02:05,2,5,3
30,MAD,P005928,PBMT,0 days 00:02:00,-5,2,7
30,MAD,P004887,P009213,0 days 00:01:55,2,4,2
30,MAD,P003108,P006540,0 days 00:01:50,0,2,2
30,MAD,P005791,PBMT,0 days 00:01:27,-1,2,3
30,MAD,P009005,PBMT,0 days 00:01:27,-1,2,3
30,MAD,P006540,PTGB,0 days 00:00:55,2,4,2
30,MAD,P009213,PCVM,0 days 00:00:52,-2,0,2
30,MAD,P009005,PCVM,0 days 00:00:46,7,7,0
30,MAD,P006540,P009213,0 days 00:00:14,-2,0,2
30,MIL,P000796,P007831,0 days 00:22:31,-12,40,52
30,MIL,P006433,P007831,0 days 00:21:23,-7,41,48
30,MIL,P007201,P007831,0 days 00:19:38,-10,35,45
30,MIL,P002849,P007831,0 days 00:18:22,-7,33,40
30,MIL,P007831,P011205,0 days 00:16:43,-5,25,30
30,MIL,P002849,P007201,0 days 00:16:41,-7,31,38
30,MIL,P000796,P006433,0 days 00:16:12,-3,34,37
30,MIL,P006433,P007201,0 days 00:15:28,-7,30,37
30,MIL,P005670,P011205,0 days 00:14:58,-2,26,28
30,MIL,P000796,P007201,0 days 00:14:39,-8,28,36
30,MIL,P002849,P006433,0 days 00:13:34,-4,28,32
30,MIL,P000796,P002849,0 days 00:13:23,-5,26,31
30,MIL,P009960,P011205,0 days 00:11:32,1,25,24
30,MIL,P005670,P007831,0 days 00:11:14,-7,14,21
30,MIL,P000796,P011205,0 days 00:10:58,0,19,19
30,MIL,P000796,P005670,0 days 00:10:45,-9,15,24
30,MIL,P000796,P009960,0 days 00:09:23,-2,18,20
30,MIL,P006433,P011205,0 days 00:09:14,1,16,15
30,MIL,P005670,P009960,0 days 00:09:11,0,20,20
30,MIL,P007831,P009960,0 days 00:08:58,-8,15,23
30,MIL,P007201,P011205,0 days 00:08:06,-4,11,15
30,MIL,P006509,P011205,0 days 00:07:34,1,17,16
30,MIL,P005670,P006509,0 days 00:07:33,1,17,16
30,MIL,P006509,P009960,0 days 00:07:12,-1,15,16
30,MIL,P002849,P011205,0 days 00:06:40,-2,9,11
30,MIL,P000796,P006509,0 days 00:06:01,-9,8,17
30,MIL,P005670,P007201,0 days 00:06:00,-5,7,12
30,MIL,P006433,P009960,0 days 00:05:56,0,11,11
30,MIL,P001518,P007831,0 days 00:05:24,-5,9,14
30,MIL,P002849,P005670,0 days 00:04:48,-3,5,8
30,MIL,P001518,P011205,0 days 00:04:33,-4,7,11
30,MIL,P002812,P011205,0 days 00:04:03,-2,9,11
30,MIL,P002812,P005670,0 days 00:03:58,1,9,8
30,MIL,P001518,P005670,0 days 00:03:38,-1,6,7
30,MIL,P002812,P006509,0 days 00:03:10,1,9,8
30,MIL,P007201,P009960,0 days 00:02:53,-2,4,6
30,MIL,P011205,P011926,0 days 00:02:47,0,4,4
30,MIL,P005670,P011926,0 days 00:02:47,0,4,4
30,MIL,P001518,P011926,0 days 00:02:47,0,4,4
30,MIL,P007831,P011926,0 days 00:02:47,0,4,4
30,MIL,P001518,P009960,0 days 00:02:37,-5,5,10
30,MIL,P006509,P007201,0 days 00:02:27,-5,2,7
30,MIL,P002812,P009960,0 days 00:02:02,1,7,6
30,MIL,P000796,P002812,0 days 00:02:01,-3,2,5
30,MIL,P006433,P006509,0 days 00:01:52,-8,0,8
30,MIL,P006509,P007831,0 days 00:01:51,-8,0,8
30,MIL,P001518,P006433,0 days 00:01:41,-1,3,4
30,MIL,P002812,P007831,0 days 00:00:53,-3,0,3
30,MIL,P000796,P001518,0 days 00:00:51,-1,2,3
30,MIL,P005670,P006433,0 days 00:00:16,1,1,0
30,MIL,P001518,P002812,0 days 00:00:05,-3,0,3
31,BAS,P010444,P011948,0 days 00:19:33,-13,40,53
31,BAS,P007230,P009048,0 days 00:19:28,-9,40,49
31,BAS,P007230,P010444,0 days 00:18:44,-15,38,53
31,BAS,P007230,P011948,0 days 00:18:26,-25,29,54
31,BAS,P009048,P012201,0 days 00:18:01,3,39,36
31,BAS,P011948,P012201,0 days 00:17:28,2,37,35
31,BAS,P009048,P011948,0 days 00:16:45,1,37,36
31,BAS,P010444,P012201,0 days 00:16:10,0,36,36
31,BAS,P009048,P010444,0 days 00:15:54,-3,36,39
31,BAS,P007230,P012201,0 days 00:14:55,-9,29,38
31,BAS,P011085,P012201,0 days 00:12:38,14,35,21
31,BAS,P004761,P007230,0 days 00:12:13,-15,20,35
31,BAS,P011064,P012201,0 days 00:10:44,3,29,26
31,BAS,P004761,P012201,0 days 00:10:32,1,27,26
31,BAS,P011085,P011948,0 days 00:10:09,12,28,16
31,BAS,P004761,P011064,0 days 00:09:48,-18,17,35
31,BAS,P004603,P012201,0 days 00:09:44,6,24,18
31,BAS,P011064,P011085,0 days 00:08:38,-2,22,24
31,BAS,P010444,P011085,0 days 00:08:33,0,18,18
31,BAS,P004761,P010444,0 days 00:08:32,-10,14,24
31,BAS,P004761,P011085,0 days 00:07:47,-11,13,24
31,BAS,P004603,P004761,0 days 00:07:47,-11,13,24
31,BAS,P003198,P007230,0 days 00:07:46,-5,14,19
31,BAS,P004603,P011085,0 days 00:07:21,5,21,16
31,BAS,P004761,P009048,0 days 00:07:20,1,16,15
31,BAS,P011064,P011948,0 days 00:07:09,-6,14,20
31,BAS,P004603,P009048,0 days 00:06:59,4,13,9
31,BAS,P004603,P011064,0 days 00:06:44,-9,13,22
31,BAS,P010444,P011064,0 days 00:06:42,-4,14,18
31,BAS,P007230,P011064,0 days 00:06:27,-12,9,21
31,BAS,P004603,P007230,0 days 00:06:22,-10,5,15
31,BAS,P004603,P011948,0 days 00:05:56,6,13,7
31,BAS,P003198,P009048,0 days 00:05:27,-1,12,13
31,BAS,P009048,P011085,0 days 00:05:14,11,15,4
31,BAS,P003198,P010444,0 days 00:04:24,1,12,11
31,BAS,P003198,P011948,0 days 00:04:24,1,12,11
31,BAS,P003198,P004603,0 days 00:03:59,-11,2,13
31,BAS,P003198,P004761,0 days 00:03:59,-11,2,13
31,BAS,P004761,P011948,0 days 00:03:54,-14,2,16
31,BAS,P003198,P011064,0 days 00:02:56,-9,2,11
31,BAS,P007230,P011085,0 days 00:02:39,-4,4,8
31,BAS,P009048,P011064,0 days 00:01:12,1,4,3
31,BAS,P003198,P011085,0 days 00:00:37,-5,0,5
31,ZAL,P002329,P011218,0 days 00:23:57,3,55,52
31,ZAL,P002329,P007109,0 days 00:22:48,13,60,47
31,ZAL,P002329,P012715,0 days 00:22:24,15,62,47
31,ZAL,P007513,P012715,0 days 00:22:00,24,65,41
31,ZAL,P002329,P007513,0 days 00:17:58,17,54,37
31,ZAL,P007109,P012715,0 days 00:17:53,13,51,38
31,ZAL,P007109,P011218,0 days 00:17:30,10,45,35
31,ZAL,P002329,P003211,0 days 00:15:27,-4,30,34
31,ZAL,P011218,P012715,0 days 00:15:15,2,38,36
31,ZAL,P007109,P007513,0 days 00:14:56,10,45,35
31,ZAL,P003211,P011218,0 days 00:13:05,-11,23,34
31,ZAL,P007513,P011218,0 days 00:11:36,10,32,22
31,ZAL,P003211,P010390,0 days 00:10:39,-10,17,27
31,ZAL,P003211,P007109,0 days 00:10:34,6,22,16
31,ZAL,P011965,P012715,0 days 00:10:32,12,29,17
31,ZAL,P002329,P010390,0 days 00:09:46,-6,17,23
31,ZAL,P007513,P011965,0 days 00:08:48,9,27,18
31,ZAL,P002329,P002676,0 days 00:08:43,-1,21,22
31,ZAL,P010390,P011218,0 days 00:08:42,-11,12,23
31,ZAL,P002676,P003211,0 days 00:08:26,-9,15,24
31,ZAL,P005504,P012715,0 days 00:08:12,14,23,9
31,ZAL,P002676,P012715,0 days 00:07:49,9,21,12
31,ZAL,P002676,P011965,0 days 00:07:26,9,20,11
31,ZAL,P002329,P011965,0 days 00:07:15,5,21,16
31,ZAL,P005504,P007513,0 days 00:07:09,13,21,8
31,ZAL,P002676,P007109,0 days 00:07:02,7,20,13
31,ZAL,P002676,P007513,0 days 00:06:52,12,21,9
31,ZAL,P003211,P012715,0 days 00:06:00,-5,10,15
31,ZAL,P002676,P010390,0 days 00:05:53,-9,10,19
31,ZAL,P007109,P011965,0 days 00:05:47,1,14,13
31,ZAL,P002676,P011218,0 days 00:05:39,-11,8,19
31,ZAL,P007109,P010390,0 days 00:05:30,4,11,7
31,ZAL,P005504,P011965,0 days 00:05:12,10,16,6
31,ZAL,P002329,P005504,0 days 00:04:50,9,15,6
31,ZAL,P003211,P011965,0 days 00:04:18,4,9,5
31,ZAL,P002676,P005504,0 days 00:03:22,5,8,3
31,ZAL,P005504,P011218,0 days 00:03:00,4,7,3
31,ZAL,P010390,P011965,0 days 00:02:34,1,7,6
31,ZAL,P010390,P012715,0 days 00:01:23,-9,0,9
31,ZAL,P003211,P005504,0 days 00:01:03,1,2,1
31,ZAL,P007513,P010390,0 days 00:00:37,0,2,2
31,ZAL,P002329,P006860,0 days 00:00:32,1,1,0
31,ZAL,P006860,P007513,0 days 00:00:32,1,1,0
31,ZAL,P006860,P011965,0 days 00:00:32,1,1,0
31,ZAL,P006860,P012715,0 days 00:00:32,1,1,0
32,IST,P004888,P007200,0 days 00:32:08,2,59,57
32,IST,P004888,P011981,0 days 00:26:54,9,54,45
32,IST,P007200,P011981,0 days 00:24:51,11,50,39
32,IST,P004888,P011078,0 days 00:22:29,-2,41,43
32,IST,P007200,P011078,0 days 00:20:26,0,37,37
32,IST,P004888,P009664,0 days 00:18:36,6,35,29
32,IST,P009664,P011078,0 days 00:17:49,-1,33,34
32,IST,P004888,P006590,0 days 00:17:37,8,37,29
32,IST,P007200,P009664,0 days 00:16:40,6,31,25
32,IST,P011078,P011981,0 days 00:16:40,4,34,30
32,IST,P006590,P011981,0 days 00:15:59,9,33,24
32,IST,P006590,P007200,0 days 00:15:34,10,33,23
32,IST,P006590,P009664,0 days 00:14:31,17,36,19
32,IST,P009664,P011981,0 days 00:12:47,12,28,16
32,IST,P006590,P011078,0 days 00:11:44,10,29,19
32,IST,P004554,P009664,0 days 00:11:28,-4,19,23
32,IST,P004554,P011078,0 days 00:11:28,-4,19,23
32,IST,P006372,P006590,0 days 00:08:43,0,18,18
32,IST,P004888,P012710,0 days 00:08:03,-6,12,18
32,IST,P007200,P012710,0 days 00:08:03,-6,12,18
32,IST,P004554,P006590,0 days 00:07:17,1,16,15
32,IST,P004554,P004888,0 days 00:07:07,-11,7,18
32,IST,P004554,P007200,0 days 00:07:07,-11,7,18
32,IST,P006372,P011078,0 days 00:06:52,0,17,17
32,IST,P011981,P012710,0 days 00:06:35,-3,10,13
32,IST,P006372,P009664,0 days 00:05:49,4,14,10
32,IST,P004554,P006372,0 days 00:05:49,4,14,10
32,IST,P011078,P012710,0 days 00:05:44,1,10,9
32,IST,P004888,P006372,0 days 00:03:50,-6,7,13
32,IST,P006372,P011981,0 days 00:03:50,-6,7,13
32,IST,P006372,P007200,0 days 00:03:43,-4,7,11
32,IST,P006590,P012710,0 days 00:02:19,-7,2,9
32,IST,P004554,P012710,0 days 00:01:28,-3,2,5
32,PAM,P000556,P010568,0 days 00:17:26,1,28,27
32,PAM,P003960,P007870,0 days 00:16:34,11,39,28
32,PAM,P003960,P010568,0 days 00:14:54,7,35,28
32,PAM,P007870,P012740,0 days 00:14:21,12,32,20
32,PAM,P010568,P012740,0 days 00:14:10,13,32,19
32,PAM,P007870,P010568,0 days 00:13:56,9,33,24
32,PAM,P003960,P012740,0 days 00:13:09,12,32,20
32,PAM,P010393,P010568,0 days 00:13:06,-3,20,23
32,PAM,P000556,P012740,0 days 00:12:47,7,25,18
32,PAM,P004863,P007870,0 days 00:11:31,-3,24,27
32,PAM,P004863,P006643,0 days 00:11:19,-7,16,23
32,PAM,P006643,P007870,0 days 00:11:17,1,22,21
32,PAM,P004863,P010393,0 days 00:10:29,-10,12,22
32,PAM,P000556,P010393,0 days 00:10:19,-4,14,18
32,PAM,P006643,P012740,0 days 00:10:19,-1,19,20
32,PAM,P004863,P012740,0 days 00:10:16,1,22,21
32,PAM,P000556,P004863,0 days 00:10:13,-9,15,24
32,PAM,P000556,P007870,0 days 00:10:07,-1,20,21
32,PAM,P010393,P012739,0 days 00:09:55,-1,15,16
32,PAM,P000556,P003960,0 days 00:09:48,2,20,18
32,PAM,P004863,P012738,0 days 00:09:14,-7,11,18
32,PAM,P004863,P010568,0 days 00:09:13,-2,16,18
32,PAM,P003960,P006643,0 days 00:09:12,4,21,17
32,PAM,P006643,P010568,0 days 00:08:56,1,20,19
32,PAM,P010393,P012740,0 days 00:08:36,2,17,15
32,PAM,P003960,P004863,0 days 00:08:09,5,21,16
32,PAM,P000556,P012739,0 days 00:08:01,-3,12,15
32,PAM,P006643,P010393,0 days 00:07:27,-5,12,17
32,PAM,P006643,P012738,0 days 00:07:26,-4,12,16
32,PAM,P010568,P012739,0 days 00:06:57,0,11,11
32,PAM,P006643,P009101,0 days 00:06:16,-3,11,14
32,PAM,P012739,P012740,0 days 00:06:12,-1,10,11
32,PAM,P004863,P012739,0 days 00:05:36,-7,6,13
32,PAM,P012738,P012740,0 days 00:05:14,-5,7,12
32,PAM,P010568,P012738,0 days 00:05:11,-1,7,8
32,PAM,P010393,P012738,0 days 00:05:04,-2,6,8
32,PAM,P007870,P009101,0 days 00:04:57,-6,10,16
32,PAM,P007870,P012738,0 days 00:04:51,-2,8,10
32,PAM,P009101,P010568,0 days 00:04:19,-1,10,11
32,PAM,P003960,P009101,0 days 00:03:08,-2,7,9
32,PAM,P000556,P012738,0 days 00:02:59,-2,2,4
32,PAM,P003960,P010393,0 days 00:02:46,1,7,6
32,PAM,P004863,P009101,0 days 00:02:44,-9,1,10
32,PAM,P009101,P010393,0 days 00:02:44,-9,1,10
32,PAM,P006643,P012739,0 days 00:02:43,-2,3,5
32,PAM,P009101,P012739,0 days 00:02:06,-4,1,5
32,PAM,P009101,P012738,0 days 00:01:11,1,3,2
32,PAM,P003960,P012739,0 days 00:00:56,0,2,2
32,PAM,P000556,P009101,0 days 00:00:47,-7,0,7
32,PAM,P007870,P010393,0 days 00:00:38,-5,0,5
32,PAM,P012738,P012739,0 days 00:00:30,-2,0,2
32,PAM,P000556,P006643,0 days 00:00:01,0,0,0
33,MCO,P005985,P011226,0 days 00:23:03,13,52,39
33,MCO,P010588,P011226,0 days 00:19:46,17,41,24
33,MCO,P005985,P010588,0 days 00:17:10,20,40,20
33,MCO,P010588,PLCZ,0 days 00:14:50,16,34,18
33,MCO,P011226,PLCZ,0 days 00:14:50,16,34,18
33,MCO,P005985,PLCZ,0 days 00:14:22,19,33,14
33,MCO,P008099,P010588,0 days 00:14:17,9,22,13
33,MCO,P008099,P011226,0 days 00:14:17,9,22,13
33,MCO,P011196,P011212,0 days 00:13:04,3,29,26
33,MCO,P011212,P012709,0 days 00:12:42,5,31,26
33,MCO,P004790,P011212,0 days 00:12:20,-1,20,21
33,MCO,P008099,PLCZ,0 days 00:12:05,9,22,13
33,MCO,P005985,P008099,0 days 00:11:37,12,21,9
33,MCO,P011196,P012709,0 days 00:11:22,7,29,22
33,MCO,P011212,P011226,0 days 00:11:19,-5,18,23
33,MCO,P005985,P011212,0 days 00:10:11,-3,19,22
33,MCO,P004790,P011226,0 days 00:09:55,-5,16,21
33,MCO,P011212,P011231,0 days 00:09:17,-2,22,24
33,MCO,P004197,P011231,0 days 00:09:12,4,28,24
33,MCO,P004790,P011196,0 days 00:08:38,-5,15,20
33,MCO,P004197,P011196,0 days 00:08:37,3,26,23
33,MCO,P011196,P011226,0 days 00:08:31,-7,17,24
33,MCO,P005985,P011196,0 days 00:08:29,-3,16,19
33,MCO,P011196,P011231,0 days 00:08:03,6,24,18
33,MCO,P004790,P005985,0 days 00:07:45,-1,15,16
33,MCO,P004197,P005985,0 days 00:07:31,-1,22,23
33,MCO,P004197,P011212,0 days 00:07:22,1,20,19
33,MCO,P004790,P012709,0 days 00:06:51,0,13,13
33,MCO,P004197,P011226,0 days 00:06:28,0,21,21
33,MCO,P011231,P012709,0 days 00:05:51,5,18,13
33,MCO,P004197,P012709,0 days 00:05:51,5,18,13
33,MCO,P005985,P011231,0 days 00:05:45,-6,12,18
33,MCO,P010588,P011212,0 days 00:05:22,3,9,6
33,MCO,P004790,P010588,0 days 00:05:00,1,7,6
33,MCO,P011226,P011231,0 days 00:04:39,-4,10,14
33,MCO,P011226,P012709,0 days 00:03:41,-3,7,10
33,MCO,P002581,P011212,0 days 00:03:29,-7,6,13
33,MCO,P002581,P011231,0 days 00:03:29,-7,6,13
33,MCO,P005985,P012709,0 days 00:03:10,3,6,3
33,MCO,P004197,PLCZ,0 days 00:02:51,2,11,9
33,MCO,P004197,P010588,0 days 00:02:51,2,11,9
33,MCO,P002581,P004197,0 days 00:02:22,-4,4,8
33,MCO,P004790,P008099,0 days 00:02:12,0,0,0
33,MCO,P008099,P011212,0 days 00:02:12,0,0,0
33,MCO,P002581,P005985,0 days 00:02:09,-5,4,9
33,MCO,P004197,P004790,0 days 00:01:47,-5,2,7
33,MCO,P002581,P012709,0 days 00:01:20,-2,2,4
33,MCO,P002581,P011226,0 days 00:01:07,-3,2,5
33,MCO,P004197,P008099,0 days 00:00:28,-3,1,4
33,MCO,P011212,PLCZ,0 days 00:00:22,2,2,0
33,MCO,P004790,P011231,0 days 00:00:04,0,0,0
33,MCO,P010588,P011231,0 days 00:00:04,0,0,0
33,BER,P003958,P008967,0 days 00:21:04,-16,29,45
33,BER,P008211,P012720,0 days 00:20:08,5,45,40
33,BER,P008173,P008967,0 days 00:19:19,-14,30,44
33,BER,P003958,P006919,0 days 00:18:13,-10,25,35
33,BER,P003958,P008173,0 days 00:17:03,-15,25,40
33,BER,P006919,P008967,0 days 00:16:52,-5,23,28
33,BER,P006919,P008173,0 days 00:14:45,-10,19,29
33,BER,P012720,P012721,0 days 00:14:17,-1,32,33
33,BER,P008211,P012721,0 days 00:13:22,2,30,28
33,BER,P003958,P012720,0 days 00:12:06,-14,19,33
33,BER,P008967,P012720,0 days 00:11:00,-9,18,27
33,BER,P006251,P008967,0 days 00:10:42,-4,18,22
33,BER,P006919,P012720,0 days 00:10:03,-2,20,22
33,BER,P008384,P012720,0 days 00:08:16,5,21,16
33,BER,P006819,P008384,0 days 00:08:10,10,23,13
33,BER,P008211,P008384,0 days 00:08:07,5,21,16
33,BER,P003958,P008211,0 days 00:08:03,-6,12,18
33,BER,P006251,P006919,0 days 00:07:46,-4,11,15
33,BER,P006251,P008173,0 days 00:07:46,-4,11,15
33,BER,P006251,P008211,0 days 00:07:36,2,19,17
33,BER,P006251,P012720,0 days 00:07:36,2,19,17
33,BER,P006251,P012721,0 days 00:07:36,2,19,17
33,BER,P006819,P008173,0 days 00:07:23,0,12,12
33,BER,P008211,P008967,0 days 00:07:21,-3,11,14
33,BER,P003958,P006819,0 days 00:07:14,0,12,12
33,BER,P006819,P008967,0 days 00:07:14,0,12,12
33,BER,P008173,P008384,0 days 00:07:01,-4,14,18
33,BER,P008384,P012721,0 days 00:06:59,0,15,15
33,BER,P008384,P008967,0 days 00:06:52,-4,14,18
33,BER,P006919,P008211,0 days 00:06:46,3,15,12
33,BER,P008967,P012721,0 days 00:06:16,-13,9,22
33,BER,P003958,P008384,0 days 00:05:31,-6,11,17
33,BER,P003958,P006251,0 days 00:05:06,-3,6,9
33,BER,P007025,P012720,0 days 00:05:04,1,13,12
33,BER,P006251,P008384,0 days 00:04:59,-2,10,12
33,BER,P007025,P008211,0 days 00:04:40,3,13,10
33,BER,P006819,P012720,0 days 00:04:38,9,14,5
33,BER,P006919,P008384,0 days 00:04:37,0,11,11
33,BER,P006819,P008211,0 days 00:04:29,9,14,5
33,BER,P006819,P006919,0 days 00:04:20,3,7,4
33,BER,P008173,P012720,0 days 00:04:12,-8,7,15
33,BER,P006819,P012721,0 days 00:04:00,5,10,5
33,BER,P003958,P012721,0 days 00:03:21,-12,3,15
33,BER,P003958,P007025,0 days 00:02:43,-2,6,8
33,BER,P006919,P007025,0 days 00:02:42,-3,5,8
33,BER,P007025,P012721,0 days 00:02:22,4,8,4
33,BER,P006251,P007025,0 days 00:02:21,3,7,4
33,BER,P008173,P012721,0 days 00:01:35,-7,2,9
33,BER,P007025,P008173,0 days 00:00:24,-2,0,2
34,BAR,P007464,P012745,0 days 00:22:04,16,53,37
34,BAR,P007519,P012745,0 days 00:19:43,17,49,32
34,BAR,P007464,P009992,0 days 00:18:46,15,44,29
34,BAR,P007464,P007519,0 days 00:18:28,13,45,32
34,BAR,P009992,P012745,0 days 00:18:02,15,44,29
34,BAR,P004866,P011244,0 days 00:15:57,19,41,22
34,BAR,P003196,P007464,0 days 00:15:49,12,32,20
34,BAR,P003196,P012745,0 days 00:15:49,12,32,20
34,BAR,P002939,P011244,0 days 00:14:51,11,33,22
34,BAR,P007519,P009992,0 days 00:14:26,12,36,24
34,BAR,P002939,P004866,0 days 00:14:07,11,33,22
34,BAR,P003196,P007519,0 days 00:14:03,17,32,15
34,BAR,P004866,P006435,0 days 00:13:58,18,37,19
34,BAR,P006435,P011244,0 days 00:13:58,18,37,19
34,BAR,P002939,P006435,0 days 00:12:08,10,29,19
34,BAR,P000925,P004866,0 days 00:11:58,14,31,17
34,BAR,P003196,P009992,0 days 00:11:47,11,23,12
34,BAR,P000925,P002939,0 days 00:10:43,10,27,17
34,BAR,P000925,P011244,0 days 00:10:43,10,27,17
34,BAR,P000925,P006435,0 days 00:10:43,10,27,17
34,BAR,P009992,P010641,0 days 00:08:58,5,25,20
34,BAR,P007464,P010641,0 days 00:06:59,4,21,17
34,BAR,P002939,P009992,0 days 00:06:19,4,12,8
34,BAR,P007519,P010641,0 days 00:06:15,4,21,17
34,BAR,P010641,P012745,0 days 00:06:15,4,21,17
34,BAR,P003478,P007519,0 days 00:05:17,5,13,8
34,BAR,P003478,P012745,0 days 00:05:17,5,13,8
34,BAR,P002939,P007464,0 days 00:04:20,3,8,5
34,BAR,P010641,P011244,0 days 00:04:08,1,6,5
34,BAR,P002939,P010641,0 days 00:04:08,1,6,5
34,BAR,P003478,P007464,0 days 00:04:02,1,9,8
34,BAR,P003196,P003478,0 days 00:04:02,1,9,8
34,BAR,P002939,P012745,0 days 00:03:36,3,8,5
34,BAR,P002939,P003196,0 days 00:03:36,3,8,5
34,BAR,P004866,P010641,0 days 00:03:24,1,6,5
34,BAR,P004866,P007519,0 days 00:03:05,12,12,0
34,BAR,P009992,P011244,0 days 00:02:43,1,4,3
34,BAR,P004866,P009992,0 days 00:01:59,1,4,3
34,BAR,P003196,P004866,0 days 00:01:50,8,8,0
34,BAR,P003196,P006435,0 days 00:01:50,8,8,0
34,BAR,P003196,P011244,0 days 00:01:50,8,8,0
34,BAR,P006435,P007519,0 days 00:01:50,8,8,0
34,BAR,P007519,P011244,0 days 00:01:50,8,8,0
34,BAR,P006435,P010641,0 days 00:01:25,0,2,2
34,BAR,P000925,P003478,0 days 00:01:15,4,4,0
34,BAR,P000925,P007519,0 days 00:01:15,4,4,0
34,BAR,P000925,P012745,0 days 00:01:15,4,4,0
34,BAR,P003478,P004866,0 days 00:01:15,4,4,0
34,BAR,P004866,P012745,0 days 00:01:15,4,4,0
34,BAR,P007464,P011244,0 days 00:00:44,0,0,0
34,MUN,P003583,P004508,0 days 00:19:43,-12,32,44
34,MUN,P001557,P004508,0 days 00:16:07,-9,25,34
34,MUN,P001557,P003583,0 days 00:13:42,-10,20,30
34,MUN,P001557,P007975,0 days 00:12:45,-17,16,33
34,MUN,P004508,P010391,0 days 00:12:45,-5,21,26
34,MUN,P001557,P010391,0 days 00:12:42,-6,16,22
34,MUN,P003583,P007975,0 days 00:11:35,-11,21,32
34,MUN,P008985,P010391,0 days 00:10:43,-2,19,21
34,MUN,P008985,P011941,0 days 00:10:28,-17,12,29
34,MUN,P003583,P010391,0 days 00:10:27,-2,23,25
34,MUN,P004508,P007975,0 days 00:10:02,-7,14,21
34,MUN,P001557,P008985,0 days 00:09:27,-1,14,15
34,MUN,P010391,P011987,0 days 00:09:17,-10,13,23
34,MUN,P007975,P010391,0 days 00:09:14,-9,12,21
34,MUN,P006760,P010391,0 days 00:08:58,-5,20,25
34,MUN,P003583,P006760,0 days 00:08:49,-6,19,25
34,MUN,P010391,P011941,0 days 00:08:46,-10,11,21
34,MUN,P004508,P008985,0 days 00:08:24,-6,11,17
34,MUN,P008985,P011987,0 days 00:08:23,-13,10,23
34,MUN,P007056,P011987,0 days 00:08:17,-12,11,23
34,MUN,P011941,P011987,0 days 00:08:12,-17,8,25
34,MUN,P004508,P006760,0 days 00:07:59,-6,12,18
34,MUN,P003583,P006245,0 days 00:07:45,-2,19,21
34,MUN,P006245,P006760,0 days 00:07:45,-2,19,21
34,MUN,P001557,P005460,0 days 00:07:40,-13,8,21
34,MUN,P003583,P005460,0 days 00:07:21,-10,7,17
34,MUN,P007056,P007975,0 days 00:06:44,-2,13,15
34,MUN,P004508,P005460,0 days 00:06:38,-6,7,13
34,MUN,P007056,P008985,0 days 00:06:16,-14,7,21
34,MUN,P007056,P011941,0 days 00:06:16,-14,7,21
34,MUN,P006245,P010391,0 days 00:06:15,-4,17,21
34,MUN,P001557,P007056,0 days 00:06:08,-4,11,15
34,MUN,P001557,P011987,0 days 00:06:05,-9,5,14
34,MUN,P006760,P011941,0 days 00:05:56,-13,3,16
34,MUN,P004508,P006245,0 days 00:05:40,-2,12,14
34,MUN,P005460,P007975,0 days 00:05:26,-11,5,16
34,MUN,P007975,P011987,0 days 00:05:26,-11,5,16
34,MUN,P006760,P011987,0 days 00:05:17,-11,5,16
34,MUN,P003583,P008985,0 days 00:05:16,-3,6,9
34,MUN,P006760,P008985,0 days 00:04:53,-14,2,16
34,MUN,P006760,P007975,0 days 00:04:48,-1,10,11
34,MUN,P004508,P007056,0 days 00:04:43,-4,9,13
34,MUN,P003583,P007056,0 days 00:04:43,-4,9,13
34,MUN,P007056,P010391,0 days 00:04:28,-2,9,11
34,MUN,P006760,P007056,0 days 00:04:25,-8,4,12
34,MUN,P004508,P011941,0 days 00:04:23,-3,5,8
34,MUN,P001557,P011941,0 days 00:04:12,-3,5,8
34,MUN,P005460,P011987,0 days 00:03:36,-9,3,12
34,MUN,P005460,P008985,0 days 00:03:18,-6,3,9
34,MUN,P005460,P010391,0 days 00:02:53,-5,3,8
34,MUN,P005460,P006760,0 days 00:02:34,-2,2,4
34,MUN,P007975,P011941,0 days 00:02:07,-3,1,4
34,MUN,P006245,P007975,0 days 00:02:05,0,7,7
34,MUN,P005460,P006245,0 days 00:01:30,2,2,0
34,MUN,P003583,P011987,0 days 00:00:43,-4,0,4
35,PAN,P001926,P002328,0 days 00:25:48,3,50,47
35,PAN,P002328,P007866,0 days 00:20:19,10,37,27
35,PAN,P001926,P007866,0 days 00:20:17,4,32,28
35,PAN,P007866,P007947,0 days 00:20:00,0,32,32
35,PAN,P002328,P007947,0 days 00:19:07,4,43,39
35,PAN,P002328,P003842,0 days 00:15:45,7,32,25
35,PAN,P001926,P011204,0 days 00:15:17,-2,25,27
35,PAN,P001926,P007947,0 days 00:15:15,-11,23,34
35,PAN,P002328,P011204,0 days 00:15:07,7,29,22
35,PAN,P003842,P007947,0 days 00:14:39,-10,27,37
35,PAN,P007947,P011221,0 days 00:13:10,-1,24,25
35,PAN,P007866,P011221,0 days 00:13:04,3,24,21
35,PAN,P001926,P011221,0 days 00:12:44,-2,21,23
35,PAN,P003842,P011204,0 days 00:11:36,2,19,17
35,PAN,P003842,P007866,0 days 00:11:24,4,18,14
35,PAN,P001926,P003842,0 days 00:10:55,-1,16,17
35,PAN,P002328,P011221,0 days 00:10:12,-2,23,25
35,PAN,P002328,P012712,0 days 00:09:14,-1,26,27
35,PAN,P003842,P011209,0 days 00:08:58,3,20,17
35,PAN,P001926,P012712,0 days 00:08:53,-7,16,23
35,PAN,P001926,P007553,0 days 00:08:29,-1,16,17
35,PAN,P002328,P007553,0 days 00:08:29,-1,16,17
35,PAN,P007553,P011204,0 days 00:08:29,-1,16,17
35,PAN,P007947,P012712,0 days 00:08:26,-8,15,23
35,PAN,P007866,P011204,0 days 00:08:23,5,12,7
35,PAN,P007947,P011204,0 days 00:07:46,-4,10,14
35,PAN,P011204,P012712,0 days 00:07:34,-5,15,20
35,PAN,P003842,P008084,0 days 00:07:05,-1,12,13
35,PAN,P002328,P011209,0 days 00:06:43,2,19,17
35,PAN,P007947,P011209,0 days 00:06:22,4,18,14
35,PAN,P003842,P012712,0 days 00:06:20,-6,14,20
35,PAN,P007553,P012712,0 days 00:05:58,0,15,15
35,PAN,P003842,P011826,0 days 00:05:29,-4,6,10
35,PAN,P008084,P011204,0 days 00:05:26,1,8,7
35,PAN,P011209,P012712,0 days 00:05:04,-2,13,15
35,PAN,P001926,P008084,0 days 00:04:59,-1,6,7
35,PAN,P002328,P008084,0 days 00:04:58,-2,8,10
35,PAN,P007866,P011209,0 days 00:03:34,10,10,0
35,PAN,P001926,P011209,0 days 00:03:34,2,5,3
35,PAN,P007866,P012712,0 days 00:03:29,-2,4,6
35,PAN,P008084,P011826,0 days 00:03:19,-1,4,5
35,PAN,P007947,P011826,0 days 00:03:18,-8,4,12
35,PAN,P007947,P008084,0 days 00:03:09,-2,8,10
35,PAN,P011204,P011826,0 days 00:02:50,-1,4,5
35,PAN,P011221,P012712,0 days 00:02:25,-5,1,6
35,PAN,P008084,P011209,0 days 00:02:23,-7,2,9
35,PAN,P001926,P011826,0 days 00:02:21,0,2,2
35,PAN,P007866,P011826,0 days 00:02:10,-3,2,5
35,PAN,P002328,P011826,0 days 00:01:58,-3,1,4
35,PAN,P007553,P007866,0 days 00:01:36,1,1,0
35,PAN,P011204,P011209,0 days 00:01:25,2,2,0
35,PAN,P011204,P011221,0 days 00:01:11,0,0,0
35,PAN,P007553,P008084,0 days 00:00:55,-2,0,2
35,PAN,P011826,P012712,0 days 00:00:46,-2,1,3
35,PAN,P011209,P011221,0 days 00:00:45,-2,3,5
35,PAN,P008084,P012712,0 days 00:00:43,-6,0,6
35,PAN,P008084,P011221,0 days 00:00:19,-3,0,3
35,PAN,P011221,P011826,0 days 00:00:05,-2,0,2
35,PAN,P003842,P011221,0 days 00:00:01,-2,0,2
35,TEL,P009622,P009783,0 days 00:32:54,4,61,57
35,TEL,P009622,P011199,0 days 00:28:42,9,52,43
35,TEL,P009783,P011199,0 days 00:26:09,4,47,43
35,TEL,P007990,P009783,0 days 00:20:25,-5,36,41
35,TEL,P007990,P009622,0 days 00:20:18,3,37,34
35,TEL,P007990,P011199,0 days 00:19:29,-1,31,32
35,TEL,P005145,P009622,0 days 00:17:37,4,34,30
35,TEL,P005145,P011199,0 days 00:17:24,2,32,30
35,TEL,P009783,P011193,0 days 00:17:03,4,35,31
35,TEL,P005145,P009783,0 days 00:16:48,-1,29,30
35,TEL,P005145,P007990,0 days 00:15:23,-3,27,30
35,TEL,P009622,P011193,0 days 00:15:00,5,31,26
35,TEL,P011193,P011219,0 days 00:13:41,-9,23,32
35,TEL,P011193,P011214,0 days 00:10:39,0,23,23
35,TEL,P009783,P011214,0 days 00:10:21,2,22,20
35,TEL,P011214,P011219,0 days 00:10:12,-2,21,23
35,TEL,P011193,P012744,0 days 00:10:11,1,20,19
35,TEL,P009622,P012744,0 days 00:10:10,4,20,16
35,TEL,P009622,P011214,0 days 00:09:25,5,18,13
35,TEL,P011199,P012744,0 days 00:08:54,8,19,11
35,TEL,P009783,P011219,0 days 00:08:15,-8,13,21
35,TEL,P011193,P011199,0 days 00:08:08,5,15,10
35,TEL,P009783,P012744,0 days 00:07:37,-1,15,16
35,TEL,P007990,P011214,0 days 00:07:28,-1,15,16
35,TEL,P007990,P011193,0 days 00:06:57,-1,18,19
35,TEL,P011214,P012744,0 days 00:06:29,-1,10,11
35,TEL,P007990,P011219,0 days 00:06:22,-3,15,18
35,TEL,P011219,P012744,0 days 00:06:19,-3,11,14
35,TEL,P009622,P011219,0 days 00:06:12,-7,9,16
35,TEL,P007990,P012744,0 days 00:04:49,5,10,5
35,TEL,P011193,P011971,0 days 00:04:38,7,13,6
35,TEL,P004233,P011193,0 days 00:04:15,1,7,6
35,TEL,P004233,P011219,0 days 00:03:41,-1,5,6
35,TEL,P004233,P009622,0 days 00:03:35,1,6,5
35,TEL,P004233,P011971,0 days 00:03:24,-1,5,6
35,TEL,P011199,P011214,0 days 00:03:20,2,6,4
35,TEL,P011219,P011971,0 days 00:03:16,1,5,4
35,TEL,P004233,P011199,0 days 00:03:05,-1,4,5
35,TEL,P005145,P011193,0 days 00:03:04,3,7,4
35,TEL,P004233,P009783,0 days 00:02:58,3,6,3
35,TEL,P004233,P007990,0 days 00:02:49,-1,4,5
35,TEL,P004233,P012744,0 days 00:02:47,1,5,4
35,TEL,P011971,P012744,0 days 00:02:47,1,5,4
35,TEL,P009622,P011971,0 days 00:01:59,4,8,4
35,TEL,P009783,P011971,0 days 00:01:22,6,8,2
35,TEL,P011214,P011971,0 days 00:01:18,1,5,4
35,TEL,P005145,P012744,0 days 00:00:49,5,5,0
35,TEL,P004233,P005145,0 days 00:00:26,0,2,2
35,TEL,P005145,P011219,0 days 00:00:25,-2,0,2
35,TEL,P007990,P011971,0 days 00:00:12,3,3,0
35,TEL,P005145,P011214,0 days 00:00:12,0,0,0
35,TEL,P004233,P011214,0 days 00:00:08,-2,0,2
35,TEL,P011199,P011971,0 days 00:00:08,-2,0,2
35,TEL,P011199,P011219,0 days 00:00:01,2,2,0
36,VIR,P001133,PBCN,0 days 00:22:15,4,43,39
36,VIR,P001133,P009549,0 days 00:22:05,-2,47,49
36,VIR,P008847,P009549,0 days 00:18:23,-7,38,45
36,VIR,P009549,PBCN,0 days 00:18:02,6,41,35
36,VIR,P001133,P001844,0 days 00:17:00,-1,33,34
36,VIR,P001133,P008847,0 days 00:16:46,-16,27,43
36,VIR,P008847,P010781,0 days 00:15:53,-10,22,32
36,VIR,P001844,PBCN,0 days 00:15:17,7,34,27
36,VIR,P006739,P008847,0 days 00:14:52,2,34,32
36,VIR,P008847,PBCN,0 days 00:13:46,3,31,28
36,VIR,P001133,P003048,0 days 00:12:47,13,32,19
36,VIR,P001844,P009549,0 days 00:11:38,3,28,25
36,VIR,P009549,P010781,0 days 00:11:23,-6,21,27
36,VIR,P003048,P009549,0 days 00:10:59,4,24,20
36,VIR,P001133,P010781,0 days 00:10:08,-5,20,25
36,VIR,P003048,PBCN,0 days 00:09:47,7,20,13
36,VIR,P003048,P010781,0 days 00:09:46,12,25,13
36,VIR,P006739,P010781,0 days 00:09:45,-4,16,20
36,VIR,P001844,P003048,0 days 00:09:33,5,18,13
36,VIR,P006739,P009549,0 days 00:09:18,-3,23,26
36,VIR,P004007,P008847,0 days 00:07:54,-8,14,22
36,VIR,P001844,P008847,0 days 00:07:54,-3,20,23
36,VIR,P001133,P004007,0 days 00:07:36,-6,12,18
36,VIR,P003048,P004007,0 days 00:07:01,10,16,6
36,VIR,P001844,P004007,0 days 00:06:45,-3,12,15
36,VIR,P003048,P008847,0 days 00:06:32,4,11,7
36,VIR,P010781,P011192,0 days 00:06:29,11,17,6
36,VIR,P001133,P006739,0 days 00:05:39,-7,8,15
36,VIR,P003048,P011192,0 days 00:05:33,9,15,6
36,VIR,P004007,P010781,0 days 00:05:29,-1,10,11
36,VIR,P003048,P006739,0 days 00:05:18,4,11,7
36,VIR,P004007,P006739,0 days 00:04:53,1,12,11
36,VIR,P004007,PBCN,0 days 00:04:35,2,8,6
36,VIR,P006739,PBCN,0 days 00:04:34,7,14,7
36,VIR,P009549,P011192,0 days 00:04:14,6,12,6
36,VIR,P010781,PBCN,0 days 00:03:59,-1,6,7
36,VIR,P001133,P011192,0 days 00:03:56,8,14,6
36,VIR,P008847,P011192,0 days 00:03:29,5,5,0
36,VIR,P009549,P012714,0 days 00:03:23,2,10,8
36,VIR,P008847,P012714,0 days 00:03:23,2,10,8
36,VIR,P006739,P012714,0 days 00:03:23,2,10,8
36,VIR,P010781,P012714,0 days 00:02:22,-1,5,6
36,VIR,P006739,P011192,0 days 00:01:19,3,3,0
36,VIR,P004007,P009549,0 days 00:01:19,-3,4,7
36,VIR,P001844,P010781,0 days 00:01:14,-3,2,5
36,VIR,P012714,PBCN,0 days 00:01:01,3,5,2
36,VIR,P011192,PBCN,0 days 00:00:56,2,2,0
36,VIR,P001844,P006739,0 days 00:00:27,3,5,2
36,RED,P009035,P011224,0 days 00:25:25,0,52,52
36,RED,P006436,P009035,0 days 00:20:55,-6,41,47
36,RED,P009035,PJDR,0 days 00:19:35,11,43,32
36,RED,P002553,P005099,0 days 00:18:23,-3,36,39
36,RED,P006436,P011224,0 days 00:17:18,-5,36,41
36,RED,P011224,PJDR,0 days 00:15:58,2,39,37
36,RED,P002553,PJDR,0 days 00:15:56,-3,38,41
36,RED,P002553,P009035,0 days 00:14:21,-3,32,35
36,RED,P002553,P011224,0 days 00:13:19,-4,33,37
36,RED,P005099,PJDR,0 days 00:11:59,-1,25,26
36,RED,P006436,PJDR,0 days 00:11:51,1,28,27
36,RED,P011224,PLUO,0 days 00:11:41,-2,18,20
36,RED,P007960,P011224,0 days 00:11:38,2,19,17
36,RED,P007960,P009035,0 days 00:11:34,-3,18,21
36,RED,P009035,PLUO,0 days 00:11:14,-5,17,22
36,RED,P007960,PLUO,0 days 00:11:07,0,18,18
36,RED,P005099,P009035,0 days 00:10:09,2,19,17
36,RED,P005099,P011224,0 days 00:09:22,-2,20,22
36,RED,P012711,PJDR,0 days 00:08:30,-2,18,20
36,RED,P006436,P007960,0 days 00:07:54,-6,11,17
36,RED,P002553,P006436,0 days 00:07:37,-8,20,28
36,RED,P000848,P007960,0 days 00:06:05,-2,9,11
36,RED,P007960,PJDR,0 days 00:06:04,3,9,6
36,RED,P011224,P012711,0 days 00:05:51,5,12,7
36,RED,P009035,P012711,0 days 00:05:51,5,12,7
36,RED,P006436,P012711,0 days 00:05:51,5,12,7
36,RED,P000848,P009035,0 days 00:05:16,-3,9,12
36,RED,P005099,PLUO,0 days 00:05:13,1,9,8
36,RED,P002553,PLUO,0 days 00:05:13,1,9,8
36,RED,P005099,P007960,0 days 00:04:57,3,7,4
36,RED,P002553,P007960,0 days 00:04:57,3,7,4
36,RED,P006436,PLUO,0 days 00:04:54,-6,6,12
36,RED,P000848,P006436,0 days 00:04:40,-3,9,12
36,RED,P000848,PJDR,0 days 00:04:25,-7,8,15
36,RED,P000848,P002553,0 days 00:04:09,-10,8,18
36,RED,P000848,P005099,0 days 00:03:54,-7,8,15
36,RED,PJDR,PLUO,0 days 00:03:40,3,7,4
36,RED,P002553,P012044,0 days 00:03:35,0,5,5
36,RED,P005099,P006436,0 days 00:03:25,-3,7,10
36,RED,P005099,P012044,0 days 00:03:20,3,5,2
36,RED,P012044,PJDR,0 days 00:03:06,5,5,0
36,RED,P002553,P012711,0 days 00:02:50,-5,8,13
36,RED,P005099,P012711,0 days 00:02:50,-5,8,13
36,RED,P000848,P012711,0 days 00:02:50,-5,8,13
36,RED,P009035,P012044,0 days 00:02:44,-2,5,7
36,RED,P000848,P011224,0 days 00:02:37,2,5,3
36,RED,P000848,PLUO,0 days 00:02:06,0,4,4
36,RED,P007960,P012044,0 days 00:01:48,0,2,2
36,RED,P006436,P012044,0 days 00:01:03,-5,2,7
36,RED,P000848,P012044,0 days 00:00:38,-5,0,5
36,RED,P011224,P012044,0 days 00:00:11,2,2,0
36,RED,P012044,P012711,0 days 00:00:11,2,2,0
37,BER,P003958,P006919,0 days 00:25:24,14,62,48
37,BER,P003958,P012720,0 days 00:22:35,22,58,36
37,BER,P006919,P012720,0 days 00:19:01,19,50,31
37,BER,P003958,P008173,0 days 00:19:00,7,41,34
37,BER,P006919,P008173,0 days 00:17:35,6,38,32
37,BER,P008211,P012720,0 days 00:14:55,11,40,29
37,BER,P003958,P008967,0 days 00:14:21,6,36,30
37,BER,P008173,P012720,0 days 00:12:53,10,29,19
37,BER,P008211,P010791,0 days 00:12:14,8,30,22
37,BER,P010791,P012720,0 days 00:12:10,6,31,25
37,BER,P006919,P008967,0 days 00:11:38,6,31,25
37,BER,P003958,P008211,0 days 00:10:46,8,29,21
37,BER,P006251,P008384,0 days 00:09:33,-18,13,31
37,BER,P006251,P012720,0 days 00:09:20,-4,20,24
37,BER,P003958,P006819,0 days 00:09:11,0,15,15
37,BER,P006819,P008173,0 days 00:09:11,0,15,15
37,BER,P008173,P008967,0 days 00:08:39,-2,19,21
37,BER,P006919,P008211,0 days 00:08:05,8,24,16
37,BER,P006819,P006919,0 days 00:08:04,-3,12,15
37,BER,P003958,P010791,0 days 00:07:50,7,20,13
37,BER,P003958,P006251,0 days 00:07:46,-3,16,19
37,BER,P008211,P008967,0 days 00:07:33,8,19,11
37,BER,P008967,P012720,0 days 00:07:32,13,24,11
37,BER,P006251,P008967,0 days 00:07:11,-13,9,22
37,BER,P006251,P006919,0 days 00:06:58,1,16,15
37,BER,P006251,P008211,0 days 00:06:50,-12,11,23
37,BER,P008211,P008384,0 days 00:06:34,-3,13,16
37,BER,P008384,P012720,0 days 00:06:14,0,14,14
37,BER,P006251,P008173,0 days 00:06:09,6,16,10
37,BER,P006819,P012720,0 days 00:05:54,7,10,3
37,BER,P008384,P010791,0 days 00:05:42,1,13,12
37,BER,P006919,P010791,0 days 00:05:39,5,15,10
37,BER,P008384,P008967,0 days 00:05:33,-13,4,17
37,BER,P008967,P012721,0 days 00:05:23,-11,4,15
37,BER,P008384,P012721,0 days 00:05:01,-11,4,15
37,BER,P006251,P010791,0 days 00:04:35,-1,11,12
37,BER,P008967,P010791,0 days 00:04:17,4,7,3
37,BER,P006251,P012721,0 days 00:04:10,-13,2,15
37,BER,P007550,P012721,0 days 00:03:32,-11,2,13
37,BER,P007550,P008967,0 days 00:03:32,-11,2,13
37,BER,P007550,P008384,0 days 00:03:32,-11,2,13
37,BER,P006251,P007550,0 days 00:03:32,-11,2,13
37,BER,P006819,P008967,0 days 00:03:17,-7,5,12
37,BER,P003958,P008384,0 days 00:02:11,-1,3,4
37,BER,P008211,P012721,0 days 00:01:51,0,2,2
37,BER,P008173,P008384,0 days 00:01:41,1,3,2
37,BER,P008173,P010791,0 days 00:01:40,0,3,3
37,BER,P010791,P012721,0 days 00:01:29,2,2,0
37,BER,P006819,P008384,0 days 00:01:07,3,3,0
37,BER,P012720,P012721,0 days 00:00:38,0,0,0
37,BER,P006919,P012721,0 days 00:00:16,0,0,0
37,BER,P008173,P012721,0 days 00:00:16,0,0,0
37,MIL,P000796,P007831,0 days 00:26:11,-1,56,57
37,MIL,P006433,P007831,0 days 00:21:10,-6,42,48
37,MIL,P000796,P011205,0 days 00:20:37,22,57,35
37,MIL,P000796,P006433,0 days 00:20:14,-2,41,43
37,MIL,P007831,P011205,0 days 00:17:48,14,47,33
37,MIL,P006433,P011205,0 days 00:14:43,6,33,27
37,MIL,P007032,P007831,0 days 00:14:20,-5,32,37
37,MIL,P002849,P007831,0 days 00:13:46,-4,24,28
37,MIL,P007201,P007831,0 days 00:12:18,-9,19,28
37,MIL,P000796,P007201,0 days 00:11:33,6,24,18
37,MIL,P002849,P006433,0 days 00:11:27,-2,19,21
37,MIL,P007201,P011205,0 days 00:11:02,12,26,14
37,MIL,P007032,P007201,0 days 00:10:59,4,24,20
37,MIL,P000796,P007032,0 days 00:10:54,9,31,22
37,MIL,P000796,P002849,0 days 00:10:30,2,20,18
37,MIL,P007831,P009960,0 days 00:10:27,0,18,18
37,MIL,P000796,P009960,0 days 00:10:27,0,18,18
37,MIL,P006433,P009960,0 days 00:10:14,0,18,18
37,MIL,P002812,P007831,0 days 00:09:18,-11,20,31
37,MIL,P007032,P011205,0 days 00:07:27,17,25,8
37,MIL,P002849,P011205,0 days 00:07:24,8,19,11
37,MIL,P002812,P006433,0 days 00:07:18,-12,11,23
37,MIL,P006509,P007201,0 days 00:07:01,-4,10,14
37,MIL,P002812,P007032,0 days 00:07:00,-4,18,22
37,MIL,P006433,P007201,0 days 00:06:28,-7,8,15
37,MIL,P006509,P007032,0 days 00:06:21,-3,12,15
37,MIL,P002849,P007032,0 days 00:06:20,-1,15,16
37,MIL,P002812,P011205,0 days 00:06:13,-7,11,18
37,MIL,P002849,P006509,0 days 00:05:38,-8,9,17
37,MIL,P006509,P011205,0 days 00:05:38,4,11,7
37,MIL,P002849,P009960,0 days 00:05:30,-7,3,10
37,MIL,P006509,P007831,0 days 00:05:19,-11,6,17
37,MIL,P000796,P006509,0 days 00:05:19,1,8,7
37,MIL,P009960,P011205,0 days 00:04:57,7,15,8
37,MIL,P000796,P002812,0 days 00:04:52,-6,13,19
37,MIL,P006433,P007032,0 days 00:04:38,-5,11,16
37,MIL,P006433,P006509,0 days 00:04:36,-4,5,9
37,MIL,P002812,P002849,0 days 00:03:56,-3,7,10
37,MIL,P002812,P006509,0 days 00:03:56,-3,7,10
37,MIL,P002849,P007201,0 days 00:03:45,-1,8,9
37,MIL,P002812,P007201,0 days 00:02:41,-4,3,7
37,MIL,P000796,P005670,0 days 00:02:23,-3,4,7
37,MIL,P005670,P007831,0 days 00:02:23,-3,4,7
37,MIL,P005670,P011205,0 days 00:02:23,-3,4,7
37,MIL,P005670,P007201,0 days 00:01:41,-1,2,3
37,MIL,P002812,P005670,0 days 00:00:42,-2,2,4
37,MIL,P007032,P009960,0 days 00:00:13,0,0,0
38,OLY,P008855,P010612,0 days 00:21:49,8,45,37
38,OLY,P001255,P010612,0 days 00:20:00,13,45,32
38,OLY,P001255,P008855,0 days 00:19:20,10,42,32
38,OLY,P001255,P003941,0 days 00:16:59,13,43,30
38,OLY,P007982,P010392,0 days 00:15:40,12,27,15
38,OLY,P001255,P007982,0 days 00:15:30,18,38,20
38,OLY,P008829,P010612,0 days 00:14:48,8,26,18
38,OLY,P003941,P007982,0 days 00:14:31,18,37,19
38,OLY,P008811,P010612,0 days 00:13:54,2,19,17
38,OLY,P008811,P008829,0 days 00:13:35,1,16,15
38,OLY,P003941,P011983,0 days 00:12:49,4,26,22
38,OLY,P003941,P010612,0 days 00:12:20,11,35,24
38,OLY,P010392,P011983,0 days 00:12:16,10,21,11
38,OLY,P007982,P010612,0 days 00:11:56,10,28,18
38,OLY,P007982,P011983,0 days 00:11:55,10,21,11
38,OLY,P001255,P011983,0 days 00:11:26,8,25,17
38,OLY,P008811,P008855,0 days 00:11:10,1,16,15
38,OLY,P001255,P008811,0 days 00:11:06,8,18,10
38,OLY,P008829,P008855,0 days 00:10:57,3,17,14
38,OLY,P008829,P010392,0 days 00:10:50,0,14,14
38,OLY,P003941,P008855,0 days 00:10:39,7,29,22
38,OLY,P003941,P010392,0 days 00:09:39,13,23,10
38,OLY,P007982,P008811,0 days 00:09:20,2,12,10
38,OLY,P008811,P010392,0 days 00:08:51,-3,7,10
38,OLY,P001255,P008829,0 days 00:08:34,8,17,9
38,OLY,P007982,P008829,0 days 00:08:27,5,14,9
38,OLY,P001255,P010392,0 days 00:07:40,10,16,6
38,OLY,P007982,P008855,0 days 00:07:31,5,19,14
38,OLY,P010392,P010612,0 days 00:06:14,0,9,9
38,OLY,P003941,P008829,0 days 00:05:49,7,15,8
38,OLY,P008829,P011983,0 days 00:04:36,0,5,5
38,OLY,P008811,P011983,0 days 00:04:18,1,4,3
38,OLY,P010612,P011983,0 days 00:03:21,0,9,9
38,OLY,P008855,P011983,0 days 00:03:21,0,9,9
38,OLY,P008855,P010392,0 days 00:02:29,-2,3,5
38,OLY,P003941,P006302,0 days 00:01:51,-5,0,5
38,OLY,P006302,P011983,0 days 00:01:51,-5,0,5
38,OLY,P003941,P012023,0 days 00:01:30,-5,0,5
38,OLY,P011983,P012023,0 days 00:01:30,-5,0,5
38,OLY,P006302,P012023,0 days 00:01:30,-5,0,5
38,OLY,P001255,P006302,0 days 00:01:20,-2,0,2
38,OLY,P010631,P012023,0 days 00:01:05,-3,0,3
38,OLY,P010631,P011983,0 days 00:01:05,-3,0,3
38,OLY,P006302,P010631,0 days 00:01:05,-3,0,3
38,OLY,P003941,P010631,0 days 00:01:05,-3,0,3
38,OLY,P006302,P007982,0 days 00:00:34,0,0,0
38,OLY,P006302,P008811,0 days 00:00:34,0,0,0
38,OLY,P006302,P010612,0 days 00:00:34,0,0,0
38,OLY,P001255,P012023,0 days 00:00:25,-2,0,2
38,OLY,P006302,P010392,0 days 00:00:21,0,0,0
38,IST,P004888,P007200,0 days 00:19:17,-7,32,39
38,IST,P007200,P009846,0 days 00:17:02,-8,25,33
38,IST,P006590,P007200,0 days 00:16:53,-8,28,36
38,IST,P004554,P009664,0 days 00:16:04,-2,26,28
38,IST,P007200,P009664,0 days 00:15:34,-21,20,41
38,IST,P004888,P006590,0 days 00:15:29,-9,24,33
38,IST,P006590,PLHK,0 days 00:15:25,-10,23,33
38,IST,P007200,PLHK,0 days 00:14:47,-8,23,31
38,IST,P004888,P009846,0 days 00:14:37,-11,19,30
38,IST,P006590,P009846,0 days 00:12:44,-4,18,22
38,IST,P009664,P011078,0 days 00:12:23,-2,20,22
38,IST,P004888,P011078,0 days 00:11:58,-5,12,17
38,IST,P006590,P011078,0 days 00:11:57,-5,17,22
38,IST,P004888,P009664,0 days 00:11:43,-2,18,20
38,IST,P009846,PLHK,0 days 00:10:44,-2,16,18
38,IST,P007200,P011078,0 days 00:10:21,-7,16,23
38,IST,P006590,P009664,0 days 00:09:59,-4,15,19
38,IST,P004554,P004888,0 days 00:09:26,-7,13,20
38,IST,P004888,PLHK,0 days 00:09:14,-5,15,20
38,IST,P004554,P011078,0 days 00:09:10,5,16,11
38,IST,P004554,P007200,0 days 00:09:00,-12,11,23
38,IST,P004554,P009846,0 days 00:08:33,-9,12,21
38,IST,P006372,P009846,0 days 00:08:30,-6,9,15
38,IST,P007200,P011981,0 days 00:08:13,1,8,7
38,IST,P009664,P009846,0 days 00:08:04,-7,12,19
38,IST,P004888,P011981,0 days 00:08:02,-4,8,12
38,IST,P011078,PLHK,0 days 00:07:59,-6,11,17
38,IST,P004554,P006372,0 days 00:06:38,-5,11,16
38,IST,P006372,P009664,0 days 00:06:32,-2,11,13
38,IST,P009846,P011981,0 days 00:06:25,-1,3,4
38,IST,P006590,P011981,0 days 00:05:55,-5,5,10
38,IST,P009846,P011078,0 days 00:05:32,0,6,6
38,IST,P006372,P007200,0 days 00:05:21,-6,5,11
38,IST,P004554,P006590,0 days 00:04:00,0,6,6
38,IST,P009664,PLHK,0 days 00:03:42,-9,4,13
38,IST,P006372,P009513,0 days 00:03:39,5,9,4
38,IST,P009513,P009664,0 days 00:03:39,5,9,4
38,IST,P004554,P009513,0 days 00:03:39,5,9,4
38,IST,P006372,P011981,0 days 00:03:34,-2,3,5
38,IST,P004888,P006372,0 days 00:03:34,-2,3,5
38,IST,P011981,PLHK,0 days 00:02:53,0,0,0
38,IST,P009664,P011981,0 days 00:02:52,0,5,5
38,IST,P011078,P011981,0 days 00:02:36,-2,0,2
38,IST,P006372,P011078,0 days 00:02:30,5,5,0
38,IST,P009513,P009846,0 days 00:02:09,0,4,4
38,IST,P009513,P011078,0 days 00:01:30,5,5,0
38,IST,P004554,P011981,0 days 00:00:06,-3,0,3
38,IST,P006372,P006590,0 days 00:00:06,-3,0,3
39,PAR,P004058,P007400,0 days 00:24:34,12,60,48
39,PAR,P008987,P009862,0 days 00:24:05,-1,41,42
39,PAR,P007400,P012743,0 days 00:20:38,0,41,41
39,PAR,P007400,P008987,0 days 00:19:29,4,41,37
39,PAR,P004058,P012743,0 days 00:18:39,2,37,35
39,PAR,P009862,P012743,0 days 00:18:16,1,36,35
39,PAR,P008987,P012743,0 days 00:18:01,-1,33,34
39,PAR,P003983,P008987,0 days 00:17:24,-12,32,44
39,PAR,P007400,P009862,0 days 00:17:21,4,34,30
39,PAR,P004058,P008987,0 days 00:17:09,3,30,27
39,PAR,P003983,P011051,0 days 00:15:26,6,40,34
39,PAR,P004058,P009862,0 days 00:15:02,6,30,24
39,PAR,P003983,P009862,0 days 00:12:55,-9,21,30
39,PAR,P008987,P011051,0 days 00:12:27,-4,23,27
39,PAR,P011051,P012742,0 days 00:12:26,10,36,26
39,PAR,P003983,P012742,0 days 00:12:03,12,38,26
39,PAR,P003983,P007400,0 days 00:11:36,4,35,31
39,PAR,P009862,P011051,0 days 00:08:50,-2,15,17
39,PAR,P008987,P012742,0 days 00:08:30,1,18,17
39,PAR,P000956,P009862,0 days 00:08:29,-11,16,27
39,PAR,P003983,P004058,0 days 00:08:01,5,24,19
39,PAR,P007400,P011051,0 days 00:07:30,9,28,19
39,PAR,P000956,P008987,0 days 00:07:24,-8,14,22
39,PAR,P004058,P011051,0 days 00:07:10,8,23,15
39,PAR,P000956,P004058,0 days 00:06:38,-3,16,19
39,PAR,P007400,P012742,0 days 00:06:04,10,27,17
39,PAR,P000956,P012743,0 days 00:06:04,-5,15,20
39,PAR,P004058,P012742,0 days 00:06:03,7,20,13
39,PAR,P009862,P012742,0 days 00:05:59,2,11,9
39,PAR,P003983,P012743,0 days 00:05:54,-9,10,19
39,PAR,P000956,P007400,0 days 00:05:24,1,18,17
39,PAR,P000956,P011051,0 days 00:05:11,-7,7,14
39,PAR,P000956,P003983,0 days 00:04:38,-7,8,15
39,PAR,P000956,P012742,0 days 00:01:16,0,2,2
39,PAR,P003983,P007673,0 days 00:00:51,-2,0,2
39,PAR,P007673,P008987,0 days 00:00:51,-2,0,2
39,PAR,P007673,P009862,0 days 00:00:51,-2,0,2
39,PAR,P007673,P012742,0 days 00:00:51,-2,0,2
39,RED,P009035,P011224,0 days 00:24:58,-7,55,62
39,RED,P002553,P005099,0 days 00:20:16,20,54,34
39,RED,P005099,P011224,0 days 00:19:59,-2,37,39
39,RED,P005099,P009035,0 days 00:18:45,-5,34,39
39,RED,P002553,PJDR,0 days 00:17:53,10,45,35
39,RED,P006436,P007960,0 days 00:17:02,-14,28,42
39,RED,P002553,P011224,0 days 00:16:25,12,40,28
39,RED,P005099,PJDR,0 days 00:15:27,8,39,31
39,RED,P009035,PJDR,0 days 00:15:03,-10,31,41
39,RED,P011224,PJDR,0 days 00:14:21,-5,34,39
39,RED,P002553,P009035,0 days 00:14:03,8,34,26
39,RED,P005099,P012044,0 days 00:13:26,12,33,21
39,RED,P007960,P011224,0 days 00:12:53,-16,22,38
39,RED,P007960,P009035,0 days 00:12:51,-21,19,40
39,RED,P006436,P011224,0 days 00:11:54,-15,21,36
39,RED,P006436,P009035,0 days 00:11:53,-22,18,40
39,RED,P002553,P012044,0 days 00:10:49,15,30,15
39,RED,P007960,P012044,0 days 00:10:32,-3,19,22
39,RED,P009035,P012044,0 days 00:10:14,4,26,22
39,RED,P011224,P012044,0 days 00:10:13,11,29,18
39,RED,P008966,P012044,0 days 00:10:00,7,24,17
39,RED,P006436,PJDR,0 days 00:09:54,-3,23,26
39,RED,P005099,P007960,0 days 00:09:25,-13,10,23
39,RED,P007960,PJDR,0 days 00:09:19,-3,22,25
39,RED,P006436,P012044,0 days 00:09:00,-6,13,19
39,RED,P012044,PJDR,0 days 00:08:54,4,22,18
39,RED,P005099,P008966,0 days 00:07:16,4,16,12
39,RED,P005099,P006436,0 days 00:06:50,-12,5,17
39,RED,P008966,PJDR,0 days 00:06:21,7,20,13
39,RED,P002553,P008966,0 days 00:06:09,6,16,10
39,RED,P006436,P008966,0 days 00:04:36,0,5,5
39,RED,P002553,P006436,0 days 00:04:07,0,11,11
39,RED,P007960,P008966,0 days 00:03:56,1,6,5
39,RED,P002553,P007960,0 days 00:02:58,5,10,5
39,RED,P008966,P011224,0 days 00:02:13,2,6,4
39,RED,P008966,P009035,0 days 00:00:05,1,3,2
40,MAD,P005928,P009005,0 days 00:23:22,5,41,36
40,MAD,P006540,P009005,0 days 00:18:22,9,32,23
40,MAD,PBMT,PTGB,0 days 00:18:16,-7,22,29
40,MAD,P005928,P006540,0 days 00:18:14,9,32,23
40,MAD,PBMT,PCVM,0 days 00:16:38,-4,24,28
40,MAD,PCVM,PTGB,0 days 00:16:19,-6,22,28
40,MAD,P005791,P009005,0 days 00:14:17,-19,14,33
40,MAD,P003108,P009005,0 days 00:14:10,14,35,21
40,MAD,P003108,P005928,0 days 00:14:10,14,35,21
40,MAD,P003108,P004887,0 days 00:13:03,7,25,18
40,MAD,P004887,P009005,0 days 00:11:54,11,25,14
40,MAD,P005791,P005928,0 days 00:11:42,-14,13,27
40,MAD,P003108,P006540,0 days 00:11:02,17,26,9
40,MAD,P004887,PCVM,0 days 00:10:22,2,20,18
40,MAD,P004887,PBMT,0 days 00:10:22,2,20,18
40,MAD,P004887,PTGB,0 days 00:10:00,0,18,18
40,MAD,P009005,PTGB,0 days 00:09:41,-9,15,24
40,MAD,P003108,PTGB,0 days 00:09:41,-6,17,23
40,MAD,P005791,PTGB,0 days 00:09:26,-12,11,23
40,MAD,P004887,P005928,0 days 00:09:17,12,21,9
40,MAD,P004887,P006540,0 days 00:09:04,12,21,9
40,MAD,P003733,P005928,0 days 00:07:12,-8,6,14
40,MAD,P003733,P005791,0 days 00:07:12,-8,6,14
40,MAD,P005791,P006540,0 days 00:07:12,-8,6,14
40,MAD,P003733,P009005,0 days 00:07:12,-8,6,14
40,MAD,P003733,P006540,0 days 00:07:12,-8,6,14
40,MAD,P009005,PBMT,0 days 00:07:12,-7,5,12
40,MAD,P003108,PCVM,0 days 00:07:07,-4,7,11
40,MAD,P003108,PBMT,0 days 00:07:04,-4,7,11
40,MAD,P005791,PBMT,0 days 00:06:56,-7,4,11
40,MAD,P009213,PBMT,0 days 00:05:42,6,12,6
40,MAD,P009213,PCVM,0 days 00:05:42,6,12,6
40,MAD,P009213,PTGB,0 days 00:05:28,4,10,6
40,MAD,P009005,PCVM,0 days 00:05:15,-6,5,11
40,MAD,P005791,PCVM,0 days 00:04:56,-6,4,10
40,MAD,P005928,PTGB,0 days 00:04:37,-3,10,13
40,MAD,P004887,P009213,0 days 00:04:34,10,14,4
40,MAD,P003108,P005791,0 days 00:04:28,-4,10,14
40,MAD,P003108,P009213,0 days 00:04:11,6,6,0
40,MAD,P005928,P009213,0 days 00:02:51,6,6,0
40,MAD,P009005,P009213,0 days 00:02:51,6,6,0
40,MAD,P006540,P009213,0 days 00:02:30,6,6,0
40,MAD,P005928,PBMT,0 days 00:02:00,-1,0,1
40,MAD,P005791,P009213,0 days 00:00:23,-2,0,2
40,MAD,P006540,PBMT,0 days 00:00:22,2,2,0
40,MAD,P006540,PCVM,0 days 00:00:22,2,2,0
40,MAD,P006540,PTGB,0 days 00:00:04,3,3,0
40,MAD,P005928,PCVM,0 days 00:00:03,0,0,0
40,BAR,P003478,P004866,0 days 00:24:49,13,49,36
40,BAR,P000925,P002939,0 days 00:23:28,14,43,29
40,BAR,P002939,P004866,0 days 00:23:12,12,43,31
40,BAR,P002939,P003478,0 days 00:22:51,14,41,27
40,BAR,P000925,P004866,0 days 00:21:44,15,46,31
40,BAR,P000925,P003478,0 days 00:21:44,15,44,29
40,BAR,P003478,P011244,0 days 00:18:18,-2,28,30
40,BAR,P004866,P011244,0 days 00:17:18,0,28,28
40,BAR,P002939,P011244,0 days 00:15:25,2,23,21
40,BAR,P004866,P007519,0 days 00:13:57,5,30,25
40,BAR,P000925,P011244,0 days 00:13:52,4,23,19
40,BAR,P003196,P007519,0 days 00:13:00,-5,18,23
40,BAR,P007464,P009992,0 days 00:11:57,-5,13,18
40,BAR,P003478,P007519,0 days 00:11:37,4,26,22
40,BAR,P003196,P007464,0 days 00:11:16,-8,13,21
40,BAR,P007519,P009992,0 days 00:11:09,-4,18,22
40,BAR,P007464,P007519,0 days 00:10:56,-6,13,19
40,BAR,P003196,P009992,0 days 00:10:44,-7,13,20
40,BAR,P007464,P012745,0 days 00:10:18,-6,11,17
40,BAR,P000925,P007519,0 days 00:09:17,9,23,14
40,BAR,P009992,P012745,0 days 00:09:05,-1,11,12
40,BAR,P002939,P007519,0 days 00:08:27,10,20,10
40,BAR,P003196,P012745,0 days 00:08:24,-4,11,15
40,BAR,P007519,P012745,0 days 00:08:04,-2,11,13
40,BAR,P003196,P004866,0 days 00:06:54,-5,7,12
40,BAR,P003196,P003478,0 days 00:05:14,-6,5,11
40,BAR,P003196,P011244,0 days 00:04:22,-3,5,8
40,BAR,P004866,P009992,0 days 00:03:58,-5,7,12
40,BAR,P002939,P009992,0 days 00:03:15,-6,2,8
40,BAR,P002939,P007464,0 days 00:02:54,-4,0,4
40,BAR,P007519,P011244,0 days 00:02:53,-4,5,9
40,BAR,P004866,P007464,0 days 00:02:52,-4,2,6
40,BAR,P000925,P009992,0 days 00:02:39,-1,5,6
40,BAR,P002939,P003196,0 days 00:02:38,-6,0,6
40,BAR,P000925,P007464,0 days 00:02:34,-2,0,2
40,BAR,P002939,P012745,0 days 00:02:14,-4,0,4
40,BAR,P000925,P012745,0 days 00:01:54,-2,0,2
40,BAR,P003478,P007464,0 days 00:01:53,-5,0,5
40,BAR,P003478,P012745,0 days 00:01:13,-5,0,5
40,BAR,P007464,P011244,0 days 00:00:40,0,0,0
40,BAR,P003478,P009992,0 days 00:00:25,-1,3,4
40,BAR,P009992,P011244,0 days 00:00:20,-2,0,2
40,BAR,P003478,P010641,0 days 00:00:04,-3,0,3
40,BAR,P004866,P010641,0 days 00:00:04,-3,0,3
40,BAR,P007519,P010641,0 days 00:00:04,-3,0,3
40,BAR,P010641,P011244,0 days 00:00:04,-3,0,3
41,MCO,P005985,P010588,0 days 00:19:13,22,50,28
41,MCO,P010588,PLCZ,0 days 00:17:41,21,46,25
41,MCO,P005985,P011226,0 days 00:17:18,24,49,25
41,MCO,P005985,PLCZ,0 days 00:16:56,20,44,24
41,MCO,P010588,P011226,0 days 00:16:39,24,46,22
41,MCO,P004790,P012709,0 days 00:14:39,0,42,42
41,MCO,P011226,PLCZ,0 days 00:14:22,22,40,18
41,MCO,P010588,P011212,0 days 00:14:05,8,34,26
41,MCO,P004790,P011212,0 days 00:14:05,4,36,32
41,MCO,P004197,P005985,0 days 00:12:54,16,34,18
41,MCO,P004197,P010588,0 days 00:12:54,16,34,18
41,MCO,P004197,PLCZ,0 days 00:12:54,16,34,18
41,MCO,P011212,P011226,0 days 00:12:46,13,31,18
41,MCO,P011212,P011231,0 days 00:12:28,4,37,33
41,MCO,P011212,P012709,0 days 00:12:26,9,38,29
41,MCO,P011196,P011212,0 days 00:11:22,4,34,30
41,MCO,P005985,P011212,0 days 00:10:59,5,28,23
41,MCO,P004790,P011231,0 days 00:10:19,0,29,29
41,MCO,P011231,P012709,0 days 00:09:42,2,29,27
41,MCO,P004197,P011226,0 days 00:09:35,17,28,11
41,MCO,P011212,PLCZ,0 days 00:07:17,2,16,14
41,MCO,P011196,P011231,0 days 00:07:16,0,25,25
41,MCO,P011196,P012709,0 days 00:07:05,2,22,20
41,MCO,P004790,P011196,0 days 00:07:01,0,22,22
41,MCO,P004790,P011226,0 days 00:06:43,0,14,14
41,MCO,P011226,P012709,0 days 00:06:34,8,21,13
41,MCO,P002581,P004790,0 days 00:06:21,-3,13,16
41,MCO,P011196,P011226,0 days 00:06:10,8,17,9
41,MCO,P010588,P012709,0 days 00:06:10,9,18,9
41,MCO,P002581,P012515,0 days 00:05:40,-3,13,16
41,MCO,P004790,P012515,0 days 00:05:40,-3,13,16
41,MCO,P002581,P011226,0 days 00:04:54,-4,9,13
41,MCO,P010588,P011231,0 days 00:04:31,4,12,8
41,MCO,P004790,P010588,0 days 00:04:31,4,12,8
41,MCO,P005985,P011196,0 days 00:04:22,2,12,10
41,MCO,P011226,P012515,0 days 00:04:13,-4,9,13
41,MCO,P012515,P012709,0 days 00:03:48,-3,11,14
41,MCO,P002581,P012709,0 days 00:03:48,-3,11,14
41,MCO,P004197,P011212,0 days 00:03:19,-1,6,7
41,MCO,P011226,P011231,0 days 00:02:50,4,8,4
41,MCO,P002581,P011212,0 days 00:02:33,0,2,2
41,MCO,P010588,P011196,0 days 00:02:12,0,4,4
41,MCO,P005985,P011231,0 days 00:02:05,2,8,6
41,MCO,P011212,P012515,0 days 00:01:52,0,2,2
41,MCO,P012709,PLCZ,0 days 00:01:34,3,4,1
41,MCO,P002581,P004197,0 days 00:01:27,1,4,3
41,MCO,P004197,P004790,0 days 00:01:27,1,4,3
41,MCO,P004197,P012515,0 days 00:01:27,1,4,3
41,MCO,P004197,P012709,0 days 00:01:27,1,4,3
41,MCO,P005985,P012709,0 days 00:00:59,4,4,0
41,MCO,P004790,P005985,0 days 00:00:46,1,3,2
41,MCO,P002581,P011231,0 days 00:00:41,0,0,0
41,TEL,P009622,P009783,0 days 00:18:54,-26,25,51
41,TEL,P009622,P011199,0 days 00:17:12,-7,28,35
41,TEL,P007990,P011199,0 days 00:13:57,-8,26,34
41,TEL,P009783,P011199,0 days 00:13:38,-13,18,31
41,TEL,P011219,P012744,0 days 00:11:58,-13,24,37
41,TEL,P011193,P011219,0 days 00:11:56,-5,30,35
41,TEL,P011219,P011971,0 days 00:11:26,-7,26,33
41,TEL,P011193,P011971,0 days 00:10:33,-4,27,31
41,TEL,P011193,P011199,0 days 00:10:20,-4,28,32
41,TEL,P005145,P007990,0 days 00:10:18,-6,19,25
41,TEL,P007990,P011193,0 days 00:10:12,-2,28,30
41,TEL,P011193,P012744,0 days 00:09:19,3,32,29
41,TEL,P004233,P011971,0 days 00:09:16,0,26,26
41,TEL,P011193,P011214,0 days 00:09:09,-9,14,23
41,TEL,P011214,P011219,0 days 00:08:57,-18,9,27
41,TEL,P005145,P011199,0 days 00:08:56,-7,15,22
41,TEL,P007990,P009622,0 days 00:08:41,-6,8,14
41,TEL,P009622,P011214,0 days 00:08:40,-20,6,26
41,TEL,P007990,P009783,0 days 00:08:29,-9,8,17
41,TEL,P007990,P012744,0 days 00:08:20,3,24,21
41,TEL,P009622,P011219,0 days 00:08:18,-15,10,25
41,TEL,P009622,P011971,0 days 00:08:17,4,24,20
41,TEL,P009783,P011193,0 days 00:08:16,-10,15,25
41,TEL,P009783,P011214,0 days 00:07:47,-20,6,26
41,TEL,P009622,P011193,0 days 00:07:31,-7,15,22
41,TEL,P007990,P011219,0 days 00:07:05,-3,15,18
41,TEL,P011199,P012744,0 days 00:06:58,2,20,18
41,TEL,P005145,P009783,0 days 00:06:54,-8,6,14
41,TEL,P011433,P011971,0 days 00:06:21,3,16,13
41,TEL,P009622,P012744,0 days 00:06:11,-14,4,18
41,TEL,P005145,P009622,0 days 00:06:09,-5,6,11
41,TEL,P009783,P011219,0 days 00:06:01,-16,7,23
41,TEL,P004233,P011219,0 days 00:05:42,-3,16,19
41,TEL,P004233,P011433,0 days 00:05:40,3,16,13
41,TEL,P011199,P011971,0 days 00:05:26,2,17,15
41,TEL,P009783,P012744,0 days 00:05:14,-14,4,18
41,TEL,P007990,P011214,0 days 00:05:01,-2,10,12
41,TEL,P011214,P012744,0 days 00:05:01,-12,6,18
41,TEL,P011971,P012744,0 days 00:04:58,-2,13,15
41,TEL,P004233,P012744,0 days 00:04:58,-2,13,15
41,TEL,P009622,P011433,0 days 00:04:54,4,13,9
41,TEL,P011214,P011971,0 days 00:04:32,-3,6,9
41,TEL,P004233,P009622,0 days 00:04:13,4,13,9
41,TEL,P005145,P011193,0 days 00:04:09,-1,13,14
41,TEL,P007990,P011971,0 days 00:03:44,-5,6,11
41,TEL,P004233,P011193,0 days 00:03:31,-1,10,11
41,TEL,P004233,P011199,0 days 00:03:27,1,10,9
41,TEL,P011199,P011219,0 days 00:03:26,0,9,9
41,TEL,P005145,P012744,0 days 00:03:24,2,13,11
41,TEL,P009783,P011971,0 days 00:03:23,0,11,11
41,TEL,P011199,P011433,0 days 00:03:22,3,10,7
41,TEL,P011199,P011214,0 days 00:03:10,-5,3,8
41,TEL,P011219,P011433,0 days 00:02:47,0,6,6
41,TEL,P011433,P012744,0 days 00:01:27,-1,3,4
41,TEL,P005145,P011214,0 days 00:01:22,1,4,3
41,TEL,P011214,P011433,0 days 00:00:53,0,0,0
41,TEL,P004233,P011214,0 days 00:00:12,0,0,0
41,TEL,P004233,P007990,0 days 00:00:05,-2,0,2
42,ASV,P011225,P012732,0 days 00:21:16,3,47,44
42,ASV,P004194,P011225,0 days 00:21:11,5,47,42
42,ASV,P006568,P011225,0 days 00:20:28,5,47,42
42,ASV,P006568,P012732,0 days 00:19:10,0,42,42
42,ASV,P011225,P012729,0 days 00:17:02,6,41,35
42,ASV,P012729,PKIR,0 days 00:16:55,-8,31,39
42,ASV,P002100,PKIR,0 days 00:16:33,-4,35,39
42,ASV,P002100,P012729,0 days 00:15:17,-6,31,37
42,ASV,P004194,P012732,0 days 00:15:00,5,35,30
42,ASV,P004194,P006568,0 days 00:14:34,2,32,30
42,ASV,P006568,P012729,0 days 00:12:19,2,28,26
42,ASV,P011386,PKIR,0 days 00:10:56,-10,18,28
42,ASV,P011225,PKIR,0 days 00:10:47,11,26,15
42,ASV,P004194,PKIR,0 days 00:10:44,11,25,14
42,ASV,P012729,P012732,0 days 00:10:28,2,24,22
42,ASV,P004194,P012729,0 days 00:10:13,6,24,18
42,ASV,P002100,P011386,0 days 00:09:39,-10,16,26
42,ASV,P003526,P004194,0 days 00:09:27,-8,16,24
42,ASV,P003526,P011225,0 days 00:09:27,-8,16,24
42,ASV,P003526,P012732,0 days 00:08:58,-6,16,22
42,ASV,P003526,P006568,0 days 00:08:58,-6,16,22
42,ASV,P011386,P012729,0 days 00:08:42,-10,14,24
42,ASV,P006568,PKIR,0 days 00:08:26,8,18,10
42,ASV,P002100,P004194,0 days 00:08:11,2,16,14
42,ASV,P002100,P012730,0 days 00:07:50,-11,14,25
42,ASV,P002100,P011225,0 days 00:07:47,4,19,15
42,ASV,P012730,PKIR,0 days 00:07:21,-9,14,23
42,ASV,P011386,P012730,0 days 00:05:57,-10,10,20
42,ASV,P012729,P012730,0 days 00:05:41,-11,10,21
42,ASV,P002100,P006568,0 days 00:03:58,3,9,6
42,ASV,P006568,P011386,0 days 00:03:56,-2,6,8
42,ASV,P012732,PKIR,0 days 00:03:53,5,7,2
42,ASV,P003274,P012732,0 days 00:03:37,-1,11,12
42,ASV,P003274,P006568,0 days 00:03:37,-1,11,12
42,ASV,P003274,P012729,0 days 00:03:37,-1,11,12
42,ASV,P003274,P011225,0 days 00:03:36,-1,11,12
42,ASV,P004194,P011386,0 days 00:03:17,2,6,4
42,ASV,P000229,P004194,0 days 00:03:06,3,7,4
42,ASV,P000229,P012729,0 days 00:02:46,4,6,2
42,ASV,P000229,P012732,0 days 00:02:46,4,6,2
42,ASV,P000229,P011225,0 days 00:02:45,4,6,2
42,ASV,P000229,P006568,0 days 00:02:14,1,3,2
42,ASV,P004194,P012730,0 days 00:02:09,0,4,4
42,ASV,P011225,P012730,0 days 00:01:53,-1,4,5
42,ASV,P000229,PKIR,0 days 00:01:17,0,2,2
42,ASV,P000229,P011386,0 days 00:01:17,0,2,2
42,ASV,P002100,P003526,0 days 00:00:29,-2,0,2
42,ASV,P003526,P012730,0 days 00:00:29,-2,0,2
42,ASV,P000229,P003274,0 days 00:00:01,0,0,0
42,VIR,P001133,P009549,0 days 00:26:37,8,64,56
42,VIR,P001133,PBCN,0 days 00:23:59,6,59,53
42,VIR,P009549,PBCN,0 days 00:23:59,6,59,53
42,VIR,P001133,P001844,0 days 00:22:19,5,52,47
42,VIR,P001844,P009549,0 days 00:19:27,4,44,40
42,VIR,P001844,PBCN,0 days 00:17:52,4,44,40
42,VIR,P001133,P008847,0 days 00:17:42,9,41,32
42,VIR,P003048,P009549,0 days 00:15:45,5,40,35
42,VIR,P008847,P009549,0 days 00:15:03,7,36,29
42,VIR,P001844,P003048,0 days 00:14:26,-2,34,36
42,VIR,P001133,P003048,0 days 00:13:45,3,34,31
42,VIR,P003048,PBCN,0 days 00:13:06,3,34,31
42,VIR,P001133,P006739,0 days 00:11:59,6,27,21
42,VIR,P008847,PBCN,0 days 00:10:53,3,25,22
42,VIR,P006739,P009549,0 days 00:10:42,8,28,20
42,VIR,P006739,P008847,0 days 00:10:35,9,29,20
42,VIR,P001844,P008847,0 days 00:10:24,-3,18,21
42,VIR,P001133,P004007,0 days 00:09:40,5,20,15
42,VIR,P004007,P010781,0 days 00:09:05,-4,15,19
42,VIR,P004007,P008847,0 days 00:07:55,1,16,15
42,VIR,P008847,P010781,0 days 00:07:45,1,17,16
42,VIR,P001133,P010781,0 days 00:07:41,3,15,12
42,VIR,P004007,P006739,0 days 00:07:29,-3,12,15
42,VIR,P006739,P010781,0 days 00:06:07,2,13,11
42,VIR,P006739,PBCN,0 days 00:06:07,2,15,13
42,VIR,P001844,P010781,0 days 00:04:58,-4,8,12
42,VIR,P006739,P012714,0 days 00:04:57,-6,6,12
42,VIR,P001844,P004007,0 days 00:04:54,-4,8,12
42,VIR,P004007,P012714,0 days 00:04:17,-8,4,12
42,VIR,P010781,P012714,0 days 00:03:20,-3,4,7
42,VIR,P003048,P008847,0 days 00:02:55,-3,6,9
42,VIR,P003048,P010781,0 days 00:02:55,-3,6,9
42,VIR,P001133,P012714,0 days 00:02:51,-1,4,5
42,VIR,P003527,P012714,0 days 00:02:36,-5,2,7
42,VIR,P003048,P006739,0 days 00:02:14,2,6,4
42,VIR,P004007,P009549,0 days 00:02:10,2,5,3
42,VIR,P003527,P011192,0 days 00:02:07,-3,2,5
42,VIR,P011192,P012714,0 days 00:02:07,-3,2,5
42,VIR,P003527,P006739,0 days 00:02:06,-5,2,7
42,VIR,P009549,P010781,0 days 00:02:00,2,6,4
42,VIR,P009549,P011192,0 days 00:01:49,2,2,0
42,VIR,P006739,P011192,0 days 00:01:37,-3,2,5
42,VIR,P003527,P004007,0 days 00:01:26,-7,0,7
42,VIR,P003527,P009549,0 days 00:01:10,2,2,0
42,VIR,P009549,P012714,0 days 00:01:10,2,2,0
42,VIR,P001844,P011192,0 days 00:01:09,0,0,0
42,VIR,P004007,P011192,0 days 00:00:57,-5,0,5
42,VIR,P003048,P004007,0 days 00:00:55,-5,0,5
42,VIR,P001133,P011192,0 days 00:00:39,0,0,0
42,VIR,P003048,P011192,0 days 00:00:39,0,0,0
42,VIR,P001844,P003527,0 days 00:00:30,0,0,0
42,VIR,P001844,P012714,0 days 00:00:30,0,0,0
42,VIR,P003527,P010781,0 days 00:00:29,-2,0,2
42,VIR,P001844,P006739,0 days 00:00:11,0,0,0
43,MUN,P007975,P010391,0 days 00:21:09,-8,38,46
43,MUN,P006760,P007056,0 days 00:18:08,-1,25,26
43,MUN,P004508,P007056,0 days 00:17:42,8,30,22
43,MUN,P010391,P011987,0 days 00:17:23,-17,29,46
43,MUN,P007056,P008985,0 days 00:16:33,7,28,21
43,MUN,P004508,P006760,0 days 00:16:16,5,25,20
43,MUN,P003583,P007056,0 days 00:16:07,2,25,23
43,MUN,P007975,P011987,0 days 00:15:43,-14,26,40
43,MUN,P010391,P011941,0 days 00:15:29,-4,31,35
43,MUN,P003583,P006760,0 days 00:15:03,-5,21,26
43,MUN,P006760,P008985,0 days 00:14:59,9,26,17
43,MUN,P007975,P011941,0 days 00:14:03,-4,29,33
43,MUN,P006760,P010391,0 days 00:13:35,-2,24,26
43,MUN,P004508,P008985,0 days 00:13:11,6,25,19
43,MUN,P003583,P008985,0 days 00:12:57,4,26,22
43,MUN,P003583,P004508,0 days 00:12:56,0,23,23
43,MUN,P011941,P011987,0 days 00:12:25,-8,23,31
43,MUN,P006760,P007975,0 days 00:12:23,-5,20,25
43,MUN,P007056,P010391,0 days 00:10:15,3,18,15
43,MUN,P008985,P010391,0 days 00:09:15,3,20,17
43,MUN,P006760,P011987,0 days 00:08:36,-8,13,21
43,MUN,P003583,P010391,0 days 00:08:05,-7,12,19
43,MUN,P006760,P011941,0 days 00:07:56,4,16,12
43,MUN,P007056,P007975,0 days 00:07:26,-1,9,10
43,MUN,P003583,P007975,0 days 00:06:20,-3,8,11
43,MUN,P007975,P008985,0 days 00:05:57,2,10,8
43,MUN,P008985,P011941,0 days 00:04:52,4,10,6
43,MUN,P001557,P011941,0 days 00:04:38,-9,8,17
43,MUN,P001557,P011987,0 days 00:04:38,-9,8,17
43,MUN,P001557,P010391,0 days 00:04:38,-9,8,17
43,MUN,P001557,P007975,0 days 00:04:38,-9,8,17
43,MUN,P007056,P011987,0 days 00:04:27,-1,7,8
43,MUN,P004508,P010391,0 days 00:04:11,5,12,7
43,MUN,P003583,P011987,0 days 00:03:37,-7,4,11
43,MUN,P006245,P007056,0 days 00:03:24,-5,2,7
43,MUN,P006245,P006760,0 days 00:03:24,-5,2,7
43,MUN,P004508,P006245,0 days 00:03:24,-5,2,7
43,MUN,P003583,P006245,0 days 00:03:24,-5,2,7
43,MUN,P004508,P007975,0 days 00:03:09,2,4,2
43,MUN,P007056,P011941,0 days 00:02:58,0,4,4
43,MUN,P008985,P011987,0 days 00:01:40,-3,3,6
43,MUN,P003583,P011941,0 days 00:01:11,1,3,2
43,MUN,P004508,P011987,0 days 00:01:03,-1,3,4
43,MUN,P004508,P011941,0 days 00:00:52,0,0,0
43,ULK,P004004,P008962,0 days 00:28:50,4,48,44
43,ULK,P008962,P010560,0 days 00:20:52,-7,31,38
43,ULK,P008962,P011157,0 days 00:20:04,-1,31,32
43,ULK,P004004,P011157,0 days 00:19:24,-3,27,30
43,ULK,P001932,P008962,0 days 00:19:19,-3,29,32
43,ULK,P005844,P006661,0 days 00:19:16,14,45,31
43,ULK,P001932,P011157,0 days 00:19:07,-3,29,32
43,ULK,P001932,P004004,0 days 00:18:39,-5,25,30
43,ULK,P004004,P010560,0 days 00:18:12,-6,25,31
43,ULK,P010560,P011157,0 days 00:16:06,-3,25,28
43,ULK,P005844,P009849,0 days 00:16:00,12,38,26
43,ULK,P006661,P009849,0 days 00:16:00,12,38,26
43,ULK,P006661,P008962,0 days 00:15:54,5,31,26
43,ULK,P001932,P010560,0 days 00:15:21,-5,23,28
43,ULK,P004004,P006661,0 days 00:13:42,11,29,18
43,ULK,P005844,P008962,0 days 00:11:40,2,23,21
43,ULK,P004004,P005844,0 days 00:09:40,5,21,16
43,ULK,P006661,P006961,0 days 00:08:44,13,25,12
43,ULK,P005844,P006961,0 days 00:08:44,13,25,12
43,ULK,P006961,P009849,0 days 00:08:02,10,22,12
43,ULK,P006961,P011980,0 days 00:08:02,10,22,12
43,ULK,P009849,P011980,0 days 00:08:02,10,22,12
43,ULK,P006661,P011980,0 days 00:08:02,10,22,12
43,ULK,P005844,P011980,0 days 00:08:02,10,22,12
43,ULK,P008962,P009849,0 days 00:07:58,2,16,14
43,ULK,P004004,P009849,0 days 00:05:58,5,14,9
43,ULK,P006661,P010560,0 days 00:05:57,-7,8,15
43,ULK,P005844,P010560,0 days 00:05:00,-6,6,12
43,ULK,P006661,P011157,0 days 00:04:40,1,8,7
43,ULK,P001932,P006661,0 days 00:03:29,1,6,5
43,ULK,P009849,P010560,0 days 00:02:00,-3,2,5
43,ULK,P004004,P006961,0 days 00:01:51,-3,3,6
43,ULK,P006961,P008962,0 days 00:01:37,-1,3,4
43,ULK,P001932,P006961,0 days 00:01:09,-6,0,6
43,ULK,P006961,P011157,0 days 00:01:09,-6,0,6
43,ULK,P001932,P011980,0 days 00:00:42,3,4,1
43,ULK,P008962,P011980,0 days 00:00:42,3,4,1
43,ULK,P010560,P011980,0 days 00:00:42,3,4,1
43,ULK,P011157,P011980,0 days 00:00:42,3,4,1
43,ULK,P001932,P005844,0 days 00:00:26,-2,0,2
43,ULK,P006961,P010560,0 days 00:00:14,-2,0,2
44,PAN,P007866,P011204,0 days 00:26:24,18,69,51
44,PAN,P003842,P007866,0 days 00:25:23,17,71,54
44,PAN,P003842,P011204,0 days 00:24:17,27,68,41
44,PAN,P002328,P011204,0 days 00:22:55,21,59,38
44,PAN,P002328,P007866,0 days 00:21:39,13,55,42
44,PAN,P002328,P003842,0 days 00:21:34,16,56,40
44,PAN,P007866,P011826,0 days 00:19:52,15,55,40
44,PAN,P003842,P011826,0 days 00:18:45,19,55,36
44,PAN,P001926,P002328,0 days 00:17:43,4,38,34
44,PAN,P011204,P011826,0 days 00:17:40,19,50,31
44,PAN,P001926,P007866,0 days 00:15:08,-2,37,39
44,PAN,P001926,P003842,0 days 00:14:34,5,38,33
44,PAN,P001926,P011204,0 days 00:14:12,10,36,26
44,PAN,P001926,P012712,0 days 00:12:53,-2,24,26
44,PAN,P002328,P011826,0 days 00:12:12,16,34,18
44,PAN,P001926,P007947,0 days 00:09:25,-6,15,21
44,PAN,P002328,P012712,0 days 00:09:25,4,19,15
44,PAN,P002328,P007947,0 days 00:09:18,-7,17,24
44,PAN,P007947,P012712,0 days 00:08:42,-4,13,17
44,PAN,P001926,P011826,0 days 00:06:50,-2,18,20
44,PAN,P001926,P011221,0 days 00:06:28,-4,11,15
44,PAN,P002328,P011221,0 days 00:05:59,0,11,11
44,PAN,P003842,P012712,0 days 00:05:52,0,13,13
44,PAN,P011221,P012712,0 days 00:05:40,0,11,11
44,PAN,P007947,P011221,0 days 00:05:40,0,11,11
44,PAN,P001926,P007553,0 days 00:04:47,-1,7,8
44,PAN,P002328,P007553,0 days 00:03:31,1,7,6
44,PAN,P003842,P007947,0 days 00:03:06,-7,6,13
44,PAN,P007553,P011204,0 days 00:02:59,1,7,6
44,PAN,P007553,P007866,0 days 00:02:49,-1,5,6
44,PAN,P007866,P012712,0 days 00:02:49,-2,7,9
44,PAN,P011826,P012712,0 days 00:02:49,-2,7,9
44,PAN,P011204,P012712,0 days 00:02:36,8,8,0
44,PAN,P007553,P012712,0 days 00:01:58,0,2,2
44,PAN,P007866,P007947,0 days 00:01:52,-5,4,9
44,PAN,P007553,P007947,0 days 00:01:48,-2,0,2
44,PAN,P011209,P012712,0 days 00:01:16,-2,0,2
44,PAN,P007947,P011209,0 days 00:01:16,-2,0,2
44,PAN,P007553,P011209,0 days 00:01:16,-2,0,2
44,PAN,P001926,P011209,0 days 00:01:16,-2,0,2
44,PAN,P007947,P011204,0 days 00:01:09,-3,2,5
44,PAN,P007866,P011221,0 days 00:01:07,-4,0,4
44,PAN,P011204,P011221,0 days 00:01:07,-4,0,4
44,PAN,P011221,P011826,0 days 00:01:07,-4,0,4
44,PAN,P003842,P011209,0 days 00:00:13,-1,1,2
44,PAN,P007866,P011209,0 days 00:00:13,-1,1,2
44,PAN,P011204,P011209,0 days 00:00:13,-1,1,2
44,PAN,P011209,P011826,0 days 00:00:13,-1,1,2
44,BAS,P009048,P011948,0 days 00:23:07,1,52,51
44,BAS,P004603,P011948,0 days 00:21:50,-9,44,53
44,BAS,P004603,P009048,0 days 00:20:11,-7,40,47
44,BAS,P007230,P009048,0 days 00:19:57,-8,39,47
44,BAS,P007230,P011948,0 days 00:19:08,-5,35,40
44,BAS,P004603,P007230,0 days 00:18:31,-15,29,44
44,BAS,P007230,P008850,0 days 00:18:28,-9,33,42
44,BAS,P004603,P011064,0 days 00:18:12,-11,37,48
44,BAS,P004761,P007230,0 days 00:17:51,-7,35,42
44,BAS,P008850,P009048,0 days 00:17:31,-11,37,48
44,BAS,P004761,P011948,0 days 00:15:30,-7,32,39
44,BAS,P008850,P011948,0 days 00:14:40,0,33,33
44,BAS,P004603,P008850,0 days 00:14:11,-12,28,40
44,BAS,P004603,P004761,0 days 00:14:04,-11,25,36
44,BAS,P010444,P011064,0 days 00:13:16,0,25,25
44,BAS,P007230,P011064,0 days 00:12:26,-9,21,30
44,BAS,P011064,P011948,0 days 00:12:18,-1,28,29
44,BAS,P004761,P009048,0 days 00:12:18,-1,28,29
44,BAS,P004761,P011064,0 days 00:11:50,-5,24,29
44,BAS,P004761,P010444,0 days 00:11:16,2,27,25
44,BAS,P007230,P010444,0 days 00:11:07,5,28,23
44,BAS,P010444,P011948,0 days 00:09:59,1,20,19
44,BAS,P009048,P011064,0 days 00:09:50,-2,24,26
44,BAS,P004603,P010444,0 days 00:09:37,-3,17,20
44,BAS,P008850,P011064,0 days 00:09:32,-4,21,25
44,BAS,P009048,P010444,0 days 00:09:02,-4,20,24
44,BAS,P004761,P008850,0 days 00:08:47,-7,17,24
44,BAS,P008850,P010444,0 days 00:05:31,-1,11,12
45,ZAL,P007109,P011218,0 days 00:22:31,-6,41,47
45,ZAL,P002676,P012715,0 days 00:18:24,-15,31,46
45,ZAL,P002329,P007109,0 days 00:17:48,-12,27,39
45,ZAL,P002329,P010390,0 days 00:16:46,-9,29,38
45,ZAL,P002329,P011218,0 days 00:16:25,-4,27,31
45,ZAL,P007109,P010390,0 days 00:16:20,-1,33,34
45,ZAL,P002676,P011218,0 days 00:14:32,-3,24,27
45,ZAL,P010390,P011218,0 days 00:13:55,3,27,24
45,ZAL,P003211,P011218,0 days 00:13:05,5,28,23
45,ZAL,P002676,P003211,0 days 00:12:56,-2,28,30
45,ZAL,P003211,P007109,0 days 00:12:13,6,30,24
45,ZAL,P011218,P012715,0 days 00:12:01,-6,20,26
45,ZAL,P002676,P007109,0 days 00:11:58,-2,24,26
45,ZAL,P002676,P005504,0 days 00:09:57,-7,16,23
45,ZAL,P003211,P012715,0 days 00:09:55,-7,20,27
45,ZAL,P007109,P012715,0 days 00:09:53,-8,16,24
45,ZAL,P003211,P010390,0 days 00:09:15,5,21,16
45,ZAL,P005504,P012715,0 days 00:09:09,-1,16,17
45,ZAL,P003210,P005504,0 days 00:08:31,1,17,16
45,ZAL,P007109,P007513,0 days 00:08:09,-5,13,18
45,ZAL,P007513,P011218,0 days 00:08:09,-5,13,18
45,ZAL,P002329,P003211,0 days 00:07:53,1,15,14
45,ZAL,P002329,P002676,0 days 00:07:49,-10,9,19
45,ZAL,P002676,P003210,0 days 00:07:33,0,16,16
45,ZAL,P002676,P011965,0 days 00:07:29,-7,15,22
45,ZAL,P003210,P011965,0 days 00:06:59,-11,11,22
45,ZAL,P007513,P010390,0 days 00:06:45,-3,12,15
45,ZAL,P002329,P007513,0 days 00:06:45,-3,12,15
45,ZAL,P005504,P011965,0 days 00:06:27,-11,9,20
45,ZAL,P003210,P012715,0 days 00:06:24,4,14,10
45,ZAL,P002329,P011965,0 days 00:04:58,-10,5,15
45,ZAL,P011965,P012715,0 days 00:04:20,-8,6,14
45,ZAL,P002329,P003210,0 days 00:04:15,-10,5,15
45,ZAL,P002329,P012715,0 days 00:04:14,-8,4,12
45,ZAL,P002676,P010390,0 days 00:04:14,4,12,8
45,ZAL,P003211,P005504,0 days 00:04:07,-3,5,8
45,ZAL,P007109,P011965,0 days 00:03:53,-3,8,11
45,ZAL,P010390,P011965,0 days 00:03:53,-3,8,11
45,ZAL,P003211,P011965,0 days 00:03:21,-3,6,9
45,ZAL,P007513,P012715,0 days 00:02:54,1,4,3
45,ZAL,P003210,P010390,0 days 00:02:40,-5,4,9
45,ZAL,P003210,P007109,0 days 00:02:40,-5,4,9
45,ZAL,P005504,P011218,0 days 00:02:19,2,4,2
45,ZAL,P002329,P005504,0 days 00:02:07,-3,3,6
45,ZAL,P003210,P011218,0 days 00:01:31,2,4,2
45,ZAL,P003210,P007513,0 days 00:01:30,3,3,0
45,ZAL,P003210,P010184,0 days 00:01:30,3,3,0
45,ZAL,P005504,P007513,0 days 00:01:30,3,3,0
45,ZAL,P005504,P010184,0 days 00:01:30,3,3,0
45,ZAL,P007513,P010184,0 days 00:01:30,3,3,0
45,ZAL,P010184,P012715,0 days 00:01:30,3,3,0
45,ZAL,P002676,P007513,0 days 00:01:24,-2,1,3
45,ZAL,P003210,P003211,0 days 00:01:11,2,3,1
45,ZAL,P010390,P012715,0 days 00:00:52,-3,2,5
45,ZAL,P005504,P007109,0 days 00:00:11,0,0,0
45,PAM,P007870,P010568,0 days 00:19:50,2,37,35
45,PAM,P010568,P012740,0 days 00:19:34,6,41,35
45,PAM,P007870,P012740,0 days 00:19:30,5,38,33
45,PAM,P000556,P007870,0 days 00:17:51,4,33,29
45,PAM,P003960,P007870,0 days 00:16:05,-7,26,33
45,PAM,P000556,P012740,0 days 00:16:04,4,28,24
45,PAM,P000556,P010568,0 days 00:15:04,3,27,24
45,PAM,P011982,P012739,0 days 00:14:48,19,42,23
45,PAM,P011982,P012738,0 days 00:14:00,21,42,21
45,PAM,P012738,P012739,0 days 00:13:56,21,42,21
45,PAM,P004863,P011982,0 days 00:13:54,14,38,24
45,PAM,P004863,P012739,0 days 00:13:22,19,38,19
45,PAM,P011970,P011982,0 days 00:13:10,16,38,22
45,PAM,P003960,P010568,0 days 00:12:57,-1,23,24
45,PAM,P004863,P011970,0 days 00:12:45,18,38,20
45,PAM,P000556,P003960,0 days 00:12:44,-1,22,23
45,PAM,P003960,P012740,0 days 00:12:37,2,24,22
45,PAM,P011970,P012738,0 days 00:12:32,22,38,16
45,PAM,P011970,P012739,0 days 00:12:28,22,38,16
45,PAM,P004863,P012738,0 days 00:11:41,25,41,16
45,PAM,P010393,P012740,0 days 00:07:18,3,15,12
45,PAM,P010393,P010568,0 days 00:06:08,6,15,9
45,PAM,P004863,P007870,0 days 00:06:07,-6,10,16
45,PAM,P003960,P004863,0 days 00:05:50,-7,7,14
45,PAM,P007870,P010393,0 days 00:05:25,4,13,9
45,PAM,P006643,P010393,0 days 00:04:48,-4,8,12
45,PAM,P006643,P012740,0 days 00:04:44,-2,10,12
45,PAM,P010568,P011982,0 days 00:04:16,-5,4,9
45,PAM,P010568,P012738,0 days 00:04:04,-4,5,9
45,PAM,P004863,P012740,0 days 00:03:52,-1,5,6
45,PAM,P000556,P004863,0 days 00:03:38,0,8,8
45,PAM,P006643,P010568,0 days 00:03:34,1,10,9
45,PAM,P000556,P010393,0 days 00:03:22,5,7,2
45,PAM,P012739,P012740,0 days 00:03:21,-2,6,8
45,PAM,P010568,P012739,0 days 00:03:19,-1,6,7
45,PAM,P006643,P007870,0 days 00:03:08,0,11,11
45,PAM,P012738,P012740,0 days 00:02:56,-2,5,7
45,PAM,P006643,P012739,0 days 00:02:45,-3,2,5
45,PAM,P010393,P012739,0 days 00:02:45,-3,2,5
45,PAM,P004863,P010568,0 days 00:02:42,-1,4,5
45,PAM,P004863,P006643,0 days 00:02:19,-4,3,7
45,PAM,P004863,P010393,0 days 00:02:02,-5,0,5
45,PAM,P007870,P011982,0 days 00:01:58,-8,0,8
45,PAM,P003960,P011982,0 days 00:01:58,-8,0,8
45,PAM,P000556,P012738,0 days 00:01:49,0,4,4
45,PAM,P007870,P012738,0 days 00:01:45,0,4,4
45,PAM,P011982,P012740,0 days 00:01:28,-1,4,5
45,PAM,P003960,P011970,0 days 00:01:21,-6,0,6
45,PAM,P007870,P011970,0 days 00:01:21,-6,0,6
45,PAM,P010568,P011970,0 days 00:01:08,-2,0,2
45,PAM,P006643,P011982,0 days 00:00:52,-2,0,2
45,PAM,P010393,P011982,0 days 00:00:52,-2,0,2
45,PAM,P003960,P006643,0 days 00:00:48,0,2,2
45,PAM,P000556,P011970,0 days 00:00:47,0,0,0
45,PAM,P000556,P006643,0 days 00:00:17,1,3,2
45,PAM,P006643,P012738,0 days 00:00:17,1,3,2
45,PAM,P000556,P011982,0 days 00:00:04,0,0,0
46,MIL,P000796,P007831,0 days 00:24:18,2,41,39
46,MIL,P006509,P007831,0 days 00:23:51,-5,41,46
46,MIL,P007032,P007831,0 days 00:23:33,1,41,40
46,MIL,P000796,P007032,0 days 00:22:45,2,39,37
46,MIL,P000796,P006509,0 days 00:18:51,0,31,31
46,MIL,P002849,P007831,0 days 00:18:08,1,32,31
46,MIL,P000796,P002849,0 days 00:17:20,4,32,28
46,MIL,P006509,P007032,0 days 00:16:50,1,31,30
46,MIL,P002849,P006509,0 days 00:16:00,2,27,25
46,MIL,P002849,P007032,0 days 00:15:47,4,30,26
46,MIL,P009960,P011205,0 days 00:14:50,0,24,24
46,MIL,P006509,P009960,0 days 00:13:03,-12,19,31
46,MIL,P000796,P011205,0 days 00:11:47,-3,15,18
46,MIL,P006509,P011205,0 days 00:11:31,-7,16,23
46,MIL,P007831,P009960,0 days 00:11:10,-3,17,20
46,MIL,P007831,P011205,0 days 00:11:03,-7,14,21
46,MIL,P006509,P007201,0 days 00:10:03,-4,19,23
46,MIL,P007201,P009960,0 days 00:10:03,-4,19,23
46,MIL,P005670,P011205,0 days 00:09:26,-1,15,16
46,MIL,P005670,P009960,0 days 00:09:26,-1,18,19
46,MIL,P000796,P009960,0 days 00:08:02,6,13,7
46,MIL,P007201,P011205,0 days 00:07:54,-2,14,16
46,MIL,P005670,P006509,0 days 00:07:34,-5,12,17
46,MIL,P005670,P007201,0 days 00:06:18,-3,12,15
46,MIL,P007032,P009960,0 days 00:05:42,3,9,6
46,MIL,P007032,P011205,0 days 00:05:34,-3,7,10
46,MIL,P007201,P007831,0 days 00:05:17,-3,10,13
46,MIL,P000796,P002812,0 days 00:04:45,-5,5,10
46,MIL,P000796,P005670,0 days 00:04:40,0,6,6
46,MIL,P000796,P001518,0 days 00:03:24,2,6,4
46,MIL,P001518,P005670,0 days 00:03:24,2,6,4
46,MIL,P001518,P011205,0 days 00:03:24,2,6,4
46,MIL,P002812,P007032,0 days 00:03:24,-4,5,9
46,MIL,P002812,P007831,0 days 00:03:24,-4,5,9
46,MIL,P002849,P011205,0 days 00:03:20,-7,4,11
46,MIL,P002812,P011205,0 days 00:03:07,-4,1,5
46,MIL,P002849,P009960,0 days 00:01:57,0,3,3
46,MIL,P001518,P009960,0 days 00:01:52,4,6,2
46,MIL,P002812,P006509,0 days 00:01:49,-2,4,6
46,MIL,P005670,P007831,0 days 00:01:32,-2,3,5
46,MIL,P001518,P002812,0 days 00:01:32,-2,0,2
46,MIL,P002812,P005670,0 days 00:01:32,-2,0,2
46,MIL,P007032,P007201,0 days 00:00:37,0,2,2
46,MIL,P002812,P009960,0 days 00:00:11,-1,0,1
46,MCO,P005985,P011226,0 days 00:21:52,7,44,37
46,MCO,P011212,P011226,0 days 00:21:40,5,39,34
46,MCO,P005985,P011212,0 days 00:20:50,-2,35,37
46,MCO,P005985,P010588,0 days 00:17:47,-5,30,35
46,MCO,P011212,P011231,0 days 00:16:18,0,24,24
46,MCO,P005985,P011231,0 days 00:15:57,-3,23,26
46,MCO,P009754,P011226,0 days 00:15:15,14,35,21
46,MCO,P005985,PLCZ,0 days 00:15:06,-14,16,30
46,MCO,P011226,PLCZ,0 days 00:14:26,2,22,20
46,MCO,P011226,P011231,0 days 00:14:25,4,27,23
46,MCO,P010588,P011212,0 days 00:14:25,-5,28,33
46,MCO,P010588,PLCZ,0 days 00:14:10,-10,16,26
46,MCO,P005985,P009754,0 days 00:13:29,7,31,24
46,MCO,P011212,PLCZ,0 days 00:13:12,-7,16,23
46,MCO,P010588,P011226,0 days 00:13:00,4,27,23
46,MCO,P005985,P011196,0 days 00:11:16,9,26,17
46,MCO,P009754,P010588,0 days 00:10:54,1,20,19
46,MCO,P011196,P011212,0 days 00:10:14,7,23,16
46,MCO,P009754,PLCZ,0 days 00:09:22,5,12,7
46,MCO,P011196,P011231,0 days 00:09:12,9,20,11
46,MCO,P011231,PLCZ,0 days 00:09:04,-8,6,14
46,MCO,P009754,P011212,0 days 00:09:01,8,21,13
46,MCO,P011196,P011226,0 days 00:08:45,3,19,16
46,MCO,P009754,P011231,0 days 00:08:40,5,15,10
46,MCO,P009754,P011196,0 days 00:08:15,0,20,20
46,MCO,P002581,P011226,0 days 00:05:50,1,12,11
46,MCO,P010588,P011231,0 days 00:05:35,-8,4,12
46,MCO,P008099,P011212,0 days 00:05:04,4,10,6
46,MCO,P002581,P011212,0 days 00:04:33,-3,5,8
46,MCO,P010588,P011196,0 days 00:04:21,-1,11,12
46,MCO,P004790,P011226,0 days 00:04:19,5,10,5
46,MCO,P002581,P004790,0 days 00:04:19,5,10,5
46,MCO,P008099,P011231,0 days 00:03:55,1,7,6
46,MCO,P002581,P005985,0 days 00:03:25,2,7,5
46,MCO,P004790,P005985,0 days 00:03:10,2,7,5
46,MCO,P002581,P008099,0 days 00:02:55,-1,5,6
46,MCO,P004790,P011212,0 days 00:02:47,1,3,2
46,MCO,P008099,P011226,0 days 00:02:40,-1,5,6
46,MCO,P005985,P008099,0 days 00:02:24,5,5,0
46,MCO,P008099,P011196,0 days 00:02:09,5,5,0
46,MCO,P002581,P011231,0 days 00:01:46,-4,2,6
46,MCO,P002581,P009754,0 days 00:01:32,4,7,3
46,MCO,P004790,P009754,0 days 00:01:32,4,7,3
46,MCO,P004790,P008099,0 days 00:01:09,3,3,0
47,RED,P002553,P009035,0 days 00:20:49,-17,29,46
47,RED,P009035,P011224,0 days 00:20:10,-17,31,48
47,RED,P006436,P009035,0 days 00:18:48,1,35,34
47,RED,P002553,P006436,0 days 00:18:40,2,33,31
47,RED,P006436,PJDR,0 days 00:17:33,28,48,20
47,RED,P007960,PJDR,0 days 00:16:59,13,38,25
47,RED,P002553,P011224,0 days 00:16:33,-14,23,37
47,RED,P012044,PJDR,0 days 00:16:11,14,34,20
47,RED,P005099,P009035,0 days 00:15:36,-16,19,35
47,RED,P006436,P011224,0 days 00:14:17,-5,25,30
47,RED,P009035,PJDR,0 days 00:14:03,2,32,30
47,RED,P002553,P005099,0 days 00:14:02,-12,18,30
47,RED,P008966,P012044,0 days 00:13:22,16,27,11
47,RED,P006436,P012044,0 days 00:12:49,17,29,12
47,RED,P008966,PJDR,0 days 00:12:48,16,27,11
47,RED,P005099,P011224,0 days 00:12:36,-17,16,33
47,RED,P007960,P012044,0 days 00:11:45,13,27,14
47,RED,P002553,PJDR,0 days 00:11:00,5,24,19
47,RED,P007960,P008966,0 days 00:10:54,12,23,11
47,RED,P005099,P006436,0 days 00:10:13,-3,15,18
47,RED,P007960,P009035,0 days 00:09:21,-2,19,21
47,RED,P011224,PJDR,0 days 00:09:01,3,24,21
47,RED,P006436,P007960,0 days 00:08:59,18,27,9
47,RED,P006436,P008966,0 days 00:08:40,14,20,6
47,RED,P007960,P011224,0 days 00:08:13,-5,13,18
47,RED,P002553,P012044,0 days 00:06:57,-2,9,11
47,RED,P007960,P012711,0 days 00:05:38,1,9,8
47,RED,P012711,PJDR,0 days 00:05:38,1,9,8
47,RED,P009035,P012044,0 days 00:04:49,-2,9,11
47,RED,P005099,PJDR,0 days 00:04:43,2,12,10
47,RED,P005099,P007960,0 days 00:04:42,-4,8,12
47,RED,P002553,P007960,0 days 00:04:33,-6,4,10
47,RED,P008966,P012711,0 days 00:04:31,2,7,5
47,RED,P012044,P012711,0 days 00:04:18,2,7,5
47,RED,P002553,P008966,0 days 00:03:05,4,4,0
47,RED,P011224,P012044,0 days 00:02:02,0,2,2
47,RED,P011224,P012711,0 days 00:01:20,-1,2,3
47,RED,P009035,P012711,0 days 00:01:07,-1,2,3
47,RED,P008966,P011224,0 days 00:01:00,0,0,0
47,RED,P005099,P012044,0 days 00:00:35,-2,0,2
47,RED,P002553,P004720,0 days 00:00:25,0,0,0
47,RED,P004720,P005099,0 days 00:00:25,0,0,0
47,RED,P004720,P006436,0 days 00:00:25,0,0,0
47,RED,P004720,P009035,0 days 00:00:25,0,0,0
47,MUN,P003583,P007056,0 days 00:26:24,15,57,42
47,MUN,P007056,P011987,0 days 00:22:05,3,40,37
47,MUN,P006760,P011987,0 days 00:20:59,2,39,37
47,MUN,P003583,P006760,0 days 00:20:55,6,41,35
47,MUN,P003583,P011987,0 days 00:20:33,14,43,29
47,MUN,P006760,P007056,0 days 00:20:24,7,39,32
47,MUN,P003583,P007975,0 days 00:18:54,-1,33,34
47,MUN,P007056,P008985,0 days 00:15:06,9,31,22
47,MUN,P008985,P011987,0 days 00:15:06,9,31,22
47,MUN,P003583,P008985,0 days 00:14:47,11,31,20
47,MUN,P007056,P007975,0 days 00:14:12,3,27,24
47,MUN,P003583,P010391,0 days 00:13:52,-10,23,33
47,MUN,P004508,P007975,0 days 00:13:13,-10,17,27
47,MUN,P007975,P010391,0 days 00:11:46,-5,20,25
47,MUN,P006760,P008985,0 days 00:11:26,12,27,15
47,MUN,P007056,P010391,0 days 00:11:21,-4,24,28
47,MUN,P006760,P007975,0 days 00:11:03,-8,11,19
47,MUN,P004508,P010391,0 days 00:10:48,-9,17,26
47,MUN,P003583,P004508,0 days 00:10:48,-9,17,26
47,MUN,P007975,P011987,0 days 00:10:07,0,16,16
47,MUN,P006760,P010391,0 days 00:08:06,-15,9,24
47,MUN,P004508,P007056,0 days 00:07:08,1,16,15
47,MUN,P006760,P011941,0 days 00:06:02,-13,2,15
47,MUN,P005460,P007975,0 days 00:05:12,0,8,8
47,MUN,P011941,P011987,0 days 00:05:02,-8,5,13
47,MUN,P007975,P011941,0 days 00:04:53,-4,3,7
47,MUN,P004508,P006760,0 days 00:04:53,-10,1,11
47,MUN,P010391,P011987,0 days 00:04:21,-8,5,13
47,MUN,P007975,P008985,0 days 00:03:40,-3,4,7
47,MUN,P003583,P005460,0 days 00:03:29,-4,5,9
47,MUN,P001557,P007975,0 days 00:03:24,0,5,5
47,MUN,P001557,P011941,0 days 00:03:22,-2,3,5
47,MUN,P007056,P011941,0 days 00:03:16,-6,2,8
47,MUN,P005460,P011987,0 days 00:02:59,4,8,4
47,MUN,P010391,P011941,0 days 00:02:22,-6,2,8
47,MUN,P004508,P005460,0 days 00:02:20,-7,0,7
47,MUN,P005460,P010391,0 days 00:02:20,-7,0,7
47,MUN,P004508,P011941,0 days 00:02:13,-2,0,2
47,MUN,P001557,P006760,0 days 00:02:09,-5,0,5
47,MUN,P001557,P011987,0 days 00:02:05,2,5,3
47,MUN,P005460,P006760,0 days 00:01:51,-4,3,7
47,MUN,P005460,P011941,0 days 00:01:50,1,3,2
47,MUN,P001557,P004508,0 days 00:01:19,-2,0,2
47,MUN,P001557,P005460,0 days 00:01:15,5,5,0
47,MUN,P004508,P008985,0 days 00:00:19,-2,0,2
47,MUN,P004508,P011987,0 days 00:00:19,-2,0,2
47,MUN,P001557,P003583,0 days 00:00:02,2,2,0
48,TEL,P009622,P011199,0 days 00:21:28,-2,39,41
48,TEL,P009622,P009783,0 days 00:21:27,-6,41,47
48,TEL,P009863,P011199,0 days 00:20:58,-13,31,44
48,TEL,P009783,P009863,0 days 00:20:43,-15,34,49
48,TEL,P009783,P011199,0 days 00:20:23,-12,35,47
48,TEL,P009622,P009863,0 days 00:20:05,-6,34,40
48,TEL,P009622,P012744,0 days 00:14:40,-7,24,31
48,TEL,P009622,P011971,0 days 00:14:04,7,36,29
48,TEL,P009622,P011214,0 days 00:12:06,-1,26,27
48,TEL,P011214,P012744,0 days 00:11:16,-14,23,37
48,TEL,P011193,P012744,0 days 00:11:02,-12,24,36
48,TEL,P011971,P012744,0 days 00:10:47,-7,23,30
48,TEL,P011193,P011971,0 days 00:10:30,-5,24,29
48,TEL,P011193,P011214,0 days 00:10:12,-13,20,33
48,TEL,P005145,P009622,0 days 00:09:39,-8,17,25
48,TEL,P009622,P011193,0 days 00:09:21,2,22,20
48,TEL,P009863,P011214,0 days 00:09:18,-13,15,28
48,TEL,P011199,P011971,0 days 00:09:14,-1,19,20
48,TEL,P011214,P011971,0 days 00:09:04,-8,19,27
48,TEL,P009863,P012744,0 days 00:09:01,-19,8,27
48,TEL,P009783,P011971,0 days 00:08:47,-3,18,21
48,TEL,P009863,P011971,0 days 00:08:34,-10,13,23
48,TEL,P009783,P012744,0 days 00:06:44,-7,5,12
48,TEL,P011199,P012744,0 days 00:06:30,-5,6,11
48,TEL,P009783,P011214,0 days 00:06:08,-1,12,13
48,TEL,P005145,P011199,0 days 00:05:54,-6,12,18
48,TEL,P005145,P009783,0 days 00:05:54,-6,12,18
48,TEL,P005145,P009863,0 days 00:05:54,-6,12,18
48,TEL,P009863,P011193,0 days 00:05:48,-13,6,19
48,TEL,P009622,P011219,0 days 00:05:04,-4,8,12
48,TEL,P011193,P011199,0 days 00:04:16,2,8,6
48,TEL,P011199,P011214,0 days 00:03:45,2,6,4
48,TEL,P004233,P005145,0 days 00:03:45,-2,5,7
48,TEL,P004233,P009622,0 days 00:03:45,-2,5,7
48,TEL,P004233,P011219,0 days 00:03:45,-2,5,7
48,TEL,P005145,P011219,0 days 00:03:45,-2,5,7
48,TEL,P011214,P011219,0 days 00:03:31,-8,7,15
48,TEL,P009863,P011219,0 days 00:03:31,-8,7,15
48,TEL,P011219,P012744,0 days 00:03:20,-7,5,12
48,TEL,P011219,P011433,0 days 00:02:37,-1,4,5
48,TEL,P009622,P011433,0 days 00:02:37,-1,4,5
48,TEL,P004233,P011433,0 days 00:02:37,-1,4,5
48,TEL,P005145,P011433,0 days 00:02:37,-1,4,5
48,TEL,P011193,P011219,0 days 00:02:12,-6,4,10
48,TEL,P004233,P009783,0 days 00:02:12,-9,0,9
48,TEL,P004233,P011971,0 days 00:02:12,-9,0,9
48,TEL,P004233,P011199,0 days 00:02:12,-9,0,9
48,TEL,P004233,P009863,0 days 00:02:12,-9,0,9
48,TEL,P009783,P011219,0 days 00:01:19,-2,3,5
48,TEL,P004233,P012744,0 days 00:01:08,-1,1,2
48,TEL,P005145,P012744,0 days 00:01:08,-1,1,2
48,TEL,P009783,P011193,0 days 00:00:59,1,4,3
48,MAD,P003108,P005928,0 days 00:22:42,12,57,45
48,MAD,P005928,P009005,0 days 00:22:11,20,60,40
48,MAD,P005791,P005928,0 days 00:19:34,14,46,32
48,MAD,P003108,P009005,0 days 00:18:51,15,50,35
48,MAD,P005791,P009005,0 days 00:18:32,16,44,28
48,MAD,P003108,P005791,0 days 00:18:16,11,42,31
48,MAD,P006540,PBMT,0 days 00:13:33,15,35,20
48,MAD,P003108,P003733,0 days 00:13:26,7,31,24
48,MAD,P003733,P009005,0 days 00:13:26,7,31,24
48,MAD,P003733,P005928,0 days 00:13:26,7,31,24
48,MAD,P003733,P005791,0 days 00:13:26,7,31,24
48,MAD,P006540,P009005,0 days 00:12:51,13,36,23
48,MAD,P004887,P006540,0 days 00:12:09,15,38,23
48,MAD,P009213,PCVM,0 days 00:11:35,11,28,17
48,MAD,P004887,PCVM,0 days 00:11:21,13,29,16
48,MAD,P005928,P006540,0 days 00:10:41,11,31,20
48,MAD,PBMT,PCVM,0 days 00:10:13,10,25,15
48,MAD,P006540,PCVM,0 days 00:10:13,10,25,15
48,MAD,P004887,P009213,0 days 00:09:52,12,25,13
48,MAD,P009213,PBMT,0 days 00:09:45,8,26,18
48,MAD,P004887,PBMT,0 days 00:09:38,13,28,15
48,MAD,P006540,P009213,0 days 00:07:50,9,21,12
48,MAD,P009005,PBMT,0 days 00:07:26,5,17,12
48,MAD,P003108,P006540,0 days 00:07:21,6,21,15
48,MAD,P005791,P006540,0 days 00:07:02,7,15,8
48,MAD,P004887,P009005,0 days 00:06:02,5,20,15
48,MAD,P005928,PBMT,0 days 00:05:15,4,15,11
48,MAD,P004887,P005928,0 days 00:04:33,4,16,12
48,MAD,P009005,PCVM,0 days 00:04:06,0,7,7
48,MAD,P003108,PTGB,0 days 00:03:51,-3,7,10
48,MAD,P005928,PTGB,0 days 00:03:51,-3,7,10
48,MAD,P004887,P011649,0 days 00:03:45,2,7,5
48,MAD,P009213,P011649,0 days 00:03:45,2,7,5
48,MAD,P003733,PCVM,0 days 00:03:45,2,7,5
48,MAD,P003733,P011649,0 days 00:03:45,2,7,5
48,MAD,P003733,P009213,0 days 00:03:45,2,7,5
48,MAD,P011649,PCVM,0 days 00:03:45,2,7,5
48,MAD,P003733,P004887,0 days 00:03:45,2,7,5
48,MAD,P003108,P004887,0 days 00:02:31,2,10,8
48,MAD,P005791,PBMT,0 days 00:02:12,3,4,1
48,MAD,P005791,PTGB,0 days 00:01:56,-2,2,4
48,MAD,P006540,PTGB,0 days 00:01:56,-2,2,4
48,MAD,PBMT,PTGB,0 days 00:01:55,-1,5,6
48,MAD,P003108,P009213,0 days 00:01:55,-1,5,6
48,MAD,P009213,PTGB,0 days 00:01:55,-1,5,6
48,MAD,P005928,P009213,0 days 00:01:55,-1,5,6
48,MAD,P003108,PBMT,0 days 00:01:55,-1,5,6
48,MAD,P009005,P009213,0 days 00:01:43,-1,3,4
48,MAD,P005791,PCVM,0 days 00:00:54,0,0,0
49,ZAL,P002329,P011218,0 days 00:21:54,-4,43,47
49,ZAL,P010390,P011218,0 days 00:20:05,10,48,38
49,ZAL,P002329,P010390,0 days 00:18:38,14,45,31
49,ZAL,P002676,P003211,0 days 00:15:45,-4,30,34
49,ZAL,P007109,P011218,0 days 00:14:49,-7,32,39
49,ZAL,P002329,P007109,0 days 00:14:21,4,36,32
49,ZAL,P003211,P011218,0 days 00:13:19,-9,24,33
49,ZAL,P002329,P003211,0 days 00:12:43,-2,19,21
49,ZAL,P003211,P005504,0 days 00:12:35,-1,30,31
49,ZAL,P002676,P011218,0 days 00:12:21,-14,12,26
49,ZAL,P003210,P007109,0 days 00:12:10,17,38,21
49,ZAL,P003210,P010390,0 days 00:11:48,13,36,23
49,ZAL,P002329,P003210,0 days 00:11:48,13,36,23
49,ZAL,P007109,P010390,0 days 00:11:33,8,36,28
49,ZAL,P003210,P011218,0 days 00:10:55,8,33,25
49,ZAL,P003211,P007109,0 days 00:10:05,1,23,22
49,ZAL,P011218,P012715,0 days 00:09:57,-5,21,26
49,ZAL,P003211,P010390,0 days 00:09:38,4,21,17
49,ZAL,P005504,P012715,0 days 00:09:31,-12,22,34
49,ZAL,P003211,P012715,0 days 00:09:04,-3,24,27
49,ZAL,P002329,P002676,0 days 00:08:50,-9,8,17
49,ZAL,P002676,P005504,0 days 00:08:15,1,22,21
49,ZAL,P005504,P011965,0 days 00:08:02,-7,18,25
49,ZAL,P002676,P007109,0 days 00:07:31,-6,9,15
49,ZAL,P002329,P012715,0 days 00:07:29,-5,12,17
49,ZAL,P007513,P011218,0 days 00:06:57,-5,12,17
49,ZAL,P003211,P011965,0 days 00:06:52,-2,16,18
49,ZAL,P002676,P012715,0 days 00:06:37,-6,15,21
49,ZAL,P011965,P012715,0 days 00:06:36,-8,15,23
49,ZAL,P002676,P010390,0 days 00:05:17,0,6,6
49,ZAL,P002329,P011965,0 days 00:04:56,-6,7,13
49,ZAL,P002329,P005504,0 days 00:04:56,-6,7,13
49,ZAL,P003210,P003211,0 days 00:04:49,8,16,8
49,ZAL,P010390,P012715,0 days 00:04:42,6,12,6
49,ZAL,P007109,P007513,0 days 00:04:41,-10,5,15
49,ZAL,P007513,P010390,0 days 00:04:27,1,12,11
49,ZAL,P005504,P007109,0 days 00:04:14,6,10,4
49,ZAL,P005504,P011218,0 days 00:04:05,-9,9,18
49,ZAL,P007513,P012715,0 days 00:03:26,3,7,4
49,ZAL,P003210,P005504,0 days 00:03:22,4,10,6
49,ZAL,P002676,P011965,0 days 00:03:06,-1,11,12
49,ZAL,P003210,P012715,0 days 00:03:00,0,8,8
49,ZAL,P003211,P007513,0 days 00:02:54,0,9,9
49,ZAL,P002329,P007513,0 days 00:02:53,-3,3,6
49,ZAL,P002676,P003210,0 days 00:02:48,5,7,2
49,ZAL,P002676,P007513,0 days 00:02:30,-6,0,6
49,ZAL,P007109,P011965,0 days 00:01:26,1,3,2
49,ZAL,P011218,P011965,0 days 00:01:10,-5,2,7
49,ZAL,P007109,P012715,0 days 00:01:10,-2,0,2
49,ASV,P004194,P012080,0 days 00:22:24,14,51,37
49,ASV,P004194,P012729,0 days 00:20:41,13,48,35
49,ASV,P012080,P012729,0 days 00:20:13,17,49,32
49,ASV,P012729,PKIR,0 days 00:18:55,19,46,27
49,ASV,P004194,P011225,0 days 00:18:03,-16,36,52
49,ASV,P012080,PKIR,0 days 00:17:55,19,44,25
49,ASV,P002100,P004194,0 days 00:16:36,5,42,37
49,ASV,P002100,P012080,0 days 00:16:26,8,43,35
49,ASV,P002100,P012729,0 days 00:16:17,14,47,33
49,ASV,P004194,PKIR,0 days 00:16:11,15,37,22
49,ASV,P006568,P011225,0 days 00:15:44,-10,34,44
49,ASV,P004194,P012732,0 days 00:15:07,-3,29,32
49,ASV,P004194,P006568,0 days 00:13:33,-14,25,39
49,ASV,P002100,P006568,0 days 00:11:51,-1,31,32
49,ASV,P002100,PKIR,0 days 00:11:48,12,33,21
49,ASV,P012729,P012732,0 days 00:10:24,5,21,16
49,ASV,P003526,P004194,0 days 00:09:54,-12,18,30
49,ASV,P003526,P006568,0 days 00:09:54,-12,18,30
49,ASV,P003526,P011225,0 days 00:09:54,-12,18,30
49,ASV,P002100,P011225,0 days 00:09:43,1,27,26
49,ASV,P006568,P012080,0 days 00:09:21,-3,20,23
49,ASV,P012732,PKIR,0 days 00:08:07,7,15,8
49,ASV,P011225,P012080,0 days 00:07:13,-1,16,17
49,ASV,P012080,P012732,0 days 00:07:07,7,13,6
49,ASV,P011225,P012732,0 days 00:07:00,-10,14,24
49,ASV,P011225,P012729,0 days 00:06:41,2,20,18
49,ASV,P006568,P012729,0 days 00:05:46,4,18,14
49,ASV,P006568,P012732,0 days 00:04:43,-8,8,16
49,ASV,P003526,P012732,0 days 00:04:43,-8,8,16
49,ASV,P000229,P012729,0 days 00:03:48,-2,9,11
49,ASV,P004194,P012731,0 days 00:03:22,-4,6,10
49,ASV,P011225,P012731,0 days 00:03:22,-4,6,10
49,ASV,P000229,P006568,0 days 00:03:21,0,9,9
49,ASV,P000229,P011225,0 days 00:03:16,2,9,7
49,ASV,P012729,P012731,0 days 00:03:03,-4,6,10
49,ASV,P000229,P002100,0 days 00:03:02,0,9,9
49,ASV,P002100,P003526,0 days 00:02:45,-3,6,9
49,ASV,P006568,PKIR,0 days 00:02:44,4,9,5
49,ASV,P003526,P012080,0 days 00:02:26,-1,4,5
49,ASV,P012731,P012732,0 days 00:02:17,-2,6,8
49,ASV,P000229,P004194,0 days 00:01:05,-2,0,2
49,ASV,P000229,P012731,0 days 00:01:05,-2,0,2
49,ASV,P002100,P012732,0 days 00:01:00,0,2,2
49,ASV,P000229,P012080,0 days 00:00:51,-4,0,4
49,ASV,P006568,P012731,0 days 00:00:19,0,0,0
50,ULK,P006661,P008962,0 days 00:24:54,-6,46,52
50,ULK,P005844,P008962,0 days 00:24:21,1,48,47
50,ULK,P008962,P009849,0 days 00:22:34,-7,40,47
50,ULK,P006661,P009849,0 days 00:21:30,-6,38,44
50,ULK,P004004,P008962,0 days 00:20:30,7,44,37
50,ULK,P001932,P008962,0 days 00:19:51,2,38,36
50,ULK,P001932,P005844,0 days 00:19:51,2,38,36
50,ULK,P004004,P005844,0 days 00:17:26,9,39,30
50,ULK,P009849,P011157,0 days 00:15:39,1,31,30
50,ULK,P008962,P011157,0 days 00:15:39,1,31,30
50,ULK,P006661,P011157,0 days 00:15:39,1,31,30
50,ULK,P001932,P004004,0 days 00:15:19,7,34,27
50,ULK,P008962,P011052,0 days 00:12:37,2,29,27
50,ULK,P006661,P011052,0 days 00:12:20,2,29,27
50,ULK,P008962,P011980,0 days 00:11:14,-6,13,19
50,ULK,P009849,P011052,0 days 00:10:13,0,24,24
50,ULK,P005844,P006661,0 days 00:09:15,-7,15,22
50,ULK,P005844,P010560,0 days 00:08:20,14,27,13
50,ULK,P004004,P010560,0 days 00:08:20,14,27,13
50,ULK,P001932,P010560,0 days 00:08:20,14,27,13
50,ULK,P008962,P010560,0 days 00:08:20,14,27,13
50,ULK,P011052,P011157,0 days 00:07:50,3,19,16
50,ULK,P005844,P009849,0 days 00:06:55,-8,9,17
50,ULK,P005844,P011980,0 days 00:06:29,-6,6,12
50,ULK,P001932,P011980,0 days 00:06:29,-6,6,12
50,ULK,P004004,P006661,0 days 00:06:28,-2,13,15
50,ULK,P009849,P011980,0 days 00:05:49,-1,9,10
50,ULK,P004004,P011980,0 days 00:05:25,-5,4,9
50,ULK,P005844,P011052,0 days 00:04:47,-1,10,11
50,ULK,P006661,P011980,0 days 00:04:45,0,7,7
50,ULK,P001932,P006661,0 days 00:04:45,-6,5,11
50,ULK,P011157,P011980,0 days 00:04:45,0,7,7
50,ULK,P001932,P009849,0 days 00:04:32,-5,4,9
50,ULK,P004004,P009849,0 days 00:03:04,-2,5,7
50,ULK,P004004,P011157,0 days 00:03:04,-2,5,7
50,ULK,P004004,P011052,0 days 00:02:24,2,5,3
50,ULK,P001932,P011052,0 days 00:00:17,0,0,0
50,OLY,P001255,P010612,0 days 00:28:49,-3,56,59
50,OLY,P001255,P008829,0 days 00:27:02,0,57,57
50,OLY,P008829,P010612,0 days 00:25:14,3,54,51
50,OLY,P008829,P008855,0 days 00:22:48,5,51,46
50,OLY,P001255,P008811,0 days 00:20:28,1,39,38
50,OLY,P008811,P010612,0 days 00:20:28,1,39,38
50,OLY,P001255,P008855,0 days 00:19:07,-2,40,42
50,OLY,P001255,P007982,0 days 00:18:52,-9,31,40
50,OLY,P003941,P007982,0 days 00:18:02,-3,33,36
50,OLY,P008855,P010612,0 days 00:17:19,1,37,36
50,OLY,P008811,P008829,0 days 00:16:26,4,35,31
50,OLY,P007982,P008829,0 days 00:15:46,3,33,30
50,OLY,P003941,P008829,0 days 00:15:32,1,33,32
50,OLY,P008811,P008855,0 days 00:14:42,2,30,28
50,OLY,P001255,P003941,0 days 00:14:36,-8,27,35
50,OLY,P007982,P010612,0 days 00:13:24,-4,23,27
50,OLY,P007982,P011983,0 days 00:11:51,-1,18,19
50,OLY,P003941,P010612,0 days 00:09:08,-3,19,22
50,OLY,P003941,P008855,0 days 00:08:26,1,21,20
50,OLY,P003941,P011983,0 days 00:07:49,2,14,12
50,OLY,P001255,P011983,0 days 00:07:42,-5,9,14
50,OLY,P007982,P008855,0 days 00:06:56,1,16,15
50,OLY,P007982,P008811,0 days 00:05:46,-1,9,10
50,OLY,P003941,P010392,0 days 00:04:35,-2,5,7
50,OLY,P007982,P010392,0 days 00:04:35,-2,5,7
50,OLY,P010392,P011983,0 days 00:04:35,-2,5,7
50,OLY,P008829,P011983,0 days 00:04:09,4,9,5
50,OLY,P008811,P011983,0 days 00:04:02,-3,4,7
50,OLY,P010612,P011983,0 days 00:04:02,-3,4,7
50,OLY,P001255,P010392,0 days 00:03:40,-2,5,7
50,OLY,P008855,P011983,0 days 00:03:14,4,9,5
50,OLY,P008829,P010392,0 days 00:00:55,0,0,0
51,BAR,P004866,P012745,0 days 00:18:37,7,42,35
51,BAR,P002939,P004866,0 days 00:16:54,17,41,24
51,BAR,P004866,P009992,0 days 00:15:29,11,42,31
51,BAR,P000925,P002939,0 days 00:14:27,21,34,13
51,BAR,P003204,P012745,0 days 00:13:36,0,28,28
51,BAR,P009992,P012745,0 days 00:13:29,10,35,25
51,BAR,P003204,P007464,0 days 00:13:18,-5,21,26
51,BAR,P000925,P004866,0 days 00:12:53,19,32,13
51,BAR,P002939,P012745,0 days 00:12:50,14,30,16
51,BAR,P003204,P009992,0 days 00:11:55,-7,17,24
51,BAR,P002939,P009992,0 days 00:11:52,15,32,17
51,BAR,P000925,P012745,0 days 00:11:44,17,29,12
51,BAR,P003196,P003204,0 days 00:11:35,2,22,20
51,BAR,P003478,P012745,0 days 00:11:01,6,21,15
51,BAR,P009992,P011244,0 days 00:10:49,-4,16,20
51,BAR,P003196,P009992,0 days 00:10:46,-1,23,24
51,BAR,P003196,P012745,0 days 00:10:06,2,22,20
51,BAR,P000925,P003478,0 days 00:09:08,6,19,13
51,BAR,P007464,P009992,0 days 00:08:54,-6,9,15
51,BAR,P003478,P004866,0 days 00:08:53,3,15,12
51,BAR,P003196,P004866,0 days 00:08:49,-2,20,22
51,BAR,P000925,P009992,0 days 00:07:51,17,23,6
51,BAR,P003204,P004866,0 days 00:07:38,-3,14,17
51,BAR,P007464,P012745,0 days 00:07:32,5,16,11
51,BAR,P003204,P003478,0 days 00:07:27,2,16,14
51,BAR,P007464,P011244,0 days 00:07:15,-7,7,14
51,BAR,P003204,P011244,0 days 00:07:15,-7,7,14
51,BAR,P003204,P010641,0 days 00:06:49,-12,5,17
51,BAR,P003196,P007464,0 days 00:06:47,2,11,9
51,BAR,P002939,P003478,0 days 00:06:36,4,11,7
51,BAR,P004866,P011244,0 days 00:06:31,4,15,11
51,BAR,P002939,P011244,0 days 00:06:31,4,15,11
51,BAR,P009992,P010641,0 days 00:05:46,-11,5,16
51,BAR,P003196,P011244,0 days 00:05:25,-1,9,10
51,BAR,P000925,P011244,0 days 00:05:15,6,13,7
51,BAR,P003478,P007464,0 days 00:05:10,3,12,9
51,BAR,P003196,P003478,0 days 00:04:55,0,8,8
51,BAR,P010641,P012745,0 days 00:04:19,-7,7,14
51,BAR,P000925,P007464,0 days 00:04:06,4,10,6
51,BAR,P002939,P003196,0 days 00:04:01,-2,9,11
51,BAR,P007464,P010641,0 days 00:03:59,-9,2,11
51,BAR,P004866,P010641,0 days 00:03:26,-6,5,11
51,BAR,P010641,P011244,0 days 00:03:06,-8,0,8
51,BAR,P003478,P011244,0 days 00:02:57,1,6,5
51,BAR,P000925,P003204,0 days 00:02:32,2,8,6
51,BAR,P002939,P007464,0 days 00:02:27,1,4,3
51,BAR,P004866,P011666,0 days 00:01:22,-6,2,8
51,BAR,P010641,P011666,0 days 00:01:22,-6,2,8
51,BAR,P011666,P012745,0 days 00:01:22,-6,2,8
51,BAR,P002939,P003204,0 days 00:00:53,-1,2,3
51,BAR,P002939,P010641,0 days 00:00:53,-1,2,3
51,BAR,P003204,P011666,0 days 00:00:46,-3,0,3
51,BAR,P009992,P011666,0 days 00:00:36,-3,2,5
51,BAR,P003478,P009992,0 days 00:00:05,-1,0,1
51,PAN,P007866,P011204,0 days 00:23:35,-20,31,51
51,PAN,P002328,P011204,0 days 00:21:50,-19,32,51
51,PAN,P003842,P007866,0 days 00:17:53,-12,28,40
51,PAN,P003842,P011204,0 days 00:17:53,-12,28,40
51,PAN,P007866,P011826,0 days 00:17:30,-1,26,27
51,PAN,P002328,P007866,0 days 00:16:27,-16,20,36
51,PAN,P011204,P012712,0 days 00:15:39,-10,26,36
51,PAN,P002328,P011209,0 days 00:14:53,-16,25,41
51,PAN,P011204,P011826,0 days 00:14:35,-11,18,29
51,PAN,P002328,P003842,0 days 00:13:27,-7,21,28
51,PAN,P002328,P012712,0 days 00:12:57,-7,21,28
51,PAN,P011204,P011209,0 days 00:12:09,-15,20,35
51,PAN,P007553,P011204,0 days 00:11:55,-1,25,26
51,PAN,P007866,P012712,0 days 00:11:38,-11,16,27
51,PAN,P007553,P008084,0 days 00:11:22,12,27,15
51,PAN,P003842,P011826,0 days 00:10:38,-11,12,23
51,PAN,P007553,P011826,0 days 00:09:09,12,20,8
51,PAN,P007866,P011209,0 days 00:09:03,-10,14,24
51,PAN,P006544,P007866,0 days 00:08:42,10,19,9
51,PAN,P003842,P012712,0 days 00:08:38,-2,17,19
51,PAN,P007553,P007866,0 days 00:08:38,10,17,7
51,PAN,P007866,P008084,0 days 00:08:38,10,17,7
51,PAN,P011209,P012712,0 days 00:08:28,-10,11,21
51,PAN,P006544,P007553,0 days 00:08:20,18,25,7
51,PAN,P006544,P008084,0 days 00:08:20,18,25,7
51,PAN,P011826,P012712,0 days 00:07:43,-2,16,18
51,PAN,P002328,P011826,0 days 00:07:29,-5,8,13
51,PAN,P002328,P007553,0 days 00:07:07,-5,14,19
51,PAN,P008084,P011826,0 days 00:06:52,10,14,4
51,PAN,P008084,P011204,0 days 00:06:10,0,13,13
51,PAN,P003842,P011209,0 days 00:06:03,-1,15,16
51,PAN,P007553,P012712,0 days 00:05:45,-1,12,13
51,PAN,P006544,P011826,0 days 00:05:12,12,14,2
51,PAN,P007553,P011209,0 days 00:04:50,-7,8,15
51,PAN,P006544,P011204,0 days 00:03:08,6,11,5
51,PAN,P006544,P011209,0 days 00:02:14,-1,3,4
51,PAN,P006544,P012712,0 days 00:02:14,-1,3,4
51,PAN,P002328,P006544,0 days 00:02:14,-1,3,4
51,PAN,P002328,P008084,0 days 00:01:52,-4,4,8
51,PAN,P008084,P011209,0 days 00:01:52,-4,4,8
51,PAN,P006544,P011442,0 days 00:01:22,6,8,2
51,PAN,P007553,P011442,0 days 00:01:22,6,8,2
51,PAN,P008084,P011442,0 days 00:01:22,6,8,2
51,PAN,P011204,P011442,0 days 00:01:22,6,8,2
51,PAN,P003842,P006544,0 days 00:00:30,1,1,0
51,PAN,P003842,P008084,0 days 00:00:30,0,2,2
51,PAN,P008084,P012712,0 days 00:00:30,0,2,2
52,BAS,P007230,P009048,0 days 00:23:18,-3,49,52
52,BAS,P004761,P007230,0 days 00:21:32,1,40,39
52,BAS,P007230,P011948,0 days 00:20:30,1,47,46
52,BAS,P004603,P009048,0 days 00:20:12,0,42,42
52,BAS,P004761,P009048,0 days 00:20:01,7,42,35
52,BAS,P009048,P011948,0 days 00:19:46,5,45,40
52,BAS,P004761,P012201,0 days 00:19:36,4,41,37
52,BAS,P004603,P007230,0 days 00:17:49,0,37,37
52,BAS,P004603,P004761,0 days 00:17:26,5,35,30
52,BAS,P004603,P011948,0 days 00:14:39,4,31,27
52,BAS,P004761,P011948,0 days 00:14:30,8,31,23
52,BAS,P004761,P012765,0 days 00:14:01,1,30,29
52,BAS,P007230,P010444,0 days 00:12:33,-4,23,27
52,BAS,P012201,P012765,0 days 00:12:04,-2,23,25
52,BAS,P004761,P010444,0 days 00:11:36,-1,21,22
52,BAS,P008850,P009048,0 days 00:11:36,-9,24,33
52,BAS,P007230,P008850,0 days 00:11:36,-9,24,33
52,BAS,P007230,P012201,0 days 00:11:02,0,21,21
52,BAS,P009048,P012201,0 days 00:10:18,6,25,19
52,BAS,P008850,P011948,0 days 00:09:54,-4,24,28
52,BAS,P004603,P012201,0 days 00:09:34,3,23,20
52,BAS,P010444,P012201,0 days 00:09:05,2,16,14
52,BAS,P010444,P011948,0 days 00:08:41,-1,20,21
52,BAS,P009048,P010444,0 days 00:08:39,2,20,18
52,BAS,P010444,P012765,0 days 00:08:05,-2,14,16
52,BAS,P004603,P008850,0 days 00:07:31,-9,14,23
52,BAS,P007230,P012765,0 days 00:07:24,2,15,13
52,BAS,P011948,P012201,0 days 00:06:45,3,15,12
52,BAS,P009048,P012765,0 days 00:05:50,4,17,13
52,BAS,P004603,P012765,0 days 00:05:49,1,14,13
52,BAS,P008850,P010444,0 days 00:04:05,0,10,10
52,BAS,P011948,P012765,0 days 00:02:51,0,7,7
52,BAS,P004761,P008850,0 days 00:01:42,-5,0,5
52,PAR,P007400,P012743,0 days 00:21:23,5,51,46
52,PAR,P007400,P008987,0 days 00:19:43,7,48,41
52,PAR,P004058,P012743,0 days 00:19:08,5,44,39
52,PAR,P004058,P007400,0 days 00:17:52,5,43,38
52,PAR,P008987,P012743,0 days 00:17:33,6,43,37
52,PAR,P000956,P012743,0 days 00:17:15,2,38,36
52,PAR,P000956,P007400,0 days 00:15:53,3,36,33
52,PAR,P003983,P009212,0 days 00:15:29,2,27,25
52,PAR,P003983,P007673,0 days 00:15:05,-1,29,30
52,PAR,P007673,P009212,0 days 00:15:02,4,31,27
52,PAR,P000956,P008987,0 days 00:14:56,4,34,30
52,PAR,P004058,P008987,0 days 00:14:44,6,35,29
52,PAR,P000956,P004058,0 days 00:14:14,3,29,26
52,PAR,P003983,P011051,0 days 00:13:46,1,26,25
52,PAR,P007673,P011051,0 days 00:13:46,-3,27,30
52,PAR,P007400,P007673,0 days 00:12:38,1,27,26
52,PAR,P003983,P007400,0 days 00:11:33,-5,20,25
52,PAR,P009212,P011051,0 days 00:11:26,4,22,18
52,PAR,P007400,P009212,0 days 00:09:24,-5,15,20
52,PAR,P003983,P012742,0 days 00:08:32,1,18,17
52,PAR,P007673,P012742,0 days 00:08:26,-2,18,20
52,PAR,P003983,P008987,0 days 00:07:46,-9,16,25
52,PAR,P007400,P011051,0 days 00:07:44,-3,12,15
52,PAR,P011051,P012742,0 days 00:07:43,0,15,15
52,PAR,P007673,P008987,0 days 00:07:16,-7,17,24
52,PAR,P009212,P012742,0 days 00:07:06,6,18,12
52,PAR,P003983,P012743,0 days 00:07:01,-4,11,15
52,PAR,P000956,P003983,0 days 00:06:07,-2,11,13
52,PAR,P009212,P012743,0 days 00:06:04,-2,10,12
52,PAR,P007673,P012743,0 days 00:06:04,4,15,11
52,PAR,P004058,P009212,0 days 00:06:00,-5,10,15
52,PAR,P004058,P007673,0 days 00:05:59,0,16,16
52,PAR,P008987,P011051,0 days 00:03:43,-7,5,12
52,PAR,P000956,P009212,0 days 00:03:11,-2,4,6
52,PAR,P008987,P012742,0 days 00:03:05,-10,3,13
52,PAR,P003983,P004058,0 days 00:02:45,-3,2,5
52,PAR,P004058,P011051,0 days 00:01:36,-4,1,5
52,PAR,P008987,P009212,0 days 00:01:14,-2,3,5
52,PAR,P000956,P011051,0 days 00:00:52,0,0,0
52,PAR,P004058,P012742,0 days 00:00:38,-3,0,3
52,PAR,P007400,P012742,0 days 00:00:18,0,0,0
53,PAM,P010568,P011982,0 days 00:20:05,16,46,30
53,PAM,P003960,P007870,0 days 00:16:14,5,39,34
53,PAM,P003960,P011970,0 days 00:15:57,9,35,26
53,PAM,P007870,P011970,0 days 00:14:55,17,41,24
53,PAM,P003960,P011982,0 days 00:13:28,9,28,19
53,PAM,P003960,P010568,0 days 00:13:08,11,28,17
53,PAM,P011970,P011982,0 days 00:12:57,14,30,16
53,PAM,P012738,P012739,0 days 00:12:46,-1,21,22
53,PAM,P012738,P012740,0 days 00:12:46,-1,21,22
53,PAM,P012739,P012740,0 days 00:12:46,-1,21,22
53,PAM,P007870,P011982,0 days 00:12:15,14,29,15
53,PAM,P010568,P012740,0 days 00:11:50,-3,19,22
53,PAM,P007870,P010568,0 days 00:10:32,11,26,15
53,PAM,P010568,P012738,0 days 00:09:58,1,15,14
53,PAM,P010568,P012739,0 days 00:09:52,0,18,18
53,PAM,P004863,P011970,0 days 00:09:20,4,21,17
53,PAM,P004863,P006643,0 days 00:08:56,-1,14,15
53,PAM,P011982,P012740,0 days 00:08:56,-3,14,17
53,PAM,P006643,P012739,0 days 00:08:26,-2,11,13
53,PAM,P011982,P012738,0 days 00:08:20,-3,13,16
53,PAM,P010568,P011970,0 days 00:08:20,17,24,7
53,PAM,P010393,P011982,0 days 00:07:45,1,16,15
53,PAM,P006643,P012738,0 days 00:07:42,-2,11,13
53,PAM,P006643,P012740,0 days 00:07:03,-2,11,13
53,PAM,P011982,P012739,0 days 00:06:58,0,13,13
53,PAM,P004863,P012738,0 days 00:06:43,-6,9,15
53,PAM,P003960,P006643,0 days 00:06:40,-2,12,14
53,PAM,P003960,P004863,0 days 00:06:22,0,12,12
53,PAM,P004863,P007870,0 days 00:06:10,6,18,12
53,PAM,P004863,P012740,0 days 00:05:44,-3,10,13
53,PAM,P006643,P011970,0 days 00:05:41,0,12,12
53,PAM,P004863,P012739,0 days 00:05:32,-2,6,8
53,PAM,P010393,P011970,0 days 00:04:56,-1,8,9
53,PAM,P007870,P012740,0 days 00:04:48,-5,8,13
53,PAM,P003960,P012740,0 days 00:04:48,-5,8,13
53,PAM,P003960,P009101,0 days 00:04:38,-2,9,11
53,PAM,P006643,P007870,0 days 00:04:26,-2,12,14
53,PAM,P009101,P010393,0 days 00:04:19,2,10,8
53,PAM,P009101,P011982,0 days 00:04:07,2,10,8
53,PAM,P004863,P010393,0 days 00:03:58,-3,6,9
53,PAM,P004863,P011982,0 days 00:03:57,2,9,7
53,PAM,P006643,P010568,0 days 00:03:33,0,5,5
53,PAM,P009101,P011970,0 days 00:03:11,-3,6,9
53,PAM,P009101,P010568,0 days 00:03:08,4,10,6
53,PAM,P010393,P010568,0 days 00:03:08,4,10,6
53,PAM,P003960,P010393,0 days 00:02:53,-1,5,6
53,PAM,P011970,P012738,0 days 00:02:37,-4,3,7
53,PAM,P006643,P009101,0 days 00:02:05,-3,4,7
53,PAM,P010393,P012738,0 days 00:01:55,-4,3,7
53,PAM,P007870,P009101,0 days 00:01:53,-3,4,7
53,PAM,P007870,P010393,0 days 00:01:51,1,3,2
53,PAM,P011970,P012740,0 days 00:01:35,-1,4,5
53,PAM,P003960,P012739,0 days 00:01:23,0,0,0
53,PAM,P011970,P012739,0 days 00:01:23,0,0,0
53,PAM,P003960,P012738,0 days 00:01:21,0,0,0
53,PAM,P009101,P012739,0 days 00:01:15,-1,3,4
53,PAM,P010393,P012739,0 days 00:01:15,-1,3,4
53,PAM,P004863,P010568,0 days 00:00:58,3,3,0
53,PAM,P006643,P010393,0 days 00:00:20,-2,0,2
53,PAM,P004863,P009101,0 days 00:00:12,0,0,0
53,BER,P003958,P012720,0 days 00:26:48,-8,45,53
53,BER,P003958,P006919,0 days 00:25:09,-11,39,50
53,BER,P006919,P012720,0 days 00:22:55,-12,34,46
53,BER,P003958,P008173,0 days 00:21:26,-4,37,41
53,BER,P008173,P012720,0 days 00:20:45,0,37,37
53,BER,P006919,P008173,0 days 00:18:40,-5,30,35
53,BER,P008211,P008967,0 days 00:16:24,-5,30,35
53,BER,P003958,P008967,0 days 00:11:39,-10,21,31
53,BER,P008211,P008384,0 days 00:11:31,4,25,21
53,BER,P008384,P012721,0 days 00:11:25,5,25,20
53,BER,P008384,P008967,0 days 00:10:58,-1,21,22
53,BER,P008211,P012721,0 days 00:10:46,5,25,20
53,BER,P003958,P006251,0 days 00:10:10,0,19,19
53,BER,P006251,P008173,0 days 00:10:10,0,19,19
53,BER,P008967,P012721,0 days 00:09:32,4,21,17
53,BER,P006251,P012720,0 days 00:09:29,4,19,15
53,BER,P003958,P008211,0 days 00:09:02,-8,13,21
53,BER,P008211,P010791,0 days 00:08:28,-1,12,13
53,BER,P006919,P008967,0 days 00:08:13,-8,14,22
53,BER,P006251,P006919,0 days 00:08:03,-1,12,13
53,BER,P008967,P012720,0 days 00:07:59,-6,16,22
53,BER,P006251,P008967,0 days 00:07:40,4,21,17
53,BER,P008967,P010791,0 days 00:07:32,-1,12,13
53,BER,P003958,P010791,0 days 00:07:19,-5,9,14
53,BER,P006919,P008211,0 days 00:06:29,-6,9,15
53,BER,P006251,P008384,0 days 00:06:14,-1,14,15
53,BER,P008211,P012720,0 days 00:06:03,-8,8,16
53,BER,P006919,P010791,0 days 00:06:00,-2,9,11
53,BER,P006251,P012721,0 days 00:05:33,3,14,11
53,BER,P006251,P008211,0 days 00:05:33,3,14,11
53,BER,P006819,P008173,0 days 00:05:07,1,9,8
53,BER,P006819,P012720,0 days 00:05:07,1,9,8
53,BER,P006819,P006919,0 days 00:05:07,1,9,8
53,BER,P003958,P006819,0 days 00:05:07,1,9,8
53,BER,P008173,P008967,0 days 00:04:47,-1,12,13
53,BER,P008384,P010791,0 days 00:04:44,0,7,7
53,BER,P010791,P012720,0 days 00:04:20,-5,4,9
53,BER,P010791,P012721,0 days 00:03:59,1,7,6
53,BER,P003958,P008384,0 days 00:03:19,-4,4,8
53,BER,P008173,P010791,0 days 00:02:50,-3,4,7
53,BER,P003958,P012721,0 days 00:01:53,1,4,3
53,BER,P008384,P012720,0 days 00:01:53,1,4,3
53,BER,P012720,P012721,0 days 00:01:53,1,4,3
53,BER,P008173,P008384,0 days 00:01:20,-4,0,4
53,BER,P008173,P012721,0 days 00:00:39,0,0,0
54,VIR,P001133,P006739,0 days 00:24:57,12,62,50
54,VIR,P001133,P009549,0 days 00:22:37,14,55,41
54,VIR,P001133,P003048,0 days 00:20:32,5,48,43
54,VIR,P006739,PBCN,0 days 00:19:23,9,53,44
54,VIR,P006739,P009549,0 days 00:19:18,15,50,35
54,VIR,P001133,PBCN,0 days 00:18:19,5,47,42
54,VIR,P003048,P006739,0 days 00:18:01,9,44,35
54,VIR,P003048,P009549,0 days 00:14:57,4,33,29
54,VIR,P006739,P011192,0 days 00:12:27,14,37,23
54,VIR,P004007,P009549,0 days 00:12:13,11,27,16
54,VIR,P003048,PBCN,0 days 00:11:23,2,29,27
54,VIR,P004007,P010781,0 days 00:10:46,-3,20,23
54,VIR,P001133,P011192,0 days 00:10:32,3,26,23
54,VIR,P009549,PBCN,0 days 00:10:29,3,28,25
54,VIR,P001133,P004007,0 days 00:10:10,6,20,14
54,VIR,P008847,P011192,0 days 00:10:04,-3,19,22
54,VIR,P006739,P008847,0 days 00:10:01,10,29,19
54,VIR,P011192,PBCN,0 days 00:08:54,6,25,19
54,VIR,P008847,P009549,0 days 00:08:46,12,27,15
54,VIR,P001133,P008847,0 days 00:08:21,6,24,18
54,VIR,P004007,P008847,0 days 00:08:02,0,18,18
54,VIR,P008847,PBCN,0 days 00:08:00,7,24,17
54,VIR,P003048,P011192,0 days 00:07:46,4,22,18
54,VIR,P009549,P010781,0 days 00:07:03,6,16,10
54,VIR,P008847,P010781,0 days 00:06:46,-4,12,16
54,VIR,P003048,P004007,0 days 00:06:40,0,12,12
54,VIR,P004007,P006739,0 days 00:06:34,8,16,8
54,VIR,P001133,P010781,0 days 00:06:14,0,12,12
54,VIR,P004007,P011192,0 days 00:05:29,-5,10,15
54,VIR,P010781,P011192,0 days 00:05:23,-13,4,17
54,VIR,P003527,P010781,0 days 00:04:55,-13,4,17
54,VIR,P003527,P011192,0 days 00:04:55,-13,4,17
54,VIR,P009549,P012714,0 days 00:04:54,3,8,5
54,VIR,P003527,P004007,0 days 00:04:37,-9,4,13
54,VIR,P003527,P008847,0 days 00:04:24,-7,4,11
54,VIR,P009549,P011192,0 days 00:04:01,8,12,4
54,VIR,P010781,P012714,0 days 00:03:51,3,6,3
54,VIR,P004007,P012714,0 days 00:03:23,3,6,3
54,VIR,P003048,P010781,0 days 00:02:44,-6,4,10
54,VIR,P008847,P012714,0 days 00:02:44,3,7,4
54,VIR,P001133,P012714,0 days 00:02:18,1,2,1
54,VIR,P011192,P012714,0 days 00:01:49,3,5,2
54,VIR,P006739,P012714,0 days 00:01:31,5,7,2
54,VIR,P003048,P003527,0 days 00:00:57,-6,0,6
54,VIR,P004007,PBCN,0 days 00:00:46,1,3,2
54,VIR,P001133,P003527,0 days 00:00:44,-4,0,4
54,VIR,P003527,P006739,0 days 00:00:26,0,0,0
54,VIR,P003527,P009549,0 days 00:00:26,0,0,0
54,VIR,P012714,PBCN,0 days 00:00:18,3,3,0
54,VIR,P006739,P010781,0 days 00:00:10,2,2,0
54,IST,P006590,P007200,0 days 00:25:59,-7,54,61
54,IST,P007200,P011981,0 days 00:20:41,-12,39,51
54,IST,P004888,P006590,0 days 00:20:33,-9,44,53
54,IST,P007200,P009664,0 days 00:19:37,-2,36,38
54,IST,P006590,P009664,0 days 00:19:33,-6,38,44
54,IST,P006590,P011078,0 days 00:19:22,0,40,40
54,IST,P006590,P011981,0 days 00:18:37,-8,34,42
54,IST,P007200,P011078,0 days 00:17:49,-3,35,38
54,IST,P004888,P007200,0 days 00:17:29,-11,37,48
54,IST,P009664,P011078,0 days 00:16:36,-5,30,35
54,IST,P004554,P006590,0 days 00:15:38,0,36,36
54,IST,P006590,P009846,0 days 00:15:22,-2,34,36
54,IST,P007200,P009846,0 days 00:15:16,-10,33,43
54,IST,P004888,P009846,0 days 00:15:15,-2,38,40
54,IST,P011078,P011981,0 days 00:14:57,-3,28,31
54,IST,P004888,P011981,0 days 00:14:30,-11,31,42
54,IST,P004888,P011078,0 days 00:13:57,-6,27,33
54,IST,P009664,P011981,0 days 00:12:13,-3,20,23
54,IST,P004554,P007200,0 days 00:12:01,1,26,25
54,IST,P009846,P011981,0 days 00:10:57,-7,24,31
54,IST,P004554,P004888,0 days 00:10:46,-1,22,23
54,IST,P004554,P011078,0 days 00:10:39,-1,23,24
54,IST,P004554,P009664,0 days 00:10:36,-5,21,26
54,IST,P004554,P009846,0 days 00:09:23,2,20,18
54,IST,P009846,P011078,0 days 00:09:04,2,21,19
54,IST,P004888,P009664,0 days 00:08:34,-8,13,21
54,IST,P009664,P009846,0 days 00:04:07,-3,6,9
54,IST,P004554,P011981,0 days 00:00:29,0,0,0
55,IST,P004888,P009664,0 days 00:35:04,0,65,65
55,IST,P009664,P011078,0 days 00:30:16,1,57,56
55,IST,P007200,P009664,0 days 00:29:35,-10,53,63
55,IST,P004888,P007200,0 days 00:29:29,2,62,60
55,IST,P004888,P011078,0 days 00:29:05,21,67,46
55,IST,P004888,P006590,0 days 00:24:14,7,45,38
55,IST,P007200,P011078,0 days 00:22:44,7,51,44
55,IST,P004888,P011981,0 days 00:22:10,1,39,38
55,IST,P004554,P007200,0 days 00:21:52,3,47,44
55,IST,P004554,P009664,0 days 00:20:30,-4,40,44
55,IST,P009664,P011981,0 days 00:19:09,-2,29,31
55,IST,P006590,P009664,0 days 00:18:56,-3,28,31
55,IST,P004554,P011078,0 days 00:18:26,2,35,33
55,IST,P004554,P004888,0 days 00:18:15,9,43,34
55,IST,P006590,P011981,0 days 00:16:32,-1,26,27
55,IST,P011078,P011981,0 days 00:15:14,13,36,23
55,IST,P006590,P007200,0 days 00:13:49,-1,25,26
55,IST,P006590,P011078,0 days 00:12:54,18,30,12
55,IST,P007200,P011981,0 days 00:12:12,-7,19,26
55,IST,P004554,P006590,0 days 00:07:42,8,19,11
55,IST,P004554,P006372,0 days 00:04:35,-6,4,10
55,IST,P006372,P007200,0 days 00:04:35,-6,4,10
55,IST,P006372,P009664,0 days 00:04:35,-6,4,10
55,IST,P006372,P011078,0 days 00:04:35,-6,4,10
55,IST,P004888,P012710,0 days 00:02:49,0,7,7
55,IST,P006590,P012710,0 days 00:02:49,0,7,7
55,IST,P011981,P012710,0 days 00:02:49,0,7,7
55,IST,P007200,P012710,0 days 00:01:57,-4,3,7
55,IST,P011078,P012710,0 days 00:00:52,4,4,0
55,IST,P004888,P009513,0 days 00:00:34,0,0,0
55,IST,P009513,P011078,0 days 00:00:34,0,0,0
55,IST,P009513,P011981,0 days 00:00:34,0,0,0
55,IST,P009513,P009664,0 days 00:00:31,0,0,0
55,IST,P007200,P009513,0 days 00:00:03,0,0,0
55,ZAL,P010390,P011218,0 days 00:27:05,15,61,46
55,ZAL,P002329,P007109,0 days 00:26:06,7,50,43
55,ZAL,P002329,P010390,0 days 00:24:49,8,52,44
55,ZAL,P007109,P010390,0 days 00:24:02,5,43,38
55,ZAL,P002329,P011218,0 days 00:23:50,6,50,44
55,ZAL,P007109,P011218,0 days 00:23:10,8,43,35
55,ZAL,P002329,P003211,0 days 00:20:53,4,47,43
55,ZAL,P007109,P007513,0 days 00:16:33,0,24,24
55,ZAL,P003211,P010390,0 days 00:16:30,3,38,35
55,ZAL,P002329,P007513,0 days 00:16:16,2,24,22
55,ZAL,P003211,P012715,0 days 00:15:56,1,31,30
55,ZAL,P007513,P010390,0 days 00:14:20,3,22,19
55,ZAL,P003211,P011218,0 days 00:14:02,8,36,28
55,ZAL,P003211,P007109,0 days 00:13:40,5,28,23
55,ZAL,P007513,P011218,0 days 00:13:28,5,22,17
55,ZAL,P002676,P003211,0 days 00:12:35,-3,26,29
55,ZAL,P002676,P012715,0 days 00:10:44,-1,24,25
55,ZAL,P002329,P012715,0 days 00:10:09,0,23,23
55,ZAL,P002676,P010390,0 days 00:09:20,-9,16,25
55,ZAL,P002676,P011218,0 days 00:08:49,-3,16,19
55,ZAL,P002676,P007109,0 days 00:08:28,-9,9,18
55,ZAL,P002329,P002676,0 days 00:07:46,-4,18,22
55,ZAL,P003211,P005504,0 days 00:06:36,-2,10,12
55,ZAL,P005504,P012715,0 days 00:06:36,-2,10,12
55,ZAL,P011218,P012715,0 days 00:06:09,3,17,14
55,ZAL,P002676,P005504,0 days 00:06:08,-2,10,12
55,ZAL,P010390,P012715,0 days 00:05:53,6,17,11
55,ZAL,P002676,P011965,0 days 00:04:45,-13,5,18
55,ZAL,P007109,P012715,0 days 00:04:43,-6,7,13
55,ZAL,P003211,P007513,0 days 00:04:34,-5,2,7
55,ZAL,P002329,P005504,0 days 00:04:03,4,10,6
55,ZAL,P007513,P012715,0 days 00:03:46,-3,2,5
55,ZAL,P002676,P003210,0 days 00:03:43,-10,0,10
55,ZAL,P010390,P011965,0 days 00:03:12,-9,3,12
55,ZAL,P003210,P005504,0 days 00:03:02,-4,2,6
55,ZAL,P007109,P011965,0 days 00:02:57,-6,2,8
55,ZAL,P003210,P003211,0 days 00:02:45,-2,2,4
55,ZAL,P003210,P012715,0 days 00:02:42,-2,2,4
55,ZAL,P011965,P012715,0 days 00:02:10,-4,3,7
55,ZAL,P005504,P011965,0 days 00:02:07,-4,2,6
55,ZAL,P003210,P011965,0 days 00:01:57,-8,0,8
55,ZAL,P003210,P007109,0 days 00:01:54,-8,0,8
55,ZAL,P003211,P011965,0 days 00:01:45,-9,0,9
55,ZAL,P002676,P007513,0 days 00:01:42,-2,0,2
55,ZAL,P011218,P011965,0 days 00:01:40,4,5,1
55,ZAL,P003210,P010390,0 days 00:01:37,-6,0,6
55,ZAL,P005504,P007109,0 days 00:01:23,0,2,2
55,ZAL,P005504,P011218,0 days 00:01:03,2,2,0
55,ZAL,P005504,P007513,0 days 00:00:58,0,0,0
55,ZAL,P002329,P003210,0 days 00:00:56,0,2,2
55,ZAL,P007513,P011965,0 days 00:00:31,0,0,0
55,ZAL,P002329,P011965,0 days 00:00:12,-3,0,3
56,MIL,P000796,P002849,0 days 00:19:57,16,44,28
56,MIL,P000796,P007831,0 days 00:18:23,9,36,27
56,MIL,P002849,P007831,0 days 00:17:56,11,36,25
56,MIL,P007032,P009960,0 days 00:17:25,11,35,24
56,MIL,P007032,P007831,0 days 00:17:04,8,35,27
56,MIL,P000796,P007032,0 days 00:16:40,6,33,27
56,MIL,P002849,P007032,0 days 00:16:13,8,33,25
56,MIL,P000796,P009960,0 days 00:15:18,15,35,20
56,MIL,P002849,P009960,0 days 00:14:20,17,35,18
56,MIL,P007201,P011205,0 days 00:13:42,10,26,16
56,MIL,P005670,P006509,0 days 00:13:19,14,30,16
56,MIL,P006509,P007201,0 days 00:13:07,13,26,13
56,MIL,P005670,P007201,0 days 00:12:51,12,25,13
56,MIL,P007831,P009960,0 days 00:12:46,10,27,17
56,MIL,P005670,P011205,0 days 00:12:37,12,27,15
56,MIL,P002812,P007201,0 days 00:12:36,13,26,13
56,MIL,P002812,P006509,0 days 00:12:36,13,26,13
56,MIL,P002812,P011205,0 days 00:12:12,11,24,13
56,MIL,P006509,P011205,0 days 00:12:12,11,24,13
56,MIL,P002812,P005670,0 days 00:10:57,9,22,13
56,MIL,P009960,P011205,0 days 00:06:56,2,13,11
56,MIL,P007032,P011205,0 days 00:06:31,1,10,9
56,MIL,P006701,P009960,0 days 00:06:29,4,13,9
56,MIL,P006701,P011205,0 days 00:06:29,4,13,9
56,MIL,P001518,P007032,0 days 00:05:49,2,11,9
56,MIL,P001518,P009960,0 days 00:04:59,5,11,6
56,MIL,P001518,P006701,0 days 00:04:59,5,11,6
56,MIL,P001518,P011205,0 days 00:04:59,5,11,6
56,MIL,P006701,P007032,0 days 00:04:39,1,8,7
56,MIL,P005670,P009960,0 days 00:04:22,8,13,5
56,MIL,P000796,P005670,0 days 00:04:15,8,11,3
56,MIL,P002849,P005670,0 days 00:03:44,8,11,3
56,MIL,P007032,P007201,0 days 00:03:19,3,6,3
56,MIL,P002812,P007032,0 days 00:03:03,0,5,5
56,MIL,P001518,P007831,0 days 00:02:40,0,5,5
56,MIL,P001518,P002849,0 days 00:02:40,0,5,5
56,MIL,P000796,P001518,0 days 00:02:40,0,5,5
56,MIL,P000796,P006509,0 days 00:02:32,5,8,3
56,MIL,P006509,P009960,0 days 00:02:32,5,8,3
56,MIL,P000796,P007201,0 days 00:02:04,3,3,0
56,MIL,P002849,P006509,0 days 00:02:01,5,8,3
56,MIL,P007201,P009960,0 days 00:02:01,-1,2,3
56,MIL,P007201,P007831,0 days 00:01:57,5,5,0
56,MIL,P001518,P005670,0 days 00:01:50,3,5,2
56,MIL,P005670,P006701,0 days 00:01:50,3,5,2
56,MIL,P006509,P007032,0 days 00:01:49,4,4,0
56,MIL,P002812,P007831,0 days 00:01:48,-2,3,5
56,MIL,P005670,P007831,0 days 00:01:43,3,3,0
56,MIL,P002849,P007201,0 days 00:01:33,3,3,0
56,MIL,P006701,P007201,0 days 00:01:30,-1,2,3
56,MIL,P000796,P002812,0 days 00:01:24,-4,1,5
56,MIL,P002812,P002849,0 days 00:01:24,-4,1,5
56,MIL,P000796,P011205,0 days 00:00:27,-2,0,2
56,MIL,P007831,P011205,0 days 00:00:27,-2,0,2
56,MIL,P006509,P007831,0 days 00:00:24,2,2,0
56,PAM,P007870,P011982,0 days 00:18:03,-10,26,36
56,PAM,P006643,P012738,0 days 00:17:26,-14,19,33
56,PAM,P007870,P011970,0 days 00:16:54,-5,29,34
56,PAM,P005356,P007870,0 days 00:15:41,-19,18,37
56,PAM,P009101,P012738,0 days 00:14:15,-8,18,26
56,PAM,P006643,P009101,0 days 00:13:53,-4,18,22
56,PAM,P005356,P011982,0 days 00:13:11,-18,14,32
56,PAM,P003960,P007870,0 days 00:12:33,2,24,22
56,PAM,P003960,P005356,0 days 00:11:00,-9,16,25
56,PAM,P003960,P011982,0 days 00:10:55,2,21,19
56,PAM,P005356,P009101,0 days 00:10:47,-14,14,28
56,PAM,P006643,P011970,0 days 00:10:00,-11,10,21
56,PAM,P011970,P011982,0 days 00:09:32,0,18,18
56,PAM,P005356,P006643,0 days 00:09:25,-6,15,21
56,PAM,P011970,P012740,0 days 00:09:16,-2,16,18
56,PAM,P005356,P011970,0 days 00:08:28,-13,10,23
56,PAM,P005356,P012738,0 days 00:08:27,-10,12,22
56,PAM,P006643,P010393,0 days 00:08:25,1,15,14
56,PAM,P005356,P010393,0 days 00:08:17,-8,12,20
56,PAM,P010393,P012738,0 days 00:07:49,-6,12,18
56,PAM,P011970,P012738,0 days 00:07:41,-13,4,17
56,PAM,P003960,P011970,0 days 00:07:33,7,16,9
56,PAM,P006643,P012740,0 days 00:07:32,-11,7,18
56,PAM,P009101,P010393,0 days 00:07:31,-6,12,18
56,PAM,P007870,P009101,0 days 00:07:11,-9,7,16
56,PAM,P006643,P007870,0 days 00:07:08,-4,10,14
56,PAM,P000556,P007870,0 days 00:06:46,-14,5,19
56,PAM,P000556,P011970,0 days 00:06:45,-16,5,21
56,PAM,P012738,P012740,0 days 00:06:29,-9,4,13
56,PAM,P007870,P012740,0 days 00:06:27,5,16,11
56,PAM,P000556,P011982,0 days 00:06:03,-9,5,14
56,PAM,P003960,P006643,0 days 00:05:53,-3,6,9
56,PAM,P003960,P012740,0 days 00:05:51,5,12,7
56,PAM,P003960,P009101,0 days 00:04:59,-2,5,7
56,PAM,P009101,P011970,0 days 00:04:52,-6,4,10
56,PAM,P000556,P005356,0 days 00:04:51,-12,2,14
56,PAM,P003960,P012738,0 days 00:04:15,-3,3,6
56,PAM,P011982,P012740,0 days 00:04:14,8,12,4
56,PAM,P003960,P004863,0 days 00:04:13,-3,5,8
56,PAM,P004863,P005356,0 days 00:04:13,-3,5,8
56,PAM,P004863,P007870,0 days 00:04:13,-3,5,8
56,PAM,P004863,P011982,0 days 00:04:13,-3,5,8
56,PAM,P000556,P006643,0 days 00:03:52,-12,0,12
56,PAM,P000556,P012740,0 days 00:03:48,-9,3,12
56,PAM,P009101,P011982,0 days 00:03:40,-7,3,10
56,PAM,P007870,P012738,0 days 00:03:31,-2,4,6
56,PAM,P010393,P012740,0 days 00:03:17,0,5,5
56,PAM,P010393,P011970,0 days 00:03:15,-5,4,9
56,PAM,P007870,P010393,0 days 00:03:13,-1,4,5
56,PAM,P009101,P012740,0 days 00:02:38,1,3,2
56,PAM,P000556,P012738,0 days 00:02:31,-7,0,7
56,PAM,P005356,P012740,0 days 00:02:12,-4,2,6
56,PAM,P000556,P009101,0 days 00:01:54,-5,0,5
56,PAM,P010393,P011982,0 days 00:01:43,-3,0,3
56,PAM,P000556,P010393,0 days 00:00:38,0,0,0
56,PAM,P006643,P011982,0 days 00:00:38,0,0,0
57,TEL,P009622,P009783,0 days 00:28:53,6,66,60
57,TEL,P009622,P011199,0 days 00:26:36,12,65,53
57,TEL,P009783,P011199,0 days 00:25:15,6,60,54
57,TEL,P009783,P009863,0 days 00:24:45,2,58,56
57,TEL,P009622,P009863,0 days 00:20:20,3,44,41
57,TEL,P009863,P011199,0 days 00:20:03,-1,44,45
57,TEL,P011193,P011214,0 days 00:12:33,-2,28,30
57,TEL,P009622,P011971,0 days 00:12:01,13,34,21
57,TEL,P011199,P011971,0 days 00:11:15,13,33,20
57,TEL,P009783,P011193,0 days 00:11:02,9,33,24
57,TEL,P009783,P011971,0 days 00:10:39,10,30,20
57,TEL,P005145,P009783,0 days 00:09:10,-5,14,19
57,TEL,P005145,P009622,0 days 00:09:10,-5,14,19
57,TEL,P005145,P011199,0 days 00:09:10,-5,14,19
57,TEL,P005145,P009863,0 days 00:09:10,-5,14,19
57,TEL,P009783,P011214,0 days 00:08:27,-5,22,27
57,TEL,P011214,P011219,0 days 00:07:45,-2,19,21
57,TEL,P011193,P011219,0 days 00:07:07,1,19,18
57,TEL,P009622,P011193,0 days 00:06:51,6,19,13
57,TEL,P009783,P011219,0 days 00:06:37,-1,16,17
57,TEL,P009863,P011971,0 days 00:06:31,5,16,11
57,TEL,P011193,P011971,0 days 00:06:23,3,17,14
57,TEL,P011214,P012744,0 days 00:06:23,-3,13,16
57,TEL,P011193,P012744,0 days 00:06:18,-1,13,14
57,TEL,P007990,P009622,0 days 00:06:14,-3,13,16
57,TEL,P007990,P012744,0 days 00:06:02,0,13,13
57,TEL,P007990,P011214,0 days 00:05:46,-7,8,15
57,TEL,P009863,P011214,0 days 00:05:45,-3,16,19
57,TEL,P009863,P011193,0 days 00:05:41,1,14,13
57,TEL,P007990,P011199,0 days 00:05:36,0,13,13
57,TEL,P007990,P011219,0 days 00:05:32,-4,9,13
57,TEL,P009622,P012744,0 days 00:05:14,7,18,11
57,TEL,P007990,P011193,0 days 00:05:08,-4,8,12
57,TEL,P009863,P011219,0 days 00:04:43,0,13,13
57,TEL,P007990,P009783,0 days 00:04:39,-5,8,13
57,TEL,P009622,P011214,0 days 00:04:02,-4,8,12
57,TEL,P009783,P012744,0 days 00:03:45,3,13,10
57,TEL,P007990,P011971,0 days 00:03:42,-1,7,8
57,TEL,P011971,P012744,0 days 00:03:37,-1,7,8
57,TEL,P011193,P011199,0 days 00:03:37,7,13,6
57,TEL,P011199,P012744,0 days 00:03:28,4,13,9
57,TEL,P011214,P011971,0 days 00:03:12,-6,4,10
57,TEL,P007990,P009863,0 days 00:02:49,-4,5,9
57,TEL,P009622,P011219,0 days 00:02:31,-3,3,6
57,TEL,P011219,P012744,0 days 00:02:24,1,6,5
57,TEL,P011199,P011219,0 days 00:01:53,0,3,3
57,TEL,P009863,P012744,0 days 00:01:53,2,8,6
57,TEL,P011199,P011214,0 days 00:00:23,-4,2,6
57,MUN,P006760,P007056,0 days 00:21:20,0,42,42
57,MUN,P003583,P007056,0 days 00:19:57,-12,37,49
57,MUN,P003583,P006760,0 days 00:18:41,1,38,37
57,MUN,P004508,P007056,0 days 00:18:21,-10,33,43
57,MUN,P003583,P010391,0 days 00:16:03,-4,27,31
57,MUN,P003583,P004508,0 days 00:16:00,-6,30,36
57,MUN,P007056,P010391,0 days 00:15:28,-3,25,28
57,MUN,P004508,P006760,0 days 00:15:03,6,31,25
57,MUN,P004508,P010391,0 days 00:15:03,-2,25,27
57,MUN,P006760,P010391,0 days 00:12:51,0,19,19
57,MUN,P008985,P011987,0 days 00:11:19,-3,28,31
57,MUN,P007056,P007975,0 days 00:10:59,0,25,25
57,MUN,P006760,P007975,0 days 00:10:40,4,27,23
57,MUN,P001557,P011987,0 days 00:10:28,1,27,26
57,MUN,P003583,P011987,0 days 00:09:35,2,28,26
57,MUN,P001557,P008985,0 days 00:09:31,-1,25,26
57,MUN,P008985,P010391,0 days 00:08:23,-1,20,21
57,MUN,P007056,P011987,0 days 00:08:17,-4,19,23
57,MUN,P004508,P008985,0 days 00:08:07,-5,19,24
57,MUN,P001557,P010391,0 days 00:07:31,-1,17,18
57,MUN,P003583,P008985,0 days 00:07:22,-5,16,21
57,MUN,P003583,P007975,0 days 00:07:17,-3,19,22
57,MUN,P010391,P011987,0 days 00:07:02,-5,17,22
57,MUN,P006760,P011987,0 days 00:06:59,11,23,12
57,MUN,P001557,P007639,0 days 00:06:41,-1,20,21
57,MUN,P007975,P011987,0 days 00:06:16,7,22,15
57,MUN,P007056,P008985,0 days 00:06:00,-9,12,21
57,MUN,P007639,P008985,0 days 00:05:40,0,17,17
57,MUN,P004508,P007975,0 days 00:05:23,1,16,15
57,MUN,P004508,P011987,0 days 00:05:08,-1,14,15
57,MUN,P007639,P011987,0 days 00:04:48,2,15,13
57,MUN,P004508,P007639,0 days 00:04:24,0,11,11
57,MUN,P007975,P010391,0 days 00:04:22,-2,9,11
57,MUN,P005460,P008985,0 days 00:04:06,-2,11,13
57,MUN,P001557,P005460,0 days 00:04:06,-2,11,13
57,MUN,P001557,P004508,0 days 00:03:44,-2,9,11
57,MUN,P007639,P007975,0 days 00:03:32,2,9,7
57,MUN,P005460,P007639,0 days 00:03:29,0,11,11
57,MUN,P007639,P010391,0 days 00:03:12,-1,9,10
57,MUN,P010391,P011941,0 days 00:03:09,3,8,5
57,MUN,P001557,P007975,0 days 00:03:07,3,9,6
57,MUN,P004508,P011941,0 days 00:02:58,2,7,5
57,MUN,P006760,P008985,0 days 00:02:57,3,8,5
57,MUN,P008985,P011941,0 days 00:02:55,3,8,5
57,MUN,P007056,P007639,0 days 00:02:31,3,6,3
57,MUN,P006760,P007639,0 days 00:02:31,3,6,3
57,MUN,P001557,P003583,0 days 00:02:21,-1,5,6
57,MUN,P005460,P011987,0 days 00:02:13,1,6,5
57,MUN,P001557,P011941,0 days 00:02:12,-1,3,4
57,MUN,P001557,P007056,0 days 00:02:09,1,4,3
57,MUN,P001557,P006760,0 days 00:02:06,4,6,2
57,MUN,P004508,P005460,0 days 00:01:53,-3,5,8
57,MUN,P011941,P011987,0 days 00:01:39,-3,1,4
57,MUN,P007056,P011941,0 days 00:01:34,2,5,3
57,MUN,P005460,P011941,0 days 00:00:37,-2,0,2
58,PAR,P008987,P012742,0 days 00:24:56,6,53,47
58,PAR,P007400,P008987,0 days 00:23:29,5,45,40
58,PAR,P007400,P012742,0 days 00:19:09,7,40,33
58,PAR,P008987,P011051,0 days 00:16:38,1,30,29
58,PAR,P008987,P012743,0 days 00:15:28,4,38,34
58,PAR,P000956,P008987,0 days 00:15:23,13,39,26
58,PAR,P007400,P012743,0 days 00:14:54,-3,32,35
58,PAR,P012742,P012743,0 days 00:14:23,4,38,34
58,PAR,P004058,P007400,0 days 00:13:20,-9,27,36
58,PAR,P003983,P011051,0 days 00:13:04,-3,26,29
58,PAR,P007400,P011051,0 days 00:12:09,5,20,15
58,PAR,P007673,P011051,0 days 00:11:44,-5,25,30
58,PAR,P000956,P012742,0 days 00:11:32,12,29,17
58,PAR,P011051,P012742,0 days 00:10:33,2,15,13
58,PAR,P004058,P012743,0 days 00:10:21,-9,22,31
58,PAR,P000956,P011051,0 days 00:10:20,6,26,20
58,PAR,P003983,P008987,0 days 00:09:47,-1,19,20
58,PAR,P004058,P008987,0 days 00:09:44,-6,20,26
58,PAR,P000956,P012743,0 days 00:09:21,6,23,17
58,PAR,P000956,P007400,0 days 00:08:29,8,16,8
58,PAR,P007673,P009212,0 days 00:07:52,-4,17,21
58,PAR,P004058,P007673,0 days 00:07:52,-4,15,19
58,PAR,P007673,P008987,0 days 00:07:46,-6,15,21
58,PAR,P003983,P007673,0 days 00:07:46,-6,17,23
58,PAR,P000956,P007673,0 days 00:07:06,0,20,20
58,PAR,P003983,P012742,0 days 00:07:01,-2,9,11
58,PAR,P007400,P007673,0 days 00:06:51,-5,12,17
58,PAR,P004058,P012742,0 days 00:06:29,-4,15,19
58,PAR,P000956,P003983,0 days 00:06:07,-1,17,18
58,PAR,P003983,P007400,0 days 00:05:20,3,9,6
58,PAR,P004172,P012743,0 days 00:05:13,4,13,9
58,PAR,P004172,P008987,0 days 00:05:13,4,13,9
58,PAR,P000956,P004172,0 days 00:05:13,4,13,9
58,PAR,P004058,P009212,0 days 00:04:35,-2,10,12
58,PAR,P000956,P009212,0 days 00:04:18,-1,10,11
58,PAR,P004172,P012742,0 days 00:04:08,4,13,9
58,PAR,P009212,P011051,0 days 00:03:58,1,10,9
58,PAR,P004058,P011051,0 days 00:03:58,1,8,7
58,PAR,P007673,P012743,0 days 00:03:54,-5,7,12
58,PAR,P009212,P012743,0 days 00:03:54,-5,7,12
58,PAR,P007400,P009212,0 days 00:03:34,-3,7,10
58,PAR,P003983,P009212,0 days 00:03:17,-2,7,9
58,PAR,P007673,P012742,0 days 00:01:41,-5,0,5
58,PAR,P004172,P007400,0 days 00:01:05,0,0,0
58,PAR,P000956,P004058,0 days 00:01:03,1,3,2
58,PAR,P003983,P004058,0 days 00:00:02,0,0,0
58,ULK,P008962,P009849,0 days 00:28:16,4,61,57
58,ULK,P008962,P011052,0 days 00:27:43,-5,48,53
58,ULK,P005844,P008962,0 days 00:25:56,-12,47,59
58,ULK,P006661,P008962,0 days 00:25:52,-8,55,63
58,ULK,P005844,P006661,0 days 00:23:32,-7,47,54
58,ULK,P009849,P011052,0 days 00:20:55,2,40,38
58,ULK,P008962,P011980,0 days 00:20:13,10,53,43
58,ULK,P006961,P008962,0 days 00:18:29,-3,39,42
58,ULK,P005844,P006961,0 days 00:17:33,-2,35,37
58,ULK,P006661,P006961,0 days 00:17:13,-2,39,41
58,ULK,P009849,P011980,0 days 00:15:19,8,38,30
58,ULK,P005844,P011052,0 days 00:14:41,-17,15,32
58,ULK,P005844,P009849,0 days 00:14:27,-9,24,33
58,ULK,P006661,P009849,0 days 00:14:10,-3,32,35
58,ULK,P006661,P011052,0 days 00:13:39,-12,19,31
58,ULK,P011052,P011157,0 days 00:13:04,12,33,21
58,ULK,P009849,P011157,0 days 00:13:04,12,33,21
58,ULK,P008962,P011157,0 days 00:13:04,12,33,21
58,ULK,P011052,P011980,0 days 00:12:50,8,29,21
58,ULK,P011157,P011980,0 days 00:11:40,12,29,17
58,ULK,P006961,P011052,0 days 00:08:08,-8,8,16
58,ULK,P005844,P011980,0 days 00:07:43,-1,20,21
58,ULK,P006661,P011980,0 days 00:07:27,2,24,22
58,ULK,P006961,P009849,0 days 00:06:47,2,16,14
58,ULK,P006961,P011980,0 days 00:05:35,3,19,16
58,ULK,P006661,P011157,0 days 00:01:24,0,4,4
58,ULK,P006661,P011201,0 days 00:00:13,-2,0,2
58,ULK,P006961,P011201,0 days 00:00:13,-2,0,2
58,ULK,P008962,P011201,0 days 00:00:13,-2,0,2
58,ULK,P011201,P011980,0 days 00:00:13,-2,0,2
58,ULK,P002969,P006661,0 days 00:00:06,0,0,0
58,ULK,P002969,P006961,0 days 00:00:06,0,0,0
58,ULK,P002969,P008962,0 days 00:00:06,0,0,0
58,ULK,P002969,P009849,0 days 00:00:06,0,0,0
59,MAD,P005791,P005928,0 days 00:21:47,21,65,44
59,MAD,P005791,P006540,0 days 00:18:20,14,51,37
59,MAD,P005928,P006540,0 days 00:18:20,14,51,37
59,MAD,P005791,P009005,0 days 00:16:10,23,53,30
59,MAD,P005928,P009005,0 days 00:16:10,23,53,30
59,MAD,P004887,P010357,0 days 00:15:01,4,32,28
59,MAD,P010357,PTGB,0 days 00:13:59,-6,15,21
59,MAD,P001392,P005928,0 days 00:13:54,8,41,33
59,MAD,P006540,P009005,0 days 00:13:14,16,39,23
59,MAD,P005928,P010357,0 days 00:11:47,4,32,28
59,MAD,PCVM,PTGB,0 days 00:11:31,-1,13,14
59,MAD,P010357,PCVM,0 days 00:11:31,-1,13,14
59,MAD,P005928,PBMT,0 days 00:10:59,25,42,17
59,MAD,P001392,P010357,0 days 00:10:52,2,25,23
59,MAD,P004887,PTGB,0 days 00:10:16,-7,12,19
59,MAD,P003108,P005791,0 days 00:10:16,8,29,21
59,MAD,P001392,P004887,0 days 00:09:03,4,25,21
59,MAD,P001392,P005791,0 days 00:09:01,0,19,19
59,MAD,P003108,P010357,0 days 00:09:00,-3,16,19
59,MAD,P003108,P005928,0 days 00:08:53,5,26,21
59,MAD,P004887,PCVM,0 days 00:08:19,-2,10,12
59,MAD,P005791,P010357,0 days 00:08:17,-1,13,14
59,MAD,P010357,PBMT,0 days 00:08:11,15,24,9
59,MAD,P003108,PTGB,0 days 00:07:28,3,15,12
59,MAD,P001392,P009005,0 days 00:07:12,2,19,17
59,MAD,P001392,P006540,0 days 00:07:12,2,19,17
59,MAD,P003108,P006540,0 days 00:07:04,3,19,16
59,MAD,P004887,P005928,0 days 00:06:42,6,22,16
59,MAD,P005791,PTGB,0 days 00:06:39,8,17,9
59,MAD,P004887,PBMT,0 days 00:06:27,13,22,9
59,MAD,P005791,PBMT,0 days 00:06:14,14,22,8
59,MAD,P001392,PTGB,0 days 00:06:07,-9,5,14
59,MAD,P003108,PCVM,0 days 00:05:39,1,8,7
59,MAD,P005928,PTGB,0 days 00:05:24,2,16,14
59,MAD,P003108,P009005,0 days 00:05:00,9,16,7
59,MAD,P001392,PBMT,0 days 00:04:45,11,20,9
59,MAD,P006540,PBMT,0 days 00:04:36,9,15,6
59,MAD,P006540,P010357,0 days 00:04:34,-2,10,12
59,MAD,P003108,P004887,0 days 00:04:16,-2,5,7
59,MAD,P001392,PCVM,0 days 00:04:10,-4,3,7
59,MAD,P009005,PBMT,0 days 00:03:58,12,18,6
59,MAD,PBMT,PTGB,0 days 00:03:20,7,9,2
59,MAD,P005791,PCVM,0 days 00:03:12,1,3,2
59,MAD,P009005,PTGB,0 days 00:02:56,7,14,7
59,MAD,PBMT,PCVM,0 days 00:01:42,2,2,0
59,MAD,P003108,PBMT,0 days 00:00:32,0,2,2
59,VIR,P001133,P006739,0 days 00:22:25,-20,39,59
59,VIR,P003048,PBCN,0 days 00:19:32,-16,40,56
59,VIR,P001133,PBCN,0 days 00:17:19,-26,27,53
59,VIR,P001133,P009549,0 days 00:16:38,-11,32,43
59,VIR,P001133,P008847,0 days 00:16:15,-7,30,37
59,VIR,P006739,P009549,0 days 00:15:49,-9,32,41
59,VIR,P003048,P006739,0 days 00:15:04,-19,29,48
59,VIR,P006739,P008847,0 days 00:14:37,-8,26,34
59,VIR,P006739,PBCN,0 days 00:14:32,-12,31,43
59,VIR,P001133,P003048,0 days 00:14:30,-22,23,45
59,VIR,P004007,P008847,0 days 00:13:39,-3,26,29
59,VIR,P001133,P004007,0 days 00:12:22,-1,26,27
59,VIR,P009549,PBCN,0 days 00:12:07,-5,29,34
59,VIR,P008847,PBCN,0 days 00:11:27,4,25,21
59,VIR,P004007,P006739,0 days 00:10:57,-11,16,27
59,VIR,P008847,P009549,0 days 00:10:30,0,15,15
59,VIR,P001844,P008847,0 days 00:10:29,9,25,16
59,VIR,P003048,P009549,0 days 00:09:46,-7,25,32
59,VIR,P001844,PBCN,0 days 00:09:19,-8,15,23
59,VIR,P001133,P011192,0 days 00:09:04,-7,19,26
59,VIR,P010781,PBCN,0 days 00:09:00,-4,17,21
59,VIR,P003048,P008847,0 days 00:08:51,8,21,13
59,VIR,P001844,P003048,0 days 00:08:41,0,15,15
59,VIR,P003048,P010781,0 days 00:08:35,-2,15,17
59,VIR,P004007,P011192,0 days 00:08:34,3,21,18
59,VIR,P001133,P001844,0 days 00:08:20,-9,14,23
59,VIR,P008847,P011192,0 days 00:07:37,2,19,17
59,VIR,P008847,P010781,0 days 00:06:59,-1,17,18
59,VIR,P004007,P009549,0 days 00:06:02,-5,7,12
59,VIR,P001844,P011192,0 days 00:05:42,2,12,10
59,VIR,P006739,P011192,0 days 00:05:36,-10,9,19
59,VIR,P001844,P010781,0 days 00:05:25,-2,11,13
59,VIR,P003048,P011192,0 days 00:05:24,-10,4,14
59,VIR,P006739,P010781,0 days 00:05:08,-6,6,12
59,VIR,P001133,P010781,0 days 00:05:03,-11,2,13
59,VIR,P001844,P004007,0 days 00:04:08,7,12,5
59,VIR,P003048,P004007,0 days 00:03:09,-1,4,5
59,VIR,P011192,PBCN,0 days 00:02:44,-11,0,11
59,VIR,P001844,P009549,0 days 00:02:20,-1,4,5
59,VIR,P003527,P006739,0 days 00:02:04,-5,0,5
59,VIR,P003527,P010781,0 days 00:01:33,-4,0,4
59,VIR,P003048,P003527,0 days 00:01:28,-7,0,7
59,VIR,P001133,P003527,0 days 00:01:04,-2,0,2
59,VIR,P003527,P004007,0 days 00:01:00,-3,0,3
59,VIR,P003527,P011192,0 days 00:00:31,-1,0,1
59,VIR,P004007,P010781,0 days 00:00:29,-2,0,2
59,VIR,P001844,P003527,-1 days +23:59:24,-2,0,2
59,VIR,P003527,P009549,-1 days +23:59:24,-2,0,2
59,VIR,P003527,PBCN,-1 days +23:59:24,-2,0,2
60,OLY,P008811,P010612,0 days 00:29:09,20,62,42
60,OLY,P008811,P008829,0 days 00:28:44,9,60,51
60,OLY,P001255,P010612,0 days 00:27:21,11,60,49
60,OLY,P001255,P008811,0 days 00:25:49,14,54,40
60,OLY,P008829,P010612,0 days 00:25:16,20,60,40
60,OLY,P001255,P008829,0 days 00:20:27,16,52,36
60,OLY,P007982,P008811,0 days 00:19:41,-5,29,34
60,OLY,P001255,P007982,0 days 00:16:21,4,29,25
60,OLY,P008811,P010392,0 days 00:16:17,-6,22,28
60,OLY,P008811,P008855,0 days 00:16:13,14,39,25
60,OLY,P008855,P010612,0 days 00:16:13,14,39,25
60,OLY,P007982,P008829,0 days 00:15:43,-10,27,37
60,OLY,P008829,P008855,0 days 00:15:40,16,39,23
60,OLY,P007982,P010612,0 days 00:14:52,6,29,23
60,OLY,P007982,P010392,0 days 00:11:28,-10,14,24
60,OLY,P001255,P008855,0 days 00:11:24,10,31,21
60,OLY,P008829,P010392,0 days 00:10:55,-10,14,24
60,OLY,P010392,P010612,0 days 00:10:11,8,16,8
60,OLY,P008811,P011983,0 days 00:09:14,-23,6,29
60,OLY,P007982,P011983,0 days 00:07:50,-16,6,22
60,OLY,P008829,P011983,0 days 00:06:21,-14,6,20
60,OLY,P010392,P011983,0 days 00:06:06,-14,6,20
60,OLY,P001255,P010392,0 days 00:05:22,4,8,4
60,OLY,P008855,P010392,0 days 00:04:49,4,8,4
60,OLY,P003941,P010612,0 days 00:03:01,-5,6,11
60,OLY,P001255,P003941,0 days 00:03:01,-5,6,11
60,OLY,P003941,P007982,0 days 00:03:01,-5,6,11
60,OLY,P001255,P011983,0 days 00:02:53,-9,0,9
60,OLY,P003941,P008829,0 days 00:02:53,-3,6,9
60,OLY,P006302,P008811,0 days 00:02:49,-7,0,7
60,OLY,P001255,P006302,0 days 00:02:42,-9,0,9
60,OLY,P006302,P011983,0 days 00:02:35,-7,0,7
60,OLY,P006302,P007982,0 days 00:01:52,-4,0,4
60,OLY,P010612,P011983,0 days 00:01:24,-7,0,7
60,OLY,P006302,P010612,0 days 00:01:13,-7,0,7
60,OLY,P008855,P011983,0 days 00:00:33,-2,0,2
60,OLY,P006302,P008829,0 days 00:00:29,0,0,0
60,OLY,P003941,P006302,0 days 00:00:08,-2,0,2
60,BAS,P007230,P012201,0 days 00:22:26,26,49,23
60,BAS,P004761,P007230,0 days 00:21:19,12,43,31
60,BAS,P007230,P009048,0 days 00:21:07,2,36,34
60,BAS,P007230,P011948,0 days 00:19:14,-8,30,38
60,BAS,P010444,P012201,0 days 00:18:07,-2,27,29
60,BAS,P007230,P010444,0 days 00:17:35,-6,18,24
60,BAS,P004603,P007230,0 days 00:16:47,10,42,32
60,BAS,P004761,P012201,0 days 00:16:26,16,37,21
60,BAS,P010444,P011948,0 days 00:15:47,-9,24,33
60,BAS,P009048,P011948,0 days 00:15:05,-6,21,27
60,BAS,P004603,P004761,0 days 00:14:25,10,35,25
60,BAS,P012201,P012765,0 days 00:14:07,10,32,22
60,BAS,P007230,P012765,0 days 00:13:44,6,28,22
60,BAS,P009048,P012201,0 days 00:13:28,9,28,19
60,BAS,P009048,P010444,0 days 00:13:08,-12,14,26
60,BAS,P011948,P012201,0 days 00:11:39,6,26,20
60,BAS,P008850,P011948,0 days 00:11:35,-15,20,35
60,BAS,P004761,P012765,0 days 00:11:08,6,21,15
60,BAS,P004761,P009048,0 days 00:10:44,3,22,19
60,BAS,P008850,P010444,0 days 00:09:45,-17,14,31
60,BAS,P010444,P012765,0 days 00:09:36,-1,15,16
60,BAS,P011948,P012765,0 days 00:08:59,-6,20,26
60,BAS,P004603,P012201,0 days 00:08:59,17,29,12
60,BAS,P004603,P009048,0 days 00:08:24,7,20,13
60,BAS,P004603,P012765,0 days 00:08:23,3,22,19
60,BAS,P004603,P011948,0 days 00:07:48,-7,13,20
60,BAS,P007230,P008850,0 days 00:07:12,-10,10,20
60,BAS,P004761,P010444,0 days 00:06:58,-5,4,9
60,BAS,P008850,P012765,0 days 00:06:31,-2,18,20
60,BAS,P004761,P011948,0 days 00:06:09,-3,10,13
60,BAS,P008850,P009048,0 days 00:05:36,-15,3,18
60,BAS,P008850,P012201,0 days 00:05:08,-6,12,18
60,BAS,P004603,P008850,0 days 00:02:22,0,7,7
60,BAS,P004761,P008850,0 days 00:00:19,-3,0,3
61,BER,P003958,P012720,0 days 00:22:49,-14,42,56
61,BER,P003958,P008211,0 days 00:17:29,-7,37,44
61,BER,P008211,P012720,0 days 00:15:32,-11,30,41
61,BER,P003958,P006919,0 days 00:14:47,-4,25,29
61,BER,P008967,P012720,0 days 00:14:32,-12,24,36
61,BER,P006919,P012720,0 days 00:14:06,-7,21,28
61,BER,P008384,P008967,0 days 00:13:50,-3,28,31
61,BER,P003958,P008967,0 days 00:12:47,-13,22,35
61,BER,P006919,P008211,0 days 00:12:43,0,26,26
61,BER,P006251,P008384,0 days 00:12:42,-2,30,32
61,BER,P006919,P010791,0 days 00:12:29,-3,26,29
61,BER,P008967,P011934,0 days 00:12:19,-5,30,35
61,BER,P008384,P012720,0 days 00:12:10,2,25,23
61,BER,P006919,P008384,0 days 00:11:07,2,25,23
61,BER,P003958,P008384,0 days 00:10:55,4,27,23
61,BER,P003958,P011934,0 days 00:10:33,-7,19,26
61,BER,P008384,P010791,0 days 00:09:48,6,25,19
61,BER,P011934,P012720,0 days 00:09:47,-7,16,23
61,BER,P010791,P012720,0 days 00:09:22,-9,14,23
61,BER,P008211,P010791,0 days 00:09:18,-6,19,25
61,BER,P007550,P008384,0 days 00:09:08,-7,22,29
61,BER,P008384,P011934,0 days 00:08:27,-5,20,25
61,BER,P006251,P012720,0 days 00:07:57,9,23,14
61,BER,P006251,P010791,0 days 00:07:40,2,18,16
61,BER,P003958,P010791,0 days 00:07:32,-7,13,20
61,BER,P008211,P011934,0 days 00:07:26,-6,14,20
61,BER,P006251,P006919,0 days 00:06:58,4,18,14
61,BER,P007550,P011934,0 days 00:06:24,-4,18,22
61,BER,P008211,P008967,0 days 00:05:50,-9,12,21
61,BER,P007550,P008967,0 days 00:05:26,0,16,16
61,BER,P006251,P007550,0 days 00:04:48,-9,6,15
61,BER,P008211,P008384,0 days 00:04:47,8,18,10
61,BER,P008384,P012721,0 days 00:04:42,0,13,13
61,BER,P008967,P012721,0 days 00:04:31,0,13,13
61,BER,P007550,P012721,0 days 00:04:31,0,13,13
61,BER,P006251,P008211,0 days 00:04:28,7,16,9
61,BER,P006919,P008967,0 days 00:03:50,-3,5,8
61,BER,P003958,P006251,0 days 00:03:48,7,15,8
61,BER,P011934,P012721,0 days 00:03:34,2,13,11
61,BER,P006251,P008967,0 days 00:03:28,-1,5,6
61,BER,P006251,P007025,0 days 00:03:12,-5,7,12
61,BER,P007025,P008384,0 days 00:03:12,-5,7,12
61,BER,P008967,P010791,0 days 00:02:43,-2,5,7
61,BER,P006919,P007550,0 days 00:01:56,-1,4,5
61,BER,P007550,P010791,0 days 00:01:56,-1,4,5
61,BER,P007025,P011934,0 days 00:01:55,-6,2,8
61,BER,P007025,P007550,0 days 00:01:55,-6,2,8
61,BER,P006251,P011934,0 days 00:01:55,-6,2,8
61,BER,P006919,P011934,0 days 00:01:48,0,2,2
61,BER,P003958,P007025,0 days 00:01:17,1,5,4
61,BER,P007025,P012720,0 days 00:01:17,1,5,4
61,BER,P006251,P012721,0 days 00:01:08,-2,0,2
61,BER,P003958,P007550,0 days 00:00:55,0,3,3
61,BER,P008211,P012721,0 days 00:00:11,0,0,0
61,BER,P012720,P012721,0 days 00:00:11,0,0,0
61,BER,P007550,P012720,0 days 00:00:09,0,0,0
61,PAN,P002328,P007866,0 days 00:34:15,10,80,70
61,PAN,P001926,P007866,0 days 00:27:35,17,66,49
61,PAN,P001926,P002328,0 days 00:27:11,14,63,49
61,PAN,P007866,P011204,0 days 00:26:35,8,62,54
61,PAN,P002328,P011204,0 days 00:24:44,6,57,51
61,PAN,P001926,P011204,0 days 00:23:56,16,59,43
61,PAN,P003842,P007866,0 days 00:22:08,1,43,42
61,PAN,P002328,P003842,0 days 00:20:41,2,41,39
61,PAN,P003842,P011204,0 days 00:18:50,4,36,32
61,PAN,P001926,P003842,0 days 00:17:24,9,35,26
61,PAN,P002328,P007553,0 days 00:13:34,8,39,31
61,PAN,P007553,P007866,0 days 00:13:34,8,39,31
61,PAN,P007866,P007947,0 days 00:13:14,8,37,29
61,PAN,P001926,P007553,0 days 00:12:59,10,40,30
61,PAN,P007553,P007947,0 days 00:11:50,11,37,26
61,PAN,P002328,P007947,0 days 00:11:23,6,32,26
61,PAN,P007553,P011204,0 days 00:10:33,6,35,29
61,PAN,P001926,P007947,0 days 00:10:27,14,34,20
61,PAN,P007866,P012774,0 days 00:07:03,-4,13,17
61,PAN,P007947,P011204,0 days 00:06:55,9,26,17
61,PAN,P003842,P007947,0 days 00:05:36,-7,13,20
61,PAN,P003842,P012774,0 days 00:05:17,-11,8,19
61,PAN,P007947,P012774,0 days 00:05:13,-3,11,14
61,PAN,P002328,P012774,0 days 00:05:12,-6,8,14
61,PAN,P011204,P012774,0 days 00:04:23,-2,9,11
61,PAN,P007947,P008084,0 days 00:03:54,2,14,12
61,PAN,P007553,P008084,0 days 00:03:54,2,14,12
61,PAN,P008084,P011204,0 days 00:03:12,5,12,7
61,PAN,P001926,P008084,0 days 00:03:12,5,12,7
61,PAN,P007553,P012774,0 days 00:02:46,-2,6,8
61,PAN,P003842,P007553,0 days 00:00:42,-3,2,5
61,PAN,P003842,P008084,0 days 00:00:42,-3,2,5
61,PAN,P008084,P012774,0 days 00:00:42,-3,2,5
61,PAN,P001926,P012774,0 days 00:00:24,3,3,0
62,MCO,P005985,P010588,0 days 00:22:12,11,53,42
62,MCO,P011212,P011226,0 days 00:20:58,-4,33,37
62,MCO,P011226,P011231,0 days 00:20:27,9,39,30
62,MCO,P005985,P009754,0 days 00:19:02,14,47,33
62,MCO,P009754,P010588,0 days 00:19:02,14,47,33
62,MCO,P011196,P011226,0 days 00:18:51,7,36,29
62,MCO,P011196,P011212,0 days 00:17:04,7,33,26
62,MCO,P011212,P011231,0 days 00:16:42,1,27,26
62,MCO,P005985,P011226,0 days 00:14:56,-2,25,27
62,MCO,P009754,P011226,0 days 00:12:44,19,32,13
62,MCO,P011196,P011231,0 days 00:12:14,10,25,15
62,MCO,P004197,P005985,0 days 00:11:58,-2,24,26
62,MCO,P004197,P010588,0 days 00:11:58,-2,24,26
62,MCO,P004197,P009754,0 days 00:11:58,-2,24,26
62,MCO,P010588,P011226,0 days 00:10:34,7,25,18
62,MCO,P009754,P011231,0 days 00:10:11,15,25,10
62,MCO,P005985,PLCZ,0 days 00:09:39,-6,16,22
62,MCO,P005985,P011196,0 days 00:09:27,0,15,15
62,MCO,P005985,P011212,0 days 00:09:24,-10,10,20
62,MCO,P009754,PLCZ,0 days 00:09:19,-1,16,17
62,MCO,P005985,P011231,0 days 00:09:13,-3,12,15
62,MCO,P009754,P011196,0 days 00:07:35,16,22,6
62,MCO,P010588,P011196,0 days 00:07:23,1,15,14
62,MCO,P010588,PLCZ,0 days 00:07:21,2,16,14
62,MCO,P009754,P011212,0 days 00:07:12,11,17,6
62,MCO,P004197,PLCZ,0 days 00:07:09,0,14,14
62,MCO,P011212,P012709,0 days 00:05:54,3,14,11
62,MCO,P011226,P012709,0 days 00:05:54,3,14,11
62,MCO,P011196,P012709,0 days 00:05:54,3,14,11
62,MCO,P010588,P011212,0 days 00:05:02,-1,10,11
62,MCO,P002581,P010588,0 days 00:04:49,-2,10,12
62,MCO,P002581,P009754,0 days 00:04:49,-2,10,12
62,MCO,P002581,P005985,0 days 00:04:49,-2,10,12
62,MCO,P002581,P004197,0 days 00:04:49,-2,10,12
62,MCO,P011231,P012709,0 days 00:04:48,5,14,9
62,MCO,P011212,PLCZ,0 days 00:04:40,-7,4,11
62,MCO,P011226,PLCZ,0 days 00:04:40,-7,4,11
62,MCO,P011231,PLCZ,0 days 00:04:28,-9,2,11
62,MCO,P010588,P011231,0 days 00:03:45,8,12,4
62,MCO,P010588,P012709,0 days 00:01:06,-2,0,2
62,ASV,P004194,P012080,0 days 00:29:20,-4,59,63
62,ASV,P004194,P011225,0 days 00:27:23,3,56,53
62,ASV,P011225,P012080,0 days 00:25:14,-2,52,54
62,ASV,P002100,P012729,0 days 00:20:09,-5,34,39
62,ASV,P003526,P004194,0 days 00:18:57,-5,32,37
62,ASV,P004194,P006568,0 days 00:18:45,-3,36,39
62,ASV,P006568,P012080,0 days 00:18:45,-3,36,39
62,ASV,P002100,P012080,0 days 00:18:37,-3,35,38
62,ASV,P003526,P011225,0 days 00:18:12,-5,32,37
62,ASV,P006568,P011225,0 days 00:16:53,-1,34,35
62,ASV,P002100,P004194,0 days 00:16:45,6,36,30
62,ASV,P003526,P012080,0 days 00:16:38,-6,29,35
62,ASV,P012080,P012729,0 days 00:15:45,-6,28,34
62,ASV,P002100,P011225,0 days 00:14:51,3,29,26
62,ASV,P003526,P006568,0 days 00:14:47,-4,29,33
62,ASV,P004194,P012729,0 days 00:13:53,3,29,26
62,ASV,P011225,P012729,0 days 00:13:51,-2,24,26
62,ASV,P012729,P012730,0 days 00:07:22,-10,5,15
62,ASV,P002100,P012730,0 days 00:07:22,-10,5,15
62,ASV,P002100,PKIR,0 days 00:07:12,-6,6,12
62,ASV,P012729,PKIR,0 days 00:07:12,-6,6,12
62,ASV,P012730,PKIR,0 days 00:06:13,-9,3,12
62,ASV,P012080,P012730,0 days 00:05:10,-5,5,10
62,ASV,P002100,P011386,0 days 00:04:30,-3,9,12
62,ASV,P004194,P011386,0 days 00:04:30,-3,9,12
62,ASV,P011386,P012080,0 days 00:04:30,-3,9,12
62,ASV,P003526,P012729,0 days 00:04:10,-1,3,4
62,ASV,P012080,PKIR,0 days 00:04:01,-4,3,7
62,ASV,P002100,P006568,0 days 00:03:58,1,7,6
62,ASV,P011225,P012730,0 days 00:03:21,-6,2,8
62,ASV,P011225,PKIR,0 days 00:03:11,-2,3,5
62,ASV,P002100,P003526,0 days 00:03:04,1,3,2
62,ASV,P011386,P012729,0 days 00:02:38,-1,7,8
62,ASV,P006568,P011386,0 days 00:01:52,-2,2,4
62,ASV,P004194,PKIR,0 days 00:00:59,3,3,0
63,BAR,P000925,P002939,0 days 00:21:26,5,43,38
63,BAR,P002939,P004866,0 days 00:18:16,8,41,33
63,BAR,P004866,P012745,0 days 00:18:09,6,41,35
63,BAR,P000925,P004866,0 days 00:16:06,10,36,26
63,BAR,P002939,P011244,0 days 00:15:39,-3,31,34
63,BAR,P003196,P007519,0 days 00:15:28,5,38,33
63,BAR,P004866,P006435,0 days 00:15:23,8,37,29
63,BAR,P003196,P012745,0 days 00:14:49,6,36,30
63,BAR,P000925,P011244,0 days 00:14:30,-5,24,29
63,BAR,P006435,P012745,0 days 00:14:29,13,34,21
63,BAR,P002939,P003478,0 days 00:13:42,3,29,26
63,BAR,P007519,P012745,0 days 00:13:14,6,34,28
63,BAR,P003478,P011244,0 days 00:12:58,-2,24,26
63,BAR,P004866,P007519,0 days 00:12:09,-2,24,26
63,BAR,P002939,P006435,0 days 00:12:01,-2,25,27
63,BAR,P003478,P007519,0 days 00:11:51,-2,25,27
63,BAR,P000925,P003478,0 days 00:11:43,-1,23,24
63,BAR,P002939,P012745,0 days 00:10:52,7,23,16
63,BAR,P003196,P004866,0 days 00:10:52,-3,25,28
63,BAR,P000925,P006435,0 days 00:09:51,0,20,20
63,BAR,P003196,P003478,0 days 00:09:14,1,22,21
63,BAR,P004866,P011244,0 days 00:08:49,1,20,19
63,BAR,P007519,P011244,0 days 00:08:18,-5,11,16
63,BAR,P003196,P006435,0 days 00:08:11,4,21,17
63,BAR,P002939,P007519,0 days 00:08:03,0,13,13
63,BAR,P003478,P012745,0 days 00:07:59,2,21,19
63,BAR,P003478,P004866,0 days 00:07:55,2,20,18
63,BAR,P000925,P012745,0 days 00:07:52,7,19,12
63,BAR,P000925,P007519,0 days 00:06:04,-4,7,11
63,BAR,P006435,P007519,0 days 00:06:01,6,16,10
63,BAR,P003478,P009992,0 days 00:05:47,1,12,11
63,BAR,P002939,P003196,0 days 00:05:05,-1,11,12
63,BAR,P007519,P009992,0 days 00:05:00,0,12,12
63,BAR,P003196,P009992,0 days 00:04:04,3,12,9
63,BAR,P006435,P011244,0 days 00:03:33,-9,7,16
63,BAR,P009992,P012745,0 days 00:03:20,5,12,7
63,BAR,P003196,P011244,0 days 00:02:49,-3,7,10
63,BAR,P009992,P011244,0 days 00:02:40,-6,0,6
63,BAR,P003478,P006435,0 days 00:02:39,-4,4,8
63,BAR,P000925,P009992,0 days 00:01:56,-4,0,4
63,BAR,P002939,P009992,0 days 00:01:00,-1,0,1
63,BAR,P004866,P009992,0 days 00:00:13,-2,0,2
63,RED,P002553,P009035,0 days 00:24:12,-7,41,48
63,RED,P002553,P011224,0 days 00:24:11,-17,41,58
63,RED,P000848,P009035,0 days 00:21:51,-1,40,41
63,RED,P000848,P002553,0 days 00:21:39,-10,35,45
63,RED,P007960,P009035,0 days 00:20:39,0,38,38
63,RED,P009035,P011224,0 days 00:20:09,-7,33,40
63,RED,P002553,P007960,0 days 00:18:41,-7,28,35
63,RED,P000848,P007960,0 days 00:18:06,-4,32,36
63,RED,P000848,P011224,0 days 00:17:36,-10,27,37
63,RED,P006436,PJDR,0 days 00:16:23,1,43,42
63,RED,P007960,P011224,0 days 00:15:05,-6,22,28
63,RED,P002553,PJDR,0 days 00:14:54,-9,30,39
63,RED,P002553,P006436,0 days 00:12:50,-12,26,38
63,RED,P007960,PJDR,0 days 00:11:12,13,30,17
63,RED,P009035,PJDR,0 days 00:10:56,8,29,21
63,RED,P006436,P011224,0 days 00:10:24,-9,23,32
63,RED,P008966,PJDR,0 days 00:10:12,1,22,21
63,RED,P006436,P008966,0 days 00:10:00,1,22,21
63,RED,P006436,P012044,0 days 00:08:45,4,20,16
63,RED,P008966,P012044,0 days 00:08:45,4,20,16
63,RED,P012044,PJDR,0 days 00:08:45,4,20,16
63,RED,P011224,PJDR,0 days 00:08:25,-6,19,25
63,RED,P006436,P009035,0 days 00:07:29,7,23,16
63,RED,P000848,P006436,0 days 00:07:29,8,23,15
63,RED,P000848,PJDR,0 days 00:07:12,7,21,14
63,RED,P006436,P007960,0 days 00:04:24,9,16,7
63,RED,P011964,P012044,0 days 00:03:53,5,11,6
63,RED,P011964,PJDR,0 days 00:03:53,5,11,6
63,RED,P008966,P011964,0 days 00:03:53,5,11,6
63,RED,P006436,P011964,0 days 00:03:53,5,11,6
63,RED,P002553,P008966,0 days 00:03:41,-6,5,11
63,RED,P002553,P012044,0 days 00:03:05,-2,5,7
63,RED,P002553,P003479,0 days 00:02:51,-6,5,11
63,RED,P003479,P006436,0 days 00:02:51,-6,5,11
63,RED,P003479,P011224,0 days 00:02:51,-6,5,11
63,RED,P007960,P008966,0 days 00:02:26,2,6,4
63,RED,P007960,P012044,0 days 00:01:47,1,4,3
63,RED,P003479,PJDR,0 days 00:01:40,-4,3,7
63,RED,P008966,P011224,0 days 00:01:27,-3,2,5
63,RED,P000848,P003479,0 days 00:01:11,-2,2,4
63,RED,P000848,P008966,0 days 00:00:12,0,0,0
63,RED,P008966,P009035,0 days 00:00:12,0,0,0
64,MCO,P009754,P010588,0 days 00:30:08,-4,63,67
64,MCO,P005985,P010588,0 days 00:30:08,-6,66,72
64,MCO,P005985,P009754,0 days 00:28:10,-8,60,68
64,MCO,P005985,PLCZ,0 days 00:18:59,-9,45,54
64,MCO,P009754,PLCZ,0 days 00:18:59,-9,45,54
64,MCO,P010588,PLCZ,0 days 00:18:07,-8,43,51
64,MCO,P010588,P011226,0 days 00:17:28,-12,34,46
64,MCO,P009754,P011226,0 days 00:16:58,-10,34,44
64,MCO,P005985,P011226,0 days 00:16:01,-16,31,47
64,MCO,P010588,P011212,0 days 00:13:23,8,26,18
64,MCO,P011212,P011231,0 days 00:11:48,3,20,17
64,MCO,P011212,P011226,0 days 00:11:22,-1,18,19
64,MCO,P005985,P011212,0 days 00:11:04,5,21,16
64,MCO,P005985,P011231,0 days 00:11:01,0,21,21
64,MCO,P011226,P011231,0 days 00:10:47,-3,19,22
64,MCO,P009754,P011212,0 days 00:10:28,9,18,9
64,MCO,P010588,P011231,0 days 00:09:33,3,19,16
64,MCO,P011226,PLCZ,0 days 00:09:07,-12,19,31
64,MCO,P009754,P011231,0 days 00:08:52,0,15,15
64,MCO,P011196,P011226,0 days 00:07:33,-4,11,15
64,MCO,P004197,P010588,0 days 00:07:29,-1,20,21
64,MCO,P004197,P009754,0 days 00:07:29,-1,20,21
64,MCO,P004197,P005985,0 days 00:07:29,-1,20,21
64,MCO,P004197,PLCZ,0 days 00:07:29,-1,20,21
64,MCO,P011196,P011212,0 days 00:07:27,-4,11,15
64,MCO,P011196,P011231,0 days 00:06:05,-1,9,10
64,MCO,P011212,P012709,0 days 00:05:34,-1,9,10
64,MCO,P011226,P012709,0 days 00:05:34,-1,9,10
64,MCO,P011196,P012709,0 days 00:05:34,-1,9,10
64,MCO,P011231,P012709,0 days 00:05:29,1,9,8
64,MCO,P004790,P011212,0 days 00:04:23,5,11,6
64,MCO,P004790,P010588,0 days 00:04:23,5,11,6
64,MCO,P004790,P009754,0 days 00:02:50,3,5,2
64,MCO,P004790,P011226,0 days 00:02:50,3,5,2
64,MCO,P011212,PLCZ,0 days 00:02:23,4,6,2
64,MCO,P005985,P011196,0 days 00:01:59,-3,2,5
64,MCO,P004790,P005985,0 days 00:01:33,2,6,4
64,MCO,P004790,P011231,0 days 00:01:33,2,6,4
64,MCO,P010588,P011196,0 days 00:01:28,-3,2,5
64,MCO,P011231,PLCZ,0 days 00:00:52,-1,2,3
64,MCO,P009754,P011196,0 days 00:00:06,0,0,0
64,MCO,P010588,P012709,0 days 00:00:05,-2,0,2
64,IST,P007200,P011078,0 days 00:29:44,19,75,56
64,IST,P006590,P007200,0 days 00:26:30,4,62,58
64,IST,P007200,P009664,0 days 00:26:26,5,62,57
64,IST,P006590,P011078,0 days 00:25:18,8,57,49
64,IST,P006590,P009664,0 days 00:25:00,2,60,58
64,IST,P009664,P011078,0 days 00:23:31,14,57,43
64,IST,P004554,P007200,0 days 00:21:14,18,62,44
64,IST,P004554,P006590,0 days 00:20:59,10,57,47
64,IST,P004554,P011078,0 days 00:19:55,19,59,40
64,IST,P004554,P009664,0 days 00:18:36,11,54,43
64,IST,P004888,P007200,0 days 00:17:37,4,39,35
64,IST,P004888,P011078,0 days 00:14:30,8,29,21
64,IST,P004888,P009664,0 days 00:13:55,-9,22,31
64,IST,P004888,P006590,0 days 00:12:49,-9,20,29
64,IST,P006372,P007200,0 days 00:09:34,-2,15,17
64,IST,P006372,P011078,0 days 00:09:22,0,15,15
64,IST,P004888,P006372,0 days 00:07:11,1,13,12
64,IST,P004888,P011981,0 days 00:06:17,-3,9,12
64,IST,P004888,PLHK,0 days 00:06:04,1,11,10
64,IST,P004554,P004888,0 days 00:06:01,5,20,15
64,IST,P007200,P011981,0 days 00:05:12,-3,9,12
64,IST,P006590,P011981,0 days 00:05:02,-8,2,10
64,IST,P007200,PLHK,0 days 00:04:24,3,11,8
64,IST,P011078,P011981,0 days 00:04:13,-4,2,6
64,IST,P006372,P009664,0 days 00:04:10,-2,3,5
64,IST,P006372,P006590,0 days 00:03:56,-5,2,7
64,IST,P011981,PLHK,0 days 00:03:41,3,7,4
64,IST,P011078,PLHK,0 days 00:03:35,0,6,6
64,IST,P004888,P009513,0 days 00:03:28,-2,9,11
64,IST,P004554,P006372,0 days 00:02:50,3,8,5
64,IST,P009664,P011981,0 days 00:02:37,-6,2,8
64,IST,P006590,PLHK,0 days 00:02:17,-4,0,4
64,IST,P009513,P011981,0 days 00:01:55,0,5,5
64,IST,P007200,P009513,0 days 00:01:55,0,5,5
64,IST,P009513,PLHK,0 days 00:01:52,3,5,2
64,IST,P006372,PLHK,0 days 00:01:46,0,4,4
64,IST,P009513,P009664,0 days 00:01:36,-5,4,9
64,IST,P004554,P009513,0 days 00:01:33,-2,4,6
64,IST,P006590,P009513,0 days 00:01:33,-2,4,6
64,IST,P006372,P011981,0 days 00:01:15,-3,0,3
64,IST,P009664,PLHK,0 days 00:00:37,-2,0,2
65,RED,P000848,P006436,0 days 00:19:15,9,40,31
65,RED,P002553,P012044,0 days 00:18:20,4,29,25
65,RED,P008966,PJDR,0 days 00:16:48,21,38,17
65,RED,P006436,P012044,0 days 00:16:44,2,33,31
65,RED,P006436,P009035,0 days 00:16:29,6,32,26
65,RED,P002553,P006436,0 days 00:16:13,5,28,23
65,RED,P000848,P009035,0 days 00:16:03,6,32,26
65,RED,P004720,P008966,0 days 00:15:47,19,34,15
65,RED,P002553,P009035,0 days 00:15:01,2,25,23
65,RED,P000848,P002553,0 days 00:14:35,2,25,23
65,RED,P000848,P012044,0 days 00:14:33,-2,27,29
65,RED,P004720,PJDR,0 days 00:14:32,17,32,15
65,RED,P004720,P007960,0 days 00:14:05,15,34,19
65,RED,P009035,P012044,0 days 00:13:17,0,24,24
65,RED,P007960,P008966,0 days 00:11:49,15,28,13
65,RED,P012044,PJDR,0 days 00:11:23,15,24,9
65,RED,P007960,PJDR,0 days 00:11:18,16,29,13
65,RED,P008966,P012044,0 days 00:10:25,10,19,9
65,RED,P000848,P007960,0 days 00:10:00,13,29,16
65,RED,P006436,P007960,0 days 00:09:17,7,25,18
65,RED,P004720,P012044,0 days 00:09:03,9,16,7
65,RED,P000848,PJDR,0 days 00:08:32,15,25,10
65,RED,P002553,PJDR,0 days 00:08:19,10,16,6
65,RED,P007960,P012044,0 days 00:07:18,5,18,13
65,RED,P000848,P008966,0 days 00:07:03,13,21,8
65,RED,P002553,P008966,0 days 00:06:21,8,12,4
65,RED,P000848,P004720,0 days 00:06:09,10,18,8
65,RED,P003479,P006436,0 days 00:05:28,2,15,13
65,RED,P003479,P007960,0 days 00:05:28,2,15,13
65,RED,P002553,P004720,0 days 00:05:20,5,9,4
65,RED,P006436,PJDR,0 days 00:05:14,11,15,4
65,RED,P004720,P006436,0 days 00:04:42,3,11,8
65,RED,P006436,P011964,0 days 00:03:51,1,9,8
65,RED,P007960,P011964,0 days 00:03:51,1,9,8
65,RED,P004720,P011964,0 days 00:03:51,1,9,8
65,RED,P006436,P008966,0 days 00:03:31,6,8,2
65,RED,P003479,P011964,0 days 00:03:23,1,9,8
65,RED,P003479,P004720,0 days 00:03:23,1,9,8
65,RED,P009035,PJDR,0 days 00:02:31,4,6,2
65,RED,P003479,P012044,0 days 00:02:05,1,6,5
65,RED,P000848,P003479,0 days 00:01:38,-2,3,5
65,RED,P007960,P009035,0 days 00:01:23,2,5,3
65,RED,P009035,P011224,0 days 00:01:08,4,4,0
65,RED,P000848,P011224,0 days 00:01:08,4,4,0
65,RED,P006436,P011224,0 days 00:01:08,4,4,0
65,RED,P002553,P011224,0 days 00:01:08,4,4,0
65,RED,P008966,P011964,0 days 00:00:28,0,0,0
65,RED,P003479,PJDR,0 days 00:00:27,3,3,0
65,RED,P002553,P007960,0 days 00:00:11,0,0,0
65,RED,P004720,P009035,0 days 00:00:04,0,0,0
65,ULK,P008962,P011980,0 days 00:19:29,-13,27,40
65,ULK,P006661,P008962,0 days 00:19:27,-12,29,41
65,ULK,P008962,P011157,0 days 00:17:36,-5,28,33
65,ULK,P008962,P011052,0 days 00:17:10,-6,28,34
65,ULK,P008962,P009849,0 days 00:16:43,-17,23,40
65,ULK,P011052,P011157,0 days 00:16:05,-3,28,31
65,ULK,P011052,P011980,0 days 00:15:48,-3,25,28
65,ULK,P006661,P011157,0 days 00:14:47,-4,19,23
65,ULK,P011157,P011980,0 days 00:14:40,-2,23,25
65,ULK,P009849,P011157,0 days 00:14:35,-12,18,30
65,ULK,P005844,P006961,0 days 00:14:25,-15,22,37
65,ULK,P005844,P006661,0 days 00:13:28,-18,14,32
65,ULK,P005844,P011201,0 days 00:13:27,-13,19,32
65,ULK,P009849,P011980,0 days 00:13:03,-15,17,32
65,ULK,P006661,P009849,0 days 00:12:49,-13,14,27
65,ULK,P005844,P009849,0 days 00:12:07,-13,11,24
65,ULK,P009849,P011052,0 days 00:11:23,-8,18,26
65,ULK,P006661,P011980,0 days 00:11:11,-4,16,20
65,ULK,P006961,P011201,0 days 00:10:44,-15,17,32
65,ULK,P005844,P008962,0 days 00:10:09,-16,12,28
65,ULK,P005844,P011052,0 days 00:08:56,-8,14,22
65,ULK,P006661,P011052,0 days 00:08:52,3,17,14
65,ULK,P006961,P011052,0 days 00:07:51,-5,14,19
65,ULK,P006661,P006961,0 days 00:07:36,-12,8,20
65,ULK,P002969,P011052,0 days 00:07:19,-7,12,19
65,ULK,P002969,P005844,0 days 00:07:19,-7,12,19
65,ULK,P002969,P006961,0 days 00:07:19,-7,12,19
65,ULK,P006661,P011201,0 days 00:07:14,-8,7,15
65,ULK,P011052,P011201,0 days 00:06:40,-7,12,19
65,ULK,P002969,P011201,0 days 00:06:40,-7,12,19
65,ULK,P006961,P008962,0 days 00:06:22,-7,8,15
65,ULK,P005844,P011980,0 days 00:05:21,-9,6,15
65,ULK,P006961,P009849,0 days 00:04:43,-2,5,7
65,ULK,P005844,P011157,0 days 00:04:24,-5,2,7
65,ULK,P008962,P011201,0 days 00:04:04,-8,5,13
65,ULK,P011157,P011201,0 days 00:03:37,-2,2,4
65,ULK,P009849,P011201,0 days 00:03:10,0,2,2
65,ULK,P006961,P011157,0 days 00:02:16,-7,0,7
65,ULK,P002969,P009849,0 days 00:00:39,0,0,0
65,ULK,P006961,P011980,0 days 00:00:32,2,2,0
66,TEL,P009622,P009783,0 days 00:26:19,-14,37,51
66,TEL,P009622,P011199,0 days 00:21:06,0,31,31
66,TEL,P009783,P011193,0 days 00:20:46,-8,36,44
66,TEL,P009783,P011199,0 days 00:19:34,-3,28,31
66,TEL,P009622,P011193,0 days 00:17:28,-8,27,35
66,TEL,P009622,P011971,0 days 00:16:45,0,26,26
66,TEL,P009783,P011971,0 days 00:15:45,0,24,24
66,TEL,P007990,P009783,0 days 00:14:16,2,24,22
66,TEL,P007990,P009622,0 days 00:13:49,2,24,22
66,TEL,P011199,P011971,0 days 00:13:39,0,22,22
66,TEL,P011193,P011214,0 days 00:11:50,-4,25,29
66,TEL,P011193,P011199,0 days 00:11:43,3,18,15
66,TEL,P009783,P011214,0 days 00:10:37,6,24,18
66,TEL,P011193,P011219,0 days 00:10:28,-11,19,30
66,TEL,P011214,P011219,0 days 00:10:20,4,23,19
66,TEL,P009622,P012744,0 days 00:09:52,-3,20,23
66,TEL,P007990,P011199,0 days 00:09:32,-7,13,20
66,TEL,P011193,P011971,0 days 00:09:25,0,13,13
66,TEL,P009622,P011219,0 days 00:08:48,-1,18,19
66,TEL,P009783,P011219,0 days 00:08:22,-4,13,17
66,TEL,P004233,P011193,0 days 00:08:04,4,25,21
66,TEL,P011193,P012744,0 days 00:07:44,-3,20,23
66,TEL,P007990,P011214,0 days 00:07:44,7,17,10
66,TEL,P007990,P011219,0 days 00:07:36,7,17,10
66,TEL,P009622,P011214,0 days 00:07:32,2,13,11
66,TEL,P007990,P011971,0 days 00:07:20,0,13,13
66,TEL,P011219,P012744,0 days 00:06:53,-6,17,23
66,TEL,P009783,P012744,0 days 00:05:49,-11,8,19
66,TEL,P011199,P012744,0 days 00:05:43,0,9,9
66,TEL,P004233,P011214,0 days 00:05:26,1,17,16
66,TEL,P004233,P012744,0 days 00:05:22,3,14,11
66,TEL,P007990,P012744,0 days 00:04:39,-3,6,9
66,TEL,P011214,P012744,0 days 00:04:22,-1,10,11
66,TEL,P004233,P011219,0 days 00:03:50,-3,11,14
66,TEL,P005145,P009783,0 days 00:03:32,-1,11,12
66,TEL,P005145,P011193,0 days 00:03:32,-1,11,12
66,TEL,P005145,P011214,0 days 00:03:32,-1,11,12
66,TEL,P007990,P011193,0 days 00:03:24,0,6,6
66,TEL,P004233,P009783,0 days 00:03:08,1,11,10
66,TEL,P011214,P011971,0 days 00:03:06,0,4,4
66,TEL,P004233,P009622,0 days 00:02:55,3,8,5
66,TEL,P004233,P005145,0 days 00:02:38,4,11,7
66,TEL,P011199,P011219,0 days 00:01:55,-2,0,2
66,TEL,P004233,P011199,0 days 00:01:45,3,3,0
66,TEL,P011219,P011971,0 days 00:01:00,0,2,2
66,TEL,P005145,P009622,0 days 00:00:54,-5,0,5
66,TEL,P011199,P011214,0 days 00:00:11,-2,0,2
66,OLY,P008811,P008855,0 days 00:32:23,-3,52,55
66,OLY,P001255,P008855,0 days 00:26:09,-6,37,43
66,OLY,P001255,P008811,0 days 00:26:02,-4,39,43
66,OLY,P008855,P010612,0 days 00:20:44,0,40,40
66,OLY,P008811,P010612,0 days 00:20:04,0,38,38
66,OLY,P008811,P008829,0 days 00:18:51,11,41,30
66,OLY,P008829,P008855,0 days 00:16:59,8,36,28
66,OLY,P001255,P010612,0 days 00:16:40,-3,28,31
66,OLY,P008829,P010612,0 days 00:16:17,7,36,29
66,OLY,P008811,P010392,0 days 00:14:29,8,29,21
66,OLY,P008855,P010392,0 days 00:12:19,3,20,17
66,OLY,P001255,P008829,0 days 00:10:46,2,18,16
66,OLY,P008855,P011983,0 days 00:10:29,-4,20,24
66,OLY,P006302,P008811,0 days 00:10:03,10,23,13
66,OLY,P006302,P010392,0 days 00:09:55,8,21,13
66,OLY,P008811,P011983,0 days 00:09:45,-5,17,22
66,OLY,P001255,P010392,0 days 00:09:33,4,16,12
66,OLY,P010612,P011983,0 days 00:09:29,1,23,22
66,OLY,P008829,P011983,0 days 00:08:24,3,25,22
66,OLY,P006302,P008855,0 days 00:07:26,2,11,9
66,OLY,P006302,P008829,0 days 00:07:15,3,19,16
66,OLY,P006589,P011983,0 days 00:07:04,-5,16,21
66,OLY,P007982,P008829,0 days 00:06:33,2,19,17
66,OLY,P006589,P008855,0 days 00:06:31,0,12,12
66,OLY,P001255,P011983,0 days 00:06:21,-8,7,15
66,OLY,P006589,P008811,0 days 00:05:58,-2,8,10
66,OLY,P006302,P007982,0 days 00:05:18,3,16,13
66,OLY,P001255,P006589,0 days 00:05:05,-2,6,8
66,OLY,P001255,P006302,0 days 00:04:48,5,9,4
66,OLY,P006589,P008829,0 days 00:04:41,-1,14,15
66,OLY,P008829,P010392,0 days 00:04:22,5,12,7
66,OLY,P007982,P011983,0 days 00:04:08,-3,10,13
66,OLY,P006589,P007982,0 days 00:04:08,-3,10,13
66,OLY,P006302,P006589,0 days 00:03:46,-2,9,11
66,OLY,P006589,P010392,0 days 00:03:35,2,6,4
66,OLY,P006302,P011983,0 days 00:03:01,0,9,9
66,OLY,P007982,P010392,0 days 00:02:25,5,9,4
66,OLY,P007982,P008811,0 days 00:02:25,5,9,4
66,OLY,P010392,P010612,0 days 00:02:15,0,6,6
66,OLY,P006589,P010612,0 days 00:01:48,1,7,6
66,OLY,P007982,P010612,0 days 00:01:15,-1,3,4
66,OLY,P010392,P011983,0 days 00:00:19,1,1,0
66,OLY,P006302,P010612,0 days 00:00:12,3,3,0
67,PAM,P007870,P010568,0 days 00:26:00,-5,50,55
67,PAM,P003960,P010568,0 days 00:23:59,-11,43,54
67,PAM,P003960,P007870,0 days 00:23:40,-5,46,51
67,PAM,P005356,P010568,0 days 00:21:46,-11,41,52
67,PAM,P005356,P007870,0 days 00:21:46,-11,41,52
67,PAM,P003960,P005356,0 days 00:20:42,-11,38,49
67,PAM,P000556,P003960,0 days 00:13:25,-11,25,36
67,PAM,P000556,P010568,0 days 00:13:25,-11,25,36
67,PAM,P000556,P007870,0 days 00:13:25,-11,25,36
67,PAM,P000556,P005356,0 days 00:12:35,-13,23,36
67,PAM,P004863,P012740,0 days 00:11:16,8,21,13
67,PAM,P004863,P012738,0 days 00:11:04,6,19,13
67,PAM,P012739,P012740,0 days 00:10:57,3,16,13
67,PAM,P004863,P011982,0 days 00:10:44,4,18,14
67,PAM,P012738,P012740,0 days 00:10:23,6,17,11
67,PAM,P010568,P011982,0 days 00:10:14,-4,17,21
67,PAM,P004863,P012739,0 days 00:10:04,4,16,12
67,PAM,P011982,P012739,0 days 00:09:54,1,13,12
67,PAM,P007870,P011982,0 days 00:09:48,0,19,19
67,PAM,P012738,P012739,0 days 00:09:39,5,15,10
67,PAM,P011982,P012740,0 days 00:09:27,2,12,10
67,PAM,P011982,P012738,0 days 00:09:05,4,13,9
67,PAM,P003960,P011982,0 days 00:07:33,-4,11,15
67,PAM,P006643,P007870,0 days 00:07:23,7,17,10
67,PAM,P005356,P011982,0 days 00:06:52,-1,12,13
67,PAM,P004863,P006643,0 days 00:06:06,6,15,9
67,PAM,P004863,P007870,0 days 00:06:06,7,15,8
67,PAM,P006643,P010568,0 days 00:04:45,6,10,4
67,PAM,P003960,P006643,0 days 00:04:25,6,11,5
67,PAM,P003960,P004863,0 days 00:03:52,4,8,4
67,PAM,P004863,P010568,0 days 00:03:37,4,8,4
67,PAM,P006643,P012740,0 days 00:03:07,3,9,6
67,PAM,P007870,P010393,0 days 00:02:49,-2,5,7
67,PAM,P010393,P011982,0 days 00:02:49,-2,5,7
67,PAM,P006643,P012738,0 days 00:02:46,2,6,4
67,PAM,P005356,P006643,0 days 00:02:19,3,6,3
67,PAM,P006643,P011982,0 days 00:02:14,0,4,4
67,PAM,P003960,P012740,0 days 00:02:11,-1,4,5
67,PAM,P007870,P012738,0 days 00:01:56,1,4,3
67,PAM,P010393,P010568,0 days 00:01:48,-1,3,4
67,PAM,P006643,P012739,0 days 00:01:46,1,4,3
67,PAM,P006643,P010393,0 days 00:01:45,-2,2,4
67,PAM,P003960,P012739,0 days 00:01:45,-3,2,5
67,PAM,P007870,P012740,0 days 00:01:37,2,5,3
67,PAM,P010568,P012739,0 days 00:01:29,-4,1,5
67,PAM,P010568,P012738,0 days 00:01:27,0,2,2
67,PAM,P010568,P012740,0 days 00:01:18,-3,0,3
67,PAM,P005356,P010393,0 days 00:01:04,0,3,3
67,PAM,P004863,P010393,0 days 00:01:01,-1,2,3
67,PAM,P000556,P004863,0 days 00:00:50,2,2,0
67,PAM,P007870,P012739,0 days 00:00:02,1,1,0
67,MAD,P005791,P005928,0 days 00:25:50,8,55,47
67,MAD,P005928,P009005,0 days 00:21:52,9,47,38
67,MAD,P005791,P009005,0 days 00:19:53,9,44,35
67,MAD,P005928,P006540,0 days 00:17:20,8,41,33
67,MAD,P006540,P009005,0 days 00:17:20,8,41,33
67,MAD,P005791,P006540,0 days 00:16:43,8,38,30
67,MAD,P005791,P010357,0 days 00:16:02,0,32,32
67,MAD,P005928,P010357,0 days 00:13:26,1,31,30
67,MAD,P003108,PTGB,0 days 00:11:51,4,20,16
67,MAD,P003108,PCVM,0 days 00:11:33,-6,15,21
67,MAD,P003108,P005791,0 days 00:10:22,-1,17,18
67,MAD,P003108,P005928,0 days 00:10:19,2,19,17
67,MAD,P005791,PTGB,0 days 00:10:13,1,18,17
67,MAD,P003108,P004887,0 days 00:10:06,-6,14,20
67,MAD,P005928,PTGB,0 days 00:09:26,5,20,15
67,MAD,P001392,P005791,0 days 00:08:57,6,17,11
67,MAD,P001392,P005928,0 days 00:08:57,6,17,11
67,MAD,P009005,P010357,0 days 00:08:36,-2,21,23
67,MAD,P006540,P010357,0 days 00:08:23,0,21,21
67,MAD,P001392,P009005,0 days 00:08:20,8,17,9
67,MAD,P001392,P006540,0 days 00:08:20,8,17,9
67,MAD,P010357,PTGB,0 days 00:08:03,3,14,11
67,MAD,P003108,P010357,0 days 00:07:41,-2,10,12
67,MAD,P010357,PCVM,0 days 00:06:51,2,10,8
67,MAD,P003108,PBMT,0 days 00:06:43,-4,12,16
67,MAD,P004887,PCVM,0 days 00:06:36,-7,8,15
67,MAD,P003108,P009005,0 days 00:06:17,-3,9,12
67,MAD,P004887,PBMT,0 days 00:05:49,-2,11,13
67,MAD,P003733,P004887,0 days 00:05:46,-10,5,15
67,MAD,P003108,P003733,0 days 00:05:46,-10,5,15
67,MAD,P005928,PBMT,0 days 00:05:45,4,14,10
67,MAD,PBMT,PTGB,0 days 00:05:14,4,14,10
67,MAD,PCVM,PTGB,0 days 00:05:14,1,7,6
67,MAD,P005791,PCVM,0 days 00:04:57,1,7,6
67,MAD,P003733,PCVM,0 days 00:04:42,-8,5,13
67,MAD,P004887,PTGB,0 days 00:04:27,5,9,4
67,MAD,P003733,PBMT,0 days 00:04:18,-6,5,11
67,MAD,P009005,PTGB,0 days 00:04:12,1,6,5
67,MAD,P004887,P005928,0 days 00:04:01,4,9,5
67,MAD,PBMT,PCVM,0 days 00:03:47,-6,5,11
67,MAD,P005791,PBMT,0 days 00:03:43,0,8,8
67,MAD,P004887,P009005,0 days 00:03:07,-4,3,7
67,MAD,P004887,P010357,0 days 00:02:51,0,6,6
67,MAD,P010357,PBMT,0 days 00:02:49,2,7,5
67,MAD,P005928,PCVM,0 days 00:01:37,1,3,2
67,MAD,P003733,P009005,0 days 00:01:28,-4,0,4
67,MAD,P009005,PCVM,0 days 00:00:55,-2,0,2
67,MAD,P003733,P005928,0 days 00:00:51,0,0,0
67,MAD,P003108,P006540,0 days 00:00:37,0,3,3
67,MAD,P004887,P006540,0 days 00:00:37,0,3,3
67,MAD,P001392,P003108,0 days 00:00:37,-2,0,2
67,MAD,P001392,P010357,0 days 00:00:37,-2,0,2
67,MAD,P003733,P010357,0 days 00:00:13,-2,0,2
68,VIR,P001844,P003048,0 days 00:20:27,-13,44,57
68,VIR,P001133,P001844,0 days 00:20:11,-9,45,54
68,VIR,P001133,P003048,0 days 00:19:41,-15,38,53
68,VIR,P001133,P009549,0 days 00:19:22,-5,44,49
68,VIR,P003527,P004007,0 days 00:17:56,19,39,20
68,VIR,P001133,PBCN,0 days 00:16:38,-5,38,43
68,VIR,P003048,P009549,0 days 00:16:18,-12,32,44
68,VIR,P003048,PBCN,0 days 00:15:18,-10,33,43
68,VIR,P001844,PBCN,0 days 00:14:45,-6,36,42
68,VIR,P001844,P009549,0 days 00:14:28,-13,30,43
68,VIR,P009549,PBCN,0 days 00:14:18,-7,30,37
68,VIR,P003527,P010781,0 days 00:12:52,16,31,15
68,VIR,P004007,P010781,0 days 00:10:32,11,26,15
68,VIR,P001133,P004007,0 days 00:10:27,10,26,16
68,VIR,P001133,P003527,0 days 00:10:07,18,26,8
68,VIR,P001844,P010781,0 days 00:10:05,2,23,21
68,VIR,P001133,P010781,0 days 00:09:05,9,27,18
68,VIR,P003527,P006739,0 days 00:08:52,6,17,11
68,VIR,P003527,P011192,0 days 00:08:46,8,16,8
68,VIR,P004007,P011192,0 days 00:08:13,10,15,5
68,VIR,P001844,P004007,0 days 00:08:12,-1,17,18
68,VIR,P001844,P003527,0 days 00:07:49,7,17,10
68,VIR,P003048,P004007,0 days 00:07:46,2,15,13
68,VIR,P006739,P011192,0 days 00:07:32,6,14,8
68,VIR,P003048,P010781,0 days 00:07:31,0,16,16
68,VIR,P004007,P006739,0 days 00:07:24,8,13,5
68,VIR,P003527,P012714,0 days 00:06:56,-1,12,13
68,VIR,P004007,P009549,0 days 00:06:26,4,17,13
68,VIR,P003048,P003527,0 days 00:06:06,5,10,5
68,VIR,P004007,P012714,0 days 00:05:28,1,8,7
68,VIR,P001133,P006739,0 days 00:05:08,5,7,2
68,VIR,P006739,P012714,0 days 00:05:08,2,12,10
68,VIR,P003527,P009549,0 days 00:05:05,7,16,9
68,VIR,P011192,P012714,0 days 00:04:13,2,9,7
68,VIR,P009549,P010781,0 days 00:04:07,5,12,7
68,VIR,P010781,PBCN,0 days 00:03:18,2,11,9
68,VIR,P006739,P009549,0 days 00:03:06,1,6,5
68,VIR,P006739,PBCN,0 days 00:02:57,-1,5,6
68,VIR,P001133,P011192,0 days 00:02:53,4,5,1
68,VIR,P003048,P006739,0 days 00:02:41,1,2,1
68,VIR,P003527,PBCN,0 days 00:02:27,3,8,5
68,VIR,P009549,P012714,0 days 00:02:01,0,4,4
68,VIR,P010781,P012714,0 days 00:01:48,-3,0,3
68,VIR,P003048,P011192,0 days 00:01:40,2,2,0
68,VIR,P010781,P011192,0 days 00:01:14,2,2,0
68,VIR,P012714,PBCN,0 days 00:01:07,-2,3,5
68,VIR,P001844,P012714,0 days 00:01:03,-3,0,3
68,VIR,P009549,P011192,0 days 00:00:21,0,1,1
68,VIR,P011192,PBCN,0 days 00:00:12,-2,0,2
68,MIL,P007032,P007831,0 days 00:28:58,4,68,64
68,MIL,P000796,P007032,0 days 00:27:07,5,63,58
68,MIL,P000796,P007831,0 days 00:27:07,6,63,57
68,MIL,P002849,P007831,0 days 00:24:11,9,63,54
68,MIL,P000796,P002849,0 days 00:23:11,6,58,52
68,MIL,P002849,P007032,0 days 00:22:46,6,58,52
68,MIL,P007032,P007201,0 days 00:20:36,5,50,45
68,MIL,P007201,P007831,0 days 00:19:45,7,50,43
68,MIL,P000796,P007201,0 days 00:17:26,9,45,36
68,MIL,P002849,P007201,0 days 00:15:36,11,45,34
68,MIL,P002812,P005670,0 days 00:09:40,-8,11,19
68,MIL,P002812,P011205,0 days 00:08:11,-8,7,15
68,MIL,P002812,P006509,0 days 00:07:41,-10,5,15
68,MIL,P002812,P007831,0 days 00:07:23,1,14,13
68,MIL,P005670,P011205,0 days 00:07:17,-6,7,13
68,MIL,P001518,P002812,0 days 00:07:13,-8,6,14
68,MIL,P001518,P005670,0 days 00:07:10,-8,6,14
68,MIL,P000796,P002812,0 days 00:06:56,-1,12,13
68,MIL,P006509,P007032,0 days 00:06:52,-9,10,19
68,MIL,P005670,P006509,0 days 00:06:50,-8,5,13
68,MIL,P001518,P006509,0 days 00:06:13,-6,5,11
68,MIL,P006509,P011205,0 days 00:06:00,-9,1,10
68,MIL,P007831,P011205,0 days 00:05:47,-2,11,13
68,MIL,P000796,P006509,0 days 00:05:40,-7,9,16
68,MIL,P006509,P007831,0 days 00:05:33,-6,10,16
68,MIL,P002812,P007032,0 days 00:05:21,-1,8,9
68,MIL,P001518,P011205,0 days 00:05:15,-6,2,8
68,MIL,P002849,P011205,0 days 00:04:53,-1,10,11
68,MIL,P006509,P009960,0 days 00:04:50,-1,10,11
68,MIL,P007032,P009960,0 days 00:04:50,-1,10,11
68,MIL,P007831,P009960,0 days 00:04:39,-1,10,11
68,MIL,P007032,P011205,0 days 00:04:27,-5,5,10
68,MIL,P002812,P002849,0 days 00:04:22,5,13,8
68,MIL,P006509,P007201,0 days 00:03:58,-6,5,11
68,MIL,P000796,P011205,0 days 00:03:39,-3,5,8
68,MIL,P002812,P007201,0 days 00:03:29,-6,0,6
68,MIL,P005670,P007831,0 days 00:02:50,0,6,6
68,MIL,P000796,P009960,0 days 00:02:31,1,5,4
68,MIL,P000796,P005670,0 days 00:02:23,-2,4,6
68,MIL,P007201,P009960,0 days 00:02:19,-2,5,7
68,MIL,P000796,P001518,0 days 00:02:12,-2,4,6
68,MIL,P002849,P005670,0 days 00:01:42,2,5,3
68,MIL,P007201,P011205,0 days 00:01:39,-4,0,4
68,MIL,P001518,P007831,0 days 00:01:11,-2,1,3
68,MIL,P002849,P006509,0 days 00:01:11,-6,0,6
68,MIL,P005670,P007201,0 days 00:00:48,-2,0,2
68,MIL,P001518,P007032,0 days 00:00:11,0,0,0
68,MIL,P001518,P009960,0 days 00:00:11,0,0,0
69,BER,P003958,P012720,0 days 00:23:59,1,45,44
69,BER,P003958,P006919,0 days 00:20:25,8,41,33
69,BER,P006919,P012720,0 days 00:20:22,8,41,33
69,BER,P003958,P008211,0 days 00:15:40,7,30,23
69,BER,P008211,P012720,0 days 00:13:51,8,27,19
69,BER,P008384,P008967,0 days 00:13:46,-6,18,24
69,BER,P003958,P011934,0 days 00:13:23,1,27,26
69,BER,P006251,P008967,0 days 00:13:08,-8,17,25
69,BER,P006251,P008384,0 days 00:13:02,-4,18,22
69,BER,P006919,P008211,0 days 00:11:58,17,25,8
69,BER,P011934,P012720,0 days 00:11:31,2,24,22
69,BER,P003958,P008173,0 days 00:10:05,-5,18,23
69,BER,P008173,P012720,0 days 00:10:02,-5,18,23
69,BER,P008211,P011934,0 days 00:09:40,0,17,17
69,BER,P006919,P008173,0 days 00:09:30,-8,18,26
69,BER,P006919,P011934,0 days 00:09:14,11,22,11
69,BER,P008173,P010791,0 days 00:08:17,-5,12,17
69,BER,P008384,P012721,0 days 00:07:56,6,14,8
69,BER,P008173,P008384,0 days 00:07:41,-6,8,14
69,BER,P008173,P011934,0 days 00:07:36,-11,12,23
69,BER,P006251,P008211,0 days 00:07:25,4,13,9
69,BER,P008967,P011934,0 days 00:07:07,-19,7,26
69,BER,P008173,P008967,0 days 00:07:03,-9,8,17
69,BER,P006251,P008173,0 days 00:07:03,-9,8,17
69,BER,P006919,P010791,0 days 00:07:01,-7,10,17
69,BER,P008384,P011934,0 days 00:06:40,-16,5,21
69,BER,P006251,P012721,0 days 00:06:39,4,12,8
69,BER,P006251,P006919,0 days 00:06:24,2,13,11
69,BER,P006251,P012720,0 days 00:06:22,4,14,10
69,BER,P010791,P012720,0 days 00:05:54,-6,8,14
69,BER,P003958,P010791,0 days 00:05:54,-6,8,14
69,BER,P008967,P012721,0 days 00:05:34,3,9,6
69,BER,P008211,P008967,0 days 00:05:26,-8,7,15
69,BER,P003958,P006251,0 days 00:05:17,3,11,8
69,BER,P007550,P008384,0 days 00:04:56,5,10,5
69,BER,P007550,P012721,0 days 00:04:56,5,10,5
69,BER,P006251,P007550,0 days 00:04:54,5,10,5
69,BER,P008211,P008384,0 days 00:04:29,-5,5,10
69,BER,P003958,P008384,0 days 00:04:04,-2,5,7
69,BER,P006251,P011934,0 days 00:03:53,-12,2,14
69,BER,P007550,P008967,0 days 00:03:49,4,7,3
69,BER,P008967,P010791,0 days 00:03:37,3,6,3
69,BER,P006251,P010791,0 days 00:03:37,3,6,3
69,BER,P003958,P008967,0 days 00:03:18,-9,5,14
69,BER,P008384,P012720,0 days 00:03:17,0,5,5
69,BER,P008384,P010791,0 days 00:02:30,4,4,0
69,BER,P012720,P012721,0 days 00:02:22,3,5,2
69,BER,P008211,P012721,0 days 00:01:45,-1,2,3
69,BER,P008967,P012720,0 days 00:01:29,-8,2,10
69,BER,P003958,P012721,0 days 00:01:17,2,2,0
69,BER,P008173,P012721,0 days 00:01:15,2,2,0
69,BER,P008211,P010791,0 days 00:01:14,2,2,0
69,BER,P006919,P008967,0 days 00:01:11,-3,2,5
69,BER,P007550,P012720,0 days 00:01:07,1,3,2
69,BER,P006919,P008384,0 days 00:00:03,0,0,0
69,BER,P003958,P007550,0 days 00:00:02,0,0,0
69,ASV,P011225,P012080,0 days 00:24:48,9,46,37
69,ASV,P004194,P012080,0 days 00:24:09,-1,45,46
69,ASV,P006568,P012080,0 days 00:24:09,13,50,37
69,ASV,P006568,P011225,0 days 00:22:14,17,47,30
69,ASV,P004194,P011225,0 days 00:21:24,-4,34,38
69,ASV,P004194,P006568,0 days 00:20:39,0,38,38
69,ASV,P003526,P012080,0 days 00:19:06,5,40,35
69,ASV,P003526,P004194,0 days 00:18:09,6,39,33
69,ASV,P012080,P012729,0 days 00:15:31,10,33,23
69,ASV,P003526,P011225,0 days 00:14:42,0,25,25
69,ASV,P003526,P006568,0 days 00:14:01,3,29,26
69,ASV,P011225,P012729,0 days 00:13:38,4,23,19
69,ASV,P011225,PKIR,0 days 00:13:20,10,26,16
69,ASV,P012080,PKIR,0 days 00:13:03,9,26,17
69,ASV,P006568,PKIR,0 days 00:12:00,12,26,14
69,ASV,P002100,P012729,0 days 00:11:42,-10,14,24
69,ASV,P002100,P012080,0 days 00:11:39,-7,20,27
69,ASV,P002100,P004194,0 days 00:10:04,-1,21,22
69,ASV,P012729,PKIR,0 days 00:09:37,12,22,10
69,ASV,P002100,P003526,0 days 00:09:05,-3,17,20
69,ASV,P004194,PKIR,0 days 00:08:17,-3,11,14
69,ASV,P002100,P011225,0 days 00:08:10,-7,9,16
69,ASV,P003526,P012729,0 days 00:07:35,-1,13,14
69,ASV,P002100,P012730,0 days 00:07:17,-9,6,15
69,ASV,P012729,P012730,0 days 00:07:17,-9,6,15
69,ASV,P004194,P012729,0 days 00:06:42,-1,12,13
69,ASV,P002100,PKIR,0 days 00:05:48,-3,8,11
69,ASV,P002100,P006568,0 days 00:05:39,0,13,13
69,ASV,P006568,P012729,0 days 00:05:22,15,17,2
69,ASV,P012080,P012730,0 days 00:04:47,-6,4,10
69,ASV,P011225,P012730,0 days 00:03:44,-5,2,7
69,ASV,P003526,P012730,0 days 00:03:27,-4,3,7
69,ASV,P012730,PKIR,0 days 00:02:36,-3,3,6
69,ASV,P003526,PKIR,0 days 00:00:19,2,2,0
70,MUN,P007056,P011987,0 days 00:19:47,-5,42,47
70,MUN,P007975,P010391,0 days 00:19:46,-10,39,49
70,MUN,P007056,P007975,0 days 00:19:13,-7,52,59
70,MUN,P001557,P007056,0 days 00:18:47,13,47,34
70,MUN,P008985,P011987,0 days 00:16:03,17,38,21
70,MUN,P003583,P007056,0 days 00:15:58,-3,30,33
70,MUN,P007056,P010391,0 days 00:15:26,-7,37,44
70,MUN,P003583,P011987,0 days 00:14:57,1,30,29
70,MUN,P007975,P011987,0 days 00:14:44,-8,41,49
70,MUN,P001557,P003583,0 days 00:13:59,3,30,27
70,MUN,P001557,P011987,0 days 00:13:11,6,30,24
70,MUN,P001557,P008985,0 days 00:12:43,17,29,12
70,MUN,P010391,P011941,0 days 00:12:22,5,28,23
70,MUN,P007056,P008985,0 days 00:12:19,15,27,12
70,MUN,P001557,P007975,0 days 00:11:45,4,32,28
70,MUN,P007975,P011941,0 days 00:11:18,-1,27,28
70,MUN,P010391,P011987,0 days 00:10:51,-2,25,27
70,MUN,P005478,P011941,0 days 00:10:00,7,23,16
70,MUN,P011941,P011987,0 days 00:09:31,9,33,24
70,MUN,P003583,P008985,0 days 00:09:11,7,15,8
70,MUN,P001557,P010391,0 days 00:08:24,6,19,13
70,MUN,P005478,P010391,0 days 00:08:08,7,15,8
70,MUN,P005478,P007975,0 days 00:07:48,-1,14,15
70,MUN,P005478,P011987,0 days 00:07:30,12,25,13
70,MUN,P005478,P008985,0 days 00:07:16,12,25,13
70,MUN,P008985,P010391,0 days 00:06:56,18,25,7
70,MUN,P003583,P007975,0 days 00:06:47,-10,15,25
70,MUN,P007975,P008985,0 days 00:06:36,10,24,14
70,MUN,P008985,P011941,0 days 00:05:40,10,21,11
70,MUN,P007639,P007975,0 days 00:05:35,-4,12,16
70,MUN,P007639,P010391,0 days 00:04:51,-2,12,14
70,MUN,P007056,P011941,0 days 00:04:40,0,15,15
70,MUN,P007975,P012123,0 days 00:04:32,-5,8,13
70,MUN,P010391,P012123,0 days 00:04:32,-5,8,13
70,MUN,P007056,P007639,0 days 00:04:25,-4,10,14
70,MUN,P001557,P011941,0 days 00:03:38,1,5,4
70,MUN,P007056,P012123,0 days 00:03:01,-2,8,10
70,MUN,P007639,P012123,0 days 00:03:01,-2,8,10
70,MUN,P003583,P010391,0 days 00:03:00,-10,0,10
70,MUN,P001557,P005478,0 days 00:02:35,0,2,2
70,MUN,P007639,P011987,0 days 00:02:34,-2,4,6
70,MUN,P005478,P007639,0 days 00:01:36,2,4,2
70,MUN,P007639,P008985,0 days 00:01:36,2,4,2
70,MUN,P005478,P012123,0 days 00:01:31,-3,0,3
70,MUN,P011941,P012123,0 days 00:01:31,-3,0,3
70,MUN,P001557,P007639,0 days 00:00:26,2,2,0
70,PAR,P007400,P008987,0 days 00:30:05,-6,60,66
70,PAR,P007400,P007673,0 days 00:22:58,-8,53,61
70,PAR,P007673,P008987,0 days 00:22:45,-10,53,63
70,PAR,P008987,P012096,0 days 00:16:28,-6,30,36
70,PAR,P007400,P012096,0 days 00:15:19,-4,25,29
70,PAR,P008987,P012742,0 days 00:15:16,2,35,33
70,PAR,P012096,P012742,0 days 00:15:14,-2,34,36
70,PAR,P008987,P012743,0 days 00:14:52,0,33,33
70,PAR,P007400,P012743,0 days 00:13:58,1,35,34
70,PAR,P007673,P012743,0 days 00:13:58,1,35,34
70,PAR,P004058,P008987,0 days 00:13:17,3,30,27
70,PAR,P004058,P012743,0 days 00:13:17,3,30,27
70,PAR,P007400,P012742,0 days 00:13:13,5,32,27
70,PAR,P003983,P008987,0 days 00:11:37,-3,27,30
70,PAR,P004058,P007673,0 days 00:11:01,4,27,23
70,PAR,P004058,P007400,0 days 00:11:01,4,27,23
70,PAR,P007673,P012742,0 days 00:10:17,-3,27,30
70,PAR,P000956,P007400,0 days 00:09:45,1,14,13
70,PAR,P000956,P012096,0 days 00:09:45,1,14,13
70,PAR,P000956,P008987,0 days 00:09:45,1,14,13
70,PAR,P007673,P012096,0 days 00:08:56,-8,18,26
70,PAR,P003983,P007400,0 days 00:08:43,-4,16,20
70,PAR,P003983,P012096,0 days 00:08:00,-2,17,19
70,PAR,P007673,P011051,0 days 00:07:57,3,22,19
70,PAR,P003983,P007673,0 days 00:07:41,-3,21,24
70,PAR,P007400,P011051,0 days 00:07:00,3,22,19
70,PAR,P000956,P012742,0 days 00:06:18,5,12,7
70,PAR,P011051,P012742,0 days 00:05:54,-1,15,16
70,PAR,P004172,P012742,0 days 00:03:54,-7,3,10
70,PAR,P008987,P011051,0 days 00:03:53,0,11,11
70,PAR,P012742,P012743,0 days 00:03:38,-1,8,9
70,PAR,P000956,P003983,0 days 00:03:27,-4,2,6
70,PAR,P011051,P012096,0 days 00:03:23,-3,6,9
70,PAR,P003983,P012742,0 days 00:03:23,5,15,10
70,PAR,P004172,P008987,0 days 00:03:02,-5,3,8
70,PAR,P004172,P012743,0 days 00:03:00,-5,3,8
70,PAR,P004058,P012742,0 days 00:02:57,-7,3,10
70,PAR,P004058,P004172,0 days 00:02:57,-7,3,10
70,PAR,P003983,P011051,0 days 00:02:44,-2,7,9
70,PAR,P004172,P007673,0 days 00:01:43,-4,0,4
70,PAR,P004172,P011051,0 days 00:01:38,-6,0,6
70,PAR,P004172,P012096,0 days 00:01:38,-6,0,6
70,PAR,P011051,P012743,0 days 00:01:22,0,5,5
70,PAR,P003983,P012743,0 days 00:00:51,1,3,2
70,PAR,P004172,P007400,0 days 00:00:46,-4,0,4
70,PAR,P004058,P011051,0 days 00:00:41,-6,0,6
70,PAR,P004058,P012096,0 days 00:00:41,-6,0,6
70,PAR,P003983,P004172,0 days 00:00:02,0,0,0
71,PAN,P002328,P007866,0 days 00:33:07,4,60,56
71,PAN,P003842,P007866,0 days 00:29:53,7,59,52
71,PAN,P007866,P011204,0 days 00:28:29,8,52,44
71,PAN,P002328,P003842,0 days 00:28:02,10,58,48
71,PAN,P001926,P002328,0 days 00:27:59,10,59,49
71,PAN,P001926,P007866,0 days 00:27:22,2,52,50
71,PAN,P002328,P011204,0 days 00:27:08,12,52,40
71,PAN,P003842,P011204,0 days 00:25:18,10,52,42
71,PAN,P001926,P011204,0 days 00:23:28,10,46,36
71,PAN,P001926,P003842,0 days 00:22:17,8,50,42
71,PAN,P007866,P007947,0 days 00:13:10,-10,17,27
71,PAN,P002328,P007947,0 days 00:11:34,-4,18,22
71,PAN,P003842,P007947,0 days 00:08:12,-3,10,13
71,PAN,P007553,P007947,0 days 00:06:56,-3,14,17
71,PAN,P007866,P012774,0 days 00:05:50,-4,8,12
71,PAN,P001926,P007947,0 days 00:05:41,-2,13,15
71,PAN,P007947,P012774,0 days 00:05:39,-2,8,10
71,PAN,P007947,P008084,0 days 00:05:32,2,13,11
71,PAN,P007553,P008084,0 days 00:05:02,1,12,11
71,PAN,P007553,P007866,0 days 00:04:58,-7,7,14
71,PAN,P002328,P007553,0 days 00:03:52,0,9,9
71,PAN,P001926,P007553,0 days 00:03:52,0,9,9
71,PAN,P007947,P011204,0 days 00:03:48,-2,3,5
71,PAN,P008084,P012774,0 days 00:03:34,-2,6,8
71,PAN,P007866,P008084,0 days 00:03:34,-2,6,8
71,PAN,P007866,P011221,0 days 00:03:11,-2,0,2
71,PAN,P002328,P011221,0 days 00:03:11,-2,0,2
71,PAN,P001926,P011221,0 days 00:03:11,-2,0,2
71,PAN,P011204,P011221,0 days 00:03:11,-2,0,2
71,PAN,P007553,P012774,0 days 00:03:04,-3,5,8
71,PAN,P003842,P012774,0 days 00:02:46,-1,3,4
71,PAN,P002328,P012774,0 days 00:02:16,-2,2,4
71,PAN,P001926,P008084,0 days 00:01:58,4,7,3
71,PAN,P002328,P008084,0 days 00:01:58,4,7,3
71,PAN,P007866,P011826,0 days 00:01:21,-4,0,4
71,PAN,P011204,P011826,0 days 00:01:21,-4,0,4
71,PAN,P001926,P011826,0 days 00:01:21,-4,0,4
71,PAN,P003842,P011826,0 days 00:01:21,-4,0,4
71,PAN,P002328,P011209,0 days 00:01:13,0,3,3
71,PAN,P003842,P011209,0 days 00:01:13,0,3,3
71,PAN,P007866,P011209,0 days 00:01:13,0,3,3
71,PAN,P011204,P011209,0 days 00:01:13,0,3,3
71,PAN,P003842,P008084,0 days 00:00:30,1,1,0
71,PAN,P001926,P012774,0 days 00:00:11,-2,0,2
71,ZAL,P002676,P011218,0 days 00:27:09,-9,46,55
71,ZAL,P002329,P011218,0 days 00:21:09,2,41,39
71,ZAL,P002329,P002676,0 days 00:20:00,0,38,38
71,ZAL,P002676,P003211,0 days 00:19:41,-2,36,38
71,ZAL,P002676,P007109,0 days 00:16:52,-5,27,32
71,ZAL,P010390,P011218,0 days 00:16:40,-7,24,31
71,ZAL,P002676,P010390,0 days 00:16:38,-8,23,31
71,ZAL,P007109,P011218,0 days 00:16:11,-1,28,29
71,ZAL,P002329,P010390,0 days 00:15:41,0,25,25
71,ZAL,P003211,P011218,0 days 00:14:50,-2,27,29
71,ZAL,P002676,P012715,0 days 00:14:19,1,29,28
71,ZAL,P011218,P012715,0 days 00:14:18,0,27,27
71,ZAL,P003211,P012715,0 days 00:12:34,1,24,23
71,ZAL,P002329,P003211,0 days 00:12:25,3,25,22
71,ZAL,P002329,P007109,0 days 00:11:42,2,19,17
71,ZAL,P002329,P012715,0 days 00:11:06,3,24,21
71,ZAL,P007109,P010390,0 days 00:10:19,-1,16,17
71,ZAL,P002676,P005504,0 days 00:10:06,-1,18,19
71,ZAL,P003211,P007109,0 days 00:09:37,2,17,15
71,ZAL,P003211,P010390,0 days 00:09:08,-7,11,18
71,ZAL,P005504,P011218,0 days 00:08:57,-1,18,19
71,ZAL,P003211,P011965,0 days 00:08:35,4,17,13
71,ZAL,P003211,P005504,0 days 00:07:54,1,11,10
71,ZAL,P002329,P005504,0 days 00:06:56,1,14,13
71,ZAL,P005504,P012715,0 days 00:05:57,1,10,9
71,ZAL,P005504,P007109,0 days 00:05:49,-4,9,13
71,ZAL,P010390,P012715,0 days 00:05:35,-4,7,11
71,ZAL,P002676,P011965,0 days 00:05:22,6,15,9
71,ZAL,P011965,P012715,0 days 00:05:06,6,13,7
71,ZAL,P003210,P011218,0 days 00:04:59,-1,10,11
71,ZAL,P002329,P011965,0 days 00:04:55,0,8,8
71,ZAL,P005504,P011965,0 days 00:04:40,0,6,6
71,ZAL,P007109,P012715,0 days 00:04:11,3,8,5
71,ZAL,P003210,P005504,0 days 00:04:09,-1,10,11
71,ZAL,P007109,P011965,0 days 00:03:44,-2,4,6
71,ZAL,P003210,P012715,0 days 00:02:58,1,6,5
71,ZAL,P002329,P003210,0 days 00:02:58,1,6,5
71,ZAL,P003210,P007109,0 days 00:02:51,-2,4,6
71,ZAL,P002676,P003210,0 days 00:02:01,-2,4,6
71,ZAL,P010390,P011965,0 days 00:01:35,-1,2,3
71,ZAL,P011218,P011965,0 days 00:00:23,3,3,0
72,BAS,P003198,P009048,0 days 00:24:05,20,61,41
72,BAS,P007230,P009048,0 days 00:21:13,10,48,38
72,BAS,P007230,P010444,0 days 00:20:18,20,51,31
72,BAS,P009048,P011948,0 days 00:19:56,18,53,35
72,BAS,P003198,P011948,0 days 00:19:34,13,50,37
72,BAS,P007230,P011948,0 days 00:19:06,21,50,29
72,BAS,P003198,P007230,0 days 00:18:38,12,42,30
72,BAS,P009048,P010444,0 days 00:17:58,13,44,31
72,BAS,P010444,P011948,0 days 00:17:16,16,46,30
72,BAS,P012201,P012765,0 days 00:15:50,3,34,31
72,BAS,P003198,P010444,0 days 00:15:46,7,36,29
72,BAS,P007230,P012201,0 days 00:14:49,12,34,22
72,BAS,P003198,P012201,0 days 00:13:47,7,32,25
72,BAS,P004603,P012201,0 days 00:13:13,4,32,28
72,BAS,P009048,P012201,0 days 00:12:52,12,34,22
72,BAS,P003198,P004603,0 days 00:10:45,12,28,16
72,BAS,P011948,P012201,0 days 00:10:38,14,30,16
72,BAS,P004603,P012765,0 days 00:10:18,0,22,22
72,BAS,P004603,P009048,0 days 00:09:55,7,25,18
72,BAS,P007230,P012765,0 days 00:09:30,4,21,17
72,BAS,P010444,P012201,0 days 00:09:29,15,24,9
72,BAS,P004603,P007230,0 days 00:09:02,-2,16,18
72,BAS,P003198,P012765,0 days 00:07:33,1,15,14
72,BAS,P004603,P011948,0 days 00:07:23,8,19,11
72,BAS,P008850,P012201,0 days 00:07:01,-3,13,16
72,BAS,P007230,P008850,0 days 00:06:14,1,12,11
72,BAS,P008850,P012765,0 days 00:06:11,-5,11,16
72,BAS,P004603,P008850,0 days 00:05:24,-1,10,11
72,BAS,P011948,P012765,0 days 00:04:43,6,12,6
72,BAS,P009048,P012765,0 days 00:03:43,0,9,9
72,BAS,P010444,P012765,0 days 00:03:15,7,9,2
72,BAS,P003198,P008850,0 days 00:02:47,-8,1,9
72,BAS,P003198,P008072,0 days 00:02:17,-4,3,7
72,BAS,P008072,P012201,0 days 00:02:17,-4,3,7
72,BAS,P008072,P012765,0 days 00:02:17,-4,3,7
72,BAS,P008850,P009048,0 days 00:01:50,0,2,2
72,BAS,P008072,P008850,0 days 00:01:47,-6,1,7
72,BAS,P008850,P010444,0 days 00:00:50,2,2,0
72,BAS,P007230,P008072,0 days 00:00:30,2,2,0
72,BAR,P002939,P006435,0 days 00:17:22,-7,34,41
72,BAR,P000925,P002939,0 days 00:16:12,-15,28,43
72,BAR,P003196,P007464,0 days 00:15:02,-17,22,39
72,BAR,P004866,P006435,0 days 00:14:48,-16,26,42
72,BAR,P000925,P006435,0 days 00:14:39,-11,26,37
72,BAR,P002939,P011244,0 days 00:14:06,-21,19,40
72,BAR,P007464,P007519,0 days 00:13:52,-10,24,34
72,BAR,P002939,P004866,0 days 00:13:50,-17,24,41
72,BAR,P003196,P007519,0 days 00:13:30,-14,20,34
72,BAR,P003196,P004866,0 days 00:11:59,-8,20,28
72,BAR,P007464,P009992,0 days 00:11:57,-6,21,27
72,BAR,P000925,P011244,0 days 00:10:51,-19,16,35
72,BAR,P003196,P012745,0 days 00:10:24,-4,18,22
72,BAR,P000925,P004866,0 days 00:10:24,-15,17,32
72,BAR,P003478,P012745,0 days 00:10:07,5,21,16
72,BAR,P006435,P011244,0 days 00:09:18,-15,14,29
72,BAR,P004866,P011244,0 days 00:09:18,-15,14,29
72,BAR,P003196,P003478,0 days 00:08:38,-5,15,20
72,BAR,P004866,P007519,0 days 00:08:33,-6,13,19
72,BAR,P006435,P012745,0 days 00:08:17,7,20,13
72,BAR,P002939,P012745,0 days 00:08:04,8,20,12
72,BAR,P004866,P007464,0 days 00:07:47,-6,15,21
72,BAR,P003478,P007519,0 days 00:07:45,-11,9,20
72,BAR,P007519,P012745,0 days 00:07:41,-8,10,18
72,BAR,P009992,P011244,0 days 00:07:32,-2,12,14
72,BAR,P007464,P011244,0 days 00:07:32,-2,12,14
72,BAR,P003196,P009992,0 days 00:06:43,-7,9,16
72,BAR,P002939,P003196,0 days 00:06:37,1,13,12
72,BAR,P002939,P009992,0 days 00:06:24,-6,10,16
72,BAR,P002939,P007464,0 days 00:06:24,-6,10,16
72,BAR,P004866,P012745,0 days 00:05:40,-2,8,10
72,BAR,P003478,P007464,0 days 00:05:36,-12,6,18
72,BAR,P007519,P009992,0 days 00:05:33,0,11,11
72,BAR,P000925,P012745,0 days 00:05:21,4,12,8
72,BAR,P007464,P012745,0 days 00:05:19,-8,7,15
72,BAR,P003196,P006435,0 days 00:05:17,5,15,10
72,BAR,P003478,P006435,0 days 00:05:08,10,15,5
72,BAR,P002939,P003478,0 days 00:05:08,10,15,5
72,BAR,P003478,P004866,0 days 00:04:55,-5,6,11
72,BAR,P000925,P003478,0 days 00:04:15,4,9,5
72,BAR,P007464,P010641,0 days 00:03:41,5,10,5
72,BAR,P010641,P011244,0 days 00:03:41,5,10,5
72,BAR,P009992,P010641,0 days 00:03:41,5,10,5
72,BAR,P007519,P011244,0 days 00:02:44,4,7,3
72,BAR,P007519,P010641,0 days 00:02:44,4,7,3
72,BAR,P006435,P007519,0 days 00:02:34,1,7,6
72,BAR,P006435,P007464,0 days 00:02:21,2,7,5
72,BAR,P003196,P011244,0 days 00:02:18,-3,0,3
72,BAR,P004866,P009992,0 days 00:02:18,-2,5,7
72,BAR,P009992,P012745,0 days 00:02:07,-2,4,6
72,BAR,P000925,P007464,0 days 00:01:33,-4,2,6
72,BAR,P000925,P009992,0 days 00:01:33,-4,2,6
72,BAR,P002939,P010641,0 days 00:00:57,1,3,2
73,MIL,P002849,P007831,0 days 00:28:34,17,73,56
73,MIL,P000796,P007831,0 days 00:20:45,5,50,45
73,MIL,P007032,P007831,0 days 00:20:02,0,46,46
73,MIL,P000796,P007032,0 days 00:19:26,-8,39,47
73,MIL,P006509,P011205,0 days 00:19:20,14,41,27
73,MIL,P000796,P002849,0 days 00:17:49,3,43,40
73,MIL,P006509,P009960,0 days 00:17:32,14,40,26
73,MIL,P002849,P007032,0 days 00:17:06,-2,39,41
73,MIL,P000796,P007201,0 days 00:15:48,-6,31,37
73,MIL,P009960,P011205,0 days 00:15:31,9,31,22
73,MIL,P007201,P007831,0 days 00:15:12,-3,31,34
73,MIL,P007032,P007201,0 days 00:15:12,-3,31,34
73,MIL,P002849,P006509,0 days 00:14:01,23,43,20
73,MIL,P006509,P007831,0 days 00:14:01,23,43,20
73,MIL,P002849,P007201,0 days 00:12:57,-6,24,30
73,MIL,P007831,P011205,0 days 00:12:45,16,35,19
73,MIL,P002849,P011205,0 days 00:12:04,17,35,18
73,MIL,P007831,P009960,0 days 00:11:57,13,30,17
73,MIL,P002849,P009960,0 days 00:11:16,14,30,16
73,MIL,P000796,P011205,0 days 00:09:30,3,22,19
73,MIL,P000796,P006509,0 days 00:08:22,6,21,15
73,MIL,P007032,P009960,0 days 00:06:07,-3,11,14
73,MIL,P001518,P006509,0 days 00:05:48,4,10,6
73,MIL,P001518,P011205,0 days 00:05:48,4,10,6
73,MIL,P006509,P007032,0 days 00:04:55,-2,11,13
73,MIL,P001518,P009960,0 days 00:04:41,4,8,4
73,MIL,P000796,P009960,0 days 00:04:35,-1,6,7
73,MIL,P007032,P011205,0 days 00:04:08,-7,8,15
73,MIL,P000796,P002812,0 days 00:03:58,0,9,9
73,MIL,P005670,P006509,0 days 00:03:08,2,4,2
73,MIL,P005670,P009960,0 days 00:03:08,2,4,2
73,MIL,P005670,P011205,0 days 00:02:59,2,4,2
73,MIL,P001518,P005670,0 days 00:02:59,2,4,2
73,MIL,P002812,P007201,0 days 00:02:51,0,7,7
73,MIL,P000796,P001518,0 days 00:02:24,4,6,2
73,MIL,P002812,P007032,0 days 00:02:15,3,7,4
73,MIL,P002812,P007831,0 days 00:02:15,3,7,4
73,MIL,P002812,P006509,0 days 00:01:43,-3,2,5
73,MIL,P002812,P011205,0 days 00:01:43,-3,2,5
73,MIL,P001518,P002812,0 days 00:01:07,0,2,2
73,MIL,P000796,P006701,0 days 00:00:38,2,5,3
73,MIL,P006509,P006701,0 days 00:00:38,2,5,3
73,MIL,P007201,P011205,0 days 00:00:36,-3,0,3
73,MIL,P006509,P007201,0 days 00:00:36,-3,0,3
73,MIL,P002849,P006701,0 days 00:00:29,2,5,3
73,MIL,P006701,P007831,0 days 00:00:29,2,5,3
73,MIL,P001518,P007032,0 days 00:00:25,-2,0,2
73,MIL,P000796,P005670,0 days 00:00:09,0,0,0
73,MIL,P005670,P006701,0 days 00:00:09,0,0,0
73,MIL,P006701,P009960,0 days 00:00:09,0,0,0
73,IST,P004888,P007200,0 days 00:30:25,-11,61,72
73,IST,P007200,P011078,0 days 00:30:23,-13,62,75
73,IST,P004888,P011078,0 days 00:29:38,-6,61,67
73,IST,P009664,P011078,0 days 00:26:46,-12,50,62
73,IST,P007200,P009664,0 days 00:26:42,-14,48,62
73,IST,P004888,P009664,0 days 00:25:17,-13,44,57
73,IST,P004888,P011981,0 days 00:15:44,-2,38,40
73,IST,P007200,P011981,0 days 00:14:57,-5,34,39
73,IST,P004554,P007200,0 days 00:14:56,-4,27,31
73,IST,P011078,P011981,0 days 00:14:46,-4,32,36
73,IST,P004554,P011078,0 days 00:14:32,0,29,29
73,IST,P004888,P006590,0 days 00:13:33,1,27,26
73,IST,P004554,P009664,0 days 00:12:58,2,23,21
73,IST,P004554,P004888,0 days 00:12:54,0,22,22
73,IST,P006590,P007200,0 days 00:12:35,-9,23,32
73,IST,P006590,P011078,0 days 00:11:48,-4,23,27
73,IST,P009664,P011981,0 days 00:09:56,-7,21,28
73,IST,P006590,P011981,0 days 00:09:14,-2,19,21
73,IST,P006590,P009664,0 days 00:08:34,-11,6,17
73,IST,P004888,P012710,0 days 00:08:04,-3,14,17
73,IST,P006372,P007200,0 days 00:06:55,-8,12,20
73,IST,P006372,P011078,0 days 00:06:55,-8,12,20
73,IST,P006590,P012710,0 days 00:06:17,-1,12,13
73,IST,P007200,P012710,0 days 00:05:27,-4,9,13
73,IST,P011981,P012710,0 days 00:05:05,-1,12,13
73,IST,P004554,P006590,0 days 00:04:32,-1,8,9
73,IST,P011078,P012710,0 days 00:04:24,-1,7,8
73,IST,P006372,P009664,0 days 00:04:08,-1,8,9
73,IST,P004888,P006372,0 days 00:03:45,-6,5,11
73,IST,P004554,P006372,0 days 00:03:10,-2,7,9
73,IST,P009664,P012710,0 days 00:01:39,0,0,0
73,IST,P006372,P006590,0 days 00:01:27,-5,2,7
73,IST,P006372,P012710,0 days 00:01:20,-2,2,4
73,IST,P004554,P011981,0 days 00:01:14,-3,0,3
74,TEL,P009783,P009863,0 days 00:24:02,4,48,44
74,TEL,P009622,P009783,0 days 00:22:37,-5,40,45
74,TEL,P009622,P009863,0 days 00:21:02,5,48,43
74,TEL,P009863,P011214,0 days 00:20:26,12,47,35
74,TEL,P009863,P011219,0 days 00:14:21,5,29,24
74,TEL,P011214,P011219,0 days 00:14:03,9,34,25
74,TEL,P009622,P011214,0 days 00:13:50,3,33,30
74,TEL,P009783,P011214,0 days 00:13:33,6,28,22
74,TEL,P009622,P011199,0 days 00:13:30,-1,20,21
74,TEL,P009783,P011199,0 days 00:13:28,-5,20,25
74,TEL,P011193,P011971,0 days 00:13:09,-1,24,25
74,TEL,P009863,P011193,0 days 00:12:15,1,23,22
74,TEL,P011193,P011214,0 days 00:11:50,3,26,23
74,TEL,P011214,P011971,0 days 00:11:45,4,30,26
74,TEL,P011193,P011219,0 days 00:11:24,5,28,23
74,TEL,P009863,P011971,0 days 00:11:12,6,27,21
74,TEL,P009863,P011199,0 days 00:10:58,-2,20,22
74,TEL,P011219,P011971,0 days 00:09:47,6,28,22
74,TEL,P009622,P012744,0 days 00:09:45,7,18,11
74,TEL,P009622,P011971,0 days 00:09:11,3,19,16
74,TEL,P009863,P012744,0 days 00:07:55,5,16,11
74,TEL,P009783,P012744,0 days 00:07:55,5,16,11
74,TEL,P005145,P009783,0 days 00:07:51,-4,18,22
74,TEL,P005145,P009622,0 days 00:07:51,-4,18,22
74,TEL,P005145,P009863,0 days 00:07:51,-4,18,22
74,TEL,P009783,P011193,0 days 00:07:49,-2,12,14
74,TEL,P009622,P011219,0 days 00:07:29,-1,15,16
74,TEL,P009783,P011219,0 days 00:06:52,2,10,8
74,TEL,P009622,P011193,0 days 00:06:01,-4,9,13
74,TEL,P011199,P011971,0 days 00:05:59,0,6,6
74,TEL,P009783,P011971,0 days 00:05:53,-2,8,10
74,TEL,P005145,P011199,0 days 00:05:35,-3,12,15
74,TEL,P011214,P012744,0 days 00:05:15,4,12,8
74,TEL,P011199,P012744,0 days 00:04:50,3,6,3
74,TEL,P011193,P011199,0 days 00:04:18,0,4,4
74,TEL,P007990,P009622,0 days 00:02:32,-3,0,3
74,TEL,P007990,P009783,0 days 00:02:32,-3,0,3
74,TEL,P011971,P012744,0 days 00:02:30,2,2,0
74,TEL,P007990,P011199,0 days 00:02:30,-3,0,3
74,TEL,P005145,P011214,0 days 00:02:16,-1,6,7
74,TEL,P011193,P012744,0 days 00:02:10,2,2,0
74,TEL,P007990,P011971,0 days 00:01:34,-2,0,2
74,TEL,P011199,P011219,0 days 00:01:24,-1,0,1
74,TEL,P007990,P011219,0 days 00:00:56,-1,0,1
74,TEL,P007990,P009863,0 days 00:00:02,0,0,0
74,TEL,P007990,P011214,0 days 00:00:02,0,0,0
74,ULK,P006661,P008962,0 days 00:28:52,-7,53,60
74,ULK,P006961,P008962,0 days 00:27:23,-4,52,56
74,ULK,P008962,P011157,0 days 00:25:51,4,59,55
74,ULK,P006661,P006961,0 days 00:23:59,-4,46,50
74,ULK,P006661,P011157,0 days 00:21:23,0,49,49
74,ULK,P008962,P011980,0 days 00:20:33,-7,37,44
74,ULK,P006961,P011157,0 days 00:18:58,3,42,39
74,ULK,P006661,P011980,0 days 00:18:03,-5,33,38
74,ULK,P005844,P008962,0 days 00:17:41,-5,24,29
74,ULK,P008962,P011052,0 days 00:16:47,-2,32,34
74,ULK,P011157,P011980,0 days 00:16:21,-5,33,38
74,ULK,P005844,P011052,0 days 00:13:33,2,22,20
74,ULK,P008962,P009849,0 days 00:13:19,0,20,20
74,ULK,P006961,P011980,0 days 00:13:10,-2,26,28
74,ULK,P005844,P009849,0 days 00:12:50,2,20,18
74,ULK,P009849,P011052,0 days 00:11:18,2,20,18
74,ULK,P005844,P006961,0 days 00:09:47,-7,10,17
74,ULK,P011052,P011157,0 days 00:09:04,0,20,20
74,ULK,P006961,P011052,0 days 00:08:29,-3,11,14
74,ULK,P005844,P006661,0 days 00:07:19,-7,4,11
74,ULK,P008962,P011201,0 days 00:06:30,1,15,14
74,ULK,P006661,P011201,0 days 00:06:30,1,15,14
74,ULK,P006961,P011201,0 days 00:06:30,1,15,14
74,ULK,P006661,P011052,0 days 00:06:25,-4,12,16
74,ULK,P009849,P011157,0 days 00:06:19,2,10,8
74,ULK,P009849,P011980,0 days 00:05:17,-4,4,8
74,ULK,P005844,P011157,0 days 00:05:14,4,10,6
74,ULK,P011052,P011980,0 days 00:04:36,-3,11,14
74,ULK,P006961,P009849,0 days 00:04:20,0,6,6
74,ULK,P005844,P011980,0 days 00:04:12,-2,4,6
74,ULK,P011157,P011201,0 days 00:03:18,8,13,5
74,ULK,P005844,P011201,0 days 00:03:12,-7,2,9
74,ULK,P006661,P009849,0 days 00:02:57,-2,0,2
75,OLY,P008811,P008829,0 days 00:32:41,0,71,71
75,OLY,P001255,P008829,0 days 00:29:53,1,63,62
75,OLY,P008829,P010612,0 days 00:29:33,1,58,57
75,OLY,P001255,P010612,0 days 00:29:26,1,58,57
75,OLY,P001255,P008811,0 days 00:27:59,0,56,56
75,OLY,P008829,P008855,0 days 00:27:27,-4,55,59
75,OLY,P008811,P010612,0 days 00:26:46,-2,49,51
75,OLY,P001255,P008855,0 days 00:25:33,2,51,49
75,OLY,P008811,P008855,0 days 00:25:33,-5,48,53
75,OLY,P008855,P010612,0 days 00:24:20,0,44,44
75,OLY,P006302,P008829,0 days 00:14:20,3,37,34
75,OLY,P006302,P008811,0 days 00:11:34,5,33,28
75,OLY,P006302,P010392,0 days 00:09:08,4,25,21
75,OLY,P008829,P010392,0 days 00:08:56,2,28,26
75,OLY,P008829,P011983,0 days 00:07:19,6,17,11
75,OLY,P006302,P011983,0 days 00:07:19,6,17,11
75,OLY,P010392,P011983,0 days 00:06:27,6,17,11
75,OLY,P006589,P008829,0 days 00:06:19,3,15,12
75,OLY,P001255,P006302,0 days 00:06:06,3,16,13
75,OLY,P008811,P010392,0 days 00:06:03,4,24,20
75,OLY,P006302,P010612,0 days 00:05:13,1,14,13
75,OLY,P008811,P011983,0 days 00:03:40,6,11,5
75,OLY,P006302,P006589,0 days 00:03:39,0,6,6
75,OLY,P006589,P011983,0 days 00:03:39,0,6,6
75,OLY,P006589,P010392,0 days 00:03:39,0,6,6
75,OLY,P006302,P008855,0 days 00:03:33,-2,8,10
75,OLY,P008855,P010392,0 days 00:03:22,-2,13,15
75,OLY,P001255,P006589,0 days 00:02:40,3,9,6
75,OLY,P006589,P008855,0 days 00:02:40,3,9,6
75,OLY,P006589,P010612,0 days 00:02:40,3,9,6
75,OLY,P001255,P010392,0 days 00:01:27,2,7,5
75,OLY,P008855,P011983,0 days 00:00:52,0,0,0
75,OLY,P010392,P010612,0 days 00:00:14,0,0,0
75,RED,P000848,P009035,0 days 00:20:34,-12,35,47
75,RED,P006436,PJDR,0 days 00:18:19,9,55,46
75,RED,P002553,P012044,0 days 00:18:10,10,46,36
75,RED,P000848,P006436,0 days 00:17:48,1,46,45
75,RED,P000848,P012044,0 days 00:17:42,1,37,36
75,RED,P000848,P007960,0 days 00:17:09,-8,31,39
75,RED,P000848,PJDR,0 days 00:16:48,-5,42,47
75,RED,P009035,P012044,0 days 00:15:19,-4,23,27
75,RED,P002553,P006436,0 days 00:14:50,9,44,35
75,RED,P000848,P002553,0 days 00:14:08,-1,33,34
75,RED,P000848,P004720,0 days 00:13:40,-12,18,30
75,RED,P002553,PJDR,0 days 00:13:13,10,40,30
75,RED,P004720,P012044,0 days 00:13:07,-2,18,20
75,RED,P006436,P012044,0 days 00:12:47,9,38,29
75,RED,P008966,PJDR,0 days 00:12:35,0,28,28
75,RED,P004720,P009035,0 days 00:12:07,-2,18,20
75,RED,P002553,P009035,0 days 00:11:45,-6,19,25
75,RED,P007960,PJDR,0 days 00:11:36,-7,21,28
75,RED,P012044,PJDR,0 days 00:11:14,13,34,21
75,RED,P007960,P009035,0 days 00:10:42,-3,19,22
75,RED,P004720,P007960,0 days 00:10:34,-7,13,20
75,RED,P006436,P009035,0 days 00:10:31,-9,20,29
75,RED,P006436,P008966,0 days 00:09:54,6,27,21
75,RED,P009035,PJDR,0 days 00:09:34,-8,18,26
75,RED,P006436,P007960,0 days 00:08:15,-1,18,19
75,RED,P000848,P008966,0 days 00:08:03,-8,14,22
75,RED,P007960,P008966,0 days 00:07:47,-5,12,17
75,RED,P008966,P012044,0 days 00:07:44,2,18,16
75,RED,P007960,P012044,0 days 00:07:33,-1,10,11
75,RED,P002553,P008966,0 days 00:06:44,2,18,16
75,RED,P004720,PJDR,0 days 00:06:41,-8,6,14
75,RED,P002553,P004720,0 days 00:06:30,-4,8,12
75,RED,P004720,P008966,0 days 00:04:57,-9,3,12
75,RED,P004720,P006436,0 days 00:00:20,0,0,0
75,RED,P004720,P011964,0 days 00:00:20,0,0,0
75,RED,P006436,P011964,0 days 00:00:20,0,0,0
75,RED,P007960,P011964,0 days 00:00:20,0,0,0
75,RED,P008966,P011964,0 days 00:00:20,0,0,0
76,MAD,P004887,PTGB,0 days 00:18:20,-4,29,33
76,MAD,P006540,P009005,0 days 00:17:34,32,55,23
76,MAD,P005928,P006540,0 days 00:17:21,25,55,30
76,MAD,P005928,P009005,0 days 00:17:08,30,57,27
76,MAD,PCVM,PTGB,0 days 00:17:00,-5,23,28
76,MAD,P004887,PCVM,0 days 00:16:09,-5,23,28
76,MAD,P004887,PBMT,0 days 00:15:51,-5,27,32
76,MAD,P001392,P005928,0 days 00:15:30,21,46,25
76,MAD,P001392,P009005,0 days 00:15:30,21,46,25
76,MAD,PBMT,PTGB,0 days 00:15:21,-4,24,28
76,MAD,P005791,P005928,0 days 00:14:36,22,47,25
76,MAD,P001392,P006540,0 days 00:13:48,20,41,21
76,MAD,P005791,P006540,0 days 00:13:36,22,45,23
76,MAD,PBMT,PCVM,0 days 00:13:31,-7,20,27
76,MAD,P005791,P009005,0 days 00:13:09,22,45,23
76,MAD,P001392,P005791,0 days 00:11:56,15,36,21
76,MAD,P003108,PBMT,0 days 00:11:36,-21,11,32
76,MAD,P010357,PBMT,0 days 00:10:21,1,23,22
76,MAD,P010357,PTGB,0 days 00:09:08,6,20,14
76,MAD,P010357,PCVM,0 days 00:09:04,2,20,18
76,MAD,P003108,PTGB,0 days 00:08:18,-13,6,19
76,MAD,P003108,P004887,0 days 00:08:18,-13,6,19
76,MAD,P004887,P010357,0 days 00:07:29,4,18,14
76,MAD,P003108,PCVM,0 days 00:07:16,-14,4,18
76,MAD,P004887,P009005,0 days 00:06:07,11,15,4
76,MAD,P004887,P006540,0 days 00:06:03,7,12,5
76,MAD,P006540,PTGB,0 days 00:05:51,9,16,7
76,MAD,P001392,P004887,0 days 00:05:20,5,14,9
76,MAD,P005928,PBMT,0 days 00:05:04,-3,10,13
76,MAD,P006540,PCVM,0 days 00:04:57,-2,7,9
76,MAD,P006540,P010357,0 days 00:04:44,-9,7,16
76,MAD,P004887,P005928,0 days 00:03:59,8,12,4
76,MAD,P009005,PTGB,0 days 00:03:46,12,14,2
76,MAD,P001392,PBMT,0 days 00:03:28,0,9,9
76,MAD,P005928,P010357,0 days 00:03:22,-4,5,9
76,MAD,P003108,P010357,0 days 00:03:18,-8,5,13
76,MAD,P005791,PTGB,0 days 00:02:52,9,11,2
76,MAD,P006540,PBMT,0 days 00:02:39,-6,5,11
76,MAD,P003108,P006540,0 days 00:02:39,-6,5,11
76,MAD,P003108,P005928,0 days 00:02:34,-6,3,9
76,MAD,P005928,PTGB,0 days 00:02:26,11,13,2
76,MAD,P005791,P010357,0 days 00:02:18,0,2,2
76,MAD,P009005,PCVM,0 days 00:02:08,3,3,0
76,MAD,P005791,PBMT,0 days 00:01:51,0,2,2
76,MAD,P001392,P003108,0 days 00:01:46,-1,4,5
76,MAD,P001392,PTGB,0 days 00:01:46,-1,4,5
76,MAD,P009005,PBMT,0 days 00:01:42,1,5,4
76,MAD,P005791,PCVM,0 days 00:00:51,0,0,0
76,MAD,P003108,P005791,0 days 00:00:39,-2,0,2
76,MCO,P011196,P011212,0 days 00:20:39,-17,30,47
76,MCO,P005985,P010588,0 days 00:18:52,-9,41,50
76,MCO,P005985,P011226,0 days 00:18:35,-8,37,45
76,MCO,P010588,P011226,0 days 00:18:33,-11,38,49
76,MCO,P005985,P009754,0 days 00:16:41,7,36,29
76,MCO,P011212,P011231,0 days 00:15:42,-4,25,29
76,MCO,P011196,P011231,0 days 00:15:42,-4,25,29
76,MCO,P005985,PLCZ,0 days 00:14:32,-4,29,33
76,MCO,P010588,PLCZ,0 days 00:13:22,-3,29,32
76,MCO,P011212,P012709,0 days 00:12:35,-17,17,34
76,MCO,P011196,P012709,0 days 00:12:35,-17,17,34
76,MCO,P005985,P011212,0 days 00:12:33,2,23,21
76,MCO,P009754,PLCZ,0 days 00:12:26,-2,27,29
76,MCO,P011212,P011226,0 days 00:12:19,-14,17,31
76,MCO,P011226,PLCZ,0 days 00:11:25,-2,23,25
76,MCO,P010588,P011212,0 days 00:11:23,-16,19,35
76,MCO,P009754,P010588,0 days 00:10:32,-1,25,26
76,MCO,P009754,P011226,0 days 00:10:14,0,21,21
76,MCO,P011231,P012709,0 days 00:09:47,-13,14,27
76,MCO,P004790,P011212,0 days 00:08:49,-1,20,21
76,MCO,P011196,P011226,0 days 00:08:45,-16,7,23
76,MCO,P005985,P011196,0 days 00:08:04,0,13,13
76,MCO,P004790,P012709,0 days 00:06:26,-5,12,17
76,MCO,P004790,P011196,0 days 00:06:26,-5,12,17
76,MCO,P004790,P011231,0 days 00:06:26,-5,12,17
76,MCO,P010588,P012515,0 days 00:06:17,-3,14,17
76,MCO,P010588,P011196,0 days 00:06:10,-18,7,25
76,MCO,P004790,P005985,0 days 00:05:59,2,14,12
76,MCO,P004790,P011226,0 days 00:05:59,2,14,12
76,MCO,P005985,P011231,0 days 00:05:55,9,11,2
76,MCO,P005985,P012515,0 days 00:05:33,-3,12,15
76,MCO,P011226,P012709,0 days 00:04:56,-7,3,10
76,MCO,P012515,PLCZ,0 days 00:04:35,-2,10,12
76,MCO,P009754,P011196,0 days 00:04:15,9,9,0
76,MCO,P009754,P011231,0 days 00:04:15,9,9,0
76,MCO,P009754,P011212,0 days 00:04:15,9,9,0
76,MCO,P004790,P010588,0 days 00:04:05,3,12,9
76,MCO,P010588,P012709,0 days 00:04:01,-9,5,14
76,MCO,P011226,P011231,0 days 00:03:48,-3,2,5
76,MCO,P011212,PLCZ,0 days 00:02:50,-2,4,6
76,MCO,P011226,P012515,0 days 00:02:26,-1,6,7
76,MCO,P011212,P012515,0 days 00:02:23,0,4,4
76,MCO,P009754,P012515,0 days 00:02:12,-2,6,8
76,MCO,P004790,P009754,0 days 00:01:54,-1,2,3
76,MCO,P004790,PLCZ,0 days 00:01:54,-1,2,3
76,MCO,P004790,P012515,0 days 00:01:42,-1,4,5
76,MCO,P010588,P011231,0 days 00:01:13,-5,2,7
77,BAR,P002939,P004866,0 days 00:21:55,11,46,35
77,BAR,P000925,P002939,0 days 00:20:18,11,45,34
77,BAR,P002939,P006435,0 days 00:19:35,11,38,27
77,BAR,P003478,P012745,0 days 00:19:07,3,42,39
77,BAR,P000925,P004866,0 days 00:18:40,3,37,34
77,BAR,P004866,P006435,0 days 00:17:41,7,32,25
77,BAR,P000925,P006435,0 days 00:16:14,11,35,24
77,BAR,P002939,P012745,0 days 00:15:28,11,38,27
77,BAR,P004866,P012745,0 days 00:14:47,3,29,26
77,BAR,P002939,P003478,0 days 00:14:42,0,30,30
77,BAR,P003196,P012745,0 days 00:13:57,3,26,23
77,BAR,P006435,P012745,0 days 00:13:17,10,29,19
77,BAR,P003196,P006435,0 days 00:11:26,1,19,18
77,BAR,P002939,P011244,0 days 00:11:20,0,19,19
77,BAR,P006435,P011244,0 days 00:11:20,0,19,19
77,BAR,P003196,P007519,0 days 00:10:42,-5,17,22
77,BAR,P000925,P012745,0 days 00:10:33,5,26,21
77,BAR,P003196,P004866,0 days 00:10:30,2,17,15
77,BAR,P007519,P012745,0 days 00:09:55,-5,14,19
77,BAR,P003478,P006435,0 days 00:09:54,1,19,18
77,BAR,P003196,P003478,0 days 00:09:12,1,18,17
77,BAR,P000925,P003478,0 days 00:09:02,4,24,20
77,BAR,P003478,P004866,0 days 00:08:31,0,19,19
77,BAR,P000925,P011244,0 days 00:08:27,6,19,13
77,BAR,P004866,P011244,0 days 00:08:27,6,19,13
77,BAR,P006435,P007519,0 days 00:08:00,-3,13,16
77,BAR,P003478,P007519,0 days 00:07:37,-3,12,15
77,BAR,P002939,P003196,0 days 00:06:13,6,12,6
77,BAR,P004866,P007519,0 days 00:04:17,-4,5,9
77,BAR,P003478,P010641,0 days 00:04:05,-8,0,8
77,BAR,P003478,P007464,0 days 00:03:54,-4,4,8
77,BAR,P007464,P007519,0 days 00:03:54,-4,4,8
77,BAR,P007464,P012745,0 days 00:03:35,-4,4,8
77,BAR,P010641,P011244,0 days 00:03:12,-6,0,6
77,BAR,P003478,P011244,0 days 00:03:12,-6,0,6
77,BAR,P000925,P003196,0 days 00:02:58,-2,3,5
77,BAR,P002939,P010641,0 days 00:02:53,-6,0,6
77,BAR,P006435,P010641,0 days 00:02:53,-6,0,6
77,BAR,P003196,P007464,0 days 00:02:42,-2,4,6
77,BAR,P000925,P007519,0 days 00:01:40,-2,3,5
77,BAR,P007464,P010641,0 days 00:01:12,-2,0,2
77,BAR,P007519,P010641,0 days 00:01:12,-2,0,2
77,BAR,P010641,P012745,0 days 00:00:53,-2,0,2
77,BAR,P007464,P011244,0 days 00:00:19,0,0,0
77,BAR,P007519,P011244,0 days 00:00:19,0,0,0
77,PAM,P010568,P011982,0 days 00:19:58,0,39,39
77,PAM,P005356,P010568,0 days 00:15:38,-2,31,33
77,PAM,P005356,P007870,0 days 00:15:23,-5,27,32
77,PAM,P003960,P005356,0 days 00:15:15,-10,24,34
77,PAM,P005356,P011982,0 days 00:14:22,-2,29,31
77,PAM,P010568,P012739,0 days 00:14:06,-2,25,27
77,PAM,P003960,P010568,0 days 00:14:00,-6,21,27
77,PAM,P000556,P005356,0 days 00:13:45,-8,20,28
77,PAM,P007870,P010568,0 days 00:12:44,7,24,17
77,PAM,P000556,P004863,0 days 00:12:37,-2,18,20
77,PAM,P011982,P012739,0 days 00:12:30,-4,23,27
77,PAM,P004863,P005356,0 days 00:12:08,-6,17,23
77,PAM,P000556,P007870,0 days 00:11:52,-4,18,22
77,PAM,P011982,P012738,0 days 00:11:20,1,26,25
77,PAM,P004863,P007870,0 days 00:11:10,-2,17,19
77,PAM,P010568,P012738,0 days 00:11:09,1,24,23
77,PAM,P004863,P010393,0 days 00:10:38,7,20,13
77,PAM,P003960,P011982,0 days 00:10:23,-6,15,21
77,PAM,P000556,P010393,0 days 00:09:30,5,17,12
77,PAM,P005356,P012738,0 days 00:09:12,-2,19,21
77,PAM,P005356,P012739,0 days 00:08:54,0,17,17
77,PAM,P007870,P011982,0 days 00:08:44,5,18,13
77,PAM,P005356,P010393,0 days 00:08:15,3,16,13
77,PAM,P007870,P010393,0 days 00:07:56,5,14,9
77,PAM,P007870,P012738,0 days 00:07:45,-1,15,16
77,PAM,P003960,P012739,0 days 00:07:22,0,11,11
77,PAM,P000556,P003960,0 days 00:07:12,0,12,12
77,PAM,P003960,P007870,0 days 00:06:50,-1,13,14
77,PAM,P012738,P012739,0 days 00:06:44,-2,14,16
77,PAM,P006643,P012738,0 days 00:06:31,-6,10,16
77,PAM,P006643,P010568,0 days 00:06:17,-6,8,14
77,PAM,P000556,P010568,0 days 00:06:11,4,10,6
77,PAM,P006643,P011982,0 days 00:05:15,-4,8,12
77,PAM,P006643,P012739,0 days 00:04:17,-4,6,10
77,PAM,P003960,P004863,0 days 00:04:08,2,9,7
77,PAM,P004863,P012738,0 days 00:04:07,-9,3,12
77,PAM,P009101,P010568,0 days 00:03:55,4,6,2
77,PAM,P000556,P012738,0 days 00:03:34,-7,3,10
77,PAM,P003960,P010393,0 days 00:03:15,4,9,5
77,PAM,P007870,P009101,0 days 00:03:14,2,6,4
77,PAM,P003960,P009101,0 days 00:02:53,6,6,0
77,PAM,P004863,P010568,0 days 00:02:23,4,4,0
77,PAM,P010393,P010568,0 days 00:02:23,4,4,0
77,PAM,P006643,P007870,0 days 00:02:14,-2,4,6
77,PAM,P009101,P011982,0 days 00:02:09,4,4,0
77,PAM,P000556,P012739,0 days 00:01:36,2,2,0
77,PAM,P004863,P011982,0 days 00:01:21,-2,0,2
77,PAM,P006643,P009101,0 days 00:01:16,-2,2,4
77,PAM,P009101,P012738,0 days 00:01:16,-2,2,4
77,PAM,P003960,P012738,0 days 00:01:14,-5,0,5
77,PAM,P009101,P012739,0 days 00:00:55,2,2,0
77,PAM,P000556,P009101,0 days 00:00:44,2,2,0
77,PAM,P010393,P011982,0 days 00:00:35,0,0,0
77,PAM,P000556,P011982,0 days 00:00:27,0,2,2
77,PAM,P004863,P006643,0 days 00:00:14,0,2,2
77,PAM,P004863,P009101,0 days 00:00:14,0,2,2
78,ASV,P004194,P011225,0 days 00:30:30,-7,59,66
78,ASV,P003526,P004194,0 days 00:24:27,-8,52,60
78,ASV,P003526,P011225,0 days 00:23:11,-6,49,55
78,ASV,P004194,P012080,0 days 00:22:47,-4,48,52
78,ASV,P011225,P012080,0 days 00:22:29,3,50,47
78,ASV,P012729,PKIR,0 days 00:17:42,6,35,29
78,ASV,P003526,P012080,0 days 00:17:33,-7,40,47
78,ASV,P011225,PKIR,0 days 00:17:22,12,34,22
78,ASV,P011225,P012729,0 days 00:16:40,15,39,24
78,ASV,P012080,P012729,0 days 00:16:04,-1,34,35
78,ASV,P004194,P012729,0 days 00:14:32,3,30,27
78,ASV,P004194,PKIR,0 days 00:13:58,2,22,20
78,ASV,P012080,PKIR,0 days 00:13:27,2,24,22
78,ASV,P006568,P011225,0 days 00:10:49,-5,22,27
78,ASV,P004194,P006568,0 days 00:10:49,-5,22,27
78,ASV,P003526,P006568,0 days 00:10:49,-5,22,27
78,ASV,P012730,PKIR,0 days 00:10:19,-2,21,23
78,ASV,P003526,P012729,0 days 00:09:18,0,22,22
78,ASV,P012729,P012730,0 days 00:08:14,2,19,17
78,ASV,P006568,P012080,0 days 00:08:11,-3,18,21
78,ASV,P012080,P012730,0 days 00:07:43,-8,16,24
78,ASV,P011225,P012730,0 days 00:07:24,1,18,17
78,ASV,P000229,P011225,0 days 00:07:11,-1,13,14
78,ASV,P003526,PKIR,0 days 00:06:39,3,12,9
78,ASV,P000229,P004194,0 days 00:06:01,-8,9,17
78,ASV,P000229,P012730,0 days 00:05:42,-5,9,14
78,ASV,P000229,PKIR,0 days 00:05:42,-5,9,14
78,ASV,P000229,P012729,0 days 00:04:55,-3,10,13
78,ASV,P004194,P012730,0 days 00:04:00,-9,6,15
78,ASV,P000229,P003526,0 days 00:03:56,-4,7,11
78,ASV,P011386,PKIR,0 days 00:03:39,-2,7,9
78,ASV,P011386,P012730,0 days 00:03:39,-2,7,9
78,ASV,P011386,P012729,0 days 00:03:39,-2,7,9
78,ASV,P011386,P012080,0 days 00:03:39,-2,7,9
78,ASV,P000229,P006568,0 days 00:02:38,-2,4,6
78,ASV,P000229,P012080,0 days 00:02:27,-8,3,11
78,ASV,P003526,P012730,0 days 00:01:55,-5,4,9
78,BAS,P011948,P012201,0 days 00:26:50,19,70,51
78,BAS,P010444,P012201,0 days 00:25:37,13,59,46
78,BAS,P003198,P012201,0 days 00:24:16,5,46,41
78,BAS,P010444,P011948,0 days 00:23:57,15,61,46
78,BAS,P009048,P012201,0 days 00:23:07,-5,47,52
78,BAS,P012201,P012765,0 days 00:19:47,9,41,32
78,BAS,P009048,P011948,0 days 00:19:30,2,49,47
78,BAS,P003198,P010444,0 days 00:19:01,7,38,31
78,BAS,P009048,P010444,0 days 00:18:33,-3,39,42
78,BAS,P003198,P012765,0 days 00:17:25,6,34,28
78,BAS,P003198,P011948,0 days 00:17:16,11,40,29
78,BAS,P003198,P009048,0 days 00:14:34,-12,20,32
78,BAS,P010444,P012765,0 days 00:13:42,12,30,18
78,BAS,P011948,P012765,0 days 00:11:46,16,31,15
78,BAS,P008850,P012201,0 days 00:11:41,-3,29,32
78,BAS,P003198,P004603,0 days 00:11:25,-8,20,28
78,BAS,P004603,P012201,0 days 00:11:18,-3,23,26
78,BAS,P004603,P009048,0 days 00:10:44,-8,20,28
78,BAS,P004603,P011948,0 days 00:09:03,-2,21,23
78,BAS,P008850,P011948,0 days 00:08:18,-4,21,25
78,BAS,P008850,P009048,0 days 00:07:17,-5,18,23
78,BAS,P004603,P012765,0 days 00:06:05,-3,11,14
78,BAS,P009048,P012765,0 days 00:05:59,-6,6,12
78,BAS,P004603,P008850,0 days 00:05:52,3,15,12
78,BAS,P008850,P010444,0 days 00:05:49,-6,14,20
78,BAS,P009048,P011064,0 days 00:05:04,5,13,8
78,BAS,P010444,P011064,0 days 00:05:04,5,13,8
78,BAS,P011064,P012201,0 days 00:05:04,5,13,8
78,BAS,P008850,P012765,0 days 00:04:24,2,11,9
78,BAS,P003198,P008850,0 days 00:03:23,1,8,7
78,BAS,P004603,P010444,0 days 00:03:05,-3,6,9
78,BAS,P011064,P011948,0 days 00:03:00,7,11,4
78,BAS,P003198,P011064,0 days 00:02:04,-2,2,4
79,PAN,P007866,P011204,0 days 00:28:37,19,70,51
79,PAN,P002328,P007866,0 days 00:23:00,16,58,42
79,PAN,P002328,P011204,0 days 00:20:36,20,58,38
79,PAN,P001926,P007866,0 days 00:19:53,18,49,31
79,PAN,P007866,P012774,0 days 00:19:19,0,46,46
79,PAN,P007553,P007866,0 days 00:18:31,-4,41,45
79,PAN,P001926,P003842,0 days 00:17:28,19,39,20
79,PAN,P001926,P011204,0 days 00:17:01,16,38,22
79,PAN,P003842,P007866,0 days 00:16:14,20,40,20
79,PAN,P001926,P007947,0 days 00:15:55,-4,26,30
79,PAN,P007553,P011204,0 days 00:15:21,-3,32,35
79,PAN,P003842,P011204,0 days 00:15:03,21,38,17
79,PAN,P002328,P012774,0 days 00:14:38,-1,33,34
79,PAN,P007553,P012774,0 days 00:14:27,0,35,35
79,PAN,P007866,P007947,0 days 00:14:14,-7,24,31
79,PAN,P011204,P012774,0 days 00:13:29,3,33,30
79,PAN,P003842,P007947,0 days 00:12:24,-2,18,20
79,PAN,P002328,P007553,0 days 00:12:01,0,27,27
79,PAN,P002328,P003842,0 days 00:11:12,17,32,15
79,PAN,P007947,P011204,0 days 00:10:10,-5,13,18
79,PAN,P007947,P012774,0 days 00:08:21,-4,18,22
79,PAN,P001926,P002328,0 days 00:07:48,18,24,6
79,PAN,P001926,P012774,0 days 00:07:46,0,18,18
79,PAN,P003842,P012774,0 days 00:07:20,-1,14,15
79,PAN,P001926,P007553,0 days 00:06:47,-4,14,18
79,PAN,P007553,P007947,0 days 00:06:45,-7,13,20
79,PAN,P002328,P007947,0 days 00:03:52,-5,5,10
79,PAN,P003842,P011221,0 days 00:02:40,0,5,5
79,PAN,P007947,P011221,0 days 00:02:40,0,5,5
79,PAN,P001926,P008084,0 days 00:02:15,-2,2,4
79,PAN,P003842,P008084,0 days 00:02:15,-2,2,4
79,PAN,P007947,P008084,0 days 00:02:15,-2,2,4
79,PAN,P008084,P012774,0 days 00:02:15,-2,2,4
79,PAN,P011204,P011221,0 days 00:02:07,-1,2,3
79,PAN,P001926,P011221,0 days 00:02:07,-1,2,3
79,PAN,P002328,P011221,0 days 00:00:33,1,3,2
79,PAN,P011221,P012774,0 days 00:00:33,1,3,2
79,PAN,P002328,P011209,0 days 00:00:32,2,4,2
79,PAN,P007866,P011209,0 days 00:00:32,2,4,2
79,PAN,P011204,P011209,0 days 00:00:32,2,4,2
79,PAN,P011209,P012774,0 days 00:00:20,0,2,2
79,PAN,P007553,P011209,0 days 00:00:12,2,2,0
79,VIR,P001133,PBCN,0 days 00:25:34,3,57,54
79,VIR,P001133,P003048,0 days 00:23:37,1,52,51
79,VIR,P003048,PBCN,0 days 00:21:33,2,46,44
79,VIR,P001133,P006739,0 days 00:16:22,4,32,28
79,VIR,P001133,P001844,0 days 00:15:02,-9,30,39
79,VIR,P001133,P009549,0 days 00:14:41,-5,29,34
79,VIR,P009549,PBCN,0 days 00:13:39,0,29,29
79,VIR,P003048,P006739,0 days 00:13:18,5,28,23
79,VIR,P006739,P011192,0 days 00:12:49,0,21,21
79,VIR,P001844,PBCN,0 days 00:12:30,-6,27,33
79,VIR,P003048,P009549,0 days 00:12:05,2,27,25
79,VIR,P006739,PBCN,0 days 00:12:04,4,24,20
79,VIR,P001133,P011192,0 days 00:12:02,-3,20,23
79,VIR,P001844,P003048,0 days 00:11:12,-8,23,31
79,VIR,P011192,PBCN,0 days 00:09:44,3,20,17
79,VIR,P010781,PBCN,0 days 00:08:59,-3,24,27
79,VIR,P011192,P012714,0 days 00:08:35,-2,12,14
79,VIR,P004007,P006739,0 days 00:08:27,-2,12,14
79,VIR,P001133,P010781,0 days 00:08:25,-9,19,28
79,VIR,P003527,P010781,0 days 00:07:42,-10,16,26
79,VIR,P003048,P011192,0 days 00:07:23,4,16,12
79,VIR,P006739,P012714,0 days 00:07:13,-3,8,11
79,VIR,P003527,P012714,0 days 00:06:42,-4,11,15
79,VIR,P003527,P011192,0 days 00:06:38,-7,8,15
79,VIR,P004007,P011192,0 days 00:06:14,-1,8,9
79,VIR,P004007,P012714,0 days 00:06:14,-1,8,9
79,VIR,P001844,P009549,0 days 00:06:11,-5,11,16
79,VIR,P001844,P010781,0 days 00:06:04,-8,13,21
79,VIR,P009549,P010781,0 days 00:05:39,-9,9,18
79,VIR,P003048,P010781,0 days 00:05:28,-7,10,17
79,VIR,P012714,PBCN,0 days 00:05:00,-6,7,13
79,VIR,P003527,P004007,0 days 00:04:54,-3,6,9
79,VIR,P003527,PBCN,0 days 00:04:49,-1,14,15
79,VIR,P006739,P009549,0 days 00:04:44,4,9,5
79,VIR,P001133,P012714,0 days 00:04:32,-3,4,7
79,VIR,P001133,P004007,0 days 00:04:30,-2,8,10
79,VIR,P003527,P006739,0 days 00:04:09,-2,4,6
79,VIR,P001133,P003527,0 days 00:04:03,-5,9,14
79,VIR,P001844,P003527,0 days 00:03:47,-2,10,12
79,VIR,P003527,P009549,0 days 00:03:34,-11,2,13
79,VIR,P001844,P004007,0 days 00:03:10,-4,6,10
79,VIR,P003048,P004007,0 days 00:03:10,-4,6,10
79,VIR,P001844,P006739,0 days 00:02:58,-2,6,8
79,VIR,P001844,P012714,0 days 00:02:53,-5,3,8
79,VIR,P010781,P012714,0 days 00:02:33,-2,7,9
79,VIR,P010781,P011192,0 days 00:02:29,-5,4,9
79,VIR,P001844,P011192,0 days 00:02:01,1,3,2
79,VIR,P009549,P011192,0 days 00:01:21,-6,0,6
79,VIR,P009549,P012714,0 days 00:01:14,-2,0,2
79,VIR,P003048,P003527,0 days 00:01:06,-3,0,3
79,VIR,P004007,P010781,0 days 00:00:57,-3,2,5
80,PAR,P000956,P012742,0 days 00:22:18,14,47,33
80,PAR,P008987,P012743,0 days 00:20:21,4,41,37
80,PAR,P000956,P003983,0 days 00:19:45,20,52,32
80,PAR,P008987,P012742,0 days 00:16:15,8,35,27
80,PAR,P000956,P008987,0 days 00:16:00,6,33,27
80,PAR,P003983,P012742,0 days 00:15:57,20,41,21
80,PAR,P000956,P012743,0 days 00:15:49,11,37,26
80,PAR,P003983,P012096,0 days 00:15:35,11,40,29
80,PAR,P007400,P008987,0 days 00:14:58,-5,31,36
80,PAR,P003983,P008987,0 days 00:14:09,9,36,27
80,PAR,P000956,P012096,0 days 00:13:50,10,33,23
80,PAR,P007400,P012096,0 days 00:12:37,5,32,27
80,PAR,P012742,P012743,0 days 00:12:32,8,27,19
80,PAR,P003983,P012743,0 days 00:12:11,15,35,20
80,PAR,P012096,P012742,0 days 00:11:07,8,24,16
80,PAR,P004058,P008987,0 days 00:11:02,-6,16,22
80,PAR,P004058,P012743,0 days 00:11:02,-6,16,22
80,PAR,P007400,P012743,0 days 00:10:41,1,24,23
80,PAR,P003983,P007400,0 days 00:09:38,3,26,23
80,PAR,P004172,P012096,0 days 00:09:01,2,20,18
80,PAR,P008987,P012096,0 days 00:08:11,-1,19,20
80,PAR,P007673,P008987,0 days 00:08:04,-2,16,18
80,PAR,P000956,P007400,0 days 00:07:53,2,19,17
80,PAR,P003983,P004172,0 days 00:07:38,2,18,16
80,PAR,P004058,P007400,0 days 00:07:24,-2,14,16
80,PAR,P007673,P012743,0 days 00:07:24,-2,14,16
80,PAR,P007400,P007673,0 days 00:07:24,-2,14,16
80,PAR,P004058,P007673,0 days 00:07:24,-2,14,16
80,PAR,P004172,P007400,0 days 00:07:04,0,16,16
80,PAR,P004172,P008987,0 days 00:05:08,-1,13,14
80,PAR,P003983,P009212,0 days 00:04:43,4,12,8
80,PAR,P009212,P012742,0 days 00:04:43,4,12,8
80,PAR,P009212,P012096,0 days 00:04:43,4,12,8
80,PAR,P000956,P009212,0 days 00:04:43,4,12,8
80,PAR,P007400,P012742,0 days 00:04:05,2,8,6
80,PAR,P000956,P004058,0 days 00:03:38,-4,2,6
80,PAR,P004058,P012742,0 days 00:03:38,-4,2,6
80,PAR,P004172,P012742,0 days 00:03:21,4,6,2
80,PAR,P000956,P004172,0 days 00:03:12,1,5,4
80,PAR,P012096,P012743,0 days 00:02:52,5,10,5
80,PAR,P004172,P007673,0 days 00:00:40,0,2,2
80,PAR,P007673,P012096,0 days 00:00:40,0,2,2
80,PAR,P007673,P012742,0 days 00:00:40,0,2,2
80,BER,P003958,P012720,0 days 00:25:50,7,55,48
80,BER,P008211,P012720,0 days 00:23:51,0,51,51
80,BER,P003958,P006919,0 days 00:21:48,8,49,41
80,BER,P006919,P012720,0 days 00:21:46,10,47,37
80,BER,P003958,P008211,0 days 00:21:14,3,49,46
80,BER,P006919,P008211,0 days 00:18:49,2,44,42
80,BER,P008211,P010791,0 days 00:16:56,-6,37,43
80,BER,P010791,P012720,0 days 00:14:24,0,32,32
80,BER,P006919,P010791,0 days 00:14:04,-1,33,34
80,BER,P003958,P010791,0 days 00:12:12,3,30,27
80,BER,P006251,P008384,0 days 00:12:11,-17,17,34
80,BER,P006919,P011934,0 days 00:10:42,5,19,14
80,BER,P011934,P012720,0 days 00:09:56,5,19,14
80,BER,P006251,P008967,0 days 00:09:39,-9,14,23
80,BER,P003958,P011934,0 days 00:09:31,5,19,14
80,BER,P006251,P008211,0 days 00:09:01,-12,13,25
80,BER,P007550,P011934,0 days 00:08:42,0,11,11
80,BER,P006251,P012720,0 days 00:08:17,-8,12,20
80,BER,P006919,P007550,0 days 00:07:46,-1,10,11
80,BER,P006251,P007550,0 days 00:07:15,-7,9,16
80,BER,P006251,P011934,0 days 00:06:47,-6,8,14
80,BER,P008384,P011934,0 days 00:06:22,-6,8,14
80,BER,P003958,P007550,0 days 00:06:17,2,10,8
80,BER,P003958,P006251,0 days 00:05:48,-3,10,13
80,BER,P008384,P008967,0 days 00:05:47,-6,8,14
80,BER,P003958,P008967,0 days 00:05:43,-3,10,13
80,BER,P006251,P006919,0 days 00:05:42,-7,7,14
80,BER,P008967,P011934,0 days 00:05:36,-6,8,14
80,BER,P008211,P011934,0 days 00:05:35,3,13,10
80,BER,P007550,P012720,0 days 00:05:29,2,8,6
80,BER,P007550,P008384,0 days 00:05:26,-4,7,11
80,BER,P008211,P008384,0 days 00:05:24,-11,9,20
80,BER,P008384,P010791,0 days 00:05:24,-11,9,20
80,BER,P006251,P010791,0 days 00:04:44,-9,7,16
80,BER,P008967,P012720,0 days 00:04:42,-3,8,11
80,BER,P008211,P008967,0 days 00:04:42,-3,8,11
80,BER,P006919,P008384,0 days 00:04:08,-6,7,13
80,BER,P007550,P008967,0 days 00:03:46,-2,5,7
80,BER,P008384,P012720,0 days 00:02:52,-5,4,9
80,BER,P006251,P007025,0 days 00:02:46,-9,3,12
80,BER,P007025,P008384,0 days 00:02:05,-6,3,9
80,BER,P007025,P008967,0 days 00:02:01,-4,3,7
80,BER,P007025,P011934,0 days 00:02:01,-4,3,7
80,BER,P003958,P008384,0 days 00:01:41,-2,4,6
80,BER,P006251,P006819,0 days 00:00:58,-5,0,5
80,BER,P006819,P007550,0 days 00:00:58,-5,0,5
80,BER,P006819,P006919,0 days 00:00:54,-3,0,3
80,BER,P006819,P007025,0 days 00:00:45,-5,0,5
80,BER,P007025,P007550,0 days 00:00:45,-5,0,5
80,BER,P006919,P007025,0 days 00:00:41,-3,0,3
80,BER,P006819,P012720,0 days 00:00:13,0,0,0
80,BER,P006819,P008384,0 days 00:00:04,-2,0,2
81,ZAL,P002676,P007109,0 days 00:22:19,-11,31,42
81,ZAL,P007109,P011218,0 days 00:18:27,-5,28,33
81,ZAL,P003210,P005504,0 days 00:15:45,13,40,27
81,ZAL,P007109,P007513,0 days 00:15:35,-6,23,29
81,ZAL,P005504,P007109,0 days 00:15:31,-6,20,26
81,ZAL,P002329,P012715,0 days 00:14:03,12,38,26
81,ZAL,P002329,P003211,0 days 00:13:49,12,34,22
81,ZAL,P003210,P003211,0 days 00:13:35,7,36,29
81,ZAL,P002676,P011218,0 days 00:13:19,-1,19,20
81,ZAL,P003211,P012715,0 days 00:13:15,7,33,26
81,ZAL,P002329,P003210,0 days 00:12:48,10,32,22
81,ZAL,P002329,P005504,0 days 00:12:39,14,35,21
81,ZAL,P003211,P005504,0 days 00:12:31,19,40,21
81,ZAL,P002676,P007513,0 days 00:11:45,-5,18,23
81,ZAL,P002676,P005504,0 days 00:11:32,-5,15,20
81,ZAL,P003210,P007109,0 days 00:11:26,-12,11,23
81,ZAL,P007513,P011218,0 days 00:11:14,-3,18,21
81,ZAL,P003210,P012715,0 days 00:11:04,8,31,23
81,ZAL,P005504,P007513,0 days 00:10:02,-10,10,20
81,ZAL,P002329,P007109,0 days 00:09:56,-7,13,20
81,ZAL,P003211,P007109,0 days 00:09:38,-9,13,22
81,ZAL,P002676,P003210,0 days 00:09:25,-11,9,20
81,ZAL,P005504,P011218,0 days 00:09:12,-5,7,12
81,ZAL,P002676,P003211,0 days 00:08:42,-5,13,18
81,ZAL,P005504,P012715,0 days 00:08:40,15,30,15
81,ZAL,P010390,P011218,0 days 00:07:28,4,15,11
81,ZAL,P002329,P011218,0 days 00:07:07,0,13,13
81,ZAL,P002676,P010390,0 days 00:06:17,2,13,11
81,ZAL,P007109,P010390,0 days 00:06:08,2,13,11
81,ZAL,P007513,P010390,0 days 00:05:45,4,13,9
81,ZAL,P007109,P012715,0 days 00:05:32,-11,7,18
81,ZAL,P003211,P011218,0 days 00:05:10,0,6,6
81,ZAL,P011218,P012715,0 days 00:04:48,-2,8,10
81,ZAL,P003210,P007513,0 days 00:04:21,-3,5,8
81,ZAL,P002329,P007513,0 days 00:04:11,-1,5,6
81,ZAL,P007109,P011965,0 days 00:03:20,1,9,8
81,ZAL,P002329,P002676,0 days 00:02:56,-2,2,4
81,ZAL,P002329,P011965,0 days 00:02:31,0,6,6
81,ZAL,P003211,P010390,0 days 00:02:24,0,2,2
81,ZAL,P002676,P012715,0 days 00:02:24,-7,1,8
81,ZAL,P011965,P012715,0 days 00:02:08,0,6,6
81,ZAL,P011218,P011965,0 days 00:02:05,0,6,6
81,ZAL,P002329,P010390,0 days 00:01:52,2,2,0
81,ZAL,P010390,P012715,0 days 00:01:43,2,2,0
81,ZAL,P003210,P011218,0 days 00:01:38,0,0,0
81,ZAL,P003211,P011965,0 days 00:01:15,1,3,2
81,ZAL,P002676,P011965,0 days 00:01:13,1,3,2
81,ZAL,P005504,P011965,0 days 00:00:52,1,3,2
81,ZAL,P003210,P010390,0 days 00:00:20,0,0,0
81,ZAL,P003211,P007513,0 days 00:00:09,0,0,0
81,ZAL,P007513,P011965,0 days 00:00:03,0,0,0
81,ZAL,P007513,P012715,0 days 00:00:03,0,0,0
81,ZAL,P010390,P011965,0 days 00:00:03,0,0,0
81,ZAL,P003210,P011965,0 days 00:00:02,0,0,0
81,MUN,P007056,P008985,0 days 00:25:03,6,45,39
81,MUN,P003583,P011987,0 days 00:21:28,-3,37,40
81,MUN,P007056,P011987,0 days 00:20:59,2,37,35
81,MUN,P008985,P010391,0 days 00:20:41,11,41,30
81,MUN,P003583,P007056,0 days 00:19:45,0,29,29
81,MUN,P001557,P003583,0 days 00:18:37,-9,30,39
81,MUN,P008985,P011987,0 days 00:18:18,-2,31,33
81,MUN,P001557,P011987,0 days 00:18:10,-9,32,41
81,MUN,P001557,P007056,0 days 00:18:02,0,31,31
81,MUN,P007056,P010391,0 days 00:16:10,8,30,22
81,MUN,P003583,P008985,0 days 00:15:21,-4,20,24
81,MUN,P001557,P008985,0 days 00:12:20,-3,18,21
81,MUN,P005478,P011987,0 days 00:10:35,-16,17,33
81,MUN,P007975,P011987,0 days 00:10:35,-10,17,27
81,MUN,P010391,P011987,0 days 00:10:34,-3,16,19
81,MUN,P005478,P010391,0 days 00:10:05,1,20,19
81,MUN,P001557,P007975,0 days 00:09:17,-7,17,24
81,MUN,P005478,P008985,0 days 00:08:56,4,20,16
81,MUN,P003583,P007975,0 days 00:08:31,-3,17,20
81,MUN,P007639,P010391,0 days 00:08:04,12,22,10
81,MUN,P008985,P012123,0 days 00:07:49,12,22,10
81,MUN,P010391,P012123,0 days 00:07:49,12,22,10
81,MUN,P007639,P008985,0 days 00:07:26,12,22,10
81,MUN,P007639,P012123,0 days 00:07:26,12,22,10
81,MUN,P003583,P010391,0 days 00:06:58,-2,7,9
81,MUN,P007056,P012123,0 days 00:06:19,8,18,10
81,MUN,P007056,P007639,0 days 00:05:56,8,18,10
81,MUN,P007056,P007975,0 days 00:05:42,3,13,10
81,MUN,P001557,P005478,0 days 00:05:10,-7,7,14
81,MUN,P005478,P007975,0 days 00:04:44,-13,4,17
81,MUN,P005478,P007056,0 days 00:04:34,1,9,8
81,MUN,P003583,P005478,0 days 00:03:49,-7,8,15
81,MUN,P011941,P011987,0 days 00:03:39,-7,5,12
81,MUN,P001557,P010391,0 days 00:03:27,-1,3,4
81,MUN,P005478,P011941,0 days 00:03:09,-7,3,10
81,MUN,P010391,P011941,0 days 00:02:14,-3,3,6
81,MUN,P008985,P011941,0 days 00:02:13,0,5,5
81,MUN,P005478,P007639,0 days 00:02:08,4,4,0
81,MUN,P005478,P012123,0 days 00:01:30,4,4,0
81,MUN,P007975,P011941,0 days 00:01:26,-7,0,7
81,MUN,P001557,P011941,0 days 00:01:25,-4,2,6
81,MUN,P007975,P010391,0 days 00:01:18,-3,0,3
81,MUN,P007639,P007975,0 days 00:00:38,0,0,0
81,MUN,P007639,P011987,0 days 00:00:38,0,0,0
81,MUN,P007056,P011941,0 days 00:00:30,0,2,2
81,MUN,P003583,P012123,0 days 00:00:23,0,0,0
81,MUN,P007975,P008985,0 days 00:00:09,0,0,0
82,ASV,P004194,P011225,0 days 00:32:10,0,77,77
82,ASV,P011225,P012080,0 days 00:28:36,-1,72,73
82,ASV,P004194,P012080,0 days 00:25:31,-9,62,71
82,ASV,P011225,P012729,0 days 00:24:53,10,66,56
82,ASV,P003526,P012080,0 days 00:23:51,-1,65,66
82,ASV,P003526,P011225,0 days 00:22:17,4,63,59
82,ASV,P003526,P004194,0 days 00:21:51,-5,56,61
82,ASV,P004194,P012729,0 days 00:20:01,2,54,52
82,ASV,P000229,P012729,0 days 00:19:19,-4,34,38
82,ASV,P012080,P012729,0 days 00:19:18,-4,51,55
82,ASV,P006568,P011225,0 days 00:17:04,3,35,32
82,ASV,P006568,P012080,0 days 00:16:54,1,35,34
82,ASV,P012729,PKIR,0 days 00:15:29,4,26,22
82,ASV,P003526,P006568,0 days 00:14:18,2,32,30
82,ASV,P000229,PKIR,0 days 00:14:12,5,26,21
82,ASV,P004194,P006568,0 days 00:12:58,-3,25,28
82,ASV,P000229,P011225,0 days 00:12:41,2,25,23
82,ASV,P000229,P004194,0 days 00:11:35,3,25,22
82,ASV,P003526,P012729,0 days 00:11:12,2,40,38
82,ASV,P011225,PKIR,0 days 00:09:51,7,19,12
82,ASV,P004194,PKIR,0 days 00:07:50,8,17,9
82,ASV,P000229,P012730,0 days 00:07:42,-5,9,14
82,ASV,P012729,P012730,0 days 00:07:42,-5,9,14
82,ASV,P000229,P012080,0 days 00:06:54,-10,10,20
82,ASV,P012730,PKIR,0 days 00:06:44,-3,9,12
82,ASV,P011386,P012729,0 days 00:05:59,-1,10,11
82,ASV,P006568,P012729,0 days 00:04:15,4,10,6
82,ASV,P011386,P012730,0 days 00:03:29,-2,5,7
82,ASV,P011386,PKIR,0 days 00:03:29,-2,5,7
82,ASV,P000229,P011386,0 days 00:03:29,-2,5,7
82,ASV,P012080,PKIR,0 days 00:03:04,-2,2,4
82,ASV,P012080,P012730,0 days 00:02:45,-3,2,5
82,ASV,P006568,P011386,0 days 00:02:24,-1,3,4
82,ASV,P011225,P011386,0 days 00:02:21,3,5,2
82,ASV,P011386,P012080,0 days 00:02:11,1,5,4
82,ASV,P011225,P012730,0 days 00:01:31,0,2,2
82,ASV,P000229,P003526,0 days 00:01:22,-3,2,5
82,ASV,P006568,PKIR,0 days 00:00:57,0,0,0
82,ASV,P003526,P012730,0 days 00:00:55,-2,0,2
82,ASV,P003526,P011386,0 days 00:00:34,0,2,2
82,ASV,P003526,PKIR,0 days 00:00:20,-1,0,1
82,ASV,P000229,P006568,0 days 00:00:02,-2,0,2
82,MUN,P003583,P007056,0 days 00:23:32,13,66,53
82,MUN,P001557,P010391,0 days 00:22:51,-4,55,59
82,MUN,P007056,P008985,0 days 00:22:50,10,50,40
82,MUN,P003583,P008985,0 days 00:22:27,12,50,38
82,MUN,P007056,P010391,0 days 00:20:45,2,58,56
82,MUN,P007056,P011987,0 days 00:18:32,0,40,40
82,MUN,P001557,P004508,0 days 00:17:38,-1,27,28
82,MUN,P001557,P007056,0 days 00:17:15,10,53,43
82,MUN,P003583,P011987,0 days 00:16:28,1,35,34
82,MUN,P004508,P010391,0 days 00:15:29,-7,24,31
82,MUN,P003583,P010391,0 days 00:14:17,-1,40,41
82,MUN,P008985,P010391,0 days 00:13:36,3,28,25
82,MUN,P008985,P011987,0 days 00:13:02,3,28,25
82,MUN,P001557,P007975,0 days 00:12:53,-4,23,27
82,MUN,P004508,P011941,0 days 00:12:35,-4,17,21
82,MUN,P007975,P010391,0 days 00:12:35,-8,22,30
82,MUN,P001557,P011941,0 days 00:12:09,1,17,16
82,MUN,P007056,P007975,0 days 00:11:23,-1,27,28
82,MUN,P010391,P011941,0 days 00:11:13,-4,15,19
82,MUN,P006760,P007056,0 days 00:11:01,2,38,36
82,MUN,P006760,P011987,0 days 00:10:55,1,25,24
82,MUN,P001557,P003583,0 days 00:09:51,2,33,31
82,MUN,P001557,P008985,0 days 00:09:48,7,22,15
82,MUN,P004508,P007056,0 days 00:09:25,5,20,15
82,MUN,P004508,P007975,0 days 00:09:05,-9,11,20
82,MUN,P006760,P007975,0 days 00:08:35,-1,20,21
82,MUN,P007975,P011941,0 days 00:08:14,-7,13,20
82,MUN,P007056,P011941,0 days 00:07:17,-3,12,15
82,MUN,P010391,P011987,0 days 00:07:09,-3,13,16
82,MUN,P006760,P008985,0 days 00:06:55,3,18,15
82,MUN,P003583,P004508,0 days 00:06:18,1,13,12
82,MUN,P003583,P007975,0 days 00:05:19,-2,7,9
82,MUN,P006760,P011941,0 days 00:04:47,-2,9,11
82,MUN,P007975,P011987,0 days 00:04:28,0,9,9
82,MUN,P003583,P006760,0 days 00:04:20,2,20,18
82,MUN,P001557,P006760,0 days 00:02:49,0,17,17
82,MUN,P006760,P010391,0 days 00:02:49,0,17,17
82,MUN,P004508,P006760,0 days 00:02:43,-1,4,5
82,MUN,P004508,P008985,0 days 00:02:19,4,4,0
82,MUN,P011941,P011987,0 days 00:02:04,-1,5,6
82,MUN,P001557,P011987,0 days 00:01:30,-1,5,6
82,MUN,P008985,P011941,0 days 00:00:17,0,0,0
82,MUN,P001557,P005478,0 days 00:00:06,-2,0,2
82,MUN,P005478,P007056,0 days 00:00:06,-2,0,2
82,MUN,P005478,P008985,0 days 00:00:06,-2,0,2
82,MUN,P005478,P010391,0 days 00:00:06,-2,0,2
82,MUN,P001557,P007639,0 days 00:00:02,0,0,0
82,MUN,P006760,P007639,0 days 00:00:02,0,0,0
82,MUN,P007056,P007639,0 days 00:00:02,0,0,0
82,MUN,P007639,P010391,0 days 00:00:02,0,0,0
83,TEL,P009622,P009783,0 days 00:27:36,0,61,61
83,TEL,P009622,P009863,0 days 00:22:49,-2,55,57
83,TEL,P009783,P009863,0 days 00:22:49,-4,50,54
83,TEL,P011214,P011219,0 days 00:16:40,8,39,31
83,TEL,P009622,P011199,0 days 00:16:37,-8,37,45
83,TEL,P009863,P011199,0 days 00:16:37,-8,37,45
83,TEL,P009622,P011219,0 days 00:16:33,10,42,32
83,TEL,P009783,P011214,0 days 00:16:31,9,38,29
83,TEL,P009783,P011219,0 days 00:16:01,9,38,29
83,TEL,P005145,P009863,0 days 00:15:36,-3,35,38
83,TEL,P011214,P012744,0 days 00:14:48,2,30,28
83,TEL,P009622,P012744,0 days 00:13:59,4,35,31
83,TEL,P009783,P011199,0 days 00:13:52,-9,28,37
83,TEL,P009622,P011214,0 days 00:13:46,10,34,24
83,TEL,P011219,P012744,0 days 00:13:40,4,32,28
83,TEL,P005145,P009622,0 days 00:12:52,-3,31,34
83,TEL,P005145,P011199,0 days 00:12:52,-3,31,34
83,TEL,P009863,P011214,0 days 00:12:26,3,28,25
83,TEL,P009783,P012744,0 days 00:11:56,2,24,22
83,TEL,P005145,P009783,0 days 00:11:21,-4,24,28
83,TEL,P009863,P012744,0 days 00:10:11,-2,23,25
83,TEL,P009863,P011219,0 days 00:09:06,4,23,19
83,TEL,P009622,P011971,0 days 00:07:08,-5,16,21
83,TEL,P005145,P012744,0 days 00:05:29,1,13,12
83,TEL,P009783,P011971,0 days 00:05:05,-5,10,15
83,TEL,P009863,P011971,0 days 00:04:22,-6,7,13
83,TEL,P004233,P011219,0 days 00:04:12,-4,9,13
83,TEL,P011219,P011971,0 days 00:04:00,-3,9,12
83,TEL,P004233,P011971,0 days 00:04:00,-3,9,12
83,TEL,P004233,P009622,0 days 00:03:44,-2,9,11
83,TEL,P011199,P011971,0 days 00:03:36,-5,6,11
83,TEL,P004233,P012744,0 days 00:03:33,0,8,8
83,TEL,P011199,P012744,0 days 00:02:45,1,9,8
83,TEL,P005145,P011214,0 days 00:02:44,0,4,4
83,TEL,P004233,P011214,0 days 00:02:19,-3,2,5
83,TEL,P004233,P009863,0 days 00:02:16,-2,2,4
83,TEL,P011971,P012744,0 days 00:02:03,0,6,6
83,TEL,P004233,P009783,0 days 00:01:41,-2,3,5
83,TEL,P004233,P005145,0 days 00:01:30,0,2,2
83,TEL,P011214,P011971,0 days 00:00:46,-1,1,2
83,TEL,P004233,P011199,0 days 00:00:09,0,0,0
83,BAR,P002939,P004866,0 days 00:19:28,4,41,37
83,BAR,P004866,P006435,0 days 00:16:13,-11,35,46
83,BAR,P003478,P004866,0 days 00:15:17,10,36,26
83,BAR,P002939,P012745,0 days 00:15:14,11,35,24
83,BAR,P010641,P012745,0 days 00:14:07,12,32,20
83,BAR,P003196,P006435,0 days 00:13:55,-14,31,45
83,BAR,P002939,P003478,0 days 00:13:48,4,28,24
83,BAR,P002939,P010641,0 days 00:13:21,10,28,18
83,BAR,P004866,P012745,0 days 00:12:49,6,31,25
83,BAR,P002939,P006435,0 days 00:12:31,-12,22,34
83,BAR,P003196,P004866,0 days 00:12:13,-12,27,39
83,BAR,P006435,P011244,0 days 00:11:33,3,29,26
83,BAR,P003478,P006435,0 days 00:11:12,-3,26,29
83,BAR,P004866,P011244,0 days 00:09:55,2,25,23
83,BAR,P003204,P003478,0 days 00:09:40,6,28,22
83,BAR,P002939,P003196,0 days 00:09:34,-10,20,30
83,BAR,P004866,P010641,0 days 00:09:19,10,22,12
83,BAR,P003478,P012745,0 days 00:09:15,9,21,12
83,BAR,P003196,P003204,0 days 00:09:05,-1,25,26
83,BAR,P007464,P009992,0 days 00:08:48,4,21,17
83,BAR,P003478,P010641,0 days 00:08:33,8,18,10
83,BAR,P003204,P006435,0 days 00:08:29,-1,24,25
83,BAR,P003196,P003478,0 days 00:08:15,-1,23,24
83,BAR,P002939,P007464,0 days 00:08:02,-6,12,18
83,BAR,P003196,P007464,0 days 00:07:54,-2,18,20
83,BAR,P003478,P007464,0 days 00:07:48,2,20,18
83,BAR,P002939,P011244,0 days 00:07:22,1,16,15
83,BAR,P003204,P007464,0 days 00:07:10,5,20,15
83,BAR,P003204,P004866,0 days 00:06:57,-4,19,23
83,BAR,P009992,P012745,0 days 00:06:44,2,16,14
83,BAR,P003478,P011244,0 days 00:06:40,3,15,12
83,BAR,P006435,P007464,0 days 00:06:15,-5,11,16
83,BAR,P009992,P010641,0 days 00:06:08,2,14,12
83,BAR,P007464,P012745,0 days 00:05:24,2,12,10
83,BAR,P007464,P010641,0 days 00:05:22,0,10,10
83,BAR,P003204,P009992,0 days 00:05:20,2,15,13
83,BAR,P003196,P011244,0 days 00:05:02,0,14,14
83,BAR,P002939,P009992,0 days 00:04:48,2,10,8
83,BAR,P003196,P012745,0 days 00:04:38,-6,11,17
83,BAR,P003204,P011244,0 days 00:04:20,2,13,11
83,BAR,P003196,P009992,0 days 00:04:00,2,11,9
83,BAR,P003204,P012745,0 days 00:03:31,-5,8,13
83,BAR,P003478,P009992,0 days 00:03:24,2,9,7
83,BAR,P006435,P012745,0 days 00:03:18,-7,6,13
83,BAR,P004866,P007464,0 days 00:02:09,-5,0,5
83,BAR,P007464,P011244,0 days 00:01:56,1,4,3
83,BAR,P003204,P010641,0 days 00:01:20,0,4,4
83,BAR,P004866,P009992,0 days 00:01:20,0,4,4
83,BAR,P006435,P010641,0 days 00:00:34,-2,0,2
84,PAN,P003842,P007866,0 days 00:27:19,18,70,52
84,PAN,P002328,P007866,0 days 00:26:12,13,65,52
84,PAN,P001926,P007866,0 days 00:25:19,19,67,48
84,PAN,P002328,P003842,0 days 00:24:02,15,62,47
84,PAN,P001926,P003842,0 days 00:23:24,23,65,42
84,PAN,P007866,P011204,0 days 00:22:21,19,56,37
84,PAN,P001926,P002328,0 days 00:20:26,19,57,38
84,PAN,P003842,P011204,0 days 00:20:03,23,53,30
84,PAN,P002328,P011204,0 days 00:20:02,19,52,33
84,PAN,P001926,P011204,0 days 00:19:20,19,51,32
84,PAN,P002328,P007947,0 days 00:13:10,-3,22,25
84,PAN,P007947,P012774,0 days 00:10:57,-2,18,20
84,PAN,P007866,P007947,0 days 00:10:54,-9,19,28
84,PAN,P007553,P007947,0 days 00:10:51,-1,17,18
84,PAN,P007947,P008084,0 days 00:10:46,4,21,17
84,PAN,P002328,P012774,0 days 00:10:28,1,21,20
84,PAN,P007553,P012774,0 days 00:09:41,3,18,15
84,PAN,P007553,P008084,0 days 00:09:19,5,17,12
84,PAN,P003842,P007947,0 days 00:08:39,-3,17,20
84,PAN,P002328,P007553,0 days 00:08:21,4,15,11
84,PAN,P008084,P012774,0 days 00:08:12,4,15,11
84,PAN,P001926,P007947,0 days 00:08:09,-3,16,19
84,PAN,P002328,P008084,0 days 00:06:30,5,12,7
84,PAN,P007866,P012774,0 days 00:05:20,-3,10,13
84,PAN,P003842,P012774,0 days 00:03:51,-2,7,9
84,PAN,P007553,P007866,0 days 00:03:27,-4,5,9
84,PAN,P007947,P011204,0 days 00:03:25,-2,3,5
84,PAN,P007553,P011204,0 days 00:02:42,-3,3,6
84,PAN,P011209,P012774,0 days 00:02:25,-1,3,4
84,PAN,P007947,P011209,0 days 00:02:25,-1,3,4
84,PAN,P008084,P011209,0 days 00:02:25,-1,3,4
84,PAN,P011204,P012774,0 days 00:02:03,2,4,2
84,PAN,P007553,P011209,0 days 00:02:03,-1,3,4
84,PAN,P003842,P011209,0 days 00:01:59,-1,2,3
84,PAN,P007866,P008084,0 days 00:01:51,0,6,6
84,PAN,P001926,P008084,0 days 00:01:51,0,6,6
84,PAN,P007866,P011209,0 days 00:01:37,-1,2,3
84,PAN,P011204,P011209,0 days 00:01:37,-1,2,3
84,PAN,P002328,P011209,0 days 00:01:37,-1,2,3
84,PAN,P001926,P007553,0 days 00:01:36,-3,2,5
84,PAN,P003842,P008084,0 days 00:01:27,-1,4,5
84,PAN,P001926,P012774,0 days 00:01:11,2,4,2
84,PAN,P008084,P011204,0 days 00:00:43,0,0,0
84,PAM,P010568,P011982,0 days 00:16:55,-8,31,39
84,PAM,P007870,P010568,0 days 00:14:43,-12,27,39
84,PAM,P012738,P012739,0 days 00:13:59,0,25,25
84,PAM,P006643,P012740,0 days 00:13:55,-1,28,29
84,PAM,P005356,P012738,0 days 00:13:24,-3,25,28
84,PAM,P005356,P010568,0 days 00:12:39,-1,26,27
84,PAM,P011970,P012738,0 days 00:12:26,-2,22,24
84,PAM,P005356,P012739,0 days 00:12:14,-5,22,27
84,PAM,P005356,P011982,0 days 00:12:05,-5,22,27
84,PAM,P010568,P012738,0 days 00:11:47,0,22,22
84,PAM,P011982,P012738,0 days 00:11:06,-5,18,23
84,PAM,P003960,P007870,0 days 00:10:01,-16,13,29
84,PAM,P003960,P010568,0 days 00:09:50,-19,13,32
84,PAM,P010568,P012739,0 days 00:09:09,0,18,18
84,PAM,P000556,P012738,0 days 00:09:00,-7,15,22
84,PAM,P011982,P012739,0 days 00:08:59,-2,17,19
84,PAM,P007870,P012740,0 days 00:08:43,-10,14,24
84,PAM,P010568,P012740,0 days 00:08:35,-9,14,23
84,PAM,P006643,P010568,0 days 00:08:35,-9,14,23
84,PAM,P000556,P005356,0 days 00:08:18,-3,16,19
84,PAM,P006643,P007870,0 days 00:08:04,-9,14,23
84,PAM,P011970,P011982,0 days 00:07:53,-8,12,20
84,PAM,P006643,P012738,0 days 00:07:48,6,17,11
84,PAM,P003960,P012740,0 days 00:07:41,-12,13,25
84,PAM,P000556,P011970,0 days 00:07:31,-8,13,21
84,PAM,P011970,P012740,0 days 00:07:29,6,17,11
84,PAM,P000556,P010568,0 days 00:07:18,1,18,17
84,PAM,P007870,P011982,0 days 00:07:18,-4,13,17
84,PAM,P006643,P010393,0 days 00:07:13,9,18,9
84,PAM,P012738,P012740,0 days 00:06:34,7,14,7
84,PAM,P003960,P006643,0 days 00:06:34,-11,10,21
84,PAM,P000556,P011982,0 days 00:06:25,-3,14,17
84,PAM,P010393,P012738,0 days 00:06:12,4,14,10
84,PAM,P011970,P012739,0 days 00:06:05,-4,10,14
84,PAM,P010393,P012740,0 days 00:05:51,8,15,7
84,PAM,P010568,P011970,0 days 00:05:44,-6,9,15
84,PAM,P003960,P011982,0 days 00:05:20,-9,6,15
84,PAM,P006643,P011970,0 days 00:05:20,8,14,6
84,PAM,P010393,P011970,0 days 00:04:50,3,11,8
84,PAM,P000556,P012739,0 days 00:04:45,-4,8,12
84,PAM,P005356,P007870,0 days 00:04:01,-1,8,9
84,PAM,P000556,P007870,0 days 00:03:32,1,10,9
84,PAM,P012739,P012740,0 days 00:03:19,1,6,5
84,PAM,P005356,P011970,0 days 00:03:17,-5,4,9
84,PAM,P007870,P011970,0 days 00:03:17,-3,5,8
84,PAM,P003960,P005356,0 days 00:03:12,-8,3,11
84,PAM,P010393,P010568,0 days 00:02:37,-1,4,5
84,PAM,P005356,P006643,0 days 00:02:16,-2,3,5
84,PAM,P011982,P012740,0 days 00:02:09,-2,3,5
84,PAM,P006643,P012739,0 days 00:02:08,2,3,1
84,PAM,P003960,P011970,0 days 00:02:08,-1,3,4
84,PAM,P000556,P006643,0 days 00:01:57,-2,3,5
84,PAM,P007870,P010393,0 days 00:01:49,2,4,2
84,PAM,P003960,P012739,0 days 00:01:34,-4,3,7
84,PAM,P000556,P010393,0 days 00:01:22,1,3,2
84,PAM,P005356,P010393,0 days 00:01:22,1,3,2
84,PAM,P006643,P011982,0 days 00:00:54,-3,0,3
84,PAM,P010393,P011982,0 days 00:00:48,-3,0,3
85,MAD,P005791,P005928,0 days 00:22:14,20,61,41
85,MAD,P001392,P005791,0 days 00:18:07,17,49,32
85,MAD,P001392,P005928,0 days 00:17:30,20,48,28
85,MAD,P004887,PCVM,0 days 00:15:58,9,37,28
85,MAD,P003108,P005928,0 days 00:14:23,13,40,27
85,MAD,P005928,P009213,0 days 00:14:04,9,35,26
85,MAD,P001392,P009213,0 days 00:14:04,9,35,26
85,MAD,P005791,P009213,0 days 00:14:04,9,35,26
85,MAD,P003108,P005791,0 days 00:13:12,15,40,25
85,MAD,P003108,P009213,0 days 00:12:32,13,38,25
85,MAD,P005928,P006540,0 days 00:11:25,5,25,20
85,MAD,P003733,P004887,0 days 00:10:24,6,17,11
85,MAD,P003733,PCVM,0 days 00:10:24,6,17,11
85,MAD,P005791,P006540,0 days 00:10:18,7,25,18
85,MAD,P003108,PTGB,0 days 00:10:01,-1,28,29
85,MAD,P001392,P003108,0 days 00:09:56,17,32,15
85,MAD,P003108,P004887,0 days 00:09:42,6,30,24
85,MAD,P009005,PBMT,0 days 00:09:32,0,13,13
85,MAD,P001392,P006540,0 days 00:08:47,7,22,15
85,MAD,P003108,PCVM,0 days 00:08:35,8,30,22
85,MAD,PBMT,PCVM,0 days 00:08:00,-2,8,10
85,MAD,P009005,PCVM,0 days 00:08:00,-2,8,10
85,MAD,P006540,P009213,0 days 00:07:34,3,16,13
85,MAD,P004887,PBMT,0 days 00:07:23,1,7,6
85,MAD,P004887,P009005,0 days 00:07:23,1,7,6
85,MAD,P003733,PBMT,0 days 00:07:23,1,7,6
85,MAD,P003733,P009005,0 days 00:07:23,1,7,6
85,MAD,P004887,PTGB,0 days 00:06:41,1,20,19
85,MAD,P003108,P006540,0 days 00:06:24,3,20,17
85,MAD,P004887,P009213,0 days 00:06:02,7,19,12
85,MAD,P009213,PCVM,0 days 00:06:02,7,19,12
85,MAD,P005928,PTGB,0 days 00:05:55,-2,13,15
85,MAD,PCVM,PTGB,0 days 00:05:34,3,20,17
85,MAD,P006540,PTGB,0 days 00:05:11,-1,14,15
85,MAD,P005791,PTGB,0 days 00:04:44,0,13,13
85,MAD,P005791,P009005,0 days 00:04:18,6,13,7
85,MAD,P005791,PBMT,0 days 00:03:50,-3,11,14
85,MAD,P005928,P009005,0 days 00:03:45,9,12,3
85,MAD,P004887,P006540,0 days 00:03:40,-1,11,12
85,MAD,P005928,PBMT,0 days 00:03:17,0,10,10
85,MAD,PBMT,PTGB,0 days 00:03:17,0,10,10
85,MAD,P003733,P009213,0 days 00:03:01,5,10,5
85,MAD,P003108,P003733,0 days 00:03:01,5,10,5
85,MAD,P009213,PTGB,0 days 00:03:01,2,9,7
85,MAD,P001392,P009005,0 days 00:02:50,4,8,4
85,MAD,P006540,PCVM,0 days 00:02:33,1,11,10
85,MAD,P003108,P009005,0 days 00:02:17,7,7,0
85,MAD,P003108,PBMT,0 days 00:01:49,-2,5,7
85,MAD,P009005,PTGB,0 days 00:01:32,2,5,3
85,MAD,P004887,P005928,0 days 00:01:07,-2,0,2
85,MAD,P001392,PBMT,0 days 00:00:37,-3,1,4
85,MAD,P001392,PCVM,0 days 00:00:37,-3,1,4
85,MAD,P005791,PCVM,0 days 00:00:37,-3,1,4
85,BER,P008173,P008384,0 days 00:19:46,-14,36,50
85,BER,P008211,P008384,0 days 00:17:49,-13,34,47
85,BER,P008384,P010791,0 days 00:17:37,-18,34,52
85,BER,P003958,P008173,0 days 00:17:35,-7,36,43
85,BER,P008173,P008211,0 days 00:16:54,-9,33,42
85,BER,P007025,P007550,0 days 00:16:49,-8,30,38
85,BER,P008173,P010791,0 days 00:16:42,-14,33,47
85,BER,P006251,P007025,0 days 00:16:26,-7,27,34
85,BER,P008211,P010791,0 days 00:16:22,-15,34,49
85,BER,P003958,P008384,0 days 00:16:20,-8,32,40
85,BER,P003958,P008211,0 days 00:16:15,-6,32,38
85,BER,P006251,P007550,0 days 00:15:47,-7,27,34
85,BER,P003958,P010791,0 days 00:14:14,-9,32,41
85,BER,P008384,P011934,0 days 00:11:53,-5,22,27
85,BER,P007550,P008211,0 days 00:10:36,-10,23,33
85,BER,P008211,P011934,0 days 00:10:27,-13,16,29
85,BER,P007025,P008384,0 days 00:09:58,-1,15,16
85,BER,P007025,P008211,0 days 00:09:41,-6,22,28
85,BER,P007550,P011934,0 days 00:09:36,-11,15,26
85,BER,P007025,P010791,0 days 00:09:31,-9,18,27
85,BER,P007025,P011934,0 days 00:08:32,-10,10,20
85,BER,P007550,P008384,0 days 00:08:01,0,13,13
85,BER,P006251,P006819,0 days 00:07:46,2,17,15
85,BER,P006819,P007550,0 days 00:07:46,2,17,15
85,BER,P006819,P007025,0 days 00:07:46,2,17,15
85,BER,P010791,P011934,0 days 00:07:29,-13,13,26
85,BER,P006251,P008211,0 days 00:07:24,-6,15,21
85,BER,P006251,P011934,0 days 00:07:22,-8,10,18
85,BER,P008173,P011934,0 days 00:07:06,-5,11,16
85,BER,P006251,P008384,0 days 00:06:30,3,8,5
85,BER,P007550,P010791,0 days 00:06:19,-9,12,21
85,BER,P007025,P008173,0 days 00:05:22,-3,11,14
85,BER,P003958,P007025,0 days 00:04:39,-2,14,16
85,BER,P006819,P008211,0 days 00:04:32,2,15,13
85,BER,P003958,P011934,0 days 00:04:23,1,7,6
85,BER,P006251,P010791,0 days 00:03:50,-5,4,9
85,BER,P006819,P008384,0 days 00:03:14,0,2,2
85,BER,P003958,P007550,0 days 00:01:02,-1,3,4
85,BER,P006251,P008173,0 days 00:00:39,0,0,0
86,VIR,P001133,P001844,0 days 00:23:04,5,54,49
86,VIR,P001133,PBCN,0 days 00:19:56,-1,47,48
86,VIR,P001844,PBCN,0 days 00:18:11,-5,41,46
86,VIR,P001133,P003048,0 days 00:17:01,-1,35,36
86,VIR,P001844,P011192,0 days 00:16:47,-3,30,33
86,VIR,P003048,PBCN,0 days 00:16:16,-1,35,36
86,VIR,P001844,P003048,0 days 00:16:03,-3,31,34
86,VIR,P001133,P011192,0 days 00:15:36,4,34,30
86,VIR,P010781,P012714,0 days 00:14:12,3,34,31
86,VIR,P001133,P010781,0 days 00:14:02,8,40,32
86,VIR,P001844,P004007,0 days 00:12:20,11,26,15
86,VIR,P011192,P012714,0 days 00:12:15,7,28,21
86,VIR,P003527,P012714,0 days 00:11:43,-1,20,21
86,VIR,P006739,P010781,0 days 00:11:17,4,24,20
86,VIR,P001844,P012714,0 days 00:11:02,8,30,22
86,VIR,P004007,P012714,0 days 00:10:20,2,20,18
86,VIR,P001133,P012714,0 days 00:09:58,13,32,19
86,VIR,P003527,P004007,0 days 00:09:55,-5,14,19
86,VIR,P001844,P010781,0 days 00:09:38,1,27,26
86,VIR,P006739,P012714,0 days 00:09:27,0,18,18
86,VIR,P001133,P004007,0 days 00:08:32,13,21,8
86,VIR,P010781,PBCN,0 days 00:08:22,1,24,23
86,VIR,P010781,P011192,0 days 00:07:21,4,18,14
86,VIR,P001844,P003527,0 days 00:07:20,2,13,11
86,VIR,P003527,P011192,0 days 00:07:01,0,11,11
86,VIR,P011192,PBCN,0 days 00:06:54,-8,12,20
86,VIR,P003527,P010781,0 days 00:06:53,-3,11,14
86,VIR,P003048,P011192,0 days 00:06:43,-7,9,16
86,VIR,P004007,P010781,0 days 00:06:35,2,13,11
86,VIR,P004007,P011192,0 days 00:06:31,3,11,8
86,VIR,P003048,P004007,0 days 00:06:25,6,13,7
86,VIR,P001133,P006739,0 days 00:05:53,8,17,9
86,VIR,P003527,P006739,0 days 00:05:51,-4,7,11
86,VIR,P004007,P006739,0 days 00:05:38,-2,9,11
86,VIR,P004007,PBCN,0 days 00:05:36,6,13,7
86,VIR,P003048,P010781,0 days 00:05:20,0,13,13
86,VIR,P006739,P011192,0 days 00:04:36,4,11,7
86,VIR,P012714,PBCN,0 days 00:02:59,0,10,10
86,VIR,P003048,P006739,0 days 00:01:57,2,4,2
86,VIR,P006739,PBCN,0 days 00:01:50,4,6,2
86,VIR,P001133,P003527,0 days 00:01:46,3,4,1
86,VIR,P001844,P006739,0 days 00:00:27,0,0,0
86,VIR,P003048,P003527,0 days 00:00:27,0,0,0
86,ULK,P006661,P008962,0 days 00:28:59,0,64,64
86,ULK,P008962,P011157,0 days 00:25:36,-2,57,59
86,ULK,P005844,P008962,0 days 00:23:00,-1,54,55
86,ULK,P006661,P011157,0 days 00:21:57,2,53,51
86,ULK,P004004,P008962,0 days 00:21:34,6,51,45
86,ULK,P005844,P006661,0 days 00:21:14,5,54,49
86,ULK,P005844,P011157,0 days 00:19:46,-2,46,48
86,ULK,P004004,P006661,0 days 00:19:16,6,47,41
86,ULK,P004004,P005844,0 days 00:16:00,11,44,33
86,ULK,P004004,P011157,0 days 00:15:56,8,40,32
86,ULK,P001932,P008962,0 days 00:14:50,-12,23,35
86,ULK,P001932,P002968,0 days 00:12:45,-4,22,26
86,ULK,P001932,P011157,0 days 00:11:58,-10,21,31
86,ULK,P001932,P006661,0 days 00:10:46,-6,19,25
86,ULK,P001932,P011052,0 days 00:10:31,-6,13,19
86,ULK,P001932,P002969,0 days 00:09:00,-4,11,15
86,ULK,P002968,P011980,0 days 00:08:37,-7,12,19
86,ULK,P002969,P011052,0 days 00:08:27,-2,11,13
86,ULK,P002968,P008962,0 days 00:07:28,-7,12,19
86,ULK,P002968,P011052,0 days 00:07:22,-4,11,15
86,ULK,P001932,P005844,0 days 00:07:00,-12,10,22
86,ULK,P002968,P002969,0 days 00:06:57,-2,11,13
86,ULK,P002969,P011980,0 days 00:06:57,-2,11,13
86,ULK,P011052,P011980,0 days 00:06:57,-2,11,13
86,ULK,P001932,P011980,0 days 00:06:57,-2,11,13
86,ULK,P008962,P011052,0 days 00:06:29,-1,10,11
86,ULK,P002968,P011157,0 days 00:05:23,0,11,11
86,ULK,P002968,P006661,0 days 00:04:45,-5,8,13
86,ULK,P006661,P011052,0 days 00:04:43,5,10,5
86,ULK,P005844,P011052,0 days 00:04:35,-3,8,11
86,ULK,P002968,P004004,0 days 00:03:58,-5,5,10
86,ULK,P001932,P004004,0 days 00:03:21,0,6,6
86,ULK,P004004,P011052,0 days 00:03:19,5,10,5
86,ULK,P002969,P006661,0 days 00:02:36,-2,0,2
86,ULK,P002969,P008962,0 days 00:02:36,-2,0,2
86,ULK,P004004,P011980,0 days 00:01:40,-5,1,6
86,ULK,P006661,P011980,0 days 00:01:40,-5,1,6
86,ULK,P008962,P011980,0 days 00:01:40,-5,1,6
86,ULK,P011052,P011157,0 days 00:01:21,-4,0,4
86,ULK,P002969,P004004,0 days 00:01:12,-2,0,2
86,ULK,P002969,P011157,0 days 00:00:27,0,0,0
86,ULK,P002968,P005844,0 days 00:00:25,-2,0,2
87,IST,P004888,P011078,0 days 00:30:11,1,73,72
87,IST,P004888,P007200,0 days 00:29:37,12,77,65
87,IST,P007200,P011078,0 days 00:27:02,5,70,65
87,IST,P004888,P006590,0 days 00:24:20,11,67,56
87,IST,P006590,P011078,0 days 00:21:45,4,60,56
87,IST,P006590,P007200,0 days 00:21:11,15,64,49
87,IST,P004554,P011078,0 days 00:18:51,0,41,41
87,IST,P004554,P004888,0 days 00:18:35,1,39,38
87,IST,P007200,P011981,0 days 00:18:17,8,52,44
87,IST,P004888,P011981,0 days 00:17:46,8,51,43
87,IST,P004554,P006590,0 days 00:16:05,3,35,32
87,IST,P011078,P011981,0 days 00:14:55,2,42,40
87,IST,P004554,P007200,0 days 00:14:55,5,35,30
87,IST,P009664,P011078,0 days 00:14:24,3,34,31
87,IST,P004888,P009664,0 days 00:14:10,12,37,25
87,IST,P006590,P009664,0 days 00:13:18,2,33,31
87,IST,P006590,P011981,0 days 00:11:50,9,42,33
87,IST,P007200,P009664,0 days 00:11:31,14,37,23
87,IST,P009664,P011981,0 days 00:09:29,18,31,13
87,IST,P004554,P009664,0 days 00:08:16,-5,16,21
87,IST,P004888,P012710,0 days 00:06:24,-8,9,17
87,IST,P007200,P012710,0 days 00:06:24,-8,9,17
87,IST,P011078,P012710,0 days 00:06:24,-8,9,17
87,IST,P004554,P012710,0 days 00:03:18,-4,4,8
87,IST,P011981,P012710,0 days 00:03:06,-4,5,9
87,IST,P004888,P006372,0 days 00:02:18,-4,5,9
87,IST,P006372,P006590,0 days 00:02:18,-4,5,9
87,IST,P004888,P010516,0 days 00:02:11,-5,2,7
87,IST,P007200,P010516,0 days 00:02:11,-5,2,7
87,IST,P010516,P011981,0 days 00:02:11,-5,2,7
87,IST,P006372,P007200,0 days 00:01:48,-2,2,4
87,IST,P004554,P006372,0 days 00:01:32,0,2,2
87,IST,P010516,P011078,0 days 00:01:10,-5,0,5
87,IST,P006590,P010516,0 days 00:01:01,0,2,2
87,IST,P006372,P011981,0 days 00:00:46,-4,3,7
87,IST,P006372,P011078,0 days 00:00:30,-2,3,5
87,PAR,P004172,P012742,0 days 00:25:33,2,62,60
87,PAR,P007400,P012742,0 days 00:24:36,9,69,60
87,PAR,P007400,P012743,0 days 00:21:30,1,55,54
87,PAR,P004172,P007400,0 days 00:20:25,-3,52,55
87,PAR,P012742,P012743,0 days 00:19:36,14,58,44
87,PAR,P012096,P012742,0 days 00:18:59,5,44,39
87,PAR,P004172,P012743,0 days 00:18:57,8,54,46
87,PAR,P008987,P012742,0 days 00:17:11,0,46,46
87,PAR,P007400,P012096,0 days 00:17:08,7,43,36
87,PAR,P004172,P012096,0 days 00:16:05,-1,34,35
87,PAR,P008987,P012743,0 days 00:16:04,-5,43,48
87,PAR,P004058,P008987,0 days 00:15:50,-7,28,35
87,PAR,P007400,P008987,0 days 00:15:48,-10,41,51
87,PAR,P004172,P008987,0 days 00:14:40,-12,37,49
87,PAR,P012096,P012743,0 days 00:11:15,7,26,19
87,PAR,P000956,P008987,0 days 00:10:35,-15,18,33
87,PAR,P004058,P012743,0 days 00:10:07,0,22,22
87,PAR,P004058,P011051,0 days 00:10:04,-6,18,24
87,PAR,P004058,P012742,0 days 00:10:04,8,26,18
87,PAR,P008987,P011051,0 days 00:08:43,-8,12,20
87,PAR,P000956,P004058,0 days 00:08:08,-12,11,23
87,PAR,P000956,P012743,0 days 00:07:52,-12,13,25
87,PAR,P004058,P007400,0 days 00:07:31,0,18,18
87,PAR,P008987,P012096,0 days 00:06:41,-7,11,18
87,PAR,P011051,P012742,0 days 00:05:50,1,14,13
87,PAR,P000956,P011051,0 days 00:05:44,-3,10,13
87,PAR,P004058,P004172,0 days 00:05:36,0,12,12
87,PAR,P004058,P012096,0 days 00:05:28,1,13,12
87,PAR,P000956,P007400,0 days 00:04:36,-6,11,17
87,PAR,P011051,P012743,0 days 00:03:55,-5,5,10
87,PAR,P004172,P011051,0 days 00:03:50,-5,3,8
87,PAR,P011051,P012096,0 days 00:03:32,4,11,7
87,PAR,P007400,P011051,0 days 00:02:42,2,11,9
87,PAR,P000956,P012096,0 days 00:02:04,-4,2,6
87,PAR,P000956,P004172,0 days 00:01:58,-9,2,11
87,PAR,P000956,P012742,0 days 00:01:23,1,5,4
88,RED,P006436,PJDR,0 days 00:19:45,-10,34,44
88,RED,P006436,P007960,0 days 00:19:41,-9,36,45
88,RED,P002553,P007960,0 days 00:19:30,-15,33,48
88,RED,P006436,P009035,0 days 00:18:09,-3,34,37
88,RED,P000848,P007960,0 days 00:17:16,-7,35,42
88,RED,P007960,PJDR,0 days 00:17:14,-6,34,40
88,RED,P002553,P006436,0 days 00:17:06,-13,26,39
88,RED,P000848,P012044,0 days 00:16:25,-11,30,41
88,RED,P007960,P009035,0 days 00:16:01,-2,32,34
88,RED,P000848,P002553,0 days 00:15:41,-19,27,46
88,RED,P002553,P009035,0 days 00:14:48,-10,26,36
88,RED,P000848,P006436,0 days 00:14:38,-11,25,36
88,RED,P009035,PJDR,0 days 00:13:25,4,28,24
88,RED,P002553,PJDR,0 days 00:13:19,-15,17,32
88,RED,P000848,P009035,0 days 00:13:10,-5,26,31
88,RED,P002553,P012044,0 days 00:12:54,-9,25,34
88,RED,P009035,P012044,0 days 00:10:01,-16,15,31
88,RED,P002553,P008966,0 days 00:09:42,0,17,17
88,RED,P000848,PJDR,0 days 00:09:19,-2,22,24
88,RED,P000848,P008966,0 days 00:08:58,0,19,19
88,RED,P007960,P012044,0 days 00:08:49,-4,16,20
88,RED,P006436,P008966,0 days 00:06:47,-3,9,12
88,RED,P006436,P012044,0 days 00:06:37,-10,8,18
88,RED,P002553,P004720,0 days 00:06:36,-4,12,16
88,RED,P007960,P008966,0 days 00:06:32,3,14,11
88,RED,P008966,P012044,0 days 00:06:20,4,15,11
88,RED,P004720,P012044,0 days 00:06:07,-8,12,20
88,RED,P000848,P004720,0 days 00:04:55,-4,10,14
88,RED,P006436,P012711,0 days 00:04:47,-9,4,13
88,RED,P009035,P012711,0 days 00:04:47,-9,4,13
88,RED,P004720,P009035,0 days 00:04:31,-7,7,14
88,RED,P012044,P012711,0 days 00:04:17,-9,4,13
88,RED,P008966,PJDR,0 days 00:04:12,-3,7,10
88,RED,P004720,P008966,0 days 00:03:57,2,10,8
88,RED,P004720,P006436,0 days 00:03:50,-1,7,8
88,RED,P006436,P011224,0 days 00:03:32,1,5,4
88,RED,P002553,P011224,0 days 00:03:32,1,5,4
88,RED,P008966,P011224,0 days 00:03:32,1,5,4
88,RED,P000848,P012711,0 days 00:03:18,-5,2,7
88,RED,P004720,P011224,0 days 00:02:04,3,5,2
88,RED,P004720,P012711,0 days 00:01:29,-4,2,6
88,RED,P011224,PJDR,0 days 00:01:28,-2,0,2
88,RED,P012711,PJDR,0 days 00:00:30,0,0,0
88,RED,P004720,P007960,0 days 00:00:17,0,0,0
88,RED,P004720,PJDR,0 days 00:00:06,3,3,0
88,RED,P012044,PJDR,0 days 00:00:06,3,3,0
88,MIL,P007032,P007831,0 days 00:27:22,22,66,44
88,MIL,P000796,P007032,0 days 00:24:15,21,59,38
88,MIL,P002849,P007831,0 days 00:23:08,24,58,34
88,MIL,P007201,P007831,0 days 00:22:42,18,55,37
88,MIL,P007032,P007201,0 days 00:22:42,18,55,37
88,MIL,P002849,P007032,0 days 00:21:53,27,56,29
88,MIL,P000796,P002849,0 days 00:21:11,30,58,28
88,MIL,P002849,P007201,0 days 00:19:44,26,53,27
88,MIL,P000796,P007831,0 days 00:19:24,20,48,28
88,MIL,P007032,P011205,0 days 00:16:25,7,37,30
88,MIL,P000796,P007201,0 days 00:14:59,21,42,21
88,MIL,P000796,P011205,0 days 00:13:06,11,32,21
88,MIL,P007831,P011205,0 days 00:12:55,0,28,28
88,MIL,P006509,P011205,0 days 00:11:50,-5,22,27
88,MIL,P002849,P011205,0 days 00:11:32,14,32,18
88,MIL,P000796,P006509,0 days 00:10:30,0,20,20
88,MIL,P007201,P011205,0 days 00:09:19,7,23,16
88,MIL,P009960,P011205,0 days 00:08:55,-7,15,22
88,MIL,P006509,P009960,0 days 00:07:54,-7,13,20
88,MIL,P000796,P009960,0 days 00:07:34,-1,13,14
88,MIL,P007032,P009960,0 days 00:06:25,1,13,12
88,MIL,P000796,P006701,0 days 00:06:07,8,15,7
88,MIL,P006509,P007032,0 days 00:06:06,-1,12,13
88,MIL,P002849,P006701,0 days 00:05:31,10,15,5
88,MIL,P006701,P011205,0 days 00:05:26,2,14,12
88,MIL,P006509,P006701,0 days 00:04:38,-3,9,12
88,MIL,P002849,P006509,0 days 00:04:30,0,10,10
88,MIL,P002812,P007032,0 days 00:04:28,-5,8,13
88,MIL,P002812,P007831,0 days 00:04:28,-5,8,13
88,MIL,P002812,P007201,0 days 00:03:46,-3,7,10
88,MIL,P002812,P011205,0 days 00:03:46,-3,7,10
88,MIL,P007831,P009960,0 days 00:02:55,-6,4,10
88,MIL,P006509,P007831,0 days 00:02:36,-8,3,11
88,MIL,P006701,P007831,0 days 00:01:34,-1,2,3
88,MIL,P006701,P007032,0 days 00:01:28,2,2,0
88,MIL,P002849,P009960,0 days 00:01:15,-3,2,5
88,MIL,P006701,P007201,0 days 00:00:48,5,5,0
88,MIL,P002812,P006509,0 days 00:00:42,-2,1,3
88,MIL,P000796,P002812,0 days 00:00:42,-2,1,3
88,MIL,P006701,P009960,0 days 00:00:42,-5,0,5
88,MIL,P001518,P006509,0 days 00:00:41,-1,1,2
88,MIL,P001518,P006701,0 days 00:00:41,-1,1,2
88,MIL,P001518,P011205,0 days 00:00:41,-1,1,2
88,MIL,P001518,P011926,0 days 00:00:41,-1,1,2
88,MIL,P006509,P011926,0 days 00:00:41,-1,1,2
88,MIL,P006701,P011926,0 days 00:00:41,-1,1,2
88,MIL,P011205,P011926,0 days 00:00:41,-1,1,2
89,OLY,P008829,P010612,0 days 00:24:59,8,56,48
89,OLY,P008855,P010612,0 days 00:21:57,15,49,34
89,OLY,P008811,P010612,0 days 00:21:52,11,50,39
89,OLY,P008811,P008855,0 days 00:20:19,12,42,30
89,OLY,P008829,P008855,0 days 00:19:10,4,36,32
89,OLY,P008811,P008829,0 days 00:18:54,2,37,35
89,OLY,P001255,P008829,0 days 00:18:20,2,36,34
89,OLY,P001255,P010612,0 days 00:16:07,2,32,30
89,OLY,P001255,P008855,0 days 00:15:28,2,30,28
89,OLY,P001255,P008811,0 days 00:12:33,-1,21,22
89,OLY,P006302,P011983,0 days 00:11:38,3,29,26
89,OLY,P003941,P006302,0 days 00:11:32,4,25,21
89,OLY,P006302,P008829,0 days 00:11:02,9,32,23
89,OLY,P003941,P011983,0 days 00:10:56,3,22,19
89,OLY,P003941,P010392,0 days 00:10:38,0,18,18
89,OLY,P008829,P010392,0 days 00:10:04,8,23,15
89,OLY,P010392,P011983,0 days 00:09:50,0,16,16
89,OLY,P006589,P011983,0 days 00:09:33,4,21,17
89,OLY,P008829,P011983,0 days 00:09:32,7,26,19
89,OLY,P010612,P011983,0 days 00:09:15,11,31,20
89,OLY,P003941,P008829,0 days 00:08:47,12,26,14
89,OLY,P008855,P010392,0 days 00:08:39,2,16,14
89,OLY,P006302,P010392,0 days 00:08:30,1,15,14
89,OLY,P008811,P011983,0 days 00:08:09,8,25,17
89,OLY,P008855,P011983,0 days 00:07:27,8,18,10
89,OLY,P006589,P010392,0 days 00:07:05,-5,8,13
89,OLY,P006589,P008855,0 days 00:06:20,10,18,8
89,OLY,P006302,P010612,0 days 00:06:00,2,20,18
89,OLY,P003941,P006589,0 days 00:05:25,-5,6,11
89,OLY,P010392,P010612,0 days 00:05:06,3,11,8
89,OLY,P001255,P010392,0 days 00:04:44,-1,9,10
89,OLY,P006589,P008811,0 days 00:04:23,9,15,6
89,OLY,P008811,P010392,0 days 00:04:00,4,8,4
89,OLY,P003941,P010612,0 days 00:03:34,7,14,7
89,OLY,P006302,P006589,0 days 00:03:28,-6,3,9
89,OLY,P001255,P003941,0 days 00:03:16,4,10,6
89,OLY,P006589,P010612,0 days 00:02:58,9,13,4
89,OLY,P006302,P008811,0 days 00:02:58,-1,10,11
89,OLY,P001255,P006302,0 days 00:02:52,0,6,6
89,OLY,P003941,P008855,0 days 00:02:40,3,7,4
89,ZAL,P002676,P010390,0 days 00:21:08,-8,34,42
89,ZAL,P010390,P011218,0 days 00:20:11,-6,31,37
89,ZAL,P002676,P011218,0 days 00:17:17,-7,26,33
89,ZAL,P002676,P007109,0 days 00:17:14,-5,27,32
89,ZAL,P002329,P003210,0 days 00:16:28,-17,28,45
89,ZAL,P002329,P010390,0 days 00:15:40,-3,28,31
89,ZAL,P007109,P010390,0 days 00:14:52,-5,21,26
89,ZAL,P003210,P010390,0 days 00:14:48,4,33,29
89,ZAL,P007109,P011218,0 days 00:14:31,-6,20,26
89,ZAL,P003210,P012715,0 days 00:13:32,-1,28,29
89,ZAL,P002329,P011218,0 days 00:13:28,1,28,27
89,ZAL,P002329,P002676,0 days 00:12:49,-13,20,33
89,ZAL,P002676,P003210,0 days 00:12:01,-6,24,30
89,ZAL,P002329,P007109,0 days 00:11:48,-8,23,31
89,ZAL,P002329,P012715,0 days 00:11:47,-2,24,26
89,ZAL,P011218,P012715,0 days 00:09:44,4,22,18
89,ZAL,P010390,P012715,0 days 00:09:40,3,20,17
89,ZAL,P002676,P012715,0 days 00:09:36,-2,23,25
89,ZAL,P003211,P007109,0 days 00:08:58,-7,12,19
89,ZAL,P003211,P010390,0 days 00:08:31,3,13,10
89,ZAL,P003210,P003211,0 days 00:08:25,-6,16,22
89,ZAL,P002676,P003211,0 days 00:08:16,-3,10,13
89,ZAL,P003210,P011218,0 days 00:07:35,3,18,15
89,ZAL,P003210,P007109,0 days 00:06:59,-4,17,21
89,ZAL,P002329,P003211,0 days 00:06:26,-9,9,18
89,ZAL,P002676,P007513,0 days 00:06:07,-2,10,12
89,ZAL,P003210,P005504,0 days 00:05:48,-15,8,23
89,ZAL,P002329,P005504,0 days 00:05:48,-15,8,23
89,ZAL,P007513,P011218,0 days 00:05:13,0,9,9
89,ZAL,P003211,P011218,0 days 00:04:55,-3,3,6
89,ZAL,P003211,P005504,0 days 00:04:49,-12,6,18
89,ZAL,P007513,P010390,0 days 00:04:41,-2,7,9
89,ZAL,P006860,P007513,0 days 00:04:16,4,11,7
89,ZAL,P007109,P007513,0 days 00:04:10,-3,6,9
89,ZAL,P002676,P006860,0 days 00:03:47,-5,6,11
89,ZAL,P002329,P007513,0 days 00:03:35,1,9,8
89,ZAL,P002329,P006860,0 days 00:03:11,-3,7,10
89,ZAL,P005504,P007109,0 days 00:03:03,-10,4,14
89,ZAL,P003211,P012715,0 days 00:03:00,1,7,6
89,ZAL,P006860,P012715,0 days 00:02:57,-2,6,8
89,ZAL,P003210,P006860,0 days 00:02:55,-7,4,11
89,ZAL,P007109,P012715,0 days 00:02:41,2,8,6
89,ZAL,P007513,P012715,0 days 00:02:31,1,6,5
89,ZAL,P003210,P007513,0 days 00:02:17,-3,4,7
89,ZAL,P006860,P010390,0 days 00:02:05,-2,5,7
89,ZAL,P006860,P011218,0 days 00:01:47,3,7,4
89,ZAL,P005504,P012715,0 days 00:01:46,-2,4,6
89,ZAL,P002676,P012784,0 days 00:01:02,2,4,2
89,ZAL,P006860,P012784,0 days 00:01:02,2,4,2
89,ZAL,P007513,P012784,0 days 00:01:02,2,4,2
89,ZAL,P012715,P012784,0 days 00:01:02,2,4,2
89,ZAL,P002676,P005504,0 days 00:00:59,-3,0,3
89,ZAL,P005504,P007513,0 days 00:00:48,-2,2,4
89,ZAL,P006860,P007109,0 days 00:00:48,2,2,0
89,ZAL,P005504,P011218,0 days 00:00:11,-1,0,1
90,BAS,P009048,P010444,0 days 00:26:47,-3,47,50
90,BAS,P007230,P010444,0 days 00:26:27,7,53,46
90,BAS,P004761,P010444,0 days 00:25:03,-5,43,48
90,BAS,P004761,P009048,0 days 00:24:15,-3,43,46
90,BAS,P007230,P009048,0 days 00:22:11,0,42,42
90,BAS,P004761,P007230,0 days 00:21:35,-4,38,42
90,BAS,P009048,P012201,0 days 00:16:57,-10,26,36
90,BAS,P010444,P012201,0 days 00:16:57,-10,26,36
90,BAS,P007230,P012201,0 days 00:16:56,-12,27,39
90,BAS,P004761,P012201,0 days 00:16:12,-14,22,36
90,BAS,P003198,P007230,0 days 00:15:34,7,35,28
90,BAS,P007230,P011948,0 days 00:15:11,7,34,27
90,BAS,P007230,P012765,0 days 00:13:02,-1,26,27
90,BAS,P010444,P011948,0 days 00:12:24,14,28,14
90,BAS,P003198,P010444,0 days 00:11:29,10,26,16
90,BAS,P011948,P012765,0 days 00:10:51,-1,22,23
90,BAS,P011948,P012201,0 days 00:09:42,-4,15,19
90,BAS,P009048,P011948,0 days 00:09:07,7,19,12
90,BAS,P004603,P012765,0 days 00:08:30,-12,11,23
90,BAS,P004603,P007230,0 days 00:08:30,-12,11,23
90,BAS,P003198,P012765,0 days 00:08:21,4,20,16
90,BAS,P004761,P011948,0 days 00:07:46,7,17,10
90,BAS,P003198,P011948,0 days 00:07:31,4,18,14
90,BAS,P003198,P004761,0 days 00:07:22,3,15,12
90,BAS,P004603,P011948,0 days 00:07:20,-10,11,21
90,BAS,P003198,P009048,0 days 00:07:13,3,15,12
90,BAS,P012201,P012765,0 days 00:04:46,-3,8,11
90,BAS,P004603,P012201,0 days 00:04:41,-5,6,11
90,BAS,P010444,P012765,0 days 00:04:27,9,13,4
90,BAS,P003198,P004603,0 days 00:03:49,-7,5,12
90,BAS,P004761,P012765,0 days 00:02:07,-2,2,4
90,BAS,P007230,P008850,0 days 00:01:26,4,6,2
90,BAS,P008850,P009048,0 days 00:01:22,2,4,2
90,BAS,P008850,P010444,0 days 00:01:22,2,4,2
90,BAS,P004603,P004761,0 days 00:01:08,-2,0,2
90,BAS,P003198,P008850,0 days 00:00:52,2,4,2
90,BAS,P008850,P012201,0 days 00:00:36,4,4,0
90,BAS,P003198,P012201,0 days 00:00:05,2,2,0
90,BAS,P008850,P012765,0 days 00:00:04,2,2,0
90,BAS,P004603,P008850,0 days 00:00:02,0,0,0
90,MCO,P005985,P010588,0 days 00:23:50,1,42,41
90,MCO,P005985,P011212,0 days 00:23:39,1,41,40
90,MCO,P010588,P011226,0 days 00:23:27,-8,34,42
90,MCO,P005985,P011226,0 days 00:22:49,-3,37,40
90,MCO,P010588,P011212,0 days 00:22:09,0,40,40
90,MCO,P011212,P011226,0 days 00:18:04,-10,23,33
90,MCO,P005985,PLCZ,0 days 00:17:49,13,46,33
90,MCO,P011226,P011231,0 days 00:15:58,-9,22,31
90,MCO,P011226,P012709,0 days 00:14:26,5,34,29
90,MCO,P005985,P011231,0 days 00:13:48,-5,20,25
90,MCO,P004197,P005985,0 days 00:13:18,4,31,27
90,MCO,P004197,PLCZ,0 days 00:12:45,6,31,25
90,MCO,P011212,PLCZ,0 days 00:12:21,10,33,23
90,MCO,P011212,P011231,0 days 00:12:10,-8,12,20
90,MCO,P010588,P011231,0 days 00:11:47,-11,10,21
90,MCO,P004197,P011212,0 days 00:11:23,8,29,21
90,MCO,P010588,PLCZ,0 days 00:10:41,12,32,20
90,MCO,P011196,P011226,0 days 00:10:24,0,21,21
90,MCO,P010588,P012709,0 days 00:10:12,5,24,19
90,MCO,P011196,P012709,0 days 00:09:00,3,21,18
90,MCO,P005985,P012709,0 days 00:08:38,8,23,15
90,MCO,P004790,P005985,0 days 00:07:11,-1,12,13
90,MCO,P011226,PLCZ,0 days 00:06:26,5,17,12
90,MCO,P004197,P010588,0 days 00:06:16,5,19,14
90,MCO,P004790,P011212,0 days 00:06:12,-1,10,11
90,MCO,P004790,PLCZ,0 days 00:06:12,-1,10,11
90,MCO,P004197,P004790,0 days 00:06:12,-1,10,11
90,MCO,P010588,P011196,0 days 00:06:10,0,11,11
90,MCO,P011196,P011212,0 days 00:06:02,-5,9,14
90,MCO,P011212,P012709,0 days 00:05:48,-3,11,14
90,MCO,P005985,P011196,0 days 00:05:46,2,12,10
90,MCO,P011231,P012709,0 days 00:04:35,-3,10,13
90,MCO,P012709,PLCZ,0 days 00:04:06,5,11,6
90,MCO,P011196,P011231,0 days 00:03:15,0,8,8
90,MCO,P004197,P011226,0 days 00:01:55,-4,2,6
90,MCO,P004197,P011231,0 days 00:01:23,-2,2,4
90,MCO,P004790,P011196,0 days 00:00:59,0,2,2
90,MCO,P004790,P011226,0 days 00:00:59,0,2,2
90,MCO,P004790,P012709,0 days 00:00:59,0,2,2
90,MCO,P011231,PLCZ,0 days 00:00:56,2,4,2
91,MCO,P005985,P011226,0 days 00:28:08,13,66,53
91,MCO,P005985,P010588,0 days 00:24:42,11,59,48
91,MCO,P010588,P011226,0 days 00:24:27,11,59,48
91,MCO,P004197,P005985,0 days 00:14:57,0,29,29
91,MCO,P004197,P010588,0 days 00:14:57,0,29,29
91,MCO,P004197,P011226,0 days 00:14:42,0,29,29
91,MCO,P005985,P011212,0 days 00:14:21,7,31,24
91,MCO,P011212,P011231,0 days 00:13:39,-2,23,25
91,MCO,P005985,PLCZ,0 days 00:13:05,10,30,20
91,MCO,P011226,PLCZ,0 days 00:13:05,10,30,20
91,MCO,P004790,P011212,0 days 00:12:30,-2,21,23
91,MCO,P011212,P011226,0 days 00:12:27,8,28,20
91,MCO,P011212,P012709,0 days 00:11:37,-5,19,24
91,MCO,P011196,P011212,0 days 00:11:34,-4,19,23
91,MCO,P010588,P011212,0 days 00:10:37,8,26,18
91,MCO,P005985,P011196,0 days 00:10:23,3,25,22
91,MCO,P010588,P011196,0 days 00:10:20,6,27,21
91,MCO,P011212,PLCZ,0 days 00:10:16,2,21,19
91,MCO,P004790,P012709,0 days 00:10:01,-7,14,21
91,MCO,P011231,P012709,0 days 00:09:58,-4,16,20
91,MCO,P010588,PLCZ,0 days 00:09:24,8,23,15
91,MCO,P011196,P011226,0 days 00:08:44,4,22,18
91,MCO,P004790,P011231,0 days 00:08:22,-6,11,17
91,MCO,P011231,PLCZ,0 days 00:07:50,2,16,14
91,MCO,P011196,P012709,0 days 00:07:28,-5,10,15
91,MCO,P004197,PLCZ,0 days 00:06:58,8,18,10
91,MCO,P011196,P011231,0 days 00:06:48,1,16,15
91,MCO,P004790,P011196,0 days 00:05:52,-7,5,12
91,MCO,P011226,P011231,0 days 00:04:48,4,16,12
91,MCO,P005985,P011231,0 days 00:04:48,4,16,12
91,MCO,P012709,PLCZ,0 days 00:04:09,0,9,9
91,MCO,P004790,PLCZ,0 days 00:04:09,0,9,9
91,MCO,P004790,P005985,0 days 00:04:08,4,10,6
91,MCO,P002581,P005985,0 days 00:03:57,-3,7,10
91,MCO,P002581,P010588,0 days 00:03:57,-3,7,10
91,MCO,P002581,P011226,0 days 00:03:57,-3,7,10
91,MCO,P002581,P004197,0 days 00:03:57,-3,7,10
91,MCO,P004197,P011196,0 days 00:03:39,-2,4,6
91,MCO,P010588,P011231,0 days 00:02:43,4,14,10
91,MCO,P004790,P010588,0 days 00:02:29,5,7,2
91,MCO,P004790,P011226,0 days 00:02:14,5,7,2
91,MCO,P005985,P012709,0 days 00:01:39,-1,3,4
91,MCO,P010588,P012709,0 days 00:01:36,2,5,3
91,MCO,P004197,P004790,0 days 00:00:15,0,0,0
91,MCO,P004197,P011212,0 days 00:00:15,0,0,0
91,MCO,P004197,P011231,0 days 00:00:08,-3,0,3
91,OLY,P008829,P008855,0 days 00:30:00,-14,55,69
91,OLY,P008855,P010612,0 days 00:25:33,-18,46,64
91,OLY,P001255,P008829,0 days 00:23:42,-1,46,47
91,OLY,P001255,P008855,0 days 00:23:19,-4,43,47
91,OLY,P008829,P010612,0 days 00:21:51,-11,44,55
91,OLY,P008811,P008829,0 days 00:17:26,7,42,35
91,OLY,P003941,P008855,0 days 00:17:22,-14,29,43
91,OLY,P001255,P008811,0 days 00:17:07,3,38,35
91,OLY,P008811,P008855,0 days 00:16:44,0,35,35
91,OLY,P008811,P010612,0 days 00:16:31,6,36,30
91,OLY,P008855,P011983,0 days 00:15:20,-6,30,36
91,OLY,P008829,P011983,0 days 00:15:20,-6,30,36
91,OLY,P001255,P010612,0 days 00:14:51,-5,28,33
91,OLY,P003941,P010612,0 days 00:14:35,-18,23,41
91,OLY,P003941,P008829,0 days 00:13:13,-14,20,34
91,OLY,P003941,P011983,0 days 00:09:57,-9,18,27
91,OLY,P006589,P010612,0 days 00:08:55,-1,15,16
91,OLY,P001255,P011983,0 days 00:08:39,4,18,14
91,OLY,P010612,P011983,0 days 00:06:44,-10,12,22
91,OLY,P001255,P003941,0 days 00:06:32,-4,8,12
91,OLY,P010392,P010612,0 days 00:06:21,1,13,12
91,OLY,P006589,P010392,0 days 00:05:58,1,13,12
91,OLY,P006302,P010612,0 days 00:05:28,3,10,7
91,OLY,P008811,P011983,0 days 00:05:20,3,12,9
91,OLY,P006302,P008811,0 days 00:05:14,6,10,4
91,OLY,P006302,P006589,0 days 00:04:46,-1,6,7
91,OLY,P003941,P006589,0 days 00:04:38,-3,9,12
91,OLY,P003941,P010392,0 days 00:04:38,-3,9,12
91,OLY,P006589,P008811,0 days 00:04:17,2,6,4
91,OLY,P006589,P008855,0 days 00:04:09,0,9,9
91,OLY,P008855,P010392,0 days 00:04:09,0,9,9
91,OLY,P007853,P008811,0 days 00:04:02,5,9,4
91,OLY,P006302,P007853,0 days 00:03:54,2,6,4
91,OLY,P007853,P010612,0 days 00:03:47,5,9,4
91,OLY,P006589,P007853,0 days 00:02:57,-2,2,4
91,OLY,P006302,P010392,0 days 00:02:12,1,4,3
91,OLY,P008811,P010392,0 days 00:01:43,4,4,0
91,OLY,P007853,P008829,0 days 00:00:42,7,7,0
91,OLY,P006302,P008829,0 days 00:00:34,4,4,0
91,OLY,P003941,P006302,0 days 00:00:29,-3,0,3
91,OLY,P007853,P010392,0 days 00:00:23,0,0,0
91,OLY,P001255,P007853,0 days 00:00:23,3,3,0
91,OLY,P001255,P006302,0 days 00:00:15,0,0,0
92,MUN,P003583,P011987,0 days 00:20:11,13,45,32
92,MUN,P007056,P011987,0 days 00:18:59,3,42,39
92,MUN,P003583,P007056,0 days 00:18:22,3,39,36
92,MUN,P010391,P011987,0 days 00:17:28,25,44,19
92,MUN,P003583,P006760,0 days 00:17:16,9,40,31
92,MUN,P006760,P011987,0 days 00:17:13,12,42,30
92,MUN,P006760,P007056,0 days 00:17:04,3,41,38
92,MUN,P007975,P011987,0 days 00:16:19,8,35,27
92,MUN,P001557,P007975,0 days 00:16:17,2,36,34
92,MUN,P007975,P010391,0 days 00:16:08,2,31,29
92,MUN,P003583,P010391,0 days 00:15:59,16,39,23
92,MUN,P006760,P010391,0 days 00:15:10,14,42,28
92,MUN,P007056,P010391,0 days 00:15:08,8,38,30
92,MUN,P007639,P011987,0 days 00:13:41,14,35,21
92,MUN,P007056,P007975,0 days 00:13:25,-4,28,32
92,MUN,P007639,P007975,0 days 00:11:40,7,28,21
92,MUN,P001557,P011987,0 days 00:11:19,7,29,22
92,MUN,P001557,P007639,0 days 00:10:56,9,28,19
92,MUN,P003583,P007975,0 days 00:09:12,-2,14,16
92,MUN,P007639,P010391,0 days 00:09:04,11,19,8
92,MUN,P001557,P010391,0 days 00:08:19,1,15,14
92,MUN,P006760,P007975,0 days 00:08:18,1,20,19
92,MUN,P001557,P005478,0 days 00:07:24,-3,12,15
92,MUN,P005478,P007975,0 days 00:07:24,-3,12,15
92,MUN,P006760,P007639,0 days 00:05:17,10,15,5
92,MUN,P007975,P011941,0 days 00:05:05,-3,12,15
92,MUN,P010391,P011941,0 days 00:05:05,-3,12,15
92,MUN,P005478,P007639,0 days 00:04:14,1,8,7
92,MUN,P005478,P010391,0 days 00:04:11,-6,4,10
92,MUN,P001557,P007056,0 days 00:03:45,-4,10,14
92,MUN,P001557,P003583,0 days 00:03:34,-3,6,9
92,MUN,P006245,P011987,0 days 00:03:33,-3,6,9
92,MUN,P006245,P007056,0 days 00:03:33,-3,6,9
92,MUN,P006245,P006760,0 days 00:03:33,-3,6,9
92,MUN,P003583,P006245,0 days 00:03:33,-3,6,9
92,MUN,P003583,P007639,0 days 00:03:30,7,9,2
92,MUN,P007056,P011941,0 days 00:03:18,1,10,9
92,MUN,P006760,P011941,0 days 00:03:18,1,10,9
92,MUN,P005478,P011987,0 days 00:02:45,1,6,5
92,MUN,P007056,P007639,0 days 00:02:18,-3,6,9
92,MUN,P001557,P011941,0 days 00:01:47,-4,2,6
92,MUN,P005478,P011941,0 days 00:01:47,-4,2,6
92,MUN,P001557,P006760,0 days 00:01:47,3,6,3
92,MUN,P003583,P005478,0 days 00:01:23,0,2,2
92,MUN,P005478,P006760,0 days 00:00:28,2,2,0
92,VIR,P001133,PBCN,0 days 00:27:35,-9,54,63
92,VIR,P001133,P001844,0 days 00:23:45,-5,41,46
92,VIR,P001844,PBCN,0 days 00:19:55,-9,35,44
92,VIR,P003048,PBCN,0 days 00:16:37,-7,37,44
92,VIR,P009549,PBCN,0 days 00:15:58,-3,31,34
92,VIR,P001133,P003048,0 days 00:15:27,-6,35,41
92,VIR,P001133,P009549,0 days 00:14:27,-2,29,31
92,VIR,P001133,P008847,0 days 00:12:56,3,22,19
92,VIR,P001844,P003048,0 days 00:12:41,-7,25,32
92,VIR,P001133,P010781,0 days 00:12:24,-4,24,28
92,VIR,P001844,P009549,0 days 00:11:39,-3,21,24
92,VIR,P001844,P008847,0 days 00:11:28,-7,15,22
92,VIR,P008847,PBCN,0 days 00:11:00,-7,12,19
92,VIR,P004007,P008847,0 days 00:09:57,1,19,18
92,VIR,P003048,P009549,0 days 00:09:31,-3,21,24
92,VIR,P003048,P006739,0 days 00:09:19,-9,19,28
92,VIR,P001133,P006739,0 days 00:08:51,1,24,23
92,VIR,P008847,P009549,0 days 00:07:58,-1,12,13
92,VIR,P008847,P010781,0 days 00:07:55,3,15,12
92,VIR,P010781,PBCN,0 days 00:07:38,-8,11,19
92,VIR,P001133,P004007,0 days 00:07:36,2,13,11
92,VIR,P006739,P008847,0 days 00:07:35,1,18,17
92,VIR,P004007,P010781,0 days 00:07:31,4,16,12
92,VIR,P003048,P011192,0 days 00:07:25,-2,18,20
92,VIR,P006739,PBCN,0 days 00:07:24,0,19,19
92,VIR,P004007,P006739,0 days 00:07:01,-4,14,18
92,VIR,P001133,P011192,0 days 00:06:58,-4,16,20
92,VIR,P001844,P004007,0 days 00:06:42,-4,8,12
92,VIR,P011192,PBCN,0 days 00:06:32,-2,16,18
92,VIR,P001844,P010781,0 days 00:06:26,-3,11,14
92,VIR,P003048,P008847,0 days 00:06:08,-7,9,16
92,VIR,P003048,P004007,0 days 00:05:32,-8,7,15
92,VIR,P001133,P012714,0 days 00:05:29,-4,10,14
92,VIR,P006739,P010781,0 days 00:05:13,4,14,10
92,VIR,P010781,P012714,0 days 00:04:53,-4,10,14
92,VIR,P006739,P009549,0 days 00:04:19,0,10,10
92,VIR,P012714,PBCN,0 days 00:04:08,-1,9,10
92,VIR,P003048,P010781,0 days 00:03:40,-3,5,8
92,VIR,P001844,P011192,0 days 00:03:33,3,9,6
92,VIR,P006739,P012714,0 days 00:03:05,-1,5,6
92,VIR,P001844,P012714,0 days 00:03:00,-3,5,8
92,VIR,P001844,P006739,0 days 00:02:39,-6,2,8
92,VIR,P006739,P011192,0 days 00:02:14,-2,7,9
92,VIR,P010781,P011192,0 days 00:02:04,-5,2,7
92,VIR,P004007,PBCN,0 days 00:01:53,-2,0,2
92,VIR,P004007,P012714,0 days 00:01:21,-3,1,4
92,VIR,P004007,P011192,0 days 00:01:19,-2,2,4
92,VIR,P008847,P011192,0 days 00:01:19,-2,2,4
93,ULK,P004004,P008962,0 days 00:28:54,5,73,68
93,ULK,P004004,P011157,0 days 00:23:09,20,62,42
93,ULK,P006661,P011157,0 days 00:22:12,16,57,41
93,ULK,P006661,P008962,0 days 00:21:39,9,53,44
93,ULK,P008962,P011157,0 days 00:20:58,12,54,42
93,ULK,P001932,P008962,0 days 00:20:42,3,53,50
93,ULK,P001932,P004004,0 days 00:19:33,5,52,47
93,ULK,P004004,P006661,0 days 00:18:28,15,50,35
93,ULK,P011052,P011157,0 days 00:15:55,10,35,25
93,ULK,P009849,P011052,0 days 00:14:40,1,28,27
93,ULK,P008962,P011052,0 days 00:14:32,-3,30,33
93,ULK,P008962,P010560,0 days 00:14:16,-13,24,37
93,ULK,P004004,P011052,0 days 00:13:42,6,33,27
93,ULK,P001932,P006661,0 days 00:12:34,11,35,24
93,ULK,P002968,P009849,0 days 00:12:16,1,24,23
93,ULK,P002968,P011052,0 days 00:11:55,2,25,23
93,ULK,P009849,P011157,0 days 00:11:39,2,23,21
93,ULK,P005844,P008962,0 days 00:11:26,-16,18,34
93,ULK,P001932,P011157,0 days 00:11:14,13,34,21
93,ULK,P006661,P011052,0 days 00:10:38,5,23,18
93,ULK,P005844,P010560,0 days 00:10:02,-13,15,28
93,ULK,P008962,P009849,0 days 00:09:54,-13,16,29
93,ULK,P002968,P011157,0 days 00:09:29,3,19,16
93,ULK,P001932,P005844,0 days 00:09:10,-13,16,29
93,ULK,P001932,P010560,0 days 00:08:15,-7,16,23
93,ULK,P004004,P005844,0 days 00:08:13,-10,16,26
93,ULK,P004004,P010560,0 days 00:07:39,-6,16,22
93,ULK,P004004,P009849,0 days 00:07:02,0,17,17
93,ULK,P002968,P006661,0 days 00:06:57,-2,12,14
93,ULK,P002968,P008962,0 days 00:06:19,-8,11,19
93,ULK,P002968,P004004,0 days 00:05:56,1,13,12
93,ULK,P010560,P011052,0 days 00:05:44,-4,10,14
93,ULK,P006661,P009849,0 days 00:05:37,-1,9,10
93,ULK,P009849,P010560,0 days 00:05:28,-5,7,12
93,ULK,P002968,P010560,0 days 00:03:32,-2,7,9
93,ULK,P005844,P009849,0 days 00:03:18,-6,5,11
93,ULK,P005844,P011052,0 days 00:02:16,-3,2,5
93,ULK,P006661,P010560,0 days 00:01:32,-2,1,3
93,ULK,P005844,P006661,0 days 00:01:19,-3,0,3
93,ULK,P001932,P009849,0 days 00:01:02,-3,3,6
93,ULK,P010560,P011157,0 days 00:00:36,0,0,0
93,ULK,P001932,P002968,0 days 00:00:12,1,1,0
93,ULK,P001932,P011052,0 days 00:00:06,2,2,0
93,MAD,P005928,P009005,0 days 00:35:41,15,90,75
93,MAD,P009005,PTGB,0 days 00:31:19,4,75,71
93,MAD,P005928,PTGB,0 days 00:29:00,11,72,61
93,MAD,P005791,P009005,0 days 00:19:44,16,53,37
93,MAD,P005791,P005928,0 days 00:18:55,15,50,35
93,MAD,P005791,PTGB,0 days 00:18:46,14,49,35
93,MAD,P004887,PBMT,0 days 00:18:18,-16,33,49
93,MAD,P004887,P009005,0 days 00:18:16,-9,39,48
93,MAD,P004887,P005928,0 days 00:18:06,-3,39,42
93,MAD,P009005,PBMT,0 days 00:15:00,-4,34,38
93,MAD,P005928,P006540,0 days 00:14:17,9,36,27
93,MAD,P004887,P006540,0 days 00:14:08,-7,28,35
93,MAD,P005928,PBMT,0 days 00:14:01,1,31,30
93,MAD,P006540,P009005,0 days 00:13:32,6,36,30
93,MAD,P004887,PTGB,0 days 00:12:29,-11,25,36
93,MAD,P006540,PBMT,0 days 00:11:04,-7,22,29
93,MAD,P003108,P005928,0 days 00:10:22,-5,19,24
93,MAD,P003108,P005791,0 days 00:09:23,0,16,16
93,MAD,P003108,P009005,0 days 00:09:02,-3,19,22
93,MAD,P003108,PTGB,0 days 00:08:58,-3,19,22
93,MAD,PBMT,PTGB,0 days 00:08:15,-8,16,24
93,MAD,P009005,P009213,0 days 00:07:58,9,23,14
93,MAD,P009213,PTGB,0 days 00:07:58,9,23,14
93,MAD,P005928,P009213,0 days 00:07:58,9,23,14
93,MAD,P005791,P009213,0 days 00:07:58,9,23,14
93,MAD,PBMT,PCVM,0 days 00:07:12,-9,9,18
93,MAD,P003108,PBMT,0 days 00:07:00,-9,6,15
93,MAD,P006540,PTGB,0 days 00:06:51,2,18,16
93,MAD,P003108,P004887,0 days 00:06:31,-13,8,21
93,MAD,P003108,PCVM,0 days 00:05:32,-7,6,13
93,MAD,P004887,PCVM,0 days 00:05:01,-10,6,16
93,MAD,P003108,P006540,0 days 00:03:48,-5,5,10
93,MAD,P005791,PBMT,0 days 00:03:38,3,7,4
93,MAD,P003108,P003733,0 days 00:03:16,-3,2,5
93,MAD,P003733,PBMT,0 days 00:03:16,-3,2,5
93,MAD,P003733,PCVM,0 days 00:03:12,-3,2,5
93,MAD,P005791,P006540,0 days 00:03:04,6,11,5
93,MAD,P006540,PCVM,0 days 00:02:20,-4,4,8
93,MAD,P003733,P004887,0 days 00:02:15,-3,2,5
93,MAD,P005791,PCVM,0 days 00:02:11,1,3,2
93,MAD,P009005,PCVM,0 days 00:01:40,-2,3,5
93,MAD,PCVM,PTGB,0 days 00:01:40,-2,3,5
93,MAD,P003733,P005791,0 days 00:01:01,0,0,0
93,MAD,P003733,P009005,0 days 00:00:04,0,0,0
94,TEL,P004233,P011219,0 days 00:20:07,20,57,37
94,TEL,P004233,P011193,0 days 00:18:40,14,50,36
94,TEL,P011193,P011219,0 days 00:17:02,11,45,34
94,TEL,P009783,P009863,0 days 00:16:31,6,39,33
94,TEL,P009622,P011214,0 days 00:15:11,3,39,36
94,TEL,P009622,P009783,0 days 00:14:18,-3,33,36
94,TEL,P005145,P009863,0 days 00:14:06,5,38,33
94,TEL,P009622,P009863,0 days 00:13:06,-2,31,33
94,TEL,P009863,P011214,0 days 00:12:54,0,29,29
94,TEL,P009783,P011214,0 days 00:12:46,-1,29,30
94,TEL,P005145,P009622,0 days 00:12:15,-1,29,30
94,TEL,P005145,P009783,0 days 00:12:15,-1,29,30
94,TEL,P005145,P011214,0 days 00:12:15,-1,29,30
94,TEL,P011193,P011971,0 days 00:11:27,14,35,21
94,TEL,P004233,P012744,0 days 00:11:16,4,23,19
94,TEL,P011219,P012744,0 days 00:11:16,4,23,19
94,TEL,P009863,P011219,0 days 00:11:01,14,32,18
94,TEL,P011193,P012744,0 days 00:10:29,-4,20,24
94,TEL,P004233,P011971,0 days 00:09:25,14,30,16
94,TEL,P004233,P009863,0 days 00:09:09,16,30,14
94,TEL,P011219,P011971,0 days 00:08:47,9,27,18
94,TEL,P009783,P011219,0 days 00:08:27,5,16,11
94,TEL,P009622,P011971,0 days 00:07:08,11,26,15
94,TEL,P009622,P011193,0 days 00:06:54,12,26,14
94,TEL,P004233,P009783,0 days 00:06:35,7,14,7
94,TEL,P009863,P011193,0 days 00:06:04,7,18,11
94,TEL,P011193,P011214,0 days 00:05:59,3,14,11
94,TEL,P009783,P012744,0 days 00:05:53,7,12,5
94,TEL,P011971,P012744,0 days 00:05:42,1,13,12
94,TEL,P011214,P011971,0 days 00:05:36,4,14,10
94,TEL,P009863,P011971,0 days 00:05:21,1,13,12
94,TEL,P009783,P011193,0 days 00:04:52,-2,6,8
94,TEL,P009622,P011219,0 days 00:04:49,7,18,11
94,TEL,P011193,P011433,0 days 00:04:38,-3,9,12
94,TEL,P004233,P011433,0 days 00:04:38,-3,9,12
94,TEL,P011433,P012744,0 days 00:04:33,-3,9,12
94,TEL,P009863,P012744,0 days 00:04:19,9,12,3
94,TEL,P005145,P011193,0 days 00:04:15,4,13,9
94,TEL,P004233,P009622,0 days 00:04:07,12,19,7
94,TEL,P011214,P012744,0 days 00:03:32,1,9,8
94,TEL,P011219,P011433,0 days 00:03:13,-3,7,10
94,TEL,P004233,P005145,0 days 00:03:03,5,11,6
94,TEL,P005145,P011219,0 days 00:03:03,5,11,6
94,TEL,P011214,P011433,0 days 00:02:40,0,4,4
94,TEL,P011433,P011971,0 days 00:02:40,0,4,4
94,TEL,P009622,P012744,0 days 00:02:12,1,7,6
94,TEL,P004233,P011214,0 days 00:02:04,3,5,2
94,TEL,P009783,P011971,0 days 00:01:26,-2,2,4
94,TEL,P009863,P011433,0 days 00:01:25,0,2,2
94,TEL,P011214,P011219,0 days 00:00:31,0,0,0
94,TEL,P009783,P011433,0 days 00:00:05,0,0,0
94,BER,P011934,P012721,0 days 00:19:26,-16,39,55
94,BER,P008173,P011934,0 days 00:18:29,-15,41,56
94,BER,P008173,P012721,0 days 00:18:05,-14,39,53
94,BER,P003958,P008384,0 days 00:17:16,5,46,41
94,BER,P008211,P010791,0 days 00:17:02,1,34,33
94,BER,P006251,P008211,0 days 00:16:03,-16,21,37
94,BER,P003958,P008211,0 days 00:13:38,0,32,32
94,BER,P006251,P010791,0 days 00:12:55,-11,15,26
94,BER,P008173,P008384,0 days 00:12:31,0,33,33
94,BER,P008384,P011934,0 days 00:12:31,0,33,33
94,BER,P008384,P012721,0 days 00:12:07,1,31,30
94,BER,P008211,P011631,0 days 00:11:39,-1,26,27
94,BER,P008211,P008384,0 days 00:10:48,7,28,21
94,BER,P007025,P012721,0 days 00:10:48,-15,15,30
94,BER,P008384,P010791,0 days 00:10:30,5,26,21
94,BER,P003958,P010791,0 days 00:10:30,5,26,21
94,BER,P003958,P008173,0 days 00:10:05,-7,25,32
94,BER,P003958,P006251,0 days 00:09:55,-13,15,28
94,BER,P006819,P008173,0 days 00:08:39,-11,17,28
94,BER,P006819,P011934,0 days 00:08:39,-11,17,28
94,BER,P006819,P012721,0 days 00:08:39,-11,17,28
94,BER,P007025,P008211,0 days 00:07:53,-6,8,14
94,BER,P007025,P011934,0 days 00:07:19,-17,8,25
94,BER,P003958,P011631,0 days 00:07:15,7,25,18
94,BER,P003958,P011934,0 days 00:07:15,0,21,21
94,BER,P010791,P011631,0 days 00:07:10,6,20,14
94,BER,P006251,P008384,0 days 00:07:05,-6,11,17
94,BER,P003958,P012721,0 days 00:06:51,1,19,18
94,BER,P006251,P007025,0 days 00:06:32,-4,8,12
94,BER,P007025,P010791,0 days 00:06:32,-4,8,12
94,BER,P006251,P011631,0 days 00:06:11,-11,7,18
94,BER,P007025,P008173,0 days 00:05:58,-15,8,23
94,BER,P008384,P011631,0 days 00:05:55,15,24,9
94,BER,P007025,P011631,0 days 00:05:29,-13,1,14
94,BER,P008173,P011631,0 days 00:05:25,-11,7,18
94,BER,P008211,P012721,0 days 00:04:50,0,7,7
94,BER,P006819,P008384,0 days 00:04:33,1,12,11
94,BER,P006819,P007025,0 days 00:04:06,-12,5,17
94,BER,P011631,P011934,0 days 00:03:56,-6,3,9
94,BER,P011631,P012721,0 days 00:03:56,-6,3,9
94,BER,P010791,P012721,0 days 00:03:29,2,7,5
94,BER,P006251,P012721,0 days 00:03:29,2,7,5
94,BER,P006251,P008173,0 days 00:03:14,-8,6,14
94,BER,P008173,P008211,0 days 00:02:50,-7,4,11
94,BER,P008211,P011934,0 days 00:01:21,-2,0,2
94,BER,P003958,P007025,0 days 00:00:47,2,3,1
94,BER,P006251,P011934,0 days 00:00:24,-1,2,3
95,PAR,P008987,P012742,0 days 00:30:37,17,73,56
95,PAR,P000956,P008987,0 days 00:25:02,26,64,38
95,PAR,P000956,P012742,0 days 00:23:14,27,62,35
95,PAR,P008987,P009862,0 days 00:20:51,3,47,44
95,PAR,P007400,P008987,0 days 00:20:25,-1,35,36
95,PAR,P008987,P011051,0 days 00:20:08,-3,41,44
95,PAR,P009862,P012096,0 days 00:19:55,15,49,34
95,PAR,P011051,P012742,0 days 00:16:18,4,35,31
95,PAR,P008987,P012096,0 days 00:15:28,18,43,25
95,PAR,P009862,P012742,0 days 00:15:10,7,38,31
95,PAR,P007400,P011051,0 days 00:14:16,1,28,27
95,PAR,P007400,P009862,0 days 00:13:36,-17,15,32
95,PAR,P007400,P012742,0 days 00:12:52,4,24,20
95,PAR,P000956,P012096,0 days 00:12:46,15,38,23
95,PAR,P012096,P012742,0 days 00:12:46,15,38,23
95,PAR,P000956,P009862,0 days 00:12:46,15,38,23
95,PAR,P000956,P007400,0 days 00:12:18,11,26,15
95,PAR,P008987,P012743,0 days 00:10:13,-9,15,24
95,PAR,P000956,P011051,0 days 00:09:38,12,24,12
95,PAR,P003983,P007400,0 days 00:08:59,-1,13,14
95,PAR,P012742,P012743,0 days 00:07:48,-8,11,19
95,PAR,P004172,P011051,0 days 00:07:11,-6,13,19
95,PAR,P007400,P012096,0 days 00:07:09,0,11,11
95,PAR,P003983,P009862,0 days 00:07:09,0,11,11
95,PAR,P003983,P012096,0 days 00:07:09,0,11,11
95,PAR,P004172,P008987,0 days 00:06:43,-6,13,19
95,PAR,P004172,P012743,0 days 00:06:20,-4,13,17
95,PAR,P011051,P012743,0 days 00:06:20,-4,13,17
95,PAR,P004172,P012742,0 days 00:05:39,-4,11,15
95,PAR,P003983,P008987,0 days 00:05:17,2,9,7
95,PAR,P007400,P009212,0 days 00:05:01,-5,6,11
95,PAR,P009212,P009862,0 days 00:05:01,-5,6,11
95,PAR,P009862,P011051,0 days 00:04:38,-11,4,15
95,PAR,P007400,P012743,0 days 00:04:29,-7,2,9
95,PAR,P003983,P009212,0 days 00:04:25,-3,6,9
95,PAR,P009212,P012096,0 days 00:04:25,-3,6,9
95,PAR,P004058,P009862,0 days 00:03:40,-7,4,11
95,PAR,P004058,P007400,0 days 00:03:40,-7,4,11
95,PAR,P004058,P008987,0 days 00:03:12,-7,4,11
95,PAR,P004058,P011051,0 days 00:03:12,-5,4,9
95,PAR,P000956,P012743,0 days 00:02:40,-1,2,3
95,PAR,P003983,P012743,0 days 00:02:33,-1,4,5
95,PAR,P000956,P003983,0 days 00:01:50,-1,2,3
95,PAR,P009862,P012743,0 days 00:01:49,-6,0,6
95,PAR,P004172,P009862,0 days 00:00:53,-2,0,2
95,PAR,P004172,P007400,0 days 00:00:51,-2,0,2
95,PAR,P003983,P004172,0 days 00:00:43,0,2,2
95,PAR,P003983,P011051,0 days 00:00:43,0,2,2
95,PAR,P009212,P012742,0 days 00:00:36,-2,0,2
95,PAR,P009212,P012743,0 days 00:00:36,-2,0,2
95,PAR,P004058,P004172,0 days 00:00:28,0,0,0
95,PAR,P004058,P012743,0 days 00:00:28,-2,0,2
95,PAR,P000956,P004172,0 days 00:00:02,0,0,0
95,PAR,P004172,P012096,0 days 00:00:02,0,0,0
95,PAN,P002328,P007866,0 days 00:37:01,-1,72,73
95,PAN,P007866,P011204,0 days 00:34:53,0,69,69
95,PAN,P002328,P011204,0 days 00:33:15,1,68,67
95,PAN,P002328,P003842,0 days 00:31:39,0,66,66
95,PAN,P003842,P011204,0 days 00:30:28,-1,62,63
95,PAN,P003842,P007866,0 days 00:29:14,-1,59,60
95,PAN,P007866,P012774,0 days 00:23:50,0,50,50
95,PAN,P002328,P012774,0 days 00:22:12,1,49,48
95,PAN,P001926,P002328,0 days 00:21:19,-4,39,43
95,PAN,P011204,P012774,0 days 00:21:06,2,48,46
95,PAN,P001926,P011204,0 days 00:20:08,-5,35,40
95,PAN,P001926,P003842,0 days 00:19:23,-6,35,41
95,PAN,P001926,P007866,0 days 00:18:54,-5,32,37
95,PAN,P003842,P012774,0 days 00:17:52,-2,40,42
95,PAN,P007553,P007866,0 days 00:11:50,0,21,21
95,PAN,P007866,P007947,0 days 00:08:34,3,17,14
95,PAN,P007553,P012774,0 days 00:08:23,3,17,14
95,PAN,P007553,P011204,0 days 00:08:21,-3,14,17
95,PAN,P002328,P007553,0 days 00:07:47,0,13,13
95,PAN,P007947,P012774,0 days 00:07:32,3,15,12
95,PAN,P007553,P007947,0 days 00:07:32,3,15,12
95,PAN,P007947,P011204,0 days 00:05:34,-5,8,13
95,PAN,P002328,P007947,0 days 00:04:31,3,9,6
95,PAN,P001926,P012774,0 days 00:04:05,-3,9,12
95,PAN,P001926,P007553,0 days 00:03:27,-3,4,7
95,PAN,P001926,P007947,0 days 00:02:33,-5,2,7
95,PAN,P003842,P007947,0 days 00:02:33,-5,2,7
95,PAN,P001926,P008084,0 days 00:01:31,-5,0,5
95,PAN,P003842,P008084,0 days 00:01:31,-5,0,5
95,PAN,P007947,P008084,0 days 00:01:31,-5,0,5
95,PAN,P008084,P011204,0 days 00:01:31,-5,0,5
96,MIL,P000796,P007831,0 days 00:29:04,-15,50,65
96,MIL,P002849,P007032,0 days 00:24:45,-12,44,56
96,MIL,P007032,P007831,0 days 00:24:11,-17,40,57
96,MIL,P000796,P007032,0 days 00:23:06,-17,38,55
96,MIL,P000796,P002849,0 days 00:23:03,-7,41,48
96,MIL,P002849,P007831,0 days 00:22:38,-9,39,48
96,MIL,P007032,P007201,0 days 00:15:37,-13,25,38
96,MIL,P007201,P007831,0 days 00:14:59,-15,24,39
96,MIL,P002849,P007201,0 days 00:14:33,-10,23,33
96,MIL,P000796,P007201,0 days 00:13:39,-13,22,35
96,MIL,P002812,P007831,0 days 00:13:19,0,27,27
96,MIL,P000796,P002812,0 days 00:11:59,2,25,23
96,MIL,P006509,P011205,0 days 00:11:25,-1,20,21
96,MIL,P007831,P011205,0 days 00:09:09,1,18,17
96,MIL,P006509,P007032,0 days 00:09:06,-5,14,19
96,MIL,P002849,P011205,0 days 00:08:48,6,17,11
96,MIL,P006509,P007831,0 days 00:08:42,-8,12,20
96,MIL,P002812,P002849,0 days 00:07:56,3,16,13
96,MIL,P000796,P011205,0 days 00:07:55,5,18,13
96,MIL,P002849,P006509,0 days 00:07:35,-3,12,15
96,MIL,P007201,P011205,0 days 00:07:26,-2,15,17
96,MIL,P002812,P011205,0 days 00:07:18,0,14,14
96,MIL,P006509,P009960,0 days 00:06:28,0,8,8
96,MIL,P002812,P007032,0 days 00:06:01,0,13,13
96,MIL,P000796,P006509,0 days 00:05:58,-6,8,14
96,MIL,P007032,P011205,0 days 00:05:34,1,12,11
96,MIL,P006509,P007201,0 days 00:05:23,-2,10,12
96,MIL,P009960,P011205,0 days 00:04:29,4,8,4
96,MIL,P001518,P009960,0 days 00:04:15,2,8,6
96,MIL,P001518,P006509,0 days 00:04:15,2,8,6
96,MIL,P006701,P011205,0 days 00:04:10,4,8,4
96,MIL,P006701,P009960,0 days 00:04:10,4,8,4
96,MIL,P007831,P009960,0 days 00:03:46,-5,4,9
96,MIL,P006509,P006701,0 days 00:03:45,2,6,4
96,MIL,P007032,P009960,0 days 00:03:27,-5,4,9
96,MIL,P002812,P007201,0 days 00:03:24,-2,7,9
96,MIL,P002812,P006509,0 days 00:03:19,-3,6,9
96,MIL,P001518,P011205,0 days 00:03:10,2,6,4
96,MIL,P001518,P006701,0 days 00:02:51,2,6,4
96,MIL,P000796,P009960,0 days 00:02:47,-3,4,7
96,MIL,P001518,P007831,0 days 00:01:24,0,2,2
96,MIL,P002849,P006701,0 days 00:01:19,2,2,0
96,MIL,P002849,P009960,0 days 00:01:19,2,2,0
96,MIL,P001518,P007032,0 days 00:01:05,0,2,2
96,MIL,P007201,P009960,0 days 00:01:03,-3,2,5
96,MIL,P000796,P006701,0 days 00:00:25,2,2,0
96,ZAL,P002329,P010390,0 days 00:31:47,18,69,51
96,ZAL,P002329,P011218,0 days 00:29:55,12,64,52
96,ZAL,P010390,P011218,0 days 00:27:23,14,58,44
96,ZAL,P007109,P010390,0 days 00:21:03,7,43,36
96,ZAL,P002329,P007109,0 days 00:18:37,8,40,32
96,ZAL,P002329,P002676,0 days 00:17:11,15,39,24
96,ZAL,P002676,P010390,0 days 00:17:11,15,39,24
96,ZAL,P002676,P011218,0 days 00:17:11,15,39,24
96,ZAL,P007513,P010390,0 days 00:17:02,2,33,31
96,ZAL,P002329,P007513,0 days 00:16:10,0,32,32
96,ZAL,P007109,P007513,0 days 00:15:58,7,36,29
96,ZAL,P007109,P011218,0 days 00:14:30,4,29,25
96,ZAL,P002329,P006860,0 days 00:12:03,8,26,18
96,ZAL,P006860,P010390,0 days 00:11:38,11,26,15
96,ZAL,P006860,P011218,0 days 00:11:22,11,26,15
96,ZAL,P007513,P011218,0 days 00:11:21,-1,21,22
96,ZAL,P003211,P007513,0 days 00:09:47,-1,19,20
96,ZAL,P002676,P006860,0 days 00:09:27,14,26,12
96,ZAL,P003210,P007513,0 days 00:06:43,2,10,8
96,ZAL,P003210,P003211,0 days 00:06:39,-2,12,14
96,ZAL,P003211,P007109,0 days 00:06:29,3,15,12
96,ZAL,P002676,P007109,0 days 00:06:13,2,10,8
96,ZAL,P002329,P003211,0 days 00:05:54,-3,15,18
96,ZAL,P003211,P005504,0 days 00:05:37,-3,11,14
96,ZAL,P003211,P010390,0 days 00:05:23,1,12,11
96,ZAL,P003210,P007109,0 days 00:04:46,3,8,5
96,ZAL,P002329,P005504,0 days 00:04:29,-6,9,15
96,ZAL,P006860,P007513,0 days 00:04:29,-8,2,10
96,ZAL,P005504,P007513,0 days 00:04:14,-1,7,8
96,ZAL,P005504,P011218,0 days 00:04:03,-3,9,12
96,ZAL,P003210,P005504,0 days 00:04:02,0,9,9
96,ZAL,P003210,P010390,0 days 00:03:53,1,5,4
96,ZAL,P002329,P003210,0 days 00:02:50,0,6,6
96,ZAL,P003211,P011218,0 days 00:02:32,-2,6,8
96,ZAL,P003211,P006860,0 days 00:02:19,-5,2,7
96,ZAL,P003210,P006860,0 days 00:02:08,-2,2,4
96,ZAL,P005504,P006860,0 days 00:02:07,-4,2,6
96,ZAL,P005504,P010390,0 days 00:01:32,-1,3,4
96,ZAL,P002676,P005504,0 days 00:01:31,-1,3,4
96,ZAL,P003210,P011218,0 days 00:01:23,-2,4,6
96,ZAL,P005504,P007109,0 days 00:00:57,3,3,0
96,ZAL,P006860,P007109,0 days 00:00:11,-1,0,1
97,RED,P002553,P009035,0 days 00:24:36,3,61,58
97,RED,P000848,P009035,0 days 00:23:49,14,68,54
97,RED,P009035,P012044,0 days 00:22:49,17,67,50
97,RED,P000848,P012044,0 days 00:20:06,18,59,41
97,RED,P000848,P002553,0 days 00:19:42,3,49,46
97,RED,P002553,P012044,0 days 00:19:17,3,48,45
97,RED,P011224,PJDR,0 days 00:12:52,-2,26,28
97,RED,P002553,P006436,0 days 00:11:29,-6,22,28
97,RED,P006436,P009035,0 days 00:09:56,-8,18,26
97,RED,P008966,PJDR,0 days 00:09:48,-2,15,17
97,RED,P007960,P008966,0 days 00:09:19,-2,13,15
97,RED,P007960,PJDR,0 days 00:09:06,-7,11,18
97,RED,P002553,PJDR,0 days 00:09:02,8,25,17
97,RED,P006436,P012044,0 days 00:08:59,-7,16,23
97,RED,P000848,P004720,0 days 00:08:38,17,27,10
97,RED,P004720,P009035,0 days 00:08:29,14,27,13
97,RED,P009035,PJDR,0 days 00:08:07,6,24,18
97,RED,P007960,P011224,0 days 00:08:06,-9,9,18
97,RED,P002553,PLUO,0 days 00:07:48,0,21,21
97,RED,P008966,P011224,0 days 00:07:13,-6,9,15
97,RED,P000848,P006436,0 days 00:07:07,-2,14,16
97,RED,P006436,PJDR,0 days 00:06:57,2,12,10
97,RED,P004720,P012044,0 days 00:06:53,17,25,8
97,RED,P009035,P011224,0 days 00:06:53,1,19,18
97,RED,P012044,PLUO,0 days 00:06:36,1,20,19
97,RED,P009035,PLUO,0 days 00:06:21,1,20,19
97,RED,P002553,P011224,0 days 00:06:18,4,19,15
97,RED,P006436,P008966,0 days 00:06:01,3,10,7
97,RED,P000848,PLUO,0 days 00:05:58,3,20,17
97,RED,P000848,P007960,0 days 00:05:56,6,18,12
97,RED,P000848,PJDR,0 days 00:05:53,-3,14,17
97,RED,P007960,P012044,0 days 00:05:29,10,18,8
97,RED,PJDR,PLUO,0 days 00:05:22,9,14,5
97,RED,P006436,P011224,0 days 00:05:06,-4,6,10
97,RED,P002553,P004720,0 days 00:05:00,3,11,8
97,RED,P008966,PLUO,0 days 00:04:58,6,11,5
97,RED,P004720,P007960,0 days 00:04:36,13,18,5
97,RED,P006436,P007960,0 days 00:04:29,1,6,5
97,RED,P011224,P012044,0 days 00:04:26,0,10,10
97,RED,P007960,P009035,0 days 00:04:04,8,16,8
97,RED,P000848,P011224,0 days 00:03:53,-6,9,15
97,RED,P007960,PLUO,0 days 00:03:43,4,7,3
97,RED,P012044,PJDR,0 days 00:03:09,6,11,5
97,RED,P006436,PLUO,0 days 00:02:50,2,6,4
97,RED,P011224,PLUO,0 days 00:02:49,2,5,3
97,RED,P004720,PJDR,0 days 00:02:40,-1,4,5
97,RED,P000848,P008966,0 days 00:01:54,-2,2,4
97,RED,P008966,P012044,0 days 00:01:44,-1,2,3
97,RED,P002553,P008966,0 days 00:01:36,2,4,2
97,RED,P004720,P008966,0 days 00:01:07,2,2,0
97,RED,P004720,P006436,0 days 00:00:58,-1,2,3
97,RED,P004720,PLUO,0 days 00:00:03,0,0,0
97,IST,P004888,P007200,0 days 00:31:29,-15,62,77
97,IST,P004888,P011981,0 days 00:26:44,0,57,57
97,IST,P007200,P011981,0 days 00:26:33,-5,58,63
97,IST,P006590,P007200,0 days 00:26:07,-13,53,66
97,IST,P004888,P011078,0 days 00:25:48,-17,48,65
97,IST,P006590,P011981,0 days 00:25:31,8,56,48
97,IST,P004888,P006590,0 days 00:25:22,-4,49,53
97,IST,P007200,P011078,0 days 00:24:41,-23,46,69
97,IST,P011078,P011981,0 days 00:22:46,-1,45,46
97,IST,P006590,P011078,0 days 00:22:20,-9,40,49
97,IST,P006372,P011981,0 days 00:15:01,-5,26,31
97,IST,P006372,P006590,0 days 00:13:16,-3,26,29
97,IST,P011981,P012786,0 days 00:12:47,6,38,32
97,IST,P006372,P007200,0 days 00:11:22,-12,20,32
97,IST,P007200,P012786,0 days 00:11:21,0,34,34
97,IST,P006372,P011078,0 days 00:11:13,2,21,19
97,IST,P006590,P012786,0 days 00:10:52,8,29,21
97,IST,P004888,P006372,0 days 00:10:43,-6,16,22
97,IST,P011078,P012786,0 days 00:09:37,-4,21,25
97,IST,P004888,P012786,0 days 00:09:35,0,28,28
97,IST,P006372,P012786,0 days 00:05:44,-3,13,16
97,IST,P007200,P012710,0 days 00:05:11,-8,11,19
97,IST,P011078,P012710,0 days 00:05:11,-8,11,19
97,IST,P004888,P012710,0 days 00:04:21,-7,8,15
97,IST,P006590,P012710,0 days 00:03:52,-7,7,14
97,IST,P006372,P012710,0 days 00:01:19,2,6,4
97,IST,P012710,P012786,0 days 00:00:50,-4,1,5
97,IST,P004888,P009513,0 days 00:00:06,-3,0,3
97,IST,P006372,P009513,0 days 00:00:06,-3,0,3
97,IST,P009513,P011981,0 days 00:00:06,-3,0,3
97,IST,P009513,P012786,0 days 00:00:06,-3,0,3
98,BAR,P002939,P006435,0 days 00:22:53,27,70,43
98,BAR,P000925,P002939,0 days 00:20:15,17,53,36
98,BAR,P000925,P006435,0 days 00:18:35,15,49,34
98,BAR,P002939,P012745,0 days 00:18:14,18,55,37
98,BAR,P004866,P011244,0 days 00:17:18,-3,36,39
98,BAR,P006435,P012745,0 days 00:17:03,21,51,30
98,BAR,P004866,P006435,0 days 00:16:36,16,48,32
98,BAR,P000925,P004866,0 days 00:16:36,10,39,29
98,BAR,P002939,P004866,0 days 00:15:57,17,44,27
98,BAR,P000925,P012745,0 days 00:15:34,10,42,32
98,BAR,P002939,P011244,0 days 00:10:36,-2,23,25
98,BAR,P004866,P012745,0 days 00:10:15,14,32,18
98,BAR,P003478,P011244,0 days 00:10:09,-14,18,32
98,BAR,P003196,P011244,0 days 00:10:05,-13,18,31
98,BAR,P007519,P011244,0 days 00:10:04,-8,19,27
98,BAR,P000925,P011244,0 days 00:09:47,3,22,19
98,BAR,P002939,P007464,0 days 00:09:43,2,26,24
98,BAR,P007464,P012745,0 days 00:09:43,2,26,24
98,BAR,P003196,P004866,0 days 00:09:21,1,25,24
98,BAR,P004866,P007519,0 days 00:09:04,-4,19,23
98,BAR,P006435,P011244,0 days 00:08:32,4,24,20
98,BAR,P003478,P004866,0 days 00:08:31,-9,15,24
98,BAR,P006435,P007464,0 days 00:07:36,7,21,14
98,BAR,P000925,P007464,0 days 00:07:22,1,19,18
98,BAR,P003196,P006435,0 days 00:07:10,13,29,16
98,BAR,P002939,P003196,0 days 00:07:09,2,24,22
98,BAR,P003478,P007519,0 days 00:06:59,-11,10,21
98,BAR,P003196,P003478,0 days 00:06:43,-11,9,20
98,BAR,P003196,P007519,0 days 00:06:42,-6,11,17
98,BAR,P000925,P009992,0 days 00:05:21,0,11,11
98,BAR,P000925,P003478,0 days 00:04:32,-2,13,15
98,BAR,P002939,P009992,0 days 00:03:42,0,10,10
98,BAR,P003196,P012745,0 days 00:03:36,6,14,8
98,BAR,P000925,P007519,0 days 00:03:22,-2,8,10
98,BAR,P004866,P009992,0 days 00:03:22,2,6,4
98,BAR,P009992,P011244,0 days 00:03:22,2,6,4
98,BAR,P002939,P003478,0 days 00:03:20,0,11,11
98,BAR,P003478,P006435,0 days 00:03:17,3,12,9
98,BAR,P003478,P012745,0 days 00:02:32,-2,5,7
98,BAR,P003196,P007464,0 days 00:02:21,1,7,6
98,BAR,P007464,P009992,0 days 00:02:07,-5,5,10
98,BAR,P009992,P012745,0 days 00:02:07,-5,5,10
98,BAR,P003204,P003478,0 days 00:01:59,-9,0,9
98,BAR,P003204,P011244,0 days 00:01:59,-9,0,9
98,BAR,P003196,P003204,0 days 00:01:59,-9,0,9
98,BAR,P007519,P009992,0 days 00:01:57,0,4,4
98,BAR,P006435,P007519,0 days 00:01:08,3,5,2
98,BAR,P003204,P007519,0 days 00:01:00,-4,0,4
98,BAR,P002939,P003204,0 days 00:00:59,-5,0,5
98,BAR,P011244,P012745,0 days 00:00:48,0,2,2
98,BAR,P003196,P009992,0 days 00:00:18,0,3,3
98,BAR,P003478,P009992,0 days 00:00:10,3,3,0
98,BAR,P006435,P009992,0 days 00:00:10,3,3,0
98,ASV,P003526,P004194,0 days 00:22:36,-17,47,64
98,ASV,P004194,P012080,0 days 00:20:39,-11,48,59
98,ASV,P006568,P011225,0 days 00:20:02,-13,42,55
98,ASV,P011225,P012080,0 days 00:19:22,-15,38,53
98,ASV,P003526,P011225,0 days 00:19:03,-22,32,54
98,ASV,P006568,P012080,0 days 00:18:52,-13,38,51
98,ASV,P000229,P012729,0 days 00:18:30,9,50,41
98,ASV,P002100,P012729,0 days 00:18:04,12,50,38
98,ASV,P004194,P011225,0 days 00:18:03,-21,34,55
98,ASV,P003526,P006568,0 days 00:16:36,-14,32,46
98,ASV,P012080,P012729,0 days 00:16:09,6,38,32
98,ASV,P003526,P012080,0 days 00:15:48,-16,28,44
98,ASV,P004194,P006568,0 days 00:15:36,-13,34,47
98,ASV,P000229,P002100,0 days 00:15:16,13,44,31
98,ASV,P002100,P004194,0 days 00:14:28,6,42,36
98,ASV,P004194,P012729,0 days 00:14:01,0,35,35
98,ASV,P002100,P012080,0 days 00:13:35,9,40,31
98,ASV,P000229,P004194,0 days 00:12:55,7,36,29
98,ASV,P003526,P012729,0 days 00:11:58,-5,25,30
98,ASV,P000229,P012080,0 days 00:10:58,8,30,22
98,ASV,P000229,P003526,0 days 00:08:42,3,24,21
98,ASV,P011225,P012729,0 days 00:07:38,-7,11,18
98,ASV,P002100,P003526,0 days 00:07:27,2,20,18
98,ASV,P006568,P012729,0 days 00:05:37,0,11,11
98,ASV,P002100,P012730,0 days 00:04:46,4,12,8
98,ASV,P012080,P012730,0 days 00:04:46,4,12,8
98,ASV,P012729,P012730,0 days 00:04:46,4,12,8
98,ASV,P000229,P006568,0 days 00:04:37,3,13,10
98,ASV,P000229,P011225,0 days 00:04:14,1,10,9
98,ASV,P002100,P011225,0 days 00:03:49,-4,10,14
98,ASV,P002100,P006568,0 days 00:03:32,-2,10,12
98,ASV,P000229,P012730,0 days 00:03:18,3,9,6
98,ASV,P011225,P012730,0 days 00:00:45,1,3,2
98,ASV,P002100,P011386,0 days 00:00:43,0,0,0
98,ASV,P011386,P012080,0 days 00:00:43,0,0,0
98,ASV,P011386,P012729,0 days 00:00:43,0,0,0
98,ASV,P011386,P012730,0 days 00:00:43,0,0,0
98,ASV,P000229,P012731,0 days 00:00:10,-3,0,3
98,ASV,P003526,P012731,0 days 00:00:10,-3,0,3
98,ASV,P004194,P012731,0 days 00:00:10,-3,0,3
98,ASV,P012729,P012731,0 days 00:00:10,-3,0,3
99,PAM,P010568,P011982,0 days 00:23:54,-20,53,73
99,PAM,P003960,P011970,0 days 00:18:53,-7,30,37
99,PAM,P005356,P011982,0 days 00:18:35,-10,40,50
99,PAM,P011970,P011982,0 days 00:18:28,-11,38,49
99,PAM,P003960,P007870,0 days 00:18:25,-8,30,38
99,PAM,P005356,P010568,0 days 00:17:44,-8,42,50
99,PAM,P007870,P011970,0 days 00:17:32,-7,30,37
99,PAM,P010568,P012739,0 days 00:15:58,-4,36,40
99,PAM,P011982,P012739,0 days 00:15:58,-4,36,40
99,PAM,P003960,P011982,0 days 00:14:42,-19,20,39
99,PAM,P007870,P011982,0 days 00:13:07,-17,22,39
99,PAM,P007870,P012740,0 days 00:13:03,5,25,20
99,PAM,P003960,P012740,0 days 00:12:25,6,23,17
99,PAM,P010568,P012738,0 days 00:12:25,2,34,32
99,PAM,P012738,P012739,0 days 00:12:14,0,32,32
99,PAM,P011982,P012738,0 days 00:12:14,0,32,32
99,PAM,P005356,P012739,0 days 00:11:17,-4,23,27
99,PAM,P010568,P011970,0 days 00:11:11,-11,26,37
99,PAM,P011970,P012740,0 days 00:11:10,8,23,15
99,PAM,P003960,P010568,0 days 00:10:12,-20,13,33
99,PAM,P005356,P012738,0 days 00:09:28,0,21,21
99,PAM,P007870,P010568,0 days 00:08:48,-16,17,33
99,PAM,P000556,P007870,0 days 00:07:40,5,21,16
99,PAM,P003960,P005356,0 days 00:06:58,-10,13,23
99,PAM,P005356,P007870,0 days 00:06:37,-6,15,21
99,PAM,P005356,P011970,0 days 00:06:30,-2,15,17
99,PAM,P000556,P003960,0 days 00:06:17,6,15,9
99,PAM,P011982,P012740,0 days 00:05:57,2,13,11
99,PAM,P000556,P012740,0 days 00:05:41,6,14,8
99,PAM,P000556,P010568,0 days 00:04:47,0,13,13
99,PAM,P011970,P012739,0 days 00:04:41,0,13,13
99,PAM,P000556,P011970,0 days 00:03:33,6,10,4
99,PAM,P003960,P012739,0 days 00:03:07,-6,2,8
99,PAM,P011970,P012738,0 days 00:02:57,2,13,11
99,PAM,P000556,P005356,0 days 00:02:33,2,9,7
99,PAM,P010568,P012740,0 days 00:02:29,1,6,5
99,PAM,P006643,P012740,0 days 00:02:21,-2,2,4
99,PAM,P006643,P011970,0 days 00:02:21,-2,2,4
99,PAM,P006643,P007870,0 days 00:02:21,-2,2,4
99,PAM,P003960,P006643,0 days 00:02:21,-2,2,4
99,PAM,P000556,P011982,0 days 00:01:49,-1,6,7
99,PAM,P000556,P012739,0 days 00:00:37,2,2,0
99,PAM,P005356,P012740,0 days 00:00:18,2,2,0
99,PAM,P000556,P012738,0 days 00:00:11,2,2,0
99,PAM,P007870,P012738,0 days 00:00:11,2,2,0
99,BAS,P007230,P009048,0 days 00:29:44,20,75,55
99,BAS,P007230,P012201,0 days 00:25:21,25,67,42
99,BAS,P004761,P007230,0 days 00:24:19,7,63,56
99,BAS,P004603,P009048,0 days 00:23:04,13,50,37
99,BAS,P004603,P007230,0 days 00:22:16,15,50,35
99,BAS,P004761,P009048,0 days 00:22:10,7,52,45
99,BAS,P009048,P012201,0 days 00:20:48,20,54,34
99,BAS,P004603,P004761,0 days 00:18:10,7,36,29
99,BAS,P007230,P011948,0 days 00:18:02,18,52,34
99,BAS,P004603,P012201,0 days 00:16:31,15,42,27
99,BAS,P011948,P012201,0 days 00:15:07,7,33,26
99,BAS,P009048,P011948,0 days 00:13:41,10,37,27
99,BAS,P004761,P012201,0 days 00:13:38,9,36,27
99,BAS,P007230,P010444,0 days 00:12:44,8,40,32
99,BAS,P010444,P011948,0 days 00:11:50,8,33,25
99,BAS,P010444,P012201,0 days 00:11:24,4,26,22
99,BAS,P010444,P011064,0 days 00:07:28,-2,15,17
99,BAS,P011064,P012201,0 days 00:07:28,-2,15,17
99,BAS,P004603,P011948,0 days 00:07:21,5,15,10
99,BAS,P003198,P007230,0 days 00:06:29,-9,11,20
99,BAS,P004761,P011948,0 days 00:06:23,2,19,17
99,BAS,P011064,P011948,0 days 00:06:16,-2,10,12
99,BAS,P003198,P004761,0 days 00:05:54,-8,8,16
99,BAS,P009048,P010444,0 days 00:05:23,7,19,12
99,BAS,P007230,P011064,0 days 00:05:21,3,13,10
99,BAS,P003198,P009048,0 days 00:05:14,-4,8,12
99,BAS,P004761,P010444,0 days 00:05:13,-1,22,23
99,BAS,P003198,P004603,0 days 00:04:54,-3,7,10
99,BAS,P003198,P010444,0 days 00:03:22,-10,5,15
99,BAS,P003198,P012201,0 days 00:02:27,-6,3,9
99,BAS,P003198,P011948,0 days 00:02:24,-6,5,11
99,BAS,P003198,P011064,0 days 00:02:07,-5,2,7
99,BAS,P010444,P012765,0 days 00:02:00,-2,8,10
99,BAS,P007230,P012765,0 days 00:02:00,-2,8,10
99,BAS,P004761,P012765,0 days 00:01:45,-2,6,8
99,BAS,P008072,P009048,0 days 00:01:45,-1,5,6
99,BAS,P007230,P008072,0 days 00:01:45,-1,5,6
99,BAS,P008072,P011948,0 days 00:01:44,-1,5,6
99,BAS,P004761,P008072,0 days 00:01:44,-1,5,6
99,BAS,P003198,P012765,0 days 00:01:15,-5,3,8
99,BAS,P004761,P011064,0 days 00:01:12,0,5,5
99,BAS,P011948,P012765,0 days 00:01:00,3,7,4
99,BAS,P007230,P008850,0 days 00:00:19,0,0,0
99,BAS,P008850,P009048,0 days 00:00:19,0,0,0
99,BAS,P008850,P012201,0 days 00:00:19,0,0,0
99,BAS,P003198,P008850,0 days 00:00:18,0,0,0
99,BAS,P008072,P008850,0 days 00:00:01,0,0,0
99,BAS,P008072,P012201,0 days 00:00:01,0,0,0
100,BER,P003958,P007025,0 days 00:22:52,3,39,36
100,BER,P007025,P011934,0 days 00:20:46,-2,38,40
100,BER,P003958,P011934,0 days 00:20:45,0,38,38
100,BER,P003958,P008173,0 days 00:19:42,-2,30,32
100,BER,P003958,P006251,0 days 00:19:23,2,35,33
100,BER,P007025,P008173,0 days 00:17:51,-4,25,29
100,BER,P006251,P011934,0 days 00:16:01,-2,25,27
100,BER,P006251,P007025,0 days 00:15:36,1,26,25
100,BER,P008384,P010791,0 days 00:15:34,1,25,24
100,BER,P008173,P011934,0 days 00:15:27,-5,24,29
100,BER,P003958,P012721,0 days 00:14:05,8,24,16
100,BER,P008211,P008384,0 days 00:13:48,1,20,19
100,BER,P008211,P011934,0 days 00:13:37,-3,17,20
100,BER,P008211,P010791,0 days 00:13:04,3,20,17
100,BER,P006251,P008211,0 days 00:12:08,6,23,17
100,BER,P003958,P008211,0 days 00:11:59,12,31,19
100,BER,P008173,P012721,0 days 00:11:52,2,16,14
100,BER,P008384,P011934,0 days 00:10:57,-9,6,15
100,BER,P011934,P012721,0 days 00:10:24,-3,13,16
100,BER,P006251,P008173,0 days 00:10:04,-4,12,16
100,BER,P003958,P008384,0 days 00:09:53,8,25,17
100,BER,P007025,P012721,0 days 00:09:03,2,11,9
100,BER,P008384,P012721,0 days 00:08:57,2,16,14
100,BER,P010791,P012721,0 days 00:08:40,2,16,14
100,BER,P010791,P011934,0 days 00:08:19,-8,3,11
100,BER,P003958,P010791,0 days 00:08:05,9,22,13
100,BER,P006251,P008384,0 days 00:06:36,1,9,8
100,BER,P007025,P008211,0 days 00:06:36,3,14,11
100,BER,P006251,P010791,0 days 00:06:09,3,9,6
100,BER,P008211,P012721,0 days 00:06:08,2,11,9
100,BER,P008173,P008384,0 days 00:04:24,-1,8,9
100,BER,P008173,P010791,0 days 00:03:20,-2,5,7
100,BER,P006251,P012721,0 days 00:02:51,1,1,0
100,BER,P007025,P008384,0 days 00:02:39,-3,3,6
100,BER,P007025,P010791,0 days 00:02:25,-4,0,4
100,ZAL,P002329,P007513,0 days 00:23:50,-1,35,36
100,ZAL,P002329,P010390,0 days 00:23:38,9,49,40
100,ZAL,P010390,P011218,0 days 00:23:05,12,49,37
100,ZAL,P002329,P011218,0 days 00:22:17,0,43,43
100,ZAL,P007109,P010390,0 days 00:21:42,10,41,31
100,ZAL,P002329,P007109,0 days 00:20:54,6,35,29
100,ZAL,P007109,P007513,0 days 00:19:09,9,32,23
100,ZAL,P007513,P010390,0 days 00:18:49,6,35,29
100,ZAL,P007109,P011218,0 days 00:18:25,8,35,27
100,ZAL,P007513,P011218,0 days 00:16:53,0,29,29
100,ZAL,P003211,P010390,0 days 00:12:53,1,23,22
100,ZAL,P002329,P003211,0 days 00:10:51,-13,17,30
100,ZAL,P002329,P006860,0 days 00:10:44,-14,11,25
100,ZAL,P003210,P006860,0 days 00:10:43,-2,13,15
100,ZAL,P003211,P006860,0 days 00:09:41,-6,12,18
100,ZAL,P003211,P011218,0 days 00:09:39,-2,17,19
100,ZAL,P003211,P012787,0 days 00:09:30,7,13,6
100,ZAL,P005504,P006860,0 days 00:09:28,-13,7,20
100,ZAL,P003211,P007109,0 days 00:08:59,2,15,13
100,ZAL,P003211,P005504,0 days 00:07:22,-7,7,14
100,ZAL,P003210,P005504,0 days 00:06:18,-4,7,11
100,ZAL,P003210,P003211,0 days 00:06:18,-4,7,11
100,ZAL,P006860,P011218,0 days 00:06:11,-3,11,14
100,ZAL,P003211,P007513,0 days 00:05:57,-2,9,11
100,ZAL,P006860,P012787,0 days 00:05:55,4,7,3
100,ZAL,P006860,P007513,0 days 00:05:47,-9,0,9
100,ZAL,P005504,P012787,0 days 00:05:31,4,7,3
100,ZAL,P002329,P003210,0 days 00:05:29,-6,6,12
100,ZAL,P003210,P012787,0 days 00:05:14,4,7,3
100,ZAL,P006860,P010390,0 days 00:04:12,4,11,7
100,ZAL,P010390,P012787,0 days 00:04:09,3,6,3
100,ZAL,P011218,P012787,0 days 00:04:02,3,6,3
100,ZAL,P002329,P005504,0 days 00:03:57,-17,0,17
100,ZAL,P007109,P012787,0 days 00:03:45,3,6,3
100,ZAL,P005504,P011218,0 days 00:03:08,-9,0,9
100,ZAL,P006860,P007109,0 days 00:02:51,-1,0,1
100,ZAL,P003210,P007513,0 days 00:02:49,-1,0,1
100,ZAL,P003210,P007109,0 days 00:02:49,-1,0,1
100,ZAL,P005504,P007513,0 days 00:02:06,-6,0,6
100,ZAL,P003210,P011218,0 days 00:01:36,3,6,3
100,ZAL,P003210,P010390,0 days 00:01:36,3,6,3
100,ZAL,P006860,P012784,0 days 00:00:24,0,0,0
100,ZAL,P010390,P012784,0 days 00:00:24,0,0,0
100,ZAL,P012784,P012787,0 days 00:00:24,0,0,0
100,ZAL,P003211,P012784,0 days 00:00:14,0,0,0
100,ZAL,P002329,P012784,0 days 00:00:10,0,0,0
100,ZAL,P002329,P012787,0 days 00:00:10,0,0,0
100,ZAL,P005504,P007109,0 days 00:00:02,0,0,0
101,IST,P007200,P011981,0 days 00:27:46,14,62,48
101,IST,P011078,P011981,0 days 00:25:46,15,59,44
101,IST,P007200,P011078,0 days 00:24:16,11,55,44
101,IST,P007200,P012710,0 days 00:20:49,10,38,28
101,IST,P011981,P012786,0 days 00:18:11,3,37,34
101,IST,P007200,P012786,0 days 00:17:53,-1,35,36
101,IST,P011981,P012710,0 days 00:16:53,9,35,26
101,IST,P011078,P012786,0 days 00:16:11,-2,30,32
101,IST,P009513,P012710,0 days 00:16:04,-2,26,28
101,IST,P007200,P009513,0 days 00:15:32,-1,27,28
101,IST,P009513,P011981,0 days 00:14:31,4,28,24
101,IST,P007200,P010516,0 days 00:12:56,-6,21,27
101,IST,P011078,P012710,0 days 00:12:47,10,28,18
101,IST,P009513,P011078,0 days 00:12:40,-1,21,22
101,IST,P010516,P011078,0 days 00:12:05,-10,19,29
101,IST,P010516,P011981,0 days 00:10:00,-8,19,27
101,IST,P006372,P007200,0 days 00:09:56,10,21,11
101,IST,P007200,P012788,0 days 00:08:44,-1,9,10
101,IST,P009513,P012786,0 days 00:08:25,-7,9,16
101,IST,P006372,P011078,0 days 00:08:14,9,20,11
101,IST,P010516,P012710,0 days 00:08:09,-1,11,12
101,IST,P009513,P012788,0 days 00:08:09,-10,6,16
101,IST,P006372,P011981,0 days 00:07:48,9,20,11
101,IST,P012710,P012788,0 days 00:07:41,-4,6,10
101,IST,P010516,P012786,0 days 00:07:35,-9,10,19
101,IST,P006372,P012786,0 days 00:07:02,9,18,9
101,IST,P010516,P012788,0 days 00:06:10,-6,2,8
101,IST,P011078,P012788,0 days 00:05:41,-4,4,8
101,IST,P006372,P012710,0 days 00:05:35,1,7,6
101,IST,P012710,P012786,0 days 00:05:30,1,9,8
101,IST,P006372,P009513,0 days 00:04:53,-1,7,8
101,IST,P006372,P012788,0 days 00:04:49,1,5,4
101,IST,P009513,P010516,0 days 00:04:02,-10,0,10
101,IST,P012786,P012788,0 days 00:02:41,-6,0,6
101,IST,P011981,P012788,0 days 00:02:25,2,4,2
101,IST,P006372,P010516,0 days 00:02:11,2,2,0
101,PAN,P007866,P011204,0 days 00:29:05,-3,53,56
101,PAN,P003842,P012774,0 days 00:28:24,-4,50,54
101,PAN,P011204,P012774,0 days 00:28:07,-2,50,52
101,PAN,P003842,P007866,0 days 00:27:10,-3,47,50
101,PAN,P003842,P011204,0 days 00:26:59,-4,48,52
101,PAN,P001926,P007866,0 days 00:25:54,4,47,43
101,PAN,P007866,P012774,0 days 00:25:02,-3,45,48
101,PAN,P001926,P011204,0 days 00:22:38,2,43,41
101,PAN,P001926,P003842,0 days 00:20:26,4,37,33
101,PAN,P001926,P012774,0 days 00:17:10,2,33,31
101,PAN,P002328,P007866,0 days 00:16:36,-3,26,29
101,PAN,P002328,P011204,0 days 00:14:29,-6,25,31
101,PAN,P002328,P003842,0 days 00:12:34,-6,19,25
101,PAN,P001926,P002328,0 days 00:10:28,-1,16,17
101,PAN,P002328,P012774,0 days 00:10:26,-6,17,23
101,PAN,P011204,P011221,0 days 00:06:53,1,11,10
101,PAN,P002328,P011221,0 days 00:06:41,-4,11,15
101,PAN,P002328,P007947,0 days 00:06:25,-1,8,9
101,PAN,P001926,P011221,0 days 00:05:01,-4,7,11
101,PAN,P001926,P007947,0 days 00:05:00,-1,6,7
101,PAN,P003842,P007947,0 days 00:04:41,2,6,4
101,PAN,P007866,P007947,0 days 00:04:41,2,6,4
101,PAN,P002328,P007553,0 days 00:04:13,2,8,6
101,PAN,P007553,P011204,0 days 00:04:13,2,8,6
101,PAN,P011221,P012774,0 days 00:03:36,2,6,4
101,PAN,P003842,P011221,0 days 00:03:36,2,6,4
101,PAN,P007553,P007866,0 days 00:03:19,3,7,4
101,PAN,P007866,P011221,0 days 00:03:17,-1,5,6
101,PAN,P001926,P007553,0 days 00:02:11,1,5,4
101,PAN,P007553,P012774,0 days 00:02:02,1,3,2
101,PAN,P011826,P012774,0 days 00:01:56,2,2,0
101,PAN,P011204,P011826,0 days 00:01:56,2,2,0
101,PAN,P011221,P011826,0 days 00:01:56,2,2,0
101,PAN,P003842,P011826,0 days 00:01:56,2,2,0
101,PAN,P001926,P008084,0 days 00:01:44,-3,2,5
101,PAN,P002328,P008084,0 days 00:01:44,-3,2,5
101,PAN,P007947,P008084,0 days 00:01:44,-3,2,5
101,PAN,P007947,P011221,0 days 00:01:44,-3,2,5
101,PAN,P008084,P011221,0 days 00:01:44,-3,2,5
101,PAN,P007947,P012774,0 days 00:01:25,0,2,2
101,PAN,P003842,P007553,0 days 00:00:54,-1,1,2
102,MUN,P003583,P011987,0 days 00:33:51,22,80,58
102,MUN,P007056,P011987,0 days 00:32:23,16,74,58
102,MUN,P003583,P007056,0 days 00:32:07,15,74,59
102,MUN,P003583,P006760,0 days 00:28:12,20,68,48
102,MUN,P006760,P011987,0 days 00:28:12,20,68,48
102,MUN,P006760,P007056,0 days 00:26:10,14,62,48
102,MUN,P010391,P011987,0 days 00:23:41,7,49,42
102,MUN,P003583,P010391,0 days 00:22:49,10,46,36
102,MUN,P006760,P010391,0 days 00:22:39,0,43,43
102,MUN,P007056,P010391,0 days 00:21:24,0,40,40
102,MUN,P001557,P007975,0 days 00:13:56,-15,14,29
102,MUN,P007975,P011987,0 days 00:12:47,13,32,19
102,MUN,P007056,P007975,0 days 00:12:32,12,29,17
102,MUN,P007975,P010391,0 days 00:11:59,-11,17,28
102,MUN,P003583,P007975,0 days 00:10:44,16,29,13
102,MUN,P001557,P010391,0 days 00:09:07,-13,8,21
102,MUN,P001557,P007056,0 days 00:06:58,-7,6,13
102,MUN,P006760,P007975,0 days 00:06:56,8,20,12
102,MUN,P006543,P010391,0 days 00:06:46,5,14,9
102,MUN,P001557,P011987,0 days 00:05:45,-4,6,10
102,MUN,P007975,P011941,0 days 00:05:13,-5,8,13
102,MUN,P010391,P011941,0 days 00:05:13,-5,8,13
102,MUN,P001557,P003583,0 days 00:05:10,-3,6,9
102,MUN,P001557,P007639,0 days 00:05:01,-9,3,12
102,MUN,P007639,P007975,0 days 00:05:01,-9,3,12
102,MUN,P006543,P007975,0 days 00:04:44,-1,8,9
102,MUN,P006543,P011941,0 days 00:04:44,-1,8,9
102,MUN,P006245,P007056,0 days 00:04:09,-2,11,13
102,MUN,P006245,P006760,0 days 00:04:09,-2,11,13
102,MUN,P003583,P006245,0 days 00:04:09,-2,11,13
102,MUN,P006245,P011987,0 days 00:04:09,-2,11,13
102,MUN,P007639,P010391,0 days 00:03:50,-9,3,12
102,MUN,P001557,P011941,0 days 00:03:45,-3,5,8
102,MUN,P006543,P011987,0 days 00:03:30,4,9,5
102,MUN,P001557,P006543,0 days 00:03:16,1,5,4
102,MUN,P001557,P006760,0 days 00:02:46,-7,3,10
102,MUN,P006760,P007639,0 days 00:02:46,-7,3,10
102,MUN,P007056,P007639,0 days 00:02:15,-2,0,2
102,MUN,P003583,P006543,0 days 00:02:02,6,6,0
102,MUN,P006543,P006760,0 days 00:02:02,6,6,0
102,MUN,P011941,P011987,0 days 00:01:47,-4,3,7
102,MUN,P007639,P011987,0 days 00:01:11,0,0,0
102,MUN,P007056,P011941,0 days 00:00:10,-2,0,2
102,MIL,P002849,P007831,0 days 00:30:49,-20,55,75
102,MIL,P002849,P006509,0 days 00:24:33,-7,48,55
102,MIL,P006509,P007831,0 days 00:24:33,-7,48,55
102,MIL,P007201,P011205,0 days 00:23:03,14,49,35
102,MIL,P007831,P011205,0 days 00:20:03,-12,34,46
102,MIL,P007032,P007831,0 days 00:18:53,-2,34,36
102,MIL,P002849,P007032,0 days 00:17:41,-2,34,36
102,MIL,P002849,P009960,0 days 00:16:43,-9,28,37
102,MIL,P007831,P009960,0 days 00:16:43,-9,28,37
102,MIL,P002812,P011205,0 days 00:16:22,4,31,27
102,MIL,P005670,P011205,0 days 00:16:05,3,31,28
102,MIL,P002849,P011205,0 days 00:15:22,-17,26,43
102,MIL,P007201,P007831,0 days 00:15:08,4,30,26
102,MIL,P006509,P007032,0 days 00:14:31,1,29,28
102,MIL,P002812,P005670,0 days 00:14:07,8,29,21
102,MIL,P002812,P007201,0 days 00:13:52,11,27,16
102,MIL,P007032,P009960,0 days 00:13:49,0,26,26
102,MIL,P006509,P009960,0 days 00:12:43,2,26,24
102,MIL,P005670,P007201,0 days 00:12:40,11,27,16
102,MIL,P007032,P011205,0 days 00:10:53,4,20,16
102,MIL,P002849,P007201,0 days 00:10:27,-1,22,23
102,MIL,P007032,P007201,0 days 00:10:07,6,20,14
102,MIL,P006509,P007201,0 days 00:09:19,-4,17,21
102,MIL,P002812,P007032,0 days 00:09:11,6,18,12
102,MIL,P006509,P011205,0 days 00:09:06,-4,19,23
102,MIL,P002812,P007831,0 days 00:08:20,-5,13,18
102,MIL,P005670,P007831,0 days 00:07:31,-9,10,19
102,MIL,P005670,P007032,0 days 00:06:31,7,15,8
102,MIL,P002849,P005670,0 days 00:04:02,-14,2,16
102,MIL,P009960,P011205,0 days 00:04:00,-11,2,13
102,MIL,P002812,P002849,0 days 00:03:39,-10,5,15
102,MIL,P002812,P006701,0 days 00:02:59,1,6,5
102,MIL,P005670,P006701,0 days 00:02:59,1,6,5
102,MIL,P006701,P011205,0 days 00:02:59,1,6,5
102,MIL,P005670,P009960,0 days 00:02:54,-9,2,11
102,MIL,P006701,P007201,0 days 00:02:40,-1,4,5
102,MIL,P002812,P006509,0 days 00:02:31,-5,5,10
102,MIL,P005670,P006509,0 days 00:00:56,-4,0,4
102,MIL,P001518,P002812,0 days 00:00:19,2,2,0
102,MIL,P001518,P005670,0 days 00:00:19,2,2,0
102,MIL,P001518,P006701,0 days 00:00:19,2,2,0
102,MIL,P001518,P011205,0 days 00:00:19,2,2,0
103,OLY,P001255,P008811,0 days 00:21:34,-1,39,40
103,OLY,P001255,P008829,0 days 00:21:09,-3,41,44
103,OLY,P001255,P008855,0 days 00:20:59,-1,36,37
103,OLY,P008811,P008855,0 days 00:20:09,-3,32,35
103,OLY,P008811,P008829,0 days 00:19:15,-3,38,41
103,OLY,P008829,P008855,0 days 00:18:57,-4,36,40
103,OLY,P001255,P010612,0 days 00:14:32,-4,28,32
103,OLY,P008829,P010612,0 days 00:14:32,-4,28,32
103,OLY,P008855,P010392,0 days 00:14:15,-5,22,27
103,OLY,P007853,P008855,0 days 00:13:47,1,21,20
103,OLY,P003941,P008855,0 days 00:11:45,0,23,23
103,OLY,P008811,P010612,0 days 00:11:08,-1,23,24
103,OLY,P007853,P010392,0 days 00:11:01,6,18,12
103,OLY,P001255,P007853,0 days 00:10:54,2,18,16
103,OLY,P001255,P010392,0 days 00:10:50,2,16,14
103,OLY,P008855,P010612,0 days 00:09:52,2,19,17
103,OLY,P003941,P007853,0 days 00:08:54,-1,16,17
103,OLY,P008829,P010392,0 days 00:08:48,-1,16,17
103,OLY,P007853,P008811,0 days 00:08:34,3,12,9
103,OLY,P003941,P010392,0 days 00:08:24,1,17,16
103,OLY,P008811,P010392,0 days 00:08:13,-1,10,11
103,OLY,P001255,P003941,0 days 00:07:31,-3,13,16
103,OLY,P003941,P008829,0 days 00:07:05,-2,14,16
103,OLY,P008855,P011983,0 days 00:07:00,-2,15,17
103,OLY,P008829,P011983,0 days 00:07:00,-2,15,17
103,OLY,P003941,P006302,0 days 00:06:45,-4,11,15
103,OLY,P006589,P007853,0 days 00:06:27,-2,8,10
103,OLY,P006302,P007853,0 days 00:06:12,-2,10,12
103,OLY,P006302,P006589,0 days 00:05:51,-2,8,10
103,OLY,P006589,P008855,0 days 00:05:44,0,8,8
103,OLY,P001255,P006302,0 days 00:05:29,-6,11,17
103,OLY,P006302,P008855,0 days 00:05:08,0,8,8
103,OLY,P006302,P008829,0 days 00:04:46,-4,11,15
103,OLY,P006302,P010612,0 days 00:04:25,-4,9,13
103,OLY,P010392,P011983,0 days 00:04:21,-2,9,11
103,OLY,P008811,P011983,0 days 00:04:09,-3,8,11
103,OLY,P003941,P006589,0 days 00:03:57,-1,6,7
103,OLY,P006302,P008811,0 days 00:03:52,-2,8,10
103,OLY,P007853,P008829,0 days 00:03:48,3,9,6
103,OLY,P003941,P010612,0 days 00:03:24,-3,5,8
103,OLY,P003941,P011983,0 days 00:02:51,1,7,6
103,OLY,P001255,P011983,0 days 00:02:39,0,6,6
103,OLY,P006589,P008811,0 days 00:02:30,-1,2,3
103,OLY,P001255,P006589,0 days 00:00:43,-2,0,2
103,OLY,P006589,P010392,0 days 00:00:36,0,0,0
103,OLY,P007853,P010612,0 days 00:00:15,-2,0,2
103,MAD,P003108,P009005,0 days 00:25:35,4,47,43
103,MAD,P005791,P005928,0 days 00:22:00,9,46,37
103,MAD,P003108,PTGB,0 days 00:21:04,-7,30,37
103,MAD,P005928,P006540,0 days 00:20:23,11,47,36
103,MAD,P009005,PTGB,0 days 00:20:20,-3,32,35
103,MAD,P005791,P006540,0 days 00:18:11,9,43,34
103,MAD,P003108,P004887,0 days 00:17:28,-5,29,34
103,MAD,P003108,P005928,0 days 00:16:32,12,36,24
103,MAD,P004887,PTGB,0 days 00:16:11,-11,23,34
103,MAD,P004887,P009005,0 days 00:16:01,-3,29,32
103,MAD,P005928,P009005,0 days 00:14:46,13,32,19
103,MAD,P003108,P006540,0 days 00:14:26,4,32,28
103,MAD,P006540,P009005,0 days 00:12:40,5,28,23
103,MAD,P001392,P005928,0 days 00:11:28,2,26,24
103,MAD,P001392,P005791,0 days 00:11:28,2,26,24
103,MAD,P001392,P006540,0 days 00:11:28,2,26,24
103,MAD,P003108,P005791,0 days 00:11:23,10,26,16
103,MAD,P005791,P009005,0 days 00:11:04,9,22,13
103,MAD,P006540,P009213,0 days 00:10:26,-1,20,21
103,MAD,P005928,P009213,0 days 00:10:26,-1,20,21
103,MAD,P005791,P009213,0 days 00:10:26,-1,20,21
103,MAD,P001392,P009213,0 days 00:09:39,-1,18,19
103,MAD,P005928,PTGB,0 days 00:09:28,2,13,11
103,MAD,P004887,P006540,0 days 00:07:24,-4,11,15
103,MAD,P006540,PTGB,0 days 00:07:22,-6,9,15
103,MAD,P004887,P010623,0 days 00:07:07,-1,12,13
103,MAD,P003108,P010623,0 days 00:07:07,-1,12,13
103,MAD,P010623,PTGB,0 days 00:07:07,-1,12,13
103,MAD,P009005,P010623,0 days 00:07:07,-1,12,13
103,MAD,P004887,P005928,0 days 00:05:41,4,12,8
103,MAD,P005791,PTGB,0 days 00:05:36,6,9,3
103,MAD,P001392,P003108,0 days 00:01:49,3,8,5
103,MAD,P009005,P009213,0 days 00:00:47,0,2,2
104,PAR,P009862,P012742,0 days 00:34:26,10,73,63
104,PAR,P007400,P009862,0 days 00:33:25,3,69,66
104,PAR,P007400,P012742,0 days 00:31:17,1,65,64
104,PAR,P008987,P012742,0 days 00:31:11,4,64,60
104,PAR,P007400,P008987,0 days 00:31:03,-6,61,67
104,PAR,P008987,P009862,0 days 00:30:26,7,63,56
104,PAR,P011051,P012742,0 days 00:21:04,-4,42,46
104,PAR,P009862,P011051,0 days 00:21:04,-4,42,46
104,PAR,P008987,P011051,0 days 00:18:38,-2,38,40
104,PAR,P009862,P012096,0 days 00:17:59,16,38,22
104,PAR,P007400,P011051,0 days 00:15:35,-11,31,42
104,PAR,P012096,P012742,0 days 00:14:30,17,33,16
104,PAR,P007400,P012096,0 days 00:12:30,9,27,18
104,PAR,P008987,P012096,0 days 00:11:57,11,25,14
104,PAR,P000956,P012742,0 days 00:08:43,2,15,13
104,PAR,P000956,P007400,0 days 00:08:43,2,15,13
104,PAR,P007400,P009212,0 days 00:07:38,-4,13,17
104,PAR,P003983,P007400,0 days 00:07:15,-5,11,16
104,PAR,P003983,P009212,0 days 00:06:39,-5,11,16
104,PAR,P000956,P009862,0 days 00:06:23,4,12,8
104,PAR,P007400,P011050,0 days 00:05:53,2,12,10
104,PAR,P011050,P012742,0 days 00:05:53,2,12,10
104,PAR,P008987,P011050,0 days 00:05:53,2,12,10
104,PAR,P011051,P012096,0 days 00:05:29,7,11,4
104,PAR,P004172,P008987,0 days 00:04:45,-3,8,11
104,PAR,P008987,P009212,0 days 00:04:45,-3,8,11
104,PAR,P004172,P009212,0 days 00:04:45,-3,8,11
104,PAR,P004172,P007400,0 days 00:04:45,-3,8,11
104,PAR,P003983,P008987,0 days 00:04:22,-4,6,10
104,PAR,P009212,P009862,0 days 00:03:52,0,7,7
104,PAR,P003983,P004172,0 days 00:03:46,-4,6,10
104,PAR,P009862,P011050,0 days 00:03:33,4,9,5
104,PAR,P003983,P009862,0 days 00:03:29,-1,5,6
104,PAR,P003983,P012096,0 days 00:03:29,-1,5,6
104,PAR,P000956,P012096,0 days 00:03:09,6,8,2
104,PAR,P000956,P008987,0 days 00:03:08,-2,3,5
104,PAR,P009212,P012096,0 days 00:02:53,-1,5,6
104,PAR,P000956,P011051,0 days 00:02:26,-2,4,6
104,PAR,P000956,P011050,0 days 00:02:20,-2,3,5
104,PAR,P004172,P009862,0 days 00:00:59,1,2,1
104,MCO,P005985,P010588,0 days 00:33:08,-1,66,67
104,MCO,P005985,P011226,0 days 00:29:31,13,61,48
104,MCO,P010588,P011226,0 days 00:25:20,7,54,47
104,MCO,P005985,P009754,0 days 00:22:54,-4,42,46
104,MCO,P009754,P010588,0 days 00:22:19,-6,42,48
104,MCO,P010588,PLCZ,0 days 00:22:14,-9,39,48
104,MCO,P005985,PLCZ,0 days 00:22:13,-7,39,46
104,MCO,P011212,P011226,0 days 00:20:34,4,44,40
104,MCO,P005985,P011212,0 days 00:18:08,7,42,35
104,MCO,P009754,PLCZ,0 days 00:16:45,-6,28,34
104,MCO,P011226,PLCZ,0 days 00:15:59,3,33,30
104,MCO,P011226,P011231,0 days 00:15:59,1,27,26
104,MCO,P009754,P011226,0 days 00:15:23,7,34,27
104,MCO,P005985,P011231,0 days 00:15:13,-3,24,27
104,MCO,P010588,P011212,0 days 00:14:33,1,35,34
104,MCO,P011212,P011231,0 days 00:13:52,2,26,24
104,MCO,P011196,P011231,0 days 00:13:25,1,25,24
104,MCO,P011196,P011212,0 days 00:11:34,2,23,21
104,MCO,P011196,P011226,0 days 00:10:52,0,18,18
104,MCO,P010588,P011231,0 days 00:09:26,-4,16,20
104,MCO,P005985,P011196,0 days 00:08:56,0,15,15
104,MCO,P011212,PLCZ,0 days 00:07:17,-6,15,21
104,MCO,P011212,P012709,0 days 00:06:04,-2,11,13
104,MCO,P011226,P012709,0 days 00:06:04,-2,11,13
104,MCO,P009754,P011231,0 days 00:05:50,-4,8,12
104,MCO,P011196,P012709,0 days 00:05:05,-1,10,11
104,MCO,P011231,P012709,0 days 00:04:29,1,10,9
104,MCO,P004197,P005985,0 days 00:03:54,-9,2,11
104,MCO,P004197,P009754,0 days 00:03:54,-9,2,11
104,MCO,P004197,P010588,0 days 00:03:54,-9,2,11
104,MCO,P004197,PLCZ,0 days 00:03:54,-9,2,11
104,MCO,P010588,P011196,0 days 00:03:45,-3,7,10
104,MCO,P004790,P010588,0 days 00:02:42,3,6,3
104,MCO,P004790,P011226,0 days 00:02:42,3,6,3
104,MCO,P004790,P011212,0 days 00:02:42,3,6,3
104,MCO,P009754,P011196,0 days 00:02:27,-3,2,5
104,MCO,P009754,P011212,0 days 00:02:08,1,10,9
104,MCO,P004790,P005985,0 days 00:01:43,4,5,1
104,MCO,P010588,P012709,0 days 00:01:35,-3,1,4
104,MCO,P004790,P012709,0 days 00:00:59,-1,1,2
104,MCO,P011231,PLCZ,0 days 00:00:34,-2,0,2
105,ASV,P004194,P011225,0 days 00:26:21,12,62,50
105,ASV,P000229,P012729,0 days 00:22:56,4,59,55
105,ASV,P002100,P012729,0 days 00:22:16,-1,60,61
105,ASV,P011225,P012080,0 days 00:21:52,-5,45,50
105,ASV,P004194,P012080,0 days 00:19:55,-5,36,41
105,ASV,P012080,P012729,0 days 00:18:26,-5,47,52
105,ASV,P000229,P002100,0 days 00:17:55,2,46,44
105,ASV,P011225,P012729,0 days 00:16:41,14,53,39
105,ASV,P006568,P012080,0 days 00:16:09,-3,30,33
105,ASV,P006568,P011225,0 days 00:15:46,-6,27,33
105,ASV,P004194,P012729,0 days 00:15:34,9,44,35
105,ASV,P002100,P012080,0 days 00:14:06,-10,34,44
105,ASV,P000229,P012080,0 days 00:14:05,-2,33,35
105,ASV,P002100,P004194,0 days 00:13:41,4,40,36
105,ASV,P004194,P006568,0 days 00:12:43,-4,18,22
105,ASV,P002100,P011225,0 days 00:12:34,9,40,31
105,ASV,P000229,P011225,0 days 00:12:20,17,39,22
105,ASV,P003526,P012080,0 days 00:12:15,-1,18,19
105,ASV,P003526,P004194,0 days 00:12:15,-1,18,19
105,ASV,P003526,P011225,0 days 00:12:02,-1,18,19
105,ASV,P003526,P006568,0 days 00:12:02,-1,18,19
105,ASV,P000229,P004194,0 days 00:11:49,10,30,20
105,ASV,P000229,P012730,0 days 00:08:17,-9,17,26
105,ASV,P002100,P012730,0 days 00:08:17,-9,17,26
105,ASV,P012729,P012730,0 days 00:08:17,-9,17,26
105,ASV,P012080,P012730,0 days 00:07:48,-5,17,22
105,ASV,P006568,P012729,0 days 00:03:26,1,12,11
105,ASV,P000229,P006568,0 days 00:02:50,3,12,9
105,ASV,P002100,P006568,0 days 00:01:40,-2,3,5
105,ASV,P000229,P011386,0 days 00:01:19,-9,0,9
105,ASV,P002100,P011386,0 days 00:01:19,-9,0,9
105,ASV,P011386,P012729,0 days 00:01:19,-9,0,9
105,ASV,P004194,P011386,0 days 00:00:50,-5,0,5
105,ASV,P011386,P012730,0 days 00:00:29,-4,0,4
105,ASV,P000229,P003526,0 days 00:00:13,0,0,0
105,ASV,P003526,P012729,0 days 00:00:13,0,0,0
105,TEL,P009783,P009863,0 days 00:28:12,2,64,62
105,TEL,P009622,P009783,0 days 00:26:13,-4,60,64
105,TEL,P009622,P009863,0 days 00:25:45,0,60,60
105,TEL,P009863,P011219,0 days 00:23:05,9,59,50
105,TEL,P011214,P011219,0 days 00:21:35,10,51,41
105,TEL,P009863,P011214,0 days 00:18:57,10,46,36
105,TEL,P009783,P011219,0 days 00:17:47,2,42,40
105,TEL,P009622,P011199,0 days 00:16:21,-7,38,45
105,TEL,P009622,P011219,0 days 00:16:08,2,40,38
105,TEL,P009863,P011199,0 days 00:15:26,-3,38,41
105,TEL,P009783,P011199,0 days 00:14:51,-5,35,40
105,TEL,P009783,P011214,0 days 00:13:39,3,29,26
105,TEL,P009622,P011214,0 days 00:11:57,3,27,24
105,TEL,P011193,P011214,0 days 00:09:38,7,24,17
105,TEL,P011193,P011219,0 days 00:09:38,7,24,17
105,TEL,P005145,P009863,0 days 00:09:32,0,18,18
105,TEL,P009863,P011193,0 days 00:09:26,8,28,20
105,TEL,P005145,P011199,0 days 00:09:19,0,18,18
105,TEL,P011193,P012744,0 days 00:08:58,6,24,18
105,TEL,P005145,P009783,0 days 00:08:29,2,15,13
105,TEL,P005145,P009622,0 days 00:07:44,0,13,13
105,TEL,P011219,P012744,0 days 00:06:40,6,19,13
105,TEL,P011214,P012744,0 days 00:06:40,6,19,13
105,TEL,P004233,P011193,0 days 00:05:03,-1,11,12
105,TEL,P011193,P011199,0 days 00:05:02,-3,14,17
105,TEL,P011199,P011971,0 days 00:04:11,-7,8,15
105,TEL,P009622,P011971,0 days 00:04:11,-7,8,15
105,TEL,P011199,P011219,0 days 00:04:11,-1,13,14
105,TEL,P004233,P011214,0 days 00:04:03,1,8,7
105,TEL,P004233,P011219,0 days 00:04:00,1,8,7
105,TEL,P009863,P012744,0 days 00:03:59,6,14,8
105,TEL,P009783,P011193,0 days 00:03:33,-1,8,9
105,TEL,P009622,P011193,0 days 00:03:27,-3,9,12
105,TEL,P011193,P011971,0 days 00:02:46,-4,5,9
105,TEL,P004233,P012744,0 days 00:02:41,0,5,5
105,TEL,P004233,P009863,0 days 00:02:25,-1,6,7
105,TEL,P009622,P012744,0 days 00:02:18,0,5,5
105,TEL,P011199,P012744,0 days 00:02:18,0,5,5
105,TEL,P011971,P012744,0 days 00:02:18,0,5,5
105,TEL,P005145,P011193,0 days 00:02:01,0,5,5
105,TEL,P009783,P011971,0 days 00:01:53,-7,3,10
105,TEL,P009863,P011971,0 days 00:01:25,-3,3,6
105,TEL,P004233,P011199,0 days 00:01:06,-2,3,5
105,TEL,P004233,P005145,0 days 00:01:03,-2,3,5
105,TEL,P004233,P009783,0 days 00:00:03,0,0,0
105,TEL,P011199,P011214,0 days 00:00:03,0,0,0
106,BAS,P004603,P009048,0 days 00:25:57,6,53,47
106,BAS,P011948,P012201,0 days 00:25:26,11,64,53
106,BAS,P004761,P009048,0 days 00:22:29,2,42,40
106,BAS,P009048,P012201,0 days 00:20:38,9,45,36
106,BAS,P004603,P004761,0 days 00:20:15,7,42,35
106,BAS,P004603,P012201,0 days 00:19:22,15,48,33
106,BAS,P009048,P011948,0 days 00:18:48,11,45,34
106,BAS,P004603,P011948,0 days 00:17:32,17,48,31
106,BAS,P004603,P007230,0 days 00:16:29,-3,32,35
106,BAS,P007230,P009048,0 days 00:15:45,-6,29,35
106,BAS,P004761,P012201,0 days 00:12:32,11,31,20
106,BAS,P004761,P007230,0 days 00:11:43,-3,19,22
106,BAS,P011085,P011948,0 days 00:11:19,-1,22,23
106,BAS,P009048,P011085,0 days 00:10:42,-2,17,19
106,BAS,P004761,P011948,0 days 00:10:42,13,31,18
106,BAS,P011085,P012201,0 days 00:10:08,-1,22,23
106,BAS,P008072,P011948,0 days 00:09:48,-11,13,24
106,BAS,P008072,P011085,0 days 00:09:33,-12,11,23
106,BAS,P007230,P011948,0 days 00:08:34,1,19,18
106,BAS,P011064,P011948,0 days 00:08:07,-5,14,19
106,BAS,P004603,P011085,0 days 00:07:45,5,19,14
106,BAS,P008072,P012201,0 days 00:07:40,-9,13,22
106,BAS,P007230,P012201,0 days 00:07:19,3,19,16
106,BAS,P007230,P011085,0 days 00:07:10,-6,8,14
106,BAS,P004761,P011085,0 days 00:06:38,-3,13,16
106,BAS,P011064,P012201,0 days 00:05:59,-3,14,17
106,BAS,P008072,P011064,0 days 00:05:57,-8,8,16
106,BAS,P011064,P011085,0 days 00:05:57,-8,8,16
106,BAS,P003198,P009048,0 days 00:05:34,-2,8,10
106,BAS,P003198,P007230,0 days 00:05:34,-2,8,10
106,BAS,P003198,P004761,0 days 00:05:34,-2,8,10
106,BAS,P003198,P004603,0 days 00:05:34,-2,8,10
106,BAS,P008072,P009048,0 days 00:05:03,-6,5,11
106,BAS,P007230,P011064,0 days 00:04:18,1,6,5
106,BAS,P007230,P008072,0 days 00:03:20,-5,0,5
106,BAS,P004761,P008072,0 days 00:02:39,-5,2,7
106,BAS,P004603,P011064,0 days 00:02:10,3,6,3
106,ULK,P008962,P010560,0 days 00:26:35,3,51,48
106,ULK,P008962,P011157,0 days 00:22:17,3,44,41
106,ULK,P004004,P008962,0 days 00:22:11,4,41,37
106,ULK,P008962,P011052,0 days 00:20:35,6,48,42
106,ULK,P008962,P009849,0 days 00:18:31,5,42,37
106,ULK,P010560,P011157,0 days 00:18:09,-8,27,35
106,ULK,P004004,P011157,0 days 00:17:47,-3,32,35
106,ULK,P002968,P011052,0 days 00:16:23,2,35,33
106,ULK,P004004,P011052,0 days 00:14:20,1,30,29
106,ULK,P002968,P008962,0 days 00:14:11,4,31,27
106,ULK,P001932,P010560,0 days 00:13:39,-5,21,26
106,ULK,P001932,P011157,0 days 00:13:39,-5,21,26
106,ULK,P004004,P010560,0 days 00:13:38,-6,17,23
106,ULK,P009849,P011052,0 days 00:12:41,5,30,25
106,ULK,P001932,P008962,0 days 00:12:19,1,21,20
106,ULK,P001932,P004004,0 days 00:12:19,-6,18,24
106,ULK,P009849,P011157,0 days 00:11:18,5,29,24
106,ULK,P010560,P011052,0 days 00:10:42,2,24,22
106,ULK,P004004,P009849,0 days 00:09:53,4,24,20
106,ULK,P002968,P010560,0 days 00:09:46,5,24,19
106,ULK,P006661,P010560,0 days 00:09:13,2,22,20
106,ULK,P006661,P008962,0 days 00:09:13,2,22,20
106,ULK,P009849,P010560,0 days 00:08:38,1,18,17
106,ULK,P002968,P004004,0 days 00:07:56,-1,13,14
106,ULK,P002968,P009849,0 days 00:07:13,0,13,13
106,ULK,P006661,P011052,0 days 00:06:55,1,17,16
106,ULK,P002968,P006661,0 days 00:06:55,1,17,16
106,ULK,P011052,P011157,0 days 00:06:24,2,17,15
106,ULK,P006661,P011157,0 days 00:03:34,0,6,6
106,ULK,P006661,P009849,0 days 00:03:34,0,6,6
106,ULK,P004004,P011980,0 days 00:03:32,-8,4,12
106,ULK,P001932,P009849,0 days 00:02:16,0,6,6
106,ULK,P001932,P011980,0 days 00:02:16,-7,3,10
106,ULK,P002968,P011980,0 days 00:02:12,-2,4,6
106,ULK,P011052,P011980,0 days 00:02:12,-2,4,6
106,ULK,P010560,P011980,0 days 00:01:20,-6,0,6
106,ULK,P011157,P011980,0 days 00:01:20,-6,0,6
106,ULK,P004004,P006661,0 days 00:01:16,-1,1,2
106,ULK,P006661,P011980,0 days 00:01:16,-1,1,2
106,ULK,P001932,P002968,0 days 00:00:56,-1,3,4
106,ULK,P001932,P011052,0 days 00:00:56,-1,3,4
107,PAM,P007870,P011970,0 days 00:20:13,-2,36,38
107,PAM,P000556,P011982,0 days 00:19:20,11,52,41
107,PAM,P000556,P010568,0 days 00:18:08,-5,38,43
107,PAM,P004863,P007870,0 days 00:17:31,10,38,28
107,PAM,P006643,P007870,0 days 00:17:25,-1,31,32
107,PAM,P004863,P011970,0 days 00:16:55,7,33,26
107,PAM,P007870,P010568,0 days 00:15:57,-12,30,42
107,PAM,P010568,P011982,0 days 00:15:31,-6,34,40
107,PAM,P006643,P011970,0 days 00:14:24,-6,19,25
107,PAM,P000556,P007870,0 days 00:14:05,1,32,31
107,PAM,P003960,P007870,0 days 00:12:59,1,25,24
107,PAM,P003960,P006643,0 days 00:12:59,1,25,24
107,PAM,P004863,P006643,0 days 00:12:47,2,22,20
107,PAM,P005356,P010568,0 days 00:11:37,-2,31,33
107,PAM,P000556,P011970,0 days 00:11:32,5,25,20
107,PAM,P007870,P011982,0 days 00:11:28,0,28,28
107,PAM,P000556,P005356,0 days 00:11:25,2,32,30
107,PAM,P003960,P004863,0 days 00:11:21,5,22,17
107,PAM,P000556,P012739,0 days 00:11:04,3,24,21
107,PAM,P005356,P011982,0 days 00:10:29,2,30,28
107,PAM,P004863,P011982,0 days 00:09:45,12,25,13
107,PAM,P011982,P012739,0 days 00:09:38,6,24,18
107,PAM,P003960,P011970,0 days 00:09:28,-1,15,16
107,PAM,P000556,P004863,0 days 00:09:22,12,23,11
107,PAM,P006643,P010568,0 days 00:08:40,-4,16,20
107,PAM,P011970,P011982,0 days 00:08:25,7,23,16
107,PAM,P010568,P012739,0 days 00:08:11,0,18,18
107,PAM,P010568,P011970,0 days 00:07:43,-9,11,20
107,PAM,P004863,P010568,0 days 00:06:43,0,12,12
107,PAM,P005356,P012739,0 days 00:06:23,1,17,16
107,PAM,P005356,P007870,0 days 00:05:54,-1,16,17
107,PAM,P000556,P006643,0 days 00:05:52,-5,6,11
107,PAM,P004863,P012739,0 days 00:05:01,4,9,5
107,PAM,P003960,P010568,0 days 00:04:14,-2,10,12
107,PAM,P011970,P012739,0 days 00:02:33,1,4,3
107,PAM,P005356,P006643,0 days 00:01:51,0,5,5
107,PAM,P006643,P012739,0 days 00:01:26,-3,0,3
107,PAM,P003960,P005356,0 days 00:00:55,0,3,3
107,PAM,P004863,P005356,0 days 00:00:43,4,4,0
107,PAM,P005356,P011970,0 days 00:00:03,2,2,0
107,RED,P002553,P009035,0 days 00:18:32,6,38,32
107,RED,P007960,PJDR,0 days 00:17:23,12,44,32
107,RED,P006436,P009035,0 days 00:15:36,-10,25,35
107,RED,P007960,P011224,0 days 00:15:31,1,38,37
107,RED,P007960,P009035,0 days 00:15:16,10,33,23
107,RED,P002553,P006436,0 days 00:15:09,-2,28,30
107,RED,P000848,P006436,0 days 00:14:27,-9,21,30
107,RED,P000848,P009035,0 days 00:13:45,-1,22,23
107,RED,P009035,PJDR,0 days 00:13:35,9,31,22
107,RED,PJDR,PLUO,0 days 00:12:30,8,29,21
107,RED,P007960,P008966,0 days 00:11:35,-8,27,35
107,RED,P006436,P012044,0 days 00:10:10,-14,13,27
107,RED,P009035,P011224,0 days 00:09:48,7,21,14
107,RED,P000848,P007960,0 days 00:09:41,-5,16,21
107,RED,P011224,PJDR,0 days 00:09:33,7,28,21
107,RED,P002553,PJDR,0 days 00:09:31,17,26,9
107,RED,P000848,P012044,0 days 00:09:27,-14,11,25
107,RED,P007960,PLUO,0 days 00:09:24,2,22,20
107,RED,P006436,P007960,0 days 00:09:18,-10,16,26
107,RED,P002553,P007960,0 days 00:09:17,9,23,14
107,RED,P009035,PLUO,0 days 00:09:05,4,20,16
107,RED,P002553,PLUO,0 days 00:09:04,13,22,9
107,RED,P000848,P002553,0 days 00:08:38,-5,12,17
107,RED,P008966,P011224,0 days 00:08:05,-4,21,25
107,RED,P000848,P011224,0 days 00:07:54,1,14,13
107,RED,P008966,PJDR,0 days 00:07:52,7,23,16
107,RED,P006436,P008966,0 days 00:06:45,-2,12,14
107,RED,P006436,P011224,0 days 00:06:41,1,14,13
107,RED,P009035,P012044,0 days 00:06:40,-10,7,17
107,RED,P002553,P012044,0 days 00:06:40,-10,7,17
107,RED,P004720,P007960,0 days 00:06:38,-5,15,20
107,RED,P002553,P011224,0 days 00:05:36,1,11,10
107,RED,P004720,PJDR,0 days 00:05:32,-1,15,16
107,RED,P006436,PJDR,0 days 00:05:30,1,10,9
107,RED,P004720,P011224,0 days 00:05:23,-2,12,14
107,RED,P004720,P008966,0 days 00:04:48,-2,12,14
107,RED,P006436,PLUO,0 days 00:04:42,-1,9,10
107,RED,P000848,P008966,0 days 00:04:34,-9,6,15
107,RED,P008966,PLUO,0 days 00:04:08,4,11,7
107,RED,P000848,PJDR,0 days 00:03:46,7,10,3
107,RED,P008966,P012044,0 days 00:03:30,-4,6,10
107,RED,P007960,P012044,0 days 00:03:30,-4,6,10
107,RED,P002553,P008966,0 days 00:03:15,2,6,4
107,RED,P011224,PLUO,0 days 00:03:01,0,9,9
107,RED,P004720,P009035,0 days 00:02:23,-4,3,7
107,RED,P002553,P004720,0 days 00:01:26,1,3,2
107,RED,P000848,P004720,0 days 00:01:04,-5,0,5
107,RED,P012044,PLUO,0 days 00:00:43,0,2,2
107,RED,P004720,P006436,0 days 00:00:39,-5,0,5
107,RED,P004720,P012711,0 days 00:00:39,-5,0,5
107,RED,P006436,P012711,0 days 00:00:39,-5,0,5
107,RED,P009035,P012711,0 days 00:00:36,-3,0,3
107,RED,P012711,PJDR,0 days 00:00:36,-3,0,3
107,RED,P004720,PLUO,0 days 00:00:24,-4,0,4
107,RED,P007960,P012711,0 days 00:00:03,-2,0,2
107,RED,P012711,PLUO,0 days 00:00:03,-2,0,2
108,VIR,P001133,P001844,0 days 00:27:48,8,57,49
108,VIR,P001844,P009549,0 days 00:20:47,2,37,35
108,VIR,P001844,PBCN,0 days 00:19:51,-2,39,41
108,VIR,P001133,PBCN,0 days 00:19:26,1,39,38
108,VIR,P001133,P009549,0 days 00:18:21,2,33,31
108,VIR,P001844,P003048,0 days 00:16:27,1,33,32
108,VIR,P001844,P008847,0 days 00:16:22,-4,28,32
108,VIR,P001133,P003048,0 days 00:16:03,12,38,26
108,VIR,P001133,P008847,0 days 00:15:10,1,26,25
108,VIR,P009549,PBCN,0 days 00:13:55,-1,23,24
108,VIR,P001133,P010781,0 days 00:13:47,16,36,20
108,VIR,P001133,P004007,0 days 00:12:46,19,32,13
108,VIR,P001844,P004007,0 days 00:12:35,8,27,19
108,VIR,P008847,P010781,0 days 00:11:58,-15,15,30
108,VIR,P004007,P010781,0 days 00:11:53,11,27,16
108,VIR,P001844,P010781,0 days 00:11:35,2,27,25
108,VIR,P008847,PBCN,0 days 00:11:35,-5,22,27
108,VIR,P003048,P009549,0 days 00:11:13,-1,17,18
108,VIR,P003048,PBCN,0 days 00:10:15,-5,18,23
108,VIR,P003048,P004007,0 days 00:09:36,15,26,11
108,VIR,P004007,P008847,0 days 00:09:18,-6,12,18
108,VIR,P008847,P009549,0 days 00:08:55,4,19,15
108,VIR,P003048,P010781,0 days 00:08:38,11,27,16
108,VIR,P010781,PBCN,0 days 00:07:58,-4,20,24
108,VIR,P004007,P009549,0 days 00:06:52,3,14,11
108,VIR,P001133,P012713,0 days 00:04:03,9,11,2
108,VIR,P010781,P012713,0 days 00:04:03,9,11,2
108,VIR,P004007,P012713,0 days 00:04:03,9,11,2
108,VIR,P008847,P012714,0 days 00:03:59,-8,6,14
108,VIR,P010781,P012714,0 days 00:03:59,-8,6,14
108,VIR,P011192,P012714,0 days 00:03:52,-7,6,13
108,VIR,P010781,P011192,0 days 00:03:52,-7,6,13
108,VIR,P008847,P011192,0 days 00:03:52,-7,6,13
108,VIR,P003048,P012713,0 days 00:03:24,9,11,2
108,VIR,P003527,P009549,0 days 00:02:26,0,4,4
108,VIR,P003527,P004007,0 days 00:02:26,0,4,4
108,VIR,P001844,P003527,0 days 00:02:26,0,4,4
108,VIR,P004007,P012714,0 days 00:02:12,-6,2,8
108,VIR,P012714,PBCN,0 days 00:02:09,-4,4,8
108,VIR,P003048,P003527,0 days 00:02:04,2,4,2
108,VIR,P011192,PBCN,0 days 00:02:02,-3,4,7
108,VIR,P004007,P011192,0 days 00:01:50,-4,2,6
108,VIR,P003048,P008847,0 days 00:01:44,-4,2,6
108,VIR,P008847,P012713,0 days 00:00:39,0,0,0
108,VIR,P001844,P012714,0 days 00:00:29,-3,0,3
108,VIR,P003527,P012714,0 days 00:00:22,-2,0,2
108,VIR,P009549,P012714,0 days 00:00:22,-2,0,2
108,VIR,P004007,PBCN,0 days 00:00:21,3,3,0
108,VIR,P009549,P010781,0 days 00:00:17,1,1,0
108,BAR,P002939,P006435,0 days 00:23:06,-7,38,45
108,BAR,P000925,P006435,0 days 00:22:06,-5,34,39
108,BAR,P000925,P002939,0 days 00:22:01,-2,36,38
108,BAR,P002939,P011244,0 days 00:19:20,-7,29,36
108,BAR,P006435,P011244,0 days 00:18:59,-7,29,36
108,BAR,P002939,P004866,0 days 00:17:54,-2,31,33
108,BAR,P000925,P011244,0 days 00:17:41,-6,24,30
108,BAR,P004866,P006435,0 days 00:17:08,-10,25,35
108,BAR,P000925,P004866,0 days 00:16:33,-1,28,29
108,BAR,P003196,P012745,0 days 00:14:30,-1,31,32
108,BAR,P009992,P012745,0 days 00:13:34,8,34,26
108,BAR,P004866,P012745,0 days 00:13:31,-11,23,34
108,BAR,P007519,P012745,0 days 00:12:28,-2,24,26
108,BAR,P003196,P009992,0 days 00:12:10,6,29,23
108,BAR,P002939,P003478,0 days 00:11:28,0,25,25
108,BAR,P004866,P011244,0 days 00:10:45,-2,15,17
108,BAR,P003196,P007519,0 days 00:10:38,-1,21,22
108,BAR,P003478,P006435,0 days 00:10:26,-2,21,23
108,BAR,P007519,P009992,0 days 00:09:29,4,21,17
108,BAR,P003196,P004866,0 days 00:09:12,-11,15,26
108,BAR,P000925,P003478,0 days 00:09:08,-1,16,17
108,BAR,P003478,P011244,0 days 00:08:56,-5,14,19
108,BAR,P004866,P009992,0 days 00:08:16,-2,18,20
108,BAR,P004866,P007519,0 days 00:07:51,-10,12,22
108,BAR,P003196,P003478,0 days 00:06:57,9,21,12
108,BAR,P002939,P012745,0 days 00:06:21,1,15,14
108,BAR,P002939,P003196,0 days 00:05:31,-1,15,16
108,BAR,P003478,P012745,0 days 00:05:18,10,16,6
108,BAR,P003478,P009992,0 days 00:05:18,10,16,6
108,BAR,P006435,P012745,0 days 00:05:15,-9,5,14
108,BAR,P003478,P007519,0 days 00:04:37,8,12,4
108,BAR,P000925,P012745,0 days 00:04:19,0,8,8
108,BAR,P002939,P009992,0 days 00:04:05,4,13,9
108,BAR,P003196,P006435,0 days 00:03:59,-8,7,15
108,BAR,P006435,P007519,0 days 00:02:59,-6,3,9
108,BAR,P003478,P004866,0 days 00:01:50,1,5,4
108,BAR,P000925,P007519,0 days 00:01:50,-1,3,4
108,BAR,P003196,P011244,0 days 00:01:39,-1,5,6
108,BAR,P000925,P009992,0 days 00:01:24,2,5,3
108,BAR,P000925,P003204,0 days 00:00:22,2,2,0
108,BAR,P002939,P003204,0 days 00:00:22,2,2,0
108,BAR,P003204,P003478,0 days 00:00:22,2,2,0
108,BAR,P003204,P006435,0 days 00:00:22,2,2,0
109,BER,P003958,P012721,0 days 00:20:20,-7,39,46
109,BER,P003958,P008173,0 days 00:18:39,-2,40,42
109,BER,P006251,P008384,0 days 00:17:28,-2,44,46
109,BER,P008173,P012721,0 days 00:16:59,-3,32,35
109,BER,P003958,P007025,0 days 00:16:21,-9,34,43
109,BER,P003958,P008384,0 days 00:15:55,3,40,37
109,BER,P006251,P008211,0 days 00:15:12,3,38,35
109,BER,P008173,P008384,0 days 00:14:26,4,36,32
109,BER,P008384,P012721,0 days 00:14:12,3,33,30
109,BER,P007025,P008211,0 days 00:12:39,-6,29,35
109,BER,P003958,P011934,0 days 00:12:35,-2,23,25
109,BER,P003958,P006251,0 days 00:12:14,4,37,33
109,BER,P008211,P008384,0 days 00:12:01,0,30,30
109,BER,P007025,P012721,0 days 00:11:47,-15,18,33
109,BER,P006251,P007025,0 days 00:10:55,1,31,30
109,BER,P011934,P012721,0 days 00:10:52,-7,18,25
109,BER,P003958,P008211,0 days 00:10:16,-2,25,27
109,BER,P006251,P008173,0 days 00:09:53,-1,30,31
109,BER,P007025,P011934,0 days 00:09:40,-7,13,20
109,BER,P006251,P012721,0 days 00:09:18,-4,23,27
109,BER,P008211,P012721,0 days 00:09:00,-9,19,28
109,BER,P006819,P008173,0 days 00:08:52,1,19,18
109,BER,P006819,P008384,0 days 00:08:52,1,19,18
109,BER,P008211,P010791,0 days 00:08:44,-5,16,21
109,BER,P006251,P010791,0 days 00:08:44,-5,18,23
109,BER,P008173,P011934,0 days 00:08:05,1,16,15
109,BER,P007025,P008173,0 days 00:07:44,-5,15,20
109,BER,P007025,P010791,0 days 00:06:55,-2,20,22
109,BER,P008211,P011934,0 days 00:06:33,-5,7,12
109,BER,P010791,P012721,0 days 00:06:04,-5,15,20
109,BER,P006819,P012721,0 days 00:05:24,-1,7,8
109,BER,P003958,P006819,0 days 00:05:21,0,8,8
109,BER,P008384,P010791,0 days 00:05:21,-3,8,11
109,BER,P006251,P006819,0 days 00:05:13,1,16,15
109,BER,P007025,P008384,0 days 00:05:04,-1,14,15
109,BER,P008384,P011934,0 days 00:04:58,3,10,7
109,BER,P003958,P010791,0 days 00:03:59,-1,14,15
109,BER,P006251,P011934,0 days 00:03:52,3,5,2
109,BER,P008173,P010791,0 days 00:02:16,-1,9,10
109,BER,P010791,P011934,0 days 00:01:57,-2,0,2
109,BER,P006819,P008211,0 days 00:01:46,2,7,5
109,BER,P008173,P008211,0 days 00:01:46,2,7,5
109,BER,P006251,P011631,0 days 00:00:27,0,2,2
109,BER,P007025,P011631,0 days 00:00:27,0,2,2
109,BER,P008211,P011631,0 days 00:00:27,0,2,2
109,BER,P008384,P011631,0 days 00:00:27,0,2,2
109,IST,P009513,P011078,0 days 00:31:16,13,86,73
109,IST,P007200,P009513,0 days 00:28:01,10,72,62
109,IST,P007200,P011078,0 days 00:27:33,9,69,60
109,IST,P007200,P011981,0 days 00:24:15,3,58,55
109,IST,P011078,P011981,0 days 00:22:51,5,58,53
109,IST,P011078,P012786,0 days 00:21:07,14,61,47
109,IST,P009513,P011981,0 days 00:20:46,6,54,48
109,IST,P009513,P012786,0 days 00:19:36,14,63,49
109,IST,P009513,P012788,0 days 00:17:43,0,44,44
109,IST,P009513,P012710,0 days 00:16:11,2,31,29
109,IST,P011078,P012788,0 days 00:15:10,0,37,37
109,IST,P007200,P012786,0 days 00:15:05,11,45,34
109,IST,P007200,P012710,0 days 00:14:27,1,26,25
109,IST,P011078,P012710,0 days 00:14:12,1,30,29
109,IST,P012786,P012788,0 days 00:14:10,3,37,34
109,IST,P011981,P012710,0 days 00:12:58,-1,24,25
109,IST,P007200,P012788,0 days 00:10:31,-1,23,24
109,IST,P010516,P012786,0 days 00:10:10,-3,23,26
109,IST,P009513,P010516,0 days 00:09:55,-1,22,23
109,IST,P010516,P011078,0 days 00:09:27,-2,19,21
109,IST,P010516,P012788,0 days 00:09:10,1,22,21
109,IST,P007200,P010516,0 days 00:08:44,-5,11,16
109,IST,P011981,P012786,0 days 00:08:40,9,29,20
109,IST,P010516,P011981,0 days 00:04:53,-5,4,9
109,IST,P012710,P012788,0 days 00:04:07,2,8,6
109,IST,P010516,P012710,0 days 00:03:53,-1,3,4
109,IST,P011981,P012788,0 days 00:02:37,-5,5,10
109,IST,P012710,P012786,0 days 00:02:32,0,6,6
110,PAN,P007947,P012774,0 days 00:27:24,-3,62,65
110,PAN,P003842,P012774,0 days 00:26:57,-7,59,66
110,PAN,P007866,P007947,0 days 00:25:23,-8,51,59
110,PAN,P002328,P007866,0 days 00:24:34,-5,45,50
110,PAN,P003842,P007947,0 days 00:22:31,3,55,52
110,PAN,P002328,P007947,0 days 00:21:49,-1,41,42
110,PAN,P007866,P012774,0 days 00:20:35,-13,43,56
110,PAN,P003842,P007866,0 days 00:18:27,-11,40,51
110,PAN,P003842,P011204,0 days 00:17:50,-9,37,46
110,PAN,P002328,P012774,0 days 00:16:45,-6,33,39
110,PAN,P011204,P012774,0 days 00:15:26,-7,33,40
110,PAN,P002328,P003842,0 days 00:14:58,-6,30,36
110,PAN,P008084,P011204,0 days 00:11:57,-2,23,25
110,PAN,P008084,P012774,0 days 00:11:57,-2,23,25
110,PAN,P003842,P008084,0 days 00:11:36,0,23,23
110,PAN,P007947,P011204,0 days 00:10:39,3,29,26
110,PAN,P002328,P007553,0 days 00:09:36,1,15,14
110,PAN,P007553,P007866,0 days 00:09:36,1,15,14
110,PAN,P007553,P007947,0 days 00:09:36,1,15,14
110,PAN,P001926,P007866,0 days 00:08:05,1,12,11
110,PAN,P001926,P003842,0 days 00:07:53,-14,8,22
110,PAN,P001926,P002328,0 days 00:07:49,1,12,11
110,PAN,P001926,P011204,0 days 00:07:32,-14,8,22
110,PAN,P007947,P008084,0 days 00:07:26,8,19,11
110,PAN,P007866,P011204,0 days 00:06:35,-11,14,25
110,PAN,P001926,P007947,0 days 00:05:04,5,8,3
110,PAN,P007553,P012774,0 days 00:04:53,-4,7,11
110,PAN,P001926,P012774,0 days 00:04:47,-10,4,14
110,PAN,P001926,P007553,0 days 00:04:43,5,8,3
110,PAN,P001926,P008084,0 days 00:04:31,-10,4,14
110,PAN,P002328,P011204,0 days 00:02:45,-4,4,8
110,PAN,P007866,P008084,0 days 00:00:21,-2,0,2
110,MAD,P005928,P009005,0 days 00:26:32,15,64,49
110,MAD,P005791,P005928,0 days 00:22:29,22,59,37
110,MAD,P005791,P009005,0 days 00:22:29,22,59,37
110,MAD,P005928,P006540,0 days 00:18:07,10,38,28
110,MAD,P006540,P009005,0 days 00:18:07,10,38,28
110,MAD,P005791,P006540,0 days 00:18:01,8,38,30
110,MAD,P003108,PBMT,0 days 00:15:30,8,41,33
110,MAD,P003108,P005928,0 days 00:15:17,9,45,36
110,MAD,P003108,P004887,0 days 00:15:00,-2,29,31
110,MAD,P003108,PTGB,0 days 00:15:00,-5,28,33
110,MAD,P001392,P005791,0 days 00:14:29,16,37,21
110,MAD,P001392,P005928,0 days 00:14:10,18,37,19
110,MAD,P001392,P009005,0 days 00:14:10,18,37,19
110,MAD,P004887,PTGB,0 days 00:13:57,0,26,26
110,MAD,P001392,P006540,0 days 00:13:02,4,26,22
110,MAD,P004887,PBMT,0 days 00:12:49,4,29,25
110,MAD,P003108,P009005,0 days 00:12:48,3,33,30
110,MAD,PBMT,PTGB,0 days 00:11:52,6,28,22
110,MAD,P005928,PBMT,0 days 00:10:02,10,34,24
110,MAD,P004887,P005928,0 days 00:09:25,1,22,21
110,MAD,P005928,PTGB,0 days 00:07:50,6,21,15
110,MAD,P009005,PBMT,0 days 00:07:33,4,22,18
110,MAD,P001392,P003108,0 days 00:07:26,-8,11,19
110,MAD,P003108,P005791,0 days 00:07:21,0,21,21
110,MAD,P004887,P009005,0 days 00:06:56,-5,10,15
110,MAD,P009005,P009213,0 days 00:05:48,1,12,11
110,MAD,P006540,P009213,0 days 00:05:48,1,12,11
110,MAD,P005928,P009213,0 days 00:05:48,1,12,11
110,MAD,P005791,P009213,0 days 00:05:48,1,12,11
110,MAD,P009005,PTGB,0 days 00:05:21,0,9,9
110,MAD,P001392,PTGB,0 days 00:04:11,-13,0,13
110,MAD,P001392,P004887,0 days 00:03:52,-11,0,11
110,MAD,P003108,P006540,0 days 00:03:06,-13,0,13
110,MAD,P006540,PTGB,0 days 00:02:32,-9,0,9
110,MAD,P004887,P006540,0 days 00:02:13,-7,0,7
110,MAD,P005791,PBMT,0 days 00:02:10,4,10,6
110,MAD,P001392,PBMT,0 days 00:02:04,-4,0,4
110,MAD,P005791,PTGB,0 days 00:00:57,-5,0,5
111,PAR,P008987,P009862,0 days 00:27:17,9,58,49
111,PAR,P007400,P008987,0 days 00:26:56,11,55,44
111,PAR,P007400,P009862,0 days 00:23:16,4,48,44
111,PAR,P008987,P011051,0 days 00:20:15,8,40,32
111,PAR,P007400,P012742,0 days 00:20:11,7,44,37
111,PAR,P009862,P012742,0 days 00:19:50,9,45,36
111,PAR,P008987,P012742,0 days 00:18:37,8,42,34
111,PAR,P008987,P012096,0 days 00:18:15,0,42,42
111,PAR,P007400,P011051,0 days 00:16:04,8,30,22
111,PAR,P009862,P012096,0 days 00:15:55,4,35,31
111,PAR,P012096,P012742,0 days 00:14:52,0,31,31
111,PAR,P009862,P011051,0 days 00:14:35,5,26,21
111,PAR,P007400,P012096,0 days 00:14:28,-1,30,31
111,PAR,P004058,P008987,0 days 00:10:49,11,23,12
111,PAR,P000956,P008987,0 days 00:09:54,11,20,9
111,PAR,P011051,P012096,0 days 00:09:26,-3,17,20
111,PAR,P004058,P011051,0 days 00:09:12,8,17,9
111,PAR,P000956,P011051,0 days 00:09:10,5,15,10
111,PAR,P000956,P007400,0 days 00:08:49,5,14,9
111,PAR,P011051,P012742,0 days 00:08:09,6,18,12
111,PAR,P004172,P011051,0 days 00:07:54,-2,15,17
111,PAR,P004058,P009862,0 days 00:07:44,4,16,12
111,PAR,P004172,P012096,0 days 00:07:29,-2,15,17
111,PAR,P004058,P007400,0 days 00:06:48,6,13,7
111,PAR,P000956,P004058,0 days 00:06:43,12,17,5
111,PAR,P000956,P009862,0 days 00:06:14,4,13,9
111,PAR,P003983,P012096,0 days 00:05:07,-3,10,13
111,PAR,P003983,P011051,0 days 00:05:07,-3,10,13
111,PAR,P003983,P004172,0 days 00:05:07,-3,10,13
111,PAR,P004172,P008987,0 days 00:04:45,-3,10,13
111,PAR,P003983,P008987,0 days 00:04:20,-3,10,13
111,PAR,P000956,P012096,0 days 00:04:20,2,10,8
111,PAR,P000956,P012742,0 days 00:03:14,1,5,4
111,PAR,P004172,P009862,0 days 00:02:10,1,3,2
111,PAR,P004058,P012096,0 days 00:02:00,3,6,3
111,PAR,P000956,P004172,0 days 00:01:24,0,2,2
111,PAR,P004172,P007400,0 days 00:01:24,0,2,2
111,PAR,P004172,P012742,0 days 00:01:23,1,3,2
111,PAR,P003983,P009862,0 days 00:00:47,0,0,0
111,MIL,P002849,P007831,0 days 00:26:38,8,57,49
111,MIL,P007032,P007831,0 days 00:23:45,-3,44,47
111,MIL,P002849,P007032,0 days 00:19:21,-1,36,37
111,MIL,P002812,P007831,0 days 00:18:44,4,36,32
111,MIL,P007831,P011205,0 days 00:17:59,-4,31,35
111,MIL,P002812,P011205,0 days 00:17:16,-11,22,33
111,MIL,P002849,P011205,0 days 00:16:46,6,33,27
111,MIL,P002849,P006509,0 days 00:16:06,-6,28,34
111,MIL,P002812,P002849,0 days 00:15:55,7,30,23
111,MIL,P007201,P007831,0 days 00:15:18,-15,24,39
111,MIL,P002812,P007032,0 days 00:15:00,-2,25,27
111,MIL,P006509,P007831,0 days 00:14:34,-6,26,32
111,MIL,P007032,P011205,0 days 00:12:47,-6,20,26
111,MIL,P002812,P006509,0 days 00:12:03,-8,14,22
111,MIL,P006509,P007201,0 days 00:11:57,-12,18,30
111,MIL,P002849,P005670,0 days 00:10:24,5,23,18
111,MIL,P005670,P006509,0 days 00:10:13,-10,14,24
111,MIL,P006509,P007032,0 days 00:09:53,-4,16,20
111,MIL,P002812,P005670,0 days 00:09:49,-4,15,19
111,MIL,P007032,P007201,0 days 00:09:41,-6,14,20
111,MIL,P005670,P011205,0 days 00:09:26,-4,15,19
111,MIL,P002812,P007201,0 days 00:08:49,-13,10,23
111,MIL,P002849,P007201,0 days 00:08:48,-4,16,20
111,MIL,P005670,P007831,0 days 00:08:27,2,21,19
111,MIL,P005670,P007201,0 days 00:07:53,-13,12,25
111,MIL,P007201,P011205,0 days 00:07:42,-20,2,22
111,MIL,P006509,P011205,0 days 00:06:44,-10,4,14
111,MIL,P001518,P007201,0 days 00:03:52,-1,8,9
111,MIL,P001518,P007831,0 days 00:03:29,1,8,7
111,MIL,P001518,P007032,0 days 00:03:27,1,8,7
111,MIL,P001518,P002812,0 days 00:03:18,3,8,5
111,MIL,P007831,P009960,0 days 00:02:47,3,8,5
111,MIL,P007032,P009960,0 days 00:02:47,3,8,5
111,MIL,P002849,P009960,0 days 00:02:47,3,8,5
111,MIL,P007032,P011926,0 days 00:02:21,-2,5,7
111,MIL,P009960,P011205,0 days 00:02:13,5,8,3
111,MIL,P001518,P006509,0 days 00:02:10,-6,0,6
111,MIL,P011205,P011926,0 days 00:02:07,-2,5,7
111,MIL,P007831,P011926,0 days 00:02:07,-2,5,7
111,MIL,P002849,P011926,0 days 00:02:07,-2,5,7
111,MIL,P001518,P011205,0 days 00:00:52,-2,0,2
111,MIL,P006509,P009960,0 days 00:00:34,-2,0,2
111,MIL,P002812,P011926,0 days 00:00:14,0,0,0
111,MIL,P005670,P007032,0 days 00:00:14,0,0,0
111,MIL,P005670,P011926,0 days 00:00:14,0,0,0
111,MIL,P006509,P011926,0 days 00:00:14,0,0,0
111,MIL,P001518,P002849,0 days 00:00:08,0,0,0
112,OLY,P008829,P008855,0 days 00:27:15,10,54,44
112,OLY,P001255,P008855,0 days 00:23:17,17,47,30
112,OLY,P008811,P008829,0 days 00:21:09,2,36,34
112,OLY,P001255,P008829,0 days 00:20:32,15,41,26
112,OLY,P001255,P010612,0 days 00:20:00,14,37,23
112,OLY,P008855,P010612,0 days 00:20:00,14,37,23
112,OLY,P008829,P010612,0 days 00:18:19,9,33,24
112,OLY,P008811,P008855,0 days 00:17:15,9,30,21
112,OLY,P008811,P010612,0 days 00:15:24,8,27,19
112,OLY,P008829,P010392,0 days 00:14:21,-9,29,38
112,OLY,P001255,P008811,0 days 00:14:20,11,25,14
112,OLY,P010392,P011983,0 days 00:13:24,-7,26,33
112,OLY,P003941,P008855,0 days 00:12:45,3,30,27
112,OLY,P003941,P010392,0 days 00:12:44,3,29,26
112,OLY,P001255,P003941,0 days 00:12:16,4,26,22
112,OLY,P008829,P011983,0 days 00:11:04,-12,19,31
112,OLY,P003941,P008829,0 days 00:10:27,1,24,23
112,OLY,P008855,P010392,0 days 00:10:00,-2,23,25
112,OLY,P003941,P006589,0 days 00:07:57,5,17,12
112,OLY,P008811,P010392,0 days 00:07:16,-9,11,20
112,OLY,P008811,P011983,0 days 00:07:16,-9,11,20
112,OLY,P008855,P011983,0 days 00:06:43,-5,13,18
112,OLY,P001255,P010392,0 days 00:06:36,1,14,13
112,OLY,P003941,P011983,0 days 00:06:08,2,15,13
112,OLY,P007853,P010392,0 days 00:06:05,1,11,10
112,OLY,P001255,P006589,0 days 00:06:04,0,10,10
112,OLY,P003941,P010612,0 days 00:05:40,3,12,9
112,OLY,P006589,P010392,0 days 00:05:39,3,11,8
112,OLY,P007853,P011983,0 days 00:05:37,1,11,10
112,OLY,P007853,P008811,0 days 00:03:17,-4,4,8
112,OLY,P007853,P008829,0 days 00:03:17,-4,4,8
112,OLY,P003941,P006302,0 days 00:02:51,-2,4,6
112,OLY,P001255,P006302,0 days 00:02:51,-2,4,6
112,OLY,P006302,P006589,0 days 00:02:51,-2,4,6
112,OLY,P006302,P010392,0 days 00:02:51,-2,4,6
112,OLY,P003941,P007853,0 days 00:02:48,5,7,2
112,OLY,P006589,P007853,0 days 00:02:48,5,7,2
112,OLY,P006589,P008855,0 days 00:02:45,2,6,4
112,OLY,P006589,P010612,0 days 00:02:45,2,6,4
112,OLY,P006589,P011983,0 days 00:02:20,5,7,2
112,OLY,P010392,P010612,0 days 00:01:04,-3,2,5
112,OLY,P010612,P011983,0 days 00:01:04,-3,2,5
112,OLY,P001255,P007853,0 days 00:00:28,0,0,0
112,OLY,P006589,P008811,0 days 00:00:27,0,0,0
112,MUN,P006543,P007975,0 days 00:18:25,0,40,40
112,MUN,P007056,P011987,0 days 00:15:59,-13,16,29
112,MUN,P006760,P007056,0 days 00:15:45,3,25,22
112,MUN,P005460,P007056,0 days 00:13:04,8,25,17
112,MUN,P001557,P011987,0 days 00:13:02,-13,15,28
112,MUN,P005460,P011987,0 days 00:12:20,5,23,18
112,MUN,P010391,P011987,0 days 00:12:16,-8,19,27
112,MUN,P005460,P006760,0 days 00:11:34,8,23,15
112,MUN,P006543,P012123,0 days 00:11:26,-4,22,26
112,MUN,P006760,P011987,0 days 00:11:25,-4,12,16
112,MUN,P007975,P012123,0 days 00:11:13,-4,22,26
112,MUN,P007975,P010391,0 days 00:10:36,-2,19,21
112,MUN,P007056,P010391,0 days 00:10:04,-5,14,19
112,MUN,P007639,P011987,0 days 00:09:54,-17,9,26
112,MUN,P001557,P007056,0 days 00:09:53,-17,4,21
112,MUN,P006760,P012123,0 days 00:08:43,7,22,15
112,MUN,P006543,P010391,0 days 00:08:39,-2,17,19
112,MUN,P006760,P007639,0 days 00:08:21,-5,11,16
112,MUN,P007639,P007975,0 days 00:08:07,-1,17,18
112,MUN,P006543,P011941,0 days 00:07:58,-5,12,17
112,MUN,P007975,P011987,0 days 00:07:45,1,18,17
112,MUN,P007975,P011941,0 days 00:07:45,-5,12,17
112,MUN,P001557,P007639,0 days 00:07:42,-14,4,18
112,MUN,P007056,P007639,0 days 00:07:42,-14,4,18
112,MUN,P006543,P007639,0 days 00:07:40,-1,17,18
112,MUN,P006245,P012123,0 days 00:07:09,3,16,13
112,MUN,P007639,P010391,0 days 00:07:01,-10,10,20
112,MUN,P005460,P010391,0 days 00:06:33,4,12,8
112,MUN,P011941,P012123,0 days 00:06:25,-6,10,16
112,MUN,P001557,P006760,0 days 00:06:22,-8,2,10
112,MUN,P001557,P005460,0 days 00:05:47,1,11,10
112,MUN,P006543,P011987,0 days 00:05:39,3,16,13
112,MUN,P001557,P007975,0 days 00:05:36,5,13,8
112,MUN,P010391,P011941,0 days 00:05:09,-1,9,10
112,MUN,P005460,P007975,0 days 00:05:06,4,13,9
112,MUN,P001557,P010391,0 days 00:05:04,-8,4,12
112,MUN,P006760,P010391,0 days 00:05:03,4,10,6
112,MUN,P007639,P012123,0 days 00:05:01,2,12,10
112,MUN,P005460,P006245,0 days 00:04:56,5,13,8
112,MUN,P006245,P006760,0 days 00:04:33,7,13,6
112,MUN,P001557,P006543,0 days 00:04:33,7,13,6
112,MUN,P010391,P012123,0 days 00:04:27,0,10,10
112,MUN,P006543,P006760,0 days 00:04:23,0,9,9
112,MUN,P005460,P012123,0 days 00:04:20,7,13,6
112,MUN,P006245,P007056,0 days 00:04:20,7,13,6
112,MUN,P007056,P012123,0 days 00:04:20,7,13,6
112,MUN,P006760,P007975,0 days 00:04:10,0,9,9
112,MUN,P006245,P007975,0 days 00:03:12,-6,3,9
112,MUN,P005460,P006543,0 days 00:03:00,6,11,5
112,MUN,P006245,P006543,0 days 00:02:49,-4,3,7
112,MUN,P006245,P011941,0 days 00:02:49,-4,3,7
112,MUN,P007056,P007975,0 days 00:01:57,0,2,2
112,MUN,P001557,P011941,0 days 00:01:33,1,2,1
112,MUN,P001557,P006245,0 days 00:00:36,-2,0,2
112,MUN,P006245,P011987,0 days 00:00:36,-2,0,2
112,MUN,P006760,P011941,0 days 00:00:13,0,0,0
113,BAR,P002939,P004866,0 days 00:21:08,11,51,40
113,BAR,P003196,P012745,0 days 00:17:02,1,43,42
113,BAR,P000925,P006435,0 days 00:15:40,23,35,12
113,BAR,P002939,P006435,0 days 00:15:18,9,31,22
113,BAR,P004866,P012745,0 days 00:14:59,6,39,33
113,BAR,P002939,P012745,0 days 00:14:55,11,39,28
113,BAR,P003196,P004866,0 days 00:14:41,-4,31,35
113,BAR,P003196,P003478,0 days 00:14:38,-1,37,38
113,BAR,P003478,P012745,0 days 00:14:33,0,39,39
113,BAR,P002939,P003196,0 days 00:13:54,2,32,30
113,BAR,P000925,P002939,0 days 00:13:22,9,30,21
113,BAR,P006435,P011244,0 days 00:13:06,5,25,20
113,BAR,P002939,P011244,0 days 00:12:21,0,23,23
113,BAR,P002939,P003478,0 days 00:12:01,6,32,26
113,BAR,P003478,P004866,0 days 00:11:59,1,30,29
113,BAR,P000925,P011244,0 days 00:11:40,5,22,17
113,BAR,P007464,P007519,0 days 00:11:02,0,25,25
113,BAR,P004866,P006435,0 days 00:10:51,7,23,16
113,BAR,P000925,P007464,0 days 00:09:57,3,17,14
113,BAR,P007519,P012745,0 days 00:09:30,-1,22,23
113,BAR,P007464,P012745,0 days 00:09:26,4,22,18
113,BAR,P006435,P007464,0 days 00:08:33,12,18,6
113,BAR,P000925,P004866,0 days 00:08:09,12,22,10
113,BAR,P004866,P011244,0 days 00:07:51,2,14,12
113,BAR,P000925,P012745,0 days 00:07:23,9,18,9
113,BAR,P006435,P012745,0 days 00:07:15,13,17,4
113,BAR,P003196,P007519,0 days 00:07:03,-8,17,25
113,BAR,P007464,P011244,0 days 00:06:47,-3,13,16
113,BAR,P003196,P007464,0 days 00:06:16,-2,18,20
113,BAR,P000925,P007519,0 days 00:05:41,5,10,5
113,BAR,P002939,P007464,0 days 00:05:11,1,10,9
113,BAR,P003478,P007519,0 days 00:05:04,-9,11,20
113,BAR,P006435,P007519,0 days 00:05:03,9,11,2
113,BAR,P003196,P006435,0 days 00:04:41,-5,7,12
113,BAR,P003478,P007464,0 days 00:04:09,-3,12,15
113,BAR,P003196,P011244,0 days 00:03:55,-7,6,13
113,BAR,P007464,P009992,0 days 00:03:31,-8,5,13
113,BAR,P007519,P011244,0 days 00:03:14,-2,5,7
113,BAR,P007519,P009992,0 days 00:02:37,-3,5,8
113,BAR,P009992,P012745,0 days 00:02:37,-3,5,8
113,BAR,P003478,P011244,0 days 00:02:32,-3,4,7
113,BAR,P000925,P003478,0 days 00:02:27,-2,6,8
113,BAR,P000925,P009992,0 days 00:01:53,-8,0,8
113,BAR,P004866,P007519,0 days 00:01:42,-3,2,5
113,BAR,P003196,P009992,0 days 00:01:38,0,5,5
113,BAR,P003478,P006435,0 days 00:00:57,-1,1,2
113,BAR,P002939,P009992,0 days 00:00:54,-5,0,5
113,BAR,P009992,P011244,0 days 00:00:54,-5,0,5
113,ULK,P008962,P010560,0 days 00:31:04,-12,58,70
113,ULK,P008962,P009849,0 days 00:30:24,1,75,74
113,ULK,P008962,P011157,0 days 00:27:56,-12,51,63
113,ULK,P009849,P010560,0 days 00:23:58,-6,54,60
113,ULK,P006661,P008962,0 days 00:22:59,-2,55,57
113,ULK,P010560,P011157,0 days 00:22:01,-20,33,53
113,ULK,P006661,P009849,0 days 00:21:52,-3,53,56
113,ULK,P009849,P011157,0 days 00:21:21,-9,45,54
113,ULK,P006661,P010560,0 days 00:19:11,-3,44,47
113,ULK,P006661,P011157,0 days 00:13:56,-12,25,37
113,ULK,P004004,P008962,0 days 00:11:43,-9,16,25
113,ULK,P004004,P010560,0 days 00:10:50,-7,14,21
113,ULK,P002968,P008962,0 days 00:10:41,8,30,22
113,ULK,P004004,P011157,0 days 00:10:02,-7,16,23
113,ULK,P002968,P010560,0 days 00:09:03,8,25,17
113,ULK,P002968,P009849,0 days 00:09:03,10,30,20
113,ULK,P002968,P006661,0 days 00:09:03,10,30,20
113,ULK,P008962,P011052,0 days 00:08:19,6,16,10
113,ULK,P011052,P011157,0 days 00:06:38,8,16,8
113,ULK,P006961,P008962,0 days 00:06:33,8,19,11
113,ULK,P006961,P011052,0 days 00:06:15,4,14,10
113,ULK,P006961,P009849,0 days 00:05:23,7,17,10
113,ULK,P001932,P011157,0 days 00:04:58,-4,4,8
113,ULK,P001932,P008962,0 days 00:04:58,-4,4,8
113,ULK,P001932,P010560,0 days 00:04:58,-4,4,8
113,ULK,P006961,P011157,0 days 00:04:52,8,14,6
113,ULK,P004004,P011052,0 days 00:04:34,-8,0,8
113,ULK,P004004,P009849,0 days 00:04:34,-3,12,15
113,ULK,P009849,P011052,0 days 00:03:58,9,14,5
113,ULK,P001932,P004004,0 days 00:03:55,-2,4,6
113,ULK,P010560,P011052,0 days 00:03:11,-4,0,4
113,ULK,P002968,P006961,0 days 00:02:58,-4,5,9
113,ULK,P002968,P011052,0 days 00:02:58,-6,0,6
113,ULK,P002968,P004004,0 days 00:02:58,-6,0,6
113,ULK,P006661,P006961,0 days 00:02:45,1,7,6
113,ULK,P004004,P006961,0 days 00:01:23,-4,0,4
113,ULK,P004004,P011980,0 days 00:01:23,-4,0,4
113,ULK,P006961,P011980,0 days 00:01:23,-4,0,4
113,ULK,P011052,P011980,0 days 00:01:23,-4,0,4
113,ULK,P002968,P011980,0 days 00:01:20,-4,0,4
113,ULK,P006661,P011052,0 days 00:01:20,3,4,1
113,ULK,P001932,P009849,0 days 00:01:03,-2,0,2
113,ULK,P004004,P006661,0 days 00:00:50,-2,2,4
113,ULK,P008962,P011980,0 days 00:00:03,0,0,0
114,ASV,P004194,P012080,0 days 00:26:11,-17,40,57
114,ASV,P004194,P011225,0 days 00:23:47,-16,36,52
114,ASV,P006568,P012080,0 days 00:23:03,-2,36,38
114,ASV,P011225,P012080,0 days 00:22:46,-14,36,50
114,ASV,P004194,P006568,0 days 00:20:43,-9,28,37
114,ASV,P006568,P011225,0 days 00:18:13,-6,24,30
114,ASV,P002100,P012729,0 days 00:16:21,-3,27,30
114,ASV,P003526,P006568,0 days 00:16:05,-8,21,29
114,ASV,P002100,P012080,0 days 00:14:45,-7,29,36
114,ASV,P003526,P012080,0 days 00:14:09,-6,21,27
114,ASV,P002100,PKIR,0 days 00:14:05,-8,17,25
114,ASV,P002100,P004194,0 days 00:14:00,-21,19,40
114,ASV,P003526,P004194,0 days 00:13:32,-5,21,26
114,ASV,P003526,P011225,0 days 00:13:07,-1,19,20
114,ASV,P012729,PKIR,0 days 00:11:08,-4,15,19
114,ASV,P004194,PKIR,0 days 00:11:01,-20,4,24
114,ASV,P012080,PKIR,0 days 00:10:57,-5,14,19
114,ASV,P002100,P006568,0 days 00:10:20,-2,15,17
114,ASV,P002100,P011225,0 days 00:09:04,-11,15,26
114,ASV,P012080,P012729,0 days 00:08:50,3,22,19
114,ASV,P000229,P012729,0 days 00:07:41,-9,5,14
114,ASV,P000229,PKIR,0 days 00:07:41,-9,5,14
114,ASV,P000229,P002100,0 days 00:07:35,-9,5,14
114,ASV,P006568,PKIR,0 days 00:07:16,6,12,6
114,ASV,P004194,P012729,0 days 00:07:10,-9,12,21
114,ASV,P011225,PKIR,0 days 00:06:18,-14,2,16
114,ASV,P012730,PKIR,0 days 00:06:00,-2,7,9
114,ASV,P012729,P012730,0 days 00:06:00,-2,7,9
114,ASV,P002100,P012730,0 days 00:06:00,-2,7,9
114,ASV,P011225,P012729,0 days 00:05:33,-2,12,14
114,ASV,P000229,P012730,0 days 00:05:09,-2,5,7
114,ASV,P002100,P003526,0 days 00:04:54,-9,2,11
114,ASV,P006568,P012729,0 days 00:04:16,5,8,3
114,ASV,P003526,P012729,0 days 00:02:45,-3,0,3
114,ASV,P000229,P004194,0 days 00:02:32,-7,0,7
114,ASV,P012080,P012730,0 days 00:00:51,0,2,2
114,ASV,P000229,P003526,0 days 00:00:06,0,0,0
114,ASV,P003526,PKIR,0 days 00:00:06,0,0,0
114,PAM,P010568,P011982,0 days 00:19:45,13,40,27
114,PAM,P003960,P011982,0 days 00:17:24,10,33,23
114,PAM,P003960,P010568,0 days 00:16:08,7,30,23
114,PAM,P007870,P010568,0 days 00:14:42,17,33,16
114,PAM,P004863,P012738,0 days 00:14:41,7,27,20
114,PAM,P003960,P007870,0 days 00:14:11,13,28,15
114,PAM,P012738,P012739,0 days 00:13:30,-6,20,26
114,PAM,P007870,P011982,0 days 00:12:55,11,27,16
114,PAM,P006643,P007870,0 days 00:12:13,16,27,11
114,PAM,P006643,P010568,0 days 00:11:50,3,22,19
114,PAM,P004863,P012739,0 days 00:11:05,1,18,17
114,PAM,P011970,P012739,0 days 00:11:02,-2,19,21
114,PAM,P003960,P006643,0 days 00:10:50,9,21,12
114,PAM,P011982,P012740,0 days 00:10:49,8,19,11
114,PAM,P010568,P012740,0 days 00:10:16,2,18,16
114,PAM,P004863,P011970,0 days 00:10:09,6,20,14
114,PAM,P011970,P012738,0 days 00:09:02,1,15,14
114,PAM,P004863,P006643,0 days 00:08:55,20,24,4
114,PAM,P003960,P012740,0 days 00:08:41,11,17,6
114,PAM,P010568,P012739,0 days 00:08:33,-8,12,20
114,PAM,P006643,P011982,0 days 00:08:28,2,14,12
114,PAM,P012739,P012740,0 days 00:07:46,-6,9,15
114,PAM,P000556,P012739,0 days 00:07:37,-6,9,15
114,PAM,P012738,P012740,0 days 00:07:36,-3,11,14
114,PAM,P000556,P012738,0 days 00:06:45,-4,9,13
114,PAM,P000556,P004863,0 days 00:06:45,-4,9,13
114,PAM,P006643,P012739,0 days 00:06:45,1,13,12
114,PAM,P006643,P012738,0 days 00:06:17,0,11,11
114,PAM,P011982,P012739,0 days 00:06:06,-1,10,11
114,PAM,P004863,P012740,0 days 00:05:52,5,10,5
114,PAM,P006643,P011970,0 days 00:05:49,10,14,4
114,PAM,P004863,P007870,0 days 00:05:41,20,21,1
114,PAM,P007870,P012740,0 days 00:05:30,9,13,4
114,PAM,P000556,P011970,0 days 00:05:12,-6,6,12
114,PAM,P011982,P012738,0 days 00:04:42,7,12,5
114,PAM,P003960,P004863,0 days 00:04:30,8,10,2
114,PAM,P010393,P010568,0 days 00:04:26,7,10,3
114,PAM,P010568,P012738,0 days 00:04:09,1,11,10
114,PAM,P003960,P012739,0 days 00:03:35,-2,6,8
114,PAM,P003960,P011970,0 days 00:03:29,2,9,7
114,PAM,P004863,P011982,0 days 00:03:14,6,9,3
114,PAM,P006643,P012740,0 days 00:02:54,-1,6,7
114,PAM,P004863,P010568,0 days 00:02:53,11,12,1
114,PAM,P003960,P012738,0 days 00:02:46,4,6,2
114,PAM,P010393,P012740,0 days 00:02:43,3,6,3
114,PAM,P010393,P011982,0 days 00:02:39,1,4,3
114,PAM,P010393,P012739,0 days 00:02:33,1,4,3
114,PAM,P000556,P012740,0 days 00:02:25,0,3,3
114,PAM,P010568,P011970,0 days 00:02:22,-3,4,7
114,PAM,P007870,P010393,0 days 00:01:51,8,8,0
114,PAM,P006643,P010393,0 days 00:01:51,8,8,0
114,PAM,P004863,P010393,0 days 00:01:51,8,8,0
114,PAM,P011970,P011982,0 days 00:01:30,-1,4,5
114,PAM,P007870,P011970,0 days 00:01:29,5,5,0
114,PAM,P007870,P012738,0 days 00:01:28,5,6,1
114,PAM,P000556,P003960,0 days 00:00:52,-2,0,2
114,PAM,P000556,P010568,0 days 00:00:52,-2,0,2
114,PAM,P003960,P010393,0 days 00:00:06,0,0,0
115,BAS,P004603,P009048,0 days 00:25:32,7,46,39
115,BAS,P007230,P009048,0 days 00:23:54,6,56,50
115,BAS,P004761,P009048,0 days 00:23:32,7,50,43
115,BAS,P004603,P011085,0 days 00:21:20,-3,35,38
115,BAS,P004603,P007230,0 days 00:20:15,9,43,34
115,BAS,P004603,P004761,0 days 00:20:14,11,40,29
115,BAS,P004761,P007230,0 days 00:20:08,7,48,41
115,BAS,P009048,P011085,0 days 00:19:32,-1,33,34
115,BAS,P007230,P011085,0 days 00:15:09,-3,28,31
115,BAS,P004761,P011085,0 days 00:14:14,3,27,24
115,BAS,P011085,P012201,0 days 00:12:46,-1,22,23
115,BAS,P003198,P009048,0 days 00:11:43,3,28,25
115,BAS,P003198,P007230,0 days 00:10:45,9,33,24
115,BAS,P009048,P012201,0 days 00:10:38,-5,16,21
115,BAS,P011948,P012765,0 days 00:09:51,-1,26,27
115,BAS,P004603,P012201,0 days 00:08:57,-4,11,15
115,BAS,P011085,P011948,0 days 00:08:44,-2,21,23
115,BAS,P003198,P004761,0 days 00:08:33,2,20,18
115,BAS,P008072,P012765,0 days 00:07:50,-2,19,21
115,BAS,P003198,P004603,0 days 00:07:49,8,18,10
115,BAS,P007230,P011948,0 days 00:07:38,-3,23,26
115,BAS,P008072,P011948,0 days 00:07:35,-1,19,20
115,BAS,P011948,P012201,0 days 00:07:12,4,21,17
115,BAS,P011085,P012765,0 days 00:06:53,-1,16,17
115,BAS,P004761,P012201,0 days 00:05:49,-3,7,10
115,BAS,P012201,P012765,0 days 00:05:42,3,16,13
115,BAS,P003198,P012201,0 days 00:05:29,-2,13,15
115,BAS,P004603,P011948,0 days 00:04:49,0,12,12
115,BAS,P008072,P011085,0 days 00:04:41,1,11,10
115,BAS,P007230,P012201,0 days 00:04:38,-3,11,14
115,BAS,P007230,P008072,0 days 00:04:31,-7,10,17
115,BAS,P007230,P012765,0 days 00:04:24,-5,10,15
115,BAS,P008072,P012201,0 days 00:04:09,3,11,8
115,BAS,P009048,P011948,0 days 00:03:55,1,13,12
115,BAS,P003198,P011085,0 days 00:02:21,-1,3,4
115,BAS,P004603,P012765,0 days 00:02:16,0,7,7
115,BAS,P003198,P011948,0 days 00:02:12,7,13,6
115,BAS,P003198,P008072,0 days 00:02:09,1,8,7
115,BAS,P008850,P012765,0 days 00:01:50,-6,2,8
115,BAS,P008850,P011948,0 days 00:01:50,-6,2,8
115,BAS,P008072,P008850,0 days 00:01:50,-6,2,8
115,BAS,P007230,P008850,0 days 00:01:50,-6,2,8
115,BAS,P003198,P012765,0 days 00:01:23,5,8,3
115,BAS,P004761,P011948,0 days 00:01:18,1,6,5
115,BAS,P004761,P008072,0 days 00:01:05,-3,2,5
115,BAS,P008072,P009048,0 days 00:00:50,-2,2,4
115,BAS,P004761,P012765,0 days 00:00:15,-1,0,1
115,RED,P002553,P006436,0 days 00:23:12,9,52,43
115,RED,P006436,PJDR,0 days 00:20:52,7,46,39
115,RED,P009035,PJDR,0 days 00:20:40,-2,33,35
115,RED,P006436,P009035,0 days 00:20:39,2,39,37
115,RED,P000848,PJDR,0 days 00:18:58,-6,33,39
115,RED,P006436,PLUO,0 days 00:17:48,12,52,40
115,RED,P000848,P009035,0 days 00:16:42,-8,24,32
115,RED,P002553,PLUO,0 days 00:16:03,11,46,35
115,RED,P007960,PJDR,0 days 00:15:32,-8,31,39
115,RED,P000848,P006436,0 days 00:14:55,-7,22,29
115,RED,P000848,P007960,0 days 00:14:36,-12,27,39
115,RED,P002553,P009035,0 days 00:14:17,6,30,24
115,RED,P007960,P009035,0 days 00:13:03,-9,20,29
115,RED,P006436,P008966,0 days 00:12:37,3,35,32
115,RED,P006436,P012044,0 days 00:12:04,-2,28,30
115,RED,P002553,PJDR,0 days 00:11:49,11,26,15
115,RED,P002553,P012044,0 days 00:11:29,-2,26,28
115,RED,P009035,PLUO,0 days 00:11:11,1,27,26
115,RED,P006436,P007960,0 days 00:10:01,-2,22,24
115,RED,P012044,PLUO,0 days 00:09:47,0,28,28
115,RED,P002553,P008966,0 days 00:08:55,3,22,19
115,RED,PJDR,PLUO,0 days 00:08:05,10,25,15
115,RED,P008966,PLUO,0 days 00:07:07,9,26,17
115,RED,P004720,P007960,0 days 00:07:07,-5,10,15
115,RED,P000848,P002553,0 days 00:07:03,-2,6,8
115,RED,P004720,P009035,0 days 00:06:43,-7,10,17
115,RED,P004720,PJDR,0 days 00:06:41,-5,10,15
115,RED,P008966,PJDR,0 days 00:06:41,5,24,19
115,RED,P009035,P012044,0 days 00:06:17,-3,17,20
115,RED,P000848,P004720,0 days 00:06:14,-5,10,15
115,RED,P008966,P012044,0 days 00:06:02,-2,11,13
115,RED,P000848,P008966,0 days 00:04:57,-6,9,15
115,RED,P007960,P008966,0 days 00:03:42,0,13,13
115,RED,P000848,P012044,0 days 00:02:41,-8,0,8
115,RED,P007960,PLUO,0 days 00:02:12,1,7,6
115,RED,P004720,P006436,0 days 00:00:56,-2,0,2
115,RED,P007960,P012044,0 days 00:00:47,-1,2,3
115,RED,P000848,PLUO,0 days 00:00:30,-2,1,3
115,RED,P004720,PLUO,0 days 00:00:29,-2,0,2
115,RED,P004720,P008966,0 days 00:00:27,0,0,0
115,RED,P012044,PJDR,0 days 00:00:06,0,0,0
115,RED,P004720,P012044,0 days 00:00:03,-2,0,2
116,VIR,P001133,P001844,0 days 00:23:32,15,66,51
116,VIR,P001844,P003048,0 days 00:22:50,6,62,56
116,VIR,P001133,PBCN,0 days 00:21:28,10,58,48
116,VIR,P001133,P003048,0 days 00:20:46,13,62,49
116,VIR,P001844,PBCN,0 days 00:19:25,8,56,48
116,VIR,P003048,PBCN,0 days 00:16:00,7,47,40
116,VIR,P001133,P010781,0 days 00:15:36,1,32,31
116,VIR,P001133,P004007,0 days 00:15:16,7,33,26
116,VIR,P001133,P011192,0 days 00:15:01,8,35,27
116,VIR,P010781,PBCN,0 days 00:14:21,-4,32,36
116,VIR,P008847,P010781,0 days 00:14:01,0,31,31
116,VIR,P001844,P009549,0 days 00:13:14,9,39,30
116,VIR,P001133,P009549,0 days 00:12:39,9,37,28
116,VIR,P001844,P004007,0 days 00:11:52,1,25,24
116,VIR,P003048,P009549,0 days 00:11:18,7,36,29
116,VIR,P010781,P011192,0 days 00:11:01,-1,20,21
116,VIR,P001844,P010781,0 days 00:10:30,-8,22,30
116,VIR,P001133,P008847,0 days 00:09:49,3,21,18
116,VIR,P011192,PBCN,0 days 00:09:36,6,27,21
116,VIR,P008847,PBCN,0 days 00:09:34,-3,22,25
116,VIR,P003048,P011192,0 days 00:09:13,0,23,23
116,VIR,P003048,P004007,0 days 00:09:08,-2,21,23
116,VIR,P003048,P010781,0 days 00:08:13,-8,15,23
116,VIR,P009549,PBCN,0 days 00:08:06,9,23,14
116,VIR,P004007,P010781,0 days 00:07:47,0,16,16
116,VIR,P001844,P008847,0 days 00:07:39,-4,19,23
116,VIR,P004007,P009549,0 days 00:07:20,2,19,17
116,VIR,P004007,P011192,0 days 00:07:05,1,12,11
116,VIR,P001844,P011192,0 days 00:06:55,1,17,16
116,VIR,P008847,P011192,0 days 00:06:01,5,12,7
116,VIR,P004007,P008847,0 days 00:05:58,2,13,11
116,VIR,P003048,P008847,0 days 00:03:04,-3,6,9
116,VIR,P004007,PBCN,0 days 00:02:55,3,7,4
116,VIR,P010781,P012714,0 days 00:02:51,0,8,8
116,VIR,P012714,PBCN,0 days 00:02:51,0,8,8
116,VIR,P008847,P012714,0 days 00:01:27,0,6,6
116,VIR,P001844,P012714,0 days 00:01:27,0,6,6
116,VIR,P011192,P012714,0 days 00:01:24,0,2,2
116,VIR,P001133,P012714,0 days 00:01:21,-2,0,2
116,VIR,P008847,P009549,0 days 00:00:51,0,2,2
116,VIR,P009549,P010781,0 days 00:00:16,0,0,0
116,VIR,P009549,P011192,0 days 00:00:16,0,0,0
116,VIR,P004007,P012714,0 days 00:00:03,2,2,0
116,TEL,P009783,P009863,0 days 00:26:10,-13,50,63
116,TEL,P009622,P009863,0 days 00:24:18,-9,55,64
116,TEL,P009622,P009783,0 days 00:22:47,-12,48,60
116,TEL,P009622,P011199,0 days 00:21:56,-9,47,56
116,TEL,P009863,P011199,0 days 00:19:26,-7,42,49
116,TEL,P009783,P011199,0 days 00:18:18,-6,38,44
116,TEL,P009622,P011193,0 days 00:17:47,10,45,35
116,TEL,P011214,P011219,0 days 00:16:25,-3,39,42
116,TEL,P009622,P011214,0 days 00:16:04,2,42,40
116,TEL,P011193,P011214,0 days 00:13:19,6,35,29
116,TEL,P009863,P011214,0 days 00:13:14,-9,30,39
116,TEL,P009622,P011219,0 days 00:12:27,4,35,31
116,TEL,P009863,P011193,0 days 00:12:13,3,26,23
116,TEL,P011193,P011219,0 days 00:11:35,1,29,28
116,TEL,P009783,P011214,0 days 00:10:44,-12,17,29
116,TEL,P009863,P011219,0 days 00:10:43,-3,25,28
116,TEL,P009622,P012744,0 days 00:10:36,-2,28,30
116,TEL,P011193,P011199,0 days 00:10:22,4,22,18
116,TEL,P009783,P011193,0 days 00:09:59,0,15,15
116,TEL,P011193,P012744,0 days 00:09:30,0,25,25
116,TEL,P009783,P011219,0 days 00:08:51,-5,16,21
116,TEL,P011214,P012744,0 days 00:07:48,4,22,18
116,TEL,P005145,P009622,0 days 00:07:32,-8,15,23
116,TEL,P005145,P011199,0 days 00:07:18,-8,15,23
116,TEL,P011199,P012744,0 days 00:07:11,-2,20,22
116,TEL,P011219,P012744,0 days 00:06:10,0,16,16
116,TEL,P009863,P012744,0 days 00:05:20,-4,15,19
116,TEL,P005145,P009863,0 days 00:05:04,-4,10,14
116,TEL,P005145,P009783,0 days 00:04:06,-2,10,12
116,TEL,P004233,P011199,0 days 00:04:05,-2,7,9
116,TEL,P011199,P011214,0 days 00:04:02,0,11,11
116,TEL,P004233,P009863,0 days 00:03:40,-2,7,9
116,TEL,P004233,P009622,0 days 00:03:37,-4,5,9
116,TEL,P009783,P012744,0 days 00:03:37,-2,9,11
116,TEL,P005145,P011193,0 days 00:02:42,-4,5,9
116,TEL,P004233,P009783,0 days 00:02:40,0,5,5
116,TEL,P005145,P012744,0 days 00:01:58,-4,5,9
116,TEL,P004233,P012744,0 days 00:01:22,2,4,2
116,TEL,P004233,P011193,0 days 00:01:17,0,2,2
116,TEL,P004233,P005145,0 days 00:01:14,-2,0,2
116,TEL,P004233,P011214,0 days 00:01:06,0,4,4
116,TEL,P004233,P011219,0 days 00:00:47,0,2,2
116,TEL,P011199,P011219,0 days 00:00:26,2,2,0
116,TEL,P005145,P011214,0 days 00:00:14,0,0,0
117,ZAL,P002329,P007513,0 days 00:26:57,-2,49,51
117,ZAL,P002329,P007109,0 days 00:25:58,-1,51,52
117,ZAL,P007109,P007513,0 days 00:24:22,3,48,45
117,ZAL,P007513,P011218,0 days 00:22:44,0,44,44
117,ZAL,P002329,P011218,0 days 00:22:28,-3,46,49
117,ZAL,P007109,P011218,0 days 00:18:26,4,41,37
117,ZAL,P002329,P003211,0 days 00:17:20,-3,37,40
117,ZAL,P002329,P010390,0 days 00:15:05,-10,21,31
117,ZAL,P002329,P005504,0 days 00:15:04,6,27,21
117,ZAL,P003211,P005504,0 days 00:13:57,4,27,23
117,ZAL,P010390,P011218,0 days 00:13:39,-7,18,25
117,ZAL,P007513,P010390,0 days 00:12:55,-5,16,21
117,ZAL,P005504,P007513,0 days 00:12:38,6,22,16
117,ZAL,P003211,P012787,0 days 00:12:04,-8,27,35
117,ZAL,P005504,P007109,0 days 00:11:35,12,24,12
117,ZAL,P003211,P007109,0 days 00:11:12,2,29,27
117,ZAL,P007109,P010390,0 days 00:10:58,-8,13,21
117,ZAL,P002329,P012787,0 days 00:10:53,-10,23,33
117,ZAL,P005504,P012787,0 days 00:09:57,3,22,19
117,ZAL,P003211,P007513,0 days 00:09:56,1,21,20
117,ZAL,P005504,P011218,0 days 00:08:59,3,19,16
117,ZAL,P006860,P012787,0 days 00:07:43,-2,15,17
117,ZAL,P005504,P006860,0 days 00:07:42,-2,15,17
117,ZAL,P011218,P012787,0 days 00:07:41,-1,20,21
117,ZAL,P007109,P012787,0 days 00:07:21,-4,18,22
117,ZAL,P003211,P011218,0 days 00:07:01,1,23,22
117,ZAL,P003211,P006860,0 days 00:06:37,0,15,15
117,ZAL,P002329,P006860,0 days 00:06:35,-1,14,15
117,ZAL,P006860,P011218,0 days 00:05:42,-1,13,14
117,ZAL,P007513,P012787,0 days 00:05:23,-5,10,15
117,ZAL,P006860,P007513,0 days 00:03:25,-2,6,8
117,ZAL,P003211,P010390,0 days 00:03:17,-5,5,10
117,ZAL,P006860,P010390,0 days 00:02:16,0,6,6
117,ZAL,P010390,P012787,0 days 00:02:10,-5,5,10
117,MCO,P005985,P010588,0 days 00:24:35,-8,46,54
117,MCO,P011212,P011226,0 days 00:24:12,3,56,53
117,MCO,P005985,P011212,0 days 00:22:34,-8,46,54
117,MCO,P005985,P011231,0 days 00:20:33,3,43,40
117,MCO,P005985,P011226,0 days 00:19:00,0,44,44
117,MCO,P010588,P011212,0 days 00:17:19,-13,33,46
117,MCO,P010588,P011231,0 days 00:15:43,3,32,29
117,MCO,P005985,PLCZ,0 days 00:15:05,5,25,20
117,MCO,P004790,P011212,0 days 00:14:51,8,35,27
117,MCO,P004790,P011226,0 days 00:14:40,6,33,27
117,MCO,P010588,P011226,0 days 00:12:58,-8,30,38
117,MCO,P010588,PLCZ,0 days 00:12:02,0,18,18
117,MCO,P011231,PLCZ,0 days 00:12:02,0,18,18
117,MCO,P011212,P011231,0 days 00:11:35,-4,23,27
117,MCO,P005985,P008099,0 days 00:11:25,6,24,18
117,MCO,P008099,P011231,0 days 00:11:13,4,22,18
117,MCO,P004790,P005985,0 days 00:09:22,3,20,17
117,MCO,P002581,P011212,0 days 00:09:16,-2,20,22
117,MCO,P002581,P011226,0 days 00:08:58,-2,20,22
117,MCO,P011226,P011231,0 days 00:08:12,6,23,17
117,MCO,P008099,PLCZ,0 days 00:07:58,5,15,10
117,MCO,P008099,P010588,0 days 00:07:58,5,15,10
117,MCO,P011212,P012709,0 days 00:07:20,5,17,12
117,MCO,P011226,P012709,0 days 00:07:20,5,17,12
117,MCO,P011212,PLCZ,0 days 00:07:07,0,10,10
117,MCO,P002581,P012709,0 days 00:06:13,5,17,12
117,MCO,P004790,P010588,0 days 00:06:07,-4,11,15
117,MCO,P011196,P011231,0 days 00:05:57,0,11,11
117,MCO,P004790,P012709,0 days 00:05:30,5,15,10
117,MCO,P002581,P004790,0 days 00:05:30,5,15,10
117,MCO,P005985,P011196,0 days 00:05:03,2,13,11
117,MCO,P011196,P011226,0 days 00:04:50,3,9,6
117,MCO,P011196,P011212,0 days 00:04:02,0,8,8
117,MCO,P002581,P010588,0 days 00:03:46,-7,5,12
117,MCO,P008099,P011196,0 days 00:03:27,1,9,8
117,MCO,P011226,PLCZ,0 days 00:03:03,5,7,2
117,MCO,P004790,PLCZ,0 days 00:03:03,5,7,2
117,MCO,P002581,P005985,0 days 00:03:03,-7,3,10
117,MCO,P008099,P011226,0 days 00:02:07,2,5,3
117,MCO,P008099,P011212,0 days 00:01:20,-1,4,5
117,MCO,P011196,P012709,0 days 00:01:07,0,0,0
117,MCO,P011231,P012709,0 days 00:01:07,0,0,0
117,MCO,P010588,P012709,0 days 00:00:43,0,2,2
117,MCO,P002581,P011231,0 days 00:00:18,0,0,0
117,MCO,P004790,P011196,0 days 00:00:13,2,2,0
117,MCO,P004790,P008099,0 days 00:00:12,2,2,0
117,MCO,P010588,P011196,0 days 00:00:01,0,0,0
118,ASV,P004194,P012080,0 days 00:24:54,-3,51,54
118,ASV,P003526,P012080,0 days 00:20:53,0,42,42
118,ASV,P006568,P012080,0 days 00:20:39,-1,42,43
118,ASV,P003526,P004194,0 days 00:19:58,3,42,39
118,ASV,P004194,P006568,0 days 00:18:13,-1,37,38
118,ASV,P004194,P011225,0 days 00:16:44,-5,34,39
118,ASV,P002100,P012729,0 days 00:16:21,-9,30,39
118,ASV,P003526,P006568,0 days 00:15:53,-3,31,34
118,ASV,P011225,P012080,0 days 00:15:06,-6,30,36
118,ASV,P002100,P012080,0 days 00:14:22,-2,32,34
118,ASV,P002100,P012730,0 days 00:12:15,1,27,26
118,ASV,P003526,P011225,0 days 00:11:53,-1,25,26
118,ASV,P006568,P011225,0 days 00:11:16,-1,25,26
118,ASV,P000229,P002100,0 days 00:10:45,2,25,23
118,ASV,P002100,P003526,0 days 00:10:04,-1,23,24
118,ASV,P003526,P012730,0 days 00:09:46,1,23,22
118,ASV,P012729,P012730,0 days 00:09:44,-4,18,22
118,ASV,P002100,P004194,0 days 00:09:39,-3,22,25
118,ASV,P000229,P012729,0 days 00:09:05,1,21,20
118,ASV,P012080,P012730,0 days 00:09:01,6,23,17
118,ASV,P000229,P003526,0 days 00:08:59,0,18,18
118,ASV,P000229,P012080,0 days 00:08:55,6,19,13
118,ASV,P012080,P012729,0 days 00:07:45,-4,14,18
118,ASV,P002100,P006568,0 days 00:07:41,-3,17,20
118,ASV,P000229,P012730,0 days 00:07:21,1,16,15
118,ASV,P000229,P006568,0 days 00:07:06,1,15,14
118,ASV,P003526,P012729,0 days 00:05:52,-5,12,17
118,ASV,P012729,PKIR,0 days 00:05:49,-7,9,16
118,ASV,P002100,PKIR,0 days 00:05:46,-5,9,14
118,ASV,P000229,P004194,0 days 00:05:33,1,10,9
118,ASV,P004194,P012730,0 days 00:05:00,4,14,10
118,ASV,P002100,P011225,0 days 00:04:59,-8,7,15
118,ASV,P011225,P012729,0 days 00:04:20,-9,4,13
118,ASV,P011225,PKIR,0 days 00:04:00,-3,6,9
118,ASV,P012080,PKIR,0 days 00:03:49,0,7,7
118,ASV,P011225,P012730,0 days 00:03:44,-3,5,8
118,ASV,P006568,P012729,0 days 00:03:38,-2,8,10
118,ASV,P004194,PKIR,0 days 00:03:05,1,6,5
118,ASV,P004194,P012729,0 days 00:03:02,-5,4,9
118,ASV,P006568,PKIR,0 days 00:02:58,-2,5,7
118,ASV,P012730,PKIR,0 days 00:02:29,-6,2,8
118,ASV,P000229,PKIR,0 days 00:01:06,-4,0,4
118,ASV,P003526,PKIR,0 days 00:00:26,-2,0,2
118,ASV,P000229,P011225,0 days 00:00:06,0,0,0
118,PAN,P001926,P007866,0 days 00:24:44,1,56,55
118,PAN,P001926,P002328,0 days 00:24:09,11,61,50
118,PAN,P002328,P007866,0 days 00:22:20,7,53,46
118,PAN,P003842,P012774,0 days 00:21:59,13,52,39
118,PAN,P001926,P003842,0 days 00:21:22,7,52,45
118,PAN,P001926,P011204,0 days 00:19:55,5,51,46
118,PAN,P007866,P011204,0 days 00:19:47,2,45,43
118,PAN,P001926,P012774,0 days 00:18:39,11,44,33
118,PAN,P002328,P011204,0 days 00:16:21,3,39,36
118,PAN,P003842,P007866,0 days 00:15:27,-2,34,36
118,PAN,P007866,P012774,0 days 00:14:34,-2,29,31
118,PAN,P002328,P003842,0 days 00:14:32,10,37,27
118,PAN,P002328,P012774,0 days 00:14:16,6,32,26
118,PAN,P003842,P011204,0 days 00:11:20,5,30,25
118,PAN,P011204,P012774,0 days 00:11:12,2,22,20
118,PAN,P003842,P012712,0 days 00:10:54,7,26,19
118,PAN,P001926,P012712,0 days 00:10:37,4,25,21
118,PAN,P012712,P012774,0 days 00:09:34,12,23,11
118,PAN,P011204,P011221,0 days 00:07:22,2,17,15
118,PAN,P002328,P011221,0 days 00:07:22,2,17,15
118,PAN,P001926,P011221,0 days 00:06:51,4,17,13
118,PAN,P007553,P011204,0 days 00:06:47,-3,12,15
118,PAN,P007866,P011221,0 days 00:06:42,2,15,13
118,PAN,P007947,P012712,0 days 00:06:24,-5,9,14
118,PAN,P001926,P007553,0 days 00:06:07,-2,12,14
118,PAN,P007553,P007866,0 days 00:05:59,0,12,12
118,PAN,P011204,P012712,0 days 00:05:54,2,14,12
118,PAN,P003842,P007947,0 days 00:05:40,-4,9,13
118,PAN,P002328,P007553,0 days 00:05:29,-2,12,14
118,PAN,P001926,P007947,0 days 00:04:56,-5,6,11
118,PAN,P002328,P012712,0 days 00:04:46,3,13,10
118,PAN,P007947,P012774,0 days 00:04:42,1,6,5
118,PAN,P007947,P011204,0 days 00:03:36,-2,6,8
118,PAN,P007866,P007947,0 days 00:01:59,-4,0,4
118,PAN,P007553,P012774,0 days 00:01:43,-1,0,1
118,PAN,P007553,P007947,0 days 00:01:30,-1,0,1
118,PAN,P007866,P012712,0 days 00:01:24,-4,0,4
118,PAN,P007553,P012712,0 days 00:01:13,-3,0,3
118,PAN,P011221,P012712,0 days 00:00:40,0,2,2
118,PAN,P011221,P012774,0 days 00:00:31,-2,0,2
118,PAN,P002328,P007947,0 days 00:00:17,0,0,0
118,PAN,P003842,P011209,0 days 00:00:06,0,0,0
118,PAN,P011204,P011209,0 days 00:00:06,0,0,0
118,PAN,P011209,P012712,0 days 00:00:06,0,0,0
118,PAN,P011209,P012774,0 days 00:00:06,0,0,0
119,MAD,P005791,P005928,0 days 00:17:32,1,33,32
119,MAD,P004887,P009005,0 days 00:17:31,12,42,30
119,MAD,P001392,P005791,0 days 00:16:53,-1,34,35
119,MAD,P004887,PTGB,0 days 00:16:30,13,42,29
119,MAD,P009005,PTGB,0 days 00:16:12,15,44,29
119,MAD,P005791,P006540,0 days 00:15:03,3,31,28
119,MAD,P005928,P006540,0 days 00:15:03,3,31,28
119,MAD,P001392,P005928,0 days 00:14:17,-3,27,30
119,MAD,PBMT,PTGB,0 days 00:13:59,9,32,23
119,MAD,P001392,P006540,0 days 00:13:51,0,27,27
119,MAD,P005791,P009213,0 days 00:13:17,0,23,23
119,MAD,P009005,PBMT,0 days 00:12:36,14,34,20
119,MAD,P004887,PBMT,0 days 00:12:31,11,30,19
119,MAD,P003108,P005791,0 days 00:11:42,3,28,25
119,MAD,PCVM,PTGB,0 days 00:11:33,4,29,25
119,MAD,P009005,PCVM,0 days 00:11:25,6,29,23
119,MAD,P003108,P005928,0 days 00:11:21,5,27,22
119,MAD,P004887,PCVM,0 days 00:10:42,4,25,21
119,MAD,P001392,P003108,0 days 00:10:37,-4,22,26
119,MAD,P001392,P009213,0 days 00:10:18,-4,19,23
119,MAD,P005928,P009213,0 days 00:10:04,0,16,16
119,MAD,P003108,P004887,0 days 00:08:34,3,18,15
119,MAD,P003108,P006540,0 days 00:08:17,3,19,16
119,MAD,P005928,PBMT,0 days 00:08:17,6,15,9
119,MAD,P006540,P009213,0 days 00:07:58,3,16,13
119,MAD,P003108,P009005,0 days 00:07:56,4,18,14
119,MAD,PBMT,PCVM,0 days 00:07:37,6,21,15
119,MAD,P003108,PCVM,0 days 00:07:30,0,15,15
119,MAD,P005928,PTGB,0 days 00:07:02,5,13,8
119,MAD,P003108,PTGB,0 days 00:06:32,4,16,12
119,MAD,P004887,P005928,0 days 00:06:25,7,15,8
119,MAD,P005928,P009005,0 days 00:05:47,8,15,7
119,MAD,P003108,P009213,0 days 00:05:39,3,15,12
119,MAD,P005791,PCVM,0 days 00:03:56,2,11,9
119,MAD,P005791,PBMT,0 days 00:03:23,1,6,5
119,MAD,P009213,PCVM,0 days 00:03:13,0,7,7
119,MAD,P009213,PTGB,0 days 00:03:12,2,4,2
119,MAD,P005791,PTGB,0 days 00:03:00,0,4,4
119,MAD,P003108,PBMT,0 days 00:02:56,3,6,3
119,MAD,P001392,PCVM,0 days 00:02:36,2,7,5
119,MAD,P009213,PBMT,0 days 00:02:17,-2,0,2
119,MAD,P004887,P009213,0 days 00:01:25,1,4,3
119,MAD,P009005,P009213,0 days 00:01:25,1,4,3
119,MAD,P005791,P009005,0 days 00:01:06,3,6,3
119,MAD,P001392,P004887,0 days 00:00:30,-3,0,3
119,MAD,P001392,P009005,0 days 00:00:30,-3,0,3
119,MUN,P006760,P011987,0 days 00:24:52,-2,51,53
119,MUN,P006760,P008985,0 days 00:22:32,-9,40,49
119,MUN,P003583,P011987,0 days 00:21:31,-1,42,43
119,MUN,P003583,P006760,0 days 00:21:05,-6,39,45
119,MUN,P008985,P011987,0 days 00:20:23,-5,38,43
119,MUN,P006760,P007056,0 days 00:18:51,0,39,39
119,MUN,P007056,P011987,0 days 00:18:51,0,39,39
119,MUN,P003583,P008985,0 days 00:17:33,-12,28,40
119,MUN,P007056,P008985,0 days 00:16:44,-7,29,36
119,MUN,P006543,P007975,0 days 00:13:26,-5,23,28
119,MUN,P003583,P007056,0 days 00:13:12,-1,26,27
119,MUN,P001557,P007975,0 days 00:12:29,-7,20,27
119,MUN,P001557,P006543,0 days 00:11:34,-3,20,23
119,MUN,P003583,P007975,0 days 00:11:31,1,24,23
119,MUN,P001557,P010391,0 days 00:11:08,-13,14,27
119,MUN,P003583,P006543,0 days 00:11:00,-7,18,25
119,MUN,P008985,P010391,0 days 00:10:51,-4,20,24
119,MUN,P006760,P010391,0 days 00:10:48,-3,22,25
119,MUN,P003583,P010391,0 days 00:10:16,-9,16,25
119,MUN,P001557,P003583,0 days 00:10:08,-9,15,24
119,MUN,P007975,P010391,0 days 00:08:56,-8,14,22
119,MUN,P010391,P011987,0 days 00:08:39,1,20,19
119,MUN,P007975,P011987,0 days 00:08:29,3,21,18
119,MUN,P006543,P010391,0 days 00:07:51,-4,13,17
119,MUN,P006543,P011987,0 days 00:07:18,-3,14,17
119,MUN,P007056,P010391,0 days 00:07:04,-5,13,18
119,MUN,P007639,P007975,0 days 00:05:00,-4,7,11
119,MUN,P001557,P007639,0 days 00:05:00,-4,7,11
119,MUN,P006760,P007975,0 days 00:04:29,3,13,10
119,MUN,P001557,P011987,0 days 00:04:00,0,8,8
119,MUN,P006543,P007639,0 days 00:03:35,2,7,5
119,MUN,P007639,P010391,0 days 00:03:35,-3,4,7
119,MUN,P007056,P007975,0 days 00:03:32,1,10,9
119,MUN,P006543,P006760,0 days 00:03:18,-3,6,9
119,MUN,P001557,P008985,0 days 00:02:39,-6,2,8
119,MUN,P001557,P006760,0 days 00:02:09,-4,2,6
119,MUN,P006543,P008985,0 days 00:01:26,-1,3,4
119,MUN,P007639,P011987,0 days 00:01:25,-1,3,4
119,MUN,P001557,P007056,0 days 00:01:25,-6,0,6
119,MUN,P007056,P007639,0 days 00:01:25,-6,0,6
120,BAS,P009048,P012201,0 days 00:21:14,-2,44,46
120,BAS,P004603,P009048,0 days 00:20:41,1,44,43
120,BAS,P004761,P009048,0 days 00:19:47,3,51,48
120,BAS,P009048,P011085,0 days 00:19:13,0,44,44
120,BAS,P004603,P004761,0 days 00:16:57,-4,38,42
120,BAS,P011948,P012201,0 days 00:16:26,-1,29,30
120,BAS,P007230,P009048,0 days 00:15:18,-5,33,38
120,BAS,P004761,P012201,0 days 00:14:58,9,43,34
120,BAS,P008072,P012201,0 days 00:14:51,0,29,29
120,BAS,P004603,P007230,0 days 00:14:42,-11,25,36
120,BAS,P004603,P011085,0 days 00:14:28,0,32,32
120,BAS,P011085,P012201,0 days 00:14:24,-3,33,36
120,BAS,P009048,P011948,0 days 00:14:20,-1,26,27
120,BAS,P004761,P011085,0 days 00:13:28,7,42,35
120,BAS,P004761,P007230,0 days 00:12:31,-5,29,34
120,BAS,P008072,P011948,0 days 00:11:33,0,22,22
120,BAS,P007230,P011085,0 days 00:10:40,-4,26,30
120,BAS,P008072,P009048,0 days 00:10:02,-5,16,21
120,BAS,P004603,P012201,0 days 00:09:43,1,20,19
120,BAS,P004603,P011948,0 days 00:07:48,-7,10,17
120,BAS,P011085,P011948,0 days 00:07:30,-9,9,18
120,BAS,P004761,P011948,0 days 00:07:04,5,16,11
120,BAS,P008850,P009048,0 days 00:06:15,-4,8,12
120,BAS,P008850,P012201,0 days 00:06:15,-4,8,12
120,BAS,P008072,P011085,0 days 00:06:14,-5,11,16
120,BAS,P004761,P008072,0 days 00:06:10,10,18,8
120,BAS,P008072,P008850,0 days 00:05:45,-5,7,12
120,BAS,P004761,P012765,0 days 00:05:31,2,13,11
120,BAS,P012201,P012765,0 days 00:05:31,2,13,11
120,BAS,P011948,P012765,0 days 00:05:01,-6,6,12
120,BAS,P008072,P012765,0 days 00:04:49,5,13,8
120,BAS,P003198,P004603,0 days 00:04:46,-7,6,13
120,BAS,P003198,P004761,0 days 00:04:46,-7,6,13
120,BAS,P003198,P007230,0 days 00:04:46,-7,6,13
120,BAS,P003198,P009048,0 days 00:04:46,-7,6,13
120,BAS,P007230,P011948,0 days 00:03:52,-8,3,11
120,BAS,P008850,P011948,0 days 00:03:50,-1,7,8
120,BAS,P011085,P012765,0 days 00:03:40,-6,7,13
120,BAS,P007230,P012201,0 days 00:03:38,-2,9,11
120,BAS,P004603,P012765,0 days 00:02:17,-10,0,10
120,BAS,P008850,P011085,0 days 00:01:55,-4,0,4
120,BAS,P007230,P012765,0 days 00:01:35,-7,0,7
120,BAS,P004603,P008850,0 days 00:00:30,1,1,0
120,BAS,P007230,P008850,0 days 00:00:30,1,1,0
120,VIR,P001133,PBCN,0 days 00:21:15,18,62,44
120,VIR,P001844,PBCN,0 days 00:20:45,15,55,40
120,VIR,P001133,P009549,0 days 00:20:31,16,51,35
120,VIR,P001133,P001844,0 days 00:20:21,15,53,38
120,VIR,P009549,PBCN,0 days 00:17:26,14,47,33
120,VIR,P012714,PBCN,0 days 00:16:44,8,41,33
120,VIR,P001844,P003048,0 days 00:16:44,5,33,28
120,VIR,P001844,P009549,0 days 00:15:21,17,40,23
120,VIR,P001133,P012714,0 days 00:15:14,8,38,30
120,VIR,P009549,P012714,0 days 00:12:50,5,29,24
120,VIR,P006739,PBCN,0 days 00:12:17,4,32,28
120,VIR,P001133,P003048,0 days 00:11:50,3,24,21
120,VIR,P001133,P006739,0 days 00:11:20,1,29,28
120,VIR,P003048,P010781,0 days 00:10:40,-6,17,23
120,VIR,P003048,PBCN,0 days 00:09:47,11,26,15
120,VIR,P006739,P012714,0 days 00:09:46,5,26,21
120,VIR,P001844,P003527,0 days 00:09:45,7,25,18
120,VIR,P003048,P009549,0 days 00:09:19,9,24,15
120,VIR,P001844,P012714,0 days 00:09:17,6,23,17
120,VIR,P001844,P010781,0 days 00:08:31,-4,14,18
120,VIR,P006739,P009549,0 days 00:08:04,0,19,19
120,VIR,P003048,P003527,0 days 00:07:34,6,16,10
120,VIR,P003048,P004007,0 days 00:07:12,-12,8,20
120,VIR,P010781,PBCN,0 days 00:06:56,7,18,11
120,VIR,P001133,P010781,0 days 00:06:18,-8,9,17
120,VIR,P001133,P003527,0 days 00:06:17,3,16,13
120,VIR,P002084,P003048,0 days 00:05:47,-6,8,14
120,VIR,P003527,PBCN,0 days 00:05:39,5,18,13
120,VIR,P003048,P006739,0 days 00:05:27,-6,8,14
120,VIR,P002084,P006739,0 days 00:04:48,-4,8,12
120,VIR,P003527,P010781,0 days 00:04:31,-1,9,10
120,VIR,P001844,P002084,0 days 00:04:23,-7,3,10
120,VIR,P001844,P006739,0 days 00:04:20,-1,11,12
120,VIR,P003527,P009549,0 days 00:04:19,10,13,3
120,VIR,P004007,P010781,0 days 00:04:16,-8,3,11
120,VIR,P002084,PBCN,0 days 00:03:59,-2,5,7
120,VIR,P001133,P004007,0 days 00:03:54,-8,2,10
120,VIR,P004007,P006739,0 days 00:03:51,-7,5,12
120,VIR,P006739,P010781,0 days 00:03:44,-2,7,9
120,VIR,P001844,P004007,0 days 00:03:21,-5,3,8
120,VIR,P002084,P004007,0 days 00:03:18,-4,6,10
120,VIR,P004007,P009549,0 days 00:02:56,-4,5,9
120,VIR,P002084,P009549,0 days 00:02:54,1,8,7
120,VIR,P002084,P010781,0 days 00:02:29,-2,3,5
120,VIR,P010781,P012714,0 days 00:01:35,0,4,4
120,VIR,P002084,P012714,0 days 00:01:30,0,3,3
120,VIR,P003527,P006739,0 days 00:00:55,-2,3,5
121,ZAL,P007109,P011218,0 days 00:32:20,-1,70,71
121,ZAL,P003211,P011218,0 days 00:25:01,19,65,46
121,ZAL,P003211,P007109,0 days 00:23:59,10,58,48
121,ZAL,P002329,P011218,0 days 00:23:18,-2,46,48
121,ZAL,P002329,P007109,0 days 00:22:44,-6,42,48
121,ZAL,P002329,P003211,0 days 00:21:18,3,45,42
121,ZAL,P003211,P006860,0 days 00:16:02,12,39,27
121,ZAL,P007109,P007513,0 days 00:15:48,-13,29,42
121,ZAL,P007513,P011218,0 days 00:14:45,-10,27,37
121,ZAL,P006860,P011218,0 days 00:12:59,17,33,16
121,ZAL,P010390,P011218,0 days 00:12:58,3,34,31
121,ZAL,P006860,P007109,0 days 00:12:50,12,30,18
121,ZAL,P007109,P010390,0 days 00:10:43,-3,25,28
121,ZAL,P002329,P006860,0 days 00:09:28,8,20,12
121,ZAL,P003211,P010390,0 days 00:08:55,7,27,20
121,ZAL,P007513,P010390,0 days 00:08:49,-18,11,29
121,ZAL,P009917,P011218,0 days 00:08:48,-3,18,21
121,ZAL,P002329,P010390,0 days 00:08:17,0,19,19
121,ZAL,P002329,P007513,0 days 00:08:11,-17,7,24
121,ZAL,P003211,P009917,0 days 00:07:45,-6,14,20
121,ZAL,P003211,P007513,0 days 00:07:26,-5,15,20
121,ZAL,P007109,P009917,0 days 00:07:17,-5,14,19
121,ZAL,P005504,P011218,0 days 00:06:41,-15,8,23
121,ZAL,P005504,P007109,0 days 00:06:41,-15,8,23
121,ZAL,P002329,P009917,0 days 00:06:05,-4,11,15
121,ZAL,P009917,P010390,0 days 00:05:48,-9,8,17
121,ZAL,P002329,P005504,0 days 00:05:47,-14,6,20
121,ZAL,P010390,P012787,0 days 00:05:08,6,19,13
121,ZAL,P003211,P012787,0 days 00:05:06,1,16,15
121,ZAL,P007513,P009917,0 days 00:04:55,-13,4,17
121,ZAL,P007109,P012787,0 days 00:04:46,-3,12,15
121,ZAL,P005504,P007513,0 days 00:04:19,-7,5,12
121,ZAL,P011218,P012787,0 days 00:04:14,4,15,11
121,ZAL,P006860,P012787,0 days 00:04:10,-1,11,12
121,ZAL,P006860,P007513,0 days 00:03:47,2,11,9
121,ZAL,P003211,P005504,0 days 00:03:16,-9,5,14
121,ZAL,P007513,P012787,0 days 00:02:56,-3,7,10
121,ZAL,P006860,P010390,0 days 00:02:34,2,9,7
121,ZAL,P006860,P009917,0 days 00:02:18,-4,3,7
121,ZAL,P002329,P012787,0 days 00:01:48,0,4,4
121,PAR,P009862,P012742,0 days 00:28:48,6,70,64
121,PAR,P008987,P009862,0 days 00:27:05,2,56,54
121,PAR,P008987,P012742,0 days 00:24:41,-5,49,54
121,PAR,P007400,P009862,0 days 00:24:36,8,62,54
121,PAR,P012096,P012742,0 days 00:23:37,-4,52,56
121,PAR,P007400,P012742,0 days 00:23:10,0,57,57
121,PAR,P009862,P012096,0 days 00:21:10,-3,45,48
121,PAR,P007400,P008987,0 days 00:20:29,-3,41,44
121,PAR,P008987,P011051,0 days 00:20:09,9,41,32
121,PAR,P008987,P012096,0 days 00:20:00,-2,44,46
121,PAR,P009862,P011051,0 days 00:18:57,12,42,30
121,PAR,P011051,P012742,0 days 00:16:02,4,32,28
121,PAR,P007400,P012096,0 days 00:13:06,-7,30,37
121,PAR,P011051,P012096,0 days 00:12:43,3,27,24
121,PAR,P007400,P011051,0 days 00:11:50,6,24,18
121,PAR,P004172,P007400,0 days 00:11:35,0,23,23
121,PAR,P004172,P008987,0 days 00:10:34,1,21,20
121,PAR,P004172,P011051,0 days 00:09:43,2,18,16
121,PAR,P007400,P009212,0 days 00:06:45,8,25,17
121,PAR,P009212,P009862,0 days 00:06:45,8,25,17
121,PAR,P009212,P012742,0 days 00:06:45,8,25,17
121,PAR,P004172,P009862,0 days 00:06:42,3,14,11
121,PAR,P007400,P011050,0 days 00:06:22,8,22,14
121,PAR,P009862,P011050,0 days 00:06:22,8,22,14
121,PAR,P011050,P012742,0 days 00:06:22,8,22,14
121,PAR,P009212,P011050,0 days 00:05:20,10,22,12
121,PAR,P004172,P012742,0 days 00:05:16,-5,9,14
121,PAR,P004172,P012096,0 days 00:02:27,-1,7,8
121,PAR,P009212,P012096,0 days 00:01:25,-2,3,5
121,PAR,P008987,P011050,0 days 00:01:02,-2,0,2
121,PAR,P000956,P004172,0 days 00:00:03,0,0,0
121,PAR,P000956,P007400,0 days 00:00:03,0,0,0
121,PAR,P000956,P009862,0 days 00:00:03,0,0,0
121,PAR,P000956,P012742,0 days 00:00:03,0,0,0
122,TEL,P009622,P009783,0 days 00:27:17,2,64,62
122,TEL,P009783,P011199,0 days 00:20:44,8,48,40
122,TEL,P009622,P011199,0 days 00:20:20,8,48,40
122,TEL,P011193,P011971,0 days 00:19:43,14,59,45
122,TEL,P009783,P009863,0 days 00:15:49,-4,31,35
122,TEL,P009622,P009863,0 days 00:15:46,-4,31,35
122,TEL,P011193,P011214,0 days 00:15:32,4,38,34
122,TEL,P011193,P011219,0 days 00:14:48,4,29,25
122,TEL,P009863,P011199,0 days 00:14:37,-2,27,29
122,TEL,P011214,P011971,0 days 00:14:26,9,36,27
122,TEL,P009622,P011193,0 days 00:14:02,9,44,35
122,TEL,P011219,P011971,0 days 00:12:47,5,28,23
122,TEL,P009783,P011193,0 days 00:11:54,4,35,31
122,TEL,P005145,P009783,0 days 00:11:46,-1,21,22
122,TEL,P005145,P009622,0 days 00:11:46,-1,21,22
122,TEL,P005145,P011199,0 days 00:11:46,-1,21,22
122,TEL,P005145,P009863,0 days 00:11:46,-1,21,22
122,TEL,P011214,P011219,0 days 00:10:56,5,21,16
122,TEL,P009622,P011971,0 days 00:10:47,12,39,27
122,TEL,P009783,P011971,0 days 00:08:40,7,30,23
122,TEL,P009622,P011219,0 days 00:08:12,3,16,13
122,TEL,P011193,P011199,0 days 00:08:03,11,28,17
122,TEL,P009622,P011214,0 days 00:07:59,-2,21,23
122,TEL,P011971,P012744,0 days 00:07:25,6,22,16
122,TEL,P011193,P012744,0 days 00:07:24,6,22,16
122,TEL,P009783,P011214,0 days 00:06:09,-5,14,19
122,TEL,P011199,P011971,0 days 00:05:51,9,25,16
122,TEL,P009783,P011219,0 days 00:05:41,-2,7,9
122,TEL,P011214,P012744,0 days 00:05:41,8,17,9
122,TEL,P011219,P012744,0 days 00:05:23,5,15,10
122,TEL,P009863,P011193,0 days 00:05:14,-8,9,17
122,TEL,P011199,P012744,0 days 00:04:53,0,13,13
122,TEL,P009863,P012744,0 days 00:04:07,-5,9,14
122,TEL,P009863,P011219,0 days 00:04:05,-6,5,11
122,TEL,P009863,P011971,0 days 00:04:05,-6,5,11
122,TEL,P009863,P011214,0 days 00:03:55,-4,6,10
122,TEL,P009622,P012744,0 days 00:03:15,1,8,7
122,TEL,P009783,P012744,0 days 00:02:56,-1,6,7
122,TEL,P011199,P011214,0 days 00:02:22,1,7,6
122,TEL,P011199,P011219,0 days 00:02:08,2,3,1
122,IST,P007200,P011078,0 days 00:31:38,5,71,66
122,IST,P007200,P011981,0 days 00:28:43,-4,57,61
122,IST,P011078,P011981,0 days 00:27:41,-1,57,58
122,IST,P011078,P012710,0 days 00:25:38,-10,52,62
122,IST,P011078,P012786,0 days 00:24:31,7,57,50
122,IST,P007200,P012786,0 days 00:24:05,7,53,46
122,IST,P007200,P012710,0 days 00:21:39,-2,40,42
122,IST,P011981,P012786,0 days 00:20:40,2,44,42
122,IST,P011981,P012710,0 days 00:17:50,-5,31,36
122,IST,P012710,P012786,0 days 00:16:35,4,34,30
122,IST,P010516,P012710,0 days 00:15:23,-17,28,45
122,IST,P010516,P011078,0 days 00:14:14,-15,30,45
122,IST,P011078,P012788,0 days 00:12:06,1,34,33
122,IST,P007200,P010516,0 days 00:11:17,-10,18,28
122,IST,P009513,P011078,0 days 00:09:39,-8,26,34
122,IST,P010516,P011981,0 days 00:09:05,-9,13,22
122,IST,P009513,P012786,0 days 00:09:02,-3,21,24
122,IST,P012710,P012788,0 days 00:08:50,-7,21,28
122,IST,P012786,P012788,0 days 00:08:39,7,21,14
122,IST,P007200,P012788,0 days 00:08:07,9,22,13
122,IST,P007200,P009513,0 days 00:07:46,-4,18,22
122,IST,P009513,P011981,0 days 00:07:45,-4,18,22
122,IST,P010516,P012788,0 days 00:07:13,-11,17,28
122,IST,P009513,P010516,0 days 00:05:15,-9,11,20
122,IST,P010516,P012786,0 days 00:05:03,-5,7,12
122,IST,P009513,P012710,0 days 00:04:12,-6,11,17
122,IST,P011981,P012788,0 days 00:03:08,5,8,3
122,IST,P009513,P012788,0 days 00:02:56,-7,8,15
122,IST,P004093,P007200,0 days 00:01:33,-1,5,6
122,IST,P004093,P012788,0 days 00:01:33,-1,5,6
122,IST,P004093,P010516,0 days 00:01:33,-1,5,6
122,IST,P009513,P012415,0 days 00:01:17,1,3,2
122,IST,P012415,P012786,0 days 00:01:17,1,3,2
122,IST,P012415,P012710,0 days 00:01:17,1,3,2
122,IST,P010516,P012415,0 days 00:01:17,1,3,2
122,IST,P004093,P011078,0 days 00:01:09,1,5,4
122,IST,P004093,P012710,0 days 00:00:24,-2,0,2
123,ULK,P006661,P008962,0 days 00:24:56,4,53,49
123,ULK,P001932,P008962,0 days 00:23:59,4,50,46
123,ULK,P001932,P006661,0 days 00:22:54,4,48,44
123,ULK,P002968,P008962,0 days 00:22:35,9,47,38
123,ULK,P004004,P008962,0 days 00:21:20,-1,41,42
123,ULK,P001932,P002968,0 days 00:21:19,13,49,36
123,ULK,P002968,P006661,0 days 00:19:29,10,44,34
123,ULK,P008962,P010560,0 days 00:14:59,6,32,26
123,ULK,P004004,P009849,0 days 00:14:00,10,33,23
123,ULK,P001932,P010560,0 days 00:13:55,8,32,24
123,ULK,P006661,P010560,0 days 00:13:55,8,32,24
123,ULK,P001932,P004004,0 days 00:13:42,1,29,28
123,ULK,P004004,P011157,0 days 00:13:15,6,32,26
123,ULK,P004004,P011052,0 days 00:13:04,3,28,25
123,ULK,P002968,P010560,0 days 00:11:56,8,29,21
123,ULK,P004004,P006661,0 days 00:11:42,-4,24,28
123,ULK,P002968,P004004,0 days 00:11:24,4,21,17
123,ULK,P011052,P011157,0 days 00:11:03,4,27,23
123,ULK,P008962,P011052,0 days 00:10:35,3,20,17
123,ULK,P009849,P011157,0 days 00:10:09,8,27,19
123,ULK,P009849,P011052,0 days 00:09:58,5,23,18
123,ULK,P008962,P011157,0 days 00:09:52,4,19,15
123,ULK,P008962,P009849,0 days 00:08:34,5,17,12
123,ULK,P004004,P011980,0 days 00:06:52,-1,17,18
123,ULK,P009849,P011980,0 days 00:05:26,5,16,11
123,ULK,P011157,P011980,0 days 00:04:41,2,13,11
123,ULK,P001932,P011980,0 days 00:04:23,-1,9,10
123,ULK,P001932,P009849,0 days 00:04:02,5,10,5
123,ULK,P002968,P009849,0 days 00:03:51,2,6,4
123,ULK,P001932,P011157,0 days 00:03:30,2,5,3
123,ULK,P006661,P011157,0 days 00:03:20,0,5,5
123,ULK,P011052,P011980,0 days 00:02:29,0,8,8
123,ULK,P010560,P011157,0 days 00:02:22,-2,0,2
123,ULK,P006661,P011052,0 days 00:02:02,0,5,5
123,ULK,P002968,P011052,0 days 00:02:01,-1,1,2
123,ULK,P004004,P010560,0 days 00:01:45,-2,3,5
123,ULK,P006661,P011980,0 days 00:01:26,-6,1,7
123,ULK,P008962,P011980,0 days 00:01:26,-6,1,7
123,ULK,P010560,P011052,0 days 00:01:04,-2,0,2
123,ULK,P002968,P011980,0 days 00:00:45,3,3,0
123,MCO,P005985,P011226,0 days 00:28:04,-7,49,56
123,MCO,P011212,P011226,0 days 00:24:59,-7,43,50
123,MCO,P005985,PLCZ,0 days 00:22:44,-5,40,45
123,MCO,P005985,P011212,0 days 00:21:43,-10,32,42
123,MCO,P011226,PLCZ,0 days 00:20:39,-2,41,43
123,MCO,P005985,P010588,0 days 00:19:29,-9,38,47
123,MCO,P011212,P011231,0 days 00:18:14,2,38,36
123,MCO,P010588,PLCZ,0 days 00:17:36,-6,36,42
123,MCO,P010588,P011226,0 days 00:17:24,-6,39,45
123,MCO,P005985,P011231,0 days 00:17:18,-4,26,30
123,MCO,P011226,P011231,0 days 00:16:18,3,33,30
123,MCO,P011196,P011212,0 days 00:13:10,-5,25,30
123,MCO,P011212,PLCZ,0 days 00:12:22,-4,19,23
123,MCO,P011196,P011226,0 days 00:10:58,-3,20,23
123,MCO,P011231,PLCZ,0 days 00:10:38,0,16,16
123,MCO,P011196,P011231,0 days 00:10:13,-2,22,24
123,MCO,P005985,P011196,0 days 00:09:53,-7,14,21
123,MCO,P011231,P012709,0 days 00:09:45,-4,20,24
123,MCO,P010588,P011212,0 days 00:09:26,-7,17,24
123,MCO,P010588,P011231,0 days 00:08:22,-6,13,19
123,MCO,P011226,P012515,0 days 00:07:35,1,22,21
123,MCO,P005985,P012515,0 days 00:07:35,1,22,21
123,MCO,P005985,P012709,0 days 00:07:26,-6,9,15
123,MCO,P012515,PLCZ,0 days 00:07:19,2,22,20
123,MCO,P010588,P012515,0 days 00:07:00,1,22,21
123,MCO,P011196,P012709,0 days 00:05:29,0,16,16
123,MCO,P011212,P012709,0 days 00:05:29,0,16,16
123,MCO,P010588,P012709,0 days 00:05:14,-4,4,8
123,MCO,P012709,PLCZ,0 days 00:05:14,-4,4,8
123,MCO,P011226,P012709,0 days 00:04:15,2,11,9
123,MCO,P004790,P005985,0 days 00:03:56,-5,2,7
123,MCO,P004790,P011226,0 days 00:03:56,-5,2,7
123,MCO,P004790,P011212,0 days 00:03:21,-5,2,7
123,MCO,P004790,PLCZ,0 days 00:03:08,-5,2,7
123,MCO,P010588,P011196,0 days 00:02:09,-3,3,6
123,MCO,P004790,P011196,0 days 00:00:48,0,0,0
123,MCO,P004790,P012515,0 days 00:00:35,0,0,0
123,MCO,P011231,P012515,0 days 00:00:16,-1,0,1
124,RED,P000848,P009035,0 days 00:21:37,18,55,37
124,RED,P000848,P012044,0 days 00:19:06,12,44,32
124,RED,P009035,P012044,0 days 00:19:06,12,44,32
124,RED,P006436,P009035,0 days 00:17:22,18,46,28
124,RED,P006436,P007960,0 days 00:16:40,2,39,37
124,RED,P007960,PJDR,0 days 00:16:06,8,36,28
124,RED,P006436,P012044,0 days 00:15:48,5,30,25
124,RED,P011224,PJDR,0 days 00:15:33,2,30,28
124,RED,P000848,P006436,0 days 00:15:29,17,41,24
124,RED,P006436,PJDR,0 days 00:13:54,7,38,31
124,RED,P008966,P011224,0 days 00:13:40,1,25,24
124,RED,P008966,PJDR,0 days 00:13:40,1,25,24
124,RED,P007960,P011224,0 days 00:13:35,2,25,23
124,RED,P002553,P009035,0 days 00:13:30,9,30,21
124,RED,P000848,P002553,0 days 00:12:57,7,28,21
124,RED,P002553,P012044,0 days 00:12:57,7,28,21
124,RED,P007960,P008966,0 days 00:12:15,3,22,19
124,RED,P006436,P011224,0 days 00:11:23,1,27,26
124,RED,P006436,P008966,0 days 00:09:30,0,22,22
124,RED,P012044,PLUO,0 days 00:08:58,-5,14,19
124,RED,P002553,P006436,0 days 00:08:47,6,19,13
124,RED,P012044,P012711,0 days 00:07:05,-2,10,12
124,RED,P006436,P012711,0 days 00:07:05,-2,10,12
124,RED,P007960,PLUO,0 days 00:07:00,-5,3,8
124,RED,P009035,PLUO,0 days 00:06:08,1,14,13
124,RED,P002553,PLUO,0 days 00:06:08,1,14,13
124,RED,P000848,PLUO,0 days 00:06:08,1,14,13
124,RED,P007960,P009035,0 days 00:05:45,6,20,14
124,RED,P007960,P012044,0 days 00:04:44,-5,6,11
124,RED,P000848,P007960,0 days 00:04:25,7,17,10
124,RED,P009035,PJDR,0 days 00:04:24,7,16,9
124,RED,P000848,P012711,0 days 00:04:15,4,10,6
124,RED,P009035,P012711,0 days 00:04:15,4,10,6
124,RED,P008966,PLUO,0 days 00:04:10,1,3,2
124,RED,P011224,PLUO,0 days 00:04:10,1,3,2
124,RED,PJDR,PLUO,0 days 00:04:10,1,3,2
124,RED,P007960,P012711,0 days 00:02:50,-6,0,6
124,RED,P012711,PLUO,0 days 00:02:50,-6,0,6
124,RED,P006436,PLUO,0 days 00:02:50,-6,0,6
124,RED,P000848,PJDR,0 days 00:02:31,6,11,5
124,RED,P002553,P011224,0 days 00:01:58,0,5,5
124,RED,P002553,PJDR,0 days 00:01:58,0,5,5
124,RED,P009035,P011224,0 days 00:01:53,1,5,4
124,RED,P002553,P008966,0 days 00:01:25,-2,3,5
124,BER,P003958,P011934,0 days 00:21:49,-10,35,45
124,BER,P003958,P012720,0 days 00:16:53,-5,31,36
124,BER,P008211,P008967,0 days 00:16:37,-1,34,35
124,BER,P011934,P012720,0 days 00:15:42,-4,29,33
124,BER,P008173,P008384,0 days 00:13:38,-2,25,27
124,BER,P003958,P008384,0 days 00:13:38,-7,26,33
124,BER,P003958,P008967,0 days 00:12:59,-5,17,22
124,BER,P003958,P008211,0 days 00:12:54,-5,19,24
124,BER,P003958,P008173,0 days 00:12:50,-9,22,31
124,BER,P006919,P008967,0 days 00:12:30,-7,24,31
124,BER,P008173,P011934,0 days 00:12:20,-7,21,28
124,BER,P008967,P011934,0 days 00:12:14,-4,16,20
124,BER,P006251,P012721,0 days 00:11:51,2,26,24
124,BER,P008173,P012720,0 days 00:11:49,-6,25,31
124,BER,P006251,P006919,0 days 00:11:30,0,27,27
124,BER,P008384,P012720,0 days 00:11:27,-6,22,28
124,BER,P006919,P008211,0 days 00:11:26,-7,23,30
124,BER,P008384,P011934,0 days 00:10:16,-5,20,25
124,BER,P008211,P011934,0 days 00:10:10,-2,15,17
124,BER,P006251,P008211,0 days 00:09:34,-8,21,29
124,BER,P006251,P008173,0 days 00:08:37,4,15,11
124,BER,P006919,P012721,0 days 00:08:32,4,23,19
124,BER,P006251,P008967,0 days 00:07:49,-1,20,21
124,BER,P008211,P012720,0 days 00:07:15,-5,9,14
124,BER,P006919,P011934,0 days 00:06:48,-5,7,12
124,BER,P003958,P006919,0 days 00:06:40,-8,6,14
124,BER,P006251,P008384,0 days 00:06:14,-1,9,10
124,BER,P006919,P008173,0 days 00:06:11,1,10,9
124,BER,P008173,P012721,0 days 00:06:09,4,9,5
124,BER,P008967,P012721,0 days 00:05:42,-2,17,19
124,BER,P008211,P012721,0 days 00:05:42,-2,17,19
124,BER,P008967,P012720,0 days 00:05:26,1,9,8
124,BER,P006251,P007025,0 days 00:04:37,-5,5,10
124,BER,P006251,P006819,0 days 00:04:34,3,9,6
124,BER,P006819,P006919,0 days 00:04:34,3,9,6
124,BER,P003958,P006251,0 days 00:03:55,-4,6,10
124,BER,P007025,P008384,0 days 00:03:37,0,5,5
124,BER,P006819,P008173,0 days 00:03:26,6,9,3
124,BER,P006251,P012720,0 days 00:03:22,-7,5,12
124,BER,P007025,P008173,0 days 00:03:19,-2,3,5
124,BER,P007025,P012721,0 days 00:03:19,-2,3,5
124,BER,P008211,P008384,0 days 00:02:52,-4,4,8
124,BER,P008384,P012721,0 days 00:02:52,1,3,2
124,BER,P006819,P012721,0 days 00:02:50,6,6,0
124,BER,P008173,P008967,0 days 00:02:45,-5,1,6
124,BER,P006819,P012720,0 days 00:01:44,-3,3,6
124,BER,P006919,P012720,0 days 00:01:44,-3,3,6
124,BER,P008384,P008967,0 days 00:01:26,0,2,2
124,BER,P003958,P007025,0 days 00:01:18,-3,2,5
124,BER,P007025,P008211,0 days 00:01:18,-3,2,5
124,BER,P006819,P008211,0 days 00:01:08,-3,0,3
124,BER,P006251,P011934,0 days 00:00:41,1,1,0
124,BER,P006919,P007025,0 days 00:00:33,-2,0,2
124,BER,P007025,P012720,0 days 00:00:27,-3,0,3
124,BER,P012720,P012721,0 days 00:00:27,-3,0,3
125,BAR,P002939,P004866,0 days 00:20:01,2,52,50
125,BAR,P003478,P007464,0 days 00:17:06,-1,27,28
125,BAR,P000925,P003478,0 days 00:16:42,4,32,28
125,BAR,P006435,P007464,0 days 00:16:03,0,35,35
125,BAR,P003478,P006435,0 days 00:14:24,-4,23,27
125,BAR,P002939,P009992,0 days 00:14:11,-3,42,45
125,BAR,P004866,P009992,0 days 00:14:11,-5,42,47
125,BAR,P006435,P007519,0 days 00:13:41,-2,24,26
125,BAR,P000925,P007464,0 days 00:13:21,8,32,24
125,BAR,P000925,P002939,0 days 00:13:13,2,24,22
125,BAR,P007464,P007519,0 days 00:12:34,1,24,23
125,BAR,P002939,P003478,0 days 00:12:32,2,26,24
125,BAR,P002939,P003196,0 days 00:11:58,-8,33,41
125,BAR,P002939,P011244,0 days 00:11:39,-10,20,30
125,BAR,P003196,P004866,0 days 00:10:51,-5,33,38
125,BAR,P000925,P006435,0 days 00:10:39,5,28,23
125,BAR,P000925,P004866,0 days 00:10:23,5,22,17
125,BAR,P002939,P006435,0 days 00:09:30,-1,19,20
125,BAR,P003478,P007519,0 days 00:09:30,1,16,15
125,BAR,P004866,P006435,0 days 00:09:21,5,26,21
125,BAR,P003196,P009992,0 days 00:09:20,-7,31,38
125,BAR,P003196,P011244,0 days 00:09:17,-12,18,30
125,BAR,P002939,P007464,0 days 00:09:06,1,18,17
125,BAR,P003478,P004866,0 days 00:09:02,4,22,18
125,BAR,P004866,P011244,0 days 00:09:01,-7,20,27
125,BAR,P004866,P007464,0 days 00:08:47,4,19,15
125,BAR,P009992,P011244,0 days 00:07:30,-9,18,27
125,BAR,P003196,P006435,0 days 00:07:17,-3,12,15
125,BAR,P003478,P009992,0 days 00:06:13,4,21,17
125,BAR,P007464,P010641,0 days 00:05:32,-3,6,9
125,BAR,P007519,P010641,0 days 00:05:32,-3,6,9
125,BAR,P006435,P010641,0 days 00:05:32,-3,6,9
125,BAR,P000925,P009992,0 days 00:05:24,1,12,11
125,BAR,P000925,P007519,0 days 00:04:15,7,14,7
125,BAR,P006435,P011244,0 days 00:04:09,-1,2,3
125,BAR,P003196,P007519,0 days 00:03:54,-6,4,10
125,BAR,P003196,P003478,0 days 00:03:36,0,13,13
125,BAR,P006435,P009992,0 days 00:03:16,0,9,9
125,BAR,P004866,P010641,0 days 00:03:15,1,8,7
125,BAR,P003478,P010641,0 days 00:03:08,-2,0,2
125,BAR,P004866,P007519,0 days 00:03:04,0,8,8
125,BAR,P003196,P007464,0 days 00:02:47,-3,4,7
125,BAR,P000925,P011244,0 days 00:01:31,0,0,0
125,BAR,P003478,P011244,0 days 00:01:31,0,0,0
125,BAR,P007464,P009992,0 days 00:01:24,1,3,2
125,BAR,P002939,P007519,0 days 00:01:07,-3,0,3
125,BAR,P007519,P011244,0 days 00:01:07,-3,0,3
125,BAR,P002939,P010641,0 days 00:00:51,2,2,0
125,BAR,P009992,P010641,0 days 00:00:51,2,2,0
125,BAR,P010641,P011244,0 days 00:00:51,2,2,0
125,MIL,P002849,P007831,0 days 00:27:16,4,67,63
125,MIL,P002849,P005670,0 days 00:25:37,7,62,55
125,MIL,P005670,P007201,0 days 00:25:10,10,56,46
125,MIL,P005670,P007831,0 days 00:24:27,8,60,52
125,MIL,P002849,P007201,0 days 00:23:11,8,50,42
125,MIL,P007201,P007831,0 days 00:21:47,9,48,39
125,MIL,P007831,P011205,0 days 00:20:28,-2,54,56
125,MIL,P005670,P011205,0 days 00:16:53,1,44,43
125,MIL,P002849,P011205,0 days 00:15:59,-2,43,45
125,MIL,P001518,P005670,0 days 00:15:49,7,28,21
125,MIL,P001518,P002849,0 days 00:13:54,3,28,25
125,MIL,P001518,P007201,0 days 00:12:41,5,26,21
125,MIL,P001518,P007831,0 days 00:12:30,4,26,22
125,MIL,P007201,P011205,0 days 00:12:29,5,30,25
125,MIL,P006509,P009960,0 days 00:11:06,1,21,20
125,MIL,P009960,P011205,0 days 00:10:01,-5,24,29
125,MIL,P002812,P006509,0 days 00:09:47,-5,18,23
125,MIL,P002812,P009960,0 days 00:09:21,-1,15,16
125,MIL,P005670,P009960,0 days 00:08:54,-3,15,18
125,MIL,P002812,P011205,0 days 00:08:40,-2,25,27
125,MIL,P006509,P011205,0 days 00:08:38,-5,22,27
125,MIL,P005670,P006509,0 days 00:08:15,0,12,12
125,MIL,P002812,P007831,0 days 00:06:56,1,23,22
125,MIL,P007831,P009960,0 days 00:06:18,-4,16,20
125,MIL,P002812,P005670,0 days 00:05:43,2,11,9
125,MIL,P006509,P007831,0 days 00:04:55,-4,14,18
125,MIL,P001518,P006509,0 days 00:04:32,1,4,3
125,MIL,P006509,P007201,0 days 00:03:23,1,8,7
125,MIL,P001518,P002812,0 days 00:03:08,2,2,0
125,MIL,P001518,P009960,0 days 00:03:08,2,2,0
125,MIL,P002812,P002849,0 days 00:02:27,1,12,11
125,MIL,P002849,P006701,0 days 00:02:23,0,4,4
125,MIL,P006701,P011205,0 days 00:02:23,0,4,4
125,MIL,P006701,P007831,0 days 00:02:23,0,4,4
125,MIL,P002849,P006509,0 days 00:02:04,-5,5,10
125,MIL,P007201,P009960,0 days 00:01:59,2,6,4
125,MIL,P002849,P009960,0 days 00:01:49,-4,5,9
125,MIL,P001518,P011205,0 days 00:01:13,-2,2,4
125,MIL,P001518,P006701,0 days 00:01:13,-2,2,4
125,MIL,P002812,P006701,0 days 00:01:10,2,2,0
126,OLY,P008855,P010612,0 days 00:30:00,3,45,42
126,OLY,P001255,P008855,0 days 00:30:00,3,45,42
126,OLY,P001255,P010612,0 days 00:30:00,3,45,42
126,OLY,P008811,P008855,0 days 00:22:43,9,41,32
126,OLY,P001255,P008811,0 days 00:19:34,11,36,25
126,OLY,P008811,P010612,0 days 00:19:34,11,36,25
126,OLY,P006589,P008811,0 days 00:16:11,2,24,22
126,OLY,P006589,P008855,0 days 00:13:44,6,22,16
126,OLY,P003941,P008855,0 days 00:12:22,-10,9,19
126,OLY,P001255,P006589,0 days 00:10:35,8,17,9
126,OLY,P006589,P010612,0 days 00:10:35,8,17,9
126,OLY,P001255,P003941,0 days 00:10:26,-8,9,17
126,OLY,P003941,P010612,0 days 00:10:26,-8,9,17
126,OLY,P008855,P010392,0 days 00:10:02,-7,8,15
126,OLY,P007853,P008855,0 days 00:09:47,1,17,16
126,OLY,P008811,P011983,0 days 00:08:36,-5,12,17
126,OLY,P003941,P010392,0 days 00:07:56,-8,4,12
126,OLY,P001255,P007853,0 days 00:07:51,3,17,14
126,OLY,P007853,P010612,0 days 00:07:51,3,17,14
126,OLY,P008811,P010392,0 days 00:07:01,-5,10,15
126,OLY,P003941,P007853,0 days 00:06:36,-6,4,10
126,OLY,P008855,P011983,0 days 00:06:09,-1,10,11
126,OLY,P007853,P008811,0 days 00:05:39,5,17,12
126,OLY,P010392,P011983,0 days 00:05:36,-6,7,13
126,OLY,P006589,P010392,0 days 00:05:36,-6,7,13
126,OLY,P006589,P011983,0 days 00:05:36,-6,7,13
126,OLY,P008855,P011194,0 days 00:05:33,-8,3,11
126,OLY,P001255,P010392,0 days 00:04:57,-3,3,6
126,OLY,P010392,P010612,0 days 00:04:57,-3,3,6
126,OLY,P007982,P010392,0 days 00:04:55,-6,6,12
126,OLY,P003941,P011194,0 days 00:04:51,-9,4,13
126,OLY,P010392,P011194,0 days 00:04:24,-4,4,8
126,OLY,P007853,P011194,0 days 00:04:24,-4,4,8
126,OLY,P007853,P010392,0 days 00:04:24,-4,4,8
126,OLY,P007982,P008811,0 days 00:03:52,-3,5,8
126,OLY,P001255,P011194,0 days 00:03:37,-6,3,9
126,OLY,P010612,P011194,0 days 00:03:37,-6,3,9
126,OLY,P008811,P011194,0 days 00:03:10,-1,3,4
126,OLY,P010612,P011983,0 days 00:03:00,1,5,4
126,OLY,P001255,P011983,0 days 00:03:00,1,5,4
126,OLY,P007853,P007982,0 days 00:02:28,-2,4,6
126,OLY,P007982,P011194,0 days 00:02:28,-2,4,6
126,OLY,P007982,P011983,0 days 00:02:27,-4,2,6
126,OLY,P006589,P007982,0 days 00:02:27,-4,2,6
126,OLY,P003941,P007982,0 days 00:01:03,-3,1,4
126,PAM,P000556,P010568,0 days 00:23:32,-1,36,37
126,PAM,P010568,P012739,0 days 00:17:33,-7,22,29
126,PAM,P004863,P007870,0 days 00:14:54,15,32,17
126,PAM,P010568,P012738,0 days 00:14:40,-5,20,25
126,PAM,P000556,P012739,0 days 00:14:10,-10,15,25
126,PAM,P000556,P012738,0 days 00:13:02,-8,15,23
126,PAM,P012738,P012739,0 days 00:12:41,-8,15,23
126,PAM,P003960,P006643,0 days 00:12:10,11,25,14
126,PAM,P004863,P010568,0 days 00:11:46,3,21,18
126,PAM,P000556,P004863,0 days 00:11:01,2,21,19
126,PAM,P006643,P007870,0 days 00:11:01,5,15,10
126,PAM,P000556,P007870,0 days 00:10:57,2,21,19
126,PAM,P007870,P010568,0 days 00:10:11,8,21,13
126,PAM,P007870,P008780,0 days 00:09:44,2,13,11
126,PAM,P007870,P010393,0 days 00:09:41,7,15,8
126,PAM,P010568,P012740,0 days 00:09:15,-5,12,17
126,PAM,P006643,P008780,0 days 00:09:11,6,14,8
126,PAM,P008780,P010568,0 days 00:08:56,5,15,10
126,PAM,P004863,P006643,0 days 00:08:41,7,15,8
126,PAM,P003960,P004863,0 days 00:08:32,8,21,13
126,PAM,P003960,P007870,0 days 00:08:32,8,21,13
126,PAM,P000556,P010393,0 days 00:08:23,3,13,10
126,PAM,P003960,P010568,0 days 00:08:23,6,20,14
126,PAM,P006643,P010568,0 days 00:08:05,1,12,11
126,PAM,P000556,P008780,0 days 00:08:00,-3,10,13
126,PAM,P000556,P012740,0 days 00:07:37,-12,5,17
126,PAM,P010393,P010568,0 days 00:07:27,7,13,6
126,PAM,P006643,P012740,0 days 00:07:13,8,13,5
126,PAM,P012739,P012740,0 days 00:07:02,-7,7,14
126,PAM,P003960,P012740,0 days 00:06:22,8,13,5
126,PAM,P012738,P012740,0 days 00:06:15,-2,10,12
126,PAM,P008780,P012739,0 days 00:05:58,3,11,8
126,PAM,P004863,P010393,0 days 00:05:50,8,11,3
126,PAM,P008780,P010393,0 days 00:05:47,1,6,5
126,PAM,P007870,P012740,0 days 00:05:35,1,6,5
126,PAM,P003960,P008780,0 days 00:04:55,6,12,6
126,PAM,P004863,P012738,0 days 00:04:54,-3,4,7
126,PAM,P004863,P012739,0 days 00:04:33,-3,4,7
126,PAM,P010393,P012740,0 days 00:04:26,-8,0,8
126,PAM,P004863,P008780,0 days 00:04:24,5,9,4
126,PAM,P008780,P012738,0 days 00:03:31,0,6,6
126,PAM,P003960,P012739,0 days 00:03:23,3,7,4
126,PAM,P006643,P012739,0 days 00:03:23,3,7,4
126,PAM,P006643,P010393,0 days 00:03:22,1,2,1
126,PAM,P004863,P012740,0 days 00:03:13,6,6,0
126,PAM,P008780,P012740,0 days 00:02:22,-5,0,5
126,PAM,P000556,P003960,0 days 00:02:02,0,8,8
126,PAM,P000556,P006643,0 days 00:01:44,-5,0,5
126,PAM,P003960,P012738,0 days 00:01:38,3,5,2
126,PAM,P006643,P012738,0 days 00:01:38,3,5,2
126,PAM,P010393,P012739,0 days 00:01:29,-2,0,2
126,PAM,P003960,P010393,0 days 00:00:35,-1,0,1
126,PAM,P007870,P012738,0 days 00:00:21,0,0,0
127,BER,P003958,P008967,0 days 00:25:26,9,54,45
127,BER,P003958,P011934,0 days 00:24:13,3,49,46
127,BER,P003958,P012720,0 days 00:21:39,2,41,39
127,BER,P011934,P012720,0 days 00:20:30,2,41,39
127,BER,P008967,P011934,0 days 00:20:21,9,45,36
127,BER,P008967,P012720,0 days 00:19:08,8,41,33
127,BER,P003958,P008173,0 days 00:16:25,8,36,28
127,BER,P008173,P008967,0 days 00:15:04,8,32,24
127,BER,P008173,P011934,0 days 00:14:21,4,32,28
127,BER,P003958,P008211,0 days 00:12:53,-5,22,27
127,BER,P006251,P008384,0 days 00:12:46,5,20,15
127,BER,P007025,P008384,0 days 00:12:03,1,20,19
127,BER,P008211,P008384,0 days 00:11:06,-9,19,28
127,BER,P008211,P012720,0 days 00:11:01,-1,17,18
127,BER,P006251,P007025,0 days 00:10:42,1,16,15
127,BER,P008173,P012720,0 days 00:10:38,3,24,21
127,BER,P008211,P008967,0 days 00:10:22,1,22,21
127,BER,P003958,P008384,0 days 00:10:10,-5,17,22
127,BER,P008211,P011934,0 days 00:09:52,-1,17,18
127,BER,P008173,P008384,0 days 00:09:46,5,14,9
127,BER,P008384,P010791,0 days 00:07:47,2,14,12
127,BER,P007025,P008211,0 days 00:06:43,1,14,13
127,BER,P006251,P008211,0 days 00:06:43,1,14,13
127,BER,P008384,P008967,0 days 00:06:18,1,13,12
127,BER,P008384,P011934,0 days 00:06:14,-5,8,13
127,BER,P006251,P008173,0 days 00:06:03,4,6,2
127,BER,P006251,P010791,0 days 00:05:55,6,9,3
127,BER,P007025,P010791,0 days 00:05:55,6,9,3
127,BER,P007025,P008173,0 days 00:05:20,0,6,6
127,BER,P008211,P010791,0 days 00:05:00,2,12,10
127,BER,P006251,P012721,0 days 00:04:47,-5,7,12
127,BER,P007025,P012721,0 days 00:04:47,-5,7,12
127,BER,P008384,P012721,0 days 00:04:47,-5,7,12
127,BER,P008211,P012721,0 days 00:04:44,-5,7,12
127,BER,P008173,P010791,0 days 00:03:56,0,2,2
127,BER,P003958,P010791,0 days 00:03:01,-4,5,9
127,BER,P008967,P010791,0 days 00:03:01,-4,5,9
127,BER,P008384,P012720,0 days 00:02:31,-6,0,6
127,BER,P003958,P006251,0 days 00:02:04,4,4,0
127,BER,P006251,P008967,0 days 00:02:04,4,4,0
127,BER,P003958,P007025,0 days 00:01:21,0,4,4
127,BER,P007025,P011934,0 days 00:01:21,0,4,4
127,BER,P010791,P012720,0 days 00:01:09,0,0,0
127,BER,P008173,P012721,0 days 00:00:03,0,0,0
127,BAR,P002939,P006435,0 days 00:23:15,1,46,45
127,BAR,P002939,P004866,0 days 00:20:49,12,42,30
127,BAR,P000925,P006435,0 days 00:19:28,4,41,37
127,BAR,P002939,P012745,0 days 00:19:20,2,37,35
127,BAR,P000925,P002939,0 days 00:19:10,5,41,36
127,BAR,P006435,P012745,0 days 00:19:05,1,37,36
127,BAR,P004866,P006435,0 days 00:18:03,9,38,29
127,BAR,P000925,P004866,0 days 00:16:40,9,36,27
127,BAR,P000925,P012745,0 days 00:16:23,5,34,29
127,BAR,P004866,P012745,0 days 00:15:56,8,32,24
127,BAR,P009992,P011244,0 days 00:13:57,-2,20,22
127,BAR,P007519,P011244,0 days 00:13:23,-6,20,26
127,BAR,P007519,P009992,0 days 00:11:26,-4,16,20
127,BAR,P003196,P011244,0 days 00:11:07,-7,14,21
127,BAR,P003196,P009992,0 days 00:09:43,-5,10,15
127,BAR,P006435,P007464,0 days 00:08:50,-11,14,25
127,BAR,P003196,P007519,0 days 00:08:36,-9,10,19
127,BAR,P007464,P011244,0 days 00:08:12,-6,9,15
127,BAR,P000925,P011244,0 days 00:07:49,2,17,15
127,BAR,P003196,P007464,0 days 00:07:31,-10,7,17
127,BAR,P002939,P007464,0 days 00:06:53,-9,10,19
127,BAR,P007464,P007519,0 days 00:06:24,-4,6,10
127,BAR,P002939,P003196,0 days 00:05:46,-2,7,9
127,BAR,P004866,P011244,0 days 00:05:39,5,12,7
127,BAR,P002939,P011244,0 days 00:05:36,1,11,10
127,BAR,P004866,P009992,0 days 00:05:13,3,8,5
127,BAR,P003204,P007519,0 days 00:05:11,-4,10,14
127,BAR,P003204,P011244,0 days 00:05:11,-4,10,14
127,BAR,P003204,P009992,0 days 00:05:11,-4,10,14
127,BAR,P000925,P009992,0 days 00:05:02,2,10,8
127,BAR,P006435,P011244,0 days 00:05:02,-3,11,14
127,BAR,P003196,P004866,0 days 00:04:52,4,8,4
127,BAR,P000925,P007519,0 days 00:04:44,3,10,7
127,BAR,P003196,P006435,0 days 00:04:39,-6,7,13
127,BAR,P007464,P009992,0 days 00:04:27,-2,2,4
127,BAR,P000925,P007464,0 days 00:04:20,-3,7,10
127,BAR,P007464,P012745,0 days 00:03:42,-7,5,12
127,BAR,P003196,P012745,0 days 00:03:15,-4,3,7
127,BAR,P000925,P003204,0 days 00:03:12,1,8,7
127,BAR,P002939,P009992,0 days 00:03:04,2,4,2
127,BAR,P003196,P003204,0 days 00:01:59,-5,2,7
127,BAR,P006435,P007519,0 days 00:01:57,-2,4,6
127,BAR,P004866,P007519,0 days 00:01:51,2,4,2
127,BAR,P004866,P007464,0 days 00:01:26,0,2,2
127,BAR,P002939,P010641,0 days 00:01:23,0,2,2
127,BAR,P004866,P010641,0 days 00:01:23,0,2,2
127,BAR,P006435,P010641,0 days 00:01:23,0,2,2
127,BAR,P007464,P010641,0 days 00:01:23,0,2,2
127,BAR,P009992,P012745,0 days 00:00:51,-1,0,1
127,BAR,P006435,P009992,0 days 00:00:18,-1,0,1
128,RED,P002553,P009035,0 days 00:20:52,-5,29,34
128,RED,P009035,P012044,0 days 00:18:45,-7,26,33
128,RED,P005099,P009035,0 days 00:17:57,-6,27,33
128,RED,P002553,P012044,0 days 00:16:39,-5,24,29
128,RED,P009035,PLUO,0 days 00:15:32,-1,20,21
128,RED,P007960,P009035,0 days 00:14:41,-8,16,24
128,RED,P005099,P012044,0 days 00:14:35,3,26,23
128,RED,P000848,PJDR,0 days 00:14:22,-8,21,29
128,RED,P007960,PJDR,0 days 00:13:50,-11,17,28
128,RED,P006436,PJDR,0 days 00:13:21,-10,21,31
128,RED,P005099,PLUO,0 days 00:13:13,-1,20,21
128,RED,P012044,PLUO,0 days 00:13:12,0,19,19
128,RED,P002553,PLUO,0 days 00:13:05,0,19,19
128,RED,P009035,PJDR,0 days 00:12:18,-5,15,20
128,RED,P000848,P007960,0 days 00:11:27,-9,14,23
128,RED,P002553,P005099,0 days 00:10:53,0,19,19
128,RED,P000848,P002553,0 days 00:10:08,-5,14,19
128,RED,P000848,P006436,0 days 00:09:44,-4,14,18
128,RED,P006436,P009035,0 days 00:09:30,-2,11,13
128,RED,P000848,P009035,0 days 00:09:03,0,10,10
128,RED,P005099,P007960,0 days 00:08:47,-1,13,14
128,RED,P002553,P007960,0 days 00:08:42,-7,12,19
128,RED,P002553,PJDR,0 days 00:08:18,-6,13,19
128,RED,P006436,P007960,0 days 00:06:57,-6,9,15
128,RED,P007960,P012044,0 days 00:06:29,1,10,9
128,RED,P008966,PJDR,0 days 00:06:02,-5,12,17
128,RED,P000848,P008966,0 days 00:06:02,-5,12,17
128,RED,P002553,P006436,0 days 00:05:52,-2,6,8
128,RED,P005099,PJDR,0 days 00:05:05,-4,6,10
128,RED,P006436,P012711,0 days 00:04:53,-7,8,15
128,RED,P012711,PJDR,0 days 00:04:48,-7,8,15
128,RED,P000848,P012711,0 days 00:04:48,-7,8,15
128,RED,P007960,P012711,0 days 00:04:24,-1,7,8
128,RED,P008966,P012711,0 days 00:04:11,-3,8,11
128,RED,P006436,P008966,0 days 00:04:11,-3,8,11
128,RED,P012044,P012711,0 days 00:03:47,3,7,4
128,RED,P005099,P012711,0 days 00:03:42,3,7,4
128,RED,P006436,P012044,0 days 00:03:16,-3,2,5
128,RED,P005099,P006436,0 days 00:02:45,-3,5,8
128,RED,P000848,P012044,0 days 00:02:42,-2,3,5
128,RED,P007960,PLUO,0 days 00:02:20,-1,1,2
128,RED,PJDR,PLUO,0 days 00:02:20,-1,1,2
128,RED,P006436,PLUO,0 days 00:02:19,0,0,0
128,RED,P009035,P012711,0 days 00:01:59,-2,2,4
128,RED,P004720,P012044,0 days 00:01:55,5,5,0
128,RED,P002553,P008966,0 days 00:01:51,-2,4,6
128,RED,P007960,P008966,0 days 00:01:51,-2,4,6
128,RED,P004720,P007960,0 days 00:01:48,5,5,0
128,RED,P004720,P012711,0 days 00:01:48,5,5,0
128,RED,P004720,P005099,0 days 00:01:43,5,5,0
128,RED,P012044,PJDR,0 days 00:00:52,-3,2,5
128,RED,P004720,P006436,0 days 00:00:12,0,0,0
128,RED,P004720,P009035,0 days 00:00:07,0,0,0
128,RED,P004720,PLUO,0 days 00:00:07,0,0,0
128,MAD,P003108,PTGB,0 days 00:20:51,18,44,26
128,MAD,P005928,P009213,0 days 00:19:02,-3,29,32
128,MAD,P005928,P006540,0 days 00:18:08,0,27,27
128,MAD,P005791,P005928,0 days 00:18:04,3,30,27
128,MAD,P005791,P009213,0 days 00:18:01,4,33,29
128,MAD,P004887,PTGB,0 days 00:17:31,10,34,24
128,MAD,P005791,P006540,0 days 00:17:27,0,27,27
128,MAD,P003108,P004887,0 days 00:17:06,14,34,20
128,MAD,P003108,PCVM,0 days 00:16:42,15,38,23
128,MAD,P003733,P004887,0 days 00:16:34,14,36,22
128,MAD,PCVM,PTGB,0 days 00:15:58,13,36,23
128,MAD,P003733,PTGB,0 days 00:15:57,12,34,22
128,MAD,P003733,PCVM,0 days 00:15:34,12,32,20
128,MAD,P006540,P009213,0 days 00:15:33,-1,24,25
128,MAD,P003108,P003733,0 days 00:15:32,16,34,18
128,MAD,P003108,P005928,0 days 00:15:08,12,26,14
128,MAD,P004887,PCVM,0 days 00:14:44,13,32,19
128,MAD,P003108,P005791,0 days 00:13:41,11,28,17
128,MAD,P003108,P006540,0 days 00:12:49,4,19,15
128,MAD,P003108,P009213,0 days 00:11:47,10,25,15
128,MAD,P001392,P009213,0 days 00:06:14,-6,8,14
128,MAD,P005928,PTGB,0 days 00:06:14,3,10,7
128,MAD,P001392,P005791,0 days 00:06:14,-6,8,14
128,MAD,P001392,P006540,0 days 00:06:14,-6,8,14
128,MAD,P001392,P005928,0 days 00:06:14,-6,8,14
128,MAD,P003733,P005928,0 days 00:05:24,-2,6,8
128,MAD,P005791,PTGB,0 days 00:04:22,6,12,6
128,MAD,P004887,P005928,0 days 00:04:20,1,6,5
128,MAD,P009213,PTGB,0 days 00:03:37,3,11,8
128,MAD,P009213,PCVM,0 days 00:03:34,-1,6,7
128,MAD,P006540,PTGB,0 days 00:03:30,-1,3,4
128,MAD,P003733,P009213,0 days 00:02:52,-5,2,7
128,MAD,P005928,PCVM,0 days 00:02:39,-1,2,3
128,MAD,P005791,PCVM,0 days 00:01:51,2,6,4
128,MAD,P011649,PCVM,0 days 00:01:43,-3,0,3
128,MAD,P003733,P011649,0 days 00:01:43,-3,0,3
128,MAD,P009213,P011649,0 days 00:01:43,-3,0,3
128,MAD,P005928,P011649,0 days 00:01:43,-3,0,3
128,MAD,P004887,P006540,0 days 00:01:36,-2,0,2
128,MAD,P004887,P009213,0 days 00:01:09,-2,2,4
128,MAD,P006540,PCVM,0 days 00:00:55,-2,0,2
129,TEL,P009622,P011971,0 days 00:22:24,3,47,44
129,TEL,P009622,P009783,0 days 00:22:07,9,46,37
129,TEL,P009783,P009863,0 days 00:20:20,14,46,32
129,TEL,P009622,P011199,0 days 00:18:34,1,37,36
129,TEL,P009863,P011971,0 days 00:18:13,20,51,31
129,TEL,P009622,P009863,0 days 00:17:55,9,41,32
129,TEL,P009783,P011199,0 days 00:17:52,5,37,32
129,TEL,P011193,P011971,0 days 00:16:20,5,42,37
129,TEL,P009863,P011199,0 days 00:15:42,7,33,26
129,TEL,P011219,P011971,0 days 00:15:21,11,46,35
129,TEL,P009783,P011971,0 days 00:14:53,17,35,18
129,TEL,P011193,P011219,0 days 00:14:34,7,40,33
129,TEL,P011193,P011214,0 days 00:13:46,-8,25,33
129,TEL,P011214,P011971,0 days 00:13:21,-8,23,31
129,TEL,P009622,P011193,0 days 00:12:31,-10,23,33
129,TEL,P009863,P011219,0 days 00:10:54,11,33,22
129,TEL,P009622,P011214,0 days 00:10:52,-6,19,25
129,TEL,P011199,P011971,0 days 00:10:27,5,20,15
129,TEL,P011214,P011219,0 days 00:10:15,-6,21,27
129,TEL,P009622,P011219,0 days 00:09:07,0,23,23
129,TEL,P009863,P011193,0 days 00:08:22,7,25,18
129,TEL,P009783,P011193,0 days 00:08:21,-1,16,17
129,TEL,P005145,P009783,0 days 00:07:35,2,17,15
129,TEL,P005145,P009622,0 days 00:07:35,2,17,15
129,TEL,P005145,P011199,0 days 00:07:35,2,17,15
129,TEL,P005145,P009863,0 days 00:06:23,0,13,13
129,TEL,P011971,P012744,0 days 00:05:49,3,16,13
129,TEL,P009783,P011214,0 days 00:05:30,-1,6,7
129,TEL,P011193,P012744,0 days 00:05:07,0,13,13
129,TEL,P009783,P011219,0 days 00:04:53,5,13,8
129,TEL,P009863,P011214,0 days 00:04:29,-4,6,10
129,TEL,P011219,P012744,0 days 00:04:13,8,16,8
129,TEL,P009863,P012744,0 days 00:04:06,8,16,8
129,TEL,P009622,P012744,0 days 00:03:43,-12,3,15
129,TEL,P011193,P011199,0 days 00:02:47,-6,4,10
129,TEL,P011199,P012744,0 days 00:02:21,-8,0,8
129,TEL,P011214,P012744,0 days 00:01:36,-5,0,5
129,TEL,P011199,P011214,0 days 00:01:35,-2,0,2
129,TEL,P009783,P012744,0 days 00:01:13,-6,0,6
129,TEL,P005145,P011193,0 days 00:01:12,2,4,2
129,TEL,P011199,P011219,0 days 00:00:07,0,0,0
129,BAS,P004761,P007230,0 days 00:28:28,-3,56,59
129,BAS,P004761,P009048,0 days 00:27:32,-5,51,56
129,BAS,P007230,P009048,0 days 00:24:19,-12,42,54
129,BAS,P009048,P011948,0 days 00:19:19,-6,39,45
129,BAS,P009048,P012201,0 days 00:19:02,-5,38,43
129,BAS,P004603,P004761,0 days 00:18:45,9,46,37
129,BAS,P004761,P011948,0 days 00:18:25,4,40,36
129,BAS,P004761,P012201,0 days 00:16:53,13,40,27
129,BAS,P007230,P011948,0 days 00:16:48,-5,33,38
129,BAS,P004603,P007230,0 days 00:16:10,1,36,35
129,BAS,P004603,P009048,0 days 00:15:33,-2,32,34
129,BAS,P011948,P012201,0 days 00:15:03,-4,32,36
129,BAS,P007230,P012201,0 days 00:13:40,6,31,25
129,BAS,P004761,P012765,0 days 00:12:30,5,29,24
129,BAS,P007230,P012765,0 days 00:11:36,8,30,22
129,BAS,P004603,P011948,0 days 00:10:10,5,26,21
129,BAS,P012201,P012765,0 days 00:09:47,7,24,17
129,BAS,P008072,P009048,0 days 00:09:23,-14,13,27
129,BAS,P004603,P012201,0 days 00:08:25,11,25,14
129,BAS,P008072,P011948,0 days 00:08:02,-11,12,23
129,BAS,P004603,P012765,0 days 00:06:49,6,19,13
129,BAS,P004761,P008072,0 days 00:06:30,-6,9,15
129,BAS,P009048,P012765,0 days 00:06:20,-1,12,13
129,BAS,P003198,P004761,0 days 00:05:40,-7,9,16
129,BAS,P003198,P009048,0 days 00:05:40,-7,9,16
129,BAS,P003198,P007230,0 days 00:05:40,-7,9,16
129,BAS,P003198,P004603,0 days 00:05:40,-7,9,16
129,BAS,P009048,P011085,0 days 00:05:24,-8,8,16
129,BAS,P011948,P012765,0 days 00:05:24,1,14,13
129,BAS,P007230,P008072,0 days 00:05:10,-6,7,13
129,BAS,P008072,P011085,0 days 00:04:14,-11,5,16
129,BAS,P008072,P012201,0 days 00:04:13,-8,6,14
129,BAS,P011085,P011948,0 days 00:02:53,-8,4,12
129,BAS,P011085,P012201,0 days 00:02:53,-8,4,12
129,BAS,P004761,P011085,0 days 00:02:53,-2,4,6
129,BAS,P007230,P011085,0 days 00:02:53,-2,4,6
129,BAS,P004603,P011085,0 days 00:01:32,1,3,2
129,BAS,P011085,P012765,0 days 00:00:22,-2,0,2
130,PAM,P007870,P010568,0 days 00:23:46,2,47,45
130,PAM,P003960,P010568,0 days 00:23:17,-14,35,49
130,PAM,P003960,P007870,0 days 00:18:10,-10,29,39
130,PAM,P000556,P003960,0 days 00:15:14,-9,19,28
130,PAM,P000556,P010568,0 days 00:15:14,-9,19,28
130,PAM,P006643,P007870,0 days 00:14:55,2,27,25
130,PAM,P007870,P012740,0 days 00:13:16,9,33,24
130,PAM,P007870,P010393,0 days 00:12:44,11,28,17
130,PAM,P004863,P007870,0 days 00:12:29,-1,20,21
130,PAM,P000556,P007870,0 days 00:11:35,-9,14,23
130,PAM,P004863,P012740,0 days 00:11:35,-5,17,22
130,PAM,P006643,P010568,0 days 00:11:19,0,22,22
130,PAM,P010393,P012740,0 days 00:10:06,13,25,12
130,PAM,P010568,P012740,0 days 00:09:26,14,30,16
130,PAM,P004863,P010568,0 days 00:09:17,-6,15,21
130,PAM,P005356,P012739,0 days 00:08:43,4,13,9
130,PAM,P005356,P010568,0 days 00:08:39,3,13,10
130,PAM,P010393,P010568,0 days 00:08:28,16,25,9
130,PAM,P004863,P006643,0 days 00:08:26,-5,11,16
130,PAM,P006643,P010393,0 days 00:08:12,6,16,10
130,PAM,P003960,P004863,0 days 00:07:52,-10,11,21
130,PAM,P003960,P006643,0 days 00:07:32,-9,9,18
130,PAM,P006643,P012740,0 days 00:07:31,5,17,12
130,PAM,P005356,P012740,0 days 00:07:17,4,13,9
130,PAM,P012738,P012740,0 days 00:07:17,-2,10,12
130,PAM,P004863,P012739,0 days 00:06:41,-11,6,17
130,PAM,P004863,P010393,0 days 00:06:24,0,8,8
130,PAM,P010568,P012739,0 days 00:06:21,-1,9,10
130,PAM,P012739,P012740,0 days 00:05:56,1,8,7
130,PAM,P000556,P006643,0 days 00:05:49,-6,8,14
130,PAM,P003960,P005356,0 days 00:05:36,-3,5,8
130,PAM,P000556,P005356,0 days 00:05:25,-3,5,8
130,PAM,P012738,P012739,0 days 00:05:15,-4,5,9
130,PAM,P003960,P012739,0 days 00:05:07,-4,6,10
130,PAM,P004863,P012738,0 days 00:04:49,-4,5,9
130,PAM,P000556,P004863,0 days 00:04:42,-4,6,10
130,PAM,P005356,P012738,0 days 00:04:40,-2,5,7
130,PAM,P004863,P005356,0 days 00:04:25,-2,5,7
130,PAM,P000556,P012739,0 days 00:04:14,-2,5,7
130,PAM,P005356,P007870,0 days 00:04:10,-3,5,8
130,PAM,P003960,P012740,0 days 00:03:56,1,11,10
130,PAM,P003960,P010393,0 days 00:02:43,2,7,5
130,PAM,P005356,P010393,0 days 00:02:37,6,8,2
130,PAM,P010568,P012738,0 days 00:02:35,0,5,5
130,PAM,P007870,P012738,0 days 00:02:09,0,5,5
130,PAM,P008780,P010568,0 days 00:02:06,-1,4,5
130,PAM,P008780,P010393,0 days 00:02:06,-1,4,5
130,PAM,P007870,P008780,0 days 00:02:06,-1,4,5
130,PAM,P003960,P008780,0 days 00:02:06,-1,4,5
130,PAM,P003960,P012738,0 days 00:01:35,1,4,3
130,PAM,P006643,P012739,0 days 00:01:35,-6,1,7
130,PAM,P010393,P012739,0 days 00:00:48,3,3,0
130,PAM,P006643,P012738,0 days 00:00:41,-3,1,4
130,PAM,P000556,P012738,0 days 00:00:35,-2,0,2
130,PAM,P000556,P012740,0 days 00:00:28,0,0,0
130,PAR,P008987,P009862,0 days 00:30:42,6,56,50
130,PAR,P007400,P009862,0 days 00:24:58,2,43,41
130,PAR,P008987,P012742,0 days 00:22:49,16,46,30
130,PAR,P008987,P011051,0 days 00:22:44,7,44,37
130,PAR,P007400,P008987,0 days 00:22:43,4,44,40
130,PAR,P009862,P012742,0 days 00:21:50,15,41,26
130,PAR,P009862,P011051,0 days 00:21:18,6,39,33
130,PAR,P007400,P012742,0 days 00:16:51,12,34,22
130,PAR,P011051,P012742,0 days 00:15:50,7,31,24
130,PAR,P007400,P011051,0 days 00:13:19,4,27,23
130,PAR,P008987,P012096,0 days 00:12:13,7,25,18
130,PAR,P009862,P012096,0 days 00:12:13,7,25,18
130,PAR,P012096,P012742,0 days 00:11:23,11,25,14
130,PAR,P007400,P012743,0 days 00:11:14,-6,15,21
130,PAR,P004172,P012743,0 days 00:11:06,-2,16,18
130,PAR,P009862,P012743,0 days 00:10:17,-5,13,18
130,PAR,P004172,P007400,0 days 00:09:18,-1,16,17
130,PAR,P009212,P012743,0 days 00:07:52,-2,11,13
130,PAR,P004172,P009212,0 days 00:07:52,-2,11,13
130,PAR,P007400,P009212,0 days 00:07:52,-2,11,13
130,PAR,P004172,P009862,0 days 00:07:08,-2,9,11
130,PAR,P008987,P012743,0 days 00:06:36,-4,9,13
130,PAR,P011051,P012096,0 days 00:06:11,3,12,9
130,PAR,P007400,P012096,0 days 00:06:02,4,13,9
130,PAR,P000956,P007400,0 days 00:05:15,-5,10,15
130,PAR,P000956,P008987,0 days 00:05:15,-5,10,15
130,PAR,P004172,P008987,0 days 00:04:53,0,10,10
130,PAR,P004172,P011051,0 days 00:04:53,0,10,10
130,PAR,P004058,P007400,0 days 00:04:48,-4,7,11
130,PAR,P000956,P009862,0 days 00:04:48,-5,10,15
130,PAR,P004058,P009212,0 days 00:04:11,-1,7,8
130,PAR,P004058,P012743,0 days 00:04:11,-1,7,8
130,PAR,P004058,P004172,0 days 00:04:11,-1,7,8
130,PAR,P009212,P009862,0 days 00:03:41,-1,4,5
130,PAR,P000956,P011051,0 days 00:03:27,1,8,7
130,PAR,P011051,P012743,0 days 00:03:14,0,5,5
130,PAR,P000956,P012743,0 days 00:01:48,-6,2,8
130,PAR,P012742,P012743,0 days 00:01:34,2,2,0
130,PAR,P004172,P012742,0 days 00:00:59,1,5,4
130,PAR,P004058,P008987,0 days 00:00:37,-3,0,3
130,PAR,P004058,P009862,0 days 00:00:37,-3,0,3
130,PAR,P004058,P012096,0 days 00:00:37,-3,0,3
130,PAR,P000956,P004172,0 days 00:00:27,0,0,0
130,PAR,P004172,P012096,0 days 00:00:13,-1,0,1
131,VIR,P001133,P009549,0 days 00:26:23,5,47,42
131,VIR,P001844,P009549,0 days 00:20:13,3,33,30
131,VIR,P001133,P001844,0 days 00:19:53,-1,29,30
131,VIR,P009549,PBCN,0 days 00:19:08,4,34,30
131,VIR,P001133,PBCN,0 days 00:18:47,3,35,32
131,VIR,P001844,P003048,0 days 00:17:32,2,32,30
131,VIR,P003048,P009549,0 days 00:16:39,-1,25,26
131,VIR,P001133,P003048,0 days 00:14:19,-5,21,26
131,VIR,P001844,P004007,0 days 00:12:39,9,24,15
131,VIR,P003048,P004007,0 days 00:11:47,7,25,18
131,VIR,P006739,PBCN,0 days 00:10:43,1,21,20
131,VIR,P001844,PBCN,0 days 00:10:41,-2,16,18
131,VIR,P001133,P012714,0 days 00:10:34,9,24,15
131,VIR,P003048,P010781,0 days 00:10:31,-7,16,23
131,VIR,P003048,PBCN,0 days 00:10:23,-11,12,23
131,VIR,P001133,P006739,0 days 00:09:46,4,22,18
131,VIR,P001133,P004007,0 days 00:09:29,1,15,14
131,VIR,P004007,P010781,0 days 00:09:01,-2,15,17
131,VIR,P006739,P009549,0 days 00:08:30,6,18,12
131,VIR,P009549,P012714,0 days 00:07:51,10,21,11
131,VIR,P004007,P009549,0 days 00:07:36,7,15,8
131,VIR,P001844,P010781,0 days 00:07:30,0,11,11
131,VIR,P001844,P003527,0 days 00:07:21,4,13,9
131,VIR,P003048,P006739,0 days 00:07:08,-8,7,15
131,VIR,P006739,P012714,0 days 00:06:53,5,17,12
131,VIR,P012714,PBCN,0 days 00:06:15,11,19,8
131,VIR,P003527,P004007,0 days 00:05:56,5,14,9
131,VIR,P006739,P010781,0 days 00:05:44,-8,8,16
131,VIR,P003048,P003527,0 days 00:05:26,6,13,7
131,VIR,P001133,P010781,0 days 00:05:10,-3,5,8
131,VIR,P002084,P003048,0 days 00:04:55,-7,5,12
131,VIR,P002084,P006739,0 days 00:04:55,-7,5,12
131,VIR,P004007,P006739,0 days 00:04:31,-5,7,12
131,VIR,P004007,P012714,0 days 00:04:19,-2,5,7
131,VIR,P002084,PBCN,0 days 00:04:11,-3,5,8
131,VIR,P003527,P010781,0 days 00:04:03,2,9,7
131,VIR,P002084,P010781,0 days 00:04:01,-7,5,12
131,VIR,P001844,P012714,0 days 00:03:41,4,7,3
131,VIR,P003527,P009549,0 days 00:03:34,3,6,3
131,VIR,P010781,P012714,0 days 00:02:43,-1,3,4
131,VIR,P003527,PBCN,0 days 00:02:41,-2,3,5
131,VIR,P001133,P003527,0 days 00:02:41,-2,3,5
131,VIR,P009549,P010781,0 days 00:02:30,-2,2,4
131,VIR,P002084,P009549,0 days 00:02:28,1,3,2
131,VIR,P002084,P004007,0 days 00:02:18,-3,3,6
131,VIR,P010781,PBCN,0 days 00:01:43,-4,2,6
131,VIR,P001133,P002084,0 days 00:01:34,1,3,2
131,VIR,P001844,P002084,0 days 00:01:34,1,3,2
131,VIR,P004007,PBCN,0 days 00:01:04,-1,1,2
131,VIR,P003527,P006739,0 days 00:00:46,0,3,3
131,OLY,P008829,P010612,0 days 00:20:43,-3,36,39
131,OLY,P001255,P008829,0 days 00:20:00,-2,34,36
131,OLY,P001255,P010612,0 days 00:20:00,-2,34,36
131,OLY,P003941,P007982,0 days 00:18:34,0,31,31
131,OLY,P003941,P008829,0 days 00:16:38,-3,24,27
131,OLY,P007982,P008829,0 days 00:15:54,-1,21,22
131,OLY,P008829,P008855,0 days 00:15:43,-5,26,31
131,OLY,P008811,P008855,0 days 00:15:13,2,27,25
131,OLY,P008855,P010612,0 days 00:12:06,-2,24,26
131,OLY,P007982,P010392,0 days 00:12:00,-1,21,22
131,OLY,P008811,P008829,0 days 00:11:39,0,21,21
131,OLY,P001255,P003941,0 days 00:11:24,-5,17,22
131,OLY,P003941,P010612,0 days 00:11:24,-5,17,22
131,OLY,P001255,P008855,0 days 00:11:23,-1,22,23
131,OLY,P003941,P010392,0 days 00:11:14,1,19,18
131,OLY,P010392,P011983,0 days 00:10:08,7,21,14
131,OLY,P003941,P008855,0 days 00:09:47,-10,12,22
131,OLY,P011194,P011983,0 days 00:09:26,6,19,13
131,OLY,P008855,P010392,0 days 00:09:22,-8,10,18
131,OLY,P008811,P010612,0 days 00:09:19,2,19,17
131,OLY,P008855,P011194,0 days 00:09:17,-3,13,16
131,OLY,P001255,P007982,0 days 00:08:37,-1,12,13
131,OLY,P007982,P010612,0 days 00:08:37,-1,12,13
131,OLY,P001255,P008811,0 days 00:08:36,3,17,14
131,OLY,P010392,P011194,0 days 00:08:11,-1,17,18
131,OLY,P008855,P011983,0 days 00:08:00,1,12,11
131,OLY,P008811,P011983,0 days 00:07:38,-3,12,15
131,OLY,P008829,P010392,0 days 00:07:34,0,9,9
131,OLY,P003941,P011983,0 days 00:06:45,11,16,5
131,OLY,P003941,P011194,0 days 00:06:37,1,14,13
131,OLY,P007982,P011983,0 days 00:06:23,7,16,9
131,OLY,P007982,P008855,0 days 00:05:37,-8,5,13
131,OLY,P008811,P011194,0 days 00:05:06,0,8,8
131,OLY,P008829,P011983,0 days 00:04:57,2,9,7
131,OLY,P007982,P011194,0 days 00:04:43,-1,12,13
131,OLY,P008811,P010392,0 days 00:04:31,-2,7,9
131,OLY,P007853,P011983,0 days 00:03:32,2,5,3
131,OLY,P007853,P011194,0 days 00:03:32,2,5,3
131,OLY,P007853,P008855,0 days 00:03:32,2,5,3
131,OLY,P007853,P008811,0 days 00:02:55,0,3,3
131,OLY,P007982,P008811,0 days 00:02:03,-2,2,4
131,OLY,P010612,P011983,0 days 00:00:43,-1,2,3
131,OLY,P003941,P007853,0 days 00:00:37,2,2,0
132,MCO,P010588,P011226,0 days 00:25:37,-11,52,63
132,MCO,P005985,P010588,0 days 00:22:28,-9,46,55
132,MCO,P005985,P011226,0 days 00:21:59,-10,45,55
132,MCO,P010588,PLCZ,0 days 00:20:31,-6,40,46
132,MCO,P005985,PLCZ,0 days 00:19:49,-6,40,46
132,MCO,P011226,PLCZ,0 days 00:19:45,-6,38,44
132,MCO,P004197,P010588,0 days 00:17:55,-8,31,39
132,MCO,P011196,P011212,0 days 00:16:50,8,44,36
132,MCO,P004197,P005985,0 days 00:16:26,-10,29,39
132,MCO,P004197,P011226,0 days 00:16:22,-11,26,37
132,MCO,P011212,P011226,0 days 00:16:21,9,43,34
132,MCO,P005985,P011212,0 days 00:16:10,2,44,42
132,MCO,P011212,P012709,0 days 00:14:41,8,38,30
132,MCO,P011196,P012709,0 days 00:14:41,8,38,30
132,MCO,P004197,PLCZ,0 days 00:14:26,-4,24,28
132,MCO,P004790,P011212,0 days 00:13:37,10,36,26
132,MCO,P004790,P011196,0 days 00:12:50,7,33,26
132,MCO,P010588,P011212,0 days 00:12:26,3,33,30
132,MCO,P004790,P012709,0 days 00:11:37,7,29,22
132,MCO,P011196,P011226,0 days 00:11:14,3,28,25
132,MCO,P005985,P011196,0 days 00:10:12,-7,24,31
132,MCO,P004790,P005985,0 days 00:09:13,3,25,22
132,MCO,P011212,PLCZ,0 days 00:07:33,-2,18,20
132,MCO,P011226,P012709,0 days 00:07:28,8,20,12
132,MCO,P005985,P012709,0 days 00:07:13,0,18,18
132,MCO,P010588,P011196,0 days 00:05:46,-6,13,19
132,MCO,P004790,P011226,0 days 00:05:28,9,15,6
132,MCO,P004197,P011212,0 days 00:03:20,1,7,6
132,MCO,P010588,P012709,0 days 00:03:04,1,9,8
132,MCO,P004197,P011196,0 days 00:02:51,-9,4,13
132,MCO,P004197,P004790,0 days 00:00:56,1,3,2
132,MCO,P004790,P010588,0 days 00:00:47,3,3,0
132,MCO,P005985,P011231,0 days 00:00:06,1,1,0
132,MCO,P010588,P011231,0 days 00:00:06,1,1,0
132,MCO,P011212,P011231,0 days 00:00:06,1,1,0
132,MCO,P011226,P011231,0 days 00:00:06,1,1,0
132,PAN,P001926,P007866,0 days 00:22:46,3,50,47
132,PAN,P001926,P003842,0 days 00:21:27,19,60,41
132,PAN,P002328,P007866,0 days 00:19:47,6,42,36
132,PAN,P001926,P002328,0 days 00:18:18,14,49,35
132,PAN,P001926,P011204,0 days 00:17:55,3,40,37
132,PAN,P002328,P003842,0 days 00:17:08,4,41,37
132,PAN,P003842,P007866,0 days 00:16:39,-3,33,36
132,PAN,P001926,P007947,0 days 00:15:58,12,43,31
132,PAN,P003842,P011204,0 days 00:15:49,-2,32,34
132,PAN,P007866,P011204,0 days 00:15:46,3,36,33
132,PAN,P003842,P012774,0 days 00:15:45,-4,37,41
132,PAN,P007866,P007947,0 days 00:15:01,-9,26,35
132,PAN,P003842,P007947,0 days 00:14:59,-1,35,36
132,PAN,P007947,P012774,0 days 00:14:02,-4,31,35
132,PAN,P012712,P012774,0 days 00:12:50,3,34,31
132,PAN,P002328,P007947,0 days 00:11:52,-3,25,28
132,PAN,P001926,P012774,0 days 00:11:37,9,35,26
132,PAN,P003842,P012712,0 days 00:11:01,3,30,27
132,PAN,P002328,P012774,0 days 00:10:21,-2,24,26
132,PAN,P002328,P011204,0 days 00:09:21,9,25,16
132,PAN,P007947,P012712,0 days 00:08:59,2,24,22
132,PAN,P001926,P012712,0 days 00:08:08,9,26,17
132,PAN,P007947,P011204,0 days 00:08:06,-8,13,21
132,PAN,P002328,P011221,0 days 00:07:05,0,14,14
132,PAN,P007866,P012774,0 days 00:06:49,-13,8,21
132,PAN,P011204,P012774,0 days 00:05:18,-9,9,18
132,PAN,P001926,P011221,0 days 00:05:16,0,10,10
132,PAN,P007947,P011221,0 days 00:05:14,1,12,11
132,PAN,P007866,P011221,0 days 00:05:13,2,10,8
132,PAN,P011204,P012712,0 days 00:04:30,-7,6,13
132,PAN,P001926,P007553,0 days 00:04:19,-5,7,12
132,PAN,P007553,P011204,0 days 00:04:19,-5,7,12
132,PAN,P007553,P007866,0 days 00:04:19,-5,7,12
132,PAN,P002328,P012712,0 days 00:04:12,-4,12,16
132,PAN,P007553,P007947,0 days 00:03:57,-2,7,9
132,PAN,P011221,P012774,0 days 00:03:40,-1,6,7
132,PAN,P011221,P012712,0 days 00:01:52,-2,4,6
132,PAN,P007553,P012774,0 days 00:00:22,-3,0,3
133,MIL,P005670,P007831,0 days 00:19:45,9,37,28
133,MIL,P007201,P007831,0 days 00:19:45,22,48,26
133,MIL,P007831,P011205,0 days 00:19:00,23,51,28
133,MIL,P002849,P007831,0 days 00:18:51,14,41,27
133,MIL,P005670,P007201,0 days 00:17:40,13,37,24
133,MIL,P002849,P005670,0 days 00:17:33,5,32,27
133,MIL,P002849,P011205,0 days 00:15:08,12,36,24
133,MIL,P007201,P011205,0 days 00:15:02,26,44,18
133,MIL,P002849,P007201,0 days 00:14:36,12,32,20
133,MIL,P005670,P011205,0 days 00:14:22,12,32,20
133,MIL,P002812,P011205,0 days 00:13:06,11,31,20
133,MIL,P005775,P011205,0 days 00:11:46,0,23,23
133,MIL,P006509,P011205,0 days 00:11:05,7,26,19
133,MIL,P002812,P006509,0 days 00:10:33,9,25,16
133,MIL,P005775,P006509,0 days 00:10:13,1,18,17
133,MIL,P006509,P007831,0 days 00:09:38,2,16,14
133,MIL,P002812,P005775,0 days 00:09:18,5,19,14
133,MIL,P002812,P007831,0 days 00:09:00,6,21,15
133,MIL,P009960,P011205,0 days 00:07:46,-1,16,17
133,MIL,P005775,P009960,0 days 00:07:45,-3,15,18
133,MIL,P005775,P007831,0 days 00:07:19,6,20,14
133,MIL,P007831,P009960,0 days 00:07:18,1,14,13
133,MIL,P005775,P011926,0 days 00:07:13,1,11,10
133,MIL,P002849,P006509,0 days 00:07:02,-6,5,11
133,MIL,P002849,P005775,0 days 00:06:50,-1,15,16
133,MIL,P006509,P009960,0 days 00:06:49,-5,9,14
133,MIL,P006509,P007201,0 days 00:06:20,9,16,7
133,MIL,P002812,P007201,0 days 00:06:18,15,21,6
133,MIL,P002812,P009960,0 days 00:06:03,-5,9,14
133,MIL,P005670,P005775,0 days 00:05:58,3,13,10
133,MIL,P011205,P011926,0 days 00:05:36,-4,7,11
133,MIL,P006509,P011926,0 days 00:04:36,-3,5,8
133,MIL,P002849,P009960,0 days 00:04:32,2,9,7
133,MIL,P005670,P006509,0 days 00:04:24,-6,0,6
133,MIL,P005775,P007201,0 days 00:04:10,8,14,6
133,MIL,P005670,P011926,0 days 00:03:50,3,8,5
133,MIL,P002812,P005670,0 days 00:03:29,3,7,4
133,MIL,P006701,P011926,0 days 00:03:15,6,8,2
133,MIL,P005670,P006701,0 days 00:03:15,6,8,2
133,MIL,P002812,P011926,0 days 00:02:56,2,5,3
133,MIL,P006721,P011926,0 days 00:02:50,4,6,2
133,MIL,P006701,P006721,0 days 00:02:50,4,6,2
133,MIL,P005775,P006721,0 days 00:02:50,4,6,2
133,MIL,P005775,P006701,0 days 00:02:50,4,6,2
133,MIL,P005670,P006721,0 days 00:02:50,4,6,2
133,MIL,P002849,P011926,0 days 00:02:40,-6,2,8
133,MIL,P005670,P009960,0 days 00:02:22,-4,0,4
133,MIL,P007831,P011926,0 days 00:00:48,-3,0,3
133,MIL,P002812,P006701,0 days 00:00:25,2,2,0
133,MIL,P006701,P011205,0 days 00:00:25,2,2,0
133,MIL,P007201,P009960,0 days 00:00:05,-1,0,1
133,ASV,P004194,P011225,0 days 00:24:07,-27,32,59
133,ASV,P004194,P012080,0 days 00:20:19,-21,28,49
133,ASV,P011225,P012080,0 days 00:19:13,-15,28,43
133,ASV,P006568,P011225,0 days 00:16:49,-15,26,41
133,ASV,P004194,P006568,0 days 00:15:56,-18,23,41
133,ASV,P003526,P012080,0 days 00:15:50,-10,22,32
133,ASV,P000229,P012730,0 days 00:15:29,-2,28,30
133,ASV,P003526,P011225,0 days 00:15:25,-17,19,36
133,ASV,P012729,P012730,0 days 00:14:34,5,26,21
133,ASV,P000229,P012729,0 days 00:13:58,8,26,18
133,ASV,P006568,P012080,0 days 00:13:52,-10,21,31
133,ASV,P003526,P004194,0 days 00:13:32,-19,16,35
133,ASV,P003526,P006568,0 days 00:12:12,-19,16,35
133,ASV,P012080,P012730,0 days 00:12:08,-10,16,26
133,ASV,P011225,PKIR,0 days 00:12:06,-10,16,26
133,ASV,P004194,PKIR,0 days 00:11:55,-15,16,31
133,ASV,P012730,PKIR,0 days 00:11:32,-13,15,28
133,ASV,P012729,PKIR,0 days 00:11:23,-1,17,18
133,ASV,P003526,P012730,0 days 00:11:21,7,19,12
133,ASV,P012080,PKIR,0 days 00:11:15,-10,19,29
133,ASV,P000229,PKIR,0 days 00:10:46,-8,15,23
133,ASV,P012080,P012729,0 days 00:10:45,-5,17,22
133,ASV,P003526,P012729,0 days 00:10:01,7,19,12
133,ASV,P000229,P012080,0 days 00:08:59,-7,13,20
133,ASV,P000229,P003526,0 days 00:08:08,5,16,11
133,ASV,P011225,P012730,0 days 00:07:10,-3,10,13
133,ASV,P011225,P012729,0 days 00:07:04,3,12,9
133,ASV,P004194,P012730,0 days 00:06:01,-13,5,18
133,ASV,P003526,PKIR,0 days 00:05:57,0,8,8
133,ASV,P006568,PKIR,0 days 00:05:14,1,10,9
133,ASV,P000229,P011225,0 days 00:04:05,1,7,6
133,ASV,P004194,P012729,0 days 00:03:56,-4,4,8
133,ASV,P000229,P004194,0 days 00:03:56,-10,2,12
133,ASV,P002100,P011225,0 days 00:03:01,3,10,7
133,ASV,P002100,P012729,0 days 00:02:18,8,8,0
133,ASV,P002100,P006568,0 days 00:02:03,-2,5,7
133,ASV,P002100,P003526,0 days 00:01:46,-2,5,7
133,ASV,P000229,P002100,0 days 00:01:42,5,5,0
133,ASV,P002100,P012730,0 days 00:01:25,5,5,0
133,ASV,P002100,P004194,0 days 00:01:10,-5,2,7
133,ASV,P006568,P012729,0 days 00:00:53,3,3,0
133,ASV,P002100,P012080,0 days 00:00:27,0,0,0
133,ASV,P000229,P006568,0 days 00:00:17,0,0,0
134,MUN,P003583,P006760,0 days 00:21:45,15,45,30
134,MUN,P007056,P008985,0 days 00:19:30,7,35,28
134,MUN,P007056,P011987,0 days 00:18:39,0,34,34
134,MUN,P008985,P011987,0 days 00:17:35,10,36,26
134,MUN,P003583,P008985,0 days 00:17:28,13,33,20
134,MUN,P006760,P007056,0 days 00:16:39,4,28,24
134,MUN,P003583,P007056,0 days 00:16:10,4,28,24
134,MUN,P006760,P008985,0 days 00:15:28,8,28,20
134,MUN,P003583,P011987,0 days 00:15:26,13,35,22
134,MUN,P006760,P011987,0 days 00:15:26,8,30,22
134,MUN,P001288,P007975,0 days 00:12:38,12,35,23
134,MUN,P004508,P007975,0 days 00:12:32,-5,28,33
134,MUN,P007056,P010391,0 days 00:10:45,-2,20,22
134,MUN,P003583,P007975,0 days 00:09:48,9,28,19
134,MUN,P001288,P004508,0 days 00:09:22,2,23,21
134,MUN,P008985,P010391,0 days 00:09:20,12,22,10
134,MUN,P003583,P004508,0 days 00:08:46,4,19,15
134,MUN,P006760,P007975,0 days 00:07:41,7,17,10
134,MUN,P001288,P003583,0 days 00:07:04,15,23,8
134,MUN,P010391,P011987,0 days 00:06:42,9,21,12
134,MUN,P007056,P007975,0 days 00:06:38,-9,14,23
134,MUN,P001288,P006760,0 days 00:06:30,11,17,6
134,MUN,P003583,P010391,0 days 00:06:26,12,17,5
134,MUN,P001557,P007975,0 days 00:06:03,-3,15,18
134,MUN,P007975,P011987,0 days 00:05:29,8,18,10
134,MUN,P001288,P001557,0 days 00:05:23,1,15,14
134,MUN,P001557,P004508,0 days 00:05:21,-1,15,16
134,MUN,P006543,P010391,0 days 00:05:19,4,13,9
134,MUN,P007975,P010391,0 days 00:05:15,-1,14,15
134,MUN,P005460,P011987,0 days 00:05:12,4,10,6
134,MUN,P005460,P007975,0 days 00:05:11,-7,7,14
134,MUN,P005460,P010391,0 days 00:04:43,1,10,9
134,MUN,P005460,P007056,0 days 00:04:43,1,10,9
134,MUN,P004508,P006760,0 days 00:04:10,2,8,6
134,MUN,P004508,P010391,0 days 00:04:06,-6,5,11
134,MUN,P003583,P006543,0 days 00:04:02,3,10,7
134,MUN,P004508,P007056,0 days 00:03:56,-7,8,15
134,MUN,P001288,P011987,0 days 00:03:46,8,12,4
134,MUN,P006760,P010391,0 days 00:03:33,5,7,2
134,MUN,P006543,P008985,0 days 00:03:28,2,8,6
134,MUN,P001288,P007056,0 days 00:03:18,-4,8,12
134,MUN,P004508,P006543,0 days 00:03:07,-2,5,7
134,MUN,P001288,P005460,0 days 00:02:32,-4,1,5
134,MUN,P006543,P007975,0 days 00:02:31,-2,5,7
134,MUN,P006543,P011987,0 days 00:02:23,2,8,6
134,MUN,P001557,P007056,0 days 00:02:17,1,8,7
134,MUN,P001557,P003583,0 days 00:02:09,0,6,6
134,MUN,P005460,P008985,0 days 00:02:04,4,4,0
134,MUN,P004508,P005460,0 days 00:02:03,-7,1,8
134,MUN,P006543,P007056,0 days 00:01:57,-3,3,6
134,MUN,P001557,P005460,0 days 00:01:37,-4,1,5
134,MUN,P001288,P010391,0 days 00:01:15,-2,3,5
134,MUN,P004508,P008985,0 days 00:01:05,0,0,0
134,MUN,P005460,P006760,0 days 00:00:55,0,0,0
134,MUN,P001288,P008985,0 days 00:00:44,1,3,2
134,MUN,P001557,P011987,0 days 00:00:42,-2,0,2
134,MUN,P001557,P006543,0 days 00:00:40,-4,0,4
134,MUN,P006543,P006760,0 days 00:00:29,0,0,0
134,MUN,P007975,P008985,0 days 00:00:14,3,3,0
134,IST,P007200,P012786,0 days 00:28:54,-9,49,58
134,IST,P007200,P011981,0 days 00:24:06,-6,45,51
134,IST,P011078,P012786,0 days 00:23:44,-1,42,43
134,IST,P009846,P012786,0 days 00:23:04,-7,46,53
134,IST,P012786,P012788,0 days 00:22:31,7,46,39
134,IST,P007200,P011078,0 days 00:21:40,-6,38,44
134,IST,P007200,P012788,0 days 00:21:22,-3,42,45
134,IST,P011981,P012786,0 days 00:19:42,-2,36,38
134,IST,P007200,P009846,0 days 00:19:35,-13,35,48
134,IST,P011078,P012788,0 days 00:18:47,-2,37,39
134,IST,P009846,P012788,0 days 00:17:57,5,44,39
134,IST,P011078,P011981,0 days 00:15:35,-4,27,31
134,IST,P011981,P012788,0 days 00:14:15,1,31,30
134,IST,P009846,P011078,0 days 00:14:09,-7,28,35
134,IST,P009846,P011981,0 days 00:13:03,-13,22,35
134,IST,P009513,P012786,0 days 00:10:24,-12,12,24
134,IST,P010516,P012786,0 days 00:10:23,-3,15,18
134,IST,P007200,P009513,0 days 00:09:59,-13,14,27
134,IST,P010516,P012788,0 days 00:09:41,1,18,17
134,IST,P010516,P011078,0 days 00:09:34,-2,18,20
134,IST,P009513,P011078,0 days 00:09:04,-5,14,19
134,IST,P009513,P011981,0 days 00:08:35,-11,14,25
134,IST,P009846,P010516,0 days 00:07:01,1,15,14
134,IST,P007200,P010516,0 days 00:05:45,-2,7,9
134,IST,P009513,P012788,0 days 00:04:03,-9,2,11
134,IST,P004554,P009846,0 days 00:02:46,-5,2,7
134,IST,P004554,P010516,0 days 00:02:46,-5,2,7
134,IST,P004554,P012786,0 days 00:02:46,-5,2,7
134,IST,P009513,P010516,0 days 00:02:34,-5,0,5
134,IST,P010516,P011981,0 days 00:02:04,-1,5,6
134,IST,P004554,P007200,0 days 00:01:51,0,2,2
134,IST,P009513,P009846,0 days 00:01:25,-9,0,9
134,IST,P004554,P011078,0 days 00:00:55,-5,0,5
135,ULK,P006661,P008962,0 days 00:26:20,14,59,45
135,ULK,P006661,P011157,0 days 00:23:21,20,55,35
135,ULK,P008962,P011157,0 days 00:23:04,20,54,34
135,ULK,P004004,P009849,0 days 00:21:01,5,44,39
135,ULK,P001932,P008962,0 days 00:20:22,-5,38,43
135,ULK,P008962,P010560,0 days 00:19:19,-10,31,41
135,ULK,P006661,P010560,0 days 00:17:38,-5,29,34
135,ULK,P001932,P010560,0 days 00:17:23,-4,31,35
135,ULK,P010560,P011157,0 days 00:16:05,-5,28,33
135,ULK,P001932,P006661,0 days 00:15:57,0,31,31
135,ULK,P008962,P009849,0 days 00:15:28,8,37,29
135,ULK,P004004,P008962,0 days 00:14:52,11,38,27
135,ULK,P001932,P011157,0 days 00:14:27,0,26,26
135,ULK,P004004,P006661,0 days 00:13:06,17,36,19
135,ULK,P009849,P011157,0 days 00:11:53,19,34,15
135,ULK,P004004,P011157,0 days 00:11:43,19,34,15
135,ULK,P006661,P009849,0 days 00:11:34,16,31,15
135,ULK,P002968,P004004,0 days 00:08:10,-5,15,20
135,ULK,P009849,P010560,0 days 00:08:08,-8,11,19
135,ULK,P002968,P009849,0 days 00:06:44,-6,10,16
135,ULK,P004004,P010560,0 days 00:06:06,-6,7,13
135,ULK,P004004,P011052,0 days 00:05:11,-7,7,14
135,ULK,P009849,P011052,0 days 00:05:11,-7,7,14
135,ULK,P002968,P011052,0 days 00:04:23,-5,7,12
135,ULK,P005844,P008962,0 days 00:04:22,-4,7,11
135,ULK,P011052,P011980,0 days 00:03:47,-5,4,9
135,ULK,P009849,P011980,0 days 00:03:47,-5,4,9
135,ULK,P004004,P011980,0 days 00:03:47,-5,4,9
135,ULK,P002968,P011980,0 days 00:03:47,-5,4,9
135,ULK,P001932,P009849,0 days 00:03:41,-4,6,10
135,ULK,P006961,P010560,0 days 00:03:37,-3,5,8
135,ULK,P001932,P005844,0 days 00:03:34,-2,7,9
135,ULK,P005844,P010560,0 days 00:03:34,-2,7,9
135,ULK,P001932,P004004,0 days 00:03:15,-1,7,8
135,ULK,P005844,P009849,0 days 00:02:56,-4,4,8
135,ULK,P004004,P006961,0 days 00:02:53,-2,4,6
135,ULK,P006961,P009849,0 days 00:02:53,-2,4,6
135,ULK,P002968,P008962,0 days 00:02:41,-3,8,11
135,ULK,P001932,P002968,0 days 00:02:05,-3,5,8
135,ULK,P002968,P010560,0 days 00:01:42,3,3,0
135,ULK,P002968,P006961,0 days 00:01:42,3,3,0
135,ULK,P002968,P006661,0 days 00:01:26,1,5,4
135,ULK,P008962,P011052,0 days 00:01:24,-2,3,5
135,ULK,P006961,P011157,0 days 00:01:11,-5,1,6
135,ULK,P004004,P005844,0 days 00:00:48,-2,0,2
135,ULK,P005844,P011052,0 days 00:00:48,-2,0,2
135,ULK,P001932,P006961,0 days 00:00:44,-1,1,2
135,ULK,P005844,P006961,0 days 00:00:44,-1,1,2
135,ULK,P006961,P008962,0 days 00:00:44,-1,1,2
135,ULK,P005844,P006661,0 days 00:00:42,1,2,1
135,ZAL,P007109,P011218,0 days 00:30:44,-3,60,63
135,ZAL,P002329,P011218,0 days 00:27:40,-9,50,59
135,ZAL,P002329,P007109,0 days 00:26:56,-3,50,53
135,ZAL,P005504,P011218,0 days 00:20:40,-18,32,50
135,ZAL,P005504,P007109,0 days 00:19:38,-12,32,44
135,ZAL,P002329,P005504,0 days 00:18:08,-17,28,45
135,ZAL,P007109,P009917,0 days 00:17:08,-13,29,42
135,ZAL,P003211,P007109,0 days 00:15:35,6,32,26
135,ZAL,P009917,P011218,0 days 00:15:11,-11,27,38
135,ZAL,P003211,P011218,0 days 00:14:17,8,30,22
135,ZAL,P005504,P009917,0 days 00:13:34,-13,22,35
135,ZAL,P002329,P009917,0 days 00:11:43,-14,19,33
135,ZAL,P007109,P010390,0 days 00:09:41,4,20,16
135,ZAL,P003211,P010390,0 days 00:09:24,8,24,16
135,ZAL,P010390,P012787,0 days 00:09:23,7,23,16
135,ZAL,P002329,P003211,0 days 00:08:58,6,18,12
135,ZAL,P003211,P005504,0 days 00:08:50,0,14,14
135,ZAL,P007513,P010390,0 days 00:08:14,7,18,11
135,ZAL,P007109,P012787,0 days 00:08:11,5,17,12
135,ZAL,P011218,P012787,0 days 00:07:53,-3,15,18
135,ZAL,P010390,P011218,0 days 00:07:51,6,18,12
135,ZAL,P002329,P012787,0 days 00:07:33,0,13,13
135,ZAL,P003211,P012787,0 days 00:07:22,7,22,15
135,ZAL,P006860,P007513,0 days 00:06:53,9,20,11
135,ZAL,P003211,P007513,0 days 00:06:20,3,14,11
135,ZAL,P002329,P010390,0 days 00:06:10,5,12,7
135,ZAL,P006860,P012787,0 days 00:05:34,-1,12,13
135,ZAL,P003211,P009917,0 days 00:05:25,1,10,9
135,ZAL,P006860,P010390,0 days 00:05:11,7,14,7
135,ZAL,P007513,P012787,0 days 00:05:04,7,14,7
135,ZAL,P007109,P007513,0 days 00:04:45,2,10,8
135,ZAL,P006860,P011218,0 days 00:04:45,-2,8,10
135,ZAL,P003211,P006860,0 days 00:04:37,5,12,7
135,ZAL,P002329,P006860,0 days 00:04:20,-2,8,10
135,ZAL,P002329,P007513,0 days 00:03:36,6,10,4
135,ZAL,P009917,P010390,0 days 00:03:34,0,7,7
135,ZAL,P007513,P011218,0 days 00:02:55,4,8,4
135,ZAL,P006860,P007109,0 days 00:02:30,2,6,4
135,ZAL,P007513,P009917,0 days 00:01:57,-2,2,4
135,ZAL,P005504,P006860,0 days 00:01:02,-6,0,6
135,ZAL,P005504,P012787,0 days 00:00:48,-6,0,6
136,TEL,P009622,P011199,0 days 00:21:11,2,50,48
136,TEL,P009622,P009783,0 days 00:20:31,-2,43,45
136,TEL,P009863,P011199,0 days 00:18:59,-7,40,47
136,TEL,P009622,P009863,0 days 00:18:30,0,43,43
136,TEL,P009783,P011199,0 days 00:16:03,-4,30,34
136,TEL,P009783,P011193,0 days 00:15:13,1,36,35
136,TEL,P009622,P011193,0 days 00:14:50,4,41,37
136,TEL,P009783,P009863,0 days 00:14:33,-1,29,30
136,TEL,P009863,P011971,0 days 00:12:34,-15,23,38
136,TEL,P009863,P011193,0 days 00:12:25,-4,28,32
136,TEL,P011193,P011199,0 days 00:12:22,-5,28,33
136,TEL,P011193,P011214,0 days 00:12:07,-5,29,34
136,TEL,P011193,P011219,0 days 00:10:40,-5,26,31
136,TEL,P009863,P012744,0 days 00:10:25,0,28,28
136,TEL,P009622,P012744,0 days 00:09:19,1,26,25
136,TEL,P005145,P011199,0 days 00:09:02,5,19,14
136,TEL,P005145,P009863,0 days 00:09:02,5,19,14
136,TEL,P005145,P009622,0 days 00:09:02,5,19,14
136,TEL,P011214,P011219,0 days 00:09:01,-1,24,25
136,TEL,P009783,P011214,0 days 00:08:44,-5,19,24
136,TEL,P009863,P011219,0 days 00:08:23,-3,19,22
136,TEL,P009622,P011971,0 days 00:07:53,-2,22,24
136,TEL,P011193,P011971,0 days 00:07:43,-3,17,20
136,TEL,P011199,P011971,0 days 00:07:40,-14,13,27
136,TEL,P011199,P012744,0 days 00:07:38,-2,20,22
136,TEL,P009622,P011219,0 days 00:07:07,-2,19,21
136,TEL,P011193,P012744,0 days 00:06:35,-5,14,19
136,TEL,P004233,P009783,0 days 00:06:29,6,17,11
136,TEL,P004233,P009622,0 days 00:06:29,6,17,11
136,TEL,P004233,P011193,0 days 00:06:29,6,17,11
136,TEL,P009783,P011219,0 days 00:06:27,-1,16,17
136,TEL,P009863,P011214,0 days 00:06:25,1,15,14
136,TEL,P009783,P011971,0 days 00:06:16,-2,15,17
136,TEL,P005145,P009783,0 days 00:06:12,4,10,6
136,TEL,P009622,P011214,0 days 00:06:04,-4,16,20
136,TEL,P011219,P011971,0 days 00:05:45,-5,13,18
136,TEL,P004233,P011199,0 days 00:05:27,1,12,11
136,TEL,P011971,P012744,0 days 00:04:29,-3,9,12
136,TEL,P011214,P011971,0 days 00:02:58,-1,7,8
136,TEL,P011219,P012744,0 days 00:02:50,0,6,6
136,TEL,P005145,P012744,0 days 00:02:50,1,9,8
136,TEL,P011214,P012744,0 days 00:02:14,-4,3,7
136,TEL,P011199,P011219,0 days 00:02:07,-3,5,8
136,TEL,P004233,P011971,0 days 00:01:02,5,5,0
136,TEL,P009783,P012744,0 days 00:01:00,-4,1,5
136,TEL,P011199,P011214,0 days 00:00:55,-1,3,4
136,RED,P006436,P009035,0 days 00:22:51,2,52,50
136,RED,P006436,PJDR,0 days 00:22:15,12,60,48
136,RED,P009035,PJDR,0 days 00:18:49,12,55,43
136,RED,P005099,P006436,0 days 00:16:08,-3,38,41
136,RED,P002553,P006436,0 days 00:15:20,2,38,36
136,RED,P005099,PJDR,0 days 00:14:51,7,44,37
136,RED,P005099,P009035,0 days 00:14:26,-6,33,39
136,RED,P006436,PLUO,0 days 00:12:07,6,25,19
136,RED,P007960,PJDR,0 days 00:11:33,14,35,21
136,RED,P002553,P009035,0 days 00:11:24,1,28,27
136,RED,P008966,PJDR,0 days 00:09:56,8,28,20
136,RED,P000848,P009035,0 days 00:09:54,1,26,25
136,RED,P006436,P007960,0 days 00:09:51,-5,19,24
136,RED,P009035,P012711,0 days 00:09:34,10,26,16
136,RED,PJDR,PLUO,0 days 00:09:33,10,26,16
136,RED,P002553,PJDR,0 days 00:09:32,7,30,23
136,RED,P006436,P008966,0 days 00:09:19,-1,20,21
136,RED,P007960,P008966,0 days 00:09:07,1,23,22
136,RED,P012711,PJDR,0 days 00:09:02,10,27,17
136,RED,P005099,P007960,0 days 00:08:49,-1,23,24
136,RED,P002553,PLUO,0 days 00:08:21,4,21,17
136,RED,P000848,PJDR,0 days 00:08:16,3,25,22
136,RED,P009035,PLUO,0 days 00:07:43,5,17,12
136,RED,P000848,P006436,0 days 00:07:33,-4,15,19
136,RED,P006436,P012044,0 days 00:07:30,-12,8,20
136,RED,P008966,PLUO,0 days 00:06:58,0,15,15
136,RED,P005099,P008966,0 days 00:06:57,0,20,20
136,RED,P005099,P012711,0 days 00:06:30,-1,19,20
136,RED,P007960,P009035,0 days 00:06:30,3,17,14
136,RED,P000848,P005099,0 days 00:06:19,-4,14,18
136,RED,P002553,P005099,0 days 00:06:11,-4,12,16
136,RED,P000848,P007960,0 days 00:06:01,7,18,11
136,RED,P006436,P012711,0 days 00:05:46,7,13,6
136,RED,P009035,P012044,0 days 00:05:25,-8,6,14
136,RED,P000848,P012711,0 days 00:05:16,6,19,13
136,RED,P000848,P002553,0 days 00:05:02,-2,11,13
136,RED,P012044,PLUO,0 days 00:04:43,-1,6,7
136,RED,P002553,P008966,0 days 00:04:14,0,10,10
136,RED,P007960,PLUO,0 days 00:03:58,-1,9,10
136,RED,P007960,P012711,0 days 00:03:55,5,14,9
136,RED,P000848,P008966,0 days 00:02:55,1,8,7
136,RED,P012711,PLUO,0 days 00:02:47,-2,2,4
136,RED,P005099,P012044,0 days 00:02:47,-11,2,13
136,RED,P007960,P012044,0 days 00:02:44,-7,2,9
136,RED,P005099,PLUO,0 days 00:02:34,-1,7,8
136,RED,P002553,P012044,0 days 00:02:28,-4,2,6
136,RED,P008966,P012044,0 days 00:02:05,-4,2,6
136,RED,P008966,P012711,0 days 00:01:53,-1,6,7
136,RED,P012044,PJDR,0 days 00:01:13,-3,2,5
136,RED,P012044,P012711,0 days 00:01:05,2,2,0
137,MAD,P001392,P009213,0 days 00:21:44,17,58,41
137,MAD,PBMT,PCVM,0 days 00:20:38,-13,32,45
137,MAD,P005791,P005928,0 days 00:18:55,18,49,31
137,MAD,P001392,P006540,0 days 00:17:45,22,52,30
137,MAD,P006540,P009213,0 days 00:17:45,22,52,30
137,MAD,P003108,PCVM,0 days 00:17:16,0,35,35
137,MAD,P004887,PCVM,0 days 00:17:00,0,32,32
137,MAD,P005928,P006540,0 days 00:16:22,19,49,30
137,MAD,P005928,P009213,0 days 00:16:22,19,49,30
137,MAD,P001392,P005928,0 days 00:16:22,19,49,30
137,MAD,P003108,PBMT,0 days 00:15:43,-7,28,35
137,MAD,P001392,P005791,0 days 00:15:25,16,43,27
137,MAD,P005791,P006540,0 days 00:15:25,16,43,27
137,MAD,P005791,P009213,0 days 00:15:25,16,43,27
137,MAD,P004887,PBMT,0 days 00:14:28,-10,22,32
137,MAD,PCVM,PTGB,0 days 00:13:26,-4,22,26
137,MAD,P004887,PTGB,0 days 00:13:06,-4,22,26
137,MAD,PBMT,PTGB,0 days 00:11:53,-11,15,26
137,MAD,P003108,P004887,0 days 00:10:46,3,25,22
137,MAD,P003108,PTGB,0 days 00:09:54,2,20,18
137,MAD,P009213,PCVM,0 days 00:08:58,-8,11,19
137,MAD,P009213,PBMT,0 days 00:07:35,-11,8,19
137,MAD,P004887,P009213,0 days 00:07:15,0,13,13
137,MAD,P001392,PCVM,0 days 00:06:38,-1,14,15
137,MAD,P001392,PBMT,0 days 00:05:15,-4,11,15
137,MAD,P001392,P004887,0 days 00:04:55,7,16,9
137,MAD,P001392,P003108,0 days 00:03:56,-4,9,13
137,MAD,P009213,PTGB,0 days 00:03:36,-6,2,8
137,MAD,P004887,P006540,0 days 00:03:33,13,16,3
137,MAD,P003108,P005791,0 days 00:03:30,2,6,4
137,MAD,P003108,P005928,0 days 00:03:30,2,6,4
137,MAD,P005791,PBMT,0 days 00:03:30,2,6,4
137,MAD,P005791,PCVM,0 days 00:03:30,2,6,4
137,MAD,P005928,PBMT,0 days 00:03:30,2,6,4
137,MAD,P005928,PCVM,0 days 00:03:30,2,6,4
137,MAD,P006540,PCVM,0 days 00:02:56,10,10,0
137,MAD,P003108,P009213,0 days 00:02:40,-5,4,9
137,MAD,P003108,P006540,0 days 00:01:37,7,7,0
137,MAD,P006540,PTGB,0 days 00:01:37,7,7,0
137,MAD,P004887,P005928,0 days 00:00:57,3,6,3
137,MAD,P003108,P010623,0 days 00:00:28,0,0,0
137,MAD,P006540,P010623,0 days 00:00:28,0,0,0
137,MAD,P010623,PTGB,0 days 00:00:28,0,0,0
137,MAD,P010623,PCVM,0 days 00:00:24,0,0,0
137,MAD,P004887,P010623,0 days 00:00:04,0,0,0
137,PAR,P004172,P007400,0 days 00:22:09,-4,45,49
137,PAR,P004172,P011051,0 days 00:17:56,1,34,33
137,PAR,P009862,P012096,0 days 00:16:50,-12,31,43
137,PAR,P008987,P009862,0 days 00:16:46,-23,26,49
137,PAR,P004172,P012096,0 days 00:14:29,-2,30,32
137,PAR,P007400,P012096,0 days 00:13:59,-9,28,37
137,PAR,P007400,P011051,0 days 00:13:45,-4,25,29
137,PAR,P009862,P012742,0 days 00:13:26,-19,19,38
137,PAR,P008987,P012742,0 days 00:13:20,-19,19,38
137,PAR,P011051,P012096,0 days 00:12:46,-4,23,27
137,PAR,P004172,P009212,0 days 00:12:11,8,30,22
137,PAR,P004058,P004172,0 days 00:11:59,11,26,15
137,PAR,P009862,P011051,0 days 00:11:17,-13,15,28
137,PAR,P007400,P009212,0 days 00:11:15,4,26,22
137,PAR,P004058,P011051,0 days 00:11:13,-4,16,20
137,PAR,P008987,P012096,0 days 00:10:21,-8,21,29
137,PAR,P004172,P009862,0 days 00:09:49,-8,17,25
137,PAR,P007400,P009862,0 days 00:09:19,-15,15,30
137,PAR,P012096,P012742,0 days 00:08:38,-10,14,24
137,PAR,P004058,P007400,0 days 00:08:16,6,17,11
137,PAR,P004058,P008987,0 days 00:08:06,-7,9,16
137,PAR,P008987,P011051,0 days 00:07:38,-7,9,16
137,PAR,P004058,P011050,0 days 00:07:38,9,22,13
137,PAR,P004172,P011050,0 days 00:07:38,9,22,13
137,PAR,P007400,P008987,0 days 00:07:31,-7,11,18
137,PAR,P000956,P008987,0 days 00:07:17,-5,14,19
137,PAR,P000956,P009862,0 days 00:07:17,-5,14,19
137,PAR,P000956,P012742,0 days 00:07:17,-5,14,19
137,PAR,P000956,P012096,0 days 00:07:17,-5,14,19
137,PAR,P009212,P012096,0 days 00:06:59,2,15,13
137,PAR,P009212,P011051,0 days 00:06:59,2,15,13
137,PAR,P004058,P009862,0 days 00:06:25,-9,5,14
137,PAR,P004172,P008987,0 days 00:06:16,-2,11,13
137,PAR,P009212,P011050,0 days 00:05:12,6,15,9
137,PAR,P004058,P009212,0 days 00:05:12,6,15,9
137,PAR,P007400,P011050,0 days 00:04:58,4,13,9
137,PAR,P011051,P012742,0 days 00:04:54,-9,5,14
137,PAR,P004058,P012742,0 days 00:04:54,-9,5,14
137,PAR,P000956,P004058,0 days 00:02:40,5,9,4
137,PAR,P000956,P004172,0 days 00:02:40,5,9,4
137,PAR,P000956,P011050,0 days 00:02:40,5,9,4
137,PAR,P000956,P011051,0 days 00:02:26,3,7,4
137,PAR,P011050,P011051,0 days 00:02:26,3,7,4
137,PAR,P007400,P012742,0 days 00:01:15,-5,0,5
137,PAR,P004172,P012743,0 days 00:01:09,-6,0,6
137,PAR,P007400,P012743,0 days 00:01:09,-6,0,6
137,PAR,P008987,P012743,0 days 00:01:09,-6,0,6
137,PAR,P009862,P012743,0 days 00:01:09,-6,0,6
137,PAR,P004058,P012096,0 days 00:01:09,0,0,0
137,PAR,P009212,P009862,0 days 00:00:42,2,2,0
137,PAR,P000956,P009212,0 days 00:00:14,2,2,0
138,PAM,P007870,P010568,0 days 00:19:27,7,45,38
138,PAM,P010568,P012740,0 days 00:18:04,-1,33,34
138,PAM,P005356,P012739,0 days 00:17:12,3,30,27
138,PAM,P007870,P012740,0 days 00:16:13,-6,30,36
138,PAM,P003960,P010568,0 days 00:16:08,19,39,20
138,PAM,P003960,P007870,0 days 00:14:52,16,38,22
138,PAM,P005356,P010393,0 days 00:14:52,0,26,26
138,PAM,P004863,P005356,0 days 00:14:16,8,33,25
138,PAM,P006643,P010568,0 days 00:14:10,-3,25,28
138,PAM,P010393,P012739,0 days 00:13:20,0,22,22
138,PAM,P006643,P007870,0 days 00:12:53,-1,25,26
138,PAM,P004863,P012739,0 days 00:12:46,-1,21,22
138,PAM,P005356,P012740,0 days 00:12:12,13,27,14
138,PAM,P003960,P012740,0 days 00:11:54,8,24,16
138,PAM,P005356,P010568,0 days 00:11:36,11,30,19
138,PAM,P003960,P006643,0 days 00:10:26,7,22,15
138,PAM,P006643,P012740,0 days 00:10:18,-7,18,25
138,PAM,P004863,P010393,0 days 00:09:57,3,18,15
138,PAM,P010393,P012740,0 days 00:09:37,5,21,16
138,PAM,P012739,P012740,0 days 00:09:34,12,19,7
138,PAM,P003960,P004863,0 days 00:09:12,11,23,12
138,PAM,P004863,P012740,0 days 00:08:37,7,16,9
138,PAM,P004863,P007870,0 days 00:08:16,13,23,10
138,PAM,P004863,P010568,0 days 00:08:01,12,20,8
138,PAM,P010568,P012739,0 days 00:07:32,1,10,9
138,PAM,P004863,P008780,0 days 00:07:22,-7,12,19
138,PAM,P005356,P008780,0 days 00:07:06,-10,10,20
138,PAM,P008780,P012739,0 days 00:07:06,-10,10,20
138,PAM,P008780,P010393,0 days 00:06:06,-7,8,15
138,PAM,P010393,P010568,0 days 00:05:46,-5,11,16
138,PAM,P005356,P007870,0 days 00:05:21,8,20,12
138,PAM,P010568,P012738,0 days 00:05:01,-6,5,11
138,PAM,P003960,P005356,0 days 00:04:29,12,17,5
138,PAM,P012738,P012740,0 days 00:04:12,-7,4,11
138,PAM,P007870,P012738,0 days 00:04:12,-7,4,11
138,PAM,P004863,P006643,0 days 00:03:52,4,7,3
138,PAM,P003960,P012739,0 days 00:03:20,3,5,2
138,PAM,P005356,P012738,0 days 00:03:08,-1,7,8
138,PAM,P006643,P012738,0 days 00:02:53,-8,0,8
138,PAM,P008780,P012740,0 days 00:02:27,0,4,4
138,PAM,P007870,P008780,0 days 00:02:27,0,4,4
138,PAM,P003960,P008780,0 days 00:02:27,0,4,4
138,PAM,P007870,P010393,0 days 00:02:23,-2,7,9
138,PAM,P008780,P010568,0 days 00:02:11,-3,2,5
138,PAM,P004863,P012738,0 days 00:01:49,-2,3,5
138,PAM,P012738,P012739,0 days 00:01:49,-2,3,5
138,PAM,P006643,P012739,0 days 00:01:17,-2,0,2
138,PAM,P008780,P012738,0 days 00:01:00,-3,2,5
138,PAM,P006643,P010393,0 days 00:00:51,-2,3,5
138,VIR,P001133,P009549,0 days 00:24:35,-2,44,46
138,VIR,P001133,P001844,0 days 00:24:10,4,44,40
138,VIR,P001133,PBCN,0 days 00:21:52,-3,39,42
138,VIR,P001133,P003048,0 days 00:18:26,-4,28,32
138,VIR,P009549,PBCN,0 days 00:18:20,-7,31,38
138,VIR,P003048,P009549,0 days 00:18:11,-6,28,34
138,VIR,P001844,P009549,0 days 00:18:04,0,33,33
138,VIR,P003048,PBCN,0 days 00:17:27,-11,24,35
138,VIR,P001844,PBCN,0 days 00:16:39,-4,30,34
138,VIR,P001844,P010781,0 days 00:16:25,-5,25,30
138,VIR,P010781,P012714,0 days 00:15:50,6,32,26
138,VIR,P001844,P003048,0 days 00:15:14,-6,24,30
138,VIR,P001844,P012714,0 days 00:15:04,2,27,25
138,VIR,P001133,P012714,0 days 00:13:15,10,32,22
138,VIR,P001133,P010781,0 days 00:12:13,9,25,16
138,VIR,P004007,P010781,0 days 00:11:08,-5,19,24
138,VIR,P001844,P004007,0 days 00:10:13,-5,14,19
138,VIR,P004007,P012714,0 days 00:09:52,1,19,18
138,VIR,P002084,P010781,0 days 00:08:04,-12,11,23
138,VIR,P002084,P004007,0 days 00:07:24,-7,11,18
138,VIR,P001133,P006739,0 days 00:06:50,-2,14,16
138,VIR,P001844,P002084,0 days 00:06:23,-10,7,17
138,VIR,P001133,P004007,0 days 00:06:23,4,14,10
138,VIR,P009549,P012714,0 days 00:06:18,4,16,12
138,VIR,P006739,P009549,0 days 00:05:35,-4,9,13
138,VIR,P010781,PBCN,0 days 00:05:28,-1,10,11
138,VIR,P002084,P012714,0 days 00:05:12,-3,9,12
138,VIR,P009549,P010781,0 days 00:05:01,1,9,8
138,VIR,P003048,P006739,0 days 00:04:59,-7,4,11
138,VIR,P012714,PBCN,0 days 00:04:54,3,15,12
138,VIR,P006739,PBCN,0 days 00:04:48,-4,7,11
138,VIR,P003048,P010781,0 days 00:04:12,-7,4,11
138,VIR,P003048,P004007,0 days 00:03:51,-2,6,8
138,VIR,P004007,P006739,0 days 00:03:34,2,11,9
138,VIR,P006739,P012714,0 days 00:03:23,5,14,9
138,VIR,P002084,P003048,0 days 00:02:52,-9,2,11
138,VIR,P006739,P010781,0 days 00:02:47,2,9,7
138,VIR,P004007,P009549,0 days 00:02:43,0,6,6
138,VIR,P002084,P006739,0 days 00:01:32,0,4,4
138,VIR,P002084,PBCN,0 days 00:00:40,-5,0,5
138,VIR,P002084,P009549,0 days 00:00:09,-2,0,2
139,BER,P003958,P012720,0 days 00:27:10,-14,52,66
139,BER,P008173,P012720,0 days 00:20:55,-11,36,47
139,BER,P003958,P008173,0 days 00:20:55,-11,36,47
139,BER,P008967,P011934,0 days 00:16:39,1,34,33
139,BER,P006251,P008211,0 days 00:15:39,3,37,34
139,BER,P008211,P008384,0 days 00:15:39,3,37,34
139,BER,P006251,P008384,0 days 00:15:39,3,37,34
139,BER,P008211,P008967,0 days 00:14:34,4,33,29
139,BER,P011934,P012720,0 days 00:14:26,-3,32,35
139,BER,P003958,P011934,0 days 00:14:26,-3,32,35
139,BER,P008211,P011934,0 days 00:13:59,2,30,28
139,BER,P006251,P008967,0 days 00:12:50,5,30,25
139,BER,P008384,P008967,0 days 00:12:50,5,30,25
139,BER,P008384,P011934,0 days 00:12:50,5,25,20
139,BER,P012720,P012721,0 days 00:12:46,-5,24,29
139,BER,P003958,P012721,0 days 00:12:46,-5,24,29
139,BER,P008173,P012721,0 days 00:11:04,-5,18,23
139,BER,P008173,P011934,0 days 00:11:00,-2,23,25
139,BER,P006251,P011934,0 days 00:10:33,3,21,18
139,BER,P008173,P010791,0 days 00:09:55,-9,13,22
139,BER,P010791,P012720,0 days 00:09:55,-9,13,22
139,BER,P003958,P010791,0 days 00:09:55,-9,13,22
139,BER,P008967,P012720,0 days 00:08:41,-8,15,23
139,BER,P003958,P008967,0 days 00:08:41,-8,15,23
139,BER,P008173,P008967,0 days 00:06:57,-7,12,19
139,BER,P010791,P012721,0 days 00:06:43,-2,9,11
139,BER,P003958,P008211,0 days 00:06:15,-3,16,19
139,BER,P008211,P012720,0 days 00:06:15,-3,16,19
139,BER,P011934,P012721,0 days 00:06:03,-3,15,18
139,BER,P003958,P008384,0 days 00:05:43,-1,13,14
139,BER,P008384,P012720,0 days 00:05:43,-1,13,14
139,BER,P008967,P010791,0 days 00:04:52,-4,11,15
139,BER,P008173,P008384,0 days 00:02:54,1,6,5
139,BER,P008384,P010791,0 days 00:02:54,1,11,10
139,BER,P003958,P006251,0 days 00:02:49,-2,7,9
139,BER,P006251,P012720,0 days 00:02:49,-2,7,9
139,BER,P006251,P010791,0 days 00:02:17,2,9,7
139,BER,P008211,P010791,0 days 00:02:17,2,9,7
139,BER,P008211,P012721,0 days 00:01:42,0,6,6
139,ULK,P008962,P010560,0 days 00:31:23,11,71,60
139,ULK,P006661,P010560,0 days 00:26:21,12,60,48
139,ULK,P001932,P010560,0 days 00:25:50,13,54,41
139,ULK,P006661,P008962,0 days 00:25:45,14,60,46
139,ULK,P001932,P008962,0 days 00:25:14,15,54,39
139,ULK,P001932,P006661,0 days 00:22:50,13,49,36
139,ULK,P008962,P011157,0 days 00:20:52,3,43,40
139,ULK,P010560,P011157,0 days 00:19:22,8,43,35
139,ULK,P001932,P011157,0 days 00:18:52,10,43,33
139,ULK,P006661,P011157,0 days 00:15:52,10,38,28
139,ULK,P001932,P005844,0 days 00:09:17,9,22,13
139,ULK,P005844,P009849,0 days 00:08:39,4,26,22
139,ULK,P004004,P009849,0 days 00:08:01,0,20,20
139,ULK,P008962,P011052,0 days 00:07:39,-9,17,26
139,ULK,P001932,P009849,0 days 00:07:33,6,18,12
139,ULK,P008962,P009849,0 days 00:07:08,-8,11,19
139,ULK,P005844,P010560,0 days 00:06:52,2,15,13
139,ULK,P004004,P011980,0 days 00:06:31,5,20,15
139,ULK,P009849,P011980,0 days 00:06:31,5,20,15
139,ULK,P004004,P005844,0 days 00:06:31,5,20,15
139,ULK,P005844,P011980,0 days 00:06:31,5,20,15
139,ULK,P005844,P008962,0 days 00:06:16,4,15,11
139,ULK,P010560,P011052,0 days 00:06:09,-4,17,21
139,ULK,P009849,P011052,0 days 00:06:06,-9,13,22
139,ULK,P002968,P006661,0 days 00:05:45,-1,13,14
139,ULK,P002968,P008962,0 days 00:05:45,-1,13,14
139,ULK,P002968,P010560,0 days 00:05:45,-1,13,14
139,ULK,P009849,P010560,0 days 00:05:38,-3,11,14
139,ULK,P009849,P011157,0 days 00:05:00,-7,5,12
139,ULK,P005844,P006661,0 days 00:04:44,3,9,6
139,ULK,P001932,P011980,0 days 00:04:33,6,13,7
139,ULK,P001932,P004004,0 days 00:04:33,6,13,7
139,ULK,P005844,P011052,0 days 00:04:06,-2,13,15
139,ULK,P002968,P011052,0 days 00:03:31,-1,11,12
139,ULK,P006661,P011052,0 days 00:03:31,-1,11,12
139,ULK,P004004,P011052,0 days 00:03:28,-6,7,13
139,ULK,P001932,P002968,0 days 00:02:14,0,2,2
139,ULK,P011052,P011157,0 days 00:02:00,-7,0,7
139,ULK,P011052,P011980,0 days 00:01:58,-1,7,8
139,ULK,P004004,P008962,0 days 00:01:30,-5,0,5
139,ULK,P004004,P011157,0 days 00:01:30,-5,0,5
139,ULK,P001932,P006961,0 days 00:00:36,-2,0,2
139,ULK,P005844,P006961,0 days 00:00:36,-2,0,2
139,ULK,P006661,P006961,0 days 00:00:36,-2,0,2
139,ULK,P006961,P010560,0 days 00:00:36,-2,0,2
140,IST,P007200,P012788,0 days 00:23:53,1,47,46
140,IST,P007200,P011078,0 days 00:23:39,1,52,51
140,IST,P009846,P011078,0 days 00:22:12,1,42,41
140,IST,P011078,P012788,0 days 00:21:42,11,46,35
140,IST,P007200,P009846,0 days 00:21:35,-12,34,46
140,IST,P006590,P007200,0 days 00:20:00,-3,46,49
140,IST,P007200,P012710,0 days 00:19:24,-11,38,49
140,IST,P009846,P012788,0 days 00:18:49,5,36,31
140,IST,P011078,P012710,0 days 00:16:57,-9,32,41
140,IST,P012710,P012788,0 days 00:15:44,-10,24,34
140,IST,P009846,P012710,0 days 00:13:16,-18,14,32
140,IST,P006590,P012788,0 days 00:11:17,-1,25,26
140,IST,P006590,P011078,0 days 00:11:12,-4,28,32
140,IST,P009846,P011981,0 days 00:10:06,0,20,20
140,IST,P007200,P011981,0 days 00:09:21,0,24,24
140,IST,P011078,P011981,0 days 00:08:55,5,26,21
140,IST,P006590,P012710,0 days 00:08:54,-4,24,28
140,IST,P006590,P012786,0 days 00:08:36,-7,12,19
140,IST,P007200,P012786,0 days 00:08:10,1,14,13
140,IST,P006590,P009846,0 days 00:07:37,-11,10,21
140,IST,P007200,P010516,0 days 00:07:04,2,18,16
140,IST,P006590,P011981,0 days 00:06:58,-4,16,20
140,IST,P006590,P010516,0 days 00:06:47,7,18,11
140,IST,P010516,P012786,0 days 00:05:50,5,14,9
140,IST,P009513,P011078,0 days 00:05:40,-5,8,13
140,IST,P009513,P009846,0 days 00:04:31,3,10,7
140,IST,P011981,P012788,0 days 00:04:30,10,14,4
140,IST,P004554,P012786,0 days 00:04:17,-1,7,8
140,IST,P009846,P012786,0 days 00:04:06,-3,6,9
140,IST,P011981,P012710,0 days 00:03:51,3,14,11
140,IST,P012786,P012788,0 days 00:03:47,0,7,7
140,IST,P010516,P012788,0 days 00:03:47,0,7,7
140,IST,P009513,P011981,0 days 00:03:44,5,10,5
140,IST,P011078,P012786,0 days 00:03:38,-7,4,11
140,IST,P004554,P006590,0 days 00:03:12,-3,5,8
140,IST,P011981,P012786,0 days 00:03:01,-5,4,9
140,IST,P009513,P012786,0 days 00:02:55,-7,4,11
140,IST,P004554,P007200,0 days 00:02:46,5,7,2
140,IST,P009513,P012788,0 days 00:02:39,4,6,2
140,IST,P004554,P011078,0 days 00:02:36,-4,2,6
140,IST,P010516,P011981,0 days 00:01:54,6,8,2
140,IST,P010516,P012710,0 days 00:01:51,-1,6,7
140,IST,P004554,P010516,0 days 00:01:41,3,5,2
140,IST,P004554,P009513,0 days 00:01:31,-6,0,6
140,IST,P006590,P009513,0 days 00:01:31,-6,0,6
140,IST,P009846,P010516,0 days 00:01:07,-3,2,5
140,IST,P004554,P009846,0 days 00:01:05,2,2,0
140,IST,P009513,P010516,0 days 00:00:50,2,2,0
140,IST,P009513,P012710,0 days 00:00:47,-2,0,2
140,IST,P010516,P011078,0 days 00:00:45,-5,0,5
140,BAS,P007230,P009048,0 days 00:29:20,5,65,60
140,BAS,P004761,P007230,0 days 00:27:09,16,61,45
140,BAS,P004761,P009048,0 days 00:25:48,13,56,43
140,BAS,P009048,P012201,0 days 00:21:37,-2,52,54
140,BAS,P009048,P011948,0 days 00:18:03,7,48,41
140,BAS,P011948,P012201,0 days 00:17:34,-1,42,43
140,BAS,P004603,P009048,0 days 00:16:29,15,36,21
140,BAS,P011085,P012201,0 days 00:15:42,-3,37,40
140,BAS,P009048,P011085,0 days 00:15:12,-5,35,40
140,BAS,P007230,P012201,0 days 00:14:38,-5,37,42
140,BAS,P004603,P004761,0 days 00:14:27,6,26,20
140,BAS,P004761,P012201,0 days 00:13:09,-5,28,33
140,BAS,P004603,P007230,0 days 00:12:50,10,26,16
140,BAS,P007230,P011948,0 days 00:12:25,7,38,31
140,BAS,P004603,P011948,0 days 00:11:30,11,30,19
140,BAS,P008850,P009048,0 days 00:11:22,1,17,16
140,BAS,P007230,P008850,0 days 00:11:22,1,17,16
140,BAS,P004761,P011948,0 days 00:11:03,7,29,22
140,BAS,P004761,P008850,0 days 00:11:02,3,17,14
140,BAS,P011085,P011948,0 days 00:10:28,1,26,25
140,BAS,P007230,P011085,0 days 00:08:13,-8,20,28
140,BAS,P004603,P012201,0 days 00:07:20,4,17,13
140,BAS,P004603,P008850,0 days 00:07:00,-1,9,10
140,BAS,P004603,P012765,0 days 00:05:34,1,11,10
140,BAS,P008072,P009048,0 days 00:05:32,-4,7,11
140,BAS,P004603,P011085,0 days 00:05:30,10,17,7
140,BAS,P004761,P011085,0 days 00:05:14,-4,11,15
140,BAS,P004761,P012765,0 days 00:04:51,1,9,8
140,BAS,P011948,P012765,0 days 00:03:54,-3,7,10
140,BAS,P007230,P008072,0 days 00:03:33,1,7,6
140,BAS,P008072,P008850,0 days 00:03:33,1,7,6
140,BAS,P007230,P012765,0 days 00:03:14,5,9,4
140,BAS,P004761,P008072,0 days 00:03:13,3,7,4
140,BAS,P012201,P012765,0 days 00:02:20,-4,2,6
140,BAS,P008072,P012201,0 days 00:02:19,-7,0,7
140,BAS,P008072,P011948,0 days 00:01:59,-5,0,5
140,BAS,P008072,P011085,0 days 00:01:59,-5,0,5
140,BAS,P009048,P012765,0 days 00:01:53,2,4,2
140,BAS,P008850,P012201,0 days 00:01:09,-1,1,2
140,BAS,P011085,P012765,0 days 00:00:30,2,2,0
141,MIL,P002849,P011205,0 days 00:24:51,-5,39,44
141,MIL,P007201,P007831,0 days 00:24:09,-4,43,47
141,MIL,P007831,P011205,0 days 00:23:25,-8,37,45
141,MIL,P007201,P011205,0 days 00:23:21,-6,38,44
141,MIL,P002849,P007831,0 days 00:22:11,1,40,39
141,MIL,P002849,P007201,0 days 00:22:03,3,41,38
141,MIL,P005670,P011205,0 days 00:15:34,-9,20,29
141,MIL,P005670,P007831,0 days 00:14:44,-6,20,26
141,MIL,P005670,P007201,0 days 00:12:20,-7,16,23
141,MIL,P002849,P005670,0 days 00:12:16,-3,17,20
141,MIL,P005775,P007831,0 days 00:11:27,-2,24,26
141,MIL,P006509,P011205,0 days 00:10:45,-5,14,19
141,MIL,P006509,P009960,0 days 00:10:17,-5,16,21
141,MIL,P006509,P007831,0 days 00:09:58,1,21,20
141,MIL,P002849,P006509,0 days 00:08:58,-2,13,15
141,MIL,P002812,P007831,0 days 00:08:39,-7,13,20
141,MIL,P006509,P006701,0 days 00:08:13,8,18,10
141,MIL,P009960,P011205,0 days 00:07:49,-2,11,13
141,MIL,P002812,P006509,0 days 00:07:28,4,17,13
141,MIL,P006509,P007201,0 days 00:07:26,6,17,11
141,MIL,P005775,P006509,0 days 00:07:24,-5,13,18
141,MIL,P005775,P011205,0 days 00:07:15,-7,11,18
141,MIL,P006701,P011205,0 days 00:07:09,7,16,9
141,MIL,P007831,P009960,0 days 00:07:08,-1,13,14
141,MIL,P002849,P006701,0 days 00:07:02,5,15,10
141,MIL,P005775,P007201,0 days 00:06:39,0,15,15
141,MIL,P002812,P009960,0 days 00:06:28,2,13,11
141,MIL,P005775,P009960,0 days 00:06:24,-7,9,16
141,MIL,P002849,P005775,0 days 00:05:39,-2,11,13
141,MIL,P002812,P011205,0 days 00:05:37,-1,10,11
141,MIL,P006701,P007201,0 days 00:05:20,8,15,7
141,MIL,P002812,P005775,0 days 00:05:13,-1,10,11
141,MIL,P002812,P007201,0 days 00:04:22,-4,7,11
141,MIL,P002849,P009960,0 days 00:03:58,-2,4,6
141,MIL,P006701,P009960,0 days 00:03:53,2,7,5
141,MIL,P002812,P005670,0 days 00:03:26,-6,3,9
141,MIL,P006701,P007831,0 days 00:03:08,5,10,5
141,MIL,P005670,P009960,0 days 00:02:20,1,4,3
141,MIL,P002812,P006701,0 days 00:02:19,5,7,2
141,MIL,P006721,P009960,0 days 00:02:11,-4,3,7
141,MIL,P006509,P006721,0 days 00:02:11,-4,3,7
141,MIL,P005775,P006721,0 days 00:02:11,-4,3,7
141,MIL,P006721,P011205,0 days 00:01:36,-5,0,5
141,MIL,P002849,P011926,0 days 00:00:54,-3,0,3
141,MIL,P005670,P006509,0 days 00:00:54,-3,0,3
141,MIL,P005670,P011926,0 days 00:00:54,-3,0,3
141,MIL,P006509,P011926,0 days 00:00:54,-3,0,3
141,MIL,P011205,P011926,0 days 00:00:54,-3,0,3
141,MIL,P006721,P007831,0 days 00:00:35,1,3,2
141,MIL,P002812,P002849,0 days 00:00:04,0,0,0
141,MIL,P005670,P006701,0 days 00:00:04,0,0,0
141,PAN,P001926,P011204,0 days 00:28:06,5,52,47
141,PAN,P001926,P003842,0 days 00:24:58,-9,41,50
141,PAN,P003842,P011204,0 days 00:23:28,-6,39,45
141,PAN,P007866,P011204,0 days 00:20:47,-3,35,38
141,PAN,P003842,P007866,0 days 00:20:39,-8,29,37
141,PAN,P001926,P007866,0 days 00:20:37,-3,33,36
141,PAN,P011204,P012774,0 days 00:18:53,14,44,30
141,PAN,P001926,P012774,0 days 00:18:52,5,35,30
141,PAN,P002328,P003842,0 days 00:17:51,-6,27,33
141,PAN,P002328,P011204,0 days 00:17:45,0,35,35
141,PAN,P003842,P012774,0 days 00:16:51,-3,28,31
141,PAN,P001926,P002328,0 days 00:16:10,-4,26,30
141,PAN,P002328,P007866,0 days 00:15:34,-8,23,31
141,PAN,P012712,P012774,0 days 00:14:15,11,35,24
141,PAN,P007866,P012774,0 days 00:13:47,5,24,19
141,PAN,P001926,P012712,0 days 00:12:45,12,29,17
141,PAN,P011204,P012712,0 days 00:12:36,21,36,15
141,PAN,P002328,P012774,0 days 00:09:14,-2,18,20
141,PAN,P007947,P012774,0 days 00:08:39,3,15,12
141,PAN,P011221,P012712,0 days 00:07:43,10,19,9
141,PAN,P011221,P012774,0 days 00:06:33,7,17,10
141,PAN,P007947,P012712,0 days 00:05:42,0,10,10
141,PAN,P003842,P012712,0 days 00:05:37,0,13,13
141,PAN,P011204,P011221,0 days 00:05:17,12,18,6
141,PAN,P002328,P012712,0 days 00:04:48,4,13,9
141,PAN,P002328,P011221,0 days 00:04:37,2,13,11
141,PAN,P007947,P011221,0 days 00:04:35,3,8,5
141,PAN,P003842,P007947,0 days 00:04:04,0,7,7
141,PAN,P002328,P007947,0 days 00:03:53,-2,5,7
141,PAN,P001926,P011221,0 days 00:03:46,6,7,1
141,PAN,P007866,P012712,0 days 00:03:22,6,9,3
141,PAN,P001926,P007947,0 days 00:03:10,0,5,5
141,PAN,P007866,P007947,0 days 00:02:57,3,5,2
141,PAN,P007947,P011204,0 days 00:01:36,5,5,0
141,PAN,P007866,P011221,0 days 00:00:33,0,2,2
142,MUN,P007056,P011987,0 days 00:21:13,-12,38,50
142,MUN,P001288,P007975,0 days 00:18:23,-3,37,40
142,MUN,P007056,P010391,0 days 00:17:22,-9,35,44
142,MUN,P004508,P007975,0 days 00:14:37,-1,34,35
142,MUN,P001288,P004508,0 days 00:14:23,1,34,33
142,MUN,P010391,P011987,0 days 00:14:14,3,35,32
142,MUN,P007975,P010391,0 days 00:13:02,-15,16,31
142,MUN,P006760,P011987,0 days 00:13:00,-8,25,33
142,MUN,P006760,P007056,0 days 00:12:22,-9,22,31
142,MUN,P003583,P007056,0 days 00:11:58,-12,15,27
142,MUN,P001288,P010391,0 days 00:11:21,-10,14,24
142,MUN,P003583,P010391,0 days 00:11:00,-2,16,18
142,MUN,P007056,P008985,0 days 00:10:55,-13,19,32
142,MUN,P003583,P011987,0 days 00:10:53,-3,18,21
142,MUN,P003583,P006760,0 days 00:09:50,-10,12,22
142,MUN,P008985,P011987,0 days 00:09:11,-11,17,28
142,MUN,P007056,P007975,0 days 00:09:04,-7,14,21
142,MUN,P004508,P010391,0 days 00:09:04,-14,11,25
142,MUN,P006760,P007975,0 days 00:08:40,11,28,17
142,MUN,P007975,P011987,0 days 00:07:25,-1,14,15
142,MUN,P006760,P008985,0 days 00:07:12,-6,15,21
142,MUN,P005478,P011987,0 days 00:07:04,-3,15,18
142,MUN,P001288,P006760,0 days 00:06:45,12,26,14
142,MUN,P001288,P007639,0 days 00:06:44,0,16,16
142,MUN,P007639,P007975,0 days 00:06:44,0,16,16
142,MUN,P003583,P008985,0 days 00:06:36,-11,6,17
142,MUN,P004508,P007639,0 days 00:06:30,0,16,16
142,MUN,P005478,P007056,0 days 00:06:26,-4,12,16
142,MUN,P005478,P007975,0 days 00:06:18,7,21,14
142,MUN,P004508,P006760,0 days 00:06:07,11,23,12
142,MUN,P008985,P010391,0 days 00:06:03,-4,15,19
142,MUN,P001288,P003583,0 days 00:05:49,2,9,7
142,MUN,P006760,P010391,0 days 00:05:35,1,16,15
142,MUN,P004508,P007056,0 days 00:05:16,-7,7,14
142,MUN,P003583,P007975,0 days 00:05:10,-5,4,9
142,MUN,P001557,P010391,0 days 00:05:03,6,10,4
142,MUN,P003583,P004508,0 days 00:05:03,-5,6,11
142,MUN,P001557,P003583,0 days 00:04:49,6,10,4
142,MUN,P001288,P007056,0 days 00:04:35,-6,5,11
142,MUN,P005478,P010391,0 days 00:04:31,-3,10,13
142,MUN,P005478,P006760,0 days 00:04:10,5,15,10
142,MUN,P001288,P011987,0 days 00:04:03,3,10,7
142,MUN,P007639,P010391,0 days 00:03:57,-5,6,11
142,MUN,P001557,P011987,0 days 00:02:58,8,10,2
142,MUN,P001288,P001557,0 days 00:02:58,3,5,2
142,MUN,P006760,P007639,0 days 00:02:47,5,10,5
142,MUN,P001557,P007056,0 days 00:02:05,3,5,2
142,MUN,P001557,P007975,0 days 00:02:05,-2,0,2
142,MUN,P001288,P005478,0 days 00:02:03,6,12,6
142,MUN,P005478,P008985,0 days 00:01:59,-5,2,7
142,MUN,P004508,P008985,0 days 00:01:44,-2,2,4
142,MUN,P004508,P005478,0 days 00:01:25,5,9,4
142,MUN,P004508,P011987,0 days 00:01:15,0,2,2
142,MUN,P001557,P007639,0 days 00:00:14,0,0,0
142,MCO,P005985,P011231,0 days 00:26:21,10,59,49
142,MCO,P005985,P010588,0 days 00:25:53,9,60,51
142,MCO,P011212,P011226,0 days 00:24:18,2,59,57
142,MCO,P010588,P011231,0 days 00:23:34,15,54,39
142,MCO,P005985,P011226,0 days 00:19:12,1,50,49
142,MCO,P011231,P012709,0 days 00:16:40,9,34,25
142,MCO,P011226,P011231,0 days 00:16:09,0,37,37
142,MCO,P005985,P012709,0 days 00:15:42,9,32,23
142,MCO,P005985,P011212,0 days 00:15:37,1,43,42
142,MCO,P011196,P011226,0 days 00:15:17,1,37,36
142,MCO,P010588,P012709,0 days 00:15:01,10,31,21
142,MCO,P010588,P011226,0 days 00:14:39,-5,35,40
142,MCO,P011196,P011212,0 days 00:14:36,2,36,34
142,MCO,P011212,P011231,0 days 00:13:31,-1,31,32
142,MCO,P010588,PLCZ,0 days 00:13:00,4,25,21
142,MCO,P012709,PLCZ,0 days 00:12:07,9,25,16
142,MCO,P011231,PLCZ,0 days 00:12:07,9,25,16
142,MCO,P005985,PLCZ,0 days 00:12:07,9,25,16
142,MCO,P010588,P011212,0 days 00:11:45,-6,29,35
142,MCO,P004790,P011226,0 days 00:08:48,13,23,10
142,MCO,P004790,P011196,0 days 00:08:32,13,23,10
142,MCO,P004790,P011212,0 days 00:07:51,14,22,8
142,MCO,P005985,P011196,0 days 00:07:29,-5,21,26
142,MCO,P008099,P011212,0 days 00:06:46,2,13,11
142,MCO,P008099,P011226,0 days 00:06:46,2,13,11
142,MCO,P008099,P011196,0 days 00:05:53,7,13,6
142,MCO,P004790,P008099,0 days 00:05:53,7,13,6
142,MCO,P011226,P012709,0 days 00:05:30,-1,10,11
142,MCO,P011196,P011231,0 days 00:04:42,-6,8,14
142,MCO,P004790,P005985,0 days 00:02:55,6,10,4
142,MCO,P011196,P012709,0 days 00:02:36,-2,4,6
142,MCO,P010588,P011196,0 days 00:02:03,-6,6,12
142,MCO,P011212,P012709,0 days 00:01:55,-1,3,4
142,MCO,P004790,P012709,0 days 00:00:57,-1,1,2
142,MCO,P008099,P010588,0 days 00:00:53,-5,0,5
142,MCO,P008099,PLCZ,0 days 00:00:53,-5,0,5
142,MCO,P011212,PLCZ,0 days 00:00:53,-5,0,5
142,MCO,P011226,PLCZ,0 days 00:00:53,-5,0,5
142,MCO,P004790,P010588,0 days 00:00:16,0,0,0
143,ASV,P004194,P011225,0 days 00:30:09,-4,50,54
143,ASV,P011225,P012080,0 days 00:23:55,-11,39,50
143,ASV,P011225,P012729,0 days 00:23:29,-6,44,50
143,ASV,P004194,P012080,0 days 00:22:35,-5,38,43
143,ASV,P004194,P012729,0 days 00:18:56,-1,33,34
143,ASV,P012729,P012730,0 days 00:18:52,-6,37,43
143,ASV,P012080,P012729,0 days 00:16:43,-10,30,40
143,ASV,P011225,P012730,0 days 00:15:58,-3,29,32
143,ASV,P004194,P006568,0 days 00:14:48,-1,25,26
143,ASV,P006568,P011225,0 days 00:14:48,-1,25,26
143,ASV,P003526,P004194,0 days 00:14:11,-8,21,29
143,ASV,P003526,P011225,0 days 00:14:11,-8,21,29
143,ASV,P003526,P006568,0 days 00:12:28,-7,19,26
143,ASV,P012080,P012730,0 days 00:12:12,-6,21,27
143,ASV,P000229,P012729,0 days 00:11:51,-1,28,29
143,ASV,P011225,PKIR,0 days 00:10:44,0,23,23
143,ASV,P006568,P012080,0 days 00:10:34,-1,19,20
143,ASV,P004194,P012730,0 days 00:10:26,2,16,14
143,ASV,P012729,PKIR,0 days 00:10:06,-7,25,32
143,ASV,P003526,P012080,0 days 00:09:57,-8,15,23
143,ASV,P000229,P012730,0 days 00:09:55,0,24,24
143,ASV,P012730,PKIR,0 days 00:09:18,-8,21,29
143,ASV,P012080,PKIR,0 days 00:08:11,2,19,17
143,ASV,P000229,P011225,0 days 00:07:32,2,18,16
143,ASV,P000229,PKIR,0 days 00:07:30,-3,20,23
143,ASV,P000229,P004194,0 days 00:05:18,1,10,9
143,ASV,P004194,PKIR,0 days 00:05:12,5,10,5
143,ASV,P003526,P012729,0 days 00:04:45,1,8,7
143,ASV,P000229,P012080,0 days 00:03:48,0,10,10
143,ASV,P006568,PKIR,0 days 00:03:32,4,6,2
143,ASV,P006568,P012729,0 days 00:03:02,2,6,4
143,ASV,P012080,P012731,0 days 00:02:57,-5,5,10
143,ASV,P012729,P012731,0 days 00:02:57,-5,5,10
143,ASV,P004194,P012731,0 days 00:02:57,-5,5,10
143,ASV,P011225,P012731,0 days 00:01:58,-5,3,8
143,ASV,P003526,PKIR,0 days 00:01:12,-2,0,2
143,ASV,P000229,P012731,0 days 00:00:59,0,2,2
143,ASV,P000229,P011386,0 days 00:00:31,-3,0,3
143,ASV,P011386,P012729,0 days 00:00:31,-3,0,3
143,ASV,P011386,P012730,0 days 00:00:31,-3,0,3
143,ASV,P011386,PKIR,0 days 00:00:31,-3,0,3
143,OLY,P008811,P010612,0 days 00:28:58,8,58,50
143,OLY,P008811,P008829,0 days 00:22:19,11,47,36
143,OLY,P008829,P010612,0 days 00:22:09,8,48,40
143,OLY,P007982,P008811,0 days 00:20:58,4,45,41
143,OLY,P001255,P008811,0 days 00:17:55,6,40,34
143,OLY,P007982,P010612,0 days 00:17:10,4,35,31
143,OLY,P007853,P007982,0 days 00:16:48,3,34,31
143,OLY,P001255,P010612,0 days 00:16:08,5,35,30
143,OLY,P001255,P008829,0 days 00:15:09,4,32,28
143,OLY,P007982,P011194,0 days 00:14:48,4,33,29
143,OLY,P008829,P008855,0 days 00:14:02,5,28,23
143,OLY,P008811,P008855,0 days 00:13:00,6,25,19
143,OLY,P007853,P008811,0 days 00:13:00,2,24,22
143,OLY,P008855,P010612,0 days 00:12:50,3,26,23
143,OLY,P001255,P008855,0 days 00:12:50,3,26,23
143,OLY,P007853,P011194,0 days 00:11:49,5,28,23
143,OLY,P008811,P011194,0 days 00:11:39,-1,23,24
143,OLY,P007982,P008829,0 days 00:11:10,3,24,21
143,OLY,P007982,P010392,0 days 00:10:00,7,26,19
143,OLY,P007853,P010612,0 days 00:08:00,0,12,12
143,OLY,P010612,P011194,0 days 00:07:51,-1,13,14
143,OLY,P008811,P010392,0 days 00:06:51,2,16,14
143,OLY,P007853,P008829,0 days 00:06:11,0,8,8
143,OLY,P010392,P011194,0 days 00:06:08,3,14,11
143,OLY,P001255,P007982,0 days 00:06:07,2,17,15
143,OLY,P010392,P010612,0 days 00:05:52,2,14,12
143,OLY,P006589,P007982,0 days 00:05:00,3,12,9
143,OLY,P006589,P007853,0 days 00:05:00,3,12,9
143,OLY,P007853,P010392,0 days 00:04:08,5,12,7
143,OLY,P008829,P010392,0 days 00:03:52,4,12,8
143,OLY,P001255,P011194,0 days 00:03:48,1,11,10
143,OLY,P006589,P010392,0 days 00:03:09,5,10,5
143,OLY,P006589,P011194,0 days 00:03:09,5,10,5
143,OLY,P008829,P011983,0 days 00:03:03,0,4,4
143,OLY,P007853,P011983,0 days 00:03:03,0,4,4
143,OLY,P001255,P007853,0 days 00:02:49,0,8,8
143,OLY,P006589,P011983,0 days 00:01:51,-2,2,4
143,OLY,P006589,P008829,0 days 00:01:51,-2,2,4
143,OLY,P007982,P011983,0 days 00:01:51,-2,2,4
143,OLY,P007853,P008855,0 days 00:01:12,2,2,0
143,OLY,P008811,P011983,0 days 00:01:12,2,2,0
143,OLY,P008855,P011983,0 days 00:01:12,2,2,0
143,OLY,P001255,P003941,0 days 00:01:02,-1,3,4
143,OLY,P003941,P008829,0 days 00:01:02,-1,3,4
143,OLY,P003941,P008855,0 days 00:01:02,-1,3,4
143,OLY,P003941,P010612,0 days 00:01:02,-1,3,4
144,ZAL,P002329,P007109,0 days 00:26:09,3,52,49
144,ZAL,P007109,P011218,0 days 00:25:05,15,54,39
144,ZAL,P002329,P011218,0 days 00:20:16,4,39,35
144,ZAL,P005504,P007109,0 days 00:18:57,13,44,31
144,ZAL,P002329,P005504,0 days 00:17:53,-8,34,42
144,ZAL,P003211,P007109,0 days 00:16:39,0,31,31
144,ZAL,P002329,P007513,0 days 00:16:30,7,37,30
144,ZAL,P003211,P005504,0 days 00:16:15,-4,31,35
144,ZAL,P005504,P011218,0 days 00:14:50,15,33,18
144,ZAL,P007109,P007513,0 days 00:14:44,8,36,28
144,ZAL,P002329,P003211,0 days 00:13:54,-16,17,33
144,ZAL,P003211,P011218,0 days 00:11:48,4,20,16
144,ZAL,P003211,P009917,0 days 00:11:42,-1,22,23
144,ZAL,P007109,P010390,0 days 00:11:24,1,23,22
144,ZAL,P005504,P007513,0 days 00:11:14,6,28,22
144,ZAL,P010390,P011218,0 days 00:10:52,5,26,21
144,ZAL,P002329,P010390,0 days 00:10:26,0,20,20
144,ZAL,P007513,P011218,0 days 00:10:06,10,25,15
144,ZAL,P005504,P009917,0 days 00:09:48,1,22,21
144,ZAL,P007109,P009917,0 days 00:07:49,2,17,15
144,ZAL,P009917,P011218,0 days 00:07:48,6,20,14
144,ZAL,P003211,P007513,0 days 00:06:31,-3,12,15
144,ZAL,P006860,P009917,0 days 00:05:52,-6,12,18
144,ZAL,P010390,P012787,0 days 00:05:49,2,14,12
144,ZAL,P007513,P010390,0 days 00:05:41,1,9,8
144,ZAL,P006860,P012787,0 days 00:05:35,-8,11,19
144,ZAL,P003211,P010390,0 days 00:05:15,-4,7,11
144,ZAL,P002329,P009917,0 days 00:04:56,-12,4,16
144,ZAL,P011218,P012787,0 days 00:04:56,4,14,10
144,ZAL,P009917,P012787,0 days 00:04:44,0,11,11
144,ZAL,P009917,P010390,0 days 00:04:29,-2,8,10
144,ZAL,P002329,P012787,0 days 00:04:20,-7,9,16
144,ZAL,P003211,P006860,0 days 00:04:15,-11,6,17
144,ZAL,P003211,P012787,0 days 00:03:50,-11,6,17
144,ZAL,P005504,P006860,0 days 00:03:38,-13,7,20
144,ZAL,P007109,P012787,0 days 00:03:29,1,9,8
144,ZAL,P005504,P012787,0 days 00:03:15,-9,6,15
144,ZAL,P006860,P010390,0 days 00:03:05,-1,5,6
144,ZAL,P003210,P009917,0 days 00:02:29,-7,3,10
144,ZAL,P007513,P009917,0 days 00:02:11,-1,1,2
144,ZAL,P002329,P003210,0 days 00:01:58,-5,3,8
144,ZAL,P003210,P007109,0 days 00:01:48,-3,2,5
144,ZAL,P006860,P011218,0 days 00:01:47,1,5,4
144,ZAL,P003210,P005504,0 days 00:01:34,-5,3,8
144,ZAL,P002329,P006860,0 days 00:01:34,-14,1,15
144,ZAL,P003210,P010390,0 days 00:00:55,-2,0,2
144,ZAL,P003210,P006860,0 days 00:00:41,-4,1,5
144,ZAL,P003210,P003211,0 days 00:00:31,-2,0,2
144,ZAL,P006860,P007513,0 days 00:00:25,0,0,0
144,ZAL,P007513,P012787,0 days 00:00:18,0,0,0
144,BAR,P004866,P006435,0 days 00:27:11,6,56,50
144,BAR,P000925,P004866,0 days 00:25:11,12,52,40
144,BAR,P004866,P012745,0 days 00:24:30,2,48,46
144,BAR,P002939,P004866,0 days 00:23:35,0,45,45
144,BAR,P002939,P012745,0 days 00:23:31,5,53,48
144,BAR,P002939,P006435,0 days 00:22:55,2,48,46
144,BAR,P006435,P012745,0 days 00:22:06,4,47,43
144,BAR,P000925,P006435,0 days 00:21:33,11,45,34
144,BAR,P000925,P002939,0 days 00:15:44,4,29,25
144,BAR,P000925,P012745,0 days 00:15:43,8,30,22
144,BAR,P004866,P007519,0 days 00:12:37,4,27,23
144,BAR,P004866,P011244,0 days 00:11:42,2,24,22
144,BAR,P003196,P012745,0 days 00:09:58,-6,23,29
144,BAR,P000925,P011244,0 days 00:09:28,4,22,18
144,BAR,P000925,P007519,0 days 00:09:27,8,23,15
144,BAR,P007519,P009992,0 days 00:09:03,-5,16,21
144,BAR,P002939,P003196,0 days 00:09:02,-4,21,25
144,BAR,P004866,P009992,0 days 00:09:01,-2,16,18
144,BAR,P003196,P004866,0 days 00:08:01,-6,18,24
144,BAR,P007519,P011244,0 days 00:07:50,6,19,13
144,BAR,P007519,P012745,0 days 00:07:02,-4,13,17
144,BAR,P006435,P011244,0 days 00:06:38,5,17,12
144,BAR,P009992,P012745,0 days 00:06:12,-1,14,15
144,BAR,P006435,P007519,0 days 00:05:49,7,16,9
144,BAR,P003196,P006435,0 days 00:05:21,-3,11,14
144,BAR,P009992,P011244,0 days 00:05:04,-3,7,10
144,BAR,P003196,P009992,0 days 00:04:55,-5,12,17
144,BAR,P002939,P009992,0 days 00:04:28,-1,10,11
144,BAR,P002939,P011244,0 days 00:03:52,-4,5,9
144,BAR,P000925,P009992,0 days 00:03:38,1,7,6
144,BAR,P003196,P007519,0 days 00:03:29,-6,7,13
144,BAR,P004866,P010641,0 days 00:03:00,-2,2,4
144,BAR,P009992,P010641,0 days 00:02:43,0,2,2
144,BAR,P002939,P010641,0 days 00:02:37,1,8,7
144,BAR,P010641,P012745,0 days 00:02:37,1,8,7
144,BAR,P002939,P007519,0 days 00:02:15,-2,5,7
144,BAR,P007519,P010641,0 days 00:01:56,0,2,2
144,BAR,P010641,P011244,0 days 00:01:56,0,2,2
144,BAR,P006435,P010641,0 days 00:01:50,1,8,7
144,BAR,P002939,P007464,0 days 00:01:33,3,8,5
144,BAR,P006435,P007464,0 days 00:01:33,3,8,5
144,BAR,P007464,P010641,0 days 00:01:33,3,8,5
144,BAR,P007464,P012745,0 days 00:01:33,3,8,5
144,BAR,P003196,P011244,0 days 00:00:18,-2,0,2
145,IST,P007200,P012788,0 days 00:25:10,-4,50,54
145,IST,P011078,P012786,0 days 00:24:21,1,56,55
145,IST,P007200,P012786,0 days 00:24:11,-6,47,53
145,IST,P006590,P007200,0 days 00:23:13,-11,40,51
145,IST,P007200,P011078,0 days 00:23:02,-7,50,57
145,IST,P011078,P012788,0 days 00:19:31,0,42,42
145,IST,P012786,P012788,0 days 00:18:41,5,39,34
145,IST,P006590,P012788,0 days 00:18:34,-2,37,39
145,IST,P007200,P009846,0 days 00:17:31,-2,39,41
145,IST,P006590,P012786,0 days 00:17:23,-7,28,35
145,IST,P009846,P012788,0 days 00:17:13,5,40,35
145,IST,P006590,P009846,0 days 00:14:17,-2,27,29
145,IST,P007200,P011981,0 days 00:13:45,-9,26,35
145,IST,P006590,P011078,0 days 00:13:27,-7,25,32
145,IST,P011078,P011981,0 days 00:13:05,-3,31,34
145,IST,P009846,P012786,0 days 00:11:36,5,29,24
145,IST,P011981,P012786,0 days 00:11:32,2,30,28
145,IST,P011981,P012788,0 days 00:10:36,-5,19,24
145,IST,P009846,P011078,0 days 00:10:26,6,31,25
145,IST,P009846,P011981,0 days 00:08:54,1,21,20
145,IST,P012710,P012788,0 days 00:07:57,5,23,18
145,IST,P007200,P012710,0 days 00:07:57,5,23,18
145,IST,P009846,P012710,0 days 00:06:48,3,21,18
145,IST,P006590,P011981,0 days 00:05:40,-6,5,11
145,IST,P006590,P012710,0 days 00:05:33,1,15,14
145,IST,P004554,P012786,0 days 00:04:53,-6,7,13
145,IST,P004554,P007200,0 days 00:04:53,-6,7,13
145,IST,P004554,P006590,0 days 00:04:53,-6,7,13
145,IST,P004554,P011078,0 days 00:02:54,-2,7,9
145,IST,P011078,P012710,0 days 00:02:24,4,8,4
145,IST,P004554,P009846,0 days 00:01:59,-4,0,4
145,IST,P007200,P009513,0 days 00:01:38,0,2,2
145,IST,P009513,P011078,0 days 00:01:38,0,2,2
145,IST,P009513,P012786,0 days 00:01:38,0,2,2
145,IST,P009513,P012788,0 days 00:01:38,0,2,2
145,IST,P012710,P012786,0 days 00:01:09,2,2,0
145,ULK,P006661,P008962,0 days 00:26:59,10,66,56
145,ULK,P001932,P006661,0 days 00:25:40,9,61,52
145,ULK,P001932,P008962,0 days 00:24:08,6,58,52
145,ULK,P006961,P008962,0 days 00:20:03,8,40,32
145,ULK,P005844,P008962,0 days 00:16:56,9,38,29
145,ULK,P004004,P008962,0 days 00:16:24,7,40,33
145,ULK,P006661,P006961,0 days 00:14:11,12,29,17
145,ULK,P005844,P006961,0 days 00:13:30,12,28,16
145,ULK,P004004,P005844,0 days 00:13:11,6,29,23
145,ULK,P005844,P006661,0 days 00:11:22,8,27,19
145,ULK,P001932,P006961,0 days 00:11:20,8,21,13
145,ULK,P004004,P006961,0 days 00:10:42,5,24,19
145,ULK,P008962,P010560,0 days 00:10:27,-3,27,30
145,ULK,P001932,P005844,0 days 00:10:24,8,25,17
145,ULK,P006661,P010560,0 days 00:10:04,4,27,23
145,ULK,P001932,P010560,0 days 00:10:04,4,27,23
145,ULK,P008962,P011157,0 days 00:09:54,-1,24,25
145,ULK,P006661,P011157,0 days 00:09:54,-1,24,25
145,ULK,P001932,P011157,0 days 00:09:54,-1,24,25
145,ULK,P008962,P009849,0 days 00:09:19,-5,17,22
145,ULK,P002968,P008962,0 days 00:09:07,-7,19,26
145,ULK,P004004,P006661,0 days 00:09:00,8,26,18
145,ULK,P010560,P011157,0 days 00:08:32,1,24,23
145,ULK,P004004,P009849,0 days 00:08:19,-1,14,15
145,ULK,P006961,P009849,0 days 00:07:24,-1,14,15
145,ULK,P005844,P009849,0 days 00:07:06,4,14,10
145,ULK,P002968,P006661,0 days 00:06:54,2,16,14
145,ULK,P002968,P006961,0 days 00:06:26,-1,13,14
145,ULK,P001932,P004004,0 days 00:06:09,4,18,14
145,ULK,P001932,P002968,0 days 00:05:01,-2,10,12
145,ULK,P002968,P009849,0 days 00:04:18,-12,6,18
145,ULK,P002968,P011052,0 days 00:04:00,-7,6,13
145,ULK,P009849,P011052,0 days 00:04:00,-7,6,13
145,ULK,P002968,P004004,0 days 00:03:51,-1,9,10
145,ULK,P002968,P010560,0 days 00:03:05,-7,6,13
145,ULK,P009849,P010560,0 days 00:03:05,-7,6,13
145,ULK,P010560,P011052,0 days 00:03:05,-7,6,13
145,ULK,P011052,P011980,0 days 00:02:10,-3,3,6
145,ULK,P002968,P011980,0 days 00:02:05,-3,3,6
145,ULK,P009849,P011980,0 days 00:02:05,-3,3,6
145,ULK,P008962,P011052,0 days 00:01:55,-4,3,7
145,ULK,P006961,P010560,0 days 00:01:32,3,3,0
145,ULK,P005844,P010560,0 days 00:01:32,3,3,0
145,ULK,P006961,P011157,0 days 00:01:22,-2,0,2
145,ULK,P010560,P011980,0 days 00:01:10,-3,3,6
145,ULK,P004004,P011052,0 days 00:01:00,0,0,0
145,ULK,P004004,P011980,0 days 00:01:00,0,0,0
145,ULK,P005844,P011052,0 days 00:00:05,0,0,0
145,ULK,P005844,P011980,0 days 00:00:05,0,0,0
145,ULK,P006961,P011052,0 days 00:00:05,0,0,0
145,ULK,P006961,P011980,0 days 00:00:05,0,0,0
145,ULK,P002968,P005844,0 days 00:00:01,-2,0,2
146,MIL,P002849,P011205,0 days 00:25:40,17,54,37
146,MIL,P005670,P007201,0 days 00:23:44,24,56,32
146,MIL,P005670,P011205,0 days 00:22:30,21,54,33
146,MIL,P007201,P011205,0 days 00:21:29,16,48,32
146,MIL,P002849,P007201,0 days 00:21:27,15,48,33
146,MIL,P002849,P005670,0 days 00:21:23,22,52,30
146,MIL,P002812,P011205,0 days 00:21:15,10,42,32
146,MIL,P002812,P002849,0 days 00:20:03,12,40,28
146,MIL,P002812,P007201,0 days 00:19:47,13,40,27
146,MIL,P002812,P005670,0 days 00:16:11,19,38,19
146,MIL,P006509,P009960,0 days 00:15:12,1,27,26
146,MIL,P002849,P006509,0 days 00:13:57,-4,21,25
146,MIL,P006509,P011205,0 days 00:13:15,-4,23,27
146,MIL,P002849,P005775,0 days 00:12:39,-14,13,27
146,MIL,P005670,P006509,0 days 00:11:52,4,27,23
146,MIL,P005775,P006509,0 days 00:11:48,-8,12,20
146,MIL,P002849,P009960,0 days 00:11:09,2,20,18
146,MIL,P006509,P007201,0 days 00:10:56,3,22,19
146,MIL,P005670,P009960,0 days 00:10:43,8,26,18
146,MIL,P005775,P011205,0 days 00:09:12,-6,13,19
146,MIL,P005775,P009960,0 days 00:09:00,-2,11,13
146,MIL,P009960,P011205,0 days 00:08:56,2,18,16
146,MIL,P007201,P009960,0 days 00:07:14,7,18,11
146,MIL,P002812,P006509,0 days 00:06:18,-10,4,14
146,MIL,P005775,P007201,0 days 00:06:01,-6,8,14
146,MIL,P002812,P005775,0 days 00:05:36,-8,4,12
146,MIL,P005670,P005775,0 days 00:04:13,-2,7,9
146,MIL,P006509,P006701,0 days 00:02:54,-6,0,6
146,MIL,P006701,P009960,0 days 00:02:24,-6,0,6
146,MIL,P005775,P006701,0 days 00:01:51,-2,0,2
146,MIL,P002849,P006701,0 days 00:01:34,-2,0,2
146,MIL,P002812,P006701,0 days 00:01:20,-4,0,4
146,MIL,P006701,P011205,0 days 00:01:03,-4,0,4
146,MIL,P005670,P006721,0 days 00:00:52,-2,2,4
146,MIL,P005670,P011926,0 days 00:00:52,-2,2,4
146,MIL,P006509,P006721,0 days 00:00:52,-2,2,4
146,MIL,P006509,P011926,0 days 00:00:52,-2,2,4
146,MIL,P006721,P011205,0 days 00:00:52,-2,2,4
146,MIL,P006721,P011926,0 days 00:00:52,-2,2,4
146,MIL,P011205,P011926,0 days 00:00:52,-2,2,4
146,MIL,P002812,P009960,0 days 00:00:50,-4,0,4
146,MIL,P006701,P007201,0 days 00:00:30,0,0,0
146,BAS,P007230,P012201,0 days 00:23:01,7,40,33
146,BAS,P007230,P009048,0 days 00:22:44,-17,34,51
146,BAS,P004761,P009048,0 days 00:21:21,-16,37,53
146,BAS,P004761,P007230,0 days 00:20:09,-9,36,45
146,BAS,P010444,P012201,0 days 00:18:10,0,30,30
146,BAS,P007230,P011948,0 days 00:16:12,-5,26,31
146,BAS,P012201,P012765,0 days 00:15:46,11,27,16
146,BAS,P007230,P010444,0 days 00:15:30,5,28,23
146,BAS,P007230,P012765,0 days 00:15:09,13,27,14
146,BAS,P009048,P012201,0 days 00:13:04,-9,19,28
146,BAS,P004603,P007230,0 days 00:12:49,-15,18,33
146,BAS,P004603,P004761,0 days 00:12:39,-13,18,31
146,BAS,P004603,P009048,0 days 00:12:39,-13,18,31
146,BAS,P009048,P011948,0 days 00:11:54,-7,20,27
146,BAS,P011085,P012201,0 days 00:11:01,4,24,20
146,BAS,P004761,P012201,0 days 00:10:29,-1,21,22
146,BAS,P007230,P011085,0 days 00:09:50,10,24,14
146,BAS,P010444,P012765,0 days 00:09:44,11,18,7
146,BAS,P009048,P010444,0 days 00:09:41,-11,16,27
146,BAS,P011948,P012201,0 days 00:09:30,-2,13,15
146,BAS,P010444,P011948,0 days 00:09:06,-4,13,17
146,BAS,P004761,P011948,0 days 00:09:01,-3,17,20
146,BAS,P004761,P010444,0 days 00:08:57,-3,18,21
146,BAS,P011085,P012765,0 days 00:07:25,5,16,11
146,BAS,P010444,P011085,0 days 00:06:32,2,13,11
146,BAS,P009048,P011085,0 days 00:06:23,0,14,14
146,BAS,P004761,P011085,0 days 00:06:23,0,14,14
146,BAS,P004603,P011948,0 days 00:06:07,-5,9,14
146,BAS,P008072,P012201,0 days 00:05:52,2,9,7
146,BAS,P008072,P012765,0 days 00:05:52,2,9,7
146,BAS,P007230,P008072,0 days 00:05:52,2,9,7
146,BAS,P011948,P012765,0 days 00:04:58,0,6,6
146,BAS,P008072,P011085,0 days 00:04:01,2,9,7
146,BAS,P004603,P011085,0 days 00:02:57,-1,6,7
146,BAS,P003198,P004603,0 days 00:02:52,-7,2,9
146,BAS,P003198,P004761,0 days 00:02:52,-7,2,9
146,BAS,P003198,P007230,0 days 00:02:52,-7,2,9
146,BAS,P003198,P009048,0 days 00:02:52,-7,2,9
146,BAS,P004761,P012765,0 days 00:02:09,4,5,1
146,BAS,P008072,P009048,0 days 00:01:51,0,0,0
146,BAS,P009048,P012765,0 days 00:01:51,0,0,0
146,BAS,P004603,P012201,0 days 00:01:03,-4,1,5
146,BAS,P011085,P011948,0 days 00:00:40,-2,0,2
146,BAS,P004603,P012765,0 days 00:00:10,-2,0,2
147,MUN,P006760,P008985,0 days 00:19:42,6,46,40
147,MUN,P006760,P007056,0 days 00:19:07,-6,38,44
147,MUN,P007056,P008985,0 days 00:17:38,-7,36,43
147,MUN,P001288,P004508,0 days 00:17:23,6,41,35
147,MUN,P001288,P008985,0 days 00:16:56,3,43,40
147,MUN,P007056,P011987,0 days 00:16:17,0,30,30
147,MUN,P008985,P011987,0 days 00:15:18,2,34,32
147,MUN,P006760,P011987,0 days 00:14:37,3,30,27
147,MUN,P001288,P007056,0 days 00:14:21,-12,27,39
147,MUN,P001288,P006760,0 days 00:13:33,7,37,30
147,MUN,P006760,P007639,0 days 00:13:26,14,34,20
147,MUN,P007639,P008985,0 days 00:12:47,13,32,19
147,MUN,P001288,P010391,0 days 00:11:38,-3,23,26
147,MUN,P004508,P007639,0 days 00:11:01,12,30,18
147,MUN,P004508,P007975,0 days 00:10:39,-13,17,30
147,MUN,P004508,P010391,0 days 00:10:38,5,23,18
147,MUN,P004508,P007056,0 days 00:10:28,-6,21,27
147,MUN,P001288,P007639,0 days 00:09:59,15,29,14
147,MUN,P007056,P007639,0 days 00:09:15,2,18,16
147,MUN,P007056,P007975,0 days 00:09:08,-4,13,17
147,MUN,P004508,P008985,0 days 00:08:45,9,26,17
147,MUN,P004508,P006760,0 days 00:08:29,8,26,18
147,MUN,P001288,P011987,0 days 00:08:28,0,20,20
147,MUN,P007639,P011987,0 days 00:07:58,5,17,12
147,MUN,P001557,P004508,0 days 00:06:37,-3,12,15
147,MUN,P007639,P010391,0 days 00:06:03,3,13,10
147,MUN,P007056,P010391,0 days 00:05:58,-9,9,18
147,MUN,P001288,P007975,0 days 00:05:45,-8,8,16
147,MUN,P008985,P010391,0 days 00:04:58,-6,11,17
147,MUN,P001557,P007975,0 days 00:04:47,-8,5,13
147,MUN,P007975,P010391,0 days 00:04:23,-4,5,9
147,MUN,P006543,P007975,0 days 00:04:16,-3,5,8
147,MUN,P001557,P006543,0 days 00:04:04,-3,5,8
147,MUN,P007639,P007975,0 days 00:04:02,0,9,9
147,MUN,P001288,P001557,0 days 00:03:53,2,9,7
147,MUN,P006760,P007975,0 days 00:03:39,1,9,8
147,MUN,P001557,P005460,0 days 00:03:12,-4,6,10
147,MUN,P004508,P005460,0 days 00:03:12,-4,6,10
147,MUN,P001557,P010391,0 days 00:03:10,7,9,2
147,MUN,P004508,P006543,0 days 00:02:44,-5,3,8
147,MUN,P006543,P007056,0 days 00:02:32,-1,2,3
147,MUN,P005460,P007975,0 days 00:02:27,-7,3,10
147,MUN,P001557,P007639,0 days 00:02:25,4,6,2
147,MUN,P001557,P007056,0 days 00:02:20,-1,2,3
147,MUN,P007975,P011987,0 days 00:02:10,2,2,0
147,MUN,P010391,P011987,0 days 00:01:52,-3,4,7
147,MUN,P005460,P006543,0 days 00:01:44,-2,3,5
147,MUN,P006543,P011987,0 days 00:01:32,2,2,0
147,MUN,P001288,P005460,0 days 00:01:28,-2,3,5
147,MUN,P001557,P011987,0 days 00:01:20,2,2,0
147,MUN,P005460,P010391,0 days 00:00:45,3,3,0
147,MUN,P006760,P010391,0 days 00:00:39,-5,0,5
147,MUN,P004508,P011987,0 days 00:00:20,3,3,0
147,MUN,P006543,P006760,0 days 00:00:12,0,0,0
147,PAM,P010568,P012740,0 days 00:23:46,0,51,51
147,PAM,P007870,P010568,0 days 00:22:34,-3,50,53
147,PAM,P010393,P010568,0 days 00:21:04,-9,42,51
147,PAM,P006643,P010568,0 days 00:20:28,-4,35,39
147,PAM,P007870,P010393,0 days 00:19:03,-7,40,47
147,PAM,P007870,P012740,0 days 00:18:05,2,43,41
147,PAM,P006643,P012740,0 days 00:17:54,-1,32,33
147,PAM,P006643,P010393,0 days 00:17:46,-5,32,37
147,PAM,P010393,P012740,0 days 00:17:05,0,37,37
147,PAM,P012738,P012795,0 days 00:16:07,8,39,31
147,PAM,P006643,P007870,0 days 00:15:41,-3,30,33
147,PAM,P008780,P012795,0 days 00:13:11,3,30,27
147,PAM,P012738,P012739,0 days 00:12:00,6,28,22
147,PAM,P005356,P012738,0 days 00:11:54,6,26,20
147,PAM,P005356,P012795,0 days 00:11:12,-1,23,24
147,PAM,P008780,P012738,0 days 00:10:59,5,25,20
147,PAM,P005356,P008780,0 days 00:10:23,3,23,20
147,PAM,P012739,P012795,0 days 00:09:28,5,25,20
147,PAM,P010568,P012795,0 days 00:09:18,-5,23,28
147,PAM,P007870,P012795,0 days 00:09:15,-7,19,26
147,PAM,P010568,P012738,0 days 00:08:47,8,21,13
147,PAM,P005356,P012739,0 days 00:08:18,8,22,14
147,PAM,P008780,P012739,0 days 00:07:18,5,19,14
147,PAM,P012738,P012740,0 days 00:07:00,3,16,13
147,PAM,P010568,P012739,0 days 00:06:04,-1,9,10
147,PAM,P007870,P012738,0 days 00:05:54,1,12,11
147,PAM,P012740,P012795,0 days 00:05:49,-2,16,18
147,PAM,P007870,P008780,0 days 00:05:13,-4,9,13
147,PAM,P012739,P012740,0 days 00:05:04,-4,6,10
147,PAM,P010393,P012795,0 days 00:04:22,-7,9,16
147,PAM,P005356,P007870,0 days 00:04:11,-7,5,12
147,PAM,P006643,P012739,0 days 00:03:54,-1,3,4
147,PAM,P005356,P010568,0 days 00:03:19,-2,6,8
147,PAM,P006643,P012738,0 days 00:03:13,3,5,2
147,PAM,P005356,P006643,0 days 00:02:54,-3,3,6
147,PAM,P008780,P010393,0 days 00:02:52,0,7,7
147,PAM,P008780,P010568,0 days 00:02:48,0,7,7
147,PAM,P005356,P010393,0 days 00:02:36,-2,5,7
147,PAM,P010393,P012739,0 days 00:01:22,-2,0,2
147,PAM,P010393,P012738,0 days 00:01:06,4,4,0
147,PAM,P006643,P012795,0 days 00:00:22,-2,0,2
147,PAM,P005356,P012740,0 days 00:00:21,2,3,1
148,ASV,P011225,PKIR,0 days 00:26:24,18,64,46
148,ASV,P004194,P011225,0 days 00:26:16,13,59,46
148,ASV,P011225,P012080,0 days 00:24:47,13,57,44
148,ASV,P012080,PKIR,0 days 00:23:04,12,57,45
148,ASV,P004194,PKIR,0 days 00:22:56,19,57,38
148,ASV,P004194,P012080,0 days 00:22:55,19,57,38
148,ASV,P011225,P012729,0 days 00:19:22,-12,30,42
148,ASV,P004194,P006568,0 days 00:17:17,11,38,27
148,ASV,P006568,P011225,0 days 00:17:17,11,38,27
148,ASV,P006568,P012080,0 days 00:16:47,14,38,24
148,ASV,P012729,P012730,0 days 00:14:53,-15,19,34
148,ASV,P000229,P012729,0 days 00:14:01,-13,17,30
148,ASV,P006568,PKIR,0 days 00:13:57,17,36,19
148,ASV,P012080,P012729,0 days 00:13:51,-6,27,33
148,ASV,P012729,PKIR,0 days 00:12:51,-1,28,29
148,ASV,P000229,P012730,0 days 00:11:52,-8,17,25
148,ASV,P011225,P012730,0 days 00:11:52,-13,13,26
148,ASV,P004194,P012729,0 days 00:10:29,-2,21,23
148,ASV,P000229,P011225,0 days 00:09:10,-9,9,18
148,ASV,P012730,PKIR,0 days 00:08:41,-8,13,21
148,ASV,P012080,P012730,0 days 00:08:32,-12,10,22
148,ASV,P003526,P012729,0 days 00:08:05,-9,8,17
148,ASV,P003526,P012730,0 days 00:08:02,-9,8,17
148,ASV,P000229,P003526,0 days 00:06:55,-9,8,17
148,ASV,P000229,PKIR,0 days 00:06:36,-1,9,10
148,ASV,P003526,P011225,0 days 00:05:28,-9,2,11
148,ASV,P000229,P012080,0 days 00:04:51,-4,8,12
148,ASV,P003526,P012080,0 days 00:03:45,0,6,6
148,ASV,P006568,P012729,0 days 00:03:20,-6,2,8
148,ASV,P004194,P012730,0 days 00:03:00,-3,4,7
148,ASV,P000229,P004194,0 days 00:02:09,-5,0,5
148,ASV,P000229,P006568,0 days 00:00:30,-3,0,3
148,ASV,P003526,PKIR,0 days 00:00:03,0,0,0
148,ASV,P003526,P004194,0 days 00:00:02,0,0,0
148,MAD,P005791,P005928,0 days 00:20:09,-17,32,49
148,MAD,P001392,P005928,0 days 00:19:17,-12,33,45
148,MAD,P005928,P006540,0 days 00:18:00,0,33,33
148,MAD,P001392,P006540,0 days 00:17:50,-1,32,33
148,MAD,P003733,PTGB,0 days 00:16:43,10,36,26
148,MAD,P005791,P006540,0 days 00:16:42,-5,32,37
148,MAD,P001392,P005791,0 days 00:16:07,-18,26,44
148,MAD,P005791,PTGB,0 days 00:14:32,-4,27,31
148,MAD,P006540,P009213,0 days 00:14:04,-13,21,34
148,MAD,P004887,P006540,0 days 00:13:42,20,33,13
148,MAD,P003733,P005791,0 days 00:13:19,-4,26,30
148,MAD,P003733,PCVM,0 days 00:12:53,16,31,15
148,MAD,P001392,P004887,0 days 00:12:39,6,28,22
148,MAD,P005791,P009213,0 days 00:12:18,-21,17,38
148,MAD,P005928,P009213,0 days 00:11:56,-18,14,32
148,MAD,P003733,P004887,0 days 00:11:47,19,31,12
148,MAD,P004887,PCVM,0 days 00:11:18,15,27,12
148,MAD,PCVM,PTGB,0 days 00:11:09,15,24,9
148,MAD,P001392,P009213,0 days 00:10:37,-12,14,26
148,MAD,P004887,P005928,0 days 00:09:45,3,21,18
148,MAD,P004887,P005791,0 days 00:09:09,4,20,16
148,MAD,P004887,PTGB,0 days 00:08:41,9,18,9
148,MAD,P003733,P006540,0 days 00:08:15,15,25,10
148,MAD,P006540,PTGB,0 days 00:07:35,11,21,10
148,MAD,P003733,P011649,0 days 00:07:20,4,12,8
148,MAD,P003733,P005928,0 days 00:06:47,-5,12,17
148,MAD,P001392,P003733,0 days 00:06:39,-2,16,18
148,MAD,P005791,PCVM,0 days 00:06:36,5,14,9
148,MAD,P005928,PTGB,0 days 00:06:20,-7,9,16
148,MAD,P006540,PCVM,0 days 00:05:30,13,15,2
148,MAD,P011649,PCVM,0 days 00:05:12,1,9,8
148,MAD,P011649,PTGB,0 days 00:04:51,4,6,2
148,MAD,P009213,PTGB,0 days 00:04:50,-9,7,16
148,MAD,P005791,P011649,0 days 00:04:32,4,6,2
148,MAD,P001392,PCVM,0 days 00:03:41,0,9,9
148,MAD,P003733,P009213,0 days 00:03:39,-9,7,16
148,MAD,P004887,P009213,0 days 00:03:07,0,4,4
148,MAD,P004887,P011649,0 days 00:02:56,0,6,6
148,MAD,P001392,P011649,0 days 00:02:37,0,6,6
148,MAD,P001392,PTGB,0 days 00:02:31,-9,4,13
148,MAD,P005928,P011649,0 days 00:02:16,3,3,0
148,MAD,P009213,PCVM,0 days 00:01:07,-2,0,2
148,MAD,P005928,PCVM,0 days 00:00:46,1,3,2
148,MAD,P009213,P011649,0 days 00:00:08,0,0,0
148,MAD,P001392,P010868,0 days 00:00:02,0,0,0
148,MAD,P003733,P010868,0 days 00:00:02,0,0,0
148,MAD,P006540,P010868,0 days 00:00:02,0,0,0
148,MAD,P009213,P010868,0 days 00:00:02,0,0,0
149,ZAL,P002329,P011218,0 days 00:24:32,12,52,40
149,ZAL,P007109,P011218,0 days 00:23:46,9,50,41
149,ZAL,P002329,P007109,0 days 00:23:45,2,46,44
149,ZAL,P002329,P007513,0 days 00:17:24,2,33,31
149,ZAL,P007513,P011218,0 days 00:17:22,7,35,28
149,ZAL,P005504,P011218,0 days 00:15:51,0,31,31
149,ZAL,P007109,P007513,0 days 00:15:48,2,29,27
149,ZAL,P002329,P005504,0 days 00:15:21,3,32,29
149,ZAL,P005504,P007109,0 days 00:15:02,-1,29,30
149,ZAL,P007109,P012787,0 days 00:13:39,0,28,28
149,ZAL,P011218,P012787,0 days 00:12:38,0,26,26
149,ZAL,P005504,P012787,0 days 00:12:38,-6,23,29
149,ZAL,P002329,P012787,0 days 00:12:28,1,25,24
149,ZAL,P010390,P011218,0 days 00:11:05,2,22,20
149,ZAL,P005504,P007513,0 days 00:10:22,-2,17,19
149,ZAL,P007513,P012715,0 days 00:10:18,-5,13,18
149,ZAL,P002329,P010390,0 days 00:08:30,2,17,15
149,ZAL,P002329,P012715,0 days 00:07:52,-2,11,13
149,ZAL,P007109,P010390,0 days 00:07:19,8,18,10
149,ZAL,P003211,P012715,0 days 00:07:07,-9,6,15
149,ZAL,P011218,P012715,0 days 00:06:56,-4,11,15
149,ZAL,P007513,P010390,0 days 00:06:34,0,15,15
149,ZAL,P007513,P012787,0 days 00:06:21,-7,7,14
149,ZAL,P003211,P007513,0 days 00:05:00,-2,7,9
149,ZAL,P007109,P012715,0 days 00:04:40,-1,7,8
149,ZAL,P003211,P006860,0 days 00:04:34,-2,6,8
149,ZAL,P003210,P009917,0 days 00:04:04,-11,4,15
149,ZAL,P003211,P010390,0 days 00:04:00,-4,5,9
149,ZAL,P006860,P012715,0 days 00:03:59,1,6,5
149,ZAL,P009917,P010390,0 days 00:03:54,-12,2,14
149,ZAL,P006860,P007513,0 days 00:03:51,3,8,5
149,ZAL,P006860,P011218,0 days 00:03:41,-1,6,7
149,ZAL,P002329,P003211,0 days 00:03:36,-7,2,9
149,ZAL,P003210,P010390,0 days 00:03:32,-12,0,12
149,ZAL,P006860,P010390,0 days 00:03:21,-6,4,10
149,ZAL,P003210,P006860,0 days 00:03:15,-6,4,10
149,ZAL,P012715,P012787,0 days 00:03:13,-3,2,5
149,ZAL,P003210,P012715,0 days 00:03:06,-4,4,8
149,ZAL,P003211,P009917,0 days 00:03:03,-1,6,7
149,ZAL,P003210,P003211,0 days 00:03:02,-3,4,7
149,ZAL,P002329,P006860,0 days 00:02:57,3,6,3
149,ZAL,P003211,P007109,0 days 00:02:54,3,7,4
149,ZAL,P009917,P012715,0 days 00:02:52,-6,4,10
149,ZAL,P005504,P012715,0 days 00:02:45,-2,4,6
149,ZAL,P006860,P009917,0 days 00:02:40,-6,4,10
149,ZAL,P009917,P011218,0 days 00:02:34,-8,2,10
149,ZAL,P010390,P012715,0 days 00:02:24,-9,0,9
149,ZAL,P003211,P012787,0 days 00:02:17,0,2,2
149,ZAL,P006860,P012787,0 days 00:02:17,0,2,2
149,ZAL,P003210,P011218,0 days 00:02:12,-8,0,8
149,ZAL,P003211,P011218,0 days 00:02:11,3,5,2
149,ZAL,P010390,P012787,0 days 00:01:57,3,5,2
149,ZAL,P007109,P009917,0 days 00:00:36,2,2,0
149,ZAL,P002329,P003210,0 days 00:00:35,0,0,0
149,ZAL,P003210,P007109,0 days 00:00:35,0,0,0
149,ZAL,P003210,P007513,0 days 00:00:35,0,0,0
149,ZAL,P005504,P006860,0 days 00:00:25,2,2,0
149,ZAL,P003211,P005504,0 days 00:00:24,2,2,0
149,ZAL,P007513,P009917,0 days 00:00:21,-2,0,2
149,TEL,P009622,P009783,0 days 00:27:58,2,55,53
149,TEL,P009783,P011199,0 days 00:25:17,1,50,49
149,TEL,P009622,P011199,0 days 00:25:17,1,50,49
149,TEL,P009622,P011193,0 days 00:20:17,10,44,34
149,TEL,P009622,P011219,0 days 00:17:38,-12,26,38
149,TEL,P009783,P011219,0 days 00:15:55,-10,24,34
149,TEL,P009783,P011193,0 days 00:15:36,16,41,25
149,TEL,P011193,P011199,0 days 00:14:08,11,36,25
149,TEL,P011199,P011219,0 days 00:13:49,-8,22,30
149,TEL,P011193,P011214,0 days 00:12:46,9,26,17
149,TEL,P007990,P011219,0 days 00:11:52,-3,20,23
149,TEL,P007990,P009622,0 days 00:11:36,-14,13,27
149,TEL,P011193,P011971,0 days 00:10:47,8,26,18
149,TEL,P011193,P011219,0 days 00:10:21,8,24,16
149,TEL,P007990,P011214,0 days 00:10:18,1,20,19
149,TEL,P007990,P011193,0 days 00:10:16,3,21,18
149,TEL,P004233,P011214,0 days 00:10:09,15,25,10
149,TEL,P004233,P011193,0 days 00:09:35,13,23,10
149,TEL,P007990,P009783,0 days 00:09:08,-9,11,20
149,TEL,P011214,P011219,0 days 00:07:59,4,16,12
149,TEL,P009622,P011214,0 days 00:07:56,-3,10,13
149,TEL,P007990,P011199,0 days 00:07:55,-5,11,16
149,TEL,P009622,P011971,0 days 00:07:41,5,19,14
149,TEL,P004233,P007990,0 days 00:06:47,11,19,8
149,TEL,P011214,P011971,0 days 00:05:59,1,10,9
149,TEL,P009622,P012744,0 days 00:05:43,-5,6,11
149,TEL,P011199,P012744,0 days 00:04:59,-5,6,11
149,TEL,P009783,P012744,0 days 00:04:59,-5,6,11
149,TEL,P011219,P012744,0 days 00:04:59,-5,6,11
149,TEL,P005145,P009622,0 days 00:04:55,2,9,7
149,TEL,P005145,P009783,0 days 00:04:55,2,9,7
149,TEL,P005145,P011199,0 days 00:04:55,2,9,7
149,TEL,P009783,P011971,0 days 00:04:48,7,16,9
149,TEL,P011199,P011971,0 days 00:04:48,7,16,9
149,TEL,P004233,P011971,0 days 00:04:35,3,9,6
149,TEL,P004233,P011219,0 days 00:04:20,9,13,4
149,TEL,P004233,P009622,0 days 00:04:11,6,8,2
149,TEL,P007990,P011971,0 days 00:03:51,0,7,7
149,TEL,P005145,P011193,0 days 00:03:26,2,7,5
149,TEL,P009783,P011214,0 days 00:02:41,1,5,4
149,TEL,P005145,P007990,0 days 00:01:29,0,2,2
149,TEL,P004233,P012744,0 days 00:00:44,0,0,0
149,TEL,P011193,P012744,0 days 00:00:44,0,0,0
149,TEL,P011214,P012744,0 days 00:00:44,0,0,0
149,TEL,P011219,P011971,0 days 00:00:39,1,1,0
149,TEL,P004233,P009783,0 days 00:00:35,3,3,0
150,PAN,P003842,P011204,0 days 00:22:24,17,56,39
150,PAN,P001926,P003842,0 days 00:21:15,15,53,38
150,PAN,P003842,P007866,0 days 00:21:06,10,53,43
150,PAN,P001926,P012774,0 days 00:18:40,7,34,27
150,PAN,P001926,P007866,0 days 00:18:29,10,44,34
150,PAN,P007866,P011204,0 days 00:16:09,10,44,34
150,PAN,P003842,P012774,0 days 00:15:31,4,32,28
150,PAN,P002328,P011204,0 days 00:15:00,10,37,27
150,PAN,P002328,P003842,0 days 00:14:59,13,39,26
150,PAN,P001926,P011204,0 days 00:14:16,15,40,25
150,PAN,P012712,P012774,0 days 00:12:13,10,22,12
150,PAN,P007866,P012774,0 days 00:12:06,-1,23,24
150,PAN,P007947,P011204,0 days 00:11:31,1,20,19
150,PAN,P002328,P007866,0 days 00:11:22,11,32,21
150,PAN,P001926,P002328,0 days 00:10:59,9,30,21
150,PAN,P011204,P012774,0 days 00:10:52,6,23,17
150,PAN,P007947,P012712,0 days 00:10:23,3,15,12
150,PAN,P001926,P012712,0 days 00:09:56,6,18,12
150,PAN,P011204,P012712,0 days 00:09:44,6,16,10
150,PAN,P001926,P011209,0 days 00:09:16,-1,14,15
150,PAN,P007947,P012774,0 days 00:09:15,4,17,13
150,PAN,P011221,P012774,0 days 00:08:46,5,13,8
150,PAN,P011209,P012774,0 days 00:08:34,1,14,13
150,PAN,P003842,P012712,0 days 00:08:18,7,16,9
150,PAN,P003842,P007947,0 days 00:08:04,2,16,14
150,PAN,P011221,P012712,0 days 00:07:16,3,11,8
150,PAN,P001926,P011221,0 days 00:07:08,1,9,8
150,PAN,P007866,P011209,0 days 00:07:06,0,11,11
150,PAN,P003842,P011209,0 days 00:05:59,0,11,11
150,PAN,P007947,P011221,0 days 00:05:57,4,10,6
150,PAN,P002328,P007947,0 days 00:05:53,-1,9,10
150,PAN,P002328,P012712,0 days 00:05:35,-3,7,10
150,PAN,P007866,P007947,0 days 00:04:45,0,11,11
150,PAN,P001926,P007947,0 days 00:03:37,2,6,4
150,PAN,P011209,P011221,0 days 00:03:22,-1,3,4
150,PAN,P011204,P011221,0 days 00:02:20,2,4,2
150,PAN,P011209,P012712,0 days 00:02:15,-1,3,4
150,PAN,P007866,P011221,0 days 00:02:12,0,2,2
150,PAN,P002328,P012774,0 days 00:01:15,0,2,2
150,PAN,P002328,P007553,0 days 00:01:07,-3,0,3
150,PAN,P007553,P007947,0 days 00:01:07,-3,0,3
150,PAN,P007553,P011204,0 days 00:01:07,-3,0,3
150,PAN,P007553,P012712,0 days 00:01:07,-3,0,3
150,PAN,P002328,P011221,0 days 00:00:51,-2,0,2
150,PAN,P002328,P011209,0 days 00:00:47,-2,0,2
150,PAN,P011204,P011209,0 days 00:00:05,0,0,0
150,PAN,P007866,P012712,0 days 00:00:01,0,0,0
150,RED,P000848,P007960,0 days 00:16:59,-2,25,27
150,RED,P002553,PJDR,0 days 00:16:53,-4,28,32
150,RED,P000848,P012044,0 days 00:16:00,0,31,31
150,RED,P000848,P006436,0 days 00:15:47,-10,22,32
150,RED,P002553,P009035,0 days 00:15:28,-8,28,36
150,RED,P009035,P012044,0 days 00:15:01,-7,29,36
150,RED,P006436,P007960,0 days 00:14:16,-4,20,24
150,RED,P009035,PLUO,0 days 00:13:21,-8,24,32
150,RED,P009035,PJDR,0 days 00:13:20,-11,22,33
150,RED,P002553,PLUO,0 days 00:12:56,-5,24,29
150,RED,PJDR,PLUO,0 days 00:12:09,-8,22,30
150,RED,P000848,P009035,0 days 00:11:51,-2,20,22
150,RED,P007960,P012044,0 days 00:11:41,-5,17,22
150,RED,P005099,P009035,0 days 00:11:16,1,17,16
150,RED,P000848,P005099,0 days 00:10:46,-5,17,22
150,RED,P002553,P012044,0 days 00:09:33,-5,21,26
150,RED,P000848,P002553,0 days 00:08:42,5,18,13
150,RED,P006436,P012044,0 days 00:08:32,-7,14,21
150,RED,P005099,P012044,0 days 00:08:30,-3,15,18
150,RED,P000848,P008966,0 days 00:08:25,-1,15,16
150,RED,P005099,P007960,0 days 00:08:19,-6,11,17
150,RED,P012044,PJDR,0 days 00:08:10,-11,13,24
150,RED,P008966,P012044,0 days 00:08:06,0,13,13
150,RED,P007960,P008966,0 days 00:07:58,-4,11,15
150,RED,P005099,PLUO,0 days 00:06:49,2,11,9
150,RED,P002553,P006436,0 days 00:06:35,-4,10,14
150,RED,P000848,PJDR,0 days 00:06:07,1,10,9
150,RED,P007960,PJDR,0 days 00:06:05,-1,8,9
150,RED,P012044,PLUO,0 days 00:06:05,-6,13,19
150,RED,P006436,P009035,0 days 00:06:02,-13,4,17
150,RED,P006436,PJDR,0 days 00:05:55,-4,8,12
150,RED,P006436,P008966,0 days 00:05:34,-2,10,12
150,RED,P002553,P005099,0 days 00:05:30,3,9,6
150,RED,P005099,PJDR,0 days 00:05:18,1,7,6
150,RED,P007960,P009035,0 days 00:04:54,0,6,6
150,RED,P005099,P006436,0 days 00:04:26,-9,4,13
150,RED,P009035,P012711,0 days 00:03:59,-5,6,11
150,RED,P002553,P007960,0 days 00:03:58,4,6,2
150,RED,P005099,P008966,0 days 00:03:45,-1,5,6
150,RED,P000848,P012711,0 days 00:03:34,-2,6,8
150,RED,P005099,P012711,0 days 00:03:34,-2,6,8
150,RED,P012044,P012711,0 days 00:02:56,-1,6,7
150,RED,P002553,P004720,0 days 00:02:12,1,4,3
150,RED,P004720,P009035,0 days 00:02:12,1,4,3
150,RED,P006436,PLUO,0 days 00:02:09,-6,2,8
150,RED,P008966,PJDR,0 days 00:02:07,-5,2,7
150,RED,P004720,P012044,0 days 00:02:06,1,4,3
150,RED,P000848,PLUO,0 days 00:02:02,0,4,4
150,RED,P004720,P006436,0 days 00:01:25,-1,2,3
150,RED,P004720,PLUO,0 days 00:01:25,-1,2,3
150,RED,P002553,P008966,0 days 00:01:21,1,4,3
150,RED,P007960,PLUO,0 days 00:01:19,-1,2,3
150,RED,P004720,P007960,0 days 00:01:19,-1,2,3
150,RED,P004720,P005099,0 days 00:01:19,-1,2,3
150,RED,P004720,PJDR,0 days 00:01:11,-3,0,3
150,RED,P006436,P012711,0 days 00:01:03,-4,0,4
150,RED,P000848,P004720,0 days 00:00:55,4,4,0
150,RED,P012711,PJDR,0 days 00:00:25,-3,0,3
150,RED,P012711,PLUO,0 days 00:00:25,-3,0,3
151,BER,P006251,P010791,0 days 00:17:51,-4,29,33
151,BER,P003958,P008967,0 days 00:17:47,-14,32,46
151,BER,P008173,P011934,0 days 00:16:41,-23,25,48
151,BER,P003958,P011934,0 days 00:16:34,-15,29,44
151,BER,P008967,P011934,0 days 00:16:34,-15,29,44
151,BER,P008173,P008967,0 days 00:16:06,-19,29,48
151,BER,P007025,P010791,0 days 00:14:25,-1,24,25
151,BER,P008211,P010791,0 days 00:13:50,-4,20,24
151,BER,P006251,P007025,0 days 00:13:36,2,22,20
151,BER,P003958,P008173,0 days 00:13:08,-17,21,38
151,BER,P011934,P012721,0 days 00:12:17,-14,23,37
151,BER,P010791,P012720,0 days 00:11:52,8,22,14
151,BER,P006251,P008211,0 days 00:11:48,-2,15,17
151,BER,P008173,P012721,0 days 00:11:28,-11,21,32
151,BER,P011934,P012720,0 days 00:11:20,-16,14,30
151,BER,P008173,P012720,0 days 00:10:59,-18,12,30
151,BER,P007025,P008211,0 days 00:10:56,-1,14,15
151,BER,P008211,P012720,0 days 00:10:07,12,22,10
151,BER,P006251,P012720,0 days 00:10:00,5,19,14
151,BER,P008967,P012721,0 days 00:09:49,-10,19,29
151,BER,P008967,P012720,0 days 00:09:39,-8,16,24
151,BER,P010791,P012721,0 days 00:09:15,-16,8,24
151,BER,P003958,P012720,0 days 00:09:00,-9,13,22
151,BER,P003958,P012721,0 days 00:08:47,-5,19,24
151,BER,P008173,P010791,0 days 00:08:09,-4,16,20
151,BER,P006251,P008173,0 days 00:07:30,-6,16,22
151,BER,P008211,P012721,0 days 00:07:09,-14,6,20
151,BER,P006251,P012721,0 days 00:06:55,-15,4,19
151,BER,P008211,P008967,0 days 00:06:20,-1,14,15
151,BER,P007025,P012721,0 days 00:06:07,-9,6,15
151,BER,P008967,P010791,0 days 00:05:52,-5,14,19
151,BER,P007025,P012720,0 days 00:05:20,10,10,0
151,BER,P003958,P008211,0 days 00:04:39,3,11,8
151,BER,P006251,P008967,0 days 00:04:39,-6,11,17
151,BER,P008211,P011934,0 days 00:04:15,-1,10,11
151,BER,P007025,P008173,0 days 00:03:29,0,10,10
151,BER,P011631,P012720,0 days 00:03:26,-2,6,8
151,BER,P008173,P011631,0 days 00:03:26,-2,6,8
151,BER,P006251,P011631,0 days 00:03:26,-2,6,8
151,BER,P007025,P008967,0 days 00:02:58,-2,8,10
151,BER,P010791,P011934,0 days 00:02:55,-5,4,9
151,BER,P012720,P012721,0 days 00:02:41,-6,2,8
151,BER,P010791,P011631,0 days 00:02:34,-2,4,6
151,BER,P006251,P011934,0 days 00:01:27,-4,2,6
151,BER,P003958,P010791,0 days 00:01:13,1,3,2
151,BER,P011631,P011934,0 days 00:00:52,0,2,2
151,BER,P007025,P011934,0 days 00:00:49,-3,2,5
151,OLY,P001255,P008829,0 days 00:21:46,18,52,34
151,OLY,P007982,P010392,0 days 00:20:00,14,48,34
151,OLY,P003941,P010392,0 days 00:19:24,13,47,34
151,OLY,P003941,P007982,0 days 00:19:24,13,47,34
151,OLY,P001255,P008855,0 days 00:19:16,13,46,33
151,OLY,P008811,P008829,0 days 00:19:01,19,47,28
151,OLY,P008829,P010612,0 days 00:18:42,18,46,28
151,OLY,P001255,P008811,0 days 00:18:42,18,46,28
151,OLY,P008811,P010612,0 days 00:18:42,18,46,28
151,OLY,P001255,P010612,0 days 00:18:42,18,46,28
151,OLY,P008811,P008855,0 days 00:18:34,19,47,28
151,OLY,P008829,P008855,0 days 00:18:17,19,47,28
151,OLY,P008855,P010612,0 days 00:17:58,18,46,28
151,OLY,P003941,P006589,0 days 00:13:37,4,31,27
151,OLY,P003941,P007853,0 days 00:13:22,1,27,26
151,OLY,P007853,P007982,0 days 00:12:21,6,27,21
151,OLY,P007853,P010392,0 days 00:12:21,6,27,21
151,OLY,P006589,P010392,0 days 00:12:19,9,31,22
151,OLY,P006589,P007982,0 days 00:12:19,9,31,22
151,OLY,P006589,P007853,0 days 00:09:21,-3,17,20
151,OLY,P007982,P008829,0 days 00:08:08,5,17,12
151,OLY,P008829,P010392,0 days 00:07:24,5,17,12
151,OLY,P003941,P008829,0 days 00:07:05,4,16,12
151,OLY,P003941,P008855,0 days 00:05:34,2,14,12
151,OLY,P006589,P008855,0 days 00:05:34,2,14,12
151,OLY,P008855,P010392,0 days 00:04:52,8,15,7
151,OLY,P007982,P008855,0 days 00:04:52,8,15,7
151,OLY,P001255,P003941,0 days 00:04:22,-5,6,11
151,OLY,P007853,P008829,0 days 00:04:01,4,10,6
151,OLY,P001255,P007982,0 days 00:03:48,0,6,6
151,OLY,P001255,P010392,0 days 00:03:04,0,6,6
151,OLY,P007853,P008855,0 days 00:01:35,-5,0,5
151,OLY,P007982,P008811,0 days 00:01:20,1,1,0
151,OLY,P001255,P006589,0 days 00:01:18,-5,0,5
151,OLY,P001255,P007853,0 days 00:01:18,-5,0,5
151,OLY,P007982,P010612,0 days 00:00:44,0,0,0
151,OLY,P008811,P010392,0 days 00:00:36,1,1,0
151,OLY,P007853,P008811,0 days 00:00:17,0,0,0
152,MCO,P011212,P011226,0 days 00:20:56,24,55,31
152,MCO,P011196,P011212,0 days 00:19:42,25,53,28
152,MCO,P011196,P011226,0 days 00:19:35,24,56,32
152,MCO,P005985,P011231,0 days 00:19:23,-7,33,40
152,MCO,P005985,P010588,0 days 00:18:42,-2,32,34
152,MCO,P010588,P011231,0 days 00:17:04,-1,30,31
152,MCO,P005985,P008099,0 days 00:16:56,-2,34,36
152,MCO,P008099,P011231,0 days 00:16:39,-1,31,32
152,MCO,P004790,P011226,0 days 00:15:40,23,50,27
152,MCO,P004790,P011212,0 days 00:15:23,24,47,23
152,MCO,P008099,P010588,0 days 00:14:56,1,28,27
152,MCO,P005985,PLCZ,0 days 00:14:50,5,31,26
152,MCO,P011231,PLCZ,0 days 00:14:35,5,31,26
152,MCO,P004790,P011196,0 days 00:14:17,24,48,24
152,MCO,P010588,PLCZ,0 days 00:13:07,7,28,21
152,MCO,P008099,PLCZ,0 days 00:12:51,7,29,22
152,MCO,P011212,P012709,0 days 00:12:08,7,25,18
152,MCO,P011226,P012709,0 days 00:12:08,7,25,18
152,MCO,P011196,P012709,0 days 00:12:08,7,25,18
152,MCO,P004790,P005985,0 days 00:12:02,12,35,23
152,MCO,P005985,P011212,0 days 00:10:56,15,32,17
152,MCO,P005985,P011226,0 days 00:10:48,14,36,22
152,MCO,P005985,P011196,0 days 00:07:51,17,31,14
152,MCO,P011212,P011231,0 days 00:07:26,-2,10,12
152,MCO,P004790,P012709,0 days 00:07:26,3,17,14
152,MCO,P011226,P011231,0 days 00:07:01,-2,11,13
152,MCO,P011196,P011231,0 days 00:05:42,0,8,8
152,MCO,P004790,P010588,0 days 00:05:11,-9,4,13
152,MCO,P011231,P012709,0 days 00:04:42,4,8,4
152,MCO,P004790,P008099,0 days 00:04:05,-9,5,14
152,MCO,P004790,P011231,0 days 00:03:48,-8,2,10
152,MCO,P010588,P011212,0 days 00:03:46,-3,4,7
152,MCO,P008099,P011226,0 days 00:02:00,-3,6,9
152,MCO,P011212,PLCZ,0 days 00:01:59,-2,2,4
152,MCO,P011226,PLCZ,0 days 00:01:58,-2,3,5
152,MCO,P010588,P011226,0 days 00:01:38,-1,2,3
152,MCO,P010588,P011196,0 days 00:00:24,0,0,0
152,MCO,P008099,P011196,0 days 00:00:17,-1,3,4
152,BAR,P002939,P006435,0 days 00:19:56,-14,35,49
152,BAR,P007464,P012745,0 days 00:17:43,-13,35,48
152,BAR,P000925,P006435,0 days 00:16:50,-10,27,37
152,BAR,P002939,P012745,0 days 00:15:24,-11,24,35
152,BAR,P002939,P004866,0 days 00:15:20,-9,25,34
152,BAR,P000925,P002939,0 days 00:14:14,-8,24,32
152,BAR,P006435,P012745,0 days 00:14:09,-16,22,38
152,BAR,P000925,P004866,0 days 00:13:24,-13,18,31
152,BAR,P004866,P006435,0 days 00:13:09,-6,23,29
152,BAR,P007519,P012745,0 days 00:13:05,-4,25,29
152,BAR,P007464,P007519,0 days 00:12:56,-2,26,28
152,BAR,P000925,P012745,0 days 00:11:31,-7,20,27
152,BAR,P006435,P007464,0 days 00:10:40,-12,17,29
152,BAR,P010641,P012745,0 days 00:10:15,-9,18,27
152,BAR,P007519,P009992,0 days 00:09:31,-6,17,23
152,BAR,P000925,P011244,0 days 00:09:25,-8,12,20
152,BAR,P000925,P007464,0 days 00:09:15,0,19,19
152,BAR,P009992,P012745,0 days 00:08:30,-7,13,20
152,BAR,P000925,P007519,0 days 00:08:25,-5,13,18
152,BAR,P004866,P011244,0 days 00:07:49,-11,9,20
152,BAR,P007464,P010641,0 days 00:07:15,-9,12,21
152,BAR,P004866,P012745,0 days 00:06:52,-4,10,14
152,BAR,P002939,P007464,0 days 00:06:23,-8,12,20
152,BAR,P006435,P011244,0 days 00:06:13,-6,6,12
152,BAR,P004866,P009992,0 days 00:05:23,-5,8,13
152,BAR,P002939,P010641,0 days 00:05:21,-11,6,17
152,BAR,P003196,P012745,0 days 00:04:58,0,9,9
152,BAR,P007519,P010641,0 days 00:04:54,2,12,10
152,BAR,P006435,P010641,0 days 00:04:51,-10,6,16
152,BAR,P007519,P011244,0 days 00:04:48,1,9,8
152,BAR,P002939,P011244,0 days 00:04:37,-9,3,12
152,BAR,P003196,P009992,0 days 00:04:34,0,9,9
152,BAR,P007464,P009992,0 days 00:04:34,-5,9,14
152,BAR,P003196,P007519,0 days 00:04:34,0,9,9
152,BAR,P003204,P012745,0 days 00:04:29,7,12,5
152,BAR,P000925,P003204,0 days 00:04:20,1,9,8
152,BAR,P006435,P007519,0 days 00:04:17,-4,5,9
152,BAR,P002939,P003196,0 days 00:04:17,3,9,6
152,BAR,P003204,P006435,0 days 00:04:15,4,12,8
152,BAR,P002939,P003204,0 days 00:04:15,4,12,8
152,BAR,P003204,P007464,0 days 00:04:05,7,12,5
152,BAR,P003204,P007519,0 days 00:04:05,7,12,5
152,BAR,P009992,P010641,0 days 00:03:56,-7,4,11
152,BAR,P002939,P009992,0 days 00:03:56,-2,4,6
152,BAR,P003204,P004866,0 days 00:03:51,4,12,8
152,BAR,P000925,P009992,0 days 00:03:12,-2,6,8
152,BAR,P004866,P007519,0 days 00:03:12,-2,6,8
152,BAR,P009992,P011244,0 days 00:03:12,-2,6,8
152,BAR,P004866,P010641,0 days 00:03:00,0,6,6
152,BAR,P003196,P007464,0 days 00:02:49,-1,7,8
152,BAR,P003196,P003204,0 days 00:02:32,2,7,5
152,BAR,P003196,P006435,0 days 00:02:32,2,7,5
152,BAR,P003196,P004866,0 days 00:02:08,2,7,5
152,BAR,P002939,P007519,0 days 00:01:45,1,2,1
152,BAR,P007464,P011244,0 days 00:01:36,3,3,0
152,BAR,P003204,P010641,0 days 00:01:28,8,8,0
153,PAR,P004058,P007400,0 days 00:29:31,7,61,54
153,PAR,P007400,P008987,0 days 00:26:35,5,55,50
153,PAR,P007400,P009862,0 days 00:24:36,-8,43,51
153,PAR,P004058,P008987,0 days 00:24:05,5,51,46
153,PAR,P004058,P009862,0 days 00:23:21,-8,41,49
153,PAR,P008987,P009862,0 days 00:19:10,-10,33,43
153,PAR,P009862,P012096,0 days 00:17:00,-24,19,43
153,PAR,P008987,P012096,0 days 00:16:26,0,31,31
153,PAR,P007400,P012096,0 days 00:16:26,0,31,31
153,PAR,P007400,P012743,0 days 00:15:35,7,34,27
153,PAR,P009862,P012743,0 days 00:15:35,7,34,27
153,PAR,P004058,P012096,0 days 00:15:11,0,29,29
153,PAR,P004058,P012743,0 days 00:14:20,7,32,25
153,PAR,P004172,P012096,0 days 00:13:27,-3,21,24
153,PAR,P012096,P012742,0 days 00:11:11,0,23,23
153,PAR,P008987,P012743,0 days 00:10:09,5,24,19
153,PAR,P009862,P012742,0 days 00:09:14,-9,12,21
153,PAR,P004172,P012742,0 days 00:09:14,-9,12,21
153,PAR,P009212,P009862,0 days 00:07:59,-9,10,19
153,PAR,P009212,P012096,0 days 00:07:59,-9,10,19
153,PAR,P009212,P012742,0 days 00:07:59,-9,10,19
153,PAR,P004172,P009862,0 days 00:07:59,-9,10,19
153,PAR,P004172,P009212,0 days 00:07:59,-9,10,19
153,PAR,P004172,P007400,0 days 00:05:28,6,11,5
153,PAR,P004172,P008987,0 days 00:05:28,6,11,5
153,PAR,P000956,P004058,0 days 00:05:26,2,10,8
153,PAR,P000956,P007400,0 days 00:05:26,2,10,8
153,PAR,P000956,P009862,0 days 00:05:26,2,10,8
153,PAR,P000956,P012743,0 days 00:05:26,2,10,8
153,PAR,P007400,P012742,0 days 00:04:27,9,15,6
153,PAR,P008987,P012742,0 days 00:04:27,9,15,6
153,PAR,P004058,P004172,0 days 00:04:13,6,9,3
153,PAR,P004058,P012742,0 days 00:01:57,9,11,2
153,PAR,P012742,P012743,0 days 00:01:15,0,2,2
153,VIR,P001133,P001844,0 days 00:23:12,1,42,41
153,VIR,P001133,PBCN,0 days 00:21:50,5,41,36
153,VIR,P001844,PBCN,0 days 00:20:35,2,36,34
153,VIR,P001133,P009549,0 days 00:20:06,2,36,34
153,VIR,P009549,PBCN,0 days 00:18:55,0,32,32
153,VIR,P001844,P009549,0 days 00:18:51,-1,31,32
153,VIR,P001133,P003048,0 days 00:16:55,-3,30,33
153,VIR,P001844,P003048,0 days 00:16:17,-2,30,32
153,VIR,P003048,P009549,0 days 00:13:57,0,26,26
153,VIR,P003048,PBCN,0 days 00:13:40,-1,24,25
153,VIR,P003527,P010781,0 days 00:13:38,4,28,24
153,VIR,P001133,P010781,0 days 00:13:31,-3,27,30
153,VIR,P006739,P010781,0 days 00:13:17,-5,23,28
153,VIR,P010781,P012714,0 days 00:11:07,5,29,24
153,VIR,P003527,P006739,0 days 00:09:56,4,19,15
153,VIR,P001133,P012714,0 days 00:09:45,3,24,21
153,VIR,P004007,P010781,0 days 00:09:01,-11,12,23
153,VIR,P004007,P006739,0 days 00:09:01,-11,12,23
153,VIR,P001844,P010781,0 days 00:08:43,9,24,15
153,VIR,P001133,P006739,0 days 00:08:37,-6,15,21
153,VIR,P003048,P010781,0 days 00:08:23,-1,15,16
153,VIR,P006739,P012714,0 days 00:07:56,1,20,19
153,VIR,P003048,P003527,0 days 00:06:09,-4,9,13
153,VIR,P001844,P012714,0 days 00:05:55,9,17,8
153,VIR,P003527,P012714,0 days 00:05:54,10,18,8
153,VIR,P003527,P004007,0 days 00:05:49,-2,8,10
153,VIR,P001133,P003527,0 days 00:05:18,-3,8,11
153,VIR,P001844,P002084,0 days 00:05:04,-2,7,9
153,VIR,P003048,P006739,0 days 00:05:01,-1,7,8
153,VIR,P001133,P004007,0 days 00:04:47,-11,5,16
153,VIR,P012714,PBCN,0 days 00:04:45,9,15,6
153,VIR,P003048,P004007,0 days 00:04:14,0,7,7
153,VIR,P002084,P010781,0 days 00:04:06,7,13,6
153,VIR,P002084,P012714,0 days 00:04:06,7,13,6
153,VIR,P002084,P003527,0 days 00:04:06,7,13,6
153,VIR,P001844,P003527,0 days 00:03:42,0,9,9
153,VIR,P010781,PBCN,0 days 00:03:41,7,11,4
153,VIR,P004007,P012714,0 days 00:03:12,-9,4,13
153,VIR,P009549,P012714,0 days 00:02:44,5,8,3
153,VIR,P002084,PBCN,0 days 00:02:39,-5,0,5
153,VIR,P002084,P009549,0 days 00:02:39,-5,0,5
153,VIR,P001133,P002084,0 days 00:02:39,-5,0,5
153,VIR,P009549,P010781,0 days 00:01:57,4,6,2
153,VIR,P002084,P006739,0 days 00:01:41,4,6,2
153,VIR,P006739,P009549,0 days 00:01:15,3,5,2
153,VIR,P006739,PBCN,0 days 00:01:15,3,5,2
153,VIR,P001844,P006739,0 days 00:00:09,0,0,0
154,ULK,P006661,P008962,0 days 00:23:53,-2,50,52
154,ULK,P001932,P008962,0 days 00:22:29,-10,44,54
154,ULK,P001932,P006661,0 days 00:20:07,-4,41,45
154,ULK,P008962,P011157,0 days 00:19:41,0,41,41
154,ULK,P006661,P011157,0 days 00:16:31,6,35,29
154,ULK,P001932,P011157,0 days 00:16:16,3,37,34
154,ULK,P004004,P009849,0 days 00:14:50,-3,23,26
154,ULK,P004004,P008962,0 days 00:14:47,-12,20,32
154,ULK,P006961,P008962,0 days 00:13:54,0,31,31
154,ULK,P001932,P004004,0 days 00:12:55,-7,15,22
154,ULK,P006661,P006961,0 days 00:12:38,2,28,26
154,ULK,P006961,P011157,0 days 00:12:03,6,31,25
154,ULK,P001932,P006961,0 days 00:11:12,1,27,26
154,ULK,P009849,P011052,0 days 00:11:00,-6,24,30
154,ULK,P004004,P005844,0 days 00:10:42,4,23,19
154,ULK,P004004,P011052,0 days 00:10:31,3,21,18
154,ULK,P008962,P009849,0 days 00:10:07,-18,19,37
154,ULK,P005844,P011052,0 days 00:09:49,3,21,18
154,ULK,P008962,P011052,0 days 00:08:52,-7,16,23
154,ULK,P004004,P011980,0 days 00:08:39,8,16,8
154,ULK,P009849,P011980,0 days 00:08:39,8,16,8
154,ULK,P004004,P006661,0 days 00:08:36,-1,13,14
154,ULK,P005844,P009849,0 days 00:08:15,0,17,17
154,ULK,P001932,P009849,0 days 00:07:46,-4,11,15
154,ULK,P004004,P011157,0 days 00:07:38,-6,10,16
154,ULK,P001932,P002968,0 days 00:07:23,-5,8,13
154,ULK,P002968,P009849,0 days 00:07:22,-6,12,18
154,ULK,P005844,P008962,0 days 00:07:02,-7,10,17
154,ULK,P011052,P011980,0 days 00:05:08,5,13,8
154,ULK,P005844,P011980,0 days 00:05:08,5,13,8
154,ULK,P002968,P004004,0 days 00:05:06,-2,3,5
154,ULK,P002968,P008962,0 days 00:04:39,-12,9,21
154,ULK,P005844,P006661,0 days 00:03:55,-2,6,8
154,ULK,P006661,P011052,0 days 00:03:46,2,9,7
154,ULK,P002968,P011980,0 days 00:03:31,3,3,0
154,ULK,P001932,P011980,0 days 00:03:31,3,3,0
154,ULK,P002968,P006661,0 days 00:03:27,-6,9,15
154,ULK,P011052,P011157,0 days 00:03:25,-3,4,7
154,ULK,P009849,P011157,0 days 00:03:10,-6,6,12
154,ULK,P006961,P011052,0 days 00:02:42,-1,4,5
154,ULK,P006661,P009849,0 days 00:02:39,-3,9,12
154,ULK,P001932,P005844,0 days 00:02:21,-5,2,7
154,ULK,P005844,P006961,0 days 00:01:27,-4,0,4
154,ULK,P006961,P009849,0 days 00:01:16,-2,3,5
154,ULK,P002968,P011052,0 days 00:00:47,-4,4,8
154,ULK,P002968,P006961,0 days 00:00:24,-2,0,2
154,ULK,P002968,P005844,0 days 00:00:01,-2,0,2
154,RED,P006436,P009035,0 days 00:21:23,4,52,48
154,RED,P005099,P009035,0 days 00:18:08,0,35,35
154,RED,P009035,P010985,0 days 00:17:40,1,41,40
154,RED,P009035,PJDR,0 days 00:16:54,17,40,23
154,RED,P007960,P009035,0 days 00:16:19,-7,27,34
154,RED,P006436,P010985,0 days 00:16:00,1,42,41
154,RED,P007960,P010985,0 days 00:14:54,-11,23,34
154,RED,P006436,PJDR,0 days 00:14:47,11,37,26
154,RED,P000848,P009035,0 days 00:14:27,6,29,23
154,RED,P005099,P006436,0 days 00:14:22,4,38,34
154,RED,P000848,P006436,0 days 00:12:36,16,37,21
154,RED,P005099,P010985,0 days 00:12:16,-1,28,29
154,RED,P006436,P007960,0 days 00:11:40,-8,23,31
154,RED,P008966,P012044,0 days 00:11:14,3,24,21
154,RED,P000848,P012044,0 days 00:09:52,10,22,12
154,RED,P000848,P005099,0 days 00:09:45,0,19,19
154,RED,P006436,PLUO,0 days 00:09:37,9,21,12
154,RED,P000848,P008966,0 days 00:09:36,13,25,12
154,RED,P000848,PJDR,0 days 00:09:25,11,23,12
154,RED,P005099,P007960,0 days 00:09:22,-11,9,20
154,RED,P006436,P008966,0 days 00:09:18,4,23,19
154,RED,P006436,P012044,0 days 00:09:17,1,20,19
154,RED,P008966,PJDR,0 days 00:07:46,-2,15,17
154,RED,P000848,PLUO,0 days 00:07:43,15,23,8
154,RED,P007960,PJDR,0 days 00:07:03,4,16,12
154,RED,P005099,PJDR,0 days 00:07:00,9,15,6
154,RED,P010985,PJDR,0 days 00:06:57,11,21,10
154,RED,P009035,PLUO,0 days 00:06:57,-1,10,11
154,RED,P009035,P012044,0 days 00:06:48,-2,10,12
154,RED,P012044,PJDR,0 days 00:06:39,-5,10,15
154,RED,P007960,PLUO,0 days 00:05:36,-3,8,11
154,RED,P008966,PLUO,0 days 00:05:22,11,16,5
154,RED,P008966,P009035,0 days 00:05:08,-2,8,10
154,RED,PJDR,PLUO,0 days 00:05:05,6,12,6
154,RED,P000848,P007960,0 days 00:04:47,-1,5,6
154,RED,P000848,P010985,0 days 00:04:41,-2,9,11
154,RED,P012044,PLUO,0 days 00:03:58,8,11,3
154,RED,P010985,PLUO,0 days 00:02:54,-4,3,7
154,RED,P006436,P011941,0 days 00:02:48,-6,3,9
154,RED,P011941,PJDR,0 days 00:02:48,-6,3,9
154,RED,P005099,P012044,0 days 00:02:17,0,5,5
154,RED,P005099,PLUO,0 days 00:02:04,-1,0,1
154,RED,P007960,P011941,0 days 00:01:34,-3,1,4
154,RED,P010985,P011941,0 days 00:01:34,-3,1,4
154,RED,P008966,P011941,0 days 00:01:14,-3,2,5
154,RED,P011941,P012044,0 days 00:01:14,-3,2,5
154,RED,P005099,P008966,0 days 00:00:54,0,3,3
154,RED,P007960,P012044,0 days 00:00:17,0,0,0
155,TEL,P009622,P009783,0 days 00:24:59,8,62,54
155,TEL,P009622,P011219,0 days 00:23:57,12,60,48
155,TEL,P009622,P009863,0 days 00:21:03,3,50,47
155,TEL,P009783,P009863,0 days 00:20:42,6,50,44
155,TEL,P009622,P011199,0 days 00:20:30,-4,48,52
155,TEL,P009783,P011199,0 days 00:19:36,3,48,45
155,TEL,P009863,P011199,0 days 00:18:50,3,46,43
155,TEL,P009783,P011219,0 days 00:18:48,8,48,40
155,TEL,P011199,P011219,0 days 00:15:09,4,36,32
155,TEL,P009863,P011219,0 days 00:14:31,6,36,30
155,TEL,P009622,P011193,0 days 00:13:41,1,34,33
155,TEL,P011193,P011971,0 days 00:12:29,1,26,25
155,TEL,P009622,P011971,0 days 00:12:29,-3,29,32
155,TEL,P011193,P011214,0 days 00:12:08,16,30,14
155,TEL,P011193,P011219,0 days 00:09:55,5,26,21
155,TEL,P009863,P011971,0 days 00:08:54,2,21,19
155,TEL,P004233,P011193,0 days 00:08:44,5,21,16
155,TEL,P009863,P011214,0 days 00:07:50,3,13,10
155,TEL,P009863,P011193,0 days 00:07:34,2,17,15
155,TEL,P009622,P011214,0 days 00:07:08,11,17,6
155,TEL,P011214,P011971,0 days 00:06:47,7,15,8
155,TEL,P004233,P009622,0 days 00:06:46,4,17,13
155,TEL,P011219,P011971,0 days 00:06:24,1,14,13
155,TEL,P009783,P011971,0 days 00:05:42,-4,14,18
155,TEL,P011193,P012744,0 days 00:05:21,-4,9,13
155,TEL,P009783,P011193,0 days 00:05:05,3,16,13
155,TEL,P011971,P012744,0 days 00:05:00,-1,9,10
155,TEL,P011199,P011971,0 days 00:05:00,-5,12,17
155,TEL,P004233,P011971,0 days 00:04:59,2,12,10
155,TEL,P005145,P011214,0 days 00:04:51,0,7,7
155,TEL,P009863,P012744,0 days 00:04:48,0,9,9
155,TEL,P004233,P011214,0 days 00:04:31,2,10,8
155,TEL,P011214,P012744,0 days 00:04:27,3,9,6
155,TEL,P004233,P011219,0 days 00:03:54,1,9,8
155,TEL,P005145,P011193,0 days 00:03:26,1,7,6
155,TEL,P004233,P005145,0 days 00:03:26,1,7,6
155,TEL,P005145,P009863,0 days 00:03:23,0,4,4
155,TEL,P009783,P011214,0 days 00:03:20,7,8,1
155,TEL,P011214,P011219,0 days 00:03:10,11,11,0
155,TEL,P005145,P009622,0 days 00:02:53,-1,3,4
155,TEL,P004233,P009863,0 days 00:02:17,3,6,3
155,TEL,P011193,P011199,0 days 00:02:01,-10,2,12
155,TEL,P005145,P009783,0 days 00:01:25,-1,0,1
155,TEL,P009622,P012744,0 days 00:00:54,-7,0,7
155,TEL,P011199,P012744,0 days 00:00:54,-7,0,7
155,TEL,P004233,P009783,0 days 00:00:19,2,2,0
155,MCO,P005985,P011226,0 days 00:28:22,-8,58,66
155,MCO,P010588,P011226,0 days 00:27:46,3,66,63
155,MCO,P005985,P010588,0 days 00:23:14,-1,50,51
155,MCO,P010588,P012709,0 days 00:18:31,7,46,39
155,MCO,P011226,P012709,0 days 00:18:05,8,48,40
155,MCO,P011212,P011231,0 days 00:16:35,-10,31,41
155,MCO,P011212,P011226,0 days 00:14:08,-6,34,40
155,MCO,P005985,P012709,0 days 00:13:33,4,32,28
155,MCO,P005985,P011212,0 days 00:13:28,-16,23,39
155,MCO,P011196,P011212,0 days 00:13:07,-8,24,32
155,MCO,P002581,P005985,0 days 00:11:40,4,28,24
155,MCO,P002581,P011226,0 days 00:11:40,4,28,24
155,MCO,P010588,P011212,0 days 00:11:18,-2,28,30
155,MCO,P005985,P011196,0 days 00:11:15,-10,20,30
155,MCO,P002581,P010588,0 days 00:10:46,4,25,21
155,MCO,P002581,P012709,0 days 00:10:46,4,25,21
155,MCO,P011226,P011231,0 days 00:10:25,-5,24,29
155,MCO,P005985,P011231,0 days 00:09:45,-15,13,28
155,MCO,P011196,P011231,0 days 00:09:02,-10,12,22
155,MCO,P011231,P012709,0 days 00:08:42,3,22,19
155,MCO,P005985,PLCZ,0 days 00:08:34,-6,15,21
155,MCO,P011226,PLCZ,0 days 00:08:34,-6,15,21
155,MCO,P011212,P012709,0 days 00:07:46,4,20,16
155,MCO,P010588,PLCZ,0 days 00:07:38,-5,13,18
155,MCO,P011196,P011226,0 days 00:07:23,-4,15,19
155,MCO,P004790,P011231,0 days 00:07:06,-6,9,15
155,MCO,P004790,P011212,0 days 00:07:06,-6,9,15
155,MCO,P010588,P011231,0 days 00:06:39,0,16,16
155,MCO,P004790,P011196,0 days 00:05:44,-4,9,13
155,MCO,P004197,P005985,0 days 00:05:13,-2,8,10
155,MCO,P004197,P010588,0 days 00:05:13,-2,8,10
155,MCO,P004197,P011226,0 days 00:05:13,-2,8,10
155,MCO,P004197,PLCZ,0 days 00:05:13,-2,8,10
155,MCO,P010588,P011196,0 days 00:04:05,2,12,10
155,MCO,P004790,P005985,0 days 00:03:52,-6,5,11
155,MCO,P004790,P012709,0 days 00:03:14,0,4,4
155,MCO,P012709,PLCZ,0 days 00:02:47,0,7,7
155,MCO,P011196,P012709,0 days 00:01:52,2,4,2
155,MCO,P004790,P010588,0 days 00:01:22,-2,0,2
155,MCO,P011231,PLCZ,0 days 00:00:56,-1,2,3
155,MCO,P002581,P011212,0 days 00:00:54,0,3,3
155,MCO,P002581,P011231,0 days 00:00:54,0,3,3
155,MCO,P011212,PLCZ,0 days 00:00:34,-4,0,4
156,OLY,P008829,P010612,0 days 00:24:17,3,49,46
156,OLY,P001255,P008829,0 days 00:20:00,7,41,34
156,OLY,P008829,P008855,0 days 00:18:39,7,34,27
156,OLY,P008811,P008855,0 days 00:18:33,18,40,22
156,OLY,P008811,P008829,0 days 00:18:20,19,41,22
156,OLY,P001255,P010612,0 days 00:17:46,12,38,26
156,OLY,P007982,P008829,0 days 00:17:11,-12,31,43
156,OLY,P008811,P010612,0 days 00:16:37,19,42,23
156,OLY,P003941,P007982,0 days 00:15:41,-12,27,39
156,OLY,P001255,P008855,0 days 00:15:03,6,29,23
156,OLY,P001255,P008811,0 days 00:14:47,18,36,18
156,OLY,P008855,P010612,0 days 00:14:42,12,32,20
156,OLY,P003941,P010392,0 days 00:13:07,-5,24,29
156,OLY,P003941,P008829,0 days 00:11:40,-20,16,36
156,OLY,P007982,P010392,0 days 00:11:34,-5,22,27
156,OLY,P007982,P010612,0 days 00:11:25,-8,23,31
156,OLY,P007853,P011194,0 days 00:10:00,6,22,16
156,OLY,P003941,P010612,0 days 00:09:26,-15,13,28
156,OLY,P007853,P007982,0 days 00:08:39,5,16,11
156,OLY,P007853,P008855,0 days 00:08:25,3,16,13
156,OLY,P010392,P011194,0 days 00:08:08,5,16,11
156,OLY,P007853,P010392,0 days 00:08:08,5,16,11
156,OLY,P001255,P007982,0 days 00:07:11,-4,15,19
156,OLY,P007853,P008811,0 days 00:06:49,3,14,11
156,OLY,P003941,P011194,0 days 00:06:40,4,13,9
156,OLY,P003941,P007853,0 days 00:06:40,4,13,9
156,OLY,P007982,P008811,0 days 00:06:37,4,15,11
156,OLY,P010392,P010612,0 days 00:06:27,-9,11,20
156,OLY,P008829,P010392,0 days 00:06:27,-9,11,20
156,OLY,P007982,P008855,0 days 00:05:47,-4,8,12
156,OLY,P001255,P003941,0 days 00:05:13,-11,5,16
156,OLY,P007982,P011194,0 days 00:05:07,4,11,7
156,OLY,P003941,P008855,0 days 00:04:53,-9,5,14
156,OLY,P008855,P011194,0 days 00:04:53,2,11,9
156,OLY,P007853,P008829,0 days 00:03:35,1,5,4
156,OLY,P008811,P011194,0 days 00:03:17,2,9,7
156,OLY,P008855,P010392,0 days 00:03:01,1,5,4
156,OLY,P007853,P010612,0 days 00:01:52,1,6,5
156,OLY,P010612,P011194,0 days 00:01:52,1,6,5
156,OLY,P008811,P010392,0 days 00:01:28,1,3,2
156,OLY,P008829,P011194,0 days 00:00:03,0,0,0
156,MIL,P002849,P011224,0 days 00:25:44,-8,42,50
156,MIL,P006509,P011224,0 days 00:21:22,1,40,39
156,MIL,P007201,P011224,0 days 00:17:24,-12,23,35
156,MIL,P002849,P006509,0 days 00:16:35,-2,28,30
156,MIL,P006509,P007201,0 days 00:16:32,-8,28,36
156,MIL,P002812,P005670,0 days 00:16:32,4,37,33
156,MIL,P005670,P006509,0 days 00:16:03,-2,32,34
156,MIL,P007201,P011205,0 days 00:15:00,-15,17,32
156,MIL,P002812,P006509,0 days 00:14:52,3,31,28
156,MIL,P002849,P011205,0 days 00:14:37,-13,18,31
156,MIL,P011205,P011224,0 days 00:14:37,-13,18,31
156,MIL,P002849,P007201,0 days 00:13:42,-13,15,28
156,MIL,P002812,P011224,0 days 00:13:01,7,29,22
156,MIL,P002812,P011205,0 days 00:12:24,6,27,21
156,MIL,P006509,P011205,0 days 00:12:12,-9,17,26
156,MIL,P005670,P007201,0 days 00:11:50,-1,24,25
156,MIL,P005670,P011205,0 days 00:11:43,2,27,25
156,MIL,P005670,P011224,0 days 00:11:30,2,26,24
156,MIL,P002812,P007201,0 days 00:09:09,3,17,14
156,MIL,P006701,P009960,0 days 00:08:35,7,23,16
156,MIL,P002812,P002849,0 days 00:08:14,4,17,13
156,MIL,P006509,P009960,0 days 00:08:10,5,19,14
156,MIL,P006701,P011224,0 days 00:08:01,6,20,14
156,MIL,P009960,P011205,0 days 00:07:51,-2,16,18
156,MIL,P002849,P005670,0 days 00:07:48,1,18,17
156,MIL,P002849,P006701,0 days 00:06:56,4,16,12
156,MIL,P006509,P006701,0 days 00:06:38,8,17,9
156,MIL,P009960,P011224,0 days 00:06:33,5,16,11
156,MIL,P002812,P006701,0 days 00:06:01,5,15,10
156,MIL,P002812,P009960,0 days 00:05:51,4,15,11
156,MIL,P005670,P009960,0 days 00:05:45,0,13,13
156,MIL,P002849,P009960,0 days 00:05:28,3,12,9
156,MIL,P006701,P011205,0 days 00:04:08,0,10,10
156,MIL,P011205,P011926,0 days 00:03:52,-8,2,10
156,MIL,P002849,P011926,0 days 00:03:52,-8,2,10
156,MIL,P007201,P011926,0 days 00:03:52,-8,2,10
156,MIL,P011224,P011926,0 days 00:03:52,-8,2,10
156,MIL,P005670,P006701,0 days 00:02:45,2,7,5
156,MIL,P007201,P009960,0 days 00:00:59,-2,2,4
157,PAR,P009212,P012096,0 days 00:19:27,10,41,31
157,PAR,P004058,P007400,0 days 00:19:19,-4,34,38
157,PAR,P004058,P012743,0 days 00:18:08,0,42,42
157,PAR,P007400,P012743,0 days 00:16:30,4,34,30
157,PAR,P009862,P012096,0 days 00:16:28,12,40,28
157,PAR,P009212,P009862,0 days 00:15:52,11,37,26
157,PAR,P000956,P009212,0 days 00:13:24,3,31,28
157,PAR,P000956,P004058,0 days 00:12:57,-16,21,37
157,PAR,P004172,P009212,0 days 00:11:16,4,30,26
157,PAR,P007400,P011192,0 days 00:10:35,17,29,12
157,PAR,P011051,P011192,0 days 00:10:30,14,28,14
157,PAR,P000956,P012096,0 days 00:10:00,5,19,14
157,PAR,P000956,P012743,0 days 00:10:00,-11,21,32
157,PAR,P011192,P012743,0 days 00:09:54,13,25,12
157,PAR,P007400,P011051,0 days 00:09:54,13,25,12
157,PAR,P011051,P012743,0 days 00:09:54,13,25,12
157,PAR,P000956,P007400,0 days 00:09:33,-14,9,23
157,PAR,P009862,P011192,0 days 00:09:28,13,26,13
157,PAR,P004058,P011192,0 days 00:08:49,15,25,10
157,PAR,P009862,P012742,0 days 00:08:31,7,21,14
157,PAR,P012096,P012742,0 days 00:08:28,7,21,14
157,PAR,P011192,P012096,0 days 00:08:17,15,26,11
157,PAR,P004058,P011051,0 days 00:08:08,11,21,10
157,PAR,P004058,P009212,0 days 00:07:56,-8,16,24
157,PAR,P004172,P012096,0 days 00:07:52,6,18,12
157,PAR,P004172,P009862,0 days 00:07:52,6,18,12
157,PAR,P004172,P012742,0 days 00:07:52,6,18,12
157,PAR,P009212,P012742,0 days 00:07:52,6,18,12
157,PAR,P009212,P011192,0 days 00:07:41,14,23,9
157,PAR,P000956,P011192,0 days 00:07:03,10,19,9
157,PAR,P000956,P009862,0 days 00:07:03,10,19,9
157,PAR,P000956,P011050,0 days 00:06:36,-9,9,18
157,PAR,P004058,P011050,0 days 00:06:36,-9,9,18
157,PAR,P007400,P011050,0 days 00:06:36,-9,9,18
157,PAR,P011050,P012743,0 days 00:06:36,-9,9,18
157,PAR,P004058,P012096,0 days 00:04:32,-6,4,10
157,PAR,P007400,P012096,0 days 00:04:32,-6,4,10
157,PAR,P007400,P009212,0 days 00:04:32,-6,4,10
157,PAR,P000956,P004172,0 days 00:03:24,-2,12,14
157,PAR,P009212,P012743,0 days 00:03:24,-2,12,14
157,PAR,P004172,P012743,0 days 00:03:24,-2,12,14
157,PAR,P004058,P004172,0 days 00:03:24,-2,12,14
157,PAR,P007400,P009862,0 days 00:02:46,-3,4,7
157,PAR,P009862,P011051,0 days 00:02:22,3,7,4
157,PAR,P009862,P012743,0 days 00:01:46,2,4,2
157,PAR,P004058,P009862,0 days 00:01:00,-5,0,5
157,PAR,P011192,P012742,0 days 00:00:39,1,3,2
157,PAR,P011051,P012096,0 days 00:00:36,1,3,2
157,PAR,P011051,P012742,0 days 00:00:36,1,3,2
157,PAR,P004058,P012742,0 days 00:00:03,0,0,0
157,PAR,P007400,P012742,0 days 00:00:03,0,0,0
157,ASV,P011225,PKIR,0 days 00:27:32,-12,51,63
157,ASV,P012080,PKIR,0 days 00:23:12,-15,41,56
157,ASV,P011225,P012080,0 days 00:21:05,-19,34,53
157,ASV,P011225,P012729,0 days 00:19:58,3,46,43
157,ASV,P004194,P011225,0 days 00:19:33,-21,27,48
157,ASV,P004194,PKIR,0 days 00:19:01,-19,27,46
157,ASV,P000229,P012729,0 days 00:18:56,6,43,37
157,ASV,P004194,P012080,0 days 00:17:40,-21,20,41
157,ASV,P012729,PKIR,0 days 00:17:06,4,40,36
157,ASV,P006568,P011225,0 days 00:15:13,-14,23,37
157,ASV,P003526,P012729,0 days 00:14:43,4,38,34
157,ASV,P006568,PKIR,0 days 00:14:41,-12,23,35
157,ASV,P012080,P012729,0 days 00:13:51,-3,29,32
157,ASV,P004194,P006568,0 days 00:13:38,-16,18,34
157,ASV,P006568,P012080,0 days 00:13:38,-16,18,34
157,ASV,P000229,P012730,0 days 00:13:24,1,26,25
157,ASV,P012729,P012730,0 days 00:13:24,1,26,25
157,ASV,P000229,P011225,0 days 00:12:32,6,30,24
157,ASV,P000229,P003526,0 days 00:11:19,2,24,22
157,ASV,P003526,P012080,0 days 00:09:44,1,25,24
157,ASV,P000229,PKIR,0 days 00:09:40,7,24,17
157,ASV,P003526,P011225,0 days 00:09:27,1,27,26
157,ASV,P003526,P012730,0 days 00:09:15,-1,19,20
157,ASV,P011225,P012730,0 days 00:09:04,4,18,14
157,ASV,P000229,P012080,0 days 00:06:25,0,13,13
157,ASV,P004194,P012729,0 days 00:05:55,-5,9,14
157,ASV,P003526,PKIR,0 days 00:05:28,5,19,14
157,ASV,P012080,P012730,0 days 00:04:21,-3,8,11
157,ASV,P012730,PKIR,0 days 00:04:08,2,7,5
157,ASV,P000229,P004194,0 days 00:01:53,0,7,7
157,ASV,P000229,P006568,0 days 00:01:35,2,5,3
157,ASV,P006568,P012729,0 days 00:01:35,2,5,3
157,ASV,P003526,P004194,0 days 00:00:32,-2,0,2
157,ASV,P003526,P006568,0 days 00:00:32,-2,0,2
158,ZAL,P002329,P011218,0 days 00:27:22,8,56,48
158,ZAL,P003210,P010390,0 days 00:17:42,0,28,28
158,ZAL,P003210,P011218,0 days 00:16:19,2,33,31
158,ZAL,P002329,P009917,0 days 00:16:09,2,38,36
158,ZAL,P003211,P011218,0 days 00:16:07,10,28,18
158,ZAL,P003210,P003211,0 days 00:15:32,3,22,19
158,ZAL,P003211,P010390,0 days 00:14:47,13,26,13
158,ZAL,P009917,P011218,0 days 00:14:32,3,35,32
158,ZAL,P005504,P011218,0 days 00:14:11,-6,31,37
158,ZAL,P002329,P003211,0 days 00:13:56,10,22,12
158,ZAL,P002329,P003210,0 days 00:13:20,2,26,24
158,ZAL,P010390,P011218,0 days 00:12:58,12,29,17
158,ZAL,P002329,P010390,0 days 00:12:38,12,28,16
158,ZAL,P003210,P012715,0 days 00:12:24,-2,21,23
158,ZAL,P002329,P005504,0 days 00:11:52,-4,27,31
158,ZAL,P007109,P011218,0 days 00:10:57,-4,13,17
158,ZAL,P010390,P012715,0 days 00:10:51,-1,17,18
158,ZAL,P002329,P007109,0 days 00:10:51,-6,11,17
158,ZAL,P003211,P012715,0 days 00:09:56,1,16,15
158,ZAL,P003210,P009917,0 days 00:09:17,-5,20,25
158,ZAL,P011218,P012715,0 days 00:09:02,3,26,23
158,ZAL,P009917,P010390,0 days 00:09:01,3,20,17
158,ZAL,P012715,P012787,0 days 00:07:28,5,16,11
158,ZAL,P003211,P009917,0 days 00:06:58,2,12,10
158,ZAL,P005504,P009917,0 days 00:06:56,-3,18,21
158,ZAL,P003211,P007109,0 days 00:06:24,1,8,7
158,ZAL,P009917,P012715,0 days 00:06:19,-4,13,17
158,ZAL,P003210,P012787,0 days 00:06:11,3,10,7
158,ZAL,P010390,P012787,0 days 00:06:11,3,10,7
158,ZAL,P005504,P012715,0 days 00:06:07,1,18,17
158,ZAL,P002329,P012715,0 days 00:06:03,3,19,16
158,ZAL,P005504,P007109,0 days 00:05:52,-7,5,12
158,ZAL,P011218,P012787,0 days 00:05:24,0,13,13
158,ZAL,P007109,P009917,0 days 00:04:50,-6,4,10
158,ZAL,P003210,P005504,0 days 00:04:31,-2,12,14
158,ZAL,P003211,P012787,0 days 00:04:14,4,6,2
158,ZAL,P003211,P005504,0 days 00:03:48,-4,4,8
158,ZAL,P002329,P012787,0 days 00:03:27,1,9,8
158,ZAL,P005504,P012787,0 days 00:03:27,1,9,8
158,ZAL,P007109,P012787,0 days 00:02:10,-1,3,4
158,ZAL,P003210,P007109,0 days 00:02:08,3,4,1
158,ZAL,P007109,P010390,0 days 00:00:30,2,2,0
158,ZAL,P002329,P007513,0 days 00:00:18,0,0,0
158,ZAL,P003211,P007513,0 days 00:00:18,0,0,0
158,ZAL,P007513,P010390,0 days 00:00:18,0,0,0
158,ZAL,P007513,P009917,0 days 00:00:14,0,0,0
158,ZAL,P007109,P012715,0 days 00:00:06,2,2,0
158,ZAL,P007513,P011218,0 days 00:00:04,0,0,0
158,BER,P003958,P011934,0 days 00:28:07,3,59,56
158,BER,P011934,P012720,0 days 00:28:04,7,63,56
158,BER,P003958,P012720,0 days 00:27:38,2,59,57
158,BER,P003958,P008173,0 days 00:24:30,-8,45,53
158,BER,P008173,P011934,0 days 00:22:40,-6,43,49
158,BER,P008173,P012720,0 days 00:22:11,-7,43,50
158,BER,P011934,P012721,0 days 00:16:31,4,39,35
158,BER,P012720,P012721,0 days 00:16:23,2,39,37
158,BER,P003958,P012721,0 days 00:15:20,1,35,34
158,BER,P008173,P012721,0 days 00:15:20,1,35,34
158,BER,P008211,P008967,0 days 00:13:59,1,22,21
158,BER,P003958,P008967,0 days 00:12:02,3,22,19
158,BER,P008967,P012720,0 days 00:11:22,3,23,20
158,BER,P006251,P008967,0 days 00:10:18,-8,8,16
158,BER,P006251,P008211,0 days 00:10:03,-7,10,17
158,BER,P008967,P011934,0 days 00:09:54,3,20,17
158,BER,P008211,P012720,0 days 00:09:07,7,23,16
158,BER,P007025,P008967,0 days 00:08:32,-8,5,13
158,BER,P006251,P010791,0 days 00:08:12,-8,6,14
158,BER,P008211,P010791,0 days 00:08:12,-8,6,14
158,BER,P008967,P010791,0 days 00:08:12,-8,6,14
158,BER,P006251,P007025,0 days 00:07:26,-5,5,10
158,BER,P008211,P011934,0 days 00:06:50,10,20,10
158,BER,P007025,P008211,0 days 00:06:41,-7,3,10
158,BER,P008173,P008967,0 days 00:06:15,-6,6,12
158,BER,P003958,P008211,0 days 00:06:05,7,16,9
158,BER,P007025,P010791,0 days 00:06:05,-7,3,10
158,BER,P003958,P007025,0 days 00:05:52,-4,6,10
158,BER,P007025,P008173,0 days 00:05:16,-4,6,10
158,BER,P007025,P011934,0 days 00:04:31,-6,4,10
158,BER,P006251,P012720,0 days 00:04:15,-2,7,9
158,BER,P007025,P012720,0 days 00:03:25,-3,4,7
158,BER,P010791,P012720,0 days 00:02:07,-1,3,4
158,BER,P003958,P006251,0 days 00:02:06,0,2,2
158,BER,P006251,P008173,0 days 00:01:38,0,2,2
158,BER,P008211,P012721,0 days 00:01:33,-1,4,5
158,BER,P006251,P011934,0 days 00:01:23,1,4,3
158,BER,P006251,P012721,0 days 00:01:23,1,4,3
158,BER,P008967,P012721,0 days 00:00:22,0,0,0
158,BER,P008173,P008211,0 days 00:00:10,-2,0,2
159,BAR,P000925,P012745,0 days 00:26:40,9,58,49
159,BAR,P000925,P004866,0 days 00:25:25,10,56,46
159,BAR,P004866,P012745,0 days 00:25:25,10,56,46
159,BAR,P002939,P004866,0 days 00:19:04,2,36,34
159,BAR,P002939,P012745,0 days 00:19:03,-2,36,38
159,BAR,P000925,P002939,0 days 00:17:54,5,37,32
159,BAR,P004866,P006435,0 days 00:17:52,3,39,36
159,BAR,P006435,P007519,0 days 00:16:05,2,35,33
159,BAR,P006435,P012745,0 days 00:15:32,-2,34,36
159,BAR,P002939,P006435,0 days 00:13:01,-8,20,28
159,BAR,P006435,P007464,0 days 00:13:00,-7,22,29
159,BAR,P003196,P006435,0 days 00:12:59,-7,22,29
159,BAR,P003196,P007464,0 days 00:12:59,-7,22,29
159,BAR,P007519,P012745,0 days 00:12:13,5,30,25
159,BAR,P000925,P006435,0 days 00:12:11,3,28,25
159,BAR,P004866,P007519,0 days 00:12:02,8,31,23
159,BAR,P002939,P007464,0 days 00:11:03,-3,15,18
159,BAR,P000925,P007519,0 days 00:10:21,6,26,20
159,BAR,P002939,P011244,0 days 00:08:53,3,22,19
159,BAR,P000925,P011244,0 days 00:08:53,3,22,19
159,BAR,P007464,P007519,0 days 00:08:46,-2,16,18
159,BAR,P003196,P007519,0 days 00:08:45,-2,16,18
159,BAR,P004866,P007464,0 days 00:08:35,4,15,11
159,BAR,P011244,P012745,0 days 00:08:33,0,19,19
159,BAR,P004866,P011244,0 days 00:08:33,0,19,19
159,BAR,P002939,P003196,0 days 00:08:09,-7,11,18
159,BAR,P007464,P012745,0 days 00:06:15,-1,10,11
159,BAR,P003196,P004866,0 days 00:05:41,0,11,11
159,BAR,P002939,P007519,0 days 00:05:10,-3,7,10
159,BAR,P000925,P009992,0 days 00:03:22,5,10,5
159,BAR,P003196,P012745,0 days 00:03:21,-5,6,11
159,BAR,P007519,P009992,0 days 00:03:02,2,7,5
159,BAR,P009992,P012745,0 days 00:03:02,2,7,5
159,BAR,P000925,P007464,0 days 00:02:54,4,4,0
159,BAR,P004866,P009992,0 days 00:01:47,3,5,2
159,BAR,P002939,P009992,0 days 00:01:35,2,5,3
159,BAR,P003204,P011244,0 days 00:00:21,3,3,0
159,BAR,P009992,P011244,0 days 00:00:20,3,3,0
159,BAR,P002939,P003204,0 days 00:00:20,3,3,0
159,BAR,P003204,P009992,0 days 00:00:20,3,3,0
159,BAR,P000925,P003204,0 days 00:00:20,3,3,0
159,BAR,P006435,P011244,0 days 00:00:03,0,0,0
159,BAR,P007464,P011244,0 days 00:00:03,0,0,0
159,BAR,P007519,P011244,0 days 00:00:03,0,0,0
159,BAR,P003196,P011244,0 days 00:00:02,0,0,0
159,BAR,P003204,P006435,0 days 00:00:01,0,0,0
159,BAR,P003204,P007464,0 days 00:00:01,0,0,0
159,BAR,P003204,P007519,0 days 00:00:01,0,0,0
159,MAD,P005791,P005928,0 days 00:23:28,3,49,46
159,MAD,P005928,P006540,0 days 00:21:37,0,44,44
159,MAD,P005791,P006540,0 days 00:19:24,4,41,37
159,MAD,P003108,P006540,0 days 00:18:14,-10,31,41
159,MAD,P003108,P005928,0 days 00:16:23,-8,27,35
159,MAD,P003108,P005791,0 days 00:16:15,-3,27,30
159,MAD,P003733,P005791,0 days 00:14:58,3,30,27
159,MAD,P003733,P005928,0 days 00:14:58,3,30,27
159,MAD,P003733,P006540,0 days 00:14:58,3,30,27
159,MAD,P003108,PTGB,0 days 00:14:20,-10,22,32
159,MAD,P005928,P009213,0 days 00:13:22,6,33,27
159,MAD,P005791,P009213,0 days 00:12:57,5,30,25
159,MAD,P004887,PCVM,0 days 00:12:56,-2,26,28
159,MAD,P001392,P003108,0 days 00:12:53,6,33,27
159,MAD,P003108,P004887,0 days 00:12:39,-6,24,30
159,MAD,P003108,PCVM,0 days 00:12:00,1,24,23
159,MAD,P004887,PTGB,0 days 00:11:16,-5,19,24
159,MAD,P006540,P009213,0 days 00:11:07,2,27,25
159,MAD,P001392,P004887,0 days 00:10:12,-1,22,23
159,MAD,P004887,P006540,0 days 00:09:54,-10,17,27
159,MAD,PCVM,PTGB,0 days 00:09:49,0,19,19
159,MAD,P001392,PCVM,0 days 00:09:16,0,19,19
159,MAD,P003108,P003733,0 days 00:08:00,-3,8,11
159,MAD,P006540,PTGB,0 days 00:07:43,-9,10,19
159,MAD,P006540,PCVM,0 days 00:07:40,-4,14,18
159,MAD,P003733,P009213,0 days 00:07:28,6,22,16
159,MAD,P001392,P006540,0 days 00:06:39,0,18,18
159,MAD,P001392,P009213,0 days 00:06:33,-2,13,15
159,MAD,P001392,P005928,0 days 00:06:07,6,19,13
159,MAD,P001392,PTGB,0 days 00:05:48,2,12,10
159,MAD,P001392,P005791,0 days 00:05:42,5,16,11
159,MAD,P003108,P009213,0 days 00:04:56,-3,8,11
159,MAD,P005928,PTGB,0 days 00:04:36,-10,3,13
159,MAD,P005791,PTGB,0 days 00:03:38,-5,3,8
159,MAD,P004887,P009213,0 days 00:03:04,-4,5,9
159,MAD,P009213,PCVM,0 days 00:02:37,-3,2,5
159,MAD,P004887,P005928,0 days 00:02:13,-4,3,7
159,MAD,P009213,PTGB,0 days 00:02:00,-3,0,3
159,MAD,P005791,PCVM,0 days 00:00:50,0,0,0
159,MAD,P001392,P003733,0 days 00:00:30,0,0,0
159,MAD,P003733,P004887,0 days 00:00:30,0,0,0
159,MAD,P003733,PTGB,0 days 00:00:30,0,0,0
160,BAS,P004761,P007230,0 days 00:24:33,-1,42,43
160,BAS,P007230,P009048,0 days 00:21:20,4,37,33
160,BAS,P004761,P009048,0 days 00:18:40,-6,25,31
160,BAS,P007230,P010444,0 days 00:17:37,0,34,34
160,BAS,P007230,P012201,0 days 00:16:52,19,46,27
160,BAS,P004761,P012201,0 days 00:15:33,9,37,28
160,BAS,P011948,P012201,0 days 00:15:28,5,35,30
160,BAS,P009048,P010444,0 days 00:15:22,2,32,30
160,BAS,P009048,P011948,0 days 00:14:44,2,31,29
160,BAS,P010444,P011948,0 days 00:14:29,-2,28,30
160,BAS,P010444,P012201,0 days 00:13:28,2,29,27
160,BAS,P007230,P011948,0 days 00:13:00,-1,25,26
160,BAS,P009048,P012201,0 days 00:12:24,8,31,23
160,BAS,P012201,P012765,0 days 00:12:21,9,30,21
160,BAS,P004761,P010444,0 days 00:11:31,-12,16,28
160,BAS,P004761,P011948,0 days 00:10:33,-9,16,25
160,BAS,P004761,P012765,0 days 00:10:14,2,26,24
160,BAS,P007230,P012765,0 days 00:10:01,0,23,23
160,BAS,P007230,P008850,0 days 00:09:16,-7,7,14
160,BAS,P003198,P007230,0 days 00:08:13,10,22,12
160,BAS,P003198,P004761,0 days 00:08:13,10,22,12
160,BAS,P004761,P008850,0 days 00:08:08,-5,7,12
160,BAS,P003198,P012765,0 days 00:07:04,9,21,12
160,BAS,P008850,P009048,0 days 00:06:51,-3,5,8
160,BAS,P003198,P012201,0 days 00:06:33,13,21,8
160,BAS,P011948,P012765,0 days 00:06:32,-5,9,14
160,BAS,P010444,P012765,0 days 00:06:10,-6,8,14
160,BAS,P008850,P010444,0 days 00:04:49,1,7,6
160,BAS,P004603,P008850,0 days 00:04:45,-6,2,8
160,BAS,P004603,P009048,0 days 00:04:45,-6,2,8
160,BAS,P004603,P007230,0 days 00:04:45,-6,2,8
160,BAS,P004603,P004761,0 days 00:04:45,-6,2,8
160,BAS,P010444,P011085,0 days 00:04:14,-1,6,7
160,BAS,P008072,P012201,0 days 00:03:58,2,9,7
160,BAS,P008072,P011948,0 days 00:03:58,2,9,7
160,BAS,P004761,P008072,0 days 00:03:39,4,9,5
160,BAS,P011085,P012765,0 days 00:03:14,-1,4,5
160,BAS,P011085,P012201,0 days 00:03:14,-1,4,5
160,BAS,P011085,P011948,0 days 00:03:14,-1,4,5
160,BAS,P008850,P012765,0 days 00:02:20,-2,4,6
160,BAS,P008072,P009048,0 days 00:02:18,4,6,2
160,BAS,P008072,P012765,0 days 00:01:40,-2,3,5
160,BAS,P003198,P011948,0 days 00:01:40,-3,1,4
160,BAS,P008850,P011948,0 days 00:01:26,0,2,2
160,BAS,P004761,P011085,0 days 00:01:19,-2,2,4
160,BAS,P007230,P011085,0 days 00:01:19,-2,2,4
160,BAS,P009048,P011085,0 days 00:01:19,-2,2,4
160,BAS,P003198,P009048,0 days 00:01:09,1,1,0
160,BAS,P008850,P012201,0 days 00:00:41,2,2,0
160,BAS,P008072,P011085,0 days 00:00:19,-2,0,2
160,PAN,P007866,P012774,0 days 00:27:18,5,55,50
160,PAN,P007866,P011204,0 days 00:26:17,4,52,48
160,PAN,P002328,P012774,0 days 00:25:38,9,49,40
160,PAN,P011204,P012774,0 days 00:24:07,4,47,43
160,PAN,P002328,P007866,0 days 00:21:15,12,49,37
160,PAN,P003842,P012774,0 days 00:20:01,-9,33,42
160,PAN,P001926,P003842,0 days 00:19:50,-6,38,44
160,PAN,P003842,P007866,0 days 00:18:37,-3,36,39
160,PAN,P002328,P011204,0 days 00:16:55,10,37,27
160,PAN,P002328,P003842,0 days 00:16:02,-6,27,33
160,PAN,P001926,P007866,0 days 00:15:52,-4,32,36
160,PAN,P001926,P012774,0 days 00:15:46,-5,29,34
160,PAN,P003842,P011204,0 days 00:14:24,-7,24,31
160,PAN,P001926,P011204,0 days 00:11:32,-6,20,26
160,PAN,P001926,P002328,0 days 00:11:24,-4,23,27
160,PAN,P007866,P011221,0 days 00:10:08,11,25,14
160,PAN,P002328,P011221,0 days 00:10:08,11,25,14
160,PAN,P011204,P011221,0 days 00:10:08,11,25,14
160,PAN,P002328,P012712,0 days 00:09:56,-7,11,18
160,PAN,P011221,P012774,0 days 00:09:55,13,25,12
160,PAN,P012712,P012774,0 days 00:08:51,-1,11,12
160,PAN,P002328,P007947,0 days 00:08:02,-10,8,18
160,PAN,P003842,P012712,0 days 00:06:11,-9,6,15
160,PAN,P007947,P012712,0 days 00:06:10,-8,3,11
160,PAN,P001926,P012712,0 days 00:05:30,-6,6,12
160,PAN,P007947,P012774,0 days 00:05:12,-5,4,9
160,PAN,P003842,P007947,0 days 00:04:07,-8,4,12
160,PAN,P007553,P012712,0 days 00:03:12,1,3,2
160,PAN,P007553,P012774,0 days 00:03:12,1,3,2
160,PAN,P007553,P007947,0 days 00:03:12,1,3,2
160,PAN,P002328,P007553,0 days 00:03:12,1,3,2
160,PAN,P001926,P007947,0 days 00:02:57,-7,4,11
160,PAN,P007866,P007947,0 days 00:01:52,-2,5,7
160,PAN,P007866,P012712,0 days 00:01:09,1,2,1
160,PAN,P011204,P012712,0 days 00:01:09,1,2,1
160,PAN,P007947,P011204,0 days 00:00:36,-1,1,2
160,PAN,P001926,P011221,0 days 00:00:13,-2,0,2
161,PAM,P010568,P011982,0 days 00:19:11,-1,42,43
161,PAM,P003960,P007870,0 days 00:18:46,10,51,41
161,PAM,P011982,P012739,0 days 00:14:45,-3,30,33
161,PAM,P011982,P012738,0 days 00:14:39,-7,27,34
161,PAM,P003960,P010568,0 days 00:14:32,4,36,32
161,PAM,P007870,P010568,0 days 00:14:26,1,33,32
161,PAM,P012738,P012739,0 days 00:14:17,-3,28,31
161,PAM,P003960,P011970,0 days 00:13:32,5,36,31
161,PAM,P003960,P012795,0 days 00:13:10,-1,30,31
161,PAM,P010568,P012738,0 days 00:12:53,-6,21,27
161,PAM,P003960,P004863,0 days 00:12:35,5,35,30
161,PAM,P010568,P012739,0 days 00:12:05,0,24,24
161,PAM,P004863,P012795,0 days 00:11:32,1,30,29
161,PAM,P005356,P010568,0 days 00:11:18,-1,24,25
161,PAM,P007870,P012795,0 days 00:10:57,1,25,24
161,PAM,P005356,P011982,0 days 00:10:22,-6,24,30
161,PAM,P007870,P011970,0 days 00:10:17,11,33,22
161,PAM,P003960,P011982,0 days 00:10:02,10,31,21
161,PAM,P004863,P007870,0 days 00:09:47,11,32,21
161,PAM,P007870,P011982,0 days 00:09:02,9,28,19
161,PAM,P010568,P012795,0 days 00:08:43,1,17,16
161,PAM,P005356,P012738,0 days 00:08:41,-4,19,23
161,PAM,P004863,P011970,0 days 00:07:52,4,22,18
161,PAM,P011982,P012740,0 days 00:07:41,-5,9,14
161,PAM,P012738,P012740,0 days 00:07:41,-5,9,14
161,PAM,P010568,P012740,0 days 00:07:41,-5,9,14
161,PAM,P005356,P012739,0 days 00:07:36,2,22,20
161,PAM,P011970,P011982,0 days 00:07:00,13,25,12
161,PAM,P011970,P012795,0 days 00:06:51,-6,13,19
161,PAM,P004863,P012739,0 days 00:06:38,-4,14,18
161,PAM,P012739,P012740,0 days 00:06:28,-4,7,11
161,PAM,P004863,P011982,0 days 00:06:18,8,20,12
161,PAM,P010568,P011970,0 days 00:06:08,5,18,13
161,PAM,P005356,P007870,0 days 00:05:47,-1,10,11
161,PAM,P003960,P005356,0 days 00:05:45,4,15,11
161,PAM,P012739,P012795,0 days 00:05:13,1,12,11
161,PAM,P003960,P012739,0 days 00:04:26,-1,10,11
161,PAM,P004863,P010568,0 days 00:04:19,2,12,10
161,PAM,P005356,P012795,0 days 00:04:14,6,10,4
161,PAM,P004863,P012738,0 days 00:03:31,0,9,9
161,PAM,P004863,P005356,0 days 00:03:28,1,10,9
161,PAM,P011970,P012739,0 days 00:03:24,-4,5,9
161,PAM,P012738,P012795,0 days 00:03:00,3,7,4
161,PAM,P011982,P012795,0 days 00:01:20,2,4,2
161,PAM,P005356,P012740,0 days 00:01:13,-1,2,3
161,PAM,P007870,P012738,0 days 00:00:54,-2,0,2
161,IST,P007200,PLHK,0 days 00:26:32,-1,57,58
161,IST,P006590,P007200,0 days 00:24:56,9,58,49
161,IST,P007200,P009846,0 days 00:23:47,-4,52,56
161,IST,P006590,PLHK,0 days 00:23:07,9,53,44
161,IST,P009846,PLHK,0 days 00:21:47,0,48,48
161,IST,P006590,P009846,0 days 00:19:13,4,44,40
161,IST,P007200,P011078,0 days 00:19:06,-7,42,49
161,IST,P007200,P012788,0 days 00:18:02,-2,37,39
161,IST,P011078,P011981,0 days 00:17:54,-3,39,42
161,IST,P006590,P011078,0 days 00:17:38,1,42,41
161,IST,P011078,PLHK,0 days 00:16:56,3,40,37
161,IST,P007200,P011981,0 days 00:16:36,-7,34,41
161,IST,P006590,P012788,0 days 00:16:23,0,33,33
161,IST,P009846,P012788,0 days 00:16:11,-7,32,39
161,IST,P012788,PLHK,0 days 00:13:40,-2,26,28
161,IST,P009846,P011078,0 days 00:13:23,-12,28,40
161,IST,P006590,P011981,0 days 00:13:00,-2,29,31
161,IST,P011981,PLHK,0 days 00:11:51,-1,25,26
161,IST,P006590,P012786,0 days 00:09:33,3,25,22
161,IST,P009846,P011981,0 days 00:08:54,-9,16,25
161,IST,P011078,P012786,0 days 00:08:42,-4,20,24
161,IST,P011078,P012788,0 days 00:06:51,-18,9,27
161,IST,P009846,P012786,0 days 00:06:41,0,16,16
161,IST,P011981,P012786,0 days 00:05:00,-1,13,14
161,IST,P007200,P012786,0 days 00:03:49,4,12,8
161,IST,P006590,P009513,0 days 00:03:06,0,8,8
161,IST,P009513,P011078,0 days 00:03:06,0,8,8
161,IST,P009513,P011981,0 days 00:03:06,0,8,8
161,IST,P009513,P012786,0 days 00:03:06,0,8,8
161,IST,P012786,P012788,0 days 00:03:02,-2,7,9
161,IST,P012786,PLHK,0 days 00:02:35,4,7,3
161,IST,P011981,P012788,0 days 00:02:27,-5,4,9
162,VIR,P001133,P001844,0 days 00:23:32,4,48,44
162,VIR,P001844,P009549,0 days 00:23:15,7,50,43
162,VIR,P001133,P009549,0 days 00:21:33,4,44,40
162,VIR,P001844,P003048,0 days 00:19:41,1,39,38
162,VIR,P001844,PBCN,0 days 00:19:18,7,42,35
162,VIR,P001133,P010781,0 days 00:18:29,-6,40,46
162,VIR,P001133,P003048,0 days 00:17:02,1,34,33
162,VIR,P001133,PBCN,0 days 00:16:57,8,39,31
162,VIR,P003048,P009549,0 days 00:14:46,0,29,29
162,VIR,P009549,PBCN,0 days 00:13:44,9,32,23
162,VIR,P003048,P010781,0 days 00:13:23,1,26,25
162,VIR,P001844,P010781,0 days 00:12:57,-2,25,27
162,VIR,P003048,PBCN,0 days 00:12:35,4,28,24
162,VIR,P006739,P010781,0 days 00:10:57,-3,25,28
162,VIR,P010781,PBCN,0 days 00:10:38,4,24,20
162,VIR,P004554,PBCN,0 days 00:08:53,9,23,14
162,VIR,P003527,P010781,0 days 00:08:33,-14,13,27
162,VIR,P001133,P004554,0 days 00:08:23,6,26,20
162,VIR,P009549,P010781,0 days 00:08:19,-2,16,18
162,VIR,P001133,P006739,0 days 00:08:11,-4,20,24
162,VIR,P003527,P006739,0 days 00:08:03,-12,13,25
162,VIR,P001133,P003527,0 days 00:07:41,-7,15,22
162,VIR,P006739,PBCN,0 days 00:06:49,0,14,14
162,VIR,P001844,P004554,0 days 00:06:49,6,18,12
162,VIR,P004554,P010781,0 days 00:06:45,-1,19,20
162,VIR,P004554,P006739,0 days 00:06:32,-3,16,19
162,VIR,P003527,PBCN,0 days 00:06:27,-6,10,16
162,VIR,P003527,P004554,0 days 00:06:17,-3,15,18
162,VIR,P004554,P009549,0 days 00:06:13,10,19,9
162,VIR,P001844,P003527,0 days 00:05:45,-3,10,13
162,VIR,P002084,PBCN,0 days 00:05:35,5,12,7
162,VIR,P002084,P010781,0 days 00:05:35,3,12,9
162,VIR,P001133,P002084,0 days 00:05:04,-6,6,12
162,VIR,P002084,P006739,0 days 00:04:05,-2,7,9
162,VIR,P001844,P002084,0 days 00:04:02,3,8,5
162,VIR,P003527,P009549,0 days 00:03:29,5,10,5
162,VIR,P002084,P003048,0 days 00:03:03,7,9,2
162,VIR,P003048,P003527,0 days 00:02:53,-4,3,7
162,VIR,P002084,P003527,0 days 00:02:32,-4,3,7
162,VIR,P002084,P009549,0 days 00:02:32,-2,3,5
162,VIR,P003048,P006739,0 days 00:01:33,2,4,2
162,VIR,P001844,P006739,0 days 00:00:53,-3,0,3
162,VIR,P006739,P009549,0 days 00:00:17,1,1,0
162,MUN,P008985,P011987,0 days 00:21:00,2,42,40
162,MUN,P007056,P008985,0 days 00:19:40,-4,35,39
162,MUN,P003583,P008985,0 days 00:19:17,-4,34,38
162,MUN,P003583,P007056,0 days 00:17:54,-5,30,35
162,MUN,P004508,P010391,0 days 00:17:40,-4,38,42
162,MUN,P007056,P011987,0 days 00:16:38,0,30,30
162,MUN,P003583,P011987,0 days 00:16:14,0,29,29
162,MUN,P007056,P010391,0 days 00:15:42,1,34,33
162,MUN,P004508,P007975,0 days 00:15:29,0,36,36
162,MUN,P001288,P010391,0 days 00:14:36,4,33,29
162,MUN,P003583,P006760,0 days 00:14:25,4,32,28
162,MUN,P007975,P010391,0 days 00:14:23,0,33,33
162,MUN,P006760,P011987,0 days 00:14:10,-1,27,28
162,MUN,P001288,P004508,0 days 00:13:58,2,31,29
162,MUN,P001288,P007975,0 days 00:13:57,2,31,29
162,MUN,P006760,P008985,0 days 00:13:56,-1,27,28
162,MUN,P003583,P010391,0 days 00:13:42,-6,24,30
162,MUN,P003583,P004508,0 days 00:11:49,-4,25,29
162,MUN,P006760,P007056,0 days 00:11:18,-1,20,21
162,MUN,P004508,P007056,0 days 00:10:22,0,24,24
162,MUN,P008985,P010391,0 days 00:10:21,-1,20,21
162,MUN,P003583,P007975,0 days 00:08:46,0,20,20
162,MUN,P007056,P007975,0 days 00:07:20,4,19,15
162,MUN,P001288,P003583,0 days 00:07:13,-1,15,16
162,MUN,P010391,P011987,0 days 00:07:04,3,15,12
162,MUN,P001288,P007056,0 days 00:05:50,5,16,11
162,MUN,P007639,P010391,0 days 00:05:12,0,13,13
162,MUN,P007639,P008985,0 days 00:05:00,2,13,11
162,MUN,P007639,P011987,0 days 00:05:00,2,13,11
162,MUN,P004508,P008985,0 days 00:03:17,-4,5,9
162,MUN,P007056,P007639,0 days 00:03:16,0,8,8
162,MUN,P003583,P006543,0 days 00:02:52,0,7,7
162,MUN,P006543,P006760,0 days 00:02:52,0,7,7
162,MUN,P006543,P008985,0 days 00:02:52,0,7,7
162,MUN,P006543,P011987,0 days 00:02:52,0,7,7
162,MUN,P001288,P007639,0 days 00:02:39,0,5,5
162,MUN,P001288,P008985,0 days 00:01:45,2,5,3
162,MUN,P001288,P011987,0 days 00:01:44,2,5,3
162,MUN,P006760,P007975,0 days 00:01:24,2,5,3
162,MUN,P004508,P006760,0 days 00:01:10,2,5,3
162,MUN,P004508,P007639,0 days 00:01:07,-5,0,5
162,MUN,P007639,P007975,0 days 00:01:07,-5,0,5
162,MUN,P001288,P006760,0 days 00:01:06,0,3,3
162,MUN,P006760,P007639,0 days 00:00:55,-3,0,3
162,MUN,P007975,P011987,0 days 00:00:14,0,0,0
162,MUN,P001557,P004508,0 days 00:00:12,-3,0,3
162,MUN,P001557,P007639,0 days 00:00:12,-3,0,3
162,MUN,P001557,P007975,0 days 00:00:12,-3,0,3
162,MUN,P001557,P010391,0 days 00:00:12,-3,0,3
162,MUN,P006760,P010391,0 days 00:00:04,2,2,0
163,RED,P006436,P012044,0 days 00:21:21,1,49,48
163,RED,P006436,PJDR,0 days 00:18:12,17,51,34
163,RED,P006436,P011941,0 days 00:18:05,10,46,36
163,RED,P000848,P009035,0 days 00:17:45,6,35,29
163,RED,P011941,PJDR,0 days 00:16:35,11,43,32
163,RED,P005099,PJDR,0 days 00:16:20,13,41,28
163,RED,P012044,PJDR,0 days 00:16:11,5,39,34
163,RED,P005099,P012044,0 days 00:15:47,11,40,29
163,RED,P005099,P011941,0 days 00:15:41,16,43,27
163,RED,P011941,P012044,0 days 00:15:12,3,36,33
163,RED,P005099,P006436,0 days 00:14:46,15,41,26
163,RED,P007960,P009035,0 days 00:13:56,6,25,19
163,RED,P000848,P006436,0 days 00:13:36,3,32,29
163,RED,P009035,PLUO,0 days 00:12:41,-5,20,25
163,RED,P000848,PLUO,0 days 00:12:30,-7,18,25
163,RED,P000848,P012044,0 days 00:11:55,-2,26,28
163,RED,P000848,P007960,0 days 00:11:10,8,22,14
163,RED,P009035,P012044,0 days 00:10:58,2,24,22
163,RED,P007960,P010985,0 days 00:09:21,0,13,13
163,RED,P009035,P010985,0 days 00:09:21,0,13,13
163,RED,P000848,P005099,0 days 00:08:58,14,25,11
163,RED,P000848,P010985,0 days 00:08:08,0,11,11
163,RED,P006436,P009035,0 days 00:07:45,2,18,16
163,RED,P005099,P007960,0 days 00:07:11,5,14,9
163,RED,P007960,PLUO,0 days 00:06:59,-1,10,11
163,RED,P010985,PLUO,0 days 00:06:59,-1,10,11
163,RED,P006436,PLUO,0 days 00:06:44,-5,11,16
163,RED,P000848,P011941,0 days 00:06:20,2,16,14
163,RED,P012044,PLUO,0 days 00:06:17,-6,10,16
163,RED,P005099,P009035,0 days 00:06:16,4,12,8
163,RED,P000848,PJDR,0 days 00:05:58,8,19,11
163,RED,P009035,PJDR,0 days 00:05:18,5,13,8
163,RED,P007960,P012044,0 days 00:04:49,4,11,7
163,RED,P007960,PJDR,0 days 00:04:22,2,8,6
163,RED,P010985,PJDR,0 days 00:03:23,2,7,5
163,RED,P005099,P010985,0 days 00:02:22,1,3,2
163,RED,P010985,P012044,0 days 00:02:10,2,5,3
163,RED,P010985,P011941,0 days 00:02:10,2,5,3
163,RED,P006436,P010985,0 days 00:02:10,2,5,3
163,RED,PJDR,PLUO,0 days 00:01:13,1,3,2
163,RED,P011941,PLUO,0 days 00:01:02,-1,1,2
163,RED,P007960,P011941,0 days 00:00:55,1,2,1
163,RED,P006436,P007960,0 days 00:00:41,3,3,0
163,RED,P005099,PLUO,0 days 00:00:27,1,1,0
163,PAR,P007400,P009862,0 days 00:27:54,-5,58,63
163,PAR,P012096,P012742,0 days 00:24:04,-1,41,42
163,PAR,P009862,P012742,0 days 00:22:07,-2,38,40
163,PAR,P009862,P012096,0 days 00:21:31,1,38,37
163,PAR,P007400,P012742,0 days 00:19:36,-5,35,40
163,PAR,P007400,P012096,0 days 00:19:00,-2,35,37
163,PAR,P000956,P007400,0 days 00:13:49,-9,29,38
163,PAR,P007400,P011192,0 days 00:12:41,-7,28,35
163,PAR,P009862,P011192,0 days 00:12:22,-5,28,33
163,PAR,P011192,P012743,0 days 00:12:02,-2,28,30
163,PAR,P000956,P009862,0 days 00:12:02,0,28,28
163,PAR,P004172,P012742,0 days 00:11:11,-3,19,22
163,PAR,P000956,P011192,0 days 00:11:00,-4,26,30
163,PAR,P007400,P011051,0 days 00:09:10,-21,11,32
163,PAR,P004058,P012742,0 days 00:08:54,-6,13,19
163,PAR,P007400,P012743,0 days 00:08:34,0,23,23
163,PAR,P000956,P012743,0 days 00:08:34,0,23,23
163,PAR,P009862,P012743,0 days 00:08:15,2,23,21
163,PAR,P009212,P009862,0 days 00:07:59,1,11,10
163,PAR,P009212,P012742,0 days 00:07:59,1,11,10
163,PAR,P009212,P012096,0 days 00:07:59,1,11,10
163,PAR,P009862,P011051,0 days 00:07:57,-15,10,25
163,PAR,P011051,P012742,0 days 00:07:54,-13,10,23
163,PAR,P004172,P012096,0 days 00:07:43,-1,14,15
163,PAR,P004172,P009862,0 days 00:07:33,-1,14,15
163,PAR,P011051,P012096,0 days 00:07:18,-10,10,20
163,PAR,P000956,P011051,0 days 00:06:55,-9,8,17
163,PAR,P004058,P009862,0 days 00:05:16,-4,8,12
163,PAR,P004058,P007400,0 days 00:05:16,-4,8,12
163,PAR,P011192,P012742,0 days 00:04:53,-2,7,9
163,PAR,P007400,P009212,0 days 00:04:34,2,7,5
163,PAR,P004058,P012096,0 days 00:04:24,2,8,6
163,PAR,P000956,P012096,0 days 00:04:10,-3,5,8
163,PAR,P000956,P012742,0 days 00:04:10,-3,5,8
163,PAR,P004172,P011192,0 days 00:03:38,-2,5,7
163,PAR,P004058,P004172,0 days 00:03:38,-2,5,7
163,PAR,P004058,P011192,0 days 00:03:38,-2,5,7
163,PAR,P004172,P007400,0 days 00:03:34,3,10,7
163,PAR,P012742,P012743,0 days 00:03:28,-2,5,7
163,PAR,P004172,P012743,0 days 00:03:28,-2,5,7
163,PAR,P004058,P012743,0 days 00:03:28,-2,5,7
163,PAR,P004172,P009212,0 days 00:03:25,-1,4,5
163,PAR,P011051,P011192,0 days 00:03:11,-9,3,12
163,PAR,P011192,P012096,0 days 00:01:51,-3,2,5
163,PAR,P004058,P011051,0 days 00:01:02,-6,0,6
163,PAR,P004172,P011051,0 days 00:00:34,-3,0,3
163,PAR,P011051,P012743,0 days 00:00:19,-2,0,2
164,ASV,P011225,PKIR,0 days 00:30:08,24,78,54
164,ASV,P006568,P011225,0 days 00:28:30,23,73,50
164,ASV,P011225,P012080,0 days 00:27:40,22,75,53
164,ASV,P012080,PKIR,0 days 00:26:51,17,69,52
164,ASV,P004194,PKIR,0 days 00:25:21,21,66,45
164,ASV,P004194,P011225,0 days 00:25:15,22,66,44
164,ASV,P006568,PKIR,0 days 00:25:15,23,67,44
164,ASV,P004194,P012080,0 days 00:24:33,15,62,47
164,ASV,P006568,P012080,0 days 00:22:59,20,64,44
164,ASV,P004194,P006568,0 days 00:19:42,22,55,33
164,ASV,P011225,P012729,0 days 00:15:48,0,31,31
164,ASV,P012080,P012729,0 days 00:13:30,2,31,29
164,ASV,P012729,PKIR,0 days 00:11:10,1,23,22
164,ASV,P003526,P012729,0 days 00:09:00,-8,15,23
164,ASV,P006568,P012729,0 days 00:08:53,1,18,17
164,ASV,P000229,P011225,0 days 00:07:57,-1,11,12
164,ASV,P000229,P012729,0 days 00:07:20,-12,7,19
164,ASV,P004194,P012729,0 days 00:07:13,-4,11,15
164,ASV,P003526,P011225,0 days 00:05:36,-4,8,12
164,ASV,P000229,P006568,0 days 00:05:31,3,9,6
164,ASV,P000229,P003526,0 days 00:05:13,-15,2,17
164,ASV,P003526,P012080,0 days 00:04:38,3,13,10
164,ASV,P003526,P012730,0 days 00:04:10,-4,9,13
164,ASV,P012729,P012730,0 days 00:04:10,-4,9,13
164,ASV,P000229,PKIR,0 days 00:04:08,5,9,4
164,ASV,P011386,P012729,0 days 00:03:40,-4,7,11
164,ASV,P003526,P006568,0 days 00:03:10,0,6,6
164,ASV,P000229,P004194,0 days 00:03:08,-1,4,5
164,ASV,P011386,P012080,0 days 00:03:07,1,7,6
164,ASV,P003526,P011386,0 days 00:02:53,-2,7,9
164,ASV,P011386,P012730,0 days 00:02:36,-2,7,9
164,ASV,P000229,P012730,0 days 00:02:07,-7,2,9
164,ASV,P012080,P012730,0 days 00:02:03,3,7,4
164,ASV,P003526,P004194,0 days 00:01:52,-5,0,5
164,ASV,P011225,P012730,0 days 00:01:34,-2,2,4
164,ASV,P004194,P011386,0 days 00:01:04,-2,0,2
164,ASV,P011386,PKIR,0 days 00:00:47,-2,0,2
164,ASV,P000229,P012080,0 days 00:00:39,-3,0,3
164,ASV,P000229,P011386,0 days 00:00:33,-5,0,5
164,ASV,P003526,PKIR,0 days 00:00:16,-1,0,1
164,ZAL,P002329,P011218,0 days 00:22:18,-13,42,55
164,ZAL,P007109,P011218,0 days 00:21:15,-7,45,52
164,ZAL,P003211,P007109,0 days 00:15:59,-4,37,41
164,ZAL,P011218,P012715,0 days 00:15:28,10,41,31
164,ZAL,P011218,P012787,0 days 00:14:04,2,30,28
164,ZAL,P002329,P007109,0 days 00:13:15,-10,27,37
164,ZAL,P003210,P007109,0 days 00:13:00,-13,21,34
164,ZAL,P007109,P009917,0 days 00:12:42,-4,26,30
164,ZAL,P003211,P011218,0 days 00:11:47,1,26,25
164,ZAL,P007109,P012715,0 days 00:11:31,2,30,28
164,ZAL,P002329,P012715,0 days 00:10:56,-4,24,28
164,ZAL,P005504,P011218,0 days 00:10:27,-8,18,26
164,ZAL,P003210,P011218,0 days 00:09:58,-8,15,23
164,ZAL,P002329,P003210,0 days 00:09:41,-7,17,24
164,ZAL,P002329,P005504,0 days 00:09:34,-5,18,23
164,ZAL,P003211,P012715,0 days 00:09:12,1,20,19
164,ZAL,P002329,P012787,0 days 00:09:06,-12,12,24
164,ZAL,P003210,P003211,0 days 00:08:57,-9,15,24
164,ZAL,P009917,P011218,0 days 00:08:50,4,18,14
164,ZAL,P012715,P012787,0 days 00:08:41,2,25,23
164,ZAL,P010390,P011218,0 days 00:08:38,0,15,15
164,ZAL,P003210,P005504,0 days 00:08:20,-12,12,24
164,ZAL,P002329,P003211,0 days 00:08:01,-8,13,21
164,ZAL,P007109,P012787,0 days 00:07:54,-1,18,19
164,ZAL,P007109,P010390,0 days 00:07:38,-1,14,15
164,ZAL,P003211,P009917,0 days 00:07:36,-3,15,18
164,ZAL,P005504,P007109,0 days 00:07:34,-10,14,24
164,ZAL,P003211,P012787,0 days 00:07:32,-1,17,18
164,ZAL,P009917,P010390,0 days 00:07:13,8,18,10
164,ZAL,P003210,P009917,0 days 00:07:03,-6,13,19
164,ZAL,P003210,P010390,0 days 00:06:12,2,14,12
164,ZAL,P009917,P012715,0 days 00:05:58,7,15,8
164,ZAL,P010390,P012787,0 days 00:05:50,2,12,10
164,ZAL,P003211,P010390,0 days 00:05:20,3,13,10
164,ZAL,P003211,P005504,0 days 00:05:08,-8,8,16
164,ZAL,P006860,P011218,0 days 00:04:51,-5,6,11
164,ZAL,P005504,P006860,0 days 00:04:51,-5,6,11
164,ZAL,P002329,P006860,0 days 00:04:51,-5,6,11
164,ZAL,P003210,P012715,0 days 00:04:47,-3,7,10
164,ZAL,P002329,P010390,0 days 00:04:17,-3,8,11
164,ZAL,P009917,P012787,0 days 00:03:59,5,8,3
164,ZAL,P005504,P009917,0 days 00:03:38,-10,2,12
164,ZAL,P010390,P012715,0 days 00:03:04,5,10,5
164,ZAL,P002329,P009917,0 days 00:03:01,3,9,6
164,ZAL,P006860,P012787,0 days 00:02:29,-2,2,4
164,ZAL,P005504,P012787,0 days 00:02:29,-2,2,4
164,ZAL,P003210,P006860,0 days 00:02:22,-3,4,7
164,ZAL,P003210,P012787,0 days 00:01:56,-5,2,7
164,ZAL,P005504,P012715,0 days 00:00:47,0,0,0
165,ULK,P006661,P008962,0 days 00:21:22,25,59,34
165,ULK,P004004,P011052,0 days 00:20:44,22,60,38
165,ULK,P009849,P011052,0 days 00:16:15,8,46,38
165,ULK,P001932,P008962,0 days 00:16:06,8,40,32
165,ULK,P001932,P006661,0 days 00:15:21,8,38,30
165,ULK,P001932,P006961,0 days 00:14:17,2,32,30
165,ULK,P006661,P006961,0 days 00:14:17,2,32,30
165,ULK,P006961,P008962,0 days 00:14:17,2,32,30
165,ULK,P004004,P009849,0 days 00:13:50,3,39,36
165,ULK,P011052,P011157,0 days 00:13:36,4,35,31
165,ULK,P009849,P011157,0 days 00:12:43,2,35,33
165,ULK,P005844,P008962,0 days 00:12:16,30,42,12
165,ULK,P005844,P006661,0 days 00:11:31,24,36,12
165,ULK,P002968,P006661,0 days 00:11:29,3,25,22
165,ULK,P004004,P011157,0 days 00:11:11,-1,28,29
165,ULK,P004004,P008962,0 days 00:10:33,28,39,11
165,ULK,P004004,P005844,0 days 00:10:13,26,35,9
165,ULK,P002968,P008962,0 days 00:09:51,1,23,22
165,ULK,P005844,P011052,0 days 00:09:09,20,29,9
165,ULK,P008962,P011052,0 days 00:08:44,22,31,9
165,ULK,P004004,P006661,0 days 00:08:43,25,29,4
165,ULK,P002968,P006961,0 days 00:08:29,-2,18,20
165,ULK,P001932,P002968,0 days 00:08:29,-2,18,20
165,ULK,P006661,P011052,0 days 00:07:39,19,23,4
165,ULK,P002968,P004004,0 days 00:07:27,1,19,18
165,ULK,P002968,P011052,0 days 00:07:27,1,19,18
165,ULK,P001932,P005844,0 days 00:06:52,10,20,10
165,ULK,P009849,P011980,0 days 00:06:42,5,16,11
165,ULK,P011052,P011980,0 days 00:06:42,5,16,11
165,ULK,P002968,P011157,0 days 00:06:05,-2,14,16
165,ULK,P005844,P006961,0 days 00:05:48,4,14,10
165,ULK,P002969,P009849,0 days 00:05:20,7,17,10
165,ULK,P002969,P011052,0 days 00:05:20,7,17,10
165,ULK,P002969,P011157,0 days 00:05:20,7,17,10
165,ULK,P005844,P009849,0 days 00:04:30,6,13,7
165,ULK,P002968,P009849,0 days 00:04:27,-4,12,16
165,ULK,P004004,P011980,0 days 00:03:32,0,7,7
165,ULK,P005844,P011980,0 days 00:03:32,0,7,7
165,ULK,P008962,P009849,0 days 00:03:28,5,12,7
165,ULK,P011157,P011980,0 days 00:03:10,5,9,4
165,ULK,P002969,P011980,0 days 00:03:10,5,9,4
165,ULK,P008962,P011157,0 days 00:02:43,-1,6,7
165,ULK,P002969,P004004,0 days 00:02:10,2,8,6
165,ULK,P001932,P004004,0 days 00:01:49,6,8,2
165,ULK,P006661,P011157,0 days 00:01:38,2,2,0
165,ULK,P001932,P009849,0 days 00:00:45,0,2,2
165,ULK,P001932,P011157,0 days 00:00:45,0,2,2
165,ULK,P005844,P011157,0 days 00:00:13,0,0,0
165,TEL,P009622,P009863,0 days 00:27:27,-29,44,73
165,TEL,P009622,P009783,0 days 00:25:05,-21,44,65
165,TEL,P009783,P009863,0 days 00:25:05,-21,44,65
165,TEL,P009622,P011199,0 days 00:22:02,-16,36,52
165,TEL,P009863,P011199,0 days 00:22:02,-16,36,52
165,TEL,P009783,P011199,0 days 00:20:42,-14,36,50
165,TEL,P009622,P011219,0 days 00:17:03,-13,26,39
165,TEL,P009863,P011219,0 days 00:17:03,-13,26,39
165,TEL,P009783,P011219,0 days 00:14:41,-5,26,31
165,TEL,P011199,P011219,0 days 00:13:57,-2,24,26
165,TEL,P011193,P011214,0 days 00:12:33,-6,30,36
165,TEL,P007990,P011193,0 days 00:12:33,-6,30,36
165,TEL,P007990,P011214,0 days 00:12:33,-6,30,36
165,TEL,P011214,P011971,0 days 00:11:32,-12,29,41
165,TEL,P007990,P012744,0 days 00:08:26,0,21,21
165,TEL,P011193,P012744,0 days 00:08:26,0,21,21
165,TEL,P011214,P012744,0 days 00:08:26,0,21,21
165,TEL,P011193,P011971,0 days 00:08:11,-4,23,27
165,TEL,P007990,P011971,0 days 00:08:11,-4,23,27
165,TEL,P009622,P011971,0 days 00:06:51,-16,10,26
165,TEL,P009863,P011971,0 days 00:06:31,-13,10,23
165,TEL,P009783,P011971,0 days 00:05:29,-7,10,17
165,TEL,P011971,P012744,0 days 00:04:33,4,16,12
165,TEL,P005145,P011193,0 days 00:04:12,-2,7,9
165,TEL,P005145,P007990,0 days 00:04:12,-2,7,9
165,TEL,P005145,P011214,0 days 00:04:12,-2,7,9
165,TEL,P009863,P012744,0 days 00:04:10,-12,2,14
165,TEL,P009622,P012744,0 days 00:04:10,-12,2,14
165,TEL,P009783,P012744,0 days 00:04:10,-12,2,14
165,TEL,P005145,P012744,0 days 00:03:53,-4,5,9
165,TEL,P009622,P011214,0 days 00:03:41,-11,6,17
165,TEL,P004233,P007990,0 days 00:03:28,-5,7,12
165,TEL,P004233,P011214,0 days 00:03:28,-5,7,12
165,TEL,P004233,P011193,0 days 00:03:28,-5,7,12
165,TEL,P009863,P011214,0 days 00:03:21,-8,6,14
165,TEL,P004233,P011971,0 days 00:03:18,-5,7,12
165,TEL,P011199,P011971,0 days 00:03:10,-5,4,9
165,TEL,P005145,P009783,0 days 00:03:08,0,10,10
165,TEL,P005145,P011199,0 days 00:02:49,-2,8,10
165,TEL,P005145,P009863,0 days 00:02:49,-2,8,10
165,TEL,P005145,P009622,0 days 00:02:49,-2,8,10
165,TEL,P009783,P011214,0 days 00:02:38,0,8,8
165,TEL,P011199,P012744,0 days 00:02:06,-7,0,7
165,TEL,P011219,P012744,0 days 00:02:04,-5,2,7
165,TEL,P007990,P009622,0 days 00:01:40,-5,0,5
165,TEL,P007990,P011219,0 days 00:01:30,-2,0,2
165,TEL,P007990,P009863,0 days 00:01:20,-2,0,2
165,TEL,P007990,P011199,0 days 00:01:20,-2,0,2
165,TEL,P011214,P011219,0 days 00:01:12,-6,0,6
165,TEL,P011219,P011971,0 days 00:01:02,-6,0,6
165,TEL,P009622,P011193,0 days 00:00:20,-3,0,3
165,TEL,P007990,P009783,0 days 00:00:19,2,2,0
165,TEL,P009783,P011193,0 days 00:00:19,2,2,0
165,TEL,P004233,P011219,0 days 00:00:10,0,0,0
165,TEL,P011193,P011219,0 days 00:00:10,0,0,0
166,OLY,P008855,P010612,0 days 00:23:44,-1,50,51
166,OLY,P008829,P008855,0 days 00:23:39,-1,43,44
166,OLY,P008811,P010612,0 days 00:22:42,0,49,49
166,OLY,P008829,P010612,0 days 00:21:54,0,42,42
166,OLY,P008811,P008855,0 days 00:21:01,-2,45,47
166,OLY,P008811,P008829,0 days 00:19:50,1,39,38
166,OLY,P001255,P008855,0 days 00:18:37,-8,38,46
166,OLY,P001255,P010612,0 days 00:18:34,-8,38,46
166,OLY,P001255,P008811,0 days 00:17:29,-5,37,42
166,OLY,P001255,P008829,0 days 00:15:07,-10,26,36
166,OLY,P007853,P008855,0 days 00:14:52,10,30,20
166,OLY,P003941,P007853,0 days 00:14:32,5,23,18
166,OLY,P003941,P008855,0 days 00:12:12,2,19,17
166,OLY,P007853,P007982,0 days 00:11:17,-1,14,15
166,OLY,P007853,P011194,0 days 00:10:19,-2,14,16
166,OLY,P003941,P007982,0 days 00:09:43,-1,12,13
166,OLY,P003941,P011194,0 days 00:09:30,0,14,14
166,OLY,P008855,P011194,0 days 00:09:26,4,20,16
166,OLY,P007853,P008829,0 days 00:09:18,12,20,8
166,OLY,P007982,P011194,0 days 00:07:10,-4,7,11
166,OLY,P003941,P011983,0 days 00:06:37,1,11,10
166,OLY,P011194,P011983,0 days 00:06:37,1,11,10
166,OLY,P007853,P011983,0 days 00:06:36,1,11,10
166,OLY,P007982,P008855,0 days 00:06:31,-1,8,9
166,OLY,P003941,P008829,0 days 00:06:06,1,9,8
166,OLY,P007982,P008829,0 days 00:05:54,5,11,6
166,OLY,P007853,P010612,0 days 00:05:18,8,15,7
166,OLY,P007853,P008811,0 days 00:05:07,3,12,9
166,OLY,P008811,P011194,0 days 00:04:10,1,10,9
166,OLY,P007982,P010392,0 days 00:03:24,1,6,5
166,OLY,P007982,P011983,0 days 00:03:24,-1,4,5
166,OLY,P007982,P008811,0 days 00:03:24,1,6,5
166,OLY,P008811,P010392,0 days 00:03:21,1,6,5
166,OLY,P001255,P011194,0 days 00:03:20,3,10,7
166,OLY,P010612,P011194,0 days 00:03:18,3,10,7
166,OLY,P008855,P011983,0 days 00:03:13,2,7,5
166,OLY,P003941,P010612,0 days 00:02:41,0,4,4
166,OLY,P008829,P010392,0 days 00:02:28,4,6,2
166,OLY,P007982,P010612,0 days 00:01:50,1,4,3
166,OLY,P010392,P010612,0 days 00:01:50,1,4,3
166,OLY,P007853,P010392,0 days 00:01:34,0,2,2
166,OLY,P001255,P003941,0 days 00:01:03,-4,0,4
166,OLY,P010392,P011194,0 days 00:00:50,-2,0,2
166,OLY,P001255,P007853,0 days 00:00:15,0,3,3
166,OLY,P008855,P010392,0 days 00:00:09,-1,0,1
166,OLY,P001255,P007982,0 days 00:00:03,0,0,0
166,OLY,P010612,P011983,0 days 00:00:01,0,0,0
166,MCO,P005985,P010588,0 days 00:29:13,1,57,56
166,MCO,P005985,P011226,0 days 00:22:14,-2,46,48
166,MCO,P010588,P011226,0 days 00:21:04,2,44,42
166,MCO,P002581,P011226,0 days 00:16:38,3,35,32
166,MCO,P011212,PLCZ,0 days 00:16:06,-8,25,33
166,MCO,P002581,P005985,0 days 00:15:45,3,33,30
166,MCO,P011212,P011231,0 days 00:15:38,-2,25,27
166,MCO,P010588,P011212,0 days 00:15:30,-7,28,35
166,MCO,P002581,P010588,0 days 00:14:35,7,31,24
166,MCO,P004197,P005985,0 days 00:13:59,7,32,25
166,MCO,P004197,P010588,0 days 00:13:59,7,32,25
166,MCO,P004197,P011226,0 days 00:13:59,7,32,25
166,MCO,P010588,PLCZ,0 days 00:13:41,-4,26,30
166,MCO,P005985,P011212,0 days 00:13:03,-8,23,31
166,MCO,P011231,P012709,0 days 00:12:55,-1,18,19
166,MCO,P011231,PLCZ,0 days 00:12:37,-4,21,25
166,MCO,P002581,P004197,0 days 00:12:15,5,26,21
166,MCO,P005985,PLCZ,0 days 00:11:14,-5,21,26
166,MCO,P010588,P011231,0 days 00:10:39,0,18,18
166,MCO,P011212,P011226,0 days 00:10:03,-3,16,19
166,MCO,P011212,P012709,0 days 00:09:37,1,14,13
166,MCO,P005985,P011231,0 days 00:09:22,-5,15,20
166,MCO,P012709,PLCZ,0 days 00:06:36,-1,10,11
166,MCO,P002581,P011231,0 days 00:06:19,0,8,8
166,MCO,P002581,P012709,0 days 00:06:19,0,8,8
166,MCO,P011226,PLCZ,0 days 00:05:13,-2,10,12
166,MCO,P010588,P012709,0 days 00:04:35,3,7,4
166,MCO,P004790,P011212,0 days 00:04:15,-1,6,7
166,MCO,P011226,P011231,0 days 00:04:14,-2,6,8
166,MCO,P004790,P011231,0 days 00:04:12,-2,5,7
166,MCO,P011226,P012709,0 days 00:04:11,-2,6,8
166,MCO,P004790,P012709,0 days 00:04:09,-2,5,7
166,MCO,P004790,PLCZ,0 days 00:04:09,-2,5,7
166,MCO,P005985,P012709,0 days 00:03:18,-2,4,6
166,MCO,P011196,P011226,0 days 00:03:15,-2,4,6
166,MCO,P011196,P011212,0 days 00:03:15,-2,4,6
166,MCO,P010588,P011196,0 days 00:03:15,-2,4,6
166,MCO,P005985,P011196,0 days 00:03:15,-2,4,6
166,MCO,P002581,P011212,0 days 00:03:13,2,7,5
166,MCO,P004197,PLCZ,0 days 00:01:44,2,6,4
166,MCO,P004790,P005985,0 days 00:00:09,1,1,0
166,MCO,P004790,P010588,0 days 00:00:09,1,1,0
166,MCO,P004790,P011226,0 days 00:00:09,1,1,0
167,BER,P008173,P011934,0 days 00:20:15,-5,33,38
167,BER,P003958,P012720,0 days 00:16:37,-10,29,39
167,BER,P011934,P012720,0 days 00:15:57,-13,19,32
167,BER,P010791,P012720,0 days 00:15:40,9,34,25
167,BER,P008173,P012720,0 days 00:15:24,-10,19,29
167,BER,P003958,P008173,0 days 00:15:02,-14,21,35
167,BER,P003958,P011934,0 days 00:14:59,-17,20,37
167,BER,P008967,P010791,0 days 00:12:58,8,31,23
167,BER,P003958,P008967,0 days 00:12:33,1,30,29
167,BER,P008967,P012720,0 days 00:12:24,9,32,23
167,BER,P008173,P012721,0 days 00:12:17,-17,10,27
167,BER,P008211,P008967,0 days 00:12:09,-4,25,29
167,BER,P003958,P008211,0 days 00:10:50,-3,23,26
167,BER,P008211,P010791,0 days 00:10:39,1,22,21
167,BER,P011934,P012721,0 days 00:10:26,-14,7,21
167,BER,P003958,P012721,0 days 00:09:46,-16,8,24
167,BER,P012720,P012721,0 days 00:09:43,-14,7,21
167,BER,P006251,P007025,0 days 00:09:06,-1,16,17
167,BER,P006251,P008967,0 days 00:08:43,-5,12,17
167,BER,P003958,P007025,0 days 00:08:34,-10,12,22
167,BER,P008211,P012720,0 days 00:08:06,4,21,17
167,BER,P007025,P012720,0 days 00:07:21,-3,11,14
167,BER,P008967,P011934,0 days 00:07:04,2,17,15
167,BER,P006251,P010791,0 days 00:07:04,-4,9,13
167,BER,P003958,P010791,0 days 00:06:34,4,18,14
167,BER,P006251,P008211,0 days 00:06:33,-4,7,11
167,BER,P007025,P008967,0 days 00:06:20,-5,10,15
167,BER,P007025,P008211,0 days 00:06:07,-6,7,13
167,BER,P008173,P008384,0 days 00:05:48,4,16,12
167,BER,P008173,P008967,0 days 00:05:31,8,15,7
167,BER,P007025,P010791,0 days 00:05:30,-3,7,10
167,BER,P007025,P011934,0 days 00:05:26,-2,13,15
167,BER,P006251,P008384,0 days 00:05:13,-2,10,12
167,BER,P008384,P011934,0 days 00:05:13,5,14,9
167,BER,P007025,P008173,0 days 00:05:12,-1,12,13
167,BER,P008173,P010791,0 days 00:05:08,3,8,5
167,BER,P010791,P011934,0 days 00:05:08,3,8,5
167,BER,P008384,P008967,0 days 00:04:54,-2,8,10
167,BER,P006251,P012720,0 days 00:04:44,0,8,8
167,BER,P003958,P006251,0 days 00:04:19,-4,6,10
167,BER,P003958,P008384,0 days 00:04:14,1,9,8
167,BER,P010791,P012721,0 days 00:04:03,-5,2,7
167,BER,P006251,P008173,0 days 00:03:47,0,10,10
167,BER,P008211,P008384,0 days 00:02:42,-4,1,5
167,BER,P008384,P010791,0 days 00:02:20,-4,1,5
167,BER,P006251,P011934,0 days 00:01:56,3,7,4
167,BER,P007025,P008384,0 days 00:01:56,3,7,4
167,BER,P006251,P012721,0 days 00:01:51,-3,3,6
167,BER,P008211,P011934,0 days 00:01:48,-6,2,8
167,BER,P008384,P012721,0 days 00:01:40,-1,2,3
167,BER,P007025,P012721,0 days 00:01:40,-4,1,5
167,BER,P008211,P012721,0 days 00:00:46,-2,0,2
167,VIR,P001133,P003048,0 days 00:21:09,2,47,45
167,VIR,P003048,P009549,0 days 00:20:46,6,45,39
167,VIR,P001844,P003048,0 days 00:19:45,6,43,37
167,VIR,P001133,P009549,0 days 00:19:27,9,45,36
167,VIR,P001133,P001844,0 days 00:19:10,7,43,36
167,VIR,P001844,P009549,0 days 00:16:27,6,36,30
167,VIR,P001844,PBCN,0 days 00:15:17,1,31,30
167,VIR,P009549,PBCN,0 days 00:15:17,1,31,30
167,VIR,P003048,PBCN,0 days 00:14:54,1,31,30
167,VIR,P001133,PBCN,0 days 00:14:46,2,31,29
167,VIR,P003527,P010781,0 days 00:14:26,11,29,18
167,VIR,P006739,P010781,0 days 00:14:09,12,30,18
167,VIR,P004554,P010781,0 days 00:12:12,9,25,16
167,VIR,P002084,P010781,0 days 00:11:34,4,22,18
167,VIR,P004554,P006739,0 days 00:11:23,9,25,16
167,VIR,P003527,P006739,0 days 00:11:00,9,23,14
167,VIR,P002084,P003527,0 days 00:10:00,6,20,14
167,VIR,P003048,P003527,0 days 00:09:34,2,18,16
167,VIR,P003527,P004554,0 days 00:09:03,6,18,12
167,VIR,P002084,P004554,0 days 00:08:57,2,16,14
167,VIR,P009549,P010781,0 days 00:08:45,13,21,8
167,VIR,P002084,P006739,0 days 00:08:08,2,16,14
167,VIR,P006739,P009549,0 days 00:07:35,8,16,8
167,VIR,P003048,P010781,0 days 00:06:33,10,16,6
167,VIR,P001133,P005553,0 days 00:05:58,-5,11,16
167,VIR,P003048,P005553,0 days 00:05:36,-5,11,16
167,VIR,P004554,P009549,0 days 00:05:12,5,11,6
167,VIR,P003527,P009549,0 days 00:04:57,4,9,5
167,VIR,P001844,P003527,0 days 00:04:34,-1,7,8
167,VIR,P003048,P012713,0 days 00:04:32,-3,10,13
167,VIR,P003527,P005553,0 days 00:04:02,-2,7,9
167,VIR,P001133,P003527,0 days 00:04:02,-2,7,9
167,VIR,P003527,P012713,0 days 00:03:47,0,6,6
167,VIR,P001844,P005553,0 days 00:03:14,0,7,7
167,VIR,P001133,P012713,0 days 00:03:06,-5,4,9
167,VIR,P005553,P012713,0 days 00:03:06,-5,4,9
167,VIR,P003048,P006739,0 days 00:02:46,3,5,2
167,VIR,P001133,P010781,0 days 00:02:45,10,10,0
167,VIR,P002084,P003048,0 days 00:02:37,2,6,4
167,VIR,P002084,P012713,0 days 00:02:37,2,6,4
167,VIR,P010781,P012713,0 days 00:02:37,2,6,4
167,VIR,P001844,P010781,0 days 00:01:59,5,5,0
167,VIR,P001133,P004554,0 days 00:01:58,5,5,0
167,VIR,P009549,P012713,0 days 00:01:56,-3,4,7
167,VIR,P005553,P009549,0 days 00:01:56,-3,4,7
167,VIR,P001133,P006739,0 days 00:01:35,5,5,0
167,VIR,P002084,P009549,0 days 00:01:34,-2,2,4
167,VIR,P001844,P002084,0 days 00:00:49,0,0,0
167,VIR,P004554,P012713,0 days 00:00:49,0,0,0
167,VIR,P003527,PBCN,0 days 00:00:31,-1,0,1
167,VIR,P001844,P004554,0 days 00:00:23,0,0,0
167,VIR,P004554,PBCN,0 days 00:00:23,0,0,0
167,VIR,P001844,P012713,0 days 00:00:22,0,0,0
168,MIL,P009960,P011224,0 days 00:17:26,18,39,21
168,MIL,P005670,P009960,0 days 00:17:10,7,30,23
168,MIL,P006701,P011205,0 days 00:16:10,19,38,19
168,MIL,P005670,P007201,0 days 00:16:01,3,26,23
168,MIL,P007201,P011224,0 days 00:15:42,-3,22,25
168,MIL,P002849,P011224,0 days 00:14:54,9,25,16
168,MIL,P002849,P009960,0 days 00:14:45,2,23,21
168,MIL,P006509,P011205,0 days 00:14:20,-9,22,31
168,MIL,P002812,P011205,0 days 00:14:19,-6,25,31
168,MIL,P002849,P005670,0 days 00:14:18,2,23,21
168,MIL,P005670,P011224,0 days 00:14:03,2,22,20
168,MIL,P011205,P011224,0 days 00:13:41,10,32,22
168,MIL,P001518,P011205,0 days 00:12:42,9,30,21
168,MIL,P002849,P007201,0 days 00:12:01,2,18,16
168,MIL,P009960,P011205,0 days 00:11:55,19,31,12
168,MIL,P007201,P009960,0 days 00:11:25,2,18,16
168,MIL,P002812,P006701,0 days 00:10:48,3,19,16
168,MIL,P005670,P011205,0 days 00:09:29,6,20,14
168,MIL,P006701,P011224,0 days 00:09:20,19,24,5
168,MIL,P002849,P011205,0 days 00:09:03,6,16,10
168,MIL,P001518,P006701,0 days 00:09:03,9,23,14
168,MIL,P001518,P009960,0 days 00:08:35,19,26,7
168,MIL,P002812,P006509,0 days 00:08:06,-14,12,26
168,MIL,P002812,P011224,0 days 00:07:56,-6,11,17
168,MIL,P001518,P006509,0 days 00:07:52,-6,13,19
168,MIL,P001518,P011224,0 days 00:07:23,8,21,13
168,MIL,P006509,P006701,0 days 00:06:19,-4,10,14
168,MIL,P006701,P009960,0 days 00:06:10,14,19,5
168,MIL,P002812,P007201,0 days 00:06:03,-4,10,14
168,MIL,P002849,P006509,0 days 00:06:00,-1,9,10
168,MIL,P006509,P009960,0 days 00:05:54,3,10,7
168,MIL,P002849,P006701,0 days 00:05:44,6,11,5
168,MIL,P007201,P011205,0 days 00:05:41,-2,10,12
168,MIL,P005670,P006509,0 days 00:05:27,3,10,7
168,MIL,P002812,P002849,0 days 00:05:07,6,11,5
168,MIL,P002812,P005670,0 days 00:04:36,1,8,7
168,MIL,P001518,P002812,0 days 00:04:13,-12,4,16
168,MIL,P006509,P011224,0 days 00:03:27,-9,4,13
168,MIL,P006701,P007201,0 days 00:03:24,1,6,5
168,MIL,P005670,P006701,0 days 00:03:08,3,6,3
168,MIL,P001518,P005670,0 days 00:02:52,5,7,2
168,MIL,P006509,P007201,0 days 00:01:53,-5,2,7
168,MIL,P001518,P006721,0 days 00:00:47,1,2,1
168,MIL,P001518,P011926,0 days 00:00:47,1,2,1
168,MIL,P006509,P006721,0 days 00:00:47,1,2,1
168,MIL,P006509,P011926,0 days 00:00:47,1,2,1
168,MIL,P006701,P006721,0 days 00:00:47,1,2,1
168,MIL,P006701,P011926,0 days 00:00:47,1,2,1
168,MIL,P006721,P011926,0 days 00:00:47,1,2,1
168,MIL,P001518,P007201,0 days 00:00:06,-2,0,2
168,MUN,P003583,P011987,0 days 00:25:45,-6,39,45
168,MUN,P007056,P011987,0 days 00:18:30,-6,28,34
168,MUN,P003583,P007056,0 days 00:18:17,2,27,25
168,MUN,P001288,P003583,0 days 00:17:21,-9,24,33
168,MUN,P003583,P006760,0 days 00:16:51,-2,28,30
168,MUN,P006760,P011987,0 days 00:16:46,-12,29,41
168,MUN,P003583,P008985,0 days 00:16:17,0,27,27
168,MUN,P008985,P011987,0 days 00:16:01,0,27,27
168,MUN,P001288,P011987,0 days 00:14:32,-6,22,28
168,MUN,P001288,P008985,0 days 00:13:26,-2,25,27
168,MUN,P007056,P007975,0 days 00:13:10,-7,22,29
168,MUN,P006760,P007975,0 days 00:13:03,-9,21,30
168,MUN,P004508,P007975,0 days 00:13:01,-5,22,27
168,MUN,P003583,P007975,0 days 00:12:05,-5,18,23
168,MUN,P006760,P007056,0 days 00:11:23,-10,17,27
168,MUN,P001288,P007056,0 days 00:10:43,2,17,15
168,MUN,P007975,P011987,0 days 00:09:45,-10,17,27
168,MUN,P001288,P004508,0 days 00:09:38,-4,14,18
168,MUN,P007056,P008985,0 days 00:09:25,5,17,12
168,MUN,P004508,P007056,0 days 00:08:54,-4,16,20
168,MUN,P001288,P007975,0 days 00:08:20,-6,11,17
168,MUN,P001288,P006760,0 days 00:07:55,-6,12,18
168,MUN,P008985,P010391,0 days 00:07:46,-3,10,13
168,MUN,P003583,P010391,0 days 00:07:28,-4,5,9
168,MUN,P004508,P006760,0 days 00:07:17,-3,13,16
168,MUN,P010391,P011987,0 days 00:07:12,-4,5,9
168,MUN,P001288,P010391,0 days 00:07:01,-8,5,13
168,MUN,P006760,P008985,0 days 00:07:01,-2,12,14
168,MUN,P003583,P004508,0 days 00:06:35,1,10,9
168,MUN,P001557,P007975,0 days 00:05:44,-2,9,11
168,MUN,P001557,P004508,0 days 00:05:44,-2,9,11
168,MUN,P007056,P010391,0 days 00:05:13,1,5,4
168,MUN,P001288,P001557,0 days 00:05:12,0,9,9
168,MUN,P001557,P007056,0 days 00:04:21,1,7,6
168,MUN,P004508,P011987,0 days 00:03:59,-4,9,13
168,MUN,P004508,P008985,0 days 00:02:48,-1,5,6
168,MUN,P004508,P010391,0 days 00:02:48,-1,5,6
168,MUN,P001288,P007639,0 days 00:02:32,-1,5,6
168,MUN,P004508,P007639,0 days 00:02:32,-1,5,6
168,MUN,P007639,P008985,0 days 00:02:32,-1,5,6
168,MUN,P007639,P010391,0 days 00:02:32,-1,5,6
168,MUN,P001557,P003583,0 days 00:02:25,-5,2,7
168,MUN,P001557,P011987,0 days 00:00:10,0,0,0
169,BAR,P002939,P012745,0 days 00:24:59,-4,51,55
169,BAR,P004866,P012745,0 days 00:22:19,9,55,46
169,BAR,P000925,P012745,0 days 00:20:40,13,53,40
169,BAR,P002939,P004866,0 days 00:19:32,-1,42,43
169,BAR,P006435,P007464,0 days 00:19:04,4,43,39
169,BAR,P007464,P012745,0 days 00:17:36,6,42,36
169,BAR,P004866,P007464,0 days 00:17:30,15,46,31
169,BAR,P000925,P002939,0 days 00:16:48,3,36,33
169,BAR,P000925,P004866,0 days 00:16:25,15,45,30
169,BAR,P006435,P012745,0 days 00:16:12,-3,36,39
169,BAR,P004866,P006435,0 days 00:15:27,9,40,31
169,BAR,P000925,P007464,0 days 00:14:39,8,35,27
169,BAR,P003196,P006435,0 days 00:14:32,-3,30,33
169,BAR,P003196,P004866,0 days 00:14:27,-3,29,32
169,BAR,P002939,P007464,0 days 00:14:09,-5,27,32
169,BAR,P002939,P009992,0 days 00:13:11,-2,28,30
169,BAR,P003196,P007464,0 days 00:11:59,-1,26,27
169,BAR,P004866,P009992,0 days 00:11:18,-1,24,25
169,BAR,P002939,P003196,0 days 00:10:43,-11,19,30
169,BAR,P002939,P006435,0 days 00:10:42,-12,17,29
169,BAR,P009992,P012745,0 days 00:10:39,2,24,22
169,BAR,P003196,P012745,0 days 00:10:18,-10,17,27
169,BAR,P000925,P009992,0 days 00:09:21,2,22,20
169,BAR,P000925,P006435,0 days 00:08:39,3,21,18
169,BAR,P003204,P007464,0 days 00:07:39,4,17,13
169,BAR,P003204,P006435,0 days 00:07:39,4,17,13
169,BAR,P003196,P003204,0 days 00:07:39,4,17,13
169,BAR,P003204,P004866,0 days 00:06:30,5,15,10
169,BAR,P007464,P009992,0 days 00:03:56,-3,8,11
169,BAR,P003196,P009992,0 days 00:03:50,-4,6,10
169,BAR,P003204,P012745,0 days 00:01:09,-1,2,3
169,BAR,P006435,P009992,0 days 00:00:29,-2,0,2
169,BAS,P009048,P011948,0 days 00:25:24,8,54,46
169,BAS,P007230,P009048,0 days 00:24:46,0,53,53
169,BAS,P007230,P011948,0 days 00:20:38,7,45,38
169,BAS,P004761,P007230,0 days 00:20:25,-1,42,43
169,BAS,P007230,P010444,0 days 00:20:04,-8,38,46
169,BAS,P004761,P009048,0 days 00:19:31,1,46,45
169,BAS,P009048,P010444,0 days 00:18:20,-8,36,44
169,BAS,P004761,P012201,0 days 00:16:14,-15,32,47
169,BAS,P009048,P012201,0 days 00:15:37,-9,33,42
169,BAS,P010444,P011948,0 days 00:14:12,-1,28,29
169,BAS,P007230,P012201,0 days 00:13:23,-15,21,36
169,BAS,P004603,P004761,0 days 00:13:21,5,34,29
169,BAS,P004603,P009048,0 days 00:13:17,9,34,25
169,BAS,P004761,P011948,0 days 00:12:02,10,29,19
169,BAS,P004603,P011948,0 days 00:11:12,9,26,17
169,BAS,P003198,P009048,0 days 00:10:46,7,30,23
169,BAS,P004603,P012201,0 days 00:10:02,1,25,24
169,BAS,P004603,P007230,0 days 00:09:39,8,25,17
169,BAS,P004761,P010444,0 days 00:09:14,-4,17,21
169,BAS,P010444,P012201,0 days 00:08:39,-10,13,23
169,BAS,P011948,P012201,0 days 00:07:31,-2,12,14
169,BAS,P003198,P011948,0 days 00:06:48,7,17,10
169,BAS,P004761,P012765,0 days 00:06:30,-5,10,15
169,BAS,P007230,P012765,0 days 00:06:30,-5,10,15
169,BAS,P012201,P012765,0 days 00:06:30,-5,10,15
169,BAS,P003198,P012201,0 days 00:06:29,2,17,15
169,BAS,P003198,P004603,0 days 00:04:36,2,12,10
169,BAS,P008850,P009048,0 days 00:04:26,-4,9,13
169,BAS,P003198,P007230,0 days 00:04:17,5,13,8
169,BAS,P003198,P010444,0 days 00:04:17,5,13,8
169,BAS,P007230,P008850,0 days 00:03:49,-6,5,11
169,BAS,P008850,P011948,0 days 00:03:49,-6,5,11
169,BAS,P008850,P010444,0 days 00:03:49,-6,5,11
169,BAS,P004761,P008072,0 days 00:03:26,-5,5,10
169,BAS,P008072,P012201,0 days 00:03:26,-5,5,10
169,BAS,P003198,P004761,0 days 00:03:21,-2,9,11
169,BAS,P004603,P012765,0 days 00:03:12,0,8,8
169,BAS,P003198,P008072,0 days 00:01:53,0,5,5
169,BAS,P008072,P009048,0 days 00:01:53,0,5,5
169,BAS,P010444,P012765,0 days 00:01:45,0,2,2
169,BAS,P007230,P008072,0 days 00:01:33,-5,0,5
169,BAS,P008072,P012765,0 days 00:01:33,-5,0,5
169,BAS,P003198,P008850,0 days 00:00:37,2,4,2
169,BAS,P004603,P008850,0 days 00:00:37,2,4,2
169,BAS,P008850,P012201,0 days 00:00:37,2,4,2
170,MAD,P003108,P005791,0 days 00:34:09,18,117,99
170,MAD,P001392,P006540,0 days 00:33:38,14,90,76
170,MAD,P003108,P006540,0 days 00:31:12,10,98,88
170,MAD,P005791,P006540,0 days 00:31:12,10,98,88
170,MAD,P001392,P003108,0 days 00:30:50,24,102,78
170,MAD,P001392,P005791,0 days 00:30:50,24,102,78
170,MAD,P005928,P006540,0 days 00:29:12,10,89,79
170,MAD,P003108,P005928,0 days 00:29:07,18,99,81
170,MAD,P005791,P005928,0 days 00:29:07,18,99,81
170,MAD,P001392,P005928,0 days 00:26:54,25,88,63
170,MAD,P010357,PCVM,0 days 00:11:22,-11,16,27
170,MAD,P004887,P010357,0 days 00:10:51,-14,13,27
170,MAD,P004887,PCVM,0 days 00:10:34,-16,11,27
170,MAD,P003733,PTGB,0 days 00:08:14,-7,8,15
170,MAD,PCVM,PTGB,0 days 00:07:27,-8,10,18
170,MAD,P004887,PTGB,0 days 00:06:38,-7,8,15
170,MAD,P010357,PTGB,0 days 00:06:38,-7,8,15
170,MAD,P003733,P010357,0 days 00:06:23,-7,8,15
170,MAD,P003733,PCVM,0 days 00:06:23,-7,8,15
170,MAD,P003733,P004887,0 days 00:06:23,-7,8,15
170,MAD,P001392,P010357,0 days 00:04:43,6,12,6
170,MAD,P003108,P009213,0 days 00:04:37,-12,6,18
170,MAD,P005791,P009213,0 days 00:04:37,-12,6,18
170,MAD,P006540,P010357,0 days 00:04:13,-7,5,12
170,MAD,P004887,P006540,0 days 00:04:13,-7,5,12
170,MAD,P006540,PCVM,0 days 00:03:56,-9,3,12
170,MAD,P006540,P009213,0 days 00:03:48,-11,4,15
170,MAD,P005928,P009213,0 days 00:03:48,-11,4,15
170,MAD,P001392,PCVM,0 days 00:03:36,2,8,6
170,MAD,P003733,P005928,0 days 00:03:22,2,5,3
170,MAD,P003733,P005791,0 days 00:03:22,2,5,3
170,MAD,P003108,P003733,0 days 00:03:22,2,5,3
170,MAD,P001392,P004887,0 days 00:03:05,-1,5,6
170,MAD,P005928,P010357,0 days 00:02:15,-2,4,6
170,MAD,P001392,PTGB,0 days 00:02:04,-2,21,23
170,MAD,P003108,P010357,0 days 00:01:53,7,7,0
170,MAD,P003108,PCVM,0 days 00:01:52,4,7,3
170,MAD,P005791,P010357,0 days 00:01:38,7,7,0
170,MAD,P005791,PCVM,0 days 00:01:37,4,7,3
170,MAD,P003733,P006540,0 days 00:01:31,2,5,3
170,MAD,P004887,P005928,0 days 00:01:25,-4,2,6
170,MAD,P005928,PCVM,0 days 00:01:08,-6,0,6
170,MAD,P009213,PCVM,0 days 00:00:49,-1,2,3
170,MAD,P009213,PTGB,0 days 00:00:49,-1,2,3
170,MAD,P003108,PTGB,0 days 00:00:19,1,27,26
170,MAD,P003108,P004887,0 days 00:00:15,0,0,0
170,MAD,P005791,PTGB,0 days 00:00:04,1,27,26
170,MAD,P006540,PTGB,-1 days +23:58:45,0,15,15
170,MAD,P005928,PTGB,-1 days +23:55:50,6,14,8
170,IST,P007200,PLHK,0 days 00:30:24,0,99,99
170,IST,P011078,PLHK,0 days 00:29:14,22,105,83
170,IST,P007200,P011078,0 days 00:27:24,14,93,79
170,IST,P006590,PLHK,0 days 00:24:50,-9,71,80
170,IST,P006590,P007200,0 days 00:22:56,-23,64,87
170,IST,P009846,PLHK,0 days 00:20:42,2,71,69
170,IST,P011078,P012786,0 days 00:20:36,9,47,38
170,IST,P007200,P012786,0 days 00:20:14,3,46,43
170,IST,P007200,P012788,0 days 00:19:41,-11,49,60
170,IST,P006590,P011078,0 days 00:18:58,5,65,60
170,IST,P012786,PLHK,0 days 00:17:54,11,47,36
170,IST,P007200,P009846,0 days 00:16:45,-3,54,57
170,IST,P006590,P012786,0 days 00:16:33,-11,36,47
170,IST,P011078,P012788,0 days 00:15:53,-4,42,46
170,IST,P009846,P011078,0 days 00:15:35,19,60,41
170,IST,P007200,P011981,0 days 00:15:20,-16,31,47
170,IST,P009846,P012786,0 days 00:15:07,11,35,24
170,IST,P006590,P012788,0 days 00:13:54,-11,30,41
170,IST,P012788,PLHK,0 days 00:13:15,-4,39,43
170,IST,P011981,PLHK,0 days 00:12:33,-2,32,34
170,IST,P006590,P011981,0 days 00:11:45,-11,30,41
170,IST,P009846,P011981,0 days 00:11:01,-8,17,25
170,IST,P006590,P009846,0 days 00:10:04,-12,28,40
170,IST,P011078,P011981,0 days 00:09:12,11,28,17
170,IST,P012786,P012788,0 days 00:08:11,-7,12,19
170,IST,P009846,P012788,0 days 00:05:02,-1,19,20
170,IST,P011981,P012786,0 days 00:04:09,-8,5,13
170,IST,P011981,P012788,0 days 00:02:48,-6,5,11
171,PAM,P010568,P011982,0 days 00:22:43,-5,46,51
171,PAM,P007870,P010568,0 days 00:17:06,-10,27,37
171,PAM,P003960,P010568,0 days 00:16:09,5,37,32
171,PAM,P003960,P011982,0 days 00:15:16,-3,32,35
171,PAM,P010568,P012740,0 days 00:13:32,-2,26,28
171,PAM,P011982,P012740,0 days 00:12:21,-5,21,26
171,PAM,P004863,P012795,0 days 00:12:05,1,26,25
171,PAM,P007870,P011982,0 days 00:11:22,-8,19,27
171,PAM,P011982,P012738,0 days 00:11:12,8,25,17
171,PAM,P007870,P010393,0 days 00:10:58,-5,17,22
171,PAM,P003960,P012738,0 days 00:10:22,10,28,18
171,PAM,P007870,P011970,0 days 00:10:15,5,25,20
171,PAM,P010568,P012738,0 days 00:10:04,2,22,20
171,PAM,P007870,P012795,0 days 00:09:51,2,18,16
171,PAM,P010393,P010568,0 days 00:09:16,-7,13,20
171,PAM,P003960,P011970,0 days 00:08:36,3,26,23
171,PAM,P003960,P007870,0 days 00:08:31,2,20,18
171,PAM,P003960,P012740,0 days 00:08:13,5,21,16
171,PAM,P005356,P012795,0 days 00:07:52,-7,5,12
171,PAM,P010393,P011982,0 days 00:07:44,-5,11,16
171,PAM,P005356,P011982,0 days 00:07:38,-3,13,16
171,PAM,P012738,P012740,0 days 00:07:15,3,17,14
171,PAM,P005356,P010568,0 days 00:07:02,-2,11,13
171,PAM,P003960,P012795,0 days 00:06:51,1,19,18
171,PAM,P004863,P011970,0 days 00:06:37,6,21,15
171,PAM,P012738,P012795,0 days 00:06:33,5,12,7
171,PAM,P005356,P012738,0 days 00:06:31,4,10,6
171,PAM,P010393,P012795,0 days 00:06:26,0,15,15
171,PAM,P004863,P010393,0 days 00:06:26,0,15,15
171,PAM,P011970,P011982,0 days 00:06:24,2,15,13
171,PAM,P010568,P012795,0 days 00:06:22,-4,9,13
171,PAM,P011970,P012795,0 days 00:06:20,5,21,16
171,PAM,P007870,P012740,0 days 00:06:17,-5,9,14
171,PAM,P010568,P011970,0 days 00:06:08,1,15,14
171,PAM,P004863,P007870,0 days 00:06:06,1,13,12
171,PAM,P004863,P012738,0 days 00:05:24,9,13,4
171,PAM,P003960,P004863,0 days 00:05:22,-2,15,17
171,PAM,P010393,P012740,0 days 00:05:19,-7,5,12
171,PAM,P010393,P011970,0 days 00:04:54,2,13,11
171,PAM,P004863,P005356,0 days 00:04:44,-1,5,6
171,PAM,P004863,P011982,0 days 00:04:33,-3,5,8
171,PAM,P006643,P010568,0 days 00:04:19,1,11,10
171,PAM,P005356,P006643,0 days 00:04:19,1,11,10
171,PAM,P006643,P011982,0 days 00:04:19,1,11,10
171,PAM,P003960,P005356,0 days 00:03:50,-3,3,6
171,PAM,P011982,P012795,0 days 00:03:44,-7,2,9
171,PAM,P005356,P007870,0 days 00:02:43,-3,0,3
171,PAM,P006643,P010393,0 days 00:02:25,2,6,4
171,PAM,P005356,P010393,0 days 00:02:25,2,6,4
171,PAM,P004863,P010568,0 days 00:01:59,-3,3,6
171,PAM,P007870,P012738,0 days 00:01:43,-3,0,3
171,PAM,P011970,P012738,0 days 00:01:42,4,8,4
171,PAM,P012740,P012795,0 days 00:01:11,3,5,2
171,PAM,P006643,P012738,0 days 00:01:06,2,5,3
171,PAM,P003960,P010393,0 days 00:00:47,-2,3,5
171,PAM,P006643,P012795,0 days 00:00:25,-3,0,3
171,PAM,P003960,P006643,0 days 00:00:23,0,0,0
171,PAN,P002328,P011204,0 days 00:27:28,7,62,55
171,PAN,P003842,P011204,0 days 00:25:18,6,53,47
171,PAN,P002328,P003842,0 days 00:23:24,3,42,39
171,PAN,P007947,P011204,0 days 00:22:46,2,53,51
171,PAN,P011204,P012774,0 days 00:21:49,-3,45,48
171,PAN,P007866,P011204,0 days 00:21:21,-8,40,48
171,PAN,P007866,P012774,0 days 00:20:22,-6,35,41
171,PAN,P003842,P012774,0 days 00:18:34,0,34,34
171,PAN,P003842,P007866,0 days 00:18:12,1,33,32
171,PAN,P002328,P007947,0 days 00:17:08,10,39,29
171,PAN,P002328,P007866,0 days 00:15:46,-2,26,28
171,PAN,P011204,P012712,0 days 00:15:39,11,42,31
171,PAN,P002328,P012774,0 days 00:14:48,-1,25,26
171,PAN,P007947,P012712,0 days 00:13:54,8,34,26
171,PAN,P002328,P012712,0 days 00:13:49,9,36,27
171,PAN,P003842,P007947,0 days 00:13:26,7,26,19
171,PAN,P007947,P011221,0 days 00:12:05,-9,25,34
171,PAN,P007866,P007947,0 days 00:11:52,-8,19,27
171,PAN,P011204,P011221,0 days 00:11:28,-5,27,32
171,PAN,P007947,P012774,0 days 00:10:36,-6,16,22
171,PAN,P003842,P012712,0 days 00:09:13,5,20,15
171,PAN,P011221,P012712,0 days 00:07:26,2,20,18
171,PAN,P011221,P012774,0 days 00:06:00,-7,9,16
171,PAN,P002328,P011221,0 days 00:05:57,2,18,16
171,PAN,P007866,P011221,0 days 00:04:55,-9,7,16
171,PAN,P012712,P012774,0 days 00:04:27,1,10,9
171,PAN,P011209,P012712,0 days 00:03:04,0,6,6
171,PAN,P011209,P012774,0 days 00:02:40,2,6,4
171,PAN,P011204,P011209,0 days 00:02:11,2,6,4
171,PAN,P003842,P011209,0 days 00:01:32,2,4,2
171,PAN,P011209,P011221,0 days 00:01:32,-2,2,4
171,PAN,P007947,P011209,0 days 00:01:17,-4,0,4
171,PAN,P003842,P011221,0 days 00:00:01,0,0,0
172,ULK,P009849,P011980,0 days 00:19:33,22,44,22
172,ULK,P004004,P009849,0 days 00:17:39,19,41,22
172,ULK,P004004,P011052,0 days 00:17:23,14,38,24
172,ULK,P010560,P011980,0 days 00:17:05,23,44,21
172,ULK,P004004,P011980,0 days 00:16:30,13,33,20
172,ULK,P001932,P010560,0 days 00:14:57,12,38,26
172,ULK,P011052,P011980,0 days 00:14:57,10,31,21
172,ULK,P004004,P008962,0 days 00:14:33,-2,30,32
172,ULK,P001932,P011980,0 days 00:14:21,9,34,25
172,ULK,P009849,P011052,0 days 00:13:39,19,33,14
172,ULK,P001932,P008962,0 days 00:13:13,-4,29,33
172,ULK,P001932,P006661,0 days 00:11:41,-4,26,30
172,ULK,P009849,P010560,0 days 00:11:14,24,31,7
172,ULK,P001932,P005844,0 days 00:11:12,8,28,20
172,ULK,P001932,P009849,0 days 00:11:08,13,30,17
172,ULK,P006661,P010560,0 days 00:10:31,-1,25,26
172,ULK,P008962,P009849,0 days 00:09:48,10,23,13
172,ULK,P001932,P004004,0 days 00:09:27,-5,21,26
172,ULK,P005844,P010560,0 days 00:09:11,8,24,16
172,ULK,P005844,P011980,0 days 00:08:57,5,24,19
172,ULK,P008962,P011052,0 days 00:08:44,4,20,16
172,ULK,P006661,P008962,0 days 00:07:58,-10,16,26
172,ULK,P008962,P011980,0 days 00:07:53,2,15,13
172,ULK,P010560,P011052,0 days 00:07:30,9,18,9
172,ULK,P005844,P009849,0 days 00:07:24,9,21,12
172,ULK,P006661,P011980,0 days 00:06:37,1,15,14
172,ULK,P004004,P010560,0 days 00:06:12,13,15,2
172,ULK,P005844,P006661,0 days 00:05:55,-3,12,15
172,ULK,P011157,P011980,0 days 00:05:17,-1,8,9
172,ULK,P001932,P002968,0 days 00:04:50,-5,12,17
172,ULK,P002968,P006661,0 days 00:04:50,-5,12,17
172,ULK,P002968,P008962,0 days 00:04:50,-5,12,17
172,ULK,P008962,P010560,0 days 00:04:47,0,12,12
172,ULK,P002968,P010560,0 days 00:04:22,-4,10,14
172,ULK,P005844,P008962,0 days 00:04:22,1,9,8
172,ULK,P004004,P005844,0 days 00:04:08,-2,9,11
172,ULK,P004004,P006661,0 days 00:04:04,-8,6,14
172,ULK,P006661,P011157,0 days 00:03:50,-1,7,8
172,ULK,P011052,P011157,0 days 00:03:26,-7,5,12
172,ULK,P004004,P011157,0 days 00:03:26,-7,5,12
172,ULK,P001932,P011157,0 days 00:03:17,2,9,7
172,ULK,P010560,P011157,0 days 00:03:03,2,7,5
172,ULK,P001932,P011052,0 days 00:02:58,2,9,7
172,ULK,P006661,P011052,0 days 00:02:54,-5,5,10
172,ULK,P009849,P011157,0 days 00:02:39,-4,5,9
172,ULK,P005844,P011052,0 days 00:02:07,-2,5,7
172,ULK,P002968,P004004,0 days 00:01:24,-5,2,7
172,ULK,P008962,P011157,0 days 00:00:58,-4,2,6
172,ULK,P004004,P006961,0 days 00:00:42,-2,0,2
172,ULK,P006961,P011052,0 days 00:00:42,-2,0,2
172,ULK,P002968,P006961,0 days 00:00:28,-2,0,2
172,ULK,P002968,P011052,0 days 00:00:28,-2,0,2
172,ULK,P006961,P010560,0 days 00:00:28,-2,0,2
172,ULK,P006961,P008962,0 days 00:00:14,0,0,0
172,ULK,P006961,P011980,0 days 00:00:14,0,0,0
172,PAR,P007400,P009862,0 days 00:28:01,0,61,61
172,PAR,P009862,P011192,0 days 00:25:59,-10,49,59
172,PAR,P008987,P009862,0 days 00:23:07,2,48,46
172,PAR,P007400,P012096,0 days 00:23:05,-3,48,51
172,PAR,P007400,P008987,0 days 00:22:41,7,48,41
172,PAR,P009862,P012096,0 days 00:22:01,1,48,47
172,PAR,P007400,P011192,0 days 00:19:48,-5,38,43
172,PAR,P009862,P012742,0 days 00:19:33,-14,36,50
172,PAR,P008987,P011192,0 days 00:19:01,-5,35,40
172,PAR,P008987,P012096,0 days 00:18:34,11,43,32
172,PAR,P011192,P012096,0 days 00:14:30,0,31,31
172,PAR,P009862,P012743,0 days 00:12:25,-9,22,31
172,PAR,P007400,P012742,0 days 00:12:25,-7,26,33
172,PAR,P007673,P011192,0 days 00:11:12,-6,17,23
172,PAR,P011192,P012743,0 days 00:11:06,-11,17,28
172,PAR,P008987,P012742,0 days 00:09:30,-2,19,21
172,PAR,P012742,P012743,0 days 00:09:22,-8,16,24
172,PAR,P012096,P012742,0 days 00:09:14,-9,17,26
172,PAR,P011192,P012742,0 days 00:09:05,-15,12,27
172,PAR,P007673,P009862,0 days 00:08:57,-2,16,18
172,PAR,P007673,P012743,0 days 00:08:34,-3,15,18
172,PAR,P007673,P012742,0 days 00:07:12,-3,12,15
172,PAR,P000956,P007400,0 days 00:06:57,-8,10,18
172,PAR,P007400,P007673,0 days 00:06:36,-7,9,16
172,PAR,P000956,P012742,0 days 00:04:42,-4,9,13
172,PAR,P007400,P012743,0 days 00:04:22,1,11,10
172,PAR,P000956,P008987,0 days 00:04:07,-4,5,9
172,PAR,P000956,P007673,0 days 00:03:33,-6,3,9
172,PAR,P000956,P009862,0 days 00:03:24,-2,7,9
172,PAR,P007673,P008987,0 days 00:02:52,-1,4,5
172,PAR,P008987,P012743,0 days 00:02:32,-8,2,10
172,PAR,P009212,P009862,0 days 00:02:21,-2,5,7
172,PAR,P009212,P012742,0 days 00:02:21,-2,5,7
172,PAR,P009212,P012096,0 days 00:02:21,-2,5,7
172,PAR,P007400,P009212,0 days 00:02:21,-2,5,7
172,PAR,P000956,P011192,0 days 00:02:15,-4,1,5
172,PAR,P000956,P012096,0 days 00:01:31,-6,0,6
172,PAR,P000956,P012743,0 days 00:01:19,2,5,3
172,PAR,P007673,P012096,0 days 00:01:04,-4,0,4
173,MCO,P004197,P005985,0 days 00:21:19,0,49,49
173,MCO,P010588,P011226,0 days 00:20:18,3,48,45
173,MCO,P005985,P010588,0 days 00:18:49,14,49,35
173,MCO,P005985,P009754,0 days 00:18:40,16,44,28
173,MCO,P005985,P011226,0 days 00:18:19,12,47,35
173,MCO,P005985,P011231,0 days 00:16:42,18,44,26
173,MCO,P005985,PLCZ,0 days 00:16:01,2,36,34
173,MCO,P004197,P010588,0 days 00:12:33,-7,26,33
173,MCO,P002581,P010588,0 days 00:12:24,-5,27,32
173,MCO,P002581,P012709,0 days 00:12:07,-2,29,31
173,MCO,P009754,PLCZ,0 days 00:11:54,4,27,23
173,MCO,P009754,P011231,0 days 00:11:54,11,29,18
173,MCO,P004197,PLCZ,0 days 00:11:50,-3,24,27
173,MCO,P004197,P009754,0 days 00:11:10,-4,20,24
173,MCO,P009754,P010588,0 days 00:10:41,8,25,17
173,MCO,P009754,P011226,0 days 00:10:00,15,27,12
173,MCO,P002581,P004197,0 days 00:09:50,2,26,24
173,MCO,P010588,P012709,0 days 00:09:42,-5,20,25
173,MCO,P011226,P011231,0 days 00:09:26,18,26,8
173,MCO,P002581,P011226,0 days 00:08:49,-8,17,25
173,MCO,P002581,P005985,0 days 00:08:45,4,25,21
173,MCO,P011226,PLCZ,0 days 00:08:19,-3,19,22
173,MCO,P010588,P011231,0 days 00:08:02,14,21,7
173,MCO,P004197,P012709,0 days 00:07:29,6,21,15
173,MCO,P004197,P011231,0 days 00:07:16,0,18,18
173,MCO,P004197,P011226,0 days 00:06:50,-8,14,22
173,MCO,P008099,P010588,0 days 00:06:00,-1,12,13
173,MCO,P008099,P011226,0 days 00:06:00,-1,12,13
173,MCO,P005985,P012709,0 days 00:06:00,8,20,12
173,MCO,P011226,P012709,0 days 00:05:43,-8,10,18
173,MCO,P010588,PLCZ,0 days 00:05:35,-5,12,17
173,MCO,P011231,PLCZ,0 days 00:05:29,3,14,11
173,MCO,P004197,P004790,0 days 00:05:19,2,10,8
173,MCO,P004790,PLCZ,0 days 00:05:19,2,10,8
173,MCO,P004790,P009754,0 days 00:05:19,2,10,8
173,MCO,P004790,P005985,0 days 00:05:19,2,10,8
173,MCO,P008099,P012709,0 days 00:04:42,-5,8,13
173,MCO,P002581,P008099,0 days 00:04:42,-5,8,13
173,MCO,P011231,P012709,0 days 00:03:30,3,11,8
173,MCO,P002581,P011231,0 days 00:03:11,1,9,8
173,MCO,P002581,P009754,0 days 00:02:32,-3,3,6
173,MCO,P009754,P012709,0 days 00:02:30,-5,3,8
173,MCO,P005985,P008099,0 days 00:01:18,4,4,0
173,MCO,P008099,P011231,0 days 00:01:18,4,4,0
173,MCO,P012709,PLCZ,0 days 00:01:05,0,2,2
173,BAS,P004761,P012201,0 days 00:25:38,-7,58,65
173,BAS,P011948,P012201,0 days 00:24:31,3,56,53
173,BAS,P004761,P011948,0 days 00:23:29,5,57,52
173,BAS,P004761,P009048,0 days 00:21:57,-14,39,53
173,BAS,P009048,P012201,0 days 00:20:54,-9,42,51
173,BAS,P004603,P004761,0 days 00:19:36,1,45,44
173,BAS,P007230,P009048,0 days 00:17:57,-13,29,42
173,BAS,P007230,P012201,0 days 00:17:00,-22,24,46
173,BAS,P004603,P011948,0 days 00:16:39,11,46,35
173,BAS,P004761,P007230,0 days 00:16:00,-21,21,42
173,BAS,P009048,P011948,0 days 00:15:47,-1,32,33
173,BAS,P004603,P009048,0 days 00:14:43,-1,30,31
173,BAS,P004761,P010444,0 days 00:14:25,-1,35,36
173,BAS,P004603,P012201,0 days 00:14:07,6,38,32
173,BAS,P011948,P012765,0 days 00:13:10,4,34,30
173,BAS,P004761,P012765,0 days 00:12:35,6,35,29
173,BAS,P010444,P012201,0 days 00:10:45,-3,25,28
173,BAS,P010444,P011948,0 days 00:10:30,4,26,22
173,BAS,P007230,P011948,0 days 00:10:25,-10,13,23
173,BAS,P012201,P012765,0 days 00:10:12,0,25,25
173,BAS,P004603,P007230,0 days 00:09:47,-2,17,19
173,BAS,P010444,P012765,0 days 00:09:29,-2,21,23
173,BAS,P004603,P012765,0 days 00:08:18,6,24,18
173,BAS,P009048,P010444,0 days 00:05:42,-1,14,15
173,BAS,P007230,P010444,0 days 00:05:27,-9,9,18
173,BAS,P007230,P008850,0 days 00:04:28,-1,6,7
173,BAS,P008850,P009048,0 days 00:04:28,-1,6,7
173,BAS,P004761,P008850,0 days 00:04:28,-1,6,7
173,BAS,P004603,P008850,0 days 00:04:28,-1,6,7
173,BAS,P004603,P010444,0 days 00:04:26,0,10,10
173,BAS,P007230,P012765,0 days 00:03:31,-10,1,11
173,BAS,P003198,P007230,0 days 00:01:17,-4,0,4
173,BAS,P003198,P011948,0 days 00:01:17,-4,0,4
173,BAS,P003198,P012201,0 days 00:01:17,-4,0,4
173,BAS,P003198,P012765,0 days 00:01:17,-4,0,4
174,PAN,P002328,P007866,0 days 00:35:02,12,75,63
174,PAN,P007866,P011204,0 days 00:32:09,1,66,65
174,PAN,P002328,P011204,0 days 00:31:00,-1,60,61
174,PAN,P003842,P007866,0 days 00:28:50,19,73,54
174,PAN,P002328,P003842,0 days 00:27:41,17,67,50
174,PAN,P003842,P011204,0 days 00:25:56,4,58,54
174,PAN,P007866,P012774,0 days 00:21:09,15,49,34
174,PAN,P011204,P012774,0 days 00:20:56,-5,36,41
174,PAN,P002328,P012774,0 days 00:20:00,13,43,30
174,PAN,P001926,P003842,0 days 00:18:49,8,45,37
174,PAN,P001926,P002328,0 days 00:18:02,10,45,35
174,PAN,P001926,P007866,0 days 00:18:02,10,45,35
174,PAN,P001926,P011204,0 days 00:17:49,-10,32,42
174,PAN,P003842,P012774,0 days 00:15:17,18,41,23
174,PAN,P011204,P011221,0 days 00:10:02,-10,10,20
174,PAN,P011221,P012774,0 days 00:09:41,-10,10,20
174,PAN,P001926,P012774,0 days 00:07:51,6,17,11
174,PAN,P007866,P011221,0 days 00:07:21,-5,8,13
174,PAN,P002328,P011221,0 days 00:07:21,-5,8,13
174,PAN,P001926,P012712,0 days 00:03:49,-7,2,9
174,PAN,P011204,P012712,0 days 00:03:49,-7,2,9
174,PAN,P012712,P012774,0 days 00:03:49,-7,2,9
174,PAN,P001926,P011221,0 days 00:03:02,-5,2,7
174,PAN,P011221,P012712,0 days 00:02:41,-5,2,7
174,PAN,P003842,P011209,0 days 00:02:11,4,8,4
174,PAN,P007866,P011209,0 days 00:02:11,4,8,4
174,PAN,P011204,P011209,0 days 00:02:11,4,8,4
174,PAN,P011209,P012774,0 days 00:01:09,2,6,4
174,PAN,P003842,P012712,0 days 00:01:08,-2,0,2
174,PAN,P002328,P011209,0 days 00:01:02,2,2,0
174,IST,P007200,P009846,0 days 00:28:36,-8,52,60
174,IST,P007200,PLHK,0 days 00:24:14,-4,49,53
174,IST,P011078,PLHK,0 days 00:23:44,2,53,51
174,IST,P009846,PLHK,0 days 00:23:28,9,53,44
174,IST,P007200,P011078,0 days 00:23:25,-4,45,49
174,IST,P007200,P009664,0 days 00:23:10,-4,47,51
174,IST,P009664,P009846,0 days 00:22:32,6,48,42
174,IST,P009846,P011078,0 days 00:21:54,8,46,38
174,IST,P009664,P011078,0 days 00:21:32,14,49,35
174,IST,P009664,PLHK,0 days 00:17:58,12,45,33
174,IST,P006590,P009664,0 days 00:15:55,-5,31,36
174,IST,P006590,PLHK,0 days 00:14:43,6,28,22
174,IST,P006590,P007200,0 days 00:14:30,-9,25,34
174,IST,P006590,P009846,0 days 00:12:59,3,26,23
174,IST,P006590,P011078,0 days 00:11:24,1,24,23
174,IST,P007200,P012786,0 days 00:10:41,-18,11,29
174,IST,P011078,P012786,0 days 00:10:22,-11,13,24
174,IST,P009846,P012786,0 days 00:09:56,-19,8,27
174,IST,P012786,PLHK,0 days 00:06:20,-10,8,18
174,IST,P007200,P012788,0 days 00:05:43,-2,9,11
174,IST,P009664,P012786,0 days 00:05:42,-10,5,15
174,IST,P009846,P012788,0 days 00:04:50,0,9,9
174,IST,P009664,P012788,0 days 00:04:50,0,9,9
174,IST,P006590,P012788,0 days 00:04:44,-3,10,13
174,IST,P011078,P012788,0 days 00:04:22,-3,5,8
174,IST,P006590,P012786,0 days 00:03:46,-10,5,15
174,IST,P009513,PLHK,0 days 00:03:21,1,6,5
174,IST,P009513,P009846,0 days 00:03:21,1,6,5
174,IST,P007200,P009513,0 days 00:03:21,1,6,5
174,IST,P010516,P011078,0 days 00:03:17,-3,5,8
174,IST,P006590,P010516,0 days 00:03:17,-3,5,8
174,IST,P006590,P009513,0 days 00:03:02,4,6,2
174,IST,P012788,PLHK,0 days 00:02:08,-3,3,6
174,IST,P009664,P010516,0 days 00:02:02,-2,2,4
174,IST,P010516,PLHK,0 days 00:01:56,-1,3,4
174,IST,P010516,P012786,0 days 00:01:21,-2,2,4
174,IST,P010516,P012788,0 days 00:01:15,-1,3,4
174,IST,P009513,P009664,0 days 00:00:19,-3,0,3
175,ASV,P011225,P012080,0 days 00:18:46,-10,44,54
175,ASV,P004194,PKIR,0 days 00:17:52,14,51,37
175,ASV,P004194,P012731,0 days 00:15:37,15,49,34
175,ASV,P012731,PKIR,0 days 00:15:05,16,45,29
175,ASV,P012080,P012729,0 days 00:14:51,-2,34,36
175,ASV,P006568,P012080,0 days 00:14:44,-3,31,34
175,ASV,P012080,PKIR,0 days 00:14:24,8,36,28
175,ASV,P011225,P012731,0 days 00:13:45,2,43,41
175,ASV,P012080,P012731,0 days 00:13:45,4,33,29
175,ASV,P006568,P011225,0 days 00:13:37,0,34,34
175,ASV,P006568,P012729,0 days 00:13:31,2,31,29
175,ASV,P011386,PKIR,0 days 00:12:25,9,25,16
175,ASV,P011225,P012729,0 days 00:12:21,-2,29,31
175,ASV,P011225,PKIR,0 days 00:11:39,6,37,31
175,ASV,P004194,P011225,0 days 00:11:33,5,38,33
175,ASV,P012729,PKIR,0 days 00:11:14,1,21,20
175,ASV,P004194,P012080,0 days 00:11:10,6,32,26
175,ASV,P000229,P004194,0 days 00:11:09,4,31,27
175,ASV,P003526,P006568,0 days 00:09:44,-2,22,24
175,ASV,P003526,P011225,0 days 00:09:44,-2,22,24
175,ASV,P003526,P012729,0 days 00:09:44,-2,22,24
175,ASV,P003526,P012080,0 days 00:09:44,-2,22,24
175,ASV,P004194,P011386,0 days 00:09:29,6,20,14
175,ASV,P011386,P012080,0 days 00:08:57,10,21,11
175,ASV,P011386,P012729,0 days 00:08:50,2,15,13
175,ASV,P000229,P012731,0 days 00:08:36,6,32,26
175,ASV,P000229,P011225,0 days 00:08:11,9,32,23
175,ASV,P000229,PKIR,0 days 00:07:59,7,24,17
175,ASV,P011386,P012731,0 days 00:07:19,9,17,8
175,ASV,P004194,P012729,0 days 00:06:47,-4,11,15
175,ASV,P006568,PKIR,0 days 00:05:19,-1,9,10
175,ASV,P000229,P011386,0 days 00:05:04,-1,8,9
175,ASV,P000229,P012729,0 days 00:04:39,2,8,6
175,ASV,P003274,P011225,0 days 00:03:52,-3,9,12
175,ASV,P006568,P012731,0 days 00:03:38,-1,9,10
175,ASV,P006568,P011386,0 days 00:03:32,1,6,5
175,ASV,P003274,P012731,0 days 00:03:20,-4,8,12
175,ASV,P000229,P012080,0 days 00:02:39,-1,7,8
175,ASV,P000229,P003274,0 days 00:02:37,2,9,7
175,ASV,P003274,P006568,0 days 00:02:25,4,9,5
175,ASV,P012729,P012731,0 days 00:02:15,2,4,2
175,ASV,P000229,P006568,0 days 00:02:06,4,9,5
175,ASV,P003274,P012080,0 days 00:00:56,-5,0,5
175,ASV,P003274,P012730,0 days 00:00:56,-5,0,5
175,ASV,P011225,P012730,0 days 00:00:56,-5,0,5
175,ASV,P012080,P012730,0 days 00:00:56,-5,0,5
175,ASV,P012730,P012731,0 days 00:00:56,-5,0,5
175,ASV,P003274,P012729,0 days 00:00:32,1,1,0
175,ASV,P003274,P004194,0 days 00:00:31,-2,0,2
175,ASV,P003274,PKIR,0 days 00:00:19,0,0,0
175,RED,P000848,P012044,0 days 00:24:37,-2,61,63
175,RED,P009035,P012044,0 days 00:22:16,8,61,53
175,RED,P000848,P009035,0 days 00:18:47,3,51,48
175,RED,P007960,P012044,0 days 00:18:28,10,49,39
175,RED,P006436,P012044,0 days 00:16:37,-3,44,47
175,RED,P000848,P006436,0 days 00:16:22,-11,39,50
175,RED,P007960,P009035,0 days 00:16:13,10,44,34
175,RED,P000848,P007960,0 days 00:15:55,10,44,34
175,RED,P009035,PLUO,0 days 00:14:33,6,35,29
175,RED,P005099,P006436,0 days 00:14:25,-15,25,40
175,RED,P012044,PLUO,0 days 00:14:15,7,35,28
175,RED,P006436,P009035,0 days 00:14:14,-4,41,45
175,RED,P006436,PJDR,0 days 00:13:19,-13,29,42
175,RED,P006436,P007960,0 days 00:12:06,1,25,24
175,RED,P005099,PJDR,0 days 00:11:54,-12,20,32
175,RED,P000848,PLUO,0 days 00:10:46,2,25,23
175,RED,P007960,PLUO,0 days 00:10:09,7,27,20
175,RED,P006436,P008966,0 days 00:09:08,2,18,16
175,RED,P009035,PJDR,0 days 00:08:46,-10,21,31
175,RED,P008966,PJDR,0 days 00:06:35,3,13,10
175,RED,P005099,P008966,0 days 00:06:35,3,13,10
175,RED,P007960,PJDR,0 days 00:06:20,-2,8,10
175,RED,P004720,P006436,0 days 00:05:52,6,20,14
175,RED,P007960,P008966,0 days 00:05:48,-2,8,10
175,RED,P012044,PJDR,0 days 00:05:01,-3,14,17
175,RED,P004720,PJDR,0 days 00:04:56,1,15,14
175,RED,P004720,P005099,0 days 00:04:56,1,15,14
175,RED,P005099,P011941,0 days 00:04:30,-11,5,16
175,RED,P006436,P011941,0 days 00:04:30,-11,5,16
175,RED,P000848,P011941,0 days 00:04:05,-8,5,13
175,RED,P005099,P009035,0 days 00:03:52,-8,7,15
175,RED,P000848,P005099,0 days 00:03:51,-8,5,13
175,RED,P005099,P007960,0 days 00:03:47,-2,3,5
175,RED,PJDR,PLUO,0 days 00:03:29,-1,5,6
175,RED,P011941,P012044,0 days 00:03:24,-5,5,10
175,RED,P004720,P008966,0 days 00:03:20,4,10,6
175,RED,P009035,P011964,0 days 00:03:19,-7,2,9
175,RED,P005099,P012044,0 days 00:03:10,-5,5,10
175,RED,P000848,PJDR,0 days 00:03:09,-6,9,15
175,RED,P006436,PLUO,0 days 00:02:39,2,8,6
175,RED,P000848,P008966,0 days 00:02:33,-1,5,6
175,RED,P008966,P012044,0 days 00:02:33,-1,5,6
175,RED,P004720,P009035,0 days 00:02:32,2,10,8
175,RED,P011964,PJDR,0 days 00:02:16,-6,2,8
175,RED,P006436,P011964,0 days 00:02:16,-6,2,8
175,RED,P005099,P011964,0 days 00:02:16,-6,2,8
175,RED,P000848,P011964,0 days 00:01:35,-3,0,3
175,RED,P011964,P012044,0 days 00:01:35,-3,0,3
175,RED,P011964,PLUO,0 days 00:01:35,-3,0,3
175,RED,P011941,PJDR,0 days 00:01:27,-7,0,7
175,RED,P004720,P012044,0 days 00:00:56,5,5,0
175,RED,P004720,PLUO,0 days 00:00:56,5,5,0
175,RED,P011941,P011964,0 days 00:00:32,-2,0,2
175,RED,P005099,PLUO,0 days 00:00:32,-1,0,1
175,RED,P007960,P011941,0 days 00:00:14,0,0,0
175,RED,P011941,PLUO,0 days 00:00:14,0,0,0
176,PAM,P007870,P010568,0 days 00:23:33,-1,56,57
176,PAM,P003960,P007870,0 days 00:21:34,-4,51,55
176,PAM,P003960,P010568,0 days 00:21:34,-4,51,55
176,PAM,P007870,P011982,0 days 00:14:22,12,38,26
176,PAM,P010568,P011982,0 days 00:13:00,10,34,24
176,PAM,P003960,P011982,0 days 00:12:45,12,34,22
176,PAM,P006433,P007870,0 days 00:12:45,10,30,20
176,PAM,P006433,P010568,0 days 00:12:45,10,30,20
176,PAM,P010568,P012795,0 days 00:12:35,-14,24,38
176,PAM,P006433,P011982,0 days 00:12:07,7,27,20
176,PAM,P011970,P012738,0 days 00:11:27,-5,17,22
176,PAM,P003960,P006433,0 days 00:11:01,5,25,20
176,PAM,P007870,P012795,0 days 00:10:33,-11,22,33
176,PAM,P004863,P012738,0 days 00:10:06,2,13,11
176,PAM,P004863,P011970,0 days 00:09:21,0,13,13
176,PAM,P010393,P012738,0 days 00:08:57,-5,12,17
176,PAM,P003960,P012795,0 days 00:08:55,-16,17,33
176,PAM,P005356,P012795,0 days 00:08:35,-8,12,20
176,PAM,P011970,P011982,0 days 00:08:17,2,16,14
176,PAM,P004863,P011982,0 days 00:08:05,5,21,16
176,PAM,P005356,P010393,0 days 00:07:32,-3,6,9
176,PAM,P011982,P012738,0 days 00:07:18,1,13,12
176,PAM,P010393,P012795,0 days 00:07:06,0,11,11
176,PAM,P005356,P012738,0 days 00:06:49,-3,6,9
176,PAM,P005356,P010568,0 days 00:06:33,-10,10,20
176,PAM,P004863,P007870,0 days 00:06:28,-4,16,20
176,PAM,P010393,P011970,0 days 00:05:55,-2,10,12
176,PAM,P004863,P010393,0 days 00:05:49,2,6,4
176,PAM,P004863,P005356,0 days 00:05:30,0,4,4
176,PAM,P012738,P012739,0 days 00:05:25,-1,7,8
176,PAM,P011982,P012739,0 days 00:05:25,-1,7,8
176,PAM,P011970,P012739,0 days 00:05:25,-1,7,8
176,PAM,P012738,P012795,0 days 00:05:16,-5,6,11
176,PAM,P005356,P007870,0 days 00:05:08,-7,8,15
176,PAM,P003960,P005356,0 days 00:04:37,-7,8,15
176,PAM,P004863,P010568,0 days 00:04:29,-6,12,18
176,PAM,P003960,P004863,0 days 00:04:20,-4,12,16
176,PAM,P004863,P012739,0 days 00:04:16,2,7,5
176,PAM,P004863,P012795,0 days 00:04:04,-5,4,9
176,PAM,P007870,P011970,0 days 00:04:02,2,10,8
176,PAM,P006433,P012795,0 days 00:03:55,-2,9,11
176,PAM,P006433,P010393,0 days 00:03:52,3,11,8
176,PAM,P010393,P010568,0 days 00:03:46,2,7,5
176,PAM,P005356,P011970,0 days 00:03:28,-2,2,4
176,PAM,P006433,P011970,0 days 00:03:17,-5,6,11
176,PAM,P006433,P012738,0 days 00:03:17,-5,6,11
176,PAM,P011970,P012795,0 days 00:02:41,-3,7,10
176,PAM,P007870,P010393,0 days 00:02:40,7,7,0
176,PAM,P010568,P011970,0 days 00:02:03,0,6,6
176,PAM,P010568,P012738,0 days 00:02:02,-3,2,5
176,PAM,P003960,P011970,0 days 00:01:48,2,6,4
176,PAM,P006433,P012739,0 days 00:01:09,-3,0,3
176,PAM,P010393,P011982,0 days 00:01:09,4,6,2
176,PAM,P007870,P012738,0 days 00:01:03,0,2,2
176,PAM,P003960,P010393,0 days 00:00:06,0,0,0
176,ZAL,P002329,P011218,0 days 00:27:33,10,71,61
176,ZAL,P002329,P007109,0 days 00:26:32,8,67,59
176,ZAL,P007109,P011218,0 days 00:25:32,8,65,57
176,ZAL,P003210,P012715,0 days 00:16:29,-1,26,27
176,ZAL,P002329,P012715,0 days 00:15:37,9,39,30
176,ZAL,P007109,P012715,0 days 00:15:16,2,30,28
176,ZAL,P003210,P007109,0 days 00:14:01,5,27,22
176,ZAL,P002329,P005504,0 days 00:13:57,3,35,32
176,ZAL,P005504,P011218,0 days 00:13:32,4,35,31
176,ZAL,P011218,P012715,0 days 00:13:00,8,35,27
176,ZAL,P002329,P007513,0 days 00:12:29,-8,27,35
176,ZAL,P002329,P003210,0 days 00:12:21,10,30,20
176,ZAL,P007109,P007513,0 days 00:12:13,-8,27,35
176,ZAL,P007513,P011218,0 days 00:11:35,-8,25,33
176,ZAL,P005504,P007109,0 days 00:11:31,2,29,27
176,ZAL,P002329,P003211,0 days 00:10:53,12,31,19
176,ZAL,P003211,P012715,0 days 00:10:26,7,19,12
176,ZAL,P012715,P012787,0 days 00:10:24,-5,9,14
176,ZAL,P003211,P007109,0 days 00:10:01,8,23,15
176,ZAL,P003210,P012787,0 days 00:09:32,-5,9,14
176,ZAL,P003211,P011218,0 days 00:09:03,12,27,15
176,ZAL,P003210,P011218,0 days 00:08:57,9,24,15
176,ZAL,P005504,P007513,0 days 00:08:37,-5,18,23
176,ZAL,P003210,P003211,0 days 00:08:18,3,13,10
176,ZAL,P010390,P012715,0 days 00:06:39,2,10,8
176,ZAL,P003210,P010390,0 days 00:05:41,2,10,8
176,ZAL,P010390,P012787,0 days 00:05:36,2,8,6
176,ZAL,P003211,P010390,0 days 00:05:31,-1,8,9
176,ZAL,P003211,P012787,0 days 00:05:30,0,4,4
176,ZAL,P009917,P012715,0 days 00:04:37,-6,3,9
176,ZAL,P009917,P012787,0 days 00:04:37,-6,3,9
176,ZAL,P007109,P012787,0 days 00:04:10,-4,1,5
176,ZAL,P003211,P005504,0 days 00:03:47,7,13,6
176,ZAL,P003210,P009917,0 days 00:03:39,-6,3,9
176,ZAL,P007513,P012715,0 days 00:03:27,-3,7,10
176,ZAL,P002329,P010390,0 days 00:02:59,-1,6,7
176,ZAL,P005504,P012715,0 days 00:02:45,-1,6,7
176,ZAL,P009917,P010390,0 days 00:02:10,-2,2,4
176,ZAL,P007109,P009917,0 days 00:02:08,-2,1,3
176,ZAL,P003210,P005504,0 days 00:01:52,-1,4,5
176,ZAL,P002329,P012787,0 days 00:01:27,1,2,1
176,ZAL,P007109,P010390,0 days 00:01:00,-3,2,5
176,ZAL,P010390,P011218,0 days 00:01:00,-3,2,5
176,ZAL,P003211,P009917,0 days 00:00:58,0,0,0
176,ZAL,P003210,P007513,0 days 00:00:54,0,2,2
176,ZAL,P005504,P012787,0 days 00:00:44,-3,0,3
176,ZAL,P003211,P007513,0 days 00:00:41,0,2,2
176,ZAL,P005504,P009917,0 days 00:00:19,-2,0,2
177,MIL,P011205,P011224,0 days 00:27:41,5,58,53
177,MIL,P002849,P011205,0 days 00:25:14,6,53,47
177,MIL,P002849,P011224,0 days 00:23:50,3,50,47
177,MIL,P005670,P011205,0 days 00:15:17,-1,28,29
177,MIL,P005670,P007201,0 days 00:15:17,-2,30,32
177,MIL,P002812,P007201,0 days 00:14:46,0,29,29
177,MIL,P002812,P006701,0 days 00:14:01,0,31,31
177,MIL,P006701,P007201,0 days 00:13:24,-2,29,31
177,MIL,P002812,P005670,0 days 00:12:48,0,28,28
177,MIL,P005670,P011224,0 days 00:12:46,-4,25,29
177,MIL,P006701,P011224,0 days 00:12:45,7,30,23
177,MIL,P006701,P011205,0 days 00:12:35,10,31,21
177,MIL,P002849,P006701,0 days 00:12:35,10,31,21
177,MIL,P002849,P005670,0 days 00:12:17,0,23,23
177,MIL,P007201,P011205,0 days 00:11:56,-1,20,21
177,MIL,P002812,P011224,0 days 00:11:47,3,24,21
177,MIL,P002812,P011205,0 days 00:11:44,4,23,19
177,MIL,P007201,P011224,0 days 00:11:23,-3,20,23
177,MIL,P002812,P006509,0 days 00:10:41,5,23,18
177,MIL,P006509,P007201,0 days 00:09:37,5,21,16
177,MIL,P005670,P006701,0 days 00:09:32,3,22,19
177,MIL,P001518,P006701,0 days 00:08:08,2,16,14
177,MIL,P005670,P006509,0 days 00:07:20,4,18,14
177,MIL,P001518,P011224,0 days 00:07:02,7,15,8
177,MIL,P002849,P007201,0 days 00:06:58,-3,12,15
177,MIL,P002812,P002849,0 days 00:06:46,2,15,13
177,MIL,P006509,P006701,0 days 00:06:32,2,18,16
177,MIL,P009960,P011224,0 days 00:05:49,0,13,13
177,MIL,P009960,P011205,0 days 00:05:49,0,13,13
177,MIL,P005670,P009960,0 days 00:05:49,0,13,13
177,MIL,P002849,P009960,0 days 00:05:49,0,13,13
177,MIL,P001518,P002849,0 days 00:05:28,7,13,6
177,MIL,P001518,P011205,0 days 00:05:28,7,13,6
177,MIL,P006509,P011205,0 days 00:05:04,2,5,3
177,MIL,P006509,P011224,0 days 00:03:57,2,5,3
177,MIL,P001518,P002812,0 days 00:03:35,-6,3,9
177,MIL,P001518,P007201,0 days 00:03:35,-6,3,9
177,MIL,P002849,P006509,0 days 00:01:59,-1,2,3
177,MIL,P001518,P005670,0 days 00:01:42,-4,1,5
177,MIL,P001518,P006509,0 days 00:01:14,-3,0,3
177,BER,P008967,P012720,0 days 00:24:53,-3,48,51
177,BER,P008967,P011934,0 days 00:21:53,-1,46,47
177,BER,P011934,P012720,0 days 00:20:11,0,42,42
177,BER,P008173,P012720,0 days 00:19:36,-3,39,42
177,BER,P008173,P008967,0 days 00:18:51,-4,34,38
177,BER,P003958,P008967,0 days 00:17:57,-4,31,35
177,BER,P008173,P011934,0 days 00:17:21,-2,35,37
177,BER,P003958,P012720,0 days 00:15:50,0,29,29
177,BER,P006251,P008173,0 days 00:15:20,-9,33,42
177,BER,P003958,P008211,0 days 00:13:40,1,25,24
177,BER,P008384,P010791,0 days 00:12:44,-1,23,24
177,BER,P003958,P011934,0 days 00:12:24,1,26,25
177,BER,P006251,P012720,0 days 00:11:58,-7,24,31
177,BER,P003958,P010791,0 days 00:11:28,0,15,15
177,BER,P006251,P008967,0 days 00:10:27,-3,21,24
177,BER,P003958,P008173,0 days 00:10:25,0,16,16
177,BER,P006251,P011934,0 days 00:10:10,-3,21,24
177,BER,P008211,P008967,0 days 00:09:33,-3,18,21
177,BER,P008173,P008384,0 days 00:09:17,-10,15,25
177,BER,P003958,P008384,0 days 00:09:13,1,12,11
177,BER,P008211,P010791,0 days 00:09:02,3,15,12
177,BER,P007025,P008384,0 days 00:08:41,5,19,14
177,BER,P008211,P012720,0 days 00:08:12,-4,14,18
177,BER,P008173,P010791,0 days 00:08:11,-7,14,21
177,BER,P007025,P010791,0 days 00:08:00,6,18,12
177,BER,P010791,P012720,0 days 00:07:24,-7,11,18
177,BER,P008967,P010791,0 days 00:06:18,-6,6,12
177,BER,P006251,P008384,0 days 00:06:07,-4,16,20
177,BER,P008211,P008384,0 days 00:06:03,7,13,6
177,BER,P006251,P010791,0 days 00:05:45,-4,14,18
177,BER,P003958,P007025,0 days 00:05:23,5,10,5
177,BER,P008211,P011934,0 days 00:05:13,0,12,12
177,BER,P007025,P008211,0 days 00:04:42,6,9,3
177,BER,P007025,P008173,0 days 00:03:59,-1,10,11
177,BER,P008384,P008967,0 days 00:03:44,-4,4,8
177,BER,P006251,P007025,0 days 00:03:18,0,9,9
177,BER,P008384,P012720,0 days 00:03:08,-4,5,9
177,BER,P008384,P011934,0 days 00:02:23,-2,5,7
177,BER,P007025,P011934,0 days 00:00:41,-1,1,2
177,BER,P006251,P008211,0 days 00:00:35,2,2,0
178,MUN,P006760,P007056,0 days 00:18:20,-3,35,38
178,MUN,P007975,P010391,0 days 00:17:54,-16,27,43
178,MUN,P001288,P010391,0 days 00:17:52,-18,30,48
178,MUN,P007056,P011987,0 days 00:17:24,-7,30,37
178,MUN,P003583,P011987,0 days 00:17:06,-4,32,36
178,MUN,P001288,P007975,0 days 00:16:01,-18,23,41
178,MUN,P003583,P007056,0 days 00:15:46,-2,30,32
178,MUN,P004508,P010391,0 days 00:14:39,-11,27,38
178,MUN,P007056,P008985,0 days 00:14:03,-4,26,30
178,MUN,P008985,P011987,0 days 00:14:03,-4,26,30
178,MUN,P003583,P008985,0 days 00:13:40,-4,26,30
178,MUN,P004508,P007975,0 days 00:12:27,-4,21,25
178,MUN,P003583,P006760,0 days 00:12:21,-2,24,26
178,MUN,P006760,P011987,0 days 00:12:21,-2,24,26
178,MUN,P006760,P008985,0 days 00:12:08,-2,24,26
178,MUN,P001288,P004508,0 days 00:11:29,-7,22,29
178,MUN,P007639,P010391,0 days 00:11:28,-4,24,28
178,MUN,P003583,P010391,0 days 00:11:01,-10,14,24
178,MUN,P010391,P011987,0 days 00:10:11,-11,14,25
178,MUN,P004508,P007639,0 days 00:10:06,3,24,21
178,MUN,P003583,P007975,0 days 00:09:42,-8,12,20
178,MUN,P007056,P010391,0 days 00:09:19,-12,14,26
178,MUN,P007639,P007975,0 days 00:08:53,3,18,15
178,MUN,P007975,P011987,0 days 00:08:29,-9,12,21
178,MUN,P001288,P007639,0 days 00:07:55,0,19,19
178,MUN,P001288,P003583,0 days 00:07:36,-10,8,18
178,MUN,P007056,P007975,0 days 00:07:16,-3,13,16
178,MUN,P004508,P007056,0 days 00:07:05,-4,14,18
178,MUN,P001288,P011987,0 days 00:06:23,-11,8,19
178,MUN,P007056,P007639,0 days 00:06:22,-1,11,12
178,MUN,P003583,P004508,0 days 00:06:16,-8,6,14
178,MUN,P004508,P006760,0 days 00:05:59,-1,11,12
178,MUN,P006760,P007639,0 days 00:05:59,-1,11,12
178,MUN,P007639,P011987,0 days 00:04:11,-4,6,10
178,MUN,P008985,P010391,0 days 00:03:46,-2,9,11
178,MUN,P006760,P010391,0 days 00:03:10,-4,5,9
178,MUN,P006760,P007975,0 days 00:03:02,3,6,3
178,MUN,P001288,P007056,0 days 00:02:21,-8,3,11
178,MUN,P007639,P008985,0 days 00:02:14,0,7,7
178,MUN,P001288,P008985,0 days 00:01:51,0,7,7
178,MUN,P004508,P008985,0 days 00:01:51,0,7,7
178,MAD,P001392,P006540,0 days 00:19:06,5,38,33
178,MAD,P004887,P005928,0 days 00:18:58,13,49,36
178,MAD,P003733,P004887,0 days 00:18:33,11,47,36
178,MAD,P005791,P006540,0 days 00:18:07,5,37,32
178,MAD,P001392,P003108,0 days 00:17:50,1,35,34
178,MAD,P003733,P005928,0 days 00:17:40,12,45,33
178,MAD,P001392,P005791,0 days 00:16:47,2,32,30
178,MAD,P005928,P010357,0 days 00:16:42,7,35,28
178,MAD,P003733,PTGB,0 days 00:16:30,20,46,26
178,MAD,P005928,PTGB,0 days 00:15:56,22,47,25
178,MAD,P003108,P006540,0 days 00:15:46,2,32,30
178,MAD,P003108,P005791,0 days 00:15:46,2,32,30
178,MAD,P004887,PTGB,0 days 00:15:29,18,44,26
178,MAD,P003108,P010623,0 days 00:13:53,4,30,26
178,MAD,P001392,P010623,0 days 00:13:53,4,30,26
178,MAD,P006540,P010623,0 days 00:13:53,4,30,26
178,MAD,P005791,P010623,0 days 00:13:53,4,30,26
178,MAD,P004887,P010357,0 days 00:13:20,2,28,26
178,MAD,P010357,PTGB,0 days 00:12:22,10,29,19
178,MAD,P003733,P010357,0 days 00:12:02,1,24,23
178,MAD,P001392,P005928,0 days 00:08:17,-6,11,17
178,MAD,P003108,P005928,0 days 00:07:31,9,23,14
178,MAD,P005928,P006540,0 days 00:06:33,4,13,9
178,MAD,P003108,P004887,0 days 00:05:38,11,21,10
178,MAD,P003108,P003733,0 days 00:05:38,11,21,10
178,MAD,P001392,P004887,0 days 00:05:23,-4,9,13
178,MAD,P005791,P005928,0 days 00:05:15,3,9,6
178,MAD,P006540,P010357,0 days 00:04:40,6,11,5
178,MAD,P001392,P010357,0 days 00:04:20,-3,6,9
178,MAD,P003108,PTGB,0 days 00:03:34,12,18,6
178,MAD,P005791,P010357,0 days 00:03:22,5,7,2
178,MAD,P001392,P003733,0 days 00:03:04,-7,3,10
178,MAD,P005791,PTGB,0 days 00:02:21,5,7,2
178,MAD,P004887,P006540,0 days 00:02:19,3,6,3
178,MAD,P010623,PTGB,0 days 00:01:54,1,4,3
178,MAD,P011649,PTGB,0 days 00:01:54,1,4,3
178,MAD,P004887,P010623,0 days 00:01:54,1,4,3
178,MAD,P010623,P011649,0 days 00:01:54,1,4,3
178,MAD,P004887,P011649,0 days 00:01:54,1,4,3
178,MAD,P003733,P011649,0 days 00:01:54,1,4,3
178,MAD,P003733,P010623,0 days 00:01:54,1,4,3
178,MAD,P006540,PTGB,0 days 00:01:20,3,5,2
178,MAD,P003733,P005791,0 days 00:01:01,2,2,0
179,BAR,P002939,P012745,0 days 00:25:56,24,64,40
179,BAR,P004866,P012745,0 days 00:25:10,15,61,46
179,BAR,P002939,P004866,0 days 00:22:20,26,59,33
179,BAR,P002939,P003196,0 days 00:18:36,6,34,28
179,BAR,P003196,P007519,0 days 00:18:09,3,38,35
179,BAR,P009992,P012745,0 days 00:17:26,7,41,34
179,BAR,P004866,P009992,0 days 00:17:26,7,41,34
179,BAR,P002939,P009992,0 days 00:17:12,12,43,31
179,BAR,P002939,P007519,0 days 00:16:56,6,35,29
179,BAR,P000925,P002939,0 days 00:16:46,11,46,35
179,BAR,P003196,P012745,0 days 00:16:13,4,32,28
179,BAR,P002939,P007464,0 days 00:14:24,-10,23,33
179,BAR,P000925,P012745,0 days 00:14:17,11,38,27
179,BAR,P000925,P004866,0 days 00:14:02,12,37,25
179,BAR,P007519,P012745,0 days 00:14:01,5,31,26
179,BAR,P000925,P009992,0 days 00:13:24,16,41,25
179,BAR,P007464,P007519,0 days 00:13:16,-15,17,32
179,BAR,P003196,P004866,0 days 00:12:52,5,28,23
179,BAR,P004866,P007519,0 days 00:10:25,7,26,19
179,BAR,P003196,P007464,0 days 00:09:59,-9,14,23
179,BAR,P002939,P011244,0 days 00:09:30,-7,16,23
179,BAR,P007464,P012745,0 days 00:08:57,-6,13,19
179,BAR,P007464,P011244,0 days 00:07:42,-9,12,21
179,BAR,P007519,P011244,0 days 00:07:29,-8,10,18
179,BAR,P000925,P007464,0 days 00:06:40,-6,11,17
179,BAR,P003196,P009992,0 days 00:06:03,-8,6,14
179,BAR,P003196,P011244,0 days 00:05:40,-5,8,13
179,BAR,P000925,P011244,0 days 00:03:46,-2,8,10
179,BAR,P004866,P007464,0 days 00:03:37,-6,4,10
179,BAR,P000925,P007519,0 days 00:03:17,-6,3,9
179,BAR,P007519,P009992,0 days 00:02:23,-4,4,8
179,BAR,P009992,P011244,0 days 00:02:05,1,6,5
179,BAR,P007464,P009992,0 days 00:02:01,1,6,5
179,BAR,P004866,P011244,0 days 00:01:44,2,4,2
179,BAR,P002939,P003204,0 days 00:00:04,0,0,0
179,BAR,P003204,P007519,0 days 00:00:04,0,0,0
179,BAR,P003204,P009992,0 days 00:00:04,0,0,0
179,BAR,P003204,P011244,0 days 00:00:04,0,0,0
179,OLY,P008829,P010612,0 days 00:28:42,-8,57,65
179,OLY,P007853,P007982,0 days 00:21:24,14,44,30
179,OLY,P008811,P010612,0 days 00:18:45,-21,32,53
179,OLY,P008811,P008829,0 days 00:18:45,-21,32,53
179,OLY,P003941,P007853,0 days 00:16:35,10,33,23
179,OLY,P003941,P007982,0 days 00:16:35,10,33,23
179,OLY,P001255,P008829,0 days 00:16:05,-15,33,48
179,OLY,P001255,P010612,0 days 00:16:05,-15,33,48
179,OLY,P008855,P010612,0 days 00:15:32,-14,31,45
179,OLY,P001255,P008811,0 days 00:14:52,-21,25,46
179,OLY,P007982,P008829,0 days 00:14:32,2,26,24
179,OLY,P007982,P010612,0 days 00:14:32,2,26,24
179,OLY,P008829,P008855,0 days 00:14:10,-10,31,41
179,OLY,P001255,P008855,0 days 00:14:06,-10,31,41
179,OLY,P008811,P008855,0 days 00:13:58,-19,24,43
179,OLY,P007853,P008829,0 days 00:12:37,7,24,17
179,OLY,P007853,P010612,0 days 00:12:37,7,24,17
179,OLY,P003941,P010612,0 days 00:11:15,9,25,16
179,OLY,P006589,P007853,0 days 00:09:56,4,21,17
179,OLY,P003941,P008829,0 days 00:09:53,13,25,12
179,OLY,P003941,P006589,0 days 00:09:17,-1,16,17
179,OLY,P006589,P007982,0 days 00:08:51,7,20,13
179,OLY,P003941,P010392,0 days 00:07:17,-3,9,12
179,OLY,P006589,P010392,0 days 00:07:17,-3,9,12
179,OLY,P007982,P008811,0 days 00:06:48,-1,13,14
179,OLY,P007853,P010392,0 days 00:05:55,1,9,8
179,OLY,P007982,P010392,0 days 00:05:55,1,9,8
179,OLY,P007853,P008811,0 days 00:05:54,1,12,11
179,OLY,P007853,P011983,0 days 00:04:05,3,12,9
179,OLY,P006589,P011983,0 days 00:04:01,3,12,9
179,OLY,P007982,P011983,0 days 00:02:56,6,11,5
179,OLY,P003941,P008855,0 days 00:02:35,2,8,6
179,OLY,P006589,P008855,0 days 00:02:27,-7,1,8
179,OLY,P006589,P008811,0 days 00:02:01,1,5,4
179,OLY,P008811,P011983,0 days 00:02:01,1,5,4
179,OLY,P003941,P011983,0 days 00:02:00,2,7,5
179,OLY,P001255,P007982,0 days 00:01:59,-5,2,7
179,OLY,P006589,P010612,0 days 00:01:22,-4,0,4
179,OLY,P008855,P010392,0 days 00:01:22,-4,0,4
179,OLY,P010392,P010612,0 days 00:01:22,-4,0,4
179,OLY,P001255,P003941,0 days 00:01:13,6,8,2
179,OLY,P007853,P008855,0 days 00:01:09,-3,1,4
179,OLY,P008855,P011983,0 days 00:01:09,-3,1,4
179,OLY,P008829,P011983,0 days 00:00:04,0,0,0
179,OLY,P010612,P011983,0 days 00:00:04,0,0,0
180,TEL,P009622,P009783,0 days 00:24:10,10,55,45
180,TEL,P009863,P011199,0 days 00:24:10,23,65,42
180,TEL,P011199,P011219,0 days 00:23:36,15,49,34
180,TEL,P009783,P011199,0 days 00:23:28,20,61,41
180,TEL,P009622,P011219,0 days 00:23:01,7,44,37
180,TEL,P009783,P011219,0 days 00:22:47,7,44,37
180,TEL,P009622,P011199,0 days 00:22:03,15,53,38
180,TEL,P009863,P011219,0 days 00:21:16,12,46,34
180,TEL,P009783,P009863,0 days 00:19:19,19,53,34
180,TEL,P009622,P009863,0 days 00:18:03,13,47,34
180,TEL,P007990,P009863,0 days 00:15:32,11,47,36
180,TEL,P007990,P011199,0 days 00:12:27,14,37,23
180,TEL,P007990,P011214,0 days 00:11:41,-7,22,29
180,TEL,P004233,P007990,0 days 00:11:39,11,34,23
180,TEL,P007990,P011219,0 days 00:10:57,-1,18,19
180,TEL,P004233,P009863,0 days 00:10:56,12,32,20
180,TEL,P007990,P011971,0 days 00:10:09,3,25,22
180,TEL,P007990,P009783,0 days 00:09:23,5,27,22
180,TEL,P009863,P011971,0 days 00:08:51,3,23,20
180,TEL,P007990,P009622,0 days 00:08:14,0,21,21
180,TEL,P009863,P011214,0 days 00:08:02,-2,18,20
180,TEL,P011214,P011971,0 days 00:07:40,-1,17,18
180,TEL,P004233,P011199,0 days 00:06:30,6,17,11
180,TEL,P004233,P011971,0 days 00:06:12,7,19,12
180,TEL,P004233,P011214,0 days 00:06:11,5,17,12
180,TEL,P004233,P011219,0 days 00:04:50,2,10,8
180,TEL,P011214,P011219,0 days 00:04:01,-6,5,11
180,TEL,P011199,P011971,0 days 00:03:17,4,8,4
180,TEL,P007990,P012744,0 days 00:03:09,-7,3,10
180,TEL,P011214,P012744,0 days 00:03:09,-7,3,10
180,TEL,P011971,P012744,0 days 00:03:09,-7,3,10
180,TEL,P009622,P011214,0 days 00:02:51,-5,4,9
180,TEL,P009863,P012744,0 days 00:02:39,-7,1,8
180,TEL,P009783,P011214,0 days 00:02:21,-5,2,7
180,TEL,P004233,P009783,0 days 00:00:51,2,5,3
180,TEL,P011199,P011214,0 days 00:00:48,0,0,0
180,TEL,P009783,P011971,0 days 00:00:48,3,3,0
180,TEL,P009622,P011971,0 days 00:00:30,0,2,2
180,TEL,P009622,P012744,0 days 00:00:30,0,2,2
180,TEL,P004233,P009622,0 days 00:00:14,0,0,0
180,TEL,P004233,P011433,0 days 00:00:09,-1,2,3
180,TEL,P007990,P011433,0 days 00:00:09,-1,2,3
180,TEL,P009783,P011433,0 days 00:00:09,-1,2,3
180,TEL,P011199,P011433,0 days 00:00:09,-1,2,3
180,VIR,P001133,P003048,0 days 00:23:26,-20,40,60
180,VIR,P001133,P001844,0 days 00:23:15,-18,41,59
180,VIR,P001133,P009549,0 days 00:22:33,-17,33,50
180,VIR,P001844,P009549,0 days 00:22:12,-17,34,51
180,VIR,P001844,P003048,0 days 00:21:18,-15,41,56
180,VIR,P003048,P009549,0 days 00:20:12,-16,31,47
180,VIR,P001133,P003527,0 days 00:16:06,-14,19,33
180,VIR,P006739,P010781,0 days 00:14:55,1,34,33
180,VIR,P010781,PBCN,0 days 00:14:39,4,38,34
180,VIR,P001844,P003527,0 days 00:14:22,-8,21,29
180,VIR,P003527,P009549,0 days 00:14:10,-10,19,29
180,VIR,P006739,PBCN,0 days 00:13:51,5,40,35
180,VIR,P003048,PBCN,0 days 00:12:51,-7,28,35
180,VIR,P003048,P003527,0 days 00:12:42,-9,18,27
180,VIR,P001133,PBCN,0 days 00:12:11,-9,25,34
180,VIR,P004554,P010781,0 days 00:11:36,5,28,23
180,VIR,P004554,P006739,0 days 00:11:27,5,28,23
180,VIR,P001844,PBCN,0 days 00:10:34,-7,23,30
180,VIR,P004554,PBCN,0 days 00:10:28,6,28,22
180,VIR,P009549,PBCN,0 days 00:08:58,-8,13,21
180,VIR,P002084,PBCN,0 days 00:07:33,9,25,16
180,VIR,P002084,P006739,0 days 00:07:05,10,24,14
180,VIR,P002084,P010781,0 days 00:07:05,10,24,14
180,VIR,P003527,P004554,0 days 00:06:59,-6,7,13
180,VIR,P003527,P010781,0 days 00:06:13,-7,7,14
180,VIR,P003527,P006739,0 days 00:06:01,-9,5,14
180,VIR,P002084,P004554,0 days 00:05:57,11,20,9
180,VIR,P001133,P006739,0 days 00:05:54,-6,14,20
180,VIR,P003048,P006739,0 days 00:05:16,-6,15,21
180,VIR,P001133,P010781,0 days 00:05:13,-7,7,14
180,VIR,P003048,P010781,0 days 00:04:59,-5,10,15
180,VIR,P003527,PBCN,0 days 00:04:59,-5,8,13
180,VIR,P001133,P004554,0 days 00:04:02,-1,5,6
180,VIR,P001844,P004554,0 days 00:02:16,0,2,2
180,VIR,P004554,P009549,0 days 00:02:07,0,2,2
180,VIR,P001844,P010781,0 days 00:01:40,-1,4,5
180,VIR,P002084,P003048,0 days 00:01:36,-2,5,7
180,VIR,P006739,P009549,0 days 00:01:24,-3,3,6
180,VIR,P001844,P006739,0 days 00:00:59,-1,9,10
180,VIR,P001844,P002084,0 days 00:00:28,-1,1,2
180,VIR,P002084,P009549,0 days 00:00:28,-1,1,2
181,ULK,P001932,P006661,0 days 00:26:10,21,66,45
181,ULK,P006661,P010560,0 days 00:25:23,19,67,48
181,ULK,P001932,P011157,0 days 00:23:37,10,59,49
181,ULK,P001932,P010560,0 days 00:22:39,20,62,42
181,ULK,P006661,P011157,0 days 00:19:01,6,44,38
181,ULK,P004004,P009849,0 days 00:16:50,2,31,29
181,ULK,P009849,P011157,0 days 00:16:48,4,40,36
181,ULK,P004004,P006961,0 days 00:16:45,-7,29,36
181,ULK,P010560,P011157,0 days 00:16:31,5,42,37
181,ULK,P006961,P009849,0 days 00:15:30,-7,27,34
181,ULK,P001932,P011980,0 days 00:15:03,9,33,24
181,ULK,P006661,P011980,0 days 00:15:03,9,33,24
181,ULK,P004004,P011157,0 days 00:14:19,-6,32,38
181,ULK,P010560,P011980,0 days 00:13:40,12,33,21
181,ULK,P001932,P009849,0 days 00:13:23,9,36,27
181,ULK,P006961,P011157,0 days 00:11:34,-6,27,33
181,ULK,P002968,P006961,0 days 00:10:14,-4,14,18
181,ULK,P006961,P011052,0 days 00:09:44,-10,11,21
181,ULK,P001932,P004004,0 days 00:09:41,2,26,24
181,ULK,P009849,P011052,0 days 00:09:01,-11,8,19
181,ULK,P001932,P006961,0 days 00:08:52,5,26,21
181,ULK,P011157,P011980,0 days 00:08:43,0,14,14
181,ULK,P006961,P010560,0 days 00:08:33,-11,16,27
181,ULK,P006661,P009849,0 days 00:08:03,5,19,14
181,ULK,P004004,P011052,0 days 00:07:47,-3,8,11
181,ULK,P002968,P011052,0 days 00:07:17,-5,9,14
181,ULK,P002968,P009849,0 days 00:06:34,-6,6,12
181,ULK,P009849,P010560,0 days 00:06:29,-1,17,18
181,ULK,P002968,P004004,0 days 00:06:29,0,6,6
181,ULK,P004004,P006661,0 days 00:06:14,-4,11,15
181,ULK,P006661,P006961,0 days 00:06:00,0,14,14
181,ULK,P005844,P010560,0 days 00:05:58,9,19,10
181,ULK,P005844,P006661,0 days 00:05:58,9,19,10
181,ULK,P001932,P005844,0 days 00:05:58,9,19,10
181,ULK,P005844,P011980,0 days 00:05:47,9,19,10
181,ULK,P002968,P010560,0 days 00:05:27,-6,8,14
181,ULK,P004004,P010560,0 days 00:05:07,-8,9,17
181,ULK,P002968,P006661,0 days 00:04:13,2,8,6
181,ULK,P011052,P011157,0 days 00:02:27,-5,2,7
181,ULK,P001932,P002968,0 days 00:02:21,3,5,2
181,ULK,P010560,P011052,0 days 00:01:57,-7,3,10
181,ULK,P009849,P011980,0 days 00:01:23,-3,0,3
181,ULK,P006661,P011052,0 days 00:00:43,1,3,2
181,ULK,P002968,P011980,0 days 00:00:33,0,0,0
181,ULK,P005844,P009849,0 days 00:00:11,0,0,0
181,MUN,P001288,P007056,0 days 00:29:53,-18,57,75
181,MUN,P004508,P007975,0 days 00:25:16,4,54,50
181,MUN,P004508,P007056,0 days 00:19:46,3,45,42
181,MUN,P007056,P008985,0 days 00:19:10,-11,37,48
181,MUN,P007056,P010391,0 days 00:19:01,0,45,45
181,MUN,P007056,P007975,0 days 00:17:30,9,43,34
181,MUN,P001288,P004508,0 days 00:17:10,-7,34,41
181,MUN,P001288,P008985,0 days 00:15:53,-14,30,44
181,MUN,P001288,P007975,0 days 00:14:54,-1,32,33
181,MUN,P001288,P010391,0 days 00:14:53,-6,32,38
181,MUN,P007056,P007639,0 days 00:12:46,-14,21,35
181,MUN,P001288,P007639,0 days 00:12:46,-14,21,35
181,MUN,P004508,P010391,0 days 00:12:35,-2,29,31
181,MUN,P007975,P010391,0 days 00:12:27,-2,29,31
181,MUN,P004508,P005460,0 days 00:11:42,7,23,16
181,MUN,P007056,P011987,0 days 00:10:46,-1,25,26
181,MUN,P001288,P011987,0 days 00:10:45,-4,22,26
181,MUN,P008985,P011987,0 days 00:10:45,-4,22,26
181,MUN,P005460,P007975,0 days 00:10:33,5,21,16
181,MUN,P004508,P006760,0 days 00:10:29,2,19,17
181,MUN,P007639,P008985,0 days 00:10:21,-15,17,32
181,MUN,P006760,P007975,0 days 00:10:21,2,19,17
181,MUN,P005460,P006760,0 days 00:09:57,2,16,14
181,MUN,P007639,P011987,0 days 00:09:22,-7,17,24
181,MUN,P005460,P006543,0 days 00:08:03,-5,11,16
181,MUN,P006543,P006760,0 days 00:07:49,-6,8,14
181,MUN,P006543,P007975,0 days 00:07:37,-5,11,16
181,MUN,P004508,P006543,0 days 00:07:37,-5,11,16
181,MUN,P008985,P010391,0 days 00:07:01,2,16,14
181,MUN,P001557,P007056,0 days 00:05:17,0,10,10
181,MUN,P001557,P008985,0 days 00:05:17,0,10,10
181,MUN,P001557,P010391,0 days 00:05:17,0,10,10
181,MUN,P005460,P007056,0 days 00:05:01,12,14,2
181,MUN,P006760,P007056,0 days 00:04:45,9,16,7
181,MUN,P006543,P008985,0 days 00:03:43,3,7,4
181,MUN,P006543,P010391,0 days 00:03:43,3,7,4
181,MUN,P004508,P007639,0 days 00:03:24,-7,4,11
181,MUN,P006543,P007056,0 days 00:03:17,3,7,4
181,MUN,P001288,P005460,0 days 00:03:16,5,9,4
181,MUN,P001288,P001557,0 days 00:02:48,-1,5,6
181,MUN,P005460,P008985,0 days 00:02:40,2,4,2
181,MUN,P006760,P010391,0 days 00:02:33,-1,6,7
181,MUN,P001557,P006543,0 days 00:02:29,1,5,4
181,MUN,P007639,P007975,0 days 00:02:25,1,4,3
181,MUN,P004508,P008985,0 days 00:02:08,-6,2,8
181,MUN,P006760,P008985,0 days 00:01:26,-1,3,4
181,MUN,P005460,P011987,0 days 00:01:05,0,2,2
181,MUN,P001288,P006543,0 days 00:01:02,3,5,2
181,MUN,P005460,P010391,0 days 00:00:35,0,0,0
181,MUN,P001288,P006760,0 days 00:00:20,-3,1,4
181,MUN,P010391,P011987,0 days 00:00:19,6,6,0
181,MUN,P004508,P011987,0 days 00:00:01,3,3,0
181,MUN,P007975,P011987,0 days 00:00:01,3,3,0
182,PAN,P002328,P003842,0 days 00:29:11,35,72,37
182,PAN,P011204,P012774,0 days 00:24:40,15,59,44
182,PAN,P002328,P011204,0 days 00:24:37,26,60,34
182,PAN,P003842,P011204,0 days 00:24:32,26,57,31
182,PAN,P002328,P012774,0 days 00:22:33,21,55,34
182,PAN,P003842,P012774,0 days 00:21:09,24,53,29
182,PAN,P007866,P011204,0 days 00:20:27,17,49,32
182,PAN,P002328,P007866,0 days 00:20:08,20,47,27
182,PAN,P003842,P007866,0 days 00:18:35,23,46,23
182,PAN,P007866,P012774,0 days 00:15:34,8,35,27
182,PAN,P012712,P012774,0 days 00:14:18,9,33,24
182,PAN,P002328,P012712,0 days 00:12:33,9,28,19
182,PAN,P001926,P011204,0 days 00:12:29,-3,21,24
182,PAN,P001926,P002328,0 days 00:12:10,4,20,16
182,PAN,P003842,P012712,0 days 00:11:59,10,26,16
182,PAN,P011204,P012712,0 days 00:11:14,5,24,19
182,PAN,P001926,P003842,0 days 00:10:48,7,19,12
182,PAN,P001926,P012712,0 days 00:08:52,-6,11,17
182,PAN,P001926,P007866,0 days 00:08:46,0,16,16
182,PAN,P011221,P012774,0 days 00:07:53,-5,15,20
182,PAN,P001926,P012774,0 days 00:07:30,-14,7,21
182,PAN,P011204,P011221,0 days 00:07:09,-4,16,20
182,PAN,P002328,P011209,0 days 00:06:52,5,15,10
182,PAN,P011221,P012712,0 days 00:06:12,0,13,13
182,PAN,P003842,P011209,0 days 00:06:02,7,15,8
182,PAN,P001926,P011221,0 days 00:06:00,-11,8,19
182,PAN,P011209,P012712,0 days 00:05:45,7,15,8
182,PAN,P011209,P012774,0 days 00:04:00,4,9,5
182,PAN,P001926,P011209,0 days 00:03:57,-1,6,7
182,PAN,P002328,P011221,0 days 00:02:40,-4,3,7
182,PAN,P007866,P011221,0 days 00:02:24,-6,3,9
182,PAN,P006544,P011221,0 days 00:01:51,6,6,0
182,PAN,P006544,P012712,0 days 00:01:51,6,6,0
182,PAN,P006544,P012774,0 days 00:01:51,6,6,0
182,PAN,P006544,P011204,0 days 00:01:36,6,6,0
182,PAN,P007866,P011209,0 days 00:01:22,-2,0,2
182,PAN,P006544,P011209,0 days 00:00:15,0,0,0
182,PAN,P011209,P011221,0 days 00:00:15,0,0,0
182,MCO,P005985,P010588,0 days 00:20:48,-22,23,45
182,MCO,P005985,PLCZ,0 days 00:19:50,-7,31,38
182,MCO,P005985,P008099,0 days 00:17:23,-19,29,48
182,MCO,P005985,P011231,0 days 00:16:44,-23,20,43
182,MCO,P005985,P011226,0 days 00:15:31,-3,24,27
182,MCO,P005985,P012709,0 days 00:14:42,-5,25,30
182,MCO,P012709,PLCZ,0 days 00:13:30,-2,25,27
182,MCO,P010588,PLCZ,0 days 00:13:13,-10,15,25
182,MCO,P008099,P011196,0 days 00:13:07,-7,24,31
182,MCO,P004790,P005985,0 days 00:12:58,-1,31,32
182,MCO,P004197,P005985,0 days 00:12:56,-9,19,28
182,MCO,P011226,PLCZ,0 days 00:12:36,2,21,19
182,MCO,P004197,P008099,0 days 00:12:35,-6,24,30
182,MCO,P004197,P011196,0 days 00:12:35,-6,24,30
182,MCO,P010588,P011231,0 days 00:12:15,-16,15,31
182,MCO,P008099,P011231,0 days 00:11:55,-19,14,33
182,MCO,P010588,P011226,0 days 00:11:29,-7,13,20
182,MCO,P008099,P010588,0 days 00:11:10,-13,17,30
182,MCO,P011226,P012709,0 days 00:10:14,-1,19,20
182,MCO,P004790,P011226,0 days 00:09:51,1,21,20
182,MCO,P005985,P011196,0 days 00:09:20,-8,17,25
182,MCO,P010588,P012709,0 days 00:08:05,-8,9,17
182,MCO,P004197,P011226,0 days 00:07:55,-1,9,10
182,MCO,P004790,P012709,0 days 00:07:49,0,16,16
182,MCO,P011231,PLCZ,0 days 00:07:14,-9,10,19
182,MCO,P004197,P010588,0 days 00:06:43,-3,7,10
182,MCO,P004790,PLCZ,0 days 00:06:37,3,16,13
182,MCO,P004790,P008099,0 days 00:06:08,3,17,14
182,MCO,P004197,P004790,0 days 00:05:44,0,14,14
182,MCO,P004790,P011196,0 days 00:05:31,2,14,12
182,MCO,P008099,P011226,0 days 00:04:56,1,10,9
182,MCO,P004197,P011231,0 days 00:04:50,-7,5,12
182,MCO,P002581,P010588,0 days 00:04:40,-7,5,12
182,MCO,P002581,P005985,0 days 00:04:40,-7,5,12
182,MCO,P002581,P008099,0 days 00:04:40,-7,5,12
182,MCO,P002581,P011231,0 days 00:04:40,-7,5,12
182,MCO,P011196,P011231,0 days 00:04:29,-7,5,12
182,MCO,P011231,P012709,0 days 00:04:28,-4,6,10
182,MCO,P011196,P011226,0 days 00:04:19,0,7,7
182,MCO,P004197,PLCZ,0 days 00:03:34,0,2,2
182,MCO,P010588,P011196,0 days 00:03:07,-2,5,7
182,MCO,P008099,PLCZ,0 days 00:02:46,-5,4,9
182,MCO,P004790,P010588,0 days 00:02:02,-4,3,7
182,MCO,P011226,P011231,0 days 00:00:21,0,0,0
183,MIL,P005670,P011205,0 days 00:24:35,-4,31,35
183,MIL,P002849,P011205,0 days 00:22:56,-5,32,37
183,MIL,P002849,P011224,0 days 00:22:06,-1,34,35
183,MIL,P011205,P011224,0 days 00:21:15,0,32,32
183,MIL,P002849,P005670,0 days 00:20:31,-1,28,29
183,MIL,P005670,P011224,0 days 00:18:50,4,28,24
183,MIL,P007201,P011224,0 days 00:18:13,-10,33,43
183,MIL,P006701,P007201,0 days 00:16:32,-11,32,43
183,MIL,P009960,P011224,0 days 00:15:04,3,27,24
183,MIL,P005670,P009960,0 days 00:14:17,7,24,17
183,MIL,P009960,P011205,0 days 00:14:17,7,24,17
183,MIL,P006701,P011224,0 days 00:13:27,-9,29,38
183,MIL,P002849,P009960,0 days 00:13:20,7,24,17
183,MIL,P006509,P007201,0 days 00:12:57,-5,27,32
183,MIL,P002812,P007201,0 days 00:12:25,-2,25,27
183,MIL,P007201,P011205,0 days 00:11:44,-7,13,20
183,MIL,P006509,P011224,0 days 00:11:02,-5,25,30
183,MIL,P002812,P006701,0 days 00:10:57,-2,23,25
183,MIL,P002812,P006509,0 days 00:10:19,-2,22,24
183,MIL,P006509,P006701,0 days 00:09:58,-4,23,27
183,MIL,P006701,P011205,0 days 00:09:39,-12,9,21
183,MIL,P005670,P007201,0 days 00:08:52,-3,9,12
183,MIL,P002849,P007201,0 days 00:08:02,-6,10,16
183,MIL,P002812,P011224,0 days 00:07:52,0,20,20
183,MIL,P002849,P006701,0 days 00:06:51,-10,6,16
183,MIL,P005670,P006701,0 days 00:05:16,-7,3,10
183,MIL,P002812,P011205,0 days 00:05:05,-4,5,9
183,MIL,P002812,P005670,0 days 00:04:38,-4,5,9
183,MIL,P001518,P005670,0 days 00:03:54,-9,0,9
183,MIL,P001518,P011205,0 days 00:03:54,-9,0,9
183,MIL,P005670,P006509,0 days 00:03:31,-3,4,7
183,MIL,P001518,P002849,0 days 00:03:22,-7,0,7
183,MIL,P006509,P011205,0 days 00:02:27,-2,2,4
183,MIL,P007201,P009960,0 days 00:02:19,-4,3,7
183,MIL,P001518,P006701,0 days 00:02:03,-5,0,5
183,MIL,P006701,P009960,0 days 00:01:57,-4,3,7
183,MIL,P002849,P006509,0 days 00:01:48,-1,2,3
183,MIL,P006509,P009960,0 days 00:01:22,-4,3,7
183,MIL,P001518,P011224,0 days 00:01:19,-2,0,2
183,MIL,P001518,P002812,0 days 00:00:32,-2,0,2
183,MIL,P001518,P006509,0 days 00:00:32,-2,0,2
183,RED,P006436,P009035,0 days 00:21:24,9,47,38
183,RED,P006436,P007960,0 days 00:20:52,16,40,24
183,RED,P005099,P009035,0 days 00:20:40,6,36,30
183,RED,P005099,PJDR,0 days 00:19:21,15,40,25
183,RED,P009035,PLUO,0 days 00:17:52,-10,31,41
183,RED,P005099,P006436,0 days 00:17:24,19,35,16
183,RED,P006436,PJDR,0 days 00:17:12,23,37,14
183,RED,P009035,P012044,0 days 00:16:08,-1,34,35
183,RED,P009035,PJDR,0 days 00:15:59,9,32,23
183,RED,P007960,PJDR,0 days 00:14:54,21,33,12
183,RED,P007960,P009035,0 days 00:14:30,8,30,22
183,RED,P005099,P007960,0 days 00:14:22,19,33,14
183,RED,P006436,PLUO,0 days 00:12:55,0,26,26
183,RED,P002553,P009035,0 days 00:12:34,-7,20,27
183,RED,P012044,PLUO,0 days 00:11:53,-2,28,30
183,RED,P006436,P012044,0 days 00:09:37,-2,22,24
183,RED,P002553,P005099,0 days 00:09:14,-6,7,13
183,RED,P007960,PLUO,0 days 00:09:07,-1,11,12
183,RED,P000848,P009035,0 days 00:07:41,1,14,13
183,RED,P002553,PJDR,0 days 00:07:02,-6,7,13
183,RED,P011941,PJDR,0 days 00:06:56,10,12,2
183,RED,P007960,P011941,0 days 00:06:56,10,12,2
183,RED,P006436,P011941,0 days 00:06:56,10,12,2
183,RED,P002553,PLUO,0 days 00:06:45,-9,14,23
183,RED,P002553,P006436,0 days 00:06:40,1,17,16
183,RED,PJDR,PLUO,0 days 00:06:36,-4,5,9
183,RED,P000848,P012044,0 days 00:06:01,-1,10,11
183,RED,P005099,PLUO,0 days 00:05:59,-8,3,11
183,RED,P002553,P012044,0 days 00:05:32,-1,13,14
183,RED,P007960,P012044,0 days 00:05:03,-1,9,10
183,RED,P011964,P012044,0 days 00:05:01,-1,10,11
183,RED,P000848,P011964,0 days 00:05:01,-1,10,11
183,RED,P009035,P011964,0 days 00:05:01,-1,10,11
183,RED,P005099,P011941,0 days 00:04:21,8,10,2
183,RED,P011964,PLUO,0 days 00:04:03,0,6,6
183,RED,P000848,PLUO,0 days 00:04:03,0,6,6
183,RED,P005099,P012044,0 days 00:03:44,1,6,5
183,RED,P000848,P005099,0 days 00:03:34,1,8,7
183,RED,P011941,PLUO,0 days 00:02:35,2,2,0
183,RED,P000848,P002553,0 days 00:02:29,0,2,2
183,RED,P000848,PJDR,0 days 00:01:40,2,4,2
183,RED,P012044,PJDR,0 days 00:01:33,4,4,0
183,RED,P005099,P011964,0 days 00:00:58,-1,4,5
183,RED,P005099,P008966,0 days 00:00:27,2,2,0
183,RED,P008966,P009035,0 days 00:00:27,2,2,0
183,RED,P008966,PJDR,0 days 00:00:27,2,2,0
183,RED,P006436,P008966,0 days 00:00:16,0,0,0
183,RED,P000848,P008966,0 days 00:00:11,2,2,0
183,RED,P000848,P006436,0 days 00:00:04,0,0,0
184,MAD,P005791,P005928,0 days 00:28:24,5,60,55
184,MAD,P005791,P006540,0 days 00:26:11,12,58,46
184,MAD,P005928,P006540,0 days 00:26:09,9,55,46
184,MAD,P003108,PTGB,0 days 00:24:17,6,54,48
184,MAD,P005791,P010357,0 days 00:22:58,-5,43,48
184,MAD,P005928,P010357,0 days 00:21:39,3,45,42
184,MAD,P005791,PTGB,0 days 00:19:58,3,43,40
184,MAD,P006540,P010357,0 days 00:19:30,0,38,38
184,MAD,P003108,P005791,0 days 00:18:10,5,40,35
184,MAD,P001392,P010357,0 days 00:16:30,4,33,29
184,MAD,P001392,P006540,0 days 00:16:30,4,33,29
184,MAD,P001392,P005928,0 days 00:16:30,4,33,29
184,MAD,P001392,P005791,0 days 00:16:30,4,33,29
184,MAD,PCVM,PTGB,0 days 00:14:15,7,34,27
184,MAD,P003108,PCVM,0 days 00:14:15,7,34,27
184,MAD,P003733,PTGB,0 days 00:13:14,1,26,25
184,MAD,P003108,P003733,0 days 00:13:11,1,26,25
184,MAD,P003733,PCVM,0 days 00:11:28,2,22,20
184,MAD,P003733,P005791,0 days 00:11:07,2,23,21
184,MAD,P005928,PTGB,0 days 00:11:00,1,25,24
184,MAD,P003108,P005928,0 days 00:10:27,3,24,21
184,MAD,P006540,PTGB,0 days 00:10:00,8,26,18
184,MAD,P003108,P006540,0 days 00:09:25,14,27,13
184,MAD,P005791,PCVM,0 days 00:09:14,4,20,16
184,MAD,P003108,P009213,0 days 00:06:41,1,14,13
184,MAD,P009213,PTGB,0 days 00:06:06,-1,12,13
184,MAD,P009213,PCVM,0 days 00:05:00,1,12,11
184,MAD,P010357,PTGB,0 days 00:04:39,-7,8,15
184,MAD,P003733,P009213,0 days 00:04:32,1,9,8
184,MAD,P003733,P005928,0 days 00:04:00,1,10,9
184,MAD,P003108,P010357,0 days 00:02:51,-5,5,10
184,MAD,P006540,P009213,0 days 00:02:44,2,7,5
184,MAD,P003733,P010357,0 days 00:02:28,2,6,4
184,MAD,P003733,P006540,0 days 00:02:25,2,6,4
184,MAD,P006540,PCVM,0 days 00:02:06,7,10,3
184,MAD,P005928,P009213,0 days 00:01:30,0,2,2
184,MAD,P010623,PTGB,0 days 00:00:51,-2,0,2
184,MAD,P010357,PCVM,0 days 00:00:41,-2,2,4
184,MAD,P005791,P010623,0 days 00:00:40,-2,0,2
184,MAD,P006540,P010623,0 days 00:00:40,-2,0,2
184,MAD,P010357,P010623,0 days 00:00:40,-2,0,2
184,MAD,P003108,P010623,0 days 00:00:11,0,0,0
184,MAD,P003733,P010623,0 days 00:00:11,0,0,0
184,MAD,P009213,P010623,0 days 00:00:11,0,0,0
184,MAD,P005928,PCVM,0 days 00:00:01,2,2,0
184,PAM,P010568,P011970,0 days 00:22:18,-9,34,43
184,PAM,P003960,P007870,0 days 00:20:03,6,49,43
184,PAM,P011970,P012795,0 days 00:19:45,-7,33,40
184,PAM,P010568,P012795,0 days 00:17:24,-9,30,39
184,PAM,P003960,P004863,0 days 00:16:24,4,43,39
184,PAM,P003960,P010568,0 days 00:16:15,-5,35,40
184,PAM,P003960,P011970,0 days 00:16:15,-5,33,38
184,PAM,P011970,P012738,0 days 00:14:55,-9,20,29
184,PAM,P006643,P012740,0 days 00:14:22,7,32,25
184,PAM,P004863,P007870,0 days 00:14:09,1,33,32
184,PAM,P010568,P012738,0 days 00:13:31,-15,12,27
184,PAM,P007870,P010568,0 days 00:12:41,3,33,30
184,PAM,P006643,P007870,0 days 00:12:37,7,29,22
184,PAM,P007870,P012740,0 days 00:12:34,9,29,20
184,PAM,P003960,P012795,0 days 00:12:28,-6,27,33
184,PAM,P012738,P012795,0 days 00:12:28,-4,20,24
184,PAM,P003960,P012740,0 days 00:12:13,5,28,23
184,PAM,P004863,P006643,0 days 00:11:52,5,28,23
184,PAM,P003960,P006643,0 days 00:11:08,8,28,20
184,PAM,P004863,P012740,0 days 00:11:06,5,25,20
184,PAM,P012739,P012795,0 days 00:09:04,-5,11,16
184,PAM,P012738,P012739,0 days 00:09:04,-5,11,16
184,PAM,P011970,P012739,0 days 00:09:04,-5,11,16
184,PAM,P007870,P012795,0 days 00:09:04,-7,18,25
184,PAM,P007870,P011970,0 days 00:08:57,1,20,19
184,PAM,P010568,P012739,0 days 00:08:12,-6,9,15
184,PAM,P010393,P010568,0 days 00:07:53,-5,11,16
184,PAM,P003960,P012738,0 days 00:06:21,-5,13,18
184,PAM,P010568,P012740,0 days 00:05:58,-4,10,14
184,PAM,P004863,P011970,0 days 00:05:47,3,17,14
184,PAM,P004863,P012795,0 days 00:05:36,-5,12,17
184,PAM,P006643,P010568,0 days 00:05:26,0,12,12
184,PAM,P005356,P010568,0 days 00:05:09,-6,6,12
184,PAM,P005356,P010393,0 days 00:05:08,-4,6,10
184,PAM,P006643,P010393,0 days 00:05:00,-2,9,11
184,PAM,P010393,P012740,0 days 00:04:51,-4,7,11
184,PAM,P004863,P012738,0 days 00:04:46,3,14,11
184,PAM,P012738,P012740,0 days 00:04:30,-8,6,14
184,PAM,P010393,P011970,0 days 00:04:05,-2,4,6
184,PAM,P005356,P011970,0 days 00:04:05,-2,4,6
184,PAM,P004863,P010568,0 days 00:03:29,0,12,12
184,PAM,P007870,P010393,0 days 00:03:18,-2,5,7
184,PAM,P006643,P012738,0 days 00:02:55,-1,6,7
184,PAM,P010393,P012738,0 days 00:02:52,-2,2,4
184,PAM,P003960,P005356,0 days 00:02:47,-4,4,8
184,PAM,P003960,P010393,0 days 00:02:46,-2,4,6
184,PAM,P005356,P012738,0 days 00:01:46,-2,0,2
184,PAM,P004863,P010393,0 days 00:01:39,-1,2,3
184,PAM,P011970,P012740,0 days 00:01:21,-5,0,5
184,PAM,P012740,P012795,0 days 00:00:54,1,3,2
184,PAM,P004863,P012739,0 days 00:00:52,1,2,1
184,PAM,P005356,P012795,0 days 00:00:37,-2,2,4
184,PAM,P005356,P006643,0 days 00:00:36,0,2,2
184,PAM,P006643,P012795,0 days 00:00:36,0,2,2
184,PAM,P010393,P012795,0 days 00:00:36,0,2,2
184,PAM,P005356,P012740,0 days 00:00:27,-2,0,2
184,PAM,P005356,P007870,0 days 00:00:01,-2,0,2
185,IST,P007200,P009846,0 days 00:26:04,17,70,53
185,IST,P007200,P009664,0 days 00:25:23,26,72,46
185,IST,P009664,P009846,0 days 00:24:58,12,63,51
185,IST,P007200,P011078,0 days 00:19:45,26,60,34
185,IST,P006590,P007200,0 days 00:18:17,10,42,32
185,IST,P006590,P009664,0 days 00:17:33,7,39,32
185,IST,P009846,P011078,0 days 00:16:52,11,47,36
185,IST,P007200,P011981,0 days 00:16:00,6,38,32
185,IST,P009664,P012788,0 days 00:15:19,16,43,27
185,IST,P009846,P012788,0 days 00:14:28,7,33,26
185,IST,P009846,P011981,0 days 00:14:24,1,36,35
185,IST,P006590,P009846,0 days 00:14:12,-4,27,31
185,IST,P009664,P011078,0 days 00:13:45,19,46,27
185,IST,P007200,P012788,0 days 00:12:28,18,40,22
185,IST,P009664,P011981,0 days 00:12:03,3,28,25
185,IST,P011078,PLHK,0 days 00:10:48,4,23,19
185,IST,P007200,PLHK,0 days 00:10:48,4,23,19
185,IST,P006590,P012788,0 days 00:10:14,2,23,21
185,IST,P011078,P011981,0 days 00:10:00,8,29,21
185,IST,P006590,P011981,0 days 00:09:09,6,21,15
185,IST,P009664,P010400,0 days 00:08:48,8,20,12
185,IST,P006590,P011078,0 days 00:08:39,9,26,17
185,IST,P009846,PLHK,0 days 00:08:27,3,19,16
185,IST,P009846,P010400,0 days 00:07:11,5,17,12
185,IST,P011078,P012788,0 days 00:06:50,9,23,14
185,IST,P007200,P010400,0 days 00:05:45,6,15,9
185,IST,P010400,P011981,0 days 00:05:13,0,10,10
185,IST,P006590,P010400,0 days 00:04:59,2,6,4
185,IST,P011981,PLHK,0 days 00:04:51,0,10,10
185,IST,P010400,P012788,0 days 00:04:24,6,10,4
185,IST,P006590,PLHK,0 days 00:03:59,-3,4,7
185,IST,P007200,P012710,0 days 00:03:10,-1,4,5
185,IST,P012710,PLHK,0 days 00:03:10,-1,4,5
185,IST,P011078,P012710,0 days 00:03:10,-1,4,5
185,IST,P006590,P012710,0 days 00:03:10,-1,4,5
185,IST,P009664,PLHK,0 days 00:02:47,5,9,4
185,IST,P010400,P011078,0 days 00:01:19,-1,2,3
185,IST,P010400,PLHK,0 days 00:00:49,-2,0,2
185,IST,P012788,PLHK,0 days 00:00:49,-2,0,2
185,VIR,P001844,P009549,0 days 00:17:54,-7,34,41
185,VIR,P009549,PBCN,0 days 00:16:54,-2,34,36
185,VIR,P001844,P003048,0 days 00:14:50,-8,29,37
185,VIR,P001133,P003048,0 days 00:14:36,-14,24,38
185,VIR,P001844,PBCN,0 days 00:13:29,0,27,27
185,VIR,P003048,PBCN,0 days 00:13:04,-11,24,35
185,VIR,P003048,P010781,0 days 00:12:54,-17,18,35
185,VIR,P001844,P002084,0 days 00:12:40,-1,23,24
185,VIR,P003048,P009549,0 days 00:12:30,-11,25,36
185,VIR,P003527,P010781,0 days 00:11:54,-20,17,37
185,VIR,P003048,P003527,0 days 00:11:35,-11,20,31
185,VIR,P001844,P010781,0 days 00:10:08,-4,16,20
185,VIR,P003048,P006739,0 days 00:09:49,-14,15,29
185,VIR,P001133,P006739,0 days 00:09:49,-14,15,29
185,VIR,P001133,PBCN,0 days 00:09:47,-3,22,25
185,VIR,P002084,P009549,0 days 00:09:44,-3,18,21
185,VIR,P001844,P003527,0 days 00:09:41,-6,20,26
185,VIR,P001844,P008847,0 days 00:09:38,2,21,19
185,VIR,P002084,PBCN,0 days 00:08:44,-2,16,18
185,VIR,P005553,P008847,0 days 00:08:32,-4,21,25
185,VIR,P001844,P004554,0 days 00:08:13,-3,13,16
185,VIR,P002084,P010781,0 days 00:08:00,-2,16,18
185,VIR,P001133,P010781,0 days 00:07:49,-15,8,23
185,VIR,P004554,P009549,0 days 00:07:23,0,11,11
185,VIR,P002084,P008847,0 days 00:07:08,1,18,17
185,VIR,P006739,PBCN,0 days 00:07:05,-6,13,19
185,VIR,P001133,P009549,0 days 00:06:37,1,16,15
185,VIR,P004554,PBCN,0 days 00:06:23,0,11,11
185,VIR,P006739,P010781,0 days 00:06:07,-10,10,20
185,VIR,P008847,P010781,0 days 00:06:01,-4,13,17
185,VIR,P003527,P005553,0 days 00:05:51,-8,15,23
185,VIR,P003527,P008847,0 days 00:05:41,-8,15,23
185,VIR,P008847,P009549,0 days 00:05:40,3,9,6
185,VIR,P001844,P005553,0 days 00:05:08,-1,12,13
185,VIR,P001133,P003527,0 days 00:04:49,-11,2,13
185,VIR,P001133,P001844,0 days 00:04:47,0,9,9
185,VIR,P002084,P003048,0 days 00:04:46,-6,5,11
185,VIR,P009549,P010781,0 days 00:04:36,-5,9,14
185,VIR,P006739,P009549,0 days 00:04:36,0,9,9
185,VIR,P002084,P005553,0 days 00:04:31,-3,11,14
185,VIR,P005553,P010781,0 days 00:04:31,-3,11,14
185,VIR,P002084,P004554,0 days 00:04:20,1,9,8
185,VIR,P002084,P003527,0 days 00:04:09,-5,8,13
185,VIR,P004554,P008847,0 days 00:03:53,-4,4,8
185,VIR,P010781,PBCN,0 days 00:03:40,-4,6,10
185,VIR,P008847,PBCN,0 days 00:03:10,4,7,3
185,VIR,P003527,P009549,0 days 00:03:06,-4,7,11
185,VIR,P003527,P006739,0 days 00:02:44,-8,2,10
185,VIR,P003048,P005553,0 days 00:02:21,2,8,6
185,VIR,P003048,P008847,0 days 00:02:11,2,8,6
185,VIR,P004554,P005553,0 days 00:01:50,-3,2,5
185,VIR,P005553,P009549,0 days 00:01:00,0,0,0
185,VIR,P002084,P006739,0 days 00:00:54,4,4,0
185,VIR,P005553,P006739,0 days 00:00:54,4,4,0
185,VIR,P006739,P008847,0 days 00:00:54,4,4,0
185,VIR,P003527,P004554,0 days 00:00:50,-3,2,5
185,VIR,P001133,P005553,0 days 00:00:10,0,0,0
186,ASV,P011225,P012080,0 days 00:27:24,-18,48,66
186,ASV,P006568,P011225,0 days 00:19:08,-16,33,49
186,ASV,P006568,P012080,0 days 00:19:08,-16,33,49
186,ASV,P004194,PKIR,0 days 00:17:10,-6,25,31
186,ASV,P011225,P012729,0 days 00:16:39,-23,21,44
186,ASV,P012731,PKIR,0 days 00:16:23,7,29,22
186,ASV,P012080,P012729,0 days 00:16:08,-23,21,44
186,ASV,P011225,PKIR,0 days 00:16:07,0,34,34
186,ASV,P004194,P012731,0 days 00:15:54,-4,25,29
186,ASV,P000229,P004194,0 days 00:14:19,-7,18,25
186,ASV,P012080,PKIR,0 days 00:13:51,-1,31,32
186,ASV,P004194,P011225,0 days 00:13:41,-4,25,29
186,ASV,P004194,P012080,0 days 00:13:22,-8,26,34
186,ASV,P006568,P012729,0 days 00:12:36,-21,16,37
186,ASV,P000229,P012731,0 days 00:10:44,-4,15,19
186,ASV,P003526,P011225,0 days 00:10:22,-14,12,26
186,ASV,P003526,P006568,0 days 00:10:22,-14,12,26
186,ASV,P003526,P012080,0 days 00:10:22,-14,12,26
186,ASV,P004194,P011386,0 days 00:10:20,-8,12,20
186,ASV,P000229,P011386,0 days 00:10:20,-8,12,20
186,ASV,P012080,P012731,0 days 00:10:04,5,24,19
186,ASV,P011225,P012731,0 days 00:09:52,9,23,14
186,ASV,P011386,P012731,0 days 00:09:25,-5,12,17
186,ASV,P000229,PKIR,0 days 00:09:16,-4,9,13
186,ASV,P003526,P012729,0 days 00:08:34,-11,9,20
186,ASV,P006568,PKIR,0 days 00:07:18,1,19,18
186,ASV,P011386,PKIR,0 days 00:07:00,-5,6,11
186,ASV,P000229,P011225,0 days 00:05:27,-2,8,10
186,ASV,P012729,PKIR,0 days 00:05:23,-12,7,19
186,ASV,P000229,P012080,0 days 00:05:08,-6,9,15
186,ASV,P000229,P012729,0 days 00:05:03,-6,5,11
186,ASV,P004194,P012729,0 days 00:04:58,-5,5,10
186,ASV,P006568,P012731,0 days 00:03:23,8,10,2
186,ASV,P003526,P004194,0 days 00:03:11,-3,5,8
186,ASV,P004194,P006568,0 days 00:03:09,-3,7,10
186,ASV,P011386,P012080,0 days 00:01:57,-3,4,7
186,ASV,P000229,P006568,0 days 00:01:28,-3,2,5
186,ASV,P000229,P003526,0 days 00:01:23,0,2,2
186,ASV,P003526,P011386,0 days 00:01:23,0,2,2
186,ASV,P003526,P012731,0 days 00:01:23,0,2,2
186,ASV,P011386,P012729,0 days 00:00:55,-3,0,3
186,BER,P008967,P012720,0 days 00:20:00,11,46,35
186,BER,P006251,P008384,0 days 00:16:25,8,31,23
186,BER,P010791,P012720,0 days 00:16:15,18,44,26
186,BER,P011934,P012720,0 days 00:14:30,9,33,24
186,BER,P006251,P012721,0 days 00:13:56,8,27,19
186,BER,P008384,P012721,0 days 00:13:56,8,27,19
186,BER,P008967,P011934,0 days 00:13:46,12,34,22
186,BER,P003958,P008384,0 days 00:13:35,16,34,18
186,BER,P008967,P010791,0 days 00:13:34,15,36,21
186,BER,P003958,P008211,0 days 00:13:10,9,28,19
186,BER,P008173,P008384,0 days 00:12:55,13,30,17
186,BER,P003958,P012720,0 days 00:12:54,2,26,24
186,BER,P008173,P011934,0 days 00:12:40,5,24,19
186,BER,P008211,P012720,0 days 00:12:20,10,31,21
186,BER,P008211,P008967,0 days 00:12:04,10,31,21
186,BER,P008173,P012720,0 days 00:11:59,4,25,21
186,BER,P003958,P006251,0 days 00:11:38,8,25,17
186,BER,P003958,P008967,0 days 00:10:51,2,21,19
186,BER,P003958,P008173,0 days 00:10:38,6,24,18
186,BER,P003958,P012721,0 days 00:10:16,10,23,13
186,BER,P006251,P008211,0 days 00:10:10,0,19,19
186,BER,P006251,P008173,0 days 00:09:36,7,19,12
186,BER,P008173,P010791,0 days 00:08:48,10,23,13
186,BER,P008173,P008967,0 days 00:08:34,4,18,14
186,BER,P008173,P012721,0 days 00:08:14,7,17,10
186,BER,P003958,P010791,0 days 00:08:11,7,21,14
186,BER,P010791,P011934,0 days 00:08:04,11,23,12
186,BER,P008211,P010791,0 days 00:07:27,8,21,13
186,BER,P008211,P008384,0 days 00:06:49,1,12,11
186,BER,P006251,P011934,0 days 00:06:45,-1,11,12
186,BER,P008211,P011934,0 days 00:06:08,5,16,11
186,BER,P008211,P012721,0 days 00:05:42,1,10,9
186,BER,P008384,P011934,0 days 00:05:40,1,9,8
186,BER,P006251,P012720,0 days 00:04:43,-1,9,10
186,BER,P008384,P012720,0 days 00:04:03,3,10,7
186,BER,P003958,P011934,0 days 00:03:59,0,6,6
186,BER,P011934,P012721,0 days 00:03:40,-2,4,6
186,BER,P006251,P008967,0 days 00:03:05,-1,7,8
186,BER,P008384,P010791,0 days 00:02:41,3,8,5
186,BER,P006251,P006819,0 days 00:01:23,0,2,2
186,BER,P006251,P007025,0 days 00:01:23,0,2,2
186,BER,P006819,P007025,0 days 00:01:23,0,2,2
186,BER,P006819,P008211,0 days 00:01:23,0,2,2
186,BER,P007025,P008211,0 days 00:01:23,0,2,2
186,BER,P006819,P008384,0 days 00:01:07,0,2,2
186,BER,P007025,P008384,0 days 00:01:07,0,2,2
186,BER,P008384,P008967,0 days 00:00:38,3,3,0
186,BER,P006819,P012720,0 days 00:00:16,0,0,0
186,BER,P007025,P012720,0 days 00:00:16,0,0,0
187,BAR,P004866,P012745,0 days 00:21:55,23,59,36
187,BAR,P004866,P009992,0 days 00:21:39,24,57,33
187,BAR,P009992,P012745,0 days 00:20:25,28,56,28
187,BAR,P002939,P012745,0 days 00:20:08,21,51,30
187,BAR,P002939,P004866,0 days 00:19:37,10,44,34
187,BAR,P003196,P009992,0 days 00:19:26,16,46,30
187,BAR,P003196,P004866,0 days 00:17:05,12,41,29
187,BAR,P000925,P002939,0 days 00:16:09,5,37,32
187,BAR,P002939,P009992,0 days 00:14:52,18,39,21
187,BAR,P000925,P012745,0 days 00:13:51,14,35,21
187,BAR,P002939,P007464,0 days 00:13:22,-10,23,33
187,BAR,P007519,P009992,0 days 00:13:02,12,32,20
187,BAR,P003196,P007519,0 days 00:13:02,12,32,20
187,BAR,P003196,P012745,0 days 00:11:57,14,31,17
187,BAR,P000925,P007464,0 days 00:10:24,-4,21,25
187,BAR,P000925,P004866,0 days 00:10:22,9,26,17
187,BAR,P007464,P012745,0 days 00:09:20,5,19,14
187,BAR,P004866,P007519,0 days 00:08:40,11,25,14
187,BAR,P007519,P011244,0 days 00:08:37,-3,17,20
187,BAR,P003196,P011244,0 days 00:08:33,2,17,15
187,BAR,P002939,P003196,0 days 00:08:25,1,16,15
187,BAR,P000925,P009992,0 days 00:07:38,14,23,9
187,BAR,P004866,P007464,0 days 00:07:35,-6,12,18
187,BAR,P007464,P011244,0 days 00:07:27,-11,11,22
187,BAR,P009992,P011244,0 days 00:07:22,5,17,12
187,BAR,P003196,P007464,0 days 00:07:20,-5,9,14
187,BAR,P007464,P009992,0 days 00:07:12,3,14,11
187,BAR,P007519,P012745,0 days 00:07:09,7,17,10
187,BAR,P007464,P007519,0 days 00:07:06,-7,9,16
187,BAR,P004866,P011244,0 days 00:06:15,1,12,11
187,BAR,P002939,P011244,0 days 00:05:09,-12,6,18
187,BAR,P000925,P011244,0 days 00:03:52,-9,6,15
187,BAR,P000925,P007519,0 days 00:02:44,-8,2,10
187,BAR,P002939,P007519,0 days 00:02:44,-8,2,10
187,BAR,P000925,P003204,0 days 00:02:44,-1,6,7
187,BAR,P003204,P011244,0 days 00:01:47,-1,4,5
187,BAR,P011244,P011666,0 days 00:01:34,0,4,4
187,BAR,P011666,P012197,0 days 00:01:34,0,4,4
187,BAR,P011244,P012197,0 days 00:01:34,0,4,4
187,BAR,P003204,P011666,0 days 00:01:34,0,4,4
187,BAR,P003204,P012197,0 days 00:01:34,0,4,4
187,BAR,P000925,P012197,0 days 00:01:34,0,4,4
187,BAR,P000925,P011666,0 days 00:01:34,0,4,4
187,BAR,P002939,P003204,0 days 00:01:10,-1,2,3
187,BAR,P003204,P007464,0 days 00:01:10,-1,2,3
187,BAR,P003204,P012745,0 days 00:00:57,0,2,2
187,BAR,P011244,P012745,0 days 00:00:50,0,2,2
187,ZAL,P002329,P005504,0 days 00:24:53,-2,52,54
187,ZAL,P002329,P011218,0 days 00:22:59,4,43,39
187,ZAL,P002329,P012787,0 days 00:21:59,-1,45,46
187,ZAL,P005504,P012787,0 days 00:21:59,-1,45,46
187,ZAL,P011218,P012787,0 days 00:20:25,10,45,35
187,ZAL,P005504,P011218,0 days 00:20:03,6,43,37
187,ZAL,P012715,P012787,0 days 00:17:41,12,45,33
187,ZAL,P005504,P012715,0 days 00:16:58,10,45,35
187,ZAL,P002329,P012715,0 days 00:16:40,8,40,32
187,ZAL,P011218,P012715,0 days 00:16:19,14,41,27
187,ZAL,P003211,P007109,0 days 00:14:27,-25,14,39
187,ZAL,P002329,P007109,0 days 00:12:55,-19,9,28
187,ZAL,P003210,P007109,0 days 00:10:58,-8,20,28
187,ZAL,P003210,P003211,0 days 00:10:45,-13,18,31
187,ZAL,P005504,P007109,0 days 00:10:16,-17,14,31
187,ZAL,P003211,P012715,0 days 00:09:39,-11,15,26
187,ZAL,P003211,P009917,0 days 00:09:24,-14,11,25
187,ZAL,P007109,P009917,0 days 00:09:11,-12,9,21
187,ZAL,P007109,P011218,0 days 00:08:23,-11,3,14
187,ZAL,P003210,P012715,0 days 00:07:45,-8,14,22
187,ZAL,P007109,P012715,0 days 00:07:15,-11,8,19
187,ZAL,P003211,P010390,0 days 00:06:24,-8,13,21
187,ZAL,P002329,P003211,0 days 00:06:11,-15,0,15
187,ZAL,P007109,P012787,0 days 00:05:54,-16,2,18
187,ZAL,P003210,P009917,0 days 00:05:48,-7,10,17
187,ZAL,P003210,P005504,0 days 00:05:23,-3,14,17
187,ZAL,P003210,P010390,0 days 00:05:14,-7,11,18
187,ZAL,P009917,P012715,0 days 00:04:50,-7,5,12
187,ZAL,P002329,P003210,0 days 00:04:36,-1,9,10
187,ZAL,P003211,P011218,0 days 00:04:16,-2,3,5
187,ZAL,P007109,P010390,0 days 00:04:00,-8,6,14
187,ZAL,P003211,P005504,0 days 00:03:32,-13,5,18
187,ZAL,P003211,P012787,0 days 00:03:26,-7,5,12
187,ZAL,P009917,P011218,0 days 00:03:26,1,4,3
187,ZAL,P002329,P009917,0 days 00:03:18,-1,3,4
187,ZAL,P009917,P010390,0 days 00:02:59,-8,8,16
187,ZAL,P003210,P012787,0 days 00:02:50,-4,5,9
187,ZAL,P010390,P012715,0 days 00:02:49,-3,7,10
187,ZAL,P010390,P012787,0 days 00:02:21,0,5,5
187,ZAL,P007109,P007513,0 days 00:02:05,3,7,4
187,ZAL,P005504,P007513,0 days 00:02:05,3,7,4
187,ZAL,P002329,P007513,0 days 00:02:05,3,7,4
187,ZAL,P003210,P007513,0 days 00:02:05,3,7,4
187,ZAL,P002329,P010390,0 days 00:01:04,0,0,0
187,ZAL,P005504,P009917,0 days 00:00:55,1,3,2
187,ZAL,P009917,P012787,0 days 00:00:45,3,3,0
187,ZAL,P010390,P011218,0 days 00:00:45,2,2,0
188,BAS,P009048,P012201,0 days 00:25:09,13,59,46
188,BAS,P009048,P011948,0 days 00:22:42,12,54,42
188,BAS,P011948,P012201,0 days 00:20:54,17,54,37
188,BAS,P004603,P004761,0 days 00:19:16,-5,28,33
188,BAS,P004603,P009048,0 days 00:19:01,7,41,34
188,BAS,P004603,P012201,0 days 00:18:50,7,41,34
188,BAS,P004603,P007230,0 days 00:18:25,3,31,28
188,BAS,P003198,P004603,0 days 00:17:03,9,34,25
188,BAS,P004603,P011948,0 days 00:14:52,11,36,25
188,BAS,P003198,P007230,0 days 00:14:51,-2,21,23
188,BAS,P004761,P007230,0 days 00:13:09,3,21,18
188,BAS,P004761,P012765,0 days 00:13:03,3,21,18
188,BAS,P003198,P004761,0 days 00:13:03,3,21,18
188,BAS,P004603,P012765,0 days 00:13:03,3,21,18
188,BAS,P003198,P012765,0 days 00:13:03,3,21,18
188,BAS,P007230,P012765,0 days 00:13:03,3,21,18
188,BAS,P011085,P012201,0 days 00:09:54,4,19,15
188,BAS,P009048,P011085,0 days 00:09:54,4,19,15
188,BAS,P004761,P012201,0 days 00:08:24,-7,12,19
188,BAS,P004761,P009048,0 days 00:08:24,-7,12,19
188,BAS,P009048,P010444,0 days 00:07:50,1,18,17
188,BAS,P010444,P011948,0 days 00:07:50,1,18,17
188,BAS,P004603,P011085,0 days 00:07:46,5,16,11
188,BAS,P003198,P009048,0 days 00:07:37,7,23,16
188,BAS,P003198,P011948,0 days 00:07:37,7,23,16
188,BAS,P007230,P009048,0 days 00:07:05,-5,10,15
188,BAS,P007230,P011948,0 days 00:06:59,-5,10,15
188,BAS,P010444,P012201,0 days 00:06:13,6,18,12
188,BAS,P003198,P012201,0 days 00:05:49,12,23,11
188,BAS,P011085,P011948,0 days 00:05:45,8,14,6
188,BAS,P007230,P012201,0 days 00:05:17,0,10,10
188,BAS,P004761,P011948,0 days 00:04:09,-3,7,10
188,BAS,P004761,P011085,0 days 00:04:09,-4,5,9
188,BAS,P003198,P010444,0 days 00:03:37,1,10,9
188,BAS,P010444,P011085,0 days 00:02:08,-1,3,4
188,BAS,P004761,P010444,0 days 00:02:05,1,5,4
188,BAS,P007230,P010444,0 days 00:01:37,-5,0,5
188,BAS,P004761,P008850,0 days 00:00:06,0,0,0
188,BAS,P007230,P008850,0 days 00:00:06,0,0,0
188,BAS,P008850,P009048,0 days 00:00:06,0,0,0
188,BAS,P008850,P012201,0 days 00:00:06,0,0,0
188,OLY,P003941,P007982,0 days 00:22:58,2,44,42
188,OLY,P007982,P010612,0 days 00:22:45,2,49,47
188,OLY,P008829,P010612,0 days 00:22:06,-9,38,47
188,OLY,P007982,P011194,0 days 00:18:00,-2,31,33
188,OLY,P003941,P011194,0 days 00:16:46,2,31,29
188,OLY,P001255,P010612,0 days 00:16:37,-4,25,29
188,OLY,P001255,P008829,0 days 00:16:26,-4,25,29
188,OLY,P008811,P010612,0 days 00:15:22,-11,25,36
188,OLY,P007982,P008829,0 days 00:15:00,-3,32,35
188,OLY,P003941,P010612,0 days 00:14:23,7,30,23
188,OLY,P008811,P008829,0 days 00:14:14,-7,25,32
188,OLY,P008855,P010612,0 days 00:11:15,-3,16,19
188,OLY,P007982,P008811,0 days 00:09:50,-7,19,26
188,OLY,P007982,P010392,0 days 00:09:33,-5,18,23
188,OLY,P010392,P011194,0 days 00:09:33,-5,18,23
188,OLY,P001255,P007982,0 days 00:09:31,2,19,17
188,OLY,P003941,P010392,0 days 00:09:27,-5,18,23
188,OLY,P007982,P011983,0 days 00:09:02,1,14,13
188,OLY,P011194,P011983,0 days 00:09:02,1,14,13
188,OLY,P003941,P011983,0 days 00:09:02,1,14,13
188,OLY,P007853,P007982,0 days 00:09:01,-13,13,26
188,OLY,P001255,P008811,0 days 00:08:40,-2,12,14
188,OLY,P008829,P008855,0 days 00:08:37,-5,10,15
188,OLY,P008811,P008855,0 days 00:08:11,-7,10,17
188,OLY,P001255,P003941,0 days 00:07:57,-2,13,15
188,OLY,P010612,P011194,0 days 00:07:51,5,17,12
188,OLY,P003941,P008829,0 days 00:07:46,-2,13,15
188,OLY,P001255,P008855,0 days 00:07:06,-6,6,12
188,OLY,P007982,P008855,0 days 00:05:56,3,13,10
188,OLY,P010392,P010612,0 days 00:05:02,3,11,8
188,OLY,P003941,P007853,0 days 00:04:58,-7,4,11
188,OLY,P007853,P011194,0 days 00:04:58,-7,4,11
188,OLY,P003941,P008855,0 days 00:04:51,4,9,5
188,OLY,P008855,P011194,0 days 00:04:25,2,9,7
188,OLY,P007853,P008811,0 days 00:04:03,-6,9,15
188,OLY,P007853,P010612,0 days 00:04:03,-6,9,15
188,OLY,P007853,P008829,0 days 00:04:03,-6,9,15
188,OLY,P007853,P011983,0 days 00:03:51,1,4,3
188,OLY,P010392,P011983,0 days 00:03:24,0,7,7
188,OLY,P008855,P011983,0 days 00:01:47,0,3,3
188,OLY,P008811,P011194,0 days 00:01:08,-4,0,4
188,OLY,P007853,P010392,0 days 00:01:07,-8,0,8
188,OLY,P001255,P011194,0 days 00:00:11,0,0,0
188,OLY,P008829,P010392,0 days 00:00:06,0,0,0
188,OLY,P008829,P011194,0 days 00:00:06,0,0,0
189,PAR,P007673,P008987,0 days 00:23:09,7,48,41
189,PAR,P007400,P012096,0 days 00:20:37,19,56,37
189,PAR,P008987,P009862,0 days 00:18:41,-10,32,42
189,PAR,P007673,P012096,0 days 00:18:24,4,41,37
189,PAR,P007400,P008987,0 days 00:17:28,7,43,36
189,PAR,P004058,P007400,0 days 00:17:01,24,52,28
189,PAR,P008987,P012742,0 days 00:16:12,-4,29,33
189,PAR,P004058,P007673,0 days 00:16:10,24,49,25
189,PAR,P011051,P012742,0 days 00:16:07,1,34,33
189,PAR,P007400,P012742,0 days 00:15:45,0,33,33
189,PAR,P008987,P012096,0 days 00:15:27,0,32,32
189,PAR,P009862,P011051,0 days 00:14:46,1,31,30
189,PAR,P008987,P011051,0 days 00:14:45,3,32,29
189,PAR,P009862,P012742,0 days 00:14:44,-5,28,33
189,PAR,P007400,P007673,0 days 00:14:37,15,41,26
189,PAR,P004058,P012096,0 days 00:14:34,24,47,23
189,PAR,P004058,P008987,0 days 00:13:34,22,40,18
189,PAR,P007673,P009862,0 days 00:13:14,-4,21,25
189,PAR,P007400,P011051,0 days 00:12:58,-2,25,27
189,PAR,P007673,P011051,0 days 00:11:10,9,25,16
189,PAR,P012096,P012742,0 days 00:10:33,4,22,18
189,PAR,P007673,P012742,0 days 00:10:25,5,20,15
189,PAR,P004058,P011051,0 days 00:09:41,12,23,11
189,PAR,P009862,P012096,0 days 00:08:21,-15,9,24
189,PAR,P007400,P009862,0 days 00:07:55,-8,15,23
189,PAR,P011051,P012096,0 days 00:06:49,4,14,10
189,PAR,P004058,P012742,0 days 00:06:30,11,18,7
189,PAR,P007673,P011192,0 days 00:03:32,-13,0,13
189,PAR,P011192,P012096,0 days 00:03:32,-13,0,13
189,PAR,P009862,P011192,0 days 00:03:32,-13,0,13
189,PAR,P008987,P011192,0 days 00:03:32,-13,0,13
189,PAR,P004058,P009862,0 days 00:03:23,6,8,2
189,PAR,P004058,P004172,0 days 00:00:43,-3,3,6
189,PAR,P004172,P007400,0 days 00:00:43,-3,3,6
189,PAR,P004172,P007673,0 days 00:00:43,-3,3,6
189,PAR,P004172,P012096,0 days 00:00:43,-3,3,6
189,TEL,P009622,P009863,0 days 00:24:39,-3,43,46
189,TEL,P009783,P009863,0 days 00:23:16,-4,42,46
189,TEL,P009622,P011219,0 days 00:20:17,1,35,34
189,TEL,P009622,P009783,0 days 00:20:13,-4,33,37
189,TEL,P009863,P011199,0 days 00:19:39,-1,35,36
189,TEL,P009783,P011199,0 days 00:19:16,-2,36,38
189,TEL,P009863,P011219,0 days 00:19:11,7,36,29
189,TEL,P009622,P011199,0 days 00:17:31,-2,29,31
189,TEL,P009783,P011219,0 days 00:17:06,5,36,31
189,TEL,P011193,P011214,0 days 00:13:45,-2,35,37
189,TEL,P011199,P011219,0 days 00:13:09,9,28,19
189,TEL,P009622,P011971,0 days 00:12:21,-14,18,32
189,TEL,P009863,P011971,0 days 00:11:29,-7,20,27
189,TEL,P009783,P011971,0 days 00:09:24,-10,12,22
189,TEL,P011193,P011971,0 days 00:09:21,7,30,23
189,TEL,P007990,P011971,0 days 00:08:47,1,20,19
189,TEL,P011214,P011971,0 days 00:08:47,7,28,21
189,TEL,P007990,P011193,0 days 00:08:15,0,20,20
189,TEL,P007990,P011219,0 days 00:07:44,-11,13,24
189,TEL,P007990,P011214,0 days 00:07:41,0,18,18
189,TEL,P011214,P012744,0 days 00:07:31,7,19,12
189,TEL,P011193,P012744,0 days 00:07:19,7,19,12
189,TEL,P011219,P011971,0 days 00:06:54,-7,10,17
189,TEL,P009783,P011193,0 days 00:06:41,-11,14,25
189,TEL,P011214,P011219,0 days 00:06:37,-16,8,24
189,TEL,P009622,P011193,0 days 00:06:08,-7,14,21
189,TEL,P011193,P011219,0 days 00:06:07,-16,8,24
189,TEL,P007990,P009863,0 days 00:05:47,-7,9,16
189,TEL,P007990,P009783,0 days 00:05:15,-11,11,22
189,TEL,P007990,P012744,0 days 00:05:02,7,14,7
189,TEL,P011199,P011971,0 days 00:04:56,-7,6,13
189,TEL,P011971,P012744,0 days 00:04:53,10,16,6
189,TEL,P009863,P011193,0 days 00:04:48,1,15,14
189,TEL,P009622,P011214,0 days 00:04:28,-3,10,13
189,TEL,P009783,P011214,0 days 00:04:15,-7,8,15
189,TEL,P007990,P009622,0 days 00:03:48,-7,4,11
189,TEL,P011193,P011199,0 days 00:03:32,-3,9,12
189,TEL,P009863,P011214,0 days 00:03:08,5,11,6
189,TEL,P007990,P011199,0 days 00:02:53,0,7,7
189,TEL,P011219,P012744,0 days 00:02:31,-4,2,6
189,TEL,P009622,P012744,0 days 00:02:11,-1,2,3
189,TEL,P009863,P012744,0 days 00:01:19,1,1,0
189,TEL,P011199,P011214,0 days 00:00:48,1,3,2
189,TEL,P011199,P012744,0 days 00:00:48,1,3,2
189,TEL,P009783,P012744,0 days 00:00:30,0,0,0
190,BER,P003958,P012720,0 days 00:22:34,7,48,41
190,BER,P008173,P011934,0 days 00:22:24,9,48,39
190,BER,P008173,P012720,0 days 00:22:19,6,45,39
190,BER,P011934,P012720,0 days 00:21:55,7,45,38
190,BER,P003958,P008173,0 days 00:21:18,9,46,37
190,BER,P003958,P011934,0 days 00:21:18,9,46,37
190,BER,P008173,P012721,0 days 00:15:10,-1,26,27
190,BER,P011934,P012721,0 days 00:14:00,-1,26,27
190,BER,P012720,P012721,0 days 00:14:00,-1,26,27
190,BER,P008967,P012720,0 days 00:13:46,1,26,25
190,BER,P008780,P010791,0 days 00:13:26,-19,17,36
190,BER,P003958,P012721,0 days 00:13:03,-1,24,25
190,BER,P003958,P008967,0 days 00:12:54,4,27,23
190,BER,P008173,P008967,0 days 00:12:44,3,24,21
190,BER,P008967,P010791,0 days 00:11:52,-18,11,29
190,BER,P008967,P011934,0 days 00:11:14,6,24,18
190,BER,P008384,P010791,0 days 00:10:57,-18,10,28
190,BER,P008780,P008967,0 days 00:10:22,-15,11,26
190,BER,P008384,P008780,0 days 00:08:55,-16,10,26
190,BER,P010791,P012721,0 days 00:07:52,-9,8,17
190,BER,P008384,P008967,0 days 00:07:26,-12,7,19
190,BER,P008780,P012721,0 days 00:06:42,-9,8,17
190,BER,P006251,P008967,0 days 00:06:15,-13,4,17
190,BER,P006251,P010791,0 days 00:06:15,-13,4,17
190,BER,P008384,P012721,0 days 00:05:58,-8,6,14
190,BER,P008211,P012721,0 days 00:05:45,-5,8,13
190,BER,P008211,P010791,0 days 00:05:45,-5,8,13
190,BER,P006251,P008780,0 days 00:04:59,-10,4,14
190,BER,P006251,P008384,0 days 00:04:59,-10,4,14
190,BER,P008967,P012721,0 days 00:04:58,-5,4,9
190,BER,P008211,P008384,0 days 00:04:52,-6,6,12
190,BER,P008211,P008780,0 days 00:04:49,-5,8,13
190,BER,P010791,P012720,0 days 00:03:53,-5,5,10
190,BER,P003958,P008780,0 days 00:03:38,-4,5,9
190,BER,P003958,P010791,0 days 00:03:38,-4,5,9
190,BER,P008780,P012720,0 days 00:03:29,-4,5,9
190,BER,P008173,P008384,0 days 00:03:23,-2,3,5
190,BER,P008173,P010791,0 days 00:03:18,-5,0,5
190,BER,P003958,P008384,0 days 00:01:21,0,3,3
190,BER,P008384,P011934,0 days 00:01:21,0,3,3
190,BER,P006251,P012720,0 days 00:01:16,-3,0,3
190,BER,P006251,P008173,0 days 00:01:16,-3,0,3
190,BER,P008173,P008211,0 days 00:00:56,0,0,0
190,BER,P008211,P008967,0 days 00:00:53,1,2,1
190,BER,P008780,P011934,0 days 00:00:52,-2,0,2
190,MUN,P008985,P011987,0 days 00:21:21,-10,36,46
190,MUN,P007056,P011987,0 days 00:20:27,-8,36,44
190,MUN,P003583,P008985,0 days 00:20:14,-12,32,44
190,MUN,P003583,P007056,0 days 00:19:38,-11,32,43
190,MUN,P007056,P008985,0 days 00:18:54,-13,29,42
190,MUN,P003583,P011987,0 days 00:18:21,-13,29,42
190,MUN,P004508,P007975,0 days 00:14:40,21,36,15
190,MUN,P001288,P004508,0 days 00:14:20,19,33,14
190,MUN,P007639,P007975,0 days 00:14:19,24,38,14
190,MUN,P001288,P007975,0 days 00:12:27,18,30,12
190,MUN,P010391,P011987,0 days 00:12:20,-1,25,26
190,MUN,P004508,P007639,0 days 00:12:13,19,31,12
190,MUN,P001288,P007639,0 days 00:10:44,18,28,10
190,MUN,P007639,P010391,0 days 00:10:23,22,30,8
190,MUN,P008985,P010391,0 days 00:10:14,-6,18,24
190,MUN,P007056,P010391,0 days 00:10:04,-2,21,23
190,MUN,P007975,P010391,0 days 00:08:44,19,26,7
190,MUN,P003583,P010391,0 days 00:08:35,-9,14,23
190,MUN,P001557,P007639,0 days 00:08:05,7,19,12
190,MUN,P001557,P007975,0 days 00:07:27,9,17,8
190,MUN,P001557,P004508,0 days 00:07:27,9,17,8
190,MUN,P004508,P010391,0 days 00:06:38,14,19,5
190,MUN,P006760,P011987,0 days 00:06:11,-10,4,14
190,MUN,P006760,P008985,0 days 00:06:11,-10,4,14
190,MUN,P006760,P007056,0 days 00:06:11,-10,4,14
190,MUN,P003583,P006760,0 days 00:06:11,-10,4,14
190,MUN,P001288,P001557,0 days 00:05:58,8,14,6
190,MUN,P001288,P003583,0 days 00:05:33,8,15,7
190,MUN,P007639,P011987,0 days 00:05:06,8,14,6
190,MUN,P001557,P008985,0 days 00:04:43,-1,8,9
190,MUN,P001557,P011987,0 days 00:04:43,-1,8,9
190,MUN,P001288,P010391,0 days 00:04:25,11,13,2
190,MUN,P003583,P004508,0 days 00:04:20,3,8,5
190,MUN,P001557,P003583,0 days 00:04:05,1,6,5
190,MUN,P001288,P008985,0 days 00:03:50,8,13,5
190,MUN,P007056,P007975,0 days 00:03:43,6,11,5
190,MUN,P001288,P007056,0 days 00:03:23,6,11,5
190,MUN,P001557,P010391,0 days 00:03:13,1,7,6
190,MUN,P007639,P008985,0 days 00:03:00,3,7,4
190,MUN,P007056,P007639,0 days 00:02:59,4,8,4
190,MUN,P001557,P007056,0 days 00:02:59,-1,4,5
190,MUN,P006543,P008985,0 days 00:02:36,4,6,2
190,MUN,P001288,P006543,0 days 00:02:31,1,5,4
190,MUN,P004508,P006543,0 days 00:02:31,1,5,4
190,MUN,P003583,P007975,0 days 00:02:27,2,5,3
190,MUN,P006543,P007639,0 days 00:02:27,3,5,2
190,MUN,P004508,P007056,0 days 00:02:10,1,4,3
190,MUN,P007975,P011987,0 days 00:02:06,5,7,2
190,MUN,P001288,P011987,0 days 00:01:57,7,10,3
190,MUN,P004508,P008985,0 days 00:01:53,1,3,2
190,MUN,P003583,P006543,0 days 00:01:20,1,3,2
190,MUN,P006543,P010391,0 days 00:01:16,3,3,0
190,MUN,P006543,P011987,0 days 00:01:16,3,3,0
190,MUN,P006543,P007975,0 days 00:01:11,0,2,2
191,RED,P006436,P009035,0 days 00:29:46,-8,62,70
191,RED,P006436,P012044,0 days 00:25:38,10,61,51
191,RED,P002553,P006436,0 days 00:23:19,2,53,51
191,RED,P002553,P012044,0 days 00:22:28,10,56,46
191,RED,P009035,P012044,0 days 00:20:38,9,50,41
191,RED,P012044,PLUO,0 days 00:20:02,7,54,47
191,RED,P002553,PLUO,0 days 00:19:48,7,51,44
191,RED,P006436,PLUO,0 days 00:19:37,3,50,47
191,RED,P002553,P009035,0 days 00:18:19,1,42,41
191,RED,P005099,P007960,0 days 00:16:02,-7,30,37
191,RED,P009035,PLUO,0 days 00:15:57,4,41,37
191,RED,P005099,P009035,0 days 00:14:37,-7,24,31
191,RED,P005099,P012801,0 days 00:13:57,-15,25,40
191,RED,P009035,P012801,0 days 00:13:49,-4,30,34
191,RED,P005099,P006436,0 days 00:13:17,-9,22,31
191,RED,P007960,P009035,0 days 00:12:58,-3,23,26
191,RED,P007960,P012801,0 days 00:12:41,-11,24,35
191,RED,P006436,P012801,0 days 00:12:04,-10,24,34
191,RED,P006436,P007960,0 days 00:11:38,-5,21,26
191,RED,P011941,PLUO,0 days 00:08:29,1,22,21
191,RED,P002553,P011941,0 days 00:05:25,5,15,10
191,RED,P006436,P011941,0 days 00:05:25,5,15,10
191,RED,P011941,P012044,0 days 00:05:25,5,15,10
191,RED,P012801,PLUO,0 days 00:05:03,2,16,14
191,RED,P005099,PLUO,0 days 00:04:24,-2,9,11
191,RED,P007960,PLUO,0 days 00:04:24,-2,9,11
191,RED,P002553,P012801,0 days 00:03:58,3,10,7
191,RED,P005099,P012044,0 days 00:03:44,4,6,2
191,RED,P007960,P012044,0 days 00:03:21,4,6,2
191,RED,P005099,P011941,0 days 00:03:04,-4,7,11
191,RED,P011941,P012801,0 days 00:03:04,-4,7,11
191,RED,P007960,P011941,0 days 00:03:04,-4,7,11
191,RED,P012044,P012801,0 days 00:02:56,7,12,5
191,RED,P002553,P005099,0 days 00:01:39,-4,1,5
191,BAS,P009048,P010444,0 days 00:28:28,18,67,49
191,BAS,P010444,P012201,0 days 00:27:21,16,65,49
191,BAS,P009048,P012201,0 days 00:26:07,14,64,50
191,BAS,P004761,P009048,0 days 00:24:47,6,60,54
191,BAS,P004761,P010444,0 days 00:22:42,14,53,39
191,BAS,P004761,P012201,0 days 00:20:21,10,50,40
191,BAS,P009048,P011948,0 days 00:19:47,7,47,40
191,BAS,P004761,P011948,0 days 00:19:37,8,49,41
191,BAS,P011948,P012201,0 days 00:19:33,10,45,35
191,BAS,P010444,P011948,0 days 00:18:09,15,43,28
191,BAS,P007230,P009048,0 days 00:16:16,-16,32,48
191,BAS,P004761,P007230,0 days 00:14:43,-17,32,49
191,BAS,P007230,P010444,0 days 00:14:11,-8,25,33
191,BAS,P007230,P012201,0 days 00:11:50,-12,22,34
191,BAS,P009048,P011085,0 days 00:11:08,2,25,23
191,BAS,P010444,P011085,0 days 00:11:08,2,25,23
191,BAS,P007230,P011948,0 days 00:11:03,-18,20,38
191,BAS,P011085,P012201,0 days 00:10:13,0,22,22
191,BAS,P003198,P012201,0 days 00:07:30,0,19,19
191,BAS,P003198,P011085,0 days 00:07:30,0,19,19
191,BAS,P007230,P011085,0 days 00:05:35,1,10,9
191,BAS,P004761,P011085,0 days 00:05:32,-3,9,12
191,BAS,P003198,P010444,0 days 00:04:13,3,14,11
191,BAS,P003198,P009048,0 days 00:04:13,3,14,11
191,BAS,P008850,P012201,0 days 00:03:44,-3,8,11
191,BAS,P004603,P009048,0 days 00:03:19,-6,8,14
191,BAS,P004603,P011948,0 days 00:03:19,-6,8,14
191,BAS,P004603,P007230,0 days 00:03:19,-6,8,14
191,BAS,P004603,P004761,0 days 00:03:19,-6,8,14
191,BAS,P003198,P004603,0 days 00:03:17,-3,5,8
191,BAS,P003198,P008850,0 days 00:03:17,-3,5,8
191,BAS,P004603,P008850,0 days 00:03:17,-3,5,8
191,BAS,P004603,P011085,0 days 00:03:17,-3,5,8
191,BAS,P004603,P012201,0 days 00:03:17,-3,5,8
191,BAS,P008850,P011085,0 days 00:03:17,-3,5,8
191,BAS,P004761,P008850,0 days 00:00:27,0,3,3
191,BAS,P007230,P008850,0 days 00:00:27,0,3,3
191,BAS,P008850,P009048,0 days 00:00:27,0,3,3
192,VIR,P001844,PBCN,0 days 00:22:06,-4,35,39
192,VIR,P009549,PBCN,0 days 00:21:49,-7,35,42
192,VIR,P008847,P009549,0 days 00:19:52,-4,28,32
192,VIR,P008847,PBCN,0 days 00:19:52,-4,28,32
192,VIR,P003048,P009549,0 days 00:18:11,1,32,31
192,VIR,P003048,PBCN,0 days 00:17:35,-1,30,31
192,VIR,P002084,P006739,0 days 00:17:30,15,39,24
192,VIR,P001844,P008847,0 days 00:17:01,-7,19,26
192,VIR,P001844,P009549,0 days 00:16:15,-8,22,30
192,VIR,P002084,P010781,0 days 00:14:47,11,28,17
192,VIR,P003048,P008847,0 days 00:14:41,2,23,21
192,VIR,P002084,P004554,0 days 00:14:36,15,36,21
192,VIR,P001844,P003048,0 days 00:14:30,-2,21,23
192,VIR,P004554,P010781,0 days 00:13:19,11,28,17
192,VIR,P002084,PBCN,0 days 00:12:04,3,29,26
192,VIR,P001844,P002084,0 days 00:12:03,16,31,15
192,VIR,P001844,P004554,0 days 00:11:45,12,28,16
192,VIR,P006739,P010781,0 days 00:10:56,11,21,10
192,VIR,P004554,P006739,0 days 00:10:45,15,29,14
192,VIR,P001844,P010781,0 days 00:10:21,13,20,7
192,VIR,P006739,PBCN,0 days 00:08:44,7,26,19
192,VIR,P004554,PBCN,0 days 00:08:44,1,18,17
192,VIR,P002084,P009549,0 days 00:07:44,-1,15,16
192,VIR,P006739,P009549,0 days 00:07:35,3,15,12
192,VIR,P001844,P006739,0 days 00:07:16,17,23,6
192,VIR,P010781,PBCN,0 days 00:06:15,2,10,8
192,VIR,P006739,P008847,0 days 00:05:58,3,9,6
192,VIR,P002084,P008847,0 days 00:04:31,0,4,4
192,VIR,P002084,P003527,0 days 00:03:43,-2,5,7
192,VIR,P003048,P006739,0 days 00:03:41,3,11,8
192,VIR,P002084,P003048,0 days 00:03:30,-1,9,10
192,VIR,P003527,P006739,0 days 00:03:23,-2,3,5
192,VIR,P003527,P004554,0 days 00:03:07,-4,3,7
192,VIR,P003527,P010781,0 days 00:03:02,-4,3,7
192,VIR,P008847,P010781,0 days 00:02:59,0,0,0
192,VIR,P004554,P009549,0 days 00:02:17,-5,2,7
192,VIR,P004554,P008847,0 days 00:02:03,-5,0,5
192,VIR,P003527,P009549,0 days 00:01:40,1,5,4
192,VIR,P009549,P010781,0 days 00:01:17,0,2,2
192,VIR,P001844,P003527,0 days 00:00:39,-1,1,2
192,VIR,P003527,P008847,0 days 00:00:39,-1,1,2
192,VIR,P003527,PBCN,0 days 00:00:39,-1,1,2
192,VIR,P003048,P003527,0 days 00:00:36,2,2,0
192,ASV,P011225,P012080,0 days 00:29:07,-6,50,56
192,ASV,P006568,P011225,0 days 00:24:46,1,46,45
192,ASV,P006568,P012080,0 days 00:24:46,1,46,45
192,ASV,P003526,P012080,0 days 00:19:33,2,34,32
192,ASV,P003526,P011225,0 days 00:19:10,2,34,32
192,ASV,P005094,P012080,0 days 00:16:38,-13,28,41
192,ASV,P005094,P011225,0 days 00:16:20,-12,30,42
192,ASV,P003526,P006568,0 days 00:15:42,7,32,25
192,ASV,P005094,P012731,0 days 00:15:02,-9,20,29
192,ASV,P004194,P012731,0 days 00:13:48,-4,18,22
192,ASV,P004194,P005094,0 days 00:12:33,-10,15,25
192,ASV,P005094,P006568,0 days 00:11:53,-2,24,26
192,ASV,P012080,P012731,0 days 00:11:08,-12,16,28
192,ASV,P011225,P012731,0 days 00:10:50,-11,18,29
192,ASV,P006568,P012731,0 days 00:10:35,-7,16,23
192,ASV,P003526,P012729,0 days 00:10:19,3,17,14
192,ASV,P012080,P012729,0 days 00:10:19,3,17,14
192,ASV,P011225,P012729,0 days 00:10:19,3,17,14
192,ASV,P003526,P005094,0 days 00:09:50,-3,17,20
192,ASV,P000229,P004194,0 days 00:09:42,0,13,13
192,ASV,P004194,P011386,0 days 00:09:37,-1,11,12
192,ASV,P006568,P012729,0 days 00:09:32,3,17,14
192,ASV,P000229,P012731,0 days 00:09:09,2,11,9
192,ASV,P000229,P011386,0 days 00:08:49,3,11,8
192,ASV,P011386,P012731,0 days 00:08:41,1,9,8
192,ASV,P004194,P011225,0 days 00:08:35,-10,11,21
192,ASV,P000229,P005094,0 days 00:08:34,1,11,10
192,ASV,P004194,P012080,0 days 00:08:30,-11,9,20
192,ASV,P005094,P011386,0 days 00:08:06,0,9,9
192,ASV,P004194,P006568,0 days 00:04:52,-1,7,8
192,ASV,P003526,P004194,0 days 00:04:04,-7,2,9
192,ASV,P000229,P006568,0 days 00:01:31,-1,2,3
192,ASV,P006568,P011386,0 days 00:01:31,-1,2,3
192,ASV,P004194,P012729,0 days 00:01:07,0,2,2
192,ASV,P000229,P003526,0 days 00:00:59,-2,0,2
192,ASV,P000229,P011225,0 days 00:00:53,-3,2,5
192,ASV,P011386,P012080,0 days 00:00:48,-4,0,4
192,ASV,P003526,P011386,0 days 00:00:36,-2,0,2
192,ASV,P000229,P012080,0 days 00:00:23,0,0,0
192,ASV,P003526,P012731,0 days 00:00:23,0,0,0
192,ASV,P000229,P012729,0 days 00:00:20,0,2,2
192,ASV,P005094,P012729,0 days 00:00:20,0,2,2
192,ASV,P011386,P012729,0 days 00:00:20,0,2,2
193,IST,P007200,P009846,0 days 00:26:47,18,67,49
193,IST,P009664,P009846,0 days 00:22:55,15,53,38
193,IST,P009846,P011078,0 days 00:21:03,1,43,42
193,IST,P007200,P009664,0 days 00:20:59,21,54,33
193,IST,P009664,P011078,0 days 00:20:56,7,46,39
193,IST,P007200,P011078,0 days 00:19:29,6,44,38
193,IST,P009846,PLHK,0 days 00:19:29,2,38,36
193,IST,P007200,P012788,0 days 00:17:29,23,57,34
193,IST,P007200,PLHK,0 days 00:17:10,0,36,36
193,IST,P011078,PLHK,0 days 00:15:56,1,29,28
193,IST,P006590,P012788,0 days 00:15:20,9,43,34
193,IST,P009664,PLHK,0 days 00:14:58,3,29,26
193,IST,P009846,P012788,0 days 00:13:31,14,42,28
193,IST,P006590,P007200,0 days 00:13:02,13,39,26
193,IST,P006590,P009846,0 days 00:12:09,13,35,22
193,IST,P009664,P012788,0 days 00:11:40,18,35,17
193,IST,P006590,P009664,0 days 00:09:28,14,28,14
193,IST,P011078,P012788,0 days 00:09:00,6,25,19
193,IST,P004888,P012788,0 days 00:08:25,11,26,15
193,IST,P006590,P012786,0 days 00:08:05,2,18,16
193,IST,P004888,P007200,0 days 00:07:59,10,26,16
193,IST,P012786,P012788,0 days 00:06:07,-1,14,15
193,IST,P007200,P012786,0 days 00:05:46,2,16,14
193,IST,P009846,P011981,0 days 00:05:03,4,13,9
193,IST,P004888,P006590,0 days 00:04:52,0,12,12
193,IST,P006590,P011078,0 days 00:04:48,-1,10,11
193,IST,P007200,P011981,0 days 00:04:47,3,13,10
193,IST,P004888,P012786,0 days 00:04:34,1,12,11
193,IST,P004888,P011078,0 days 00:04:21,5,9,4
193,IST,P011981,P012788,0 days 00:04:05,6,13,7
193,IST,P006590,PLHK,0 days 00:04:03,3,11,8
193,IST,P004888,P009664,0 days 00:03:57,6,9,3
193,IST,P011078,P011981,0 days 00:03:38,-1,8,9
193,IST,P004888,P009846,0 days 00:02:58,4,5,1
193,IST,P009846,P012786,0 days 00:02:11,1,4,3
193,IST,P012786,PLHK,0 days 00:01:58,3,4,1
193,IST,P011078,P012786,0 days 00:01:45,0,2,2
193,IST,P012788,PLHK,0 days 00:01:35,-2,5,7
193,IST,P004888,P011981,0 days 00:01:31,3,5,2
193,IST,P009664,P012786,0 days 00:01:20,0,2,2
193,IST,P004888,PLHK,0 days 00:01:15,0,0,0
193,IST,P011981,PLHK,0 days 00:00:58,-2,0,2
193,IST,P006590,P010400,0 days 00:00:34,0,0,0
193,IST,P009846,P010400,0 days 00:00:34,0,0,0
193,IST,P010400,P012786,0 days 00:00:34,0,0,0
193,IST,P010400,PLHK,0 days 00:00:34,0,0,0
193,IST,P009664,P011981,0 days 00:00:19,0,0,0
193,IST,P006590,P011981,0 days 00:00:03,-1,0,1
193,BAR,P009992,P012745,0 days 00:23:45,-16,34,50
193,BAR,P004866,P012745,0 days 00:21:52,-8,40,48
193,BAR,P004866,P009992,0 days 00:21:20,-11,38,49
193,BAR,P002939,P004866,0 days 00:20:07,-16,38,54
193,BAR,P002939,P012745,0 days 00:19:22,-9,38,47
193,BAR,P003196,P007519,0 days 00:18:41,-11,34,45
193,BAR,P000925,P004866,0 days 00:17:32,-3,37,40
193,BAR,P000925,P012745,0 days 00:16:53,-12,30,42
193,BAR,P000925,P009992,0 days 00:16:46,-10,31,41
193,BAR,P002939,P009992,0 days 00:15:59,-10,27,37
193,BAR,P000925,P002939,0 days 00:15:20,-11,28,39
193,BAR,P002939,P003196,0 days 00:13:48,-5,30,35
193,BAR,P002939,P007519,0 days 00:13:44,-11,27,38
193,BAR,P007519,P009992,0 days 00:13:42,-14,18,32
193,BAR,P004866,P007519,0 days 00:12:54,-18,20,38
193,BAR,P007519,P011244,0 days 00:12:16,-9,29,38
193,BAR,P007519,P012745,0 days 00:12:05,-10,14,24
193,BAR,P003196,P004866,0 days 00:10:46,-20,14,34
193,BAR,P003196,P011244,0 days 00:10:29,-10,22,32
193,BAR,P002939,P011244,0 days 00:10:16,-7,20,27
193,BAR,P003196,P012745,0 days 00:10:00,-3,15,18
193,BAR,P003196,P009992,0 days 00:09:50,-8,12,20
193,BAR,P002939,P007464,0 days 00:08:56,5,24,19
193,BAR,P007464,P007519,0 days 00:08:22,5,21,16
193,BAR,P003196,P007464,0 days 00:08:22,5,21,16
193,BAR,P007464,P011244,0 days 00:07:02,6,18,12
193,BAR,P004866,P011244,0 days 00:06:56,-15,11,26
193,BAR,P000925,P007519,0 days 00:05:40,-8,9,17
193,BAR,P007464,P012745,0 days 00:04:20,-2,9,11
193,BAR,P009992,P011244,0 days 00:02:51,-2,9,11
193,BAR,P004866,P007464,0 days 00:02:45,-1,6,7
193,BAR,P000925,P007464,0 days 00:02:30,-1,6,7
193,BAR,P000925,P011244,0 days 00:02:23,1,7,6
193,BAR,P007464,P009992,0 days 00:02:11,-1,3,4
193,BAR,P011244,P012745,0 days 00:00:15,0,0,0
194,OLY,P003941,P008855,0 days 00:23:02,22,58,36
194,OLY,P001255,P003941,0 days 00:22:21,15,56,41
194,OLY,P001255,P010612,0 days 00:22:12,12,56,44
194,OLY,P003941,P010612,0 days 00:21:58,23,62,39
194,OLY,P001255,P008855,0 days 00:20:06,18,50,32
194,OLY,P003941,P008829,0 days 00:18:37,26,51,25
194,OLY,P007982,P011194,0 days 00:18:25,-7,33,40
194,OLY,P008829,P008855,0 days 00:18:13,26,51,25
194,OLY,P008829,P010612,0 days 00:18:02,20,45,25
194,OLY,P007982,P010392,0 days 00:17:39,2,33,31
194,OLY,P008855,P010612,0 days 00:16:57,19,47,28
194,OLY,P001255,P008829,0 days 00:16:44,22,45,23
194,OLY,P010392,P011194,0 days 00:15:46,-2,27,29
194,OLY,P003941,P007982,0 days 00:12:13,8,31,23
194,OLY,P003941,P010392,0 days 00:11:31,14,28,14
194,OLY,P003941,P011194,0 days 00:10:33,1,27,26
194,OLY,P010612,P011194,0 days 00:08:44,-3,20,23
194,OLY,P007982,P010612,0 days 00:08:31,0,18,18
194,OLY,P008855,P010392,0 days 00:06:53,1,11,10
194,OLY,P001255,P011194,0 days 00:06:16,-12,11,23
194,OLY,P001255,P007982,0 days 00:06:03,-9,9,18
194,OLY,P007853,P010392,0 days 00:05:49,3,11,8
194,OLY,P003941,P007853,0 days 00:05:49,3,11,8
194,OLY,P010392,P010612,0 days 00:05:28,5,12,7
194,OLY,P001255,P010392,0 days 00:05:21,-3,6,9
194,OLY,P007982,P008855,0 days 00:04:32,0,8,8
194,OLY,P006589,P011194,0 days 00:04:11,-5,5,10
194,OLY,P006589,P007982,0 days 00:04:11,-5,5,10
194,OLY,P006589,P010392,0 days 00:04:11,-5,5,10
194,OLY,P011194,P011965,0 days 00:04:11,-5,5,10
194,OLY,P006589,P011965,0 days 00:04:11,-5,5,10
194,OLY,P007982,P011965,0 days 00:04:11,-5,5,10
194,OLY,P010392,P011965,0 days 00:04:11,-5,5,10
194,OLY,P007982,P008829,0 days 00:03:35,2,6,4
194,OLY,P007853,P007982,0 days 00:03:28,2,8,6
194,OLY,P007853,P011194,0 days 00:03:28,2,8,6
194,OLY,P008855,P011194,0 days 00:03:16,-7,4,11
194,OLY,P008829,P010392,0 days 00:03:11,2,6,4
194,OLY,P001255,P007853,0 days 00:02:21,1,3,2
194,OLY,P007853,P008855,0 days 00:02:21,1,3,2
194,OLY,P008829,P011194,0 days 00:01:18,-2,0,2
194,TEL,P009863,P011219,0 days 00:22:47,-20,36,56
194,TEL,P009863,P011199,0 days 00:21:20,-14,31,45
194,TEL,P009783,P011219,0 days 00:20:30,-23,29,52
194,TEL,P009783,P009863,0 days 00:19:11,-23,27,50
194,TEL,P011199,P011219,0 days 00:18:13,-15,25,40
194,TEL,P009783,P011193,0 days 00:16:46,-18,24,42
194,TEL,P009783,P011199,0 days 00:16:14,-17,20,37
194,TEL,P007990,P009863,0 days 00:15:21,-1,28,29
194,TEL,P007990,P009783,0 days 00:14:09,-7,23,30
194,TEL,P007990,P011971,0 days 00:13:30,9,34,25
194,TEL,P007990,P011219,0 days 00:13:02,-7,22,29
194,TEL,P007990,P011193,0 days 00:12:53,3,28,25
194,TEL,P011193,P011219,0 days 00:12:49,-17,16,33
194,TEL,P007990,P011199,0 days 00:12:46,-1,19,20
194,TEL,P011193,P011214,0 days 00:12:03,-5,26,31
194,TEL,P004233,P007990,0 days 00:12:02,11,28,17
194,TEL,P011193,P011199,0 days 00:11:44,-9,16,25
194,TEL,P009863,P011193,0 days 00:11:30,-17,14,31
194,TEL,P007990,P011214,0 days 00:11:00,1,26,25
194,TEL,P004233,P011971,0 days 00:10:07,7,23,16
194,TEL,P011193,P011971,0 days 00:09:11,3,24,21
194,TEL,P011214,P011971,0 days 00:09:11,3,24,21
194,TEL,P004233,P009863,0 days 00:07:44,3,17,14
194,TEL,P009863,P011971,0 days 00:06:41,-2,12,14
194,TEL,P004233,P011199,0 days 00:06:00,5,13,8
194,TEL,P007990,P012744,0 days 00:05:49,0,16,16
194,TEL,P009783,P011214,0 days 00:05:38,-9,8,17
194,TEL,P004233,P011193,0 days 00:05:34,6,13,7
194,TEL,P004233,P011214,0 days 00:05:21,6,13,7
194,TEL,P011219,P012744,0 days 00:04:39,0,11,11
194,TEL,P009863,P012744,0 days 00:04:27,0,11,11
194,TEL,P011199,P011971,0 days 00:04:11,3,8,5
194,TEL,P011971,P012744,0 days 00:04:06,-4,9,13
194,TEL,P004233,P011219,0 days 00:03:45,0,9,9
194,TEL,P009783,P012744,0 days 00:03:11,2,9,7
194,TEL,P009783,P011971,0 days 00:02:46,-1,6,7
194,TEL,P011214,P012744,0 days 00:02:38,-2,7,9
194,TEL,P011193,P012744,0 days 00:02:38,-2,7,9
194,TEL,P011219,P011971,0 days 00:02:09,-2,4,6
194,TEL,P004233,P009783,0 days 00:01:47,0,2,2
194,TEL,P004233,P012744,0 days 00:01:28,-2,2,4
194,TEL,P011214,P011219,0 days 00:01:18,-8,0,8
194,TEL,P009863,P011214,0 days 00:01:03,-6,0,6
194,TEL,P004233,P011433,0 days 00:00:12,0,0,0
194,TEL,P011219,P011433,0 days 00:00:12,0,0,0
194,TEL,P011433,P011971,0 days 00:00:12,0,0,0
194,TEL,P011433,P012744,0 days 00:00:12,0,0,0
195,MCO,P005985,P011231,0 days 00:19:30,10,43,33
195,MCO,P005985,P011226,0 days 00:19:09,19,51,32
195,MCO,P004197,P005985,0 days 00:17:48,11,40,29
195,MCO,P005985,P011212,0 days 00:17:10,13,42,29
195,MCO,P011226,P011231,0 days 00:16:33,4,39,35
195,MCO,P004790,P011212,0 days 00:15:01,9,39,30
195,MCO,P011196,P011212,0 days 00:14:18,1,27,26
195,MCO,P004790,P005985,0 days 00:13:07,17,41,24
195,MCO,P004197,P011231,0 days 00:13:06,15,30,15
195,MCO,P009754,P011226,0 days 00:12:49,-3,30,33
195,MCO,P005985,P011196,0 days 00:12:35,5,28,23
195,MCO,P009754,P011212,0 days 00:12:23,6,31,25
195,MCO,P004790,P009754,0 days 00:12:14,17,37,20
195,MCO,P004790,PLCZ,0 days 00:11:11,11,31,20
195,MCO,P005985,P009754,0 days 00:11:07,11,35,24
195,MCO,P005985,PLCZ,0 days 00:10:42,10,32,22
195,MCO,P009754,PLCZ,0 days 00:10:31,4,28,24
195,MCO,P011212,P011226,0 days 00:10:24,0,21,21
195,MCO,P011212,PLCZ,0 days 00:10:15,9,29,20
195,MCO,P011196,P011231,0 days 00:09:36,-1,17,18
195,MCO,P011212,P011231,0 days 00:09:32,1,17,16
195,MCO,P002581,P004197,0 days 00:09:20,12,24,12
195,MCO,P002581,P005985,0 days 00:09:20,12,24,12
195,MCO,P004197,P011226,0 days 00:09:20,12,24,12
195,MCO,P002581,P011231,0 days 00:09:20,12,24,12
195,MCO,P002581,P011226,0 days 00:09:20,12,24,12
195,MCO,P004790,P011226,0 days 00:09:18,10,24,14
195,MCO,P004197,P011212,0 days 00:09:09,1,18,17
195,MCO,P011196,P011226,0 days 00:08:56,5,24,19
195,MCO,P009754,P011196,0 days 00:07:59,4,21,17
195,MCO,P011226,PLCZ,0 days 00:07:35,-3,15,18
195,MCO,P004790,P011196,0 days 00:07:10,6,20,14
195,MCO,P004197,P011196,0 days 00:06:30,0,11,11
195,MCO,P009754,P011231,0 days 00:06:16,-9,12,21
195,MCO,P004197,P004790,0 days 00:05:23,-2,12,14
195,MCO,P011231,PLCZ,0 days 00:02:43,-4,6,10
195,MCO,P004197,PLCZ,0 days 00:02:39,1,7,6
195,MCO,P004197,P009754,0 days 00:00:41,2,2,0
195,MAD,P003108,P004887,0 days 00:16:58,-19,26,45
195,MAD,P004887,P006540,0 days 00:16:04,-13,28,41
195,MAD,P010357,PBMT,0 days 00:15:47,0,35,35
195,MAD,P003108,P006540,0 days 00:14:53,-14,24,38
195,MAD,P004887,P005928,0 days 00:14:15,-12,28,40
195,MAD,P003733,P010357,0 days 00:13:01,-5,24,29
195,MAD,P005928,P006540,0 days 00:12:40,-7,28,35
195,MAD,P003108,P005928,0 days 00:12:33,-12,24,36
195,MAD,P001392,P004887,0 days 00:12:28,-8,28,36
195,MAD,P001392,P005928,0 days 00:12:14,-15,22,37
195,MAD,P003733,PBMT,0 days 00:11:59,-7,23,30
195,MAD,P009005,P010357,0 days 00:11:40,-5,22,27
195,MAD,P009005,PCVM,0 days 00:10:48,-11,15,26
195,MAD,P009213,P010357,0 days 00:10:29,-2,18,20
195,MAD,P010357,P010623,0 days 00:09:06,5,20,15
195,MAD,P004887,PBMT,0 days 00:08:26,-1,18,19
195,MAD,P005928,PBMT,0 days 00:08:25,-5,14,19
195,MAD,P001392,P006540,0 days 00:08:11,-11,16,27
195,MAD,P001392,P003108,0 days 00:08:11,-11,16,27
195,MAD,P010357,PCVM,0 days 00:07:41,-6,16,22
195,MAD,P003733,P009005,0 days 00:07:32,-3,12,15
195,MAD,P001392,P010357,0 days 00:07:28,0,18,18
195,MAD,P003733,P010623,0 days 00:07:16,-1,12,13
195,MAD,P004887,P009005,0 days 00:07:09,-6,10,16
195,MAD,P006540,P009005,0 days 00:07:00,-9,8,17
195,MAD,P004887,P010357,0 days 00:06:48,1,18,17
195,MAD,P004887,PCVM,0 days 00:06:21,-9,6,15
195,MAD,P005928,P010357,0 days 00:06:15,-4,12,16
195,MAD,P010623,PBMT,0 days 00:06:01,6,17,11
195,MAD,P009213,PBMT,0 days 00:06:00,2,13,11
195,MAD,P009213,P010623,0 days 00:05:56,2,10,8
195,MAD,P003733,P009213,0 days 00:05:56,2,10,8
195,MAD,P001392,PBMT,0 days 00:05:53,2,14,12
195,MAD,P003733,PCVM,0 days 00:05:45,-4,12,16
195,MAD,P003108,PCVM,0 days 00:05:43,-9,5,14
195,MAD,PBMT,PCVM,0 days 00:05:43,-2,12,14
195,MAD,P003108,PBMT,0 days 00:05:40,-3,11,14
195,MAD,P006540,PCVM,0 days 00:04:48,-9,2,11
195,MAD,P005928,P009213,0 days 00:04:33,-4,8,12
195,MAD,P009005,P009213,0 days 00:04:29,-4,5,9
195,MAD,P003108,P009005,0 days 00:04:25,-7,2,9
195,MAD,P009005,PBMT,0 days 00:04:25,0,9,9
195,MAD,P003733,P004887,0 days 00:03:25,-8,4,12
195,MAD,P003108,P003733,0 days 00:03:23,-7,5,12
195,MAD,P004887,P010623,0 days 00:03:10,3,10,7
195,MAD,P001392,P009213,0 days 00:03:09,-1,6,7
195,MAD,P009005,P010623,0 days 00:03:05,-1,3,4
195,MAD,P006540,P010357,0 days 00:02:35,-2,6,8
195,MAD,P006540,PBMT,0 days 00:02:17,4,6,2
195,MAD,P005928,P009005,0 days 00:02:12,0,6,6
195,MAD,P003733,P005928,0 days 00:02:05,-5,2,7
195,MAD,P001392,P010623,0 days 00:01:50,6,8,2
195,MAD,P001392,P009005,0 days 00:01:35,-2,4,6
195,MAD,P001392,PCVM,0 days 00:01:35,-2,4,6
195,MAD,P006540,P009213,0 days 00:01:24,-3,2,5
195,MAD,P003108,P010357,0 days 00:01:18,-2,3,5
195,MAD,P001392,P003733,0 days 00:00:02,-2,0,2
196,PAN,P007866,P011204,0 days 00:30:24,13,64,51
196,PAN,P003842,P007866,0 days 00:28:43,9,61,52
196,PAN,P003842,P011204,0 days 00:27:32,15,60,45
196,PAN,P011204,P012774,0 days 00:27:19,6,55,49
196,PAN,P007866,P012774,0 days 00:26:37,0,50,50
196,PAN,P003842,P012774,0 days 00:24:25,4,47,43
196,PAN,P002328,P007866,0 days 00:23:03,3,46,43
196,PAN,P001926,P011204,0 days 00:22:24,16,53,37
196,PAN,P002328,P003842,0 days 00:22:17,5,47,42
196,PAN,P002328,P011204,0 days 00:20:43,4,40,36
196,PAN,P001926,P007866,0 days 00:20:36,12,48,36
196,PAN,P001926,P012774,0 days 00:19:17,9,44,35
196,PAN,P001926,P003842,0 days 00:17:41,16,45,29
196,PAN,P002328,P012774,0 days 00:16:46,-5,29,34
196,PAN,P001926,P002328,0 days 00:11:51,5,27,22
196,PAN,P001926,P012712,0 days 00:07:52,3,16,13
196,PAN,P011204,P011221,0 days 00:07:23,-1,15,16
196,PAN,P001926,P011221,0 days 00:07:23,-1,15,16
196,PAN,P011221,P012774,0 days 00:06:17,1,15,14
196,PAN,P012712,P012774,0 days 00:06:03,5,16,11
196,PAN,P011204,P012712,0 days 00:05:57,1,11,10
196,PAN,P011221,P012712,0 days 00:03:58,-2,8,10
196,PAN,P002328,P012712,0 days 00:03:44,0,5,5
196,PAN,P007866,P011221,0 days 00:03:25,1,7,6
196,PAN,P003842,P012712,0 days 00:02:12,5,6,1
196,PAN,P007866,P012712,0 days 00:01:42,0,2,2
196,PAN,P002328,P011221,0 days 00:01:06,-2,0,2
196,PAN,P002328,P011209,0 days 00:00:50,2,2,0
196,PAN,P003842,P011209,0 days 00:00:50,2,2,0
196,PAN,P007866,P011209,0 days 00:00:50,2,2,0
196,PAN,P011204,P011209,0 days 00:00:50,2,2,0
196,PAR,P008987,P012742,0 days 00:21:29,0,41,41
196,PAR,P007400,P012742,0 days 00:20:50,-7,41,48
196,PAR,P007673,P012742,0 days 00:19:56,-3,35,38
196,PAR,P007400,P011051,0 days 00:18:28,-8,35,43
196,PAR,P011051,P012742,0 days 00:18:16,-6,35,41
196,PAR,P007673,P008987,0 days 00:16:42,-1,30,31
196,PAR,P012096,P012742,0 days 00:14:33,0,26,26
196,PAR,P007673,P012096,0 days 00:11:23,-3,18,21
196,PAR,P007400,P011050,0 days 00:10:37,-2,18,20
196,PAR,P007400,P007673,0 days 00:10:30,0,19,19
196,PAR,P000956,P011051,0 days 00:09:59,-2,18,20
196,PAR,P008987,P012096,0 days 00:09:42,-2,16,18
196,PAR,P007400,P008987,0 days 00:09:36,1,20,19
196,PAR,P011050,P012742,0 days 00:09:19,-2,17,19
196,PAR,P004172,P008987,0 days 00:08:53,-5,13,18
196,PAR,P000956,P007400,0 days 00:08:31,-6,15,21
196,PAR,P007400,P011192,0 days 00:08:23,-7,15,22
196,PAR,P011192,P012742,0 days 00:08:01,-7,15,22
196,PAR,P000956,P012742,0 days 00:07:52,-2,15,17
196,PAR,P008987,P011051,0 days 00:07:26,0,16,16
196,PAR,P007400,P012096,0 days 00:07:22,-1,14,15
196,PAR,P000956,P008987,0 days 00:07:21,0,13,13
196,PAR,P011051,P011192,0 days 00:07:06,-7,11,18
196,PAR,P011050,P011051,0 days 00:07:01,-5,13,18
196,PAR,P007673,P011051,0 days 00:06:55,-7,12,19
196,PAR,P004058,P008987,0 days 00:06:54,1,12,11
196,PAR,P004058,P007673,0 days 00:06:54,1,12,11
196,PAR,P004058,P012742,0 days 00:06:54,1,12,11
196,PAR,P004058,P012096,0 days 00:06:54,1,12,11
196,PAR,P008987,P011050,0 days 00:06:47,1,11,10
196,PAR,P007673,P011050,0 days 00:06:47,1,11,10
196,PAR,P011051,P012096,0 days 00:05:43,1,10,9
196,PAR,P004172,P012742,0 days 00:05:28,-2,9,11
196,PAR,P011050,P011192,0 days 00:05:11,-3,10,13
196,PAR,P004172,P007673,0 days 00:05:00,-8,6,14
196,PAR,P011192,P012096,0 days 00:04:31,-1,8,9
196,PAR,P004172,P011050,0 days 00:03:57,-2,6,8
196,PAR,P000956,P004172,0 days 00:03:53,3,7,4
196,PAR,P008987,P011192,0 days 00:03:47,-5,6,11
196,PAR,P007673,P011192,0 days 00:03:33,-8,5,13
196,PAR,P004172,P011051,0 days 00:03:16,-2,5,7
196,PAR,P000956,P011050,0 days 00:03:06,-2,5,7
196,PAR,P000956,P012096,0 days 00:03:04,2,6,4
196,PAR,P004172,P011192,0 days 00:02:39,-3,4,7
196,PAR,P004058,P011050,0 days 00:02:27,-2,5,7
196,PAR,P000956,P004058,0 days 00:02:27,-2,5,7
196,PAR,P004058,P007400,0 days 00:02:27,-2,5,7
196,PAR,P004058,P011051,0 days 00:02:27,-2,5,7
196,PAR,P000956,P011192,0 days 00:02:05,1,2,1
196,PAR,P004172,P012096,0 days 00:01:40,-1,2,3
196,PAR,P000956,P012743,0 days 00:01:18,-4,2,6
196,PAR,P007400,P012743,0 days 00:01:18,-4,2,6
196,PAR,P012742,P012743,0 days 00:01:18,-4,2,6
196,PAR,P008987,P012743,0 days 00:00:59,-2,2,4
196,PAR,P004172,P007400,0 days 00:00:46,0,0,0
196,PAR,P011051,P012743,0 days 00:00:19,-2,0,2
197,PAM,P010568,P011982,0 days 00:26:06,18,60,42
197,PAM,P007870,P010568,0 days 00:24:31,2,46,44
197,PAM,P007870,P011982,0 days 00:22:05,5,43,38
197,PAM,P010568,P012740,0 days 00:21:32,7,44,37
197,PAM,P007870,P012740,0 days 00:21:01,8,44,36
197,PAM,P011982,P012740,0 days 00:19:34,8,41,33
197,PAM,P003960,P010568,0 days 00:14:41,0,29,29
197,PAM,P003960,P011982,0 days 00:14:25,1,27,26
197,PAM,P011970,P012738,0 days 00:13:31,10,34,24
197,PAM,P003960,P007870,0 days 00:13:14,-1,25,26
197,PAM,P003960,P012740,0 days 00:13:14,-1,25,26
197,PAM,P006433,P011970,0 days 00:11:12,-2,19,21
197,PAM,P006433,P012738,0 days 00:11:12,-2,19,21
197,PAM,P010393,P010568,0 days 00:09:41,9,25,16
197,PAM,P010393,P011982,0 days 00:09:27,15,26,11
197,PAM,P005356,P010393,0 days 00:07:52,-9,10,19
197,PAM,P011970,P012739,0 days 00:07:29,1,17,16
197,PAM,P010393,P012738,0 days 00:07:26,10,19,9
197,PAM,P007870,P010393,0 days 00:07:10,1,13,12
197,PAM,P005356,P010568,0 days 00:07:08,-8,9,17
197,PAM,P010393,P011970,0 days 00:06:55,11,19,8
197,PAM,P006433,P012795,0 days 00:06:52,-3,10,13
197,PAM,P012738,P012795,0 days 00:06:52,-3,10,13
197,PAM,P011970,P012795,0 days 00:06:52,-3,10,13
197,PAM,P005356,P007870,0 days 00:06:35,-7,7,14
197,PAM,P012738,P012739,0 days 00:06:35,-1,15,16
197,PAM,P005356,P012738,0 days 00:05:48,-3,9,12
197,PAM,P012739,P012795,0 days 00:05:43,-3,10,13
197,PAM,P006433,P012739,0 days 00:05:43,-3,10,13
197,PAM,P006433,P010393,0 days 00:05:28,1,9,8
197,PAM,P010568,P012738,0 days 00:04:48,10,18,8
197,PAM,P011970,P011982,0 days 00:04:46,20,23,3
197,PAM,P005356,P011982,0 days 00:04:27,-4,4,8
197,PAM,P010568,P011970,0 days 00:04:15,17,20,3
197,PAM,P010393,P012740,0 days 00:04:11,6,11,5
197,PAM,P005356,P011970,0 days 00:03:50,-2,6,8
197,PAM,P005356,P006433,0 days 00:03:50,-2,6,8
197,PAM,P011982,P012738,0 days 00:03:21,14,18,4
197,PAM,P005356,P012740,0 days 00:03:05,-1,5,6
197,PAM,P012738,P012740,0 days 00:02:29,-2,3,5
197,PAM,P007870,P012738,0 days 00:01:58,-1,3,4
197,PAM,P010393,P012795,0 days 00:01:53,-3,2,5
197,PAM,P010568,P012739,0 days 00:01:46,4,7,3
197,PAM,P011982,P012739,0 days 00:01:46,4,7,3
197,PAM,P007870,P011970,0 days 00:01:02,3,3,0
197,PAM,P011970,P012740,0 days 00:01:02,3,3,0
197,PAM,P003960,P011970,0 days 00:00:54,2,2,0
197,PAM,P003960,P012739,0 days 00:00:54,2,2,0
197,PAM,P005356,P012795,0 days 00:00:44,-3,2,5
197,PAM,P010568,P012795,0 days 00:00:44,-3,2,5
197,PAM,P003960,P005356,0 days 00:00:33,-1,2,3
197,PAM,P003960,P010393,0 days 00:00:33,-1,2,3
197,PAM,P006433,P011982,0 days 00:00:31,3,3,0
197,PAM,P007870,P012795,0 days 00:00:28,-2,0,2
197,PAM,P003960,P012795,0 days 00:00:16,-1,2,3
197,MIL,P011205,P011224,0 days 00:27:31,-6,44,50
197,MIL,P002849,P011205,0 days 00:27:27,3,51,48
197,MIL,P002849,P011224,0 days 00:24:56,-3,42,45
197,MIL,P011205,P012800,0 days 00:18:44,-2,29,31
197,MIL,P011224,P012800,0 days 00:17:06,0,26,26
197,MIL,P002849,P012800,0 days 00:16:18,2,29,27
197,MIL,P002812,P011205,0 days 00:16:09,-1,27,28
197,MIL,P006509,P007201,0 days 00:15:32,-2,32,34
197,MIL,P002812,P011224,0 days 00:15:06,-4,24,28
197,MIL,P002812,P002849,0 days 00:15:02,-1,25,26
197,MIL,P007201,P011205,0 days 00:14:49,-15,21,36
197,MIL,P002812,P012800,0 days 00:14:32,-2,22,24
197,MIL,P007201,P011224,0 days 00:13:38,-5,21,26
197,MIL,P007201,P007831,0 days 00:11:09,-13,21,34
197,MIL,P007201,P009960,0 days 00:10:42,-13,19,32
197,MIL,P006509,P011224,0 days 00:09:45,-3,16,19
197,MIL,P006509,P011205,0 days 00:09:40,2,19,17
197,MIL,P007831,P009960,0 days 00:09:28,-9,22,31
197,MIL,P002849,P007201,0 days 00:09:03,-1,16,17
197,MIL,P002849,P006509,0 days 00:08:17,-1,14,15
197,MIL,P005670,P009960,0 days 00:07:56,-6,19,25
197,MIL,P005670,P007201,0 days 00:07:14,-9,16,25
197,MIL,P006509,P009960,0 days 00:07:13,2,19,17
197,MIL,P006509,P007831,0 days 00:06:57,-1,16,17
197,MIL,P005670,P007831,0 days 00:06:56,-7,16,23
197,MIL,P007831,P011205,0 days 00:06:37,-13,11,24
197,MIL,P005670,P006509,0 days 00:06:32,4,19,15
197,MIL,P009960,P011205,0 days 00:06:07,-11,9,20
197,MIL,P007831,P011224,0 days 00:04:40,-5,8,13
197,MIL,P002849,P007831,0 days 00:03:56,2,11,9
197,MIL,P005670,P011205,0 days 00:03:54,-3,9,12
197,MIL,P009960,P011224,0 days 00:03:28,-4,3,7
197,MIL,P007201,P012800,0 days 00:02:26,-4,0,4
197,MIL,P009960,P012800,0 days 00:02:18,-2,3,5
197,MIL,P002812,P007831,0 days 00:02:15,-8,0,8
197,MIL,P001518,P012800,0 days 00:01:54,2,4,2
197,MIL,P001518,P011224,0 days 00:01:54,2,4,2
197,MIL,P001518,P011205,0 days 00:01:54,2,4,2
197,MIL,P001518,P002849,0 days 00:01:54,2,4,2
197,MIL,P002812,P006509,0 days 00:01:52,3,5,2
197,MIL,P002812,P007201,0 days 00:01:51,-2,2,4
197,MIL,P007831,P012800,0 days 00:01:38,-2,3,5
197,MIL,P002849,P009960,0 days 00:01:28,3,6,3
197,MIL,P002849,P005670,0 days 00:01:27,6,6,0
197,MIL,P002812,P005670,0 days 00:00:45,3,3,0
198,ZAL,P011218,P012715,0 days 00:27:17,28,71,43
198,ZAL,P005504,P012715,0 days 00:19:57,29,53,24
198,ZAL,P005504,P011218,0 days 00:18:18,25,49,24
198,ZAL,P012715,P012787,0 days 00:18:08,18,42,24
198,ZAL,P002329,P012715,0 days 00:18:06,22,47,25
198,ZAL,P011218,P012787,0 days 00:17:06,21,42,21
198,ZAL,P002329,P011218,0 days 00:16:22,20,43,23
198,ZAL,P005504,P012787,0 days 00:15:20,23,39,16
198,ZAL,P002329,P005504,0 days 00:13:51,24,36,12
198,ZAL,P007109,P012715,0 days 00:12:54,3,30,27
198,ZAL,P002329,P012787,0 days 00:11:44,14,28,14
198,ZAL,P007109,P011218,0 days 00:11:20,4,28,24
198,ZAL,P002329,P007109,0 days 00:09:32,-7,23,30
198,ZAL,P002676,P011218,0 days 00:09:27,-3,22,25
198,ZAL,P003210,P010390,0 days 00:09:03,-7,19,26
198,ZAL,P002676,P012715,0 days 00:09:01,6,25,19
198,ZAL,P003211,P012715,0 days 00:08:36,13,26,13
198,ZAL,P002676,P010390,0 days 00:08:32,-6,19,25
198,ZAL,P007109,P010390,0 days 00:08:17,-18,14,32
198,ZAL,P007109,P012787,0 days 00:08:10,2,17,15
198,ZAL,P003210,P007109,0 days 00:07:29,-9,14,23
198,ZAL,P003210,P003211,0 days 00:07:24,9,17,8
198,ZAL,P002676,P003211,0 days 00:07:17,7,21,14
198,ZAL,P003211,P010390,0 days 00:07:16,-6,13,19
198,ZAL,P010390,P012715,0 days 00:07:11,-4,13,17
198,ZAL,P002676,P007109,0 days 00:07:05,-4,19,23
198,ZAL,P002676,P003210,0 days 00:06:59,3,19,16
198,ZAL,P002329,P003210,0 days 00:06:34,-3,16,19
198,ZAL,P003211,P011218,0 days 00:06:30,2,19,17
198,ZAL,P003210,P012715,0 days 00:06:27,0,11,11
198,ZAL,P003211,P005504,0 days 00:06:13,14,20,6
198,ZAL,P005504,P007109,0 days 00:05:49,7,14,7
198,ZAL,P002329,P003211,0 days 00:05:44,6,15,9
198,ZAL,P002329,P002676,0 days 00:05:23,-1,16,17
198,ZAL,P010390,P011218,0 days 00:05:07,-6,8,14
198,ZAL,P003211,P007109,0 days 00:04:53,-7,7,14
198,ZAL,P002329,P010390,0 days 00:04:28,-7,12,19
198,ZAL,P003210,P005504,0 days 00:04:04,8,10,2
198,ZAL,P002676,P005504,0 days 00:02:52,4,9,5
198,ZAL,P003210,P011218,0 days 00:01:53,-3,2,5
198,ZAL,P005504,P006860,0 days 00:01:36,6,6,0
198,ZAL,P003210,P006860,0 days 00:01:36,6,6,0
198,ZAL,P003211,P006860,0 days 00:01:36,6,6,0
198,ZAL,P002676,P006860,0 days 00:01:36,6,6,0
198,ZAL,P007109,P007513,0 days 00:01:03,-3,2,5
198,ZAL,P007513,P010390,0 days 00:01:03,-3,2,5
198,ZAL,P007513,P012715,0 days 00:01:03,-3,2,5
198,ZAL,P010390,P012787,0 days 00:00:55,-3,0,3
198,ZAL,P003210,P007513,0 days 00:00:44,0,2,2
198,ZAL,P003210,P012787,0 days 00:00:43,0,0,0
198,ZAL,P007513,P012787,0 days 00:00:19,-3,0,3
198,ZAL,P003211,P012787,0 days 00:00:07,0,0,0
198,ULK,P004004,P009849,0 days 00:17:39,-6,42,48
198,ULK,P006661,P010560,0 days 00:17:05,-20,21,41
198,ULK,P001932,P006661,0 days 00:16:13,-7,26,33
198,ULK,P002968,P010560,0 days 00:15:57,-15,19,34
198,ULK,P002968,P006661,0 days 00:15:24,-14,21,35
198,ULK,P001932,P010560,0 days 00:15:12,-14,19,33
198,ULK,P001932,P005844,0 days 00:14:04,-7,22,29
198,ULK,P004004,P006661,0 days 00:13:55,2,38,36
198,ULK,P005844,P010560,0 days 00:13:22,-21,11,32
198,ULK,P001932,P002968,0 days 00:13:03,-5,21,26
198,ULK,P002968,P005844,0 days 00:12:45,-4,19,23
198,ULK,P004004,P005844,0 days 00:12:23,-3,24,27
198,ULK,P005844,P006661,0 days 00:12:00,-10,16,26
198,ULK,P006661,P009849,0 days 00:11:47,-3,31,34
198,ULK,P009849,P010560,0 days 00:11:39,-5,23,28
198,ULK,P006661,P011157,0 days 00:10:47,-6,27,33
198,ULK,P004004,P010560,0 days 00:10:09,-9,17,26
198,ULK,P002968,P009849,0 days 00:10:01,2,18,16
198,ULK,P009849,P011052,0 days 00:09:48,0,21,21
198,ULK,P005844,P009849,0 days 00:09:42,-6,14,20
198,ULK,P004004,P011157,0 days 00:09:25,3,31,28
198,ULK,P009849,P011157,0 days 00:09:18,3,34,31
198,ULK,P001932,P004004,0 days 00:09:01,7,22,15
198,ULK,P010560,P011052,0 days 00:08:32,-11,10,21
198,ULK,P002968,P011052,0 days 00:07:56,-7,11,18
198,ULK,P004004,P011052,0 days 00:07:51,-2,17,19
198,ULK,P002969,P009849,0 days 00:06:59,-3,20,23
198,ULK,P001932,P009849,0 days 00:06:53,2,15,13
198,ULK,P002968,P004004,0 days 00:06:19,7,16,9
198,ULK,P002969,P004004,0 days 00:06:10,-3,17,20
198,ULK,P010560,P011157,0 days 00:06:08,-5,12,17
198,ULK,P005844,P011052,0 days 00:05:02,-3,8,11
198,ULK,P011052,P011157,0 days 00:04:57,-4,10,14
198,ULK,P002969,P011157,0 days 00:04:51,-3,16,19
198,ULK,P002969,P006661,0 days 00:04:02,-3,13,16
198,ULK,P006661,P011052,0 days 00:03:39,-3,7,10
198,ULK,P002968,P011157,0 days 00:02:55,-6,3,9
198,ULK,P001932,P011157,0 days 00:02:27,4,7,3
198,ULK,P002969,P011201,0 days 00:02:25,-6,3,9
198,ULK,P011201,P012724,0 days 00:02:25,-6,3,9
198,ULK,P002969,P012724,0 days 00:02:25,-6,3,9
198,ULK,P002969,P005844,0 days 00:02:08,0,4,4
198,ULK,P001932,P002969,0 days 00:02:08,0,4,4
198,ULK,P002969,P011052,0 days 00:01:36,-6,0,6
198,ULK,P002968,P012724,0 days 00:01:36,-6,0,6
198,ULK,P002968,P011201,0 days 00:01:36,-6,0,6
198,ULK,P011052,P011201,0 days 00:01:36,-6,0,6
198,ULK,P011052,P012724,0 days 00:01:36,-6,0,6
198,ULK,P002968,P002969,0 days 00:01:36,-6,0,6
198,ULK,P009849,P011201,0 days 00:00:49,0,3,3
198,ULK,P009849,P012724,0 days 00:00:49,0,3,3
198,ULK,P011157,P011201,0 days 00:00:49,0,3,3
198,ULK,P011157,P012724,0 days 00:00:49,0,3,3
198,ULK,P005844,P011157,0 days 00:00:10,2,2,0
198,ULK,P001932,P011052,0 days 00:00:07,0,0,0
199,BER,P008780,P008967,0 days 00:25:48,8,57,49
199,BER,P008967,P012720,0 days 00:21:59,6,45,39
199,BER,P008780,P012720,0 days 00:21:55,3,42,39
199,BER,P008967,P011934,0 days 00:17:19,5,40,35
199,BER,P008780,P011934,0 days 00:17:13,5,38,33
199,BER,P003958,P008967,0 days 00:16:02,11,41,30
199,BER,P003958,P008780,0 days 00:15:30,8,38,30
199,BER,P011934,P012720,0 days 00:15:12,-2,29,31
199,BER,P011934,P012721,0 days 00:13:38,5,30,25
199,BER,P003958,P012720,0 days 00:13:31,6,30,24
199,BER,P008173,P008211,0 days 00:12:42,0,27,27
199,BER,P008211,P008384,0 days 00:12:38,-2,27,29
199,BER,P008173,P008384,0 days 00:12:08,0,25,25
199,BER,P008384,P012721,0 days 00:10:57,3,25,22
199,BER,P008384,P011934,0 days 00:10:10,8,31,23
199,BER,P008173,P012721,0 days 00:09:41,3,23,20
199,BER,P008211,P012721,0 days 00:09:41,3,23,20
199,BER,P008967,P010791,0 days 00:09:35,6,22,16
199,BER,P008780,P010791,0 days 00:09:03,3,19,16
199,BER,P008967,P012721,0 days 00:08:53,1,18,17
199,BER,P008211,P011934,0 days 00:08:41,3,22,19
199,BER,P008780,P012721,0 days 00:08:19,1,16,15
199,BER,P003958,P011934,0 days 00:08:17,5,23,18
199,BER,P003958,P010791,0 days 00:07:45,6,18,12
199,BER,P010791,P012720,0 days 00:07:45,6,18,12
199,BER,P008173,P011934,0 days 00:07:43,5,20,15
199,BER,P008384,P010791,0 days 00:06:49,-5,11,16
199,BER,P012720,P012721,0 days 00:06:29,1,12,11
199,BER,P008173,P010791,0 days 00:05:31,-2,10,12
199,BER,P008211,P010791,0 days 00:04:59,-5,7,12
199,BER,P010791,P012721,0 days 00:04:22,-1,9,10
199,BER,P008384,P008780,0 days 00:04:21,5,15,10
199,BER,P008384,P008967,0 days 00:04:21,5,15,10
199,BER,P006251,P008211,0 days 00:03:59,-5,6,11
199,BER,P006251,P008384,0 days 00:03:31,-5,6,11
199,BER,P006251,P011934,0 days 00:03:31,-2,7,9
199,BER,P006251,P008173,0 days 00:03:01,-3,4,7
199,BER,P006251,P012720,0 days 00:02:57,-3,5,8
199,BER,P003958,P008384,0 days 00:02:31,5,11,6
199,BER,P006251,P010791,0 days 00:02:27,-4,2,6
199,BER,P006251,P008780,0 days 00:02:27,-1,3,4
199,BER,P006251,P008967,0 days 00:01:59,-1,3,4
199,BER,P008173,P008967,0 days 00:01:06,3,5,2
199,BER,P008211,P012720,0 days 00:00:58,-2,2,4
199,BER,P008211,P008967,0 days 00:00:34,0,2,2
199,BER,P003958,P008173,0 days 00:00:32,3,3,0
199,BER,P008173,P012720,0 days 00:00:32,3,3,0
199,BER,P008384,P012720,0 days 00:00:30,-2,2,4
199,BER,P008211,P008780,0 days 00:00:28,0,0,0
199,RED,P006436,P009035,0 days 00:28:36,-6,57,63
199,RED,P006436,P012044,0 days 00:23:55,-10,45,55
199,RED,P009035,P012044,0 days 00:22:19,-8,42,50
199,RED,P005099,P012801,0 days 00:20:57,7,48,41
199,RED,P009035,P012801,0 days 00:20:21,10,46,36
199,RED,P005099,P009035,0 days 00:19:44,3,44,41
199,RED,P006436,P012801,0 days 00:14:46,6,32,26
199,RED,P005099,P006436,0 days 00:14:09,-1,30,31
199,RED,P002553,P009035,0 days 00:13:23,-1,25,26
199,RED,P002553,P006436,0 days 00:12:20,-5,22,27
199,RED,P007960,P012801,0 days 00:12:09,-6,22,28
199,RED,P007960,P009035,0 days 00:11:28,-7,19,26
199,RED,P002553,P012044,0 days 00:11:27,-7,20,27
199,RED,P009035,PLUO,0 days 00:11:05,4,30,26
199,RED,P000848,P007960,0 days 00:10:41,-9,17,26
199,RED,P005099,P007960,0 days 00:10:22,-6,18,24
199,RED,P012044,P012801,0 days 00:10:06,2,19,17
199,RED,P006436,PLUO,0 days 00:10:02,0,27,27
199,RED,P002553,PLUO,0 days 00:09:50,0,21,21
199,RED,P000848,P009035,0 days 00:08:34,-2,16,18
199,RED,P006436,P007960,0 days 00:08:32,-9,11,20
199,RED,P012044,PLUO,0 days 00:08:25,-3,20,23
199,RED,P005099,P012044,0 days 00:07:52,-3,15,18
199,RED,P000848,P005099,0 days 00:07:38,-5,12,17
199,RED,P000848,P012801,0 days 00:07:09,-3,14,17
199,RED,P000848,P006436,0 days 00:05:38,-4,8,12
199,RED,P007960,P012044,0 days 00:05:19,-6,7,13
199,RED,P000848,P012044,0 days 00:05:09,-2,10,12
199,RED,P002553,P005099,0 days 00:04:55,-3,8,11
199,RED,P002553,P012801,0 days 00:04:19,4,8,4
199,RED,P005099,PLUO,0 days 00:04:16,5,13,8
199,RED,P012801,PLUO,0 days 00:04:16,5,13,8
199,RED,P011941,P012801,0 days 00:04:13,-5,6,11
199,RED,P007960,P011941,0 days 00:04:13,-5,6,11
199,RED,P000848,P011941,0 days 00:04:13,-5,6,11
199,RED,P005099,P011941,0 days 00:03:39,-5,4,9
199,RED,P006436,P008966,0 days 00:02:50,-3,8,11
199,RED,P008966,P012044,0 days 00:02:50,-3,8,11
199,RED,P008966,PLUO,0 days 00:02:50,-3,8,11
199,RED,P000848,P002553,0 days 00:02:06,2,5,3
199,RED,P002553,P008966,0 days 00:01:36,-2,3,5
199,RED,P008966,P009035,0 days 00:01:14,-1,5,6
199,RED,P011941,P012044,0 days 00:00:34,0,2,2
200,MUN,P001288,P011987,0 days 00:27:39,-5,45,50
200,MUN,P007975,P011987,0 days 00:18:45,3,32,29
200,MUN,P001288,P007975,0 days 00:16:59,-5,23,28
200,MUN,P001288,P005460,0 days 00:16:34,7,31,24
200,MUN,P005460,P007975,0 days 00:16:31,2,29,27
200,MUN,P005460,P011987,0 days 00:15:42,13,34,21
200,MUN,P001288,P007639,0 days 00:14:09,-19,14,33
200,MUN,P001288,P004508,0 days 00:13:05,-14,14,28
200,MUN,P007639,P011987,0 days 00:12:09,-15,14,29
200,MUN,P004508,P005460,0 days 00:12:01,-9,17,26
200,MUN,P001288,P008985,0 days 00:11:38,-1,22,23
200,MUN,P008985,P011987,0 days 00:11:38,-1,22,23
200,MUN,P004508,P011987,0 days 00:10:01,-7,14,21
200,MUN,P006760,P007975,0 days 00:09:58,5,23,18
200,MUN,P001288,P007056,0 days 00:08:50,2,17,15
200,MUN,P007639,P008985,0 days 00:08:40,-7,12,19
200,MUN,P005460,P006760,0 days 00:08:29,-1,17,18
200,MUN,P004508,P006760,0 days 00:08:27,-9,10,19
200,MUN,P010391,P011987,0 days 00:08:05,-3,11,14
200,MUN,P007975,P010391,0 days 00:07:59,-1,11,12
200,MUN,P004508,P007975,0 days 00:07:54,-11,7,18
200,MUN,P006760,P010391,0 days 00:07:52,-3,11,14
200,MUN,P007056,P011987,0 days 00:07:46,5,17,12
200,MUN,P004508,P007639,0 days 00:07:31,-10,7,17
200,MUN,P001557,P006760,0 days 00:07:30,-2,12,14
200,MUN,P007639,P010391,0 days 00:07:24,-9,7,16
200,MUN,P001288,P010391,0 days 00:07:15,-12,2,14
200,MUN,P006760,P011987,0 days 00:07:15,7,18,11
200,MUN,P007056,P007639,0 days 00:06:49,0,12,12
200,MUN,P001288,P006760,0 days 00:06:37,1,12,11
200,MUN,P004508,P008985,0 days 00:06:24,-3,12,15
200,MUN,P001557,P010391,0 days 00:05:45,0,12,12
200,MUN,P007056,P008985,0 days 00:05:44,0,10,10
200,MUN,P004508,P010391,0 days 00:05:14,-5,5,10
200,MUN,P001557,P004508,0 days 00:04:52,-4,6,10
200,MUN,P006760,P007639,0 days 00:04:35,-3,5,8
200,MUN,P001557,P007975,0 days 00:04:23,6,12,6
200,MUN,P007056,P007975,0 days 00:04:16,-1,9,10
200,MUN,P005460,P007056,0 days 00:03:36,1,9,8
200,MUN,P005460,P008985,0 days 00:03:28,4,10,6
200,MUN,P007639,P007975,0 days 00:03:23,-6,2,8
200,MUN,P005460,P010391,0 days 00:03:17,-1,3,4
200,MUN,P001557,P011987,0 days 00:02:56,3,9,6
200,MUN,P001557,P005460,0 days 00:02:54,0,6,6
200,MUN,P004508,P007056,0 days 00:02:39,-4,4,8
200,MUN,P001557,P007639,0 days 00:02:16,-3,3,6
200,MUN,P006760,P007056,0 days 00:01:35,-1,4,5
200,MUN,P001557,P008985,0 days 00:00:30,-2,0,2
200,MUN,P006760,P008985,0 days 00:00:30,-2,0,2
200,MUN,P007056,P010391,0 days 00:00:25,2,2,0
200,MUN,P001288,P001557,0 days 00:00:06,-2,0,2
200,ASV,P000229,P011225,0 days 00:28:07,14,56,42
200,ASV,P006568,P011225,0 days 00:24:36,13,52,39
200,ASV,P000229,P006568,0 days 00:24:28,13,50,37
200,ASV,P000229,P012729,0 days 00:24:02,14,50,36
200,ASV,P011225,P012729,0 days 00:23:30,12,50,38
200,ASV,P011225,P012731,0 days 00:22:31,19,45,26
200,ASV,P006568,P012729,0 days 00:22:30,10,46,36
200,ASV,P000229,P012731,0 days 00:21:06,-1,33,34
200,ASV,P004194,P012731,0 days 00:14:39,-3,22,25
200,ASV,P012729,P012731,0 days 00:14:04,11,29,18
200,ASV,P005094,P012731,0 days 00:13:20,-3,20,23
200,ASV,P006568,P012731,0 days 00:12:45,11,27,16
200,ASV,P004194,P005094,0 days 00:12:20,-3,20,23
200,ASV,P003526,P011225,0 days 00:12:05,3,25,22
200,ASV,P003526,P006568,0 days 00:11:38,1,23,22
200,ASV,P003526,P012729,0 days 00:11:38,1,23,22
200,ASV,P000229,P003526,0 days 00:10:59,-1,21,22
200,ASV,P005094,P011225,0 days 00:10:56,13,24,11
200,ASV,P004194,P011225,0 days 00:09:48,10,20,10
200,ASV,P000229,P005094,0 days 00:09:42,-9,12,21
200,ASV,P000229,P004194,0 days 00:09:14,-10,10,20
200,ASV,P004194,P011386,0 days 00:06:52,-3,12,15
200,ASV,P011386,P012731,0 days 00:06:52,-3,12,15
200,ASV,P005094,P011386,0 days 00:06:12,-5,10,15
200,ASV,P000229,P011386,0 days 00:05:23,-9,4,13
200,ASV,P005094,PKIR,0 days 00:03:53,2,8,6
200,ASV,P011225,PKIR,0 days 00:03:52,2,8,6
200,ASV,P005094,P006568,0 days 00:02:49,3,6,3
200,ASV,P004194,P012729,0 days 00:02:23,4,6,2
200,ASV,P003526,P012731,0 days 00:02:13,0,4,4
200,ASV,P011225,P011386,0 days 00:02:11,6,8,2
200,ASV,P004194,PKIR,0 days 00:02:06,1,4,3
200,ASV,P012731,PKIR,0 days 00:02:06,1,4,3
200,ASV,P006568,PKIR,0 days 00:01:47,1,4,3
200,ASV,P000229,PKIR,0 days 00:01:47,1,4,3
200,ASV,P011386,P012729,0 days 00:01:23,2,2,0
200,ASV,P003526,P004194,0 days 00:01:22,0,2,2
200,ASV,P003526,P005094,0 days 00:01:22,0,2,2
200,ASV,P003526,P011386,0 days 00:00:43,0,0,0
200,ASV,P006568,P011386,0 days 00:00:43,0,0,0
200,ASV,P005094,P012729,0 days 00:00:02,2,2,0
200,ASV,P011386,PKIR,0 days 00:00:01,0,0,0
201,ULK,P004004,P006661,0 days 00:26:01,14,58,44
201,ULK,P001932,P006661,0 days 00:23:02,20,58,38
201,ULK,P006661,P011157,0 days 00:22:44,11,53,42
201,ULK,P004004,P011157,0 days 00:22:17,1,44,43
201,ULK,P001932,P011157,0 days 00:20:42,15,51,36
201,ULK,P001932,P004004,0 days 00:19:30,11,43,32
201,ULK,P006068,P006661,0 days 00:15:55,23,42,19
201,ULK,P004004,P005844,0 days 00:15:33,-4,30,34
201,ULK,P005844,P011157,0 days 00:13:48,-6,25,31
201,ULK,P006068,P011157,0 days 00:13:00,10,31,21
201,ULK,P001932,P006068,0 days 00:12:56,17,33,16
201,ULK,P005844,P006661,0 days 00:12:48,-1,26,27
201,ULK,P004004,P006068,0 days 00:12:23,14,27,13
201,ULK,P009849,P011157,0 days 00:11:56,-7,24,31
201,ULK,P009849,P011052,0 days 00:10:41,-10,15,25
201,ULK,P004004,P011052,0 days 00:09:30,0,17,17
201,ULK,P002968,P011052,0 days 00:09:08,5,20,15
201,ULK,P001932,P005844,0 days 00:08:22,4,20,16
201,ULK,P006068,P011052,0 days 00:08:18,3,20,17
201,ULK,P002968,P006068,0 days 00:08:14,10,22,12
201,ULK,P002968,P006661,0 days 00:08:04,10,20,10
201,ULK,P006068,P009849,0 days 00:08:01,5,22,17
201,ULK,P002968,P004004,0 days 00:07:37,8,18,10
201,ULK,P005844,P011052,0 days 00:07:25,-8,8,16
201,ULK,P011052,P011157,0 days 00:06:56,-10,8,18
201,ULK,P006661,P011052,0 days 00:06:52,3,13,10
201,ULK,P006661,P009849,0 days 00:06:49,3,18,15
201,ULK,P004004,P009849,0 days 00:06:45,-8,11,19
201,ULK,P002969,P006068,0 days 00:06:09,-2,15,17
201,ULK,P005844,P009849,0 days 00:05:55,-9,6,15
201,ULK,P002969,P009849,0 days 00:05:26,-3,11,14
201,ULK,P002969,P011052,0 days 00:05:26,-3,11,14
201,ULK,P001932,P009849,0 days 00:04:26,7,16,9
201,ULK,P002968,P009849,0 days 00:04:05,2,9,7
201,ULK,P002968,P002969,0 days 00:03:31,0,7,7
201,ULK,P002968,P005844,0 days 00:02:53,0,5,5
201,ULK,P002969,P011157,0 days 00:02:45,-2,8,10
201,ULK,P001932,P002968,0 days 00:02:20,5,7,2
201,ULK,P002969,P006661,0 days 00:00:57,1,4,3
201,ULK,P001932,P002969,0 days 00:00:50,1,4,3
201,VIR,P001844,P010781,0 days 00:27:14,-10,47,57
201,VIR,P009549,P010781,0 days 00:23:21,0,53,53
201,VIR,P003527,P010781,0 days 00:21:22,-6,37,43
201,VIR,P004554,P009549,0 days 00:21:14,2,43,41
201,VIR,P008847,P010781,0 days 00:19:31,-8,40,48
201,VIR,P001844,P003527,0 days 00:19:16,-2,34,36
201,VIR,P001844,P009549,0 days 00:18:02,-9,35,44
201,VIR,P001844,P008847,0 days 00:17:55,-6,36,42
201,VIR,P004554,P010781,0 days 00:16:45,9,38,29
201,VIR,P003048,P010781,0 days 00:14:58,-10,25,35
201,VIR,P001844,P004554,0 days 00:13:46,-4,25,29
201,VIR,P001844,P003048,0 days 00:13:24,-7,21,28
201,VIR,P003048,P003527,0 days 00:12:54,-8,18,26
201,VIR,P003527,P008847,0 days 00:12:51,-6,24,30
201,VIR,P003048,P008847,0 days 00:12:40,-6,24,30
201,VIR,P006739,P009549,0 days 00:12:37,-2,24,26
201,VIR,P002084,P009549,0 days 00:12:35,-8,22,30
201,VIR,P002084,P004554,0 days 00:11:39,-5,22,27
201,VIR,P004554,P006739,0 days 00:09:40,2,19,17
201,VIR,P002084,P010781,0 days 00:09:40,-3,17,20
201,VIR,P003527,P009549,0 days 00:09:12,0,20,20
201,VIR,P006739,P010781,0 days 00:09:06,3,22,19
201,VIR,P008847,P009549,0 days 00:08:55,-4,23,27
201,VIR,P002084,P006739,0 days 00:08:45,3,18,15
201,VIR,P001844,P002084,0 days 00:07:17,-17,5,22
201,VIR,P003527,P004554,0 days 00:05:59,4,12,8
201,VIR,P004554,P008847,0 days 00:03:17,3,9,6
201,VIR,P001844,P006739,0 days 00:02:56,-3,2,5
201,VIR,P003048,P009549,0 days 00:02:48,-4,8,12
201,VIR,P004554,P005553,0 days 00:02:36,-3,4,7
201,VIR,P005553,P009549,0 days 00:02:36,-3,4,7
201,VIR,P002084,P005553,0 days 00:02:36,-3,4,7
201,VIR,P006739,P008847,0 days 00:02:13,-2,4,6
201,VIR,P003527,P006739,0 days 00:02:06,-4,3,7
201,VIR,P002084,P003527,0 days 00:01:48,-2,0,2
201,VIR,P002084,P003048,0 days 00:01:34,-2,0,2
201,VIR,P003048,P006739,0 days 00:01:34,-3,4,7
201,VIR,P005553,P006739,0 days 00:01:31,-2,0,2
201,VIR,P001844,P005553,0 days 00:00:58,-2,3,5
201,VIR,P002084,P008847,0 days 00:00:42,-3,0,3
201,VIR,P005553,P010781,0 days 00:00:07,1,1,0
202,TEL,P009783,P011199,0 days 00:30:35,30,78,48
202,TEL,P009622,P009783,0 days 00:30:30,25,72,47
202,TEL,P009622,P011199,0 days 00:28:37,27,72,45
202,TEL,P009783,P009863,0 days 00:26:18,19,67,48
202,TEL,P009863,P011199,0 days 00:23:32,23,62,39
202,TEL,P009622,P009863,0 days 00:23:01,18,56,38
202,TEL,P009783,P011971,0 days 00:20:05,24,56,32
202,TEL,P009622,P011971,0 days 00:20:04,20,51,31
202,TEL,P011199,P011971,0 days 00:16:53,28,51,23
202,TEL,P009863,P011971,0 days 00:16:20,11,44,33
202,TEL,P011193,P011219,0 days 00:10:40,-14,15,29
202,TEL,P005145,P011199,0 days 00:09:15,5,19,14
202,TEL,P005145,P009783,0 days 00:09:15,5,19,14
202,TEL,P005145,P009863,0 days 00:09:15,5,19,14
202,TEL,P005145,P009622,0 days 00:09:15,5,19,14
202,TEL,P011193,P011214,0 days 00:07:58,-13,12,25
202,TEL,P009863,P011193,0 days 00:07:39,-4,18,22
202,TEL,P009863,P011214,0 days 00:07:08,-9,12,21
202,TEL,P009863,P011219,0 days 00:06:20,-2,13,15
202,TEL,P011214,P011219,0 days 00:06:13,-11,7,18
202,TEL,P009783,P011193,0 days 00:06:12,-5,13,18
202,TEL,P011214,P011971,0 days 00:05:45,-10,7,17
202,TEL,P009622,P011193,0 days 00:04:46,-12,2,14
202,TEL,P007990,P011199,0 days 00:04:34,13,14,1
202,TEL,P007990,P011971,0 days 00:04:34,13,14,1
202,TEL,P007990,P009783,0 days 00:04:34,13,14,1
202,TEL,P007990,P009622,0 days 00:04:34,13,14,1
202,TEL,P011199,P011219,0 days 00:04:27,-3,8,11
202,TEL,P009783,P011219,0 days 00:04:27,-3,8,11
202,TEL,P011193,P011199,0 days 00:04:27,-3,8,11
202,TEL,P009622,P011219,0 days 00:04:20,-12,2,14
202,TEL,P011193,P011971,0 days 00:04:18,-8,7,15
202,TEL,P009622,P011214,0 days 00:03:44,-8,0,8
202,TEL,P004233,P011214,0 days 00:03:40,-5,5,10
202,TEL,P004233,P011219,0 days 00:03:40,-5,5,10
202,TEL,P004233,P011193,0 days 00:03:40,-5,5,10
202,TEL,P009783,P011214,0 days 00:03:12,-4,5,9
202,TEL,P004233,P009863,0 days 00:03:07,-5,5,10
202,TEL,P011219,P011971,0 days 00:02:33,-6,2,8
202,TEL,P004233,P009622,0 days 00:00:33,0,0,0
202,PAN,P007866,P011204,0 days 00:27:03,-20,46,66
202,PAN,P002328,P011204,0 days 00:21:19,-8,41,49
202,PAN,P003842,P011204,0 days 00:21:02,-25,31,56
202,PAN,P003842,P007866,0 days 00:20:26,-26,28,54
202,PAN,P011204,P012774,0 days 00:18:56,-17,31,48
202,PAN,P003842,P012774,0 days 00:18:45,-17,26,43
202,PAN,P007866,P012774,0 days 00:18:20,-18,28,46
202,PAN,P011204,P011209,0 days 00:15:27,9,37,28
202,PAN,P011209,P012712,0 days 00:15:17,4,32,28
202,PAN,P002328,P011209,0 days 00:14:45,-2,31,33
202,PAN,P002328,P003842,0 days 00:14:44,-17,23,40
202,PAN,P002328,P012774,0 days 00:13:45,-11,22,33
202,PAN,P011204,P011221,0 days 00:13:43,15,36,21
202,PAN,P002328,P012712,0 days 00:13:39,4,29,25
202,PAN,P002328,P007866,0 days 00:13:37,-18,20,38
202,PAN,P011209,P011221,0 days 00:13:31,12,31,19
202,PAN,P002328,P011221,0 days 00:11:50,4,26,22
202,PAN,P011204,P012712,0 days 00:11:20,9,27,18
202,PAN,P005161,P007866,0 days 00:10:10,-3,19,22
202,PAN,P005161,P011204,0 days 00:10:10,-3,19,22
202,PAN,P011221,P012712,0 days 00:09:43,5,22,17
202,PAN,P007866,P011209,0 days 00:08:21,0,19,19
202,PAN,P005161,P012774,0 days 00:07:29,-8,12,20
202,PAN,P003842,P011209,0 days 00:07:11,-8,14,22
202,PAN,P005161,P011221,0 days 00:07:07,3,18,15
202,PAN,P003842,P012712,0 days 00:06:52,-1,13,14
202,PAN,P007866,P011221,0 days 00:06:37,6,18,12
202,PAN,P003842,P005161,0 days 00:05:40,-10,5,15
202,PAN,P005161,P011209,0 days 00:05:18,1,11,10
202,PAN,P007866,P012712,0 days 00:03:38,-1,6,7
202,PAN,P012712,P012774,0 days 00:03:14,0,7,7
202,PAN,P011209,P012774,0 days 00:02:58,0,5,5
202,PAN,P011221,P012774,0 days 00:02:49,-1,9,10
202,PAN,P002328,P005161,0 days 00:02:37,-4,4,8
202,PAN,P005161,P012712,0 days 00:02:37,-4,4,8
203,MAD,P004887,P005928,0 days 00:25:12,7,64,57
203,MAD,P005928,P009005,0 days 00:24:39,6,59,53
203,MAD,P004887,P009005,0 days 00:23:18,4,57,53
203,MAD,P004887,P006540,0 days 00:23:10,1,53,52
203,MAD,P005928,P006540,0 days 00:22:04,-1,51,52
203,MAD,P003733,P004887,0 days 00:20:27,15,51,36
203,MAD,P003733,P005928,0 days 00:20:19,15,51,36
203,MAD,P006540,P009005,0 days 00:20:10,-4,44,48
203,MAD,P003733,P006540,0 days 00:18:50,7,43,36
203,MAD,P003733,P009005,0 days 00:18:25,12,44,32
203,MAD,P001392,P003108,0 days 00:12:44,-4,25,29
203,MAD,P001392,PBMT,0 days 00:12:34,-4,22,26
203,MAD,P001392,PCVM,0 days 00:12:17,-4,22,26
203,MAD,P003108,PCVM,0 days 00:12:15,0,22,22
203,MAD,PBMT,PCVM,0 days 00:12:07,-2,22,24
203,MAD,P003108,PBMT,0 days 00:11:03,-2,20,22
203,MAD,P009213,PBMT,0 days 00:11:02,-2,17,19
203,MAD,P001392,P009213,0 days 00:10:14,-6,15,21
203,MAD,P009213,PCVM,0 days 00:09:47,-4,15,19
203,MAD,P003108,P009213,0 days 00:08:43,-4,13,17
203,MAD,P003108,P004887,0 days 00:08:21,4,23,19
203,MAD,P001392,P004887,0 days 00:07:01,-5,20,25
203,MAD,P001392,P009005,0 days 00:06:06,-9,15,24
203,MAD,P001392,P005928,0 days 00:04:54,-5,13,18
203,MAD,P003108,P005928,0 days 00:04:45,2,14,12
203,MAD,P003108,P006540,0 days 00:04:20,4,11,7
203,MAD,P009005,PBMT,0 days 00:04:10,6,12,6
203,MAD,P004887,PBMT,0 days 00:04:07,8,15,7
203,MAD,P004887,PCVM,0 days 00:03:36,2,9,7
203,MAD,P003108,P003733,0 days 00:03:10,3,9,6
203,MAD,P001392,P006540,0 days 00:03:00,-5,8,13
203,MAD,P005928,PBMT,0 days 00:02:58,10,10,0
203,MAD,P003108,P009005,0 days 00:02:55,-3,7,10
203,MAD,P003733,PBMT,0 days 00:02:35,10,10,0
203,MAD,P009005,P009213,0 days 00:02:33,-2,4,6
203,MAD,P005928,P009213,0 days 00:01:21,2,2,0
203,MAD,P003733,PCVM,0 days 00:01:16,0,2,2
203,MAD,P009005,PCVM,0 days 00:01:08,-2,2,4
203,MAD,P003733,P009213,0 days 00:01:08,0,2,2
203,MAD,P006540,PCVM,0 days 00:01:06,2,2,0
203,MAD,P001392,P003733,0 days 00:00:10,-2,0,2
203,OLY,P001255,P006589,0 days 00:22:21,5,49,44
203,OLY,P008829,P008855,0 days 00:21:14,-5,45,50
203,OLY,P008829,P010612,0 days 00:19:56,-10,36,46
203,OLY,P008855,P010612,0 days 00:19:49,-10,36,46
203,OLY,P006589,P007853,0 days 00:19:48,-6,40,46
203,OLY,P001255,P007853,0 days 00:19:28,3,45,42
203,OLY,P001255,P011965,0 days 00:18:16,1,42,41
203,OLY,P007853,P011965,0 days 00:17:37,1,40,39
203,OLY,P006589,P011965,0 days 00:16:55,-2,35,37
203,OLY,P010612,P011194,0 days 00:14:37,-7,27,34
203,OLY,P008855,P011194,0 days 00:14:37,-7,27,34
203,OLY,P008829,P011194,0 days 00:14:37,-7,27,34
203,OLY,P001255,P008829,0 days 00:12:42,14,40,26
203,OLY,P001255,P008855,0 days 00:12:03,21,42,21
203,OLY,P006589,P008829,0 days 00:11:10,-1,25,26
203,OLY,P007853,P008829,0 days 00:10:32,-9,23,32
203,OLY,P007853,P008855,0 days 00:10:32,-2,27,29
203,OLY,P006589,P008855,0 days 00:10:31,6,27,21
203,OLY,P011194,P011983,0 days 00:10:30,-7,15,22
203,OLY,P010612,P011983,0 days 00:10:30,-7,15,22
203,OLY,P008829,P011983,0 days 00:10:30,-7,15,22
203,OLY,P008855,P011983,0 days 00:10:30,-7,15,22
203,OLY,P006589,P010392,0 days 00:10:04,-3,19,22
203,OLY,P001255,P010392,0 days 00:10:00,-5,17,22
203,OLY,P007853,P010392,0 days 00:09:32,-3,17,20
203,OLY,P010392,P011965,0 days 00:08:09,-7,12,19
203,OLY,P008829,P011965,0 days 00:07:15,3,21,18
203,OLY,P001255,P010612,0 days 00:05:34,11,19,8
203,OLY,P006589,P010612,0 days 00:05:19,-3,9,12
203,OLY,P008855,P011965,0 days 00:04:45,8,18,10
203,OLY,P007853,P010612,0 days 00:03:52,-14,2,16
203,OLY,P007853,P011194,0 days 00:02:15,-6,2,8
203,OLY,P008855,P010392,0 days 00:01:55,4,7,3
203,OLY,P001255,P011194,0 days 00:01:52,6,10,4
203,OLY,P008829,P010392,0 days 00:00:36,2,4,2
203,OLY,P010612,P011965,0 days 00:00:07,0,0,0
204,IST,P006590,P009846,0 days 00:21:13,12,50,38
204,IST,P006590,P009664,0 days 00:18:35,5,37,32
204,IST,P004888,P006590,0 days 00:17:58,1,37,36
204,IST,P004888,P011078,0 days 00:17:54,-13,31,44
204,IST,P007200,P009664,0 days 00:17:51,4,35,31
204,IST,P009846,P011078,0 days 00:17:04,4,37,33
204,IST,P009846,P012788,0 days 00:16:22,8,38,30
204,IST,P009664,P009846,0 days 00:16:16,7,37,30
204,IST,P007200,P009846,0 days 00:15:26,8,37,29
204,IST,P006590,P011078,0 days 00:15:00,-1,32,33
204,IST,P006590,P012788,0 days 00:14:16,7,34,27
204,IST,P006590,P007200,0 days 00:14:07,10,31,21
204,IST,P011078,P012788,0 days 00:13:59,1,30,29
204,IST,P007200,PLHK,0 days 00:13:29,-7,24,31
204,IST,P009664,P011078,0 days 00:13:20,-5,24,29
204,IST,P009664,PLHK,0 days 00:12:46,-6,26,32
204,IST,P004888,P012788,0 days 00:11:22,3,28,25
204,IST,P004888,P009846,0 days 00:11:11,6,26,20
204,IST,P004888,P011981,0 days 00:11:03,-5,13,18
204,IST,P004888,P007200,0 days 00:10:33,-8,12,20
204,IST,P011078,PLHK,0 days 00:10:00,-15,13,28
204,IST,P007200,P011078,0 days 00:09:46,-13,13,26
204,IST,P009846,PLHK,0 days 00:09:19,2,22,20
204,IST,P007200,P011981,0 days 00:08:56,-6,10,16
204,IST,P004888,P009664,0 days 00:08:39,-5,11,16
204,IST,P006590,PLHK,0 days 00:07:57,-4,19,23
204,IST,P006590,P011981,0 days 00:07:22,6,12,6
204,IST,P011078,P011981,0 days 00:06:29,-6,8,14
204,IST,P004888,PLHK,0 days 00:06:24,-15,6,21
204,IST,P009664,P011981,0 days 00:06:04,6,10,4
204,IST,P009664,P012788,0 days 00:06:01,2,12,10
204,IST,P007200,P012788,0 days 00:05:24,0,14,14
204,IST,P011981,PLHK,0 days 00:02:57,-7,2,9
204,IST,P009846,P011981,0 days 00:02:49,5,5,0
204,IST,P011981,P012788,0 days 00:02:08,-1,4,5
204,MCO,P005985,P010588,0 days 00:25:28,-5,47,52
204,MCO,P005985,P011226,0 days 00:23:02,-5,44,49
204,MCO,P011212,P011226,0 days 00:20:01,1,38,37
204,MCO,P011212,PLCZ,0 days 00:16:48,15,38,23
204,MCO,P009754,P011226,0 days 00:15:57,3,36,33
204,MCO,P005985,P009754,0 days 00:15:23,3,34,31
204,MCO,P005985,P011212,0 days 00:15:18,5,31,26
204,MCO,P010588,P011226,0 days 00:15:16,-11,25,36
204,MCO,P011226,PLCZ,0 days 00:14:45,10,31,21
204,MCO,P011226,P011231,0 days 00:14:00,1,32,31
204,MCO,P011212,P011231,0 days 00:12:55,5,33,28
204,MCO,P005985,PLCZ,0 days 00:12:40,11,26,15
204,MCO,P009754,P010588,0 days 00:11:28,0,26,26
204,MCO,P005985,P011231,0 days 00:11:14,5,28,23
204,MCO,P010588,P011212,0 days 00:10:40,0,18,18
204,MCO,P010588,PLCZ,0 days 00:10:25,4,17,13
204,MCO,P002581,P009754,0 days 00:10:21,2,26,24
204,MCO,P002581,P010588,0 days 00:10:21,2,26,24
204,MCO,P002581,P005985,0 days 00:10:21,2,26,24
204,MCO,P011196,P011231,0 days 00:10:06,-4,15,19
204,MCO,P005985,P011196,0 days 00:09:58,-8,13,21
204,MCO,P009754,P011231,0 days 00:09:54,2,20,18
204,MCO,P011196,P011226,0 days 00:09:32,-9,12,21
204,MCO,P011231,PLCZ,0 days 00:07:39,14,26,12
204,MCO,P009754,P011212,0 days 00:07:33,3,16,13
204,MCO,P009754,P011196,0 days 00:06:53,-4,8,12
204,MCO,P002581,P011226,0 days 00:05:16,-1,14,15
204,MCO,P004197,P010588,0 days 00:05:05,3,12,9
204,MCO,P004197,P009754,0 days 00:05:05,3,12,9
204,MCO,P004197,P005985,0 days 00:05:05,3,12,9
204,MCO,P002581,P004197,0 days 00:05:05,3,12,9
204,MCO,P011196,P011212,0 days 00:05:01,-5,6,11
204,MCO,P009754,PLCZ,0 days 00:04:55,6,14,8
204,MCO,P005985,P012709,0 days 00:04:27,-7,3,10
204,MCO,P010588,P011196,0 days 00:04:27,-7,3,10
204,MCO,P010588,P012709,0 days 00:04:27,-7,3,10
204,MCO,P011196,P012709,0 days 00:04:27,-7,3,10
204,MCO,P010588,P011231,0 days 00:04:15,1,11,10
204,MCO,P011231,P012709,0 days 00:01:57,0,3,3
204,MCO,P011226,P012709,0 days 00:01:23,-5,0,5
204,MCO,P009754,P012709,0 days 00:01:07,-2,0,2
205,MIL,P007831,P011224,0 days 00:28:03,4,57,53
205,MIL,P002849,P007831,0 days 00:23:56,4,51,47
205,MIL,P002849,P011224,0 days 00:23:21,0,48,48
205,MIL,P011205,P011224,0 days 00:20:26,-11,35,46
205,MIL,P002849,P011205,0 days 00:20:13,-14,32,46
205,MIL,P007831,P011205,0 days 00:20:11,-11,35,46
205,MIL,P007831,P009960,0 days 00:14:36,-4,26,30
205,MIL,P009960,P011224,0 days 00:14:20,-2,26,28
205,MIL,P007831,P012800,0 days 00:13:16,16,34,18
205,MIL,P002849,P009960,0 days 00:13:02,-5,22,27
205,MIL,P007201,P007831,0 days 00:11:32,13,27,14
205,MIL,P007201,P011205,0 days 00:10:28,2,18,16
205,MIL,P002812,P012800,0 days 00:10:12,4,18,14
205,MIL,P009960,P011205,0 days 00:09:42,-6,17,23
205,MIL,P011224,P012800,0 days 00:09:18,14,27,13
205,MIL,P001518,P007831,0 days 00:09:01,-2,15,17
205,MIL,P007201,P011224,0 days 00:08:54,4,18,14
205,MIL,P001518,P012800,0 days 00:08:51,-1,13,14
205,MIL,P002849,P012800,0 days 00:08:46,10,23,13
205,MIL,P005670,P012800,0 days 00:08:44,5,13,8
205,MIL,P007201,P012800,0 days 00:08:06,14,20,6
205,MIL,P002849,P007201,0 days 00:07:48,3,16,13
205,MIL,P011205,P012800,0 days 00:06:58,-1,11,12
205,MIL,P001518,P011224,0 days 00:06:54,4,15,11
205,MIL,P002812,P011205,0 days 00:06:30,-3,12,15
205,MIL,P002812,P007831,0 days 00:06:24,-2,12,14
205,MIL,P001518,P011205,0 days 00:06:00,-4,6,10
205,MIL,P002812,P007201,0 days 00:05:51,9,14,5
205,MIL,P009960,P012800,0 days 00:05:47,2,9,7
205,MIL,P005670,P011205,0 days 00:05:32,0,6,6
205,MIL,P005670,P007201,0 days 00:05:20,7,11,4
205,MIL,P002812,P005670,0 days 00:05:11,5,8,3
205,MIL,P001518,P002849,0 days 00:05:01,4,11,7
205,MIL,P002812,P011224,0 days 00:04:04,-1,10,11
205,MIL,P001518,P002812,0 days 00:03:38,-7,2,9
205,MIL,P002849,P005670,0 days 00:03:33,0,5,5
205,MIL,P001518,P009960,0 days 00:03:20,1,4,3
205,MIL,P001518,P005670,0 days 00:03:08,0,2,2
205,MIL,P005670,P007831,0 days 00:02:19,5,7,2
205,MIL,P002812,P002849,0 days 00:01:56,-2,4,6
205,MIL,P002812,P007032,0 days 00:01:54,-3,0,3
205,MIL,P007032,P012800,0 days 00:01:54,-3,0,3
205,MIL,P007032,P007831,0 days 00:01:54,-3,0,3
205,MIL,P001518,P007032,0 days 00:01:40,-3,0,3
205,MIL,P005670,P009960,0 days 00:01:09,-2,0,2
205,MIL,P001518,P007201,0 days 00:01:03,0,0,0
205,MIL,P007032,P007201,0 days 00:00:14,0,0,0
205,BAR,P000925,P004866,0 days 00:25:21,9,53,44
205,BAR,P002939,P004866,0 days 00:25:14,1,50,49
205,BAR,P000925,P012745,0 days 00:23:40,11,53,42
205,BAR,P002939,P012745,0 days 00:23:16,6,53,47
205,BAR,P004866,P012745,0 days 00:22:40,7,48,41
205,BAR,P000925,P002939,0 days 00:21:43,10,53,43
205,BAR,P007519,P012745,0 days 00:17:50,10,43,33
205,BAR,P004866,P007519,0 days 00:17:24,13,38,25
205,BAR,P009992,P012745,0 days 00:16:30,-8,29,37
205,BAR,P000925,P007519,0 days 00:15:49,20,40,20
205,BAR,P002939,P007519,0 days 00:13:07,12,37,25
205,BAR,P000925,P009992,0 days 00:13:03,-2,23,25
205,BAR,P002939,P009992,0 days 00:13:01,-6,23,29
205,BAR,P004866,P006435,0 days 00:12:13,-6,10,16
205,BAR,P004866,P009992,0 days 00:11:39,-6,18,24
205,BAR,P006435,P011244,0 days 00:10:35,-6,10,16
205,BAR,P004866,P011244,0 days 00:10:35,-6,10,16
205,BAR,P003196,P011244,0 days 00:08:56,-10,6,16
205,BAR,P003196,P006435,0 days 00:08:22,-9,5,14
205,BAR,P003196,P007519,0 days 00:08:20,-12,10,22
205,BAR,P007519,P009992,0 days 00:08:11,-4,14,18
205,BAR,P003196,P004866,0 days 00:07:54,-8,5,13
205,BAR,P002939,P003196,0 days 00:07:15,-10,4,14
205,BAR,P006435,P007519,0 days 00:06:35,-1,6,7
205,BAR,P002939,P006435,0 days 00:06:34,-7,4,11
205,BAR,P007519,P011244,0 days 00:06:19,-2,7,9
205,BAR,P002939,P011244,0 days 00:05:42,-6,4,10
205,BAR,P003196,P009992,0 days 00:04:53,-8,7,15
205,BAR,P000925,P006435,0 days 00:04:19,2,5,3
205,BAR,P003196,P012745,0 days 00:04:19,-7,6,13
205,BAR,P000925,P011244,0 days 00:03:05,2,5,3
205,BAR,P003196,P007464,0 days 00:03:01,-4,5,9
205,BAR,P007464,P007519,0 days 00:03:01,-4,5,9
205,BAR,P007464,P009992,0 days 00:03:01,-4,5,9
205,BAR,P006435,P012745,0 days 00:02:06,-1,0,1
205,BAR,P007464,P012745,0 days 00:01:35,-2,4,6
205,BAR,P007464,P011244,0 days 00:01:26,-2,1,3
205,BAR,P009992,P011244,0 days 00:01:26,-2,1,3
206,PAR,P009862,P012742,0 days 00:25:54,4,57,53
206,PAR,P007400,P008987,0 days 00:20:12,9,42,33
206,PAR,P007400,P012742,0 days 00:19:05,15,46,31
206,PAR,P011051,P012742,0 days 00:18:39,1,38,37
206,PAR,P009862,P011051,0 days 00:17:25,1,36,35
206,PAR,P007400,P011051,0 days 00:17:22,8,34,26
206,PAR,P007400,P009862,0 days 00:17:19,13,42,29
206,PAR,P007673,P008987,0 days 00:16:38,3,29,26
206,PAR,P008987,P012742,0 days 00:16:27,-3,37,40
206,PAR,P003983,P007400,0 days 00:15:33,6,26,20
206,PAR,P008987,P009862,0 days 00:15:06,-5,33,38
206,PAR,P007400,P012743,0 days 00:14:48,16,39,23
206,PAR,P003983,P008987,0 days 00:13:50,5,24,19
206,PAR,P007400,P007673,0 days 00:13:06,3,20,17
206,PAR,P012096,P012742,0 days 00:12:50,-6,27,33
206,PAR,P009862,P012096,0 days 00:12:50,-6,27,33
206,PAR,P003983,P007673,0 days 00:12:45,3,20,17
206,PAR,P008987,P012096,0 days 00:12:35,-10,18,28
206,PAR,P008987,P011051,0 days 00:11:23,-9,18,27
206,PAR,P012742,P012743,0 days 00:09:28,10,24,14
206,PAR,P008987,P012743,0 days 00:08:57,10,27,17
206,PAR,P009862,P012743,0 days 00:08:56,8,22,14
206,PAR,P011051,P012096,0 days 00:08:32,-6,18,24
206,PAR,P007673,P012096,0 days 00:08:18,-1,12,13
206,PAR,P007400,P012096,0 days 00:08:15,2,15,13
206,PAR,P003983,P012743,0 days 00:06:49,9,19,10
206,PAR,P007673,P012743,0 days 00:05:20,6,15,9
206,PAR,P007673,P012742,0 days 00:05:04,0,9,9
206,PAR,P011051,P012743,0 days 00:04:54,5,10,5
206,PAR,P007673,P009862,0 days 00:04:39,0,9,9
206,PAR,P003983,P011051,0 days 00:04:35,-2,4,6
206,PAR,P003983,P012096,0 days 00:04:00,-1,3,4
206,PAR,P007673,P011051,0 days 00:03:46,-2,2,4
206,PAR,P003983,P012742,0 days 00:03:13,3,6,3
206,PAR,P003983,P009862,0 days 00:01:27,1,2,1
206,ZAL,P007109,P011218,0 days 00:21:30,1,41,40
206,ZAL,P007513,P011218,0 days 00:18:40,0,40,40
206,ZAL,P010390,P011218,0 days 00:17:38,1,31,30
206,ZAL,P002329,P011218,0 days 00:17:08,0,32,32
206,ZAL,P002329,P007109,0 days 00:16:15,3,30,27
206,ZAL,P002676,P007513,0 days 00:15:48,-4,32,36
206,ZAL,P007109,P007513,0 days 00:15:06,-12,26,38
206,ZAL,P002676,P011218,0 days 00:14:51,3,34,31
206,ZAL,P002676,P010390,0 days 00:14:42,1,32,31
206,ZAL,P005504,P007109,0 days 00:14:41,-1,28,29
206,ZAL,P010390,P012715,0 days 00:14:05,4,27,23
206,ZAL,P005504,P011218,0 days 00:12:57,5,30,25
206,ZAL,P005504,P007513,0 days 00:12:37,-5,28,33
206,ZAL,P011218,P012715,0 days 00:12:30,1,22,21
206,ZAL,P002676,P012715,0 days 00:12:04,0,23,23
206,ZAL,P007513,P012715,0 days 00:11:55,-1,23,24
206,ZAL,P007513,P010390,0 days 00:11:30,-4,21,25
206,ZAL,P002676,P007109,0 days 00:11:04,-7,22,29
206,ZAL,P002329,P005504,0 days 00:10:04,5,21,16
206,ZAL,P007109,P010390,0 days 00:09:10,-7,15,22
206,ZAL,P002329,P007513,0 days 00:08:15,-2,17,19
206,ZAL,P003210,P007513,0 days 00:07:19,-11,9,20
206,ZAL,P002329,P010390,0 days 00:07:04,-5,11,16
206,ZAL,P003211,P011218,0 days 00:06:48,3,8,5
206,ZAL,P002676,P003210,0 days 00:06:20,-8,9,17
206,ZAL,P002676,P005504,0 days 00:05:51,-4,11,15
206,ZAL,P003211,P010390,0 days 00:05:35,0,8,8
206,ZAL,P003210,P007109,0 days 00:05:32,-11,4,15
206,ZAL,P003210,P012715,0 days 00:05:23,-2,9,11
206,ZAL,P003210,P005504,0 days 00:04:59,-9,4,13
206,ZAL,P003210,P010390,0 days 00:04:18,-4,9,13
206,ZAL,P003211,P012715,0 days 00:04:14,0,6,6
206,ZAL,P012715,P012787,0 days 00:04:06,2,6,4
206,ZAL,P002329,P003211,0 days 00:04:02,1,4,3
206,ZAL,P003211,P007109,0 days 00:04:02,1,4,3
206,ZAL,P010390,P012787,0 days 00:03:42,2,6,4
206,ZAL,P003211,P012787,0 days 00:03:42,2,6,4
206,ZAL,P002329,P002676,0 days 00:03:32,1,9,8
206,ZAL,P011218,P012787,0 days 00:02:46,2,4,2
206,ZAL,P007109,P012715,0 days 00:02:46,-2,2,4
206,ZAL,P003211,P005504,0 days 00:02:41,1,2,1
206,ZAL,P003210,P012787,0 days 00:02:02,-5,2,7
206,ZAL,P005504,P012715,0 days 00:01:56,-3,4,7
206,ZAL,P003210,P011218,0 days 00:01:44,0,2,2
206,ZAL,P003210,P003211,0 days 00:01:28,-2,2,4
206,ZAL,P002329,P003210,0 days 00:01:19,0,2,2
206,ZAL,P007109,P012787,0 days 00:01:06,-5,0,5
206,ZAL,P007513,P012787,0 days 00:01:06,-5,0,5
206,ZAL,P002329,P012715,0 days 00:00:53,-3,2,5
206,ZAL,P005504,P012787,0 days 00:00:42,-5,0,5
206,ZAL,P002676,P003211,0 days 00:00:32,-2,0,2
207,BAS,P004761,P007230,0 days 00:20:28,-11,27,38
207,BAS,P007230,P012201,0 days 00:20:06,0,32,32
207,BAS,P010444,P012201,0 days 00:19:38,3,38,35
207,BAS,P004761,P009048,0 days 00:19:32,-15,17,32
207,BAS,P004761,P012201,0 days 00:19:27,-1,28,29
207,BAS,P009048,P012201,0 days 00:19:21,-13,21,34
207,BAS,P007230,P009048,0 days 00:17:51,-18,13,31
207,BAS,P004603,P007230,0 days 00:16:19,-14,20,34
207,BAS,P007230,P011948,0 days 00:16:03,-9,25,34
207,BAS,P007230,P007946,0 days 00:15:46,5,36,31
207,BAS,P004761,P010444,0 days 00:14:59,2,25,23
207,BAS,P004603,P011948,0 days 00:12:19,-13,17,30
207,BAS,P007946,P012201,0 days 00:12:17,8,29,21
207,BAS,P007230,P010444,0 days 00:12:03,5,25,20
207,BAS,P009048,P010444,0 days 00:11:18,-8,14,22
207,BAS,P007946,P011948,0 days 00:11:17,-5,25,30
207,BAS,P007946,P010444,0 days 00:11:05,8,29,21
207,BAS,P004603,P004761,0 days 00:10:47,-10,10,20
207,BAS,P004603,P009048,0 days 00:10:05,-8,8,16
207,BAS,P009048,P011948,0 days 00:09:18,-10,10,20
207,BAS,P007230,P008850,0 days 00:08:13,-6,14,20
207,BAS,P004761,P007946,0 days 00:07:38,5,18,13
207,BAS,P004761,P011948,0 days 00:06:47,-9,7,16
207,BAS,P004603,P007946,0 days 00:06:14,-6,12,18
207,BAS,P007946,P008850,0 days 00:05:50,-4,10,14
207,BAS,P011948,P012201,0 days 00:05:33,1,13,12
207,BAS,P004603,P008850,0 days 00:05:32,-4,10,14
207,BAS,P008850,P011948,0 days 00:05:32,-4,10,14
207,BAS,P003198,P004761,0 days 00:04:50,1,8,7
207,BAS,P003198,P009048,0 days 00:04:50,1,8,7
207,BAS,P003198,P010444,0 days 00:04:50,1,8,7
207,BAS,P003198,P012201,0 days 00:04:50,1,8,7
207,BAS,P010444,P011948,0 days 00:04:39,1,13,12
207,BAS,P004603,P012201,0 days 00:04:00,-1,3,4
207,BAS,P007946,P009048,0 days 00:03:57,-3,5,8
207,BAS,P009048,P011085,0 days 00:02:51,-4,4,8
207,BAS,P011085,P012201,0 days 00:02:51,-4,4,8
207,BAS,P007230,P011085,0 days 00:02:51,-4,4,8
207,BAS,P008850,P012201,0 days 00:02:41,-2,4,6
207,BAS,P008850,P009048,0 days 00:02:41,-2,4,6
207,BAS,P008850,P011085,0 days 00:02:23,-2,4,6
207,BAS,P004761,P011085,0 days 00:00:28,-2,0,2
207,PAM,P007870,P010568,0 days 00:24:21,8,43,35
207,PAM,P003960,P010568,0 days 00:21:39,25,46,21
207,PAM,P003960,P007870,0 days 00:20:29,19,40,21
207,PAM,P007870,P012795,0 days 00:19:31,11,40,29
207,PAM,P010568,P012795,0 days 00:19:23,16,40,24
207,PAM,P003960,P012795,0 days 00:16:09,25,37,12
207,PAM,P004863,P011982,0 days 00:14:58,1,30,29
207,PAM,P005356,P011982,0 days 00:13:13,7,32,25
207,PAM,P005356,P010568,0 days 00:12:46,7,21,14
207,PAM,P004863,P005356,0 days 00:12:45,2,29,27
207,PAM,P003960,P006433,0 days 00:11:49,6,18,12
207,PAM,P006433,P007870,0 days 00:11:49,6,18,12
207,PAM,P006433,P010568,0 days 00:11:49,6,18,12
207,PAM,P003960,P005356,0 days 00:11:43,9,19,10
207,PAM,P005356,P007870,0 days 00:11:33,2,19,17
207,PAM,P010393,P011982,0 days 00:11:19,0,22,22
207,PAM,P004863,P010393,0 days 00:11:19,0,22,22
207,PAM,P007870,P011970,0 days 00:09:22,-4,18,22
207,PAM,P005356,P010393,0 days 00:09:11,2,20,18
207,PAM,P010568,P011982,0 days 00:08:15,-5,11,16
207,PAM,P007870,P011982,0 days 00:08:14,-12,11,23
207,PAM,P011982,P012795,0 days 00:07:34,-2,15,17
207,PAM,P004863,P007870,0 days 00:07:25,0,13,13
207,PAM,P010568,P011970,0 days 00:07:14,-2,16,18
207,PAM,P011970,P012795,0 days 00:07:14,-2,16,18
207,PAM,P011970,P011982,0 days 00:07:07,-14,10,24
207,PAM,P005356,P012795,0 days 00:06:35,10,16,6
207,PAM,P006433,P012795,0 days 00:06:05,7,12,5
207,PAM,P005356,P006433,0 days 00:05:44,-1,6,7
207,PAM,P011982,P012740,0 days 00:05:18,3,11,8
207,PAM,P004863,P012740,0 days 00:05:18,3,11,8
207,PAM,P010393,P012740,0 days 00:05:18,3,11,8
207,PAM,P005356,P012740,0 days 00:05:18,3,11,8
207,PAM,P003960,P011970,0 days 00:04:47,9,15,6
207,PAM,P004863,P011970,0 days 00:04:40,-3,9,12
207,PAM,P010393,P011970,0 days 00:04:40,-3,9,12
207,PAM,P004863,P010568,0 days 00:04:24,1,7,6
207,PAM,P004863,P012795,0 days 00:03:57,3,8,5
207,PAM,P005356,P011970,0 days 00:02:32,-1,7,8
207,PAM,P007870,P010393,0 days 00:02:08,-2,2,4
207,PAM,P003960,P011982,0 days 00:02:06,6,6,0
207,PAM,P003960,P004863,0 days 00:01:38,1,3,2
207,PAM,P010393,P010568,0 days 00:01:21,0,2,2
208,RED,P007960,P008966,0 days 00:18:19,19,43,24
208,RED,P008966,P012801,0 days 00:16:13,9,32,23
208,RED,P008966,PJDR,0 days 00:15:19,14,34,20
208,RED,P006436,P012044,0 days 00:14:31,11,28,17
208,RED,P000848,P007960,0 days 00:14:07,11,37,26
208,RED,P007960,PJDR,0 days 00:13:06,17,33,16
208,RED,P007960,P012801,0 days 00:12:24,10,25,15
208,RED,P007960,P012044,0 days 00:11:50,3,25,22
208,RED,P000848,PJDR,0 days 00:11:47,5,26,21
208,RED,P012801,PJDR,0 days 00:11:34,11,25,14
208,RED,P006436,P008966,0 days 00:11:13,9,25,16
208,RED,P005099,PJDR,0 days 00:10:51,13,27,14
208,RED,P006436,P009035,0 days 00:10:50,5,19,14
208,RED,P006436,P012801,0 days 00:10:42,0,17,17
208,RED,P009035,P012044,0 days 00:10:36,1,16,15
208,RED,P006436,PJDR,0 days 00:10:19,2,21,19
208,RED,P006436,P007960,0 days 00:09:54,9,25,16
208,RED,P005099,P008966,0 days 00:09:51,9,24,15
208,RED,P012044,PLUO,0 days 00:09:37,-5,13,18
208,RED,P009035,PLUO,0 days 00:09:08,5,16,11
208,RED,P000848,P006436,0 days 00:09:06,7,26,19
208,RED,P000848,P008966,0 days 00:09:00,9,23,14
208,RED,P002553,P012044,0 days 00:08:37,-1,12,13
208,RED,P012044,P012801,0 days 00:08:37,-4,12,16
208,RED,P002553,P009035,0 days 00:08:27,0,11,11
208,RED,P008966,P012044,0 days 00:08:19,3,17,14
208,RED,P005099,P012801,0 days 00:08:11,11,19,8
208,RED,P002553,P006436,0 days 00:07:44,1,10,9
208,RED,P000848,P009035,0 days 00:07:24,2,19,17
208,RED,P000848,P012044,0 days 00:07:21,4,20,16
208,RED,P005099,P007960,0 days 00:06:02,10,17,7
208,RED,P002553,PLUO,0 days 00:05:35,0,6,6
208,RED,P005099,P006436,0 days 00:05:16,0,10,10
208,RED,P009035,PJDR,0 days 00:04:52,3,12,9
208,RED,P006436,PLUO,0 days 00:04:46,6,7,1
208,RED,P007960,PLUO,0 days 00:04:46,-3,9,12
208,RED,P000848,PLUO,0 days 00:04:44,3,12,9
208,RED,P007960,P009035,0 days 00:04:06,1,11,10
208,RED,P009035,P012801,0 days 00:03:58,-2,5,7
208,RED,P002553,P012801,0 days 00:03:26,-2,5,7
208,RED,P000848,P012801,0 days 00:03:23,0,6,6
208,RED,P000848,P005099,0 days 00:02:40,2,8,6
208,RED,P012801,PLUO,0 days 00:02:16,-5,2,7
208,RED,P000848,P002553,0 days 00:02:13,-5,3,8
208,RED,P008966,PLUO,0 days 00:02:09,-6,2,8
208,RED,P006436,P011941,0 days 00:02:03,-2,4,6
208,RED,P000848,P011941,0 days 00:02:03,-2,4,6
208,RED,P011941,P012044,0 days 00:01:48,-2,4,6
208,RED,PJDR,PLUO,0 days 00:01:40,4,5,1
208,RED,P007960,P011941,0 days 00:01:38,-1,3,4
208,RED,P005099,P009035,0 days 00:01:27,1,3,2
208,RED,P012044,PJDR,0 days 00:01:09,1,1,0
208,RED,P002553,PJDR,0 days 00:00:52,-2,0,2
208,RED,P002553,P008966,0 days 00:00:37,-2,0,2
208,RED,P005099,P012044,0 days 00:00:27,-3,0,3
208,RED,P005099,PLUO,0 days 00:00:27,-3,0,3
208,RED,P002553,P011941,0 days 00:00:25,-1,1,2
208,RED,P011941,PJDR,0 days 00:00:15,0,0,0
208,PAM,P003960,P010568,0 days 00:22:56,-1,38,39
208,PAM,P011970,P011982,0 days 00:18:03,-13,28,41
208,PAM,P010568,P012738,0 days 00:16:42,0,29,29
208,PAM,P003960,P012738,0 days 00:15:05,-2,25,27
208,PAM,P012738,P012740,0 days 00:14:34,-2,32,34
208,PAM,P005356,P012738,0 days 00:12:00,-3,18,21
208,PAM,P010568,P012740,0 days 00:11:53,1,24,23
208,PAM,P005356,P010568,0 days 00:11:24,-3,15,18
208,PAM,P003960,P005356,0 days 00:11:04,-3,15,18
208,PAM,P006643,P012738,0 days 00:11:02,-6,17,23
208,PAM,P010568,P011982,0 days 00:10:47,3,23,20
208,PAM,P003960,P012740,0 days 00:10:16,-1,20,21
208,PAM,P006433,P010393,0 days 00:10:14,-15,13,28
208,PAM,P010393,P011982,0 days 00:10:03,-15,12,27
208,PAM,P010393,P011970,0 days 00:10:03,-15,12,27
208,PAM,P000556,P011982,0 days 00:09:58,-6,14,20
208,PAM,P010568,P011970,0 days 00:09:57,3,22,19
208,PAM,P011982,P012795,0 days 00:09:33,-5,13,18
208,PAM,P011970,P012795,0 days 00:09:17,-5,13,18
208,PAM,P003960,P011970,0 days 00:09:03,4,18,14
208,PAM,P011982,P012740,0 days 00:08:32,-1,13,14
208,PAM,P006643,P010568,0 days 00:08:30,-2,12,14
208,PAM,P003960,P011982,0 days 00:08:16,2,15,13
208,PAM,P006433,P011982,0 days 00:07:42,-11,8,19
208,PAM,P006433,P011970,0 days 00:07:42,-11,8,19
208,PAM,P010393,P012795,0 days 00:07:35,-8,8,16
208,PAM,P006643,P012740,0 days 00:07:25,-2,17,19
208,PAM,P000556,P011970,0 days 00:07:15,-5,12,17
208,PAM,P003960,P006643,0 days 00:07:13,-4,8,12
208,PAM,P000556,P010568,0 days 00:07:03,-3,12,15
208,PAM,P006433,P012795,0 days 00:07:03,-8,8,16
208,PAM,P011970,P012738,0 days 00:06:15,2,12,10
208,PAM,P000556,P003960,0 days 00:06:09,-2,8,10
208,PAM,P005356,P012740,0 days 00:05:39,-4,11,15
208,PAM,P005356,P011970,0 days 00:05:10,-1,10,11
208,PAM,P011982,P012738,0 days 00:04:38,3,11,8
208,PAM,P000556,P012740,0 days 00:04:27,-1,4,5
208,PAM,P011970,P012740,0 days 00:04:03,-3,5,8
208,PAM,P010393,P012740,0 days 00:03:59,-7,5,12
208,PAM,P005356,P006643,0 days 00:03:53,-4,0,4
208,PAM,P006643,P010393,0 days 00:02:32,-4,5,9
208,PAM,P006433,P012740,0 days 00:02:32,-4,5,9
208,PAM,P006433,P012738,0 days 00:02:32,-4,5,9
208,PAM,P006433,P006643,0 days 00:02:32,-4,5,9
208,PAM,P010393,P012738,0 days 00:02:32,-4,5,9
208,PAM,P005356,P011982,0 days 00:02:07,-3,3,6
208,PAM,P000556,P012738,0 days 00:02:00,0,2,2
208,PAM,P003960,P012795,0 days 00:01:42,3,5,2
208,PAM,P010568,P012795,0 days 00:01:42,3,5,2
208,PAM,P000556,P010393,0 days 00:01:33,-4,4,8
208,PAM,P006643,P011982,0 days 00:01:33,2,4,2
208,PAM,P005356,P010393,0 days 00:00:55,-3,0,3
208,PAM,P010393,P010568,0 days 00:00:54,-1,4,5
208,PAM,P000556,P006433,0 days 00:00:39,-3,0,3
208,PAM,P012740,P012795,0 days 00:00:32,0,0,0
208,PAM,P000556,P005356,0 days 00:00:16,0,0,0
208,PAM,P000556,P006643,0 days 00:00:16,0,0,0
208,PAM,P000556,P012795,0 days 00:00:16,0,0,0
208,PAM,P005356,P012795,0 days 00:00:16,0,0,0
208,PAM,P006643,P012795,0 days 00:00:16,0,0,0
209,MUN,P001288,P003583,0 days 00:24:51,-1,54,55
209,MUN,P001288,P011987,0 days 00:21:47,-1,58,59
209,MUN,P001288,P001557,0 days 00:21:45,-6,46,52
209,MUN,P003583,P007975,0 days 00:20:33,-7,43,50
209,MUN,P001288,P008985,0 days 00:19:06,3,53,50
209,MUN,P007975,P010391,0 days 00:18:10,9,44,35
209,MUN,P004508,P007975,0 days 00:17:46,7,43,36
209,MUN,P003583,P011987,0 days 00:17:12,3,41,38
209,MUN,P001557,P003583,0 days 00:16:43,-1,36,37
209,MUN,P008985,P011987,0 days 00:15:23,5,44,39
209,MUN,P004508,P010391,0 days 00:15:18,11,40,29
209,MUN,P003583,P010391,0 days 00:14:25,1,32,31
209,MUN,P001288,P007975,0 days 00:14:24,-5,29,34
209,MUN,P001288,P010391,0 days 00:14:03,-1,34,35
209,MUN,P003583,P004508,0 days 00:13:55,-4,26,30
209,MUN,P001557,P008985,0 days 00:13:32,5,33,28
209,MUN,P001557,P011987,0 days 00:12:35,0,28,28
209,MUN,P006543,P010391,0 days 00:12:18,9,39,30
209,MUN,P003583,P008985,0 days 00:12:06,5,32,27
209,MUN,P001288,P004508,0 days 00:11:13,-5,23,28
209,MUN,P004508,P006543,0 days 00:10:48,8,31,23
209,MUN,P006543,P007975,0 days 00:10:42,8,31,23
209,MUN,P005460,P010391,0 days 00:08:56,5,25,20
209,MUN,P004508,P005460,0 days 00:08:06,7,28,21
209,MUN,P001288,P005460,0 days 00:07:33,-5,19,24
209,MUN,P007975,P011987,0 days 00:07:03,-2,19,21
209,MUN,P003583,P006543,0 days 00:06:47,0,16,16
209,MUN,P001557,P007975,0 days 00:06:25,-7,9,16
209,MUN,P001557,P010391,0 days 00:06:05,-5,13,18
209,MUN,P010391,P011987,0 days 00:05:46,-3,16,19
209,MUN,P001557,P004508,0 days 00:05:29,-5,9,14
209,MUN,P005460,P008985,0 days 00:05:18,-3,13,16
209,MUN,P001557,P005460,0 days 00:05:01,-3,10,13
209,MUN,P008985,P010391,0 days 00:04:47,2,17,15
209,MUN,P005460,P007975,0 days 00:04:45,10,17,7
209,MUN,P005460,P006543,0 days 00:03:55,8,15,7
209,MUN,P005460,P011987,0 days 00:03:06,-7,9,16
209,MUN,P004508,P008985,0 days 00:03:06,-5,7,12
209,MUN,P004508,P011987,0 days 00:02:47,-2,9,11
209,MUN,P001288,P006543,0 days 00:01:42,1,8,7
209,MUN,P006543,P008985,0 days 00:01:42,1,8,7
209,MUN,P006543,P011987,0 days 00:01:29,3,8,5
209,MUN,P007975,P008985,0 days 00:01:24,-1,5,6
209,MUN,P001557,P006543,0 days 00:00:13,-2,0,2
209,BAS,P009048,P010444,0 days 00:28:59,1,73,72
209,BAS,P009048,P011948,0 days 00:28:13,7,73,66
209,BAS,P003198,P009048,0 days 00:28:03,0,68,68
209,BAS,P003198,P004761,0 days 00:21:54,-8,48,56
209,BAS,P004761,P009048,0 days 00:21:31,-11,50,61
209,BAS,P003198,P007946,0 days 00:20:17,-2,48,50
209,BAS,P010444,P011948,0 days 00:19:38,2,53,51
209,BAS,P004761,P010444,0 days 00:19:12,-4,43,47
209,BAS,P003198,P011948,0 days 00:17:42,10,46,36
209,BAS,P003198,P010444,0 days 00:17:09,2,41,39
209,BAS,P003198,P004603,0 days 00:15:52,-2,36,38
209,BAS,P004603,P007946,0 days 00:15:52,-2,36,38
209,BAS,P007946,P009048,0 days 00:15:10,0,39,39
209,BAS,P004603,P009048,0 days 00:13:55,-4,33,37
209,BAS,P010444,P012201,0 days 00:13:44,2,36,34
209,BAS,P009048,P012201,0 days 00:13:44,2,36,34
209,BAS,P004603,P011948,0 days 00:11:45,1,26,25
209,BAS,P004761,P012201,0 days 00:11:11,-4,21,25
209,BAS,P004761,P007946,0 days 00:10:42,-11,24,35
209,BAS,P004603,P004761,0 days 00:10:27,-11,22,33
209,BAS,P003198,P012201,0 days 00:10:11,-3,19,22
209,BAS,P004761,P011948,0 days 00:09:51,-3,23,26
209,BAS,P007946,P011948,0 days 00:09:35,9,24,15
209,BAS,P011948,P012201,0 days 00:07:55,1,24,23
209,BAS,P008850,P009048,0 days 00:05:38,5,21,16
209,BAS,P008850,P010444,0 days 00:05:29,7,21,14
209,BAS,P008850,P012201,0 days 00:05:13,7,21,14
209,BAS,P004603,P012201,0 days 00:05:07,-2,9,11
209,BAS,P007946,P012201,0 days 00:05:07,-2,9,11
209,BAS,P009048,P011085,0 days 00:04:19,-4,7,11
209,BAS,P010444,P011085,0 days 00:04:19,-4,7,11
209,BAS,P011085,P011948,0 days 00:04:19,-4,7,11
209,BAS,P007946,P010444,0 days 00:04:16,2,12,10
209,BAS,P008850,P011948,0 days 00:03:54,5,16,11
209,BAS,P011085,P012201,0 days 00:03:12,-1,5,6
209,BAS,P004603,P010444,0 days 00:03:10,-4,6,10
209,BAS,P004761,P008850,0 days 00:01:44,0,5,5
209,BAS,P003198,P011085,0 days 00:01:07,-3,2,5
209,BAS,P003198,P008850,0 days 00:00:25,-2,0,2
209,BAS,P007946,P008850,0 days 00:00:09,-2,0,2
210,ASV,P012729,PKIR,0 days 00:20:32,2,48,46
210,ASV,P000229,P006568,0 days 00:19:38,-12,32,44
210,ASV,P005094,P011225,0 days 00:19:10,-15,32,47
210,ASV,P011225,P012729,0 days 00:18:52,-2,45,47
210,ASV,P006568,P011225,0 days 00:18:32,-12,31,43
210,ASV,P000229,P011225,0 days 00:18:27,-15,32,47
210,ASV,P011225,PKIR,0 days 00:17:13,-1,39,40
210,ASV,P012729,P012731,0 days 00:17:01,3,36,33
210,ASV,P012731,PKIR,0 days 00:16:20,2,35,33
210,ASV,P011225,P012731,0 days 00:16:00,1,32,31
210,ASV,P003526,P011225,0 days 00:15:26,-8,25,33
210,ASV,P000229,P012729,0 days 00:14:52,4,33,29
210,ASV,P000229,P005094,0 days 00:13:57,-16,20,36
210,ASV,P000229,P003526,0 days 00:13:45,-8,18,26
210,ASV,P003526,P006568,0 days 00:12:31,-9,15,24
210,ASV,P005094,P006568,0 days 00:12:21,-10,19,29
210,ASV,P003526,P012731,0 days 00:10:30,1,16,15
210,ASV,P000229,PKIR,0 days 00:09:47,1,23,22
210,ASV,P005094,P012729,0 days 00:09:27,-5,20,25
210,ASV,P003526,P005094,0 days 00:08:59,-10,12,22
210,ASV,P000229,P012731,0 days 00:08:46,1,12,11
210,ASV,P000229,P011386,0 days 00:08:28,5,14,9
210,ASV,P003526,PKIR,0 days 00:08:24,1,16,15
210,ASV,P006568,P012729,0 days 00:08:23,1,21,20
210,ASV,P003526,P012729,0 days 00:08:18,1,16,15
210,ASV,P011386,P012729,0 days 00:07:19,4,13,9
210,ASV,P006568,P012731,0 days 00:06:59,-5,6,11
210,ASV,P005094,PKIR,0 days 00:06:49,-5,13,18
210,ASV,P006568,PKIR,0 days 00:06:44,2,15,13
210,ASV,P005094,P012731,0 days 00:05:57,1,12,11
210,ASV,P011386,P012731,0 days 00:05:51,0,7,7
210,ASV,P011386,PKIR,0 days 00:05:39,2,11,9
210,ASV,P003526,P011386,0 days 00:05:23,0,6,6
210,ASV,P006568,P011386,0 days 00:03:40,1,5,4
210,ULK,P006068,P006661,0 days 00:26:10,17,57,40
210,ULK,P001932,P006068,0 days 00:25:21,7,45,38
210,ULK,P001932,P006661,0 days 00:24:31,12,51,39
210,ULK,P005844,P006661,0 days 00:23:40,17,58,41
210,ULK,P005844,P006068,0 days 00:19:36,16,46,30
210,ULK,P004004,P011157,0 days 00:18:05,-5,34,39
210,ULK,P004004,P006661,0 days 00:17:05,13,47,34
210,ULK,P001932,P005844,0 days 00:17:03,10,35,25
210,ULK,P002968,P006661,0 days 00:16:44,10,36,26
210,ULK,P006661,P011157,0 days 00:16:21,12,43,31
210,ULK,P002968,P006068,0 days 00:15:56,9,33,24
210,ULK,P002968,P005844,0 days 00:14:25,5,31,26
210,ULK,P001932,P002968,0 days 00:14:09,10,29,19
210,ULK,P006068,P011157,0 days 00:14:01,-1,26,27
210,ULK,P001932,P011157,0 days 00:13:29,-1,24,25
210,ULK,P004004,P006068,0 days 00:13:22,-1,25,26
210,ULK,P001932,P004004,0 days 00:11:03,0,19,19
210,ULK,P005844,P011157,0 days 00:09:46,12,27,15
210,ULK,P009849,P011157,0 days 00:08:15,-11,9,20
210,ULK,P004004,P005844,0 days 00:08:11,8,26,18
210,ULK,P004004,P009849,0 days 00:07:40,-11,7,18
210,ULK,P002968,P004004,0 days 00:05:20,6,15,9
210,ULK,P006961,P011157,0 days 00:05:07,3,16,13
210,ULK,P011157,P011980,0 days 00:04:49,-2,7,9
210,ULK,P004004,P011980,0 days 00:04:49,-2,7,9
210,ULK,P004004,P006961,0 days 00:04:32,3,14,11
210,ULK,P009849,P011980,0 days 00:04:14,0,7,7
210,ULK,P002969,P004004,0 days 00:03:33,-7,2,9
210,ULK,P006661,P006961,0 days 00:03:26,5,14,9
210,ULK,P005844,P006961,0 days 00:03:12,4,9,5
210,ULK,P002969,P009849,0 days 00:03:11,-7,2,9
210,ULK,P002969,P011157,0 days 00:03:11,-7,2,9
210,ULK,P006068,P009849,0 days 00:03:10,-7,2,9
210,ULK,P002969,P011980,0 days 00:02:39,-3,2,5
210,ULK,P001932,P009849,0 days 00:02:38,-3,2,5
210,ULK,P006661,P009849,0 days 00:02:26,-1,5,6
210,ULK,P001932,P006961,0 days 00:01:49,1,7,6
210,ULK,P006661,P011980,0 days 00:01:35,3,5,2
210,ULK,P006068,P006961,0 days 00:01:12,-2,2,4
210,ULK,P002969,P006068,0 days 00:00:54,-4,0,4
210,ULK,P005844,P009849,0 days 00:00:51,-4,0,4
210,ULK,P006961,P009849,0 days 00:00:35,0,2,2
210,ULK,P006961,P011980,0 days 00:00:35,-2,0,2
210,ULK,P001932,P011980,0 days 00:00:29,0,0,0
210,ULK,P002968,P002969,0 days 00:00:22,0,0,0
210,ULK,P002969,P006661,0 days 00:00:22,0,0,0
210,ULK,P006068,P011980,0 days 00:00:06,-2,0,2
211,OLY,P010612,P012878,0 days 00:21:10,23,60,37
211,OLY,P010612,P011983,0 days 00:20:00,23,53,30
211,OLY,P001255,P010612,0 days 00:16:18,10,44,34
211,OLY,P011983,P012878,0 days 00:15:19,25,47,22
211,OLY,P007982,P010612,0 days 00:15:16,-6,32,38
211,OLY,P001255,P007982,0 days 00:15:02,3,41,38
211,OLY,P001255,P012878,0 days 00:15:01,16,46,30
211,OLY,P008829,P011983,0 days 00:14:51,4,30,26
211,OLY,P001255,P010392,0 days 00:14:18,-3,36,39
211,OLY,P008829,P010612,0 days 00:13:50,6,28,22
211,OLY,P008855,P010612,0 days 00:13:19,24,40,16
211,OLY,P008855,P011983,0 days 00:13:19,24,40,16
211,OLY,P008855,P012878,0 days 00:13:19,24,40,16
211,OLY,P006589,P007982,0 days 00:11:37,0,28,28
211,OLY,P008829,P012878,0 days 00:11:24,11,28,17
211,OLY,P007982,P012878,0 days 00:10:59,0,28,28
211,OLY,P007982,P010392,0 days 00:10:21,7,31,24
211,OLY,P001255,P006589,0 days 00:10:08,-6,25,31
211,OLY,P007982,P008829,0 days 00:09:41,0,21,21
211,OLY,P006589,P010612,0 days 00:08:58,-7,12,19
211,OLY,P006589,P010392,0 days 00:08:09,-5,21,26
211,OLY,P007982,P011983,0 days 00:07:34,-3,15,18
211,OLY,P010392,P010612,0 days 00:07:34,0,15,15
211,OLY,P008829,P008855,0 days 00:07:17,7,15,8
211,OLY,P006589,P008829,0 days 00:07:09,-7,13,20
211,OLY,P001255,P007853,0 days 00:07:00,-1,20,21
211,OLY,P006589,P007853,0 days 00:07:00,-1,20,21
211,OLY,P001255,P011965,0 days 00:06:55,-13,11,24
211,OLY,P001255,P011983,0 days 00:06:10,17,25,8
211,OLY,P010392,P012878,0 days 00:06:09,2,15,13
211,OLY,P007853,P007982,0 days 00:06:03,4,20,16
211,OLY,P001255,P008855,0 days 00:06:02,17,25,8
211,OLY,P006589,P011983,0 days 00:05:42,-4,8,12
211,OLY,P007853,P010392,0 days 00:05:09,0,16,16
211,OLY,P008829,P011965,0 days 00:04:43,-2,13,15
211,OLY,P006589,P011965,0 days 00:04:05,-10,5,15
211,OLY,P010392,P011965,0 days 00:03:57,-10,5,15
211,OLY,P007982,P011965,0 days 00:03:51,-5,8,13
211,OLY,P011965,P012878,0 days 00:03:51,-5,8,13
211,OLY,P001255,P008829,0 days 00:03:42,0,11,11
211,OLY,P010612,P011965,0 days 00:02:16,-8,0,8
211,OLY,P007853,P010612,0 days 00:01:51,-1,4,5
211,OLY,P008829,P010392,0 days 00:01:35,-3,5,8
211,OLY,P011965,P011983,0 days 00:01:09,-2,2,4
211,OLY,P007853,P011965,0 days 00:00:57,-5,0,5
211,BER,P008173,P012721,0 days 00:18:41,2,46,44
211,BER,P008173,P011934,0 days 00:17:34,-7,40,47
211,BER,P011934,P012721,0 days 00:16:50,-6,35,41
211,BER,P008384,P010791,0 days 00:16:35,-9,32,41
211,BER,P006251,P008384,0 days 00:16:08,-9,32,41
211,BER,P006251,P010791,0 days 00:16:08,-9,32,41
211,BER,P008173,P012720,0 days 00:15:44,-8,33,41
211,BER,P011934,P012720,0 days 00:15:44,-8,33,41
211,BER,P008384,P008780,0 days 00:14:51,-18,23,41
211,BER,P006251,P008211,0 days 00:14:40,-8,28,36
211,BER,P008211,P010791,0 days 00:14:40,-8,28,36
211,BER,P008211,P008384,0 days 00:14:40,-8,28,36
211,BER,P012720,P012721,0 days 00:13:00,-4,26,30
211,BER,P008967,P011934,0 days 00:12:53,-16,20,36
211,BER,P008967,P012721,0 days 00:12:53,-16,20,36
211,BER,P008780,P010791,0 days 00:12:51,-15,21,36
211,BER,P006251,P008780,0 days 00:12:51,-15,21,36
211,BER,P008211,P008780,0 days 00:11:23,-14,17,31
211,BER,P007025,P008173,0 days 00:10:59,11,35,24
211,BER,P008173,P008967,0 days 00:10:53,-13,18,31
211,BER,P008173,P008384,0 days 00:09:25,12,31,19
211,BER,P008967,P012720,0 days 00:09:03,-14,11,25
211,BER,P007025,P012721,0 days 00:07:48,15,28,13
211,BER,P008384,P012721,0 days 00:07:41,3,22,19
211,BER,P007025,P012720,0 days 00:06:41,6,22,16
211,BER,P007025,P011934,0 days 00:06:41,6,22,16
211,BER,P006251,P008173,0 days 00:06:01,2,18,16
211,BER,P007025,P008384,0 days 00:05:46,4,17,13
211,BER,P006819,P008173,0 days 00:04:18,5,13,8
211,BER,P006819,P007025,0 days 00:04:18,5,13,8
211,BER,P006819,P008384,0 days 00:04:18,5,13,8
211,BER,P006251,P007025,0 days 00:04:12,-5,11,16
211,BER,P006819,P012721,0 days 00:03:51,5,13,8
211,BER,P008384,P008967,0 days 00:03:50,-2,9,11
211,BER,P008384,P011934,0 days 00:03:50,-2,9,11
211,BER,P008173,P010791,0 days 00:03:44,6,11,5
211,BER,P008173,P008211,0 days 00:03:17,6,11,5
211,BER,P006251,P011934,0 days 00:02:44,-4,7,11
211,BER,P006251,P012720,0 days 00:02:44,-4,7,11
211,BER,P008780,P008967,0 days 00:02:00,-3,2,5
211,BER,P008780,P011934,0 days 00:02:00,-3,2,5
211,BER,P008780,P012721,0 days 00:02:00,-3,2,5
211,BER,P007025,P010791,0 days 00:01:55,-1,4,5
211,BER,P007025,P008780,0 days 00:01:28,-1,4,5
211,BER,P006819,P010791,0 days 00:00:27,0,0,0
212,MAD,P003108,P004887,0 days 00:22:00,4,60,56
212,MAD,P004887,P005928,0 days 00:21:37,10,61,51
212,MAD,P003108,P005928,0 days 00:21:19,10,61,51
212,MAD,P006540,PBMT,0 days 00:18:26,1,48,47
212,MAD,P005928,P009005,0 days 00:17:16,1,46,45
212,MAD,P006540,P010357,0 days 00:17:09,0,41,41
212,MAD,P006540,PCVM,0 days 00:16:20,-7,40,47
212,MAD,P003108,P009005,0 days 00:15:17,5,42,37
212,MAD,P004887,P009005,0 days 00:14:49,6,41,35
212,MAD,P010357,PBMT,0 days 00:14:31,-5,34,39
212,MAD,PBMT,PCVM,0 days 00:13:52,-2,35,37
212,MAD,P003108,P006540,0 days 00:12:09,6,36,30
212,MAD,P004887,P006540,0 days 00:11:31,2,35,33
212,MAD,P010357,PCVM,0 days 00:11:26,-2,27,29
212,MAD,P005928,P006540,0 days 00:10:38,4,33,29
212,MAD,P001392,P003108,0 days 00:08:11,-4,20,24
212,MAD,P001392,P004887,0 days 00:08:11,-4,20,24
212,MAD,P003108,P003733,0 days 00:08:06,6,22,16
212,MAD,P003733,P009005,0 days 00:08:06,6,22,16
212,MAD,P003733,P005928,0 days 00:08:06,6,22,16
212,MAD,P003733,P004887,0 days 00:08:06,6,22,16
212,MAD,P006540,P009005,0 days 00:08:04,-7,22,29
212,MAD,P001392,P005928,0 days 00:07:15,-2,19,21
212,MAD,P009005,PBMT,0 days 00:06:54,-7,17,24
212,MAD,P006540,P009213,0 days 00:06:38,4,16,12
212,MAD,P009005,P010357,0 days 00:06:33,-9,15,24
212,MAD,P003108,PCVM,0 days 00:06:02,-2,16,18
212,MAD,P001392,P009005,0 days 00:06:01,-1,15,16
212,MAD,P004887,P010357,0 days 00:05:55,6,17,11
212,MAD,P009213,PBMT,0 days 00:05:52,3,13,10
212,MAD,P005928,P010357,0 days 00:05:43,2,14,12
212,MAD,P004887,PCVM,0 days 00:05:30,-6,15,21
212,MAD,P009005,PCVM,0 days 00:04:58,-3,13,16
212,MAD,P004887,PBMT,0 days 00:04:53,4,17,13
212,MAD,P009213,PCVM,0 days 00:04:44,-1,9,10
212,MAD,P003108,PBMT,0 days 00:04:42,7,15,8
212,MAD,P005928,PBMT,0 days 00:04:07,3,13,10
212,MAD,P003108,P010357,0 days 00:03:46,8,10,2
212,MAD,P009213,P010357,0 days 00:03:33,0,6,6
212,MAD,P003108,P009213,0 days 00:03:05,4,10,6
212,MAD,P001392,P006540,0 days 00:02:10,-3,5,8
212,MAD,P005928,PCVM,0 days 00:01:32,-3,4,7
212,MAD,P005928,P009213,0 days 00:01:27,5,7,2
212,MAD,P001392,PCVM,0 days 00:00:56,-2,1,3
212,MAD,P009005,P009213,0 days 00:00:46,1,3,2
212,MAD,P003108,P010623,0 days 00:00:27,0,0,0
212,MAD,P006540,P010623,0 days 00:00:27,0,0,0
212,MAD,P009213,P010623,0 days 00:00:27,0,0,0
212,MAD,P010623,PBMT,0 days 00:00:27,0,0,0
212,TEL,P009622,P009783,0 days 00:29:28,6,79,73
212,TEL,P009783,P009863,0 days 00:25:22,6,69,63
212,TEL,P009783,P011971,0 days 00:22:14,19,67,48
212,TEL,P009783,P011199,0 days 00:21:46,2,54,52
212,TEL,P009622,P009863,0 days 00:21:44,4,59,55
212,TEL,P009622,P011971,0 days 00:21:32,14,63,49
212,TEL,P009863,P011199,0 days 00:20:58,1,49,48
212,TEL,P009622,P011199,0 days 00:20:18,3,52,49
212,TEL,P009863,P011971,0 days 00:16:37,17,52,35
212,TEL,P011193,P011219,0 days 00:15:44,-6,37,43
212,TEL,P009783,P011219,0 days 00:13:43,4,41,37
212,TEL,P011199,P011971,0 days 00:13:23,9,37,28
212,TEL,P011219,P011971,0 days 00:12:04,-1,36,37
212,TEL,P009622,P011219,0 days 00:11:33,0,35,35
212,TEL,P009863,P011219,0 days 00:11:06,3,32,29
212,TEL,P009783,P011193,0 days 00:09:34,1,25,24
212,TEL,P011193,P011971,0 days 00:08:54,-7,24,31
212,TEL,P011214,P011219,0 days 00:08:00,-15,17,32
212,TEL,P009622,P011193,0 days 00:07:45,-5,19,24
212,TEL,P011193,P011214,0 days 00:07:38,-11,17,28
212,TEL,P009863,P011193,0 days 00:06:55,2,16,14
212,TEL,P005145,P009863,0 days 00:06:18,-7,11,18
212,TEL,P005145,P009783,0 days 00:06:18,-7,11,18
212,TEL,P005145,P009622,0 days 00:06:18,-7,11,18
212,TEL,P005145,P011199,0 days 00:06:18,-7,11,18
212,TEL,P007990,P011219,0 days 00:05:05,-9,8,17
212,TEL,P007990,P011193,0 days 00:04:44,-7,8,15
212,TEL,P009622,P011214,0 days 00:04:39,-10,9,19
212,TEL,P007990,P011971,0 days 00:03:36,-6,7,13
212,TEL,P011199,P011219,0 days 00:03:28,-2,6,8
212,TEL,P007990,P011214,0 days 00:03:21,-5,8,13
212,TEL,P007990,P009863,0 days 00:03:17,0,6,6
212,TEL,P011214,P011971,0 days 00:03:16,-11,6,17
212,TEL,P011193,P011199,0 days 00:03:14,-7,2,9
212,TEL,P007990,P011199,0 days 00:03:11,1,5,4
212,TEL,P009783,P011214,0 days 00:02:50,-6,5,11
212,TEL,P009863,P011214,0 days 00:02:16,-2,6,8
212,TEL,P007990,P009783,0 days 00:02:09,1,5,4
212,TEL,P007990,P009622,0 days 00:01:48,3,5,2
212,TEL,P009783,P012744,0 days 00:00:24,-2,0,2
212,TEL,P011971,P012744,0 days 00:00:24,-2,0,2
212,TEL,P007990,P012744,0 days 00:00:21,-2,0,2
212,TEL,P011219,P012744,0 days 00:00:21,-2,0,2
212,TEL,P009622,P012744,0 days 00:00:03,0,0,0
212,TEL,P009863,P012744,0 days 00:00:03,0,0,0
213,MCO,P005985,P010588,0 days 00:25:40,19,65,46
213,MCO,P005985,P011226,0 days 00:19:00,9,42,33
213,MCO,P005985,P011212,0 days 00:18:50,17,47,30
213,MCO,P002581,P005985,0 days 00:17:36,6,33,27
213,MCO,P002581,P010588,0 days 00:17:36,6,33,27
213,MCO,P010588,P011226,0 days 00:17:22,3,34,31
213,MCO,P011212,PLCZ,0 days 00:16:14,1,32,31
213,MCO,P002581,P004197,0 days 00:15:59,7,31,24
213,MCO,P004197,P010588,0 days 00:15:59,7,31,24
213,MCO,P004197,P005985,0 days 00:15:59,7,31,24
213,MCO,P010588,P011212,0 days 00:15:13,11,39,28
213,MCO,P011212,P011231,0 days 00:14:17,0,25,25
213,MCO,P009754,P011212,0 days 00:14:06,-1,27,28
213,MCO,P011212,P011226,0 days 00:13:56,-5,24,29
213,MCO,P009754,PLCZ,0 days 00:13:51,-1,27,28
213,MCO,P004197,P011226,0 days 00:10:57,2,20,18
213,MCO,P002581,P011226,0 days 00:10:57,2,20,18
213,MCO,P011226,P011231,0 days 00:10:26,-2,20,22
213,MCO,P009754,P011226,0 days 00:10:13,-4,18,22
213,MCO,P011226,PLCZ,0 days 00:09:56,-9,12,21
213,MCO,P011231,PLCZ,0 days 00:09:45,-4,13,17
213,MCO,P005985,P011231,0 days 00:08:54,6,17,11
213,MCO,P009754,P010588,0 days 00:08:54,9,27,18
213,MCO,P005985,P009754,0 days 00:08:13,11,25,14
213,MCO,P005985,PLCZ,0 days 00:08:11,9,22,13
213,MCO,P009754,P011231,0 days 00:07:22,-6,8,14
213,MCO,P010588,PLCZ,0 days 00:06:59,8,22,14
213,MCO,P002581,P011212,0 days 00:06:39,4,13,9
213,MCO,P011196,P011226,0 days 00:05:25,8,18,10
213,MCO,P005985,P011196,0 days 00:05:25,8,18,10
213,MCO,P004197,P011212,0 days 00:05:02,5,11,6
213,MCO,P011196,P011212,0 days 00:03:15,4,10,6
213,MCO,P010588,P011196,0 days 00:03:00,3,10,7
213,MCO,P010588,P011231,0 days 00:02:37,2,7,5
213,MCO,P011196,P011231,0 days 00:02:25,5,8,3
213,MCO,P009754,P011196,0 days 00:02:10,4,8,4
213,MCO,P002581,P011231,0 days 00:01:22,-1,2,3
213,MCO,P002581,P009754,0 days 00:00:15,0,0,0
213,PAR,P008987,P009862,0 days 00:35:46,-8,70,78
213,PAR,P007400,P008987,0 days 00:34:54,-12,65,77
213,PAR,P007400,P009862,0 days 00:33:56,-11,65,76
213,PAR,P008987,P012743,0 days 00:21:44,8,46,38
213,PAR,P007400,P012743,0 days 00:21:32,3,43,40
213,PAR,P009862,P012743,0 days 00:20:58,9,46,37
213,PAR,P008987,P012742,0 days 00:20:02,-17,27,44
213,PAR,P007400,P012742,0 days 00:19:50,-22,24,46
213,PAR,P009862,P012742,0 days 00:18:57,-16,27,43
213,PAR,P003983,P008987,0 days 00:18:23,10,46,36
213,PAR,P003983,P009862,0 days 00:17:44,11,46,35
213,PAR,P003983,P007400,0 days 00:17:09,5,41,36
213,PAR,P003983,P012743,0 days 00:14:57,4,33,29
213,PAR,P008987,P012096,0 days 00:12:52,-16,19,35
213,PAR,P009862,P012096,0 days 00:12:52,-16,19,35
213,PAR,P007400,P012096,0 days 00:11:43,-16,17,33
213,PAR,P012742,P012743,0 days 00:09:33,2,16,14
213,PAR,P012096,P012742,0 days 00:09:22,-19,9,28
213,PAR,P003983,P012096,0 days 00:05:56,-1,10,11
213,PAR,P003983,P007673,0 days 00:03:42,-4,2,6
213,PAR,P007673,P012096,0 days 00:03:35,-4,2,6
213,PAR,P003983,P011051,0 days 00:03:34,-5,3,8
213,PAR,P007400,P011051,0 days 00:02:51,-3,5,8
213,PAR,P007673,P011051,0 days 00:02:45,-4,0,4
213,PAR,P004058,P007673,0 days 00:02:33,-4,0,4
213,PAR,P003983,P004058,0 days 00:02:33,-4,0,4
213,PAR,P004058,P011051,0 days 00:02:26,-4,0,4
213,PAR,P004058,P012096,0 days 00:02:26,-4,0,4
213,PAR,P011051,P012096,0 days 00:02:26,-4,0,4
213,PAR,P011051,P012742,0 days 00:02:19,-4,2,6
213,PAR,P008987,P011051,0 days 00:02:15,-1,5,6
213,PAR,P003983,P012742,0 days 00:02:10,0,3,3
213,PAR,P009862,P011051,0 days 00:01:56,-1,5,6
213,PAR,P007673,P008987,0 days 00:01:28,0,2,2
213,PAR,P007673,P009862,0 days 00:01:16,0,2,2
213,PAR,P011051,P012743,0 days 00:00:36,-2,0,2
213,PAR,P007400,P007673,0 days 00:00:26,0,0,0
213,PAR,P007673,P012742,0 days 00:00:19,0,0,0
213,PAR,P004058,P007400,0 days 00:00:07,0,0,0
213,PAR,P004058,P009862,0 days 00:00:07,0,0,0
214,BAR,P004866,P012745,0 days 00:21:31,18,49,31
214,BAR,P002939,P004866,0 days 00:20:56,17,49,32
214,BAR,P000925,P004866,0 days 00:19:48,13,43,30
214,BAR,P006435,P012745,0 days 00:19:36,19,46,27
214,BAR,P000925,P006435,0 days 00:18:48,16,43,27
214,BAR,P004866,P006435,0 days 00:18:48,16,43,27
214,BAR,P002939,P012745,0 days 00:18:46,15,47,32
214,BAR,P003196,P009992,0 days 00:18:40,9,36,27
214,BAR,P000925,P012745,0 days 00:18:04,14,41,27
214,BAR,P000925,P002939,0 days 00:15:09,9,34,25
214,BAR,P002939,P006435,0 days 00:14:09,12,34,22
214,BAR,P002939,P009992,0 days 00:13:45,2,26,24
214,BAR,P009992,P011244,0 days 00:13:10,3,21,18
214,BAR,P002939,P003196,0 days 00:12:45,5,26,21
214,BAR,P003196,P011244,0 days 00:12:10,6,21,15
214,BAR,P004866,P009992,0 days 00:09:18,5,19,14
214,BAR,P002939,P011244,0 days 00:09:08,-1,13,14
214,BAR,P007519,P009992,0 days 00:08:50,2,14,12
214,BAR,P003196,P007519,0 days 00:08:50,2,14,12
214,BAR,P003196,P004866,0 days 00:08:18,8,19,11
214,BAR,P007519,P011244,0 days 00:07:41,4,14,10
214,BAR,P003196,P007464,0 days 00:07:27,3,13,10
214,BAR,P007464,P009992,0 days 00:07:27,3,13,10
214,BAR,P007519,P012745,0 days 00:07:20,7,14,7
214,BAR,P004866,P007519,0 days 00:07:10,4,13,9
214,BAR,P004866,P011244,0 days 00:06:35,3,13,10
214,BAR,P003196,P012745,0 days 00:06:30,3,15,12
214,BAR,P009992,P012745,0 days 00:06:30,3,15,12
214,BAR,P006435,P007519,0 days 00:06:11,9,14,5
214,BAR,P000925,P007519,0 days 00:04:39,4,9,5
214,BAR,P007464,P011244,0 days 00:04:24,4,6,2
214,BAR,P002939,P007464,0 days 00:04:03,-1,7,8
214,BAR,P007464,P007519,0 days 00:03:24,4,6,2
214,BAR,P007464,P012745,0 days 00:03:03,-1,7,8
214,BAR,P002939,P007519,0 days 00:02:55,-2,4,6
214,BAR,P000925,P011244,0 days 00:01:44,-1,2,3
214,BAR,P003204,P006435,0 days 00:01:32,5,5,0
214,BAR,P003204,P007519,0 days 00:01:32,5,5,0
214,BAR,P003204,P010641,0 days 00:01:32,5,5,0
214,BAR,P003204,P012745,0 days 00:01:32,5,5,0
214,BAR,P006435,P010641,0 days 00:01:32,5,5,0
214,BAR,P007519,P010641,0 days 00:01:32,5,5,0
214,BAR,P010641,P012745,0 days 00:01:32,5,5,0
214,BAR,P000925,P009992,0 days 00:01:00,-3,0,3
214,BAR,P006435,P011244,0 days 00:00:44,2,2,0
214,VIR,P001844,P009549,0 days 00:19:12,-9,26,35
214,VIR,P001844,P008847,0 days 00:18:58,-15,26,41
214,VIR,P001844,P003048,0 days 00:17:51,-14,26,40
214,VIR,P001844,PBCN,0 days 00:17:48,-5,31,36
214,VIR,P008847,P009549,0 days 00:15:34,-8,24,32
214,VIR,P002084,P010781,0 days 00:14:48,-8,23,31
214,VIR,P003048,P008847,0 days 00:14:36,-10,22,32
214,VIR,P001844,P003527,0 days 00:14:19,-15,15,30
214,VIR,P001844,P010781,0 days 00:14:05,-21,16,37
214,VIR,P004554,P010781,0 days 00:13:59,-5,21,26
214,VIR,P003527,P009549,0 days 00:13:44,-11,15,26
214,VIR,P002084,P004554,0 days 00:12:57,-3,21,24
214,VIR,P010781,PBCN,0 days 00:12:54,-17,17,34
214,VIR,P003048,PBCN,0 days 00:12:22,-6,21,27
214,VIR,P003048,P009549,0 days 00:11:39,0,20,20
214,VIR,P008847,PBCN,0 days 00:10:58,-7,19,26
214,VIR,P009549,PBCN,0 days 00:09:38,4,20,16
214,VIR,P009549,P010781,0 days 00:09:11,-12,9,21
214,VIR,P003527,P008847,0 days 00:09:09,-11,9,20
214,VIR,P002084,P006739,0 days 00:08:52,-1,14,15
214,VIR,P002084,P009549,0 days 00:08:35,-6,11,17
214,VIR,P008847,P010781,0 days 00:08:30,-15,10,25
214,VIR,P006739,P010781,0 days 00:07:48,-1,12,13
214,VIR,P004554,P006739,0 days 00:07:48,-1,12,13
214,VIR,P003048,P003527,0 days 00:07:20,-8,9,17
214,VIR,P004554,P009549,0 days 00:07:11,-5,7,12
214,VIR,P004554,PBCN,0 days 00:07:08,0,11,11
214,VIR,P001844,P004554,0 days 00:07:02,-3,10,13
214,VIR,P003048,P010781,0 days 00:06:54,-16,6,22
214,VIR,P002084,PBCN,0 days 00:06:42,-3,11,14
214,VIR,P001844,P002084,0 days 00:06:13,-1,10,11
214,VIR,P002084,P004007,0 days 00:04:38,-1,10,11
214,VIR,P004007,P006739,0 days 00:04:38,-1,10,11
214,VIR,P006739,P009549,0 days 00:04:20,0,6,6
214,VIR,P003527,PBCN,0 days 00:04:08,-2,6,8
214,VIR,P004007,P010781,0 days 00:03:34,-1,8,9
214,VIR,P004007,P004554,0 days 00:03:34,-1,8,9
214,VIR,P003527,P010781,0 days 00:03:21,-8,2,10
214,VIR,P002084,P008847,0 days 00:03:19,-1,6,7
214,VIR,P003527,P004554,0 days 00:02:37,-2,2,4
214,VIR,P005553,P009549,0 days 00:01:32,-5,0,5
214,VIR,P005553,P008847,0 days 00:01:32,-5,0,5
214,VIR,P003527,P005553,0 days 00:01:32,-5,0,5
214,VIR,P001844,P005553,0 days 00:01:32,-5,0,5
214,VIR,P002084,P003527,0 days 00:01:06,2,2,0
214,VIR,P004007,P008847,0 days 00:01:04,0,2,2
214,VIR,P004007,P009549,0 days 00:01:04,0,2,2
214,VIR,P006739,P008847,0 days 00:01:04,0,2,2
214,VIR,P006739,PBCN,0 days 00:00:58,0,0,0
214,VIR,P002084,P003048,0 days 00:00:42,-2,0,2
215,PAN,P002328,P011204,0 days 00:27:33,11,49,38
215,PAN,P002328,P012774,0 days 00:21:55,7,42,35
215,PAN,P002328,P003842,0 days 00:20:21,11,42,31
215,PAN,P003842,P012774,0 days 00:19:57,10,41,31
215,PAN,P011204,P012774,0 days 00:19:44,5,34,29
215,PAN,P007866,P011204,0 days 00:19:07,6,32,26
215,PAN,P012712,P012774,0 days 00:17:22,12,38,26
215,PAN,P003842,P012712,0 days 00:16:43,16,39,23
215,PAN,P002328,P007866,0 days 00:16:20,4,28,24
215,PAN,P003842,P011204,0 days 00:15:58,7,30,23
215,PAN,P002328,P012712,0 days 00:15:36,11,33,22
215,PAN,P011204,P011221,0 days 00:14:22,6,23,17
215,PAN,P011204,P011209,0 days 00:12:33,10,23,13
215,PAN,P011204,P012712,0 days 00:12:03,7,21,14
215,PAN,P007866,P011221,0 days 00:12:01,7,20,13
215,PAN,P002328,P011221,0 days 00:11:35,4,19,15
215,PAN,P007866,P011209,0 days 00:10:36,7,19,12
215,PAN,P011209,P011221,0 days 00:10:30,1,18,17
215,PAN,P002328,P011209,0 days 00:10:30,8,21,13
215,PAN,P007866,P012774,0 days 00:10:28,1,17,16
215,PAN,P007947,P012712,0 days 00:09:11,4,24,20
215,PAN,P011209,P012712,0 days 00:08:18,3,20,17
215,PAN,P003842,P011209,0 days 00:07:49,9,21,12
215,PAN,P011221,P012774,0 days 00:07:38,3,14,11
215,PAN,P003842,P007947,0 days 00:07:22,8,19,11
215,PAN,P007947,P012774,0 days 00:07:22,8,19,11
215,PAN,P003842,P007866,0 days 00:07:06,-1,12,13
215,PAN,P011209,P012774,0 days 00:05:54,6,15,9
215,PAN,P007947,P011209,0 days 00:05:17,0,14,14
215,PAN,P011221,P012712,0 days 00:05:00,-5,8,13
215,PAN,P002328,P007947,0 days 00:03:54,4,10,6
215,PAN,P006544,P007947,0 days 00:01:49,-4,5,9
215,PAN,P006544,P011209,0 days 00:01:49,-4,5,9
215,PAN,P006544,P011221,0 days 00:01:49,-4,5,9
215,PAN,P006544,P012712,0 days 00:01:49,-4,5,9
215,PAN,P007947,P011221,0 days 00:01:49,-4,5,9
215,PAN,P007866,P012712,0 days 00:00:50,0,0,0
215,MIL,P007831,P011224,0 days 00:25:50,-21,32,53
215,MIL,P002849,P011224,0 days 00:20:07,-10,32,42
215,MIL,P002849,P007831,0 days 00:18:18,-14,23,37
215,MIL,P011205,P011224,0 days 00:18:07,-8,27,35
215,MIL,P007831,P011205,0 days 00:17:06,-12,23,35
215,MIL,P007831,P009960,0 days 00:15:37,-8,21,29
215,MIL,P009960,P011224,0 days 00:15:37,-8,21,29
215,MIL,P009960,P011205,0 days 00:13:35,-6,21,27
215,MIL,P007201,P012800,0 days 00:12:10,-4,19,23
215,MIL,P000796,P012800,0 days 00:11:55,-2,19,21
215,MIL,P002849,P009960,0 days 00:11:27,-4,15,19
215,MIL,P002849,P011205,0 days 00:11:25,-5,16,21
215,MIL,P002812,P012800,0 days 00:10:49,6,19,13
215,MIL,P000796,P011205,0 days 00:09:42,-4,19,23
215,MIL,P000796,P007201,0 days 00:09:18,-4,15,19
215,MIL,P007201,P007831,0 days 00:08:59,-5,12,17
215,MIL,P002812,P011224,0 days 00:08:47,-1,19,20
215,MIL,P002812,P007201,0 days 00:07:54,-3,7,10
215,MIL,P002812,P007831,0 days 00:07:45,-7,10,17
215,MIL,P005670,P007201,0 days 00:07:38,-3,8,11
215,MIL,P007032,P012800,0 days 00:07:15,0,20,20
215,MIL,P007201,P011224,0 days 00:07:11,-7,8,15
215,MIL,P007201,P011205,0 days 00:06:51,-4,15,19
215,MIL,P000796,P002812,0 days 00:06:43,0,6,6
215,MIL,P011205,P012800,0 days 00:06:27,0,15,15
215,MIL,P011224,P012800,0 days 00:06:22,6,15,9
215,MIL,P002812,P007032,0 days 00:05:57,0,14,14
215,MIL,P005670,P012800,0 days 00:05:54,0,6,6
215,MIL,P002812,P005670,0 days 00:05:54,0,6,6
215,MIL,P002812,P002849,0 days 00:05:46,-2,14,16
215,MIL,P000796,P011224,0 days 00:05:38,0,10,10
215,MIL,P002812,P011205,0 days 00:05:33,-5,5,10
215,MIL,P007032,P011205,0 days 00:05:26,-4,11,15
215,MIL,P000796,P007032,0 days 00:05:26,-4,11,15
215,MIL,P007831,P012800,0 days 00:05:20,0,6,6
215,MIL,P007032,P011224,0 days 00:05:17,0,14,14
215,MIL,P002849,P007032,0 days 00:05:17,0,14,14
215,MIL,P000796,P007831,0 days 00:04:37,-4,6,10
215,MIL,P000796,P005670,0 days 00:04:06,-2,2,4
215,MIL,P007032,P007201,0 days 00:03:50,-2,11,13
215,MIL,P005670,P007831,0 days 00:03:32,-1,6,7
215,MIL,P002849,P012800,0 days 00:03:30,2,9,7
215,MIL,P007032,P007831,0 days 00:03:28,-4,5,9
215,MIL,P000796,P009960,0 days 00:03:15,-4,4,8
215,MIL,P002849,P007201,0 days 00:02:54,-4,3,7
215,MIL,P002849,P005670,0 days 00:01:44,-3,2,5
215,MIL,P005670,P011224,0 days 00:01:44,-3,2,5
215,MIL,P009960,P012800,0 days 00:01:06,0,0,0
215,MIL,P007032,P009960,0 days 00:00:56,-2,0,2
215,MIL,P007201,P009960,0 days 00:00:55,0,2,2
216,ZAL,P005504,P007513,0 days 00:19:20,17,46,29
216,ZAL,P002329,P005504,0 days 00:19:06,17,48,31
216,ZAL,P005504,P011218,0 days 00:16:31,23,44,21
216,ZAL,P002329,P011218,0 days 00:16:31,23,44,21
216,ZAL,P003211,P010390,0 days 00:16:19,9,37,28
216,ZAL,P002329,P007513,0 days 00:16:17,18,38,20
216,ZAL,P002676,P003211,0 days 00:16:07,7,38,31
216,ZAL,P002676,P010390,0 days 00:14:52,6,34,28
216,ZAL,P002676,P012787,0 days 00:13:34,2,28,26
216,ZAL,P003211,P007109,0 days 00:12:30,19,37,18
216,ZAL,P002676,P007513,0 days 00:12:28,9,27,18
216,ZAL,P007513,P011218,0 days 00:12:15,21,31,10
216,ZAL,P005504,P012715,0 days 00:11:36,7,33,26
216,ZAL,P003211,P012787,0 days 00:10:14,3,21,18
216,ZAL,P010390,P012787,0 days 00:10:14,3,21,18
216,ZAL,P002676,P005504,0 days 00:09:41,9,22,13
216,ZAL,P003211,P012715,0 days 00:09:32,-15,19,34
216,ZAL,P007109,P007513,0 days 00:09:32,6,18,12
216,ZAL,P002676,P007109,0 days 00:09:18,11,27,16
216,ZAL,P007109,P010390,0 days 00:09:00,14,26,12
216,ZAL,P007513,P012715,0 days 00:08:51,7,25,18
216,ZAL,P002329,P012715,0 days 00:08:46,7,26,19
216,ZAL,P002329,P003211,0 days 00:08:07,-1,20,21
216,ZAL,P002676,P012715,0 days 00:08:02,-9,16,25
216,ZAL,P003211,P005504,0 days 00:07:55,-3,21,24
216,ZAL,P003211,P007513,0 days 00:07:53,-2,16,18
216,ZAL,P011218,P012715,0 days 00:07:45,14,26,12
216,ZAL,P012715,P012787,0 days 00:07:23,-8,14,22
216,ZAL,P005504,P007109,0 days 00:06:49,5,15,10
216,ZAL,P002329,P007109,0 days 00:06:36,6,14,8
216,ZAL,P002329,P002676,0 days 00:05:11,7,11,4
216,ZAL,P002676,P011218,0 days 00:05:11,7,11,4
216,ZAL,P010390,P012715,0 days 00:05:07,-7,9,16
216,ZAL,P003211,P011218,0 days 00:04:16,2,13,11
216,ZAL,P007109,P012787,0 days 00:04:15,6,12,6
216,ZAL,P007513,P010390,0 days 00:04:14,3,8,5
216,ZAL,P007109,P011218,0 days 00:03:35,2,7,5
216,ZAL,P007513,P012787,0 days 00:03:26,1,7,6
216,ZAL,P005504,P012787,0 days 00:03:26,1,7,6
216,ZAL,P006860,P012787,0 days 00:02:12,2,2,0
216,ZAL,P006860,P010390,0 days 00:02:12,2,2,0
216,ZAL,P003211,P006860,0 days 00:02:12,2,2,0
216,ZAL,P002676,P006860,0 days 00:02:12,2,2,0
216,ZAL,P002676,P003210,0 days 00:01:56,1,8,7
216,ZAL,P003210,P007109,0 days 00:01:56,1,8,7
216,ZAL,P003210,P003211,0 days 00:01:51,3,8,5
216,ZAL,P003210,P010390,0 days 00:01:51,3,8,5
216,ZAL,P002329,P010390,0 days 00:01:27,3,3,0
216,ZAL,P002329,P012787,0 days 00:00:11,0,0,0
216,ZAL,P003210,P012715,0 days 00:00:05,-2,0,2
216,ZAL,P003210,P012787,0 days 00:00:05,-2,0,2
216,ZAL,P007109,P012715,0 days 00:00:05,-2,0,2
216,IST,P004888,P011078,0 days 00:24:00,-8,46,54
216,IST,P004888,P009664,0 days 00:23:45,-5,52,57
216,IST,P004888,P007200,0 days 00:22:01,-30,25,55
216,IST,P004888,PLHK,0 days 00:20:32,-15,35,50
216,IST,P009664,P011078,0 days 00:17:58,0,43,43
216,IST,P004888,P006590,0 days 00:16:44,9,44,35
216,IST,P004888,P011981,0 days 00:15:40,6,36,30
216,IST,P006590,P009664,0 days 00:13:45,9,39,30
216,IST,P007200,P009664,0 days 00:13:31,-20,17,37
216,IST,P007200,P011981,0 days 00:13:29,-17,19,36
216,IST,P009664,PLHK,0 days 00:13:22,-10,27,37
216,IST,P011078,PLHK,0 days 00:12:58,-13,21,34
216,IST,P007200,PLHK,0 days 00:12:34,-15,18,33
216,IST,P006590,P007200,0 days 00:12:01,-13,19,32
216,IST,P006590,P011981,0 days 00:11:39,3,30,27
216,IST,P007200,P009846,0 days 00:11:16,-19,12,31
216,IST,P006590,PLHK,0 days 00:10:58,1,26,25
216,IST,P007200,P011078,0 days 00:10:11,-20,8,28
216,IST,P009664,P011981,0 days 00:09:07,8,25,17
216,IST,P011078,P011981,0 days 00:09:05,13,28,15
216,IST,P007200,P012788,0 days 00:09:00,-16,10,26
216,IST,P009846,P012788,0 days 00:09:00,-16,10,26
216,IST,P006590,P011078,0 days 00:08:53,14,32,18
216,IST,P009846,P011981,0 days 00:08:31,-12,13,25
216,IST,P004888,P009846,0 days 00:08:27,-10,8,18
216,IST,P011981,P012788,0 days 00:06:33,-11,10,21
216,IST,P006590,P009846,0 days 00:05:26,-11,7,18
216,IST,P004888,P012788,0 days 00:04:50,-8,3,11
216,IST,P004888,P010516,0 days 00:04:16,-5,3,8
216,IST,P010516,PLHK,0 days 00:04:11,-5,3,8
216,IST,P006590,P012788,0 days 00:04:10,-8,7,15
216,IST,P011981,PLHK,0 days 00:04:05,1,8,7
216,IST,P009846,P011078,0 days 00:03:48,-4,3,7
216,IST,P010516,P011078,0 days 00:03:35,-3,3,6
216,IST,P009664,P009846,0 days 00:03:32,-2,5,7
216,IST,P010516,P012710,0 days 00:03:05,-6,0,6
216,IST,P011078,P012710,0 days 00:03:05,-6,0,6
216,IST,P012710,PLHK,0 days 00:03:05,-6,0,6
216,IST,P004888,P012710,0 days 00:03:05,-6,0,6
216,IST,P011078,P012788,0 days 00:02:27,-5,0,5
216,IST,P010516,P011981,0 days 00:01:11,1,3,2
216,IST,P007200,P010516,0 days 00:00:41,-2,0,2
216,IST,P009846,PLHK,0 days 00:00:23,2,2,0
216,IST,P009846,P010516,0 days 00:00:05,0,0,0
217,BER,P008780,P008967,0 days 00:18:09,-17,23,40
217,BER,P008780,P011934,0 days 00:17:04,-19,21,40
217,BER,P008967,P011934,0 days 00:15:38,-16,21,37
217,BER,P011934,P012720,0 days 00:15:11,-17,18,35
217,BER,P008173,P012721,0 days 00:15:06,7,35,28
217,BER,P006251,P008967,0 days 00:15:00,-16,19,35
217,BER,P006251,P008780,0 days 00:14:58,-16,15,31
217,BER,P008173,P010791,0 days 00:14:32,5,32,27
217,BER,P008780,P012720,0 days 00:14:14,-14,18,32
217,BER,P008173,P008384,0 days 00:13:09,-3,24,27
217,BER,P008967,P012720,0 days 00:12:48,-11,18,29
217,BER,P008384,P012721,0 days 00:12:27,3,25,22
217,BER,P006251,P011934,0 days 00:12:27,-15,13,28
217,BER,P006251,P008384,0 days 00:11:54,-15,12,27
217,BER,P008173,P008211,0 days 00:11:52,6,23,17
217,BER,P007025,P008173,0 days 00:11:16,11,29,18
217,BER,P008967,P012721,0 days 00:10:44,-6,20,26
217,BER,P006251,P012720,0 days 00:10:05,-9,11,20
217,BER,P008384,P010791,0 days 00:09:49,-1,18,19
217,BER,P007025,P012721,0 days 00:09:38,7,23,16
217,BER,P010791,P012721,0 days 00:09:13,7,24,17
217,BER,P008384,P008967,0 days 00:08:57,-7,15,22
217,BER,P007025,P010791,0 days 00:08:43,9,24,15
217,BER,P006251,P008173,0 days 00:08:39,-4,14,18
217,BER,P008211,P010791,0 days 00:08:24,0,16,16
217,BER,P006251,P008211,0 days 00:07:11,-1,10,11
217,BER,P008780,P012721,0 days 00:07:08,-5,10,15
217,BER,P008211,P012721,0 days 00:06:33,8,15,7
217,BER,P007025,P008211,0 days 00:06:19,11,19,8
217,BER,P006251,P012721,0 days 00:05:51,-3,8,11
217,BER,P011934,P012721,0 days 00:05:34,-7,8,15
217,BER,P008211,P008384,0 days 00:05:33,-5,4,9
217,BER,P008384,P008780,0 days 00:05:21,-6,5,11
217,BER,P006251,P010791,0 days 00:05:19,-2,8,10
217,BER,P012720,P012721,0 days 00:05:06,-8,7,15
217,BER,P007025,P008384,0 days 00:04:00,3,10,7
217,BER,P008173,P008967,0 days 00:03:36,-1,10,11
217,BER,P006251,P007025,0 days 00:03:04,1,6,5
217,BER,P008384,P011934,0 days 00:02:50,-5,3,8
217,BER,P007025,P011934,0 days 00:02:23,-6,0,6
217,BER,P007025,P012720,0 days 00:02:23,-6,0,6
217,BER,P008967,P010791,0 days 00:02:08,2,6,4
217,BER,P006819,P007025,0 days 00:01:36,5,5,0
217,BER,P006819,P008173,0 days 00:01:36,5,5,0
217,BER,P006819,P008211,0 days 00:01:36,5,5,0
217,BER,P006819,P012721,0 days 00:01:36,5,5,0
217,BER,P007025,P008780,0 days 00:01:26,-3,0,3
217,BER,P008173,P011934,0 days 00:00:57,-3,0,3
217,BER,P008173,P012720,0 days 00:00:57,-3,0,3
217,PAM,P005356,P012738,0 days 00:18:30,-1,38,39
217,PAM,P010393,P012795,0 days 00:18:02,18,40,22
217,PAM,P010568,P012795,0 days 00:17:06,17,37,20
217,PAM,P010568,P012740,0 days 00:16:27,20,38,18
217,PAM,P010393,P010568,0 days 00:16:22,17,37,20
217,PAM,P011982,P012795,0 days 00:16:19,17,37,20
217,PAM,P010393,P011982,0 days 00:16:19,17,37,20
217,PAM,P010393,P012740,0 days 00:16:16,15,35,20
217,PAM,P010568,P011982,0 days 00:15:56,14,37,23
217,PAM,P012740,P012795,0 days 00:15:38,18,35,17
217,PAM,P003960,P005356,0 days 00:15:19,2,30,28
217,PAM,P011982,P012740,0 days 00:14:42,17,35,18
217,PAM,P003960,P012738,0 days 00:14:41,1,27,26
217,PAM,P003960,P004863,0 days 00:12:06,4,22,18
217,PAM,P005356,P006433,0 days 00:11:47,0,21,21
217,PAM,P004863,P005356,0 days 00:11:38,4,22,18
217,PAM,P006433,P012738,0 days 00:10:56,-3,18,21
217,PAM,P011970,P012738,0 days 00:10:23,-3,21,24
217,PAM,P004863,P012738,0 days 00:10:16,3,19,16
217,PAM,P005356,P011970,0 days 00:09:52,-1,21,22
217,PAM,P004863,P006433,0 days 00:09:11,4,15,11
217,PAM,P003960,P006433,0 days 00:09:08,1,13,12
217,PAM,P006433,P010393,0 days 00:07:46,-7,13,20
217,PAM,P003960,P011970,0 days 00:07:13,0,13,13
217,PAM,P003960,P010568,0 days 00:05:32,1,11,10
217,PAM,P006433,P011970,0 days 00:05:28,-7,8,15
217,PAM,P010393,P011970,0 days 00:05:06,-7,8,15
217,PAM,P010568,P012738,0 days 00:05:06,-2,11,13
217,PAM,P005356,P010568,0 days 00:04:22,-2,11,13
217,PAM,P006433,P011982,0 days 00:04:02,1,8,7
217,PAM,P010393,P012738,0 days 00:04:01,-4,8,12
217,PAM,P005356,P010393,0 days 00:03:30,-2,8,10
217,PAM,P003960,P012740,0 days 00:03:16,4,7,3
217,PAM,P010568,P011970,0 days 00:03:09,-3,7,10
217,PAM,P012738,P012740,0 days 00:02:58,0,7,7
217,PAM,P006433,P012795,0 days 00:02:54,-2,5,7
217,PAM,P004863,P011970,0 days 00:02:51,4,6,2
217,PAM,P004863,P011982,0 days 00:02:48,4,6,2
217,PAM,P003960,P012795,0 days 00:02:35,0,3,3
217,PAM,P005356,P011982,0 days 00:02:25,1,6,5
217,PAM,P003960,P010393,0 days 00:02:20,2,3,1
217,PAM,P004863,P012795,0 days 00:02:16,0,3,3
217,PAM,P004863,P010393,0 days 00:01:54,3,3,0
217,PAM,P005356,P012740,0 days 00:01:43,2,7,5
217,PAM,P006433,P012740,0 days 00:01:36,-5,0,5
217,PAM,P011970,P012740,0 days 00:01:36,-5,0,5
217,PAM,P006433,P010568,0 days 00:01:24,-2,3,5
217,PAM,P003960,P011982,0 days 00:01:22,1,3,2
217,PAM,P012738,P012795,0 days 00:01:06,-3,0,3
217,PAM,P011982,P012738,0 days 00:01:03,0,3,3
217,PAM,P004863,P012740,0 days 00:00:40,2,4,2
217,PAM,P004863,P010568,0 days 00:00:28,0,0,0
217,PAM,P005356,P012795,0 days 00:00:22,-3,0,3
217,PAM,P011970,P012795,0 days 00:00:14,-2,0,2
218,MUN,P001288,P003583,0 days 00:20:53,14,47,33
218,MUN,P001557,P008985,0 days 00:15:21,0,22,22
218,MUN,P001557,P003583,0 days 00:15:13,8,26,18
218,MUN,P008985,P011987,0 days 00:15:06,-4,16,20
218,MUN,P001288,P001557,0 days 00:14:52,7,26,19
218,MUN,P003583,P008985,0 days 00:14:36,1,19,18
218,MUN,P003583,P011987,0 days 00:14:32,3,23,20
218,MUN,P001557,P011987,0 days 00:14:06,3,21,18
218,MUN,P001288,P011987,0 days 00:13:51,1,23,22
218,MUN,P003583,P010391,0 days 00:13:05,1,26,25
218,MUN,P001288,P008985,0 days 00:12:50,2,19,17
218,MUN,P007975,P010391,0 days 00:12:21,-4,24,28
218,MUN,P006543,P007975,0 days 00:11:29,2,25,23
218,MUN,P001288,P007975,0 days 00:11:15,2,26,24
218,MUN,P004508,P007975,0 days 00:10:59,-2,22,24
218,MUN,P004508,P006760,0 days 00:10:26,-9,19,28
218,MUN,P006760,P010391,0 days 00:09:53,-10,15,25
218,MUN,P003583,P007975,0 days 00:09:27,1,23,22
218,MUN,P001288,P006543,0 days 00:09:20,3,21,18
218,MUN,P001288,P010391,0 days 00:09:11,8,26,18
218,MUN,P004508,P005460,0 days 00:08:57,-2,19,21
218,MUN,P008985,P010391,0 days 00:08:49,-5,15,20
218,MUN,P005460,P006760,0 days 00:08:32,-2,19,21
218,MUN,P006760,P007975,0 days 00:08:21,-6,13,19
218,MUN,P004508,P010391,0 days 00:07:58,-8,15,23
218,MUN,P001557,P010391,0 days 00:07:10,5,16,11
218,MUN,P003583,P006543,0 days 00:06:37,4,18,14
218,MUN,P005460,P007975,0 days 00:06:22,1,13,12
218,MUN,P005460,P010391,0 days 00:06:04,-1,15,16
218,MUN,P010391,P011987,0 days 00:05:29,1,8,7
218,MUN,P004508,P006543,0 days 00:04:59,4,10,6
218,MUN,P006543,P010391,0 days 00:04:51,1,13,12
218,MUN,P007639,P011987,0 days 00:04:04,-6,3,9
218,MUN,P006760,P008985,0 days 00:04:00,-5,6,11
218,MUN,P007639,P007975,0 days 00:03:47,-6,3,9
218,MUN,P001288,P007639,0 days 00:03:31,-5,3,8
218,MUN,P001288,P004508,0 days 00:03:08,4,9,5
218,MUN,P005460,P006543,0 days 00:02:53,-1,4,5
218,MUN,P007975,P011987,0 days 00:02:46,-4,5,9
218,MUN,P007639,P010391,0 days 00:02:45,-4,3,7
218,MUN,P004508,P008985,0 days 00:02:35,-3,6,9
218,MUN,P005460,P008985,0 days 00:02:35,-3,6,9
218,MUN,P007639,P008985,0 days 00:02:29,-3,3,6
218,MUN,P001557,P007639,0 days 00:02:29,-3,3,6
218,MUN,P006543,P006760,0 days 00:02:28,-1,4,5
218,MUN,P003583,P004508,0 days 00:02:25,0,6,6
218,MUN,P003583,P006760,0 days 00:02:20,-4,0,4
218,MUN,P006543,P007639,0 days 00:02:18,-1,3,4
218,MUN,P004508,P007639,0 days 00:02:12,-3,3,6
218,MUN,P006543,P011987,0 days 00:01:58,-3,2,5
218,MUN,P006760,P011987,0 days 00:01:55,-2,0,2
218,MUN,P001557,P007975,0 days 00:01:37,0,2,2
218,MUN,P006760,P007639,0 days 00:01:29,-5,0,5
218,MUN,P004508,P011987,0 days 00:00:37,-1,3,4
218,MUN,P001288,P005460,0 days 00:00:25,0,0,0
218,MUN,P006543,P008985,0 days 00:00:19,0,0,0
218,OLY,P008829,P008855,0 days 00:20:00,10,37,27
218,OLY,P008829,P011983,0 days 00:20:00,10,37,27
218,OLY,P008855,P011983,0 days 00:20:00,10,37,27
218,OLY,P001255,P010392,0 days 00:19:29,-6,39,45
218,OLY,P008829,P012878,0 days 00:16:45,3,26,23
218,OLY,P008855,P012878,0 days 00:16:45,3,26,23
218,OLY,P011983,P012878,0 days 00:16:45,3,26,23
218,OLY,P001255,P007853,0 days 00:16:34,-6,32,38
218,OLY,P007853,P010392,0 days 00:16:03,-6,32,38
218,OLY,P001255,P011194,0 days 00:15:42,-2,31,33
218,OLY,P010392,P011194,0 days 00:15:11,-2,31,33
218,OLY,P007853,P011194,0 days 00:13:44,-3,25,28
218,OLY,P008855,P010612,0 days 00:13:15,-3,15,18
218,OLY,P010612,P011983,0 days 00:13:15,-3,15,18
218,OLY,P010612,P012878,0 days 00:13:15,-3,15,18
218,OLY,P008829,P010612,0 days 00:13:15,-3,15,18
218,OLY,P007982,P008855,0 days 00:10:42,13,29,16
218,OLY,P008855,P011194,0 days 00:10:07,8,25,17
218,OLY,P001255,P007982,0 days 00:09:55,-3,22,25
218,OLY,P007982,P010392,0 days 00:09:24,-3,22,25
218,OLY,P007982,P011194,0 days 00:08:52,8,25,17
218,OLY,P001255,P008855,0 days 00:08:20,0,15,15
218,OLY,P008855,P010392,0 days 00:07:49,0,15,15
218,OLY,P007982,P011983,0 days 00:06:45,13,22,9
218,OLY,P007982,P008829,0 days 00:06:45,13,22,9
218,OLY,P007853,P007982,0 days 00:06:29,-3,15,18
218,OLY,P011194,P011965,0 days 00:05:42,-3,9,12
218,OLY,P010392,P011965,0 days 00:05:42,-3,9,12
218,OLY,P007853,P011965,0 days 00:05:42,-3,9,12
218,OLY,P001255,P011965,0 days 00:05:42,-3,9,12
218,OLY,P007853,P008855,0 days 00:04:54,0,8,8
218,OLY,P001255,P006589,0 days 00:04:18,-4,8,12
218,OLY,P006589,P007982,0 days 00:04:18,-4,8,12
218,OLY,P006589,P010392,0 days 00:04:18,-4,8,12
218,OLY,P007982,P012878,0 days 00:03:30,6,11,5
218,OLY,P008829,P011194,0 days 00:03:15,7,11,4
218,OLY,P011194,P011983,0 days 00:03:15,7,11,4
218,OLY,P006589,P007853,0 days 00:02:50,-3,7,10
218,OLY,P006589,P008855,0 days 00:01:28,-1,1,2
219,MAD,P006540,P010357,0 days 00:19:02,-2,44,46
219,MAD,P004887,P009005,0 days 00:18:41,6,37,31
219,MAD,P010357,PBMT,0 days 00:18:13,-2,40,42
219,MAD,P003733,P009005,0 days 00:17:15,8,36,28
219,MAD,P003108,P009005,0 days 00:16:46,6,34,28
219,MAD,P003108,P004887,0 days 00:16:46,6,34,28
219,MAD,P006540,PBMT,0 days 00:15:56,-5,35,40
219,MAD,P010357,PCVM,0 days 00:15:48,-3,35,38
219,MAD,P006540,PCVM,0 days 00:15:26,-6,33,39
219,MAD,P003733,P004887,0 days 00:14:09,5,27,22
219,MAD,P003108,P005928,0 days 00:13:21,2,26,24
219,MAD,P004887,P005928,0 days 00:13:21,2,26,24
219,MAD,P005928,P009005,0 days 00:13:21,2,26,24
219,MAD,PBMT,PCVM,0 days 00:12:42,-6,26,32
219,MAD,P003108,P003733,0 days 00:12:14,5,24,19
219,MAD,P003733,P005928,0 days 00:12:14,5,24,19
219,MAD,P003108,PCVM,0 days 00:10:55,-2,22,24
219,MAD,P009005,PCVM,0 days 00:09:55,7,25,18
219,MAD,P003108,PBMT,0 days 00:07:30,-6,14,20
219,MAD,P003108,P010357,0 days 00:07:30,-6,14,20
219,MAD,P003108,P006540,0 days 00:06:35,-6,14,20
219,MAD,P006540,P009005,0 days 00:06:30,3,17,14
219,MAD,P004887,P006540,0 days 00:06:05,8,15,7
219,MAD,P001392,PCVM,0 days 00:05:42,7,13,6
219,MAD,P001392,P003108,0 days 00:05:27,1,10,9
219,MAD,P004887,PCVM,0 days 00:05:20,4,11,7
219,MAD,P009213,PBMT,0 days 00:05:04,-4,9,13
219,MAD,P009213,P010357,0 days 00:05:04,-4,9,13
219,MAD,P003733,PCVM,0 days 00:05:01,3,12,9
219,MAD,P003733,P006540,0 days 00:05:01,3,12,9
219,MAD,P009005,P010357,0 days 00:04:35,3,14,11
219,MAD,P010623,PBMT,0 days 00:04:35,6,12,6
219,MAD,P010357,P010623,0 days 00:04:35,6,12,6
219,MAD,P006540,P010623,0 days 00:04:35,6,12,6
219,MAD,P001392,P009005,0 days 00:04:32,1,10,9
219,MAD,P001392,P004887,0 days 00:04:32,1,10,9
219,MAD,P004887,PBMT,0 days 00:04:10,8,12,4
219,MAD,P004887,P010623,0 days 00:04:10,8,12,4
219,MAD,P004887,P010357,0 days 00:04:10,8,12,4
219,MAD,P009213,PCVM,0 days 00:03:43,0,7,7
219,MAD,P006540,P009213,0 days 00:03:42,-7,4,11
219,MAD,P003733,P010357,0 days 00:03:06,3,9,6
219,MAD,P001392,P010357,0 days 00:02:17,3,5,2
219,MAD,P001392,PBMT,0 days 00:02:17,3,5,2
219,MAD,P009005,PBMT,0 days 00:01:29,0,5,5
219,MAD,P001392,P009213,0 days 00:01:22,3,5,2
219,MAD,P001392,P005928,0 days 00:01:07,-3,2,5
219,MAD,P005928,P006540,0 days 00:00:56,-2,2,4
219,MAD,P005928,P009213,0 days 00:00:56,-2,2,4
219,MAD,P005928,P010357,0 days 00:00:56,-2,2,4
219,MAD,P005928,PBMT,0 days 00:00:56,-2,2,4
219,MAD,P009213,P010623,0 days 00:00:25,-2,0,2
219,ASV,P000229,P005094,0 days 00:25:22,-4,50,54
219,ASV,P000229,P011225,0 days 00:23:57,3,52,49
219,ASV,P005094,P011225,0 days 00:23:03,1,51,50
219,ASV,P003526,P011225,0 days 00:21:59,-8,45,53
219,ASV,P011225,P012729,0 days 00:21:30,10,52,42
219,ASV,P012729,P012731,0 days 00:21:18,12,48,36
219,ASV,P011225,P012731,0 days 00:18:52,11,45,34
219,ASV,P000229,P012731,0 days 00:17:52,1,34,33
219,ASV,P003526,P005094,0 days 00:17:33,-14,34,48
219,ASV,P000229,P012729,0 days 00:16:25,11,38,27
219,ASV,P000229,P003526,0 days 00:15:36,-10,30,40
219,ASV,P000229,P006568,0 days 00:15:12,-18,22,40
219,ASV,P005094,P006568,0 days 00:15:08,-18,22,40
219,ASV,P005094,P012731,0 days 00:15:06,0,32,32
219,ASV,P005094,P012729,0 days 00:12:55,10,34,24
219,ASV,P003526,P012729,0 days 00:12:26,1,30,29
219,ASV,P012729,PKIR,0 days 00:11:53,1,23,22
219,ASV,P003526,P006568,0 days 00:11:37,-11,19,30
219,ASV,P012731,PKIR,0 days 00:11:09,1,21,20
219,ASV,P006568,P011225,0 days 00:10:58,-7,19,26
219,ASV,P003526,P012731,0 days 00:10:22,-2,23,25
219,ASV,P011225,PKIR,0 days 00:09:17,2,20,18
219,ASV,P003526,PKIR,0 days 00:06:30,4,15,11
219,ASV,P000229,PKIR,0 days 00:06:07,-3,10,13
219,ASV,P000229,P011386,0 days 00:05:41,-8,4,12
219,ASV,P011386,P012731,0 days 00:05:32,-8,4,12
219,ASV,P006568,P012731,0 days 00:05:05,-11,5,16
219,ASV,P005094,P011386,0 days 00:03:05,-7,1,8
219,ASV,P011386,P012729,0 days 00:02:57,-1,3,4
219,ASV,P006568,P011386,0 days 00:02:44,-7,1,8
219,ASV,P011386,PKIR,0 days 00:02:36,-1,3,4
219,ASV,P003526,P011386,0 days 00:00:09,0,0,0
219,ASV,P006568,P012729,0 days 00:00:04,0,0,0
220,BAS,P004603,P012201,0 days 00:33:18,23,82,59
220,BAS,P004603,P009048,0 days 00:28:49,1,60,59
220,BAS,P004603,P004761,0 days 00:28:24,15,63,48
220,BAS,P009048,P012201,0 days 00:28:13,2,62,60
220,BAS,P004761,P012201,0 days 00:27:51,15,63,48
220,BAS,P004603,P011085,0 days 00:22:14,11,50,39
220,BAS,P004761,P009048,0 days 00:21:16,-2,39,41
220,BAS,P011085,P012201,0 days 00:20:58,9,48,39
220,BAS,P004603,P011948,0 days 00:20:11,17,52,35
220,BAS,P004761,P011085,0 days 00:19:53,14,45,31
220,BAS,P011948,P012201,0 days 00:19:41,18,54,36
220,BAS,P009048,P011948,0 days 00:19:07,5,42,37
220,BAS,P009048,P011085,0 days 00:15:46,-5,31,36
220,BAS,P004761,P011948,0 days 00:13:10,8,31,23
220,BAS,P007946,P012201,0 days 00:11:29,7,33,26
220,BAS,P004603,P007946,0 days 00:09:26,11,29,18
220,BAS,P007946,P011948,0 days 00:06:46,8,23,15
220,BAS,P007946,P009048,0 days 00:06:41,-1,20,21
220,BAS,P011085,P011948,0 days 00:05:40,10,16,6
220,BAS,P004761,P007946,0 days 00:04:48,8,13,5
220,BAS,P007946,P011085,0 days 00:04:44,-1,10,11
220,BAS,P003198,P009048,0 days 00:04:09,-9,6,15
220,BAS,P008850,P011948,0 days 00:04:03,-7,8,15
220,BAS,P003198,P011948,0 days 00:03:58,-7,6,13
220,BAS,P008850,P009048,0 days 00:03:27,-11,4,15
220,BAS,P004603,P008850,0 days 00:03:09,-7,6,13
220,BAS,P003198,P008850,0 days 00:02:17,-7,2,9
220,BAS,P003198,P004603,0 days 00:02:17,-7,2,9
220,BAS,P008850,P012201,0 days 00:02:02,-4,6,10
220,BAS,P003198,P012201,0 days 00:01:52,-2,4,6
220,BAS,P003198,P004761,0 days 00:01:11,-4,2,6
220,BAS,P007946,P008850,0 days 00:01:10,-4,2,6
220,BAS,P004761,P008850,0 days 00:01:03,-2,4,6
220,BAS,P003198,P007946,0 days 00:00:52,0,2,2
220,BAS,P008850,P011085,0 days 00:00:05,-2,0,2
220,TEL,P009783,P009863,0 days 00:24:38,-6,46,52
220,TEL,P009863,P011199,0 days 00:23:02,-5,41,46
220,TEL,P009783,P011199,0 days 00:20:20,-6,35,41
220,TEL,P009622,P011199,0 days 00:19:36,-13,34,47
220,TEL,P009622,P009863,0 days 00:17:31,-3,36,39
220,TEL,P009622,P009783,0 days 00:17:06,-3,33,36
220,TEL,P009863,P011971,0 days 00:17:00,-10,31,41
220,TEL,P009783,P011193,0 days 00:14:46,-2,29,31
220,TEL,P009622,P011214,0 days 00:13:53,-8,32,40
220,TEL,P009863,P011193,0 days 00:13:10,-5,26,31
220,TEL,P009783,P011971,0 days 00:13:04,-10,19,29
220,TEL,P011193,P011219,0 days 00:12:21,5,35,30
220,TEL,P009622,P012744,0 days 00:11:42,4,31,27
220,TEL,P011199,P011971,0 days 00:11:27,-9,14,23
220,TEL,P011193,P011971,0 days 00:10:34,-6,20,26
220,TEL,P011199,P012744,0 days 00:09:40,2,20,18
220,TEL,P009622,P011193,0 days 00:09:07,-2,20,22
220,TEL,P009622,P011971,0 days 00:08:28,-10,11,21
220,TEL,P011193,P011199,0 days 00:08:18,-6,11,17
220,TEL,P009863,P012744,0 days 00:08:04,9,22,13
220,TEL,P009783,P011219,0 days 00:07:57,0,20,20
220,TEL,P011214,P012744,0 days 00:07:52,-6,17,23
220,TEL,P011214,P011219,0 days 00:07:42,4,20,16
220,TEL,P011193,P011214,0 days 00:07:22,4,20,16
220,TEL,P009622,P011219,0 days 00:07:22,4,20,16
220,TEL,P011193,P012744,0 days 00:06:54,0,15,15
220,TEL,P009783,P011214,0 days 00:06:10,-4,13,17
220,TEL,P011199,P011214,0 days 00:05:40,-12,8,20
220,TEL,P009863,P011219,0 days 00:05:30,3,17,14
220,TEL,P009783,P012744,0 days 00:05:00,5,12,7
220,TEL,P011219,P011971,0 days 00:04:59,1,15,14
220,TEL,P011219,P012744,0 days 00:04:32,1,11,10
220,TEL,P005145,P011199,0 days 00:04:22,3,11,8
220,TEL,P005145,P009863,0 days 00:04:22,3,11,8
220,TEL,P005145,P009783,0 days 00:04:22,3,11,8
220,TEL,P005145,P009622,0 days 00:04:22,3,11,8
220,TEL,P009863,P011214,0 days 00:03:52,-2,10,12
220,TEL,P007990,P009622,0 days 00:03:29,-8,4,12
220,TEL,P007990,P011214,0 days 00:03:29,-8,4,12
220,TEL,P007990,P011199,0 days 00:03:10,-8,4,12
220,TEL,P011971,P012744,0 days 00:02:44,4,10,6
220,TEL,P007990,P012744,0 days 00:02:28,-7,2,9
220,TEL,P007990,P009783,0 days 00:01:01,-1,2,3
220,TEL,P011214,P011971,0 days 00:00:52,0,4,4
220,TEL,P011199,P011219,0 days 00:00:21,2,2,0
220,TEL,P007990,P009863,0 days 00:00:19,0,0,0
221,IST,P007200,P009664,0 days 00:29:47,11,58,47
221,IST,P004888,P007200,0 days 00:29:12,8,57,49
221,IST,P009664,PLHK,0 days 00:27:42,14,56,42
221,IST,P007200,PLHK,0 days 00:27:11,14,54,40
221,IST,P004888,P009664,0 days 00:26:19,17,54,37
221,IST,P009664,P011078,0 days 00:25:28,20,55,35
221,IST,P004888,PLHK,0 days 00:24:25,18,50,32
221,IST,P004888,P011078,0 days 00:24:00,12,53,41
221,IST,P007200,P011078,0 days 00:21:04,14,45,31
221,IST,P011078,PLHK,0 days 00:19:41,15,43,28
221,IST,P006590,P009846,0 days 00:13:41,-11,25,36
221,IST,P009846,P011981,0 days 00:10:24,-7,19,26
221,IST,P006590,P011981,0 days 00:10:24,-7,19,26
221,IST,P011078,P011981,0 days 00:08:43,3,20,17
221,IST,P006590,P009664,0 days 00:07:52,0,14,14
221,IST,P009664,P009846,0 days 00:07:52,0,14,14
221,IST,P004888,P011981,0 days 00:07:43,-12,15,27
221,IST,P006590,P011078,0 days 00:07:20,4,18,14
221,IST,P009846,P011078,0 days 00:07:20,4,18,14
221,IST,P009664,P011981,0 days 00:06:29,3,12,9
221,IST,P007200,P009846,0 days 00:06:21,-15,7,22
221,IST,P006590,P007200,0 days 00:06:21,-15,7,22
221,IST,P004888,P006590,0 days 00:05:49,-11,11,22
221,IST,P004888,P009846,0 days 00:05:49,-11,11,22
221,IST,P007200,P011981,0 days 00:05:29,-12,7,19
221,IST,P007200,P010516,0 days 00:05:15,3,9,6
221,IST,P009664,P010516,0 days 00:05:15,3,9,6
221,IST,P004888,P010516,0 days 00:05:15,3,9,6
221,IST,P010516,PLHK,0 days 00:05:15,3,9,6
221,IST,P006590,PLHK,0 days 00:03:17,-4,6,10
221,IST,P009846,PLHK,0 days 00:03:17,-4,6,10
221,MIL,P007831,P011224,0 days 00:25:55,0,43,43
221,MIL,P002849,P011224,0 days 00:24:41,2,44,42
221,MIL,P002849,P007831,0 days 00:23:30,3,41,38
221,MIL,P007201,P007831,0 days 00:22:01,2,39,37
221,MIL,P002849,P007201,0 days 00:19:31,7,36,29
221,MIL,P007201,P011224,0 days 00:19:31,7,36,29
221,MIL,P007831,P011205,0 days 00:18:27,-17,23,40
221,MIL,P011205,P011224,0 days 00:15:17,-6,20,26
221,MIL,P011224,P012800,0 days 00:12:38,3,26,23
221,MIL,P000796,P007032,0 days 00:12:36,-5,27,32
221,MIL,P002849,P011205,0 days 00:12:34,-3,18,21
221,MIL,P002849,P012800,0 days 00:12:20,3,26,23
221,MIL,P007201,P011205,0 days 00:12:14,-8,16,24
221,MIL,P007201,P012800,0 days 00:11:58,6,25,19
221,MIL,P007831,P012800,0 days 00:11:09,4,23,19
221,MIL,P000796,P002812,0 days 00:10:38,1,24,23
221,MIL,P000796,P012800,0 days 00:09:26,6,24,18
221,MIL,P007032,P012800,0 days 00:09:08,6,24,18
221,MIL,P006509,P012800,0 days 00:08:27,7,25,18
221,MIL,P002812,P012800,0 days 00:08:26,9,25,16
221,MIL,P000796,P011205,0 days 00:08:03,-16,7,23
221,MIL,P002812,P007032,0 days 00:07:55,4,22,18
221,MIL,P006509,P007032,0 days 00:07:16,8,22,14
221,MIL,P000796,P006509,0 days 00:07:16,8,22,14
221,MIL,P002812,P006509,0 days 00:06:16,11,23,12
221,MIL,P000796,P007831,0 days 00:05:53,-14,5,19
221,MIL,P002812,P011205,0 days 00:05:33,-11,4,15
221,MIL,P007032,P011205,0 days 00:05:20,-13,5,18
221,MIL,P007032,P007201,0 days 00:04:41,-9,5,14
221,MIL,P000796,P007201,0 days 00:04:41,-9,5,14
221,MIL,P002812,P011224,0 days 00:03:54,-4,5,9
221,MIL,P009960,P011224,0 days 00:03:46,-2,5,7
221,MIL,P007831,P009960,0 days 00:03:46,-2,5,7
221,MIL,P002849,P009960,0 days 00:03:46,-2,5,7
221,MIL,P007032,P007831,0 days 00:03:28,-11,3,14
221,MIL,P002812,P007831,0 days 00:03:23,-9,2,11
221,MIL,P000796,P011224,0 days 00:02:43,-3,2,5
221,MIL,P009960,P011205,0 days 00:02:37,2,5,3
221,MIL,P011205,P012800,0 days 00:02:23,-4,2,6
221,MIL,P006509,P007201,0 days 00:02:11,-4,2,6
221,MIL,P002812,P002849,0 days 00:01:11,-1,3,4
221,MIL,P002849,P006509,0 days 00:01:11,-1,3,4
221,MIL,P006509,P011224,0 days 00:01:11,-1,3,4
221,MIL,P009960,P012800,0 days 00:01:09,-4,0,4
222,MCO,P005985,P010588,0 days 00:33:36,4,61,57
222,MCO,P010588,P011226,0 days 00:25:27,4,50,46
222,MCO,P010588,P011212,0 days 00:23:16,20,49,29
222,MCO,P005985,P011226,0 days 00:22:52,0,43,43
222,MCO,P011212,P011226,0 days 00:21:47,14,48,34
222,MCO,P005985,P011212,0 days 00:20:41,16,42,26
222,MCO,P010588,PLCZ,0 days 00:20:11,-3,33,36
222,MCO,P005985,PLCZ,0 days 00:19:25,-5,31,36
222,MCO,P009754,P010588,0 days 00:15:35,2,27,25
222,MCO,P005985,P009754,0 days 00:13:00,-2,20,22
222,MCO,P011196,P011226,0 days 00:12:43,6,25,19
222,MCO,P009754,P011212,0 days 00:11:42,8,24,16
222,MCO,P011196,P011212,0 days 00:11:40,9,25,16
222,MCO,P011226,PLCZ,0 days 00:11:16,-2,22,24
222,MCO,P009754,PLCZ,0 days 00:10:54,-2,15,17
222,MCO,P010588,P011196,0 days 00:10:39,6,21,15
222,MCO,P009754,P011231,0 days 00:09:15,-2,17,19
222,MCO,P005985,P011196,0 days 00:08:50,4,16,12
222,MCO,P009754,P011226,0 days 00:08:40,-3,17,20
222,MCO,P011212,PLCZ,0 days 00:08:19,6,14,8
222,MCO,P002581,P011212,0 days 00:07:06,4,18,14
222,MCO,P011231,PLCZ,0 days 00:05:26,-1,9,10
222,MCO,P010588,P011231,0 days 00:05:26,-1,9,10
222,MCO,P005985,P011231,0 days 00:05:26,-1,9,10
222,MCO,P002581,P005985,0 days 00:05:21,5,14,9
222,MCO,P002581,P010588,0 days 00:05:21,5,14,9
222,MCO,P002581,P011226,0 days 00:05:17,-1,11,12
222,MCO,P004197,PLCZ,0 days 00:05:13,-5,8,13
222,MCO,P004197,P011226,0 days 00:05:13,-5,8,13
222,MCO,P004197,P010588,0 days 00:05:13,-5,8,13
222,MCO,P004197,P005985,0 days 00:05:13,-5,8,13
222,MCO,P009754,P011196,0 days 00:04:56,-1,9,10
222,MCO,P011212,P011231,0 days 00:03:49,-1,8,9
222,MCO,P011226,P011231,0 days 00:03:49,-1,8,9
222,MCO,P002581,P009754,0 days 00:03:34,4,11,7
222,MCO,P011196,P011231,0 days 00:02:04,0,4,4
222,MCO,P002581,P011231,0 days 00:01:45,-1,4,5
222,ULK,P001932,P006661,0 days 00:21:06,-3,28,31
222,ULK,P002968,P006661,0 days 00:20:24,-7,35,42
222,ULK,P004004,P006661,0 days 00:18:54,-12,29,41
222,ULK,P005844,P006661,0 days 00:17:57,-2,30,32
222,ULK,P006068,P006661,0 days 00:16:56,6,35,29
222,ULK,P001932,P002968,0 days 00:16:27,-3,26,29
222,ULK,P001932,P006068,0 days 00:15:47,5,29,24
222,ULK,P004004,P008962,0 days 00:15:00,-7,23,30
222,ULK,P006661,P008962,0 days 00:14:44,-2,27,29
222,ULK,P001932,P005844,0 days 00:13:52,-3,20,23
222,ULK,P002968,P006068,0 days 00:13:26,-1,28,29
222,ULK,P005844,P006068,0 days 00:13:21,0,24,24
222,ULK,P002968,P004004,0 days 00:12:22,-10,19,29
222,ULK,P002968,P005844,0 days 00:11:35,-3,22,25
222,ULK,P006661,P011157,0 days 00:11:25,0,19,19
222,ULK,P001932,P008962,0 days 00:11:19,-2,15,17
222,ULK,P002968,P008962,0 days 00:11:10,-6,18,24
222,ULK,P008962,P011157,0 days 00:10:31,0,20,20
222,ULK,P001932,P004004,0 days 00:10:01,-8,8,16
222,ULK,P004004,P011157,0 days 00:09:24,-4,14,18
222,ULK,P004004,P006961,0 days 00:08:41,0,18,18
222,ULK,P006961,P008962,0 days 00:08:08,-1,17,18
222,ULK,P001932,P011157,0 days 00:08:07,-4,7,11
222,ULK,P008962,P009849,0 days 00:07:59,-4,15,19
222,ULK,P006068,P008962,0 days 00:07:54,4,18,14
222,ULK,P004004,P005844,0 days 00:07:23,-5,12,17
222,ULK,P006068,P011157,0 days 00:07:12,3,12,9
222,ULK,P005844,P011157,0 days 00:06:22,1,8,7
222,ULK,P006961,P011157,0 days 00:06:08,3,12,9
222,ULK,P009849,P011157,0 days 00:05:39,-2,10,12
222,ULK,P006661,P006961,0 days 00:05:27,1,13,12
222,ULK,P001932,P009849,0 days 00:04:05,-2,7,9
222,ULK,P006068,P009849,0 days 00:04:05,-2,7,9
222,ULK,P004004,P009849,0 days 00:03:54,-2,8,10
222,ULK,P004004,P006068,0 days 00:03:53,0,9,9
222,ULK,P006961,P009849,0 days 00:03:15,0,6,6
222,ULK,P002968,P006961,0 days 00:02:48,-2,7,9
222,ULK,P002968,P009849,0 days 00:02:20,-2,5,7
222,ULK,P006068,P011052,0 days 00:02:12,1,6,5
222,ULK,P006661,P011052,0 days 00:02:12,1,6,5
222,ULK,P008962,P011052,0 days 00:02:12,1,6,5
222,ULK,P011052,P011157,0 days 00:01:44,3,6,3
222,ULK,P005844,P006961,0 days 00:01:03,3,3,0
222,ULK,P006661,P009849,0 days 00:00:39,-2,2,4
222,ULK,P002968,P011052,0 days 00:00:28,-2,0,2
222,ULK,P005844,P008962,0 days 00:00:15,1,1,0
222,ULK,P006068,P006961,0 days 00:00:14,0,0,0
223,RED,P000848,P006436,0 days 00:22:35,2,47,45
223,RED,P006436,P009035,0 days 00:20:48,-6,33,39
223,RED,P000848,P009035,0 days 00:18:26,-6,31,37
223,RED,P006436,P012044,0 days 00:15:20,-3,28,31
223,RED,P000848,PJDR,0 days 00:14:54,-1,28,29
223,RED,P000848,P012044,0 days 00:14:31,5,35,30
223,RED,P005099,PJDR,0 days 00:13:43,-3,26,29
223,RED,P009035,PJDR,0 days 00:12:33,-3,21,24
223,RED,P007960,P012044,0 days 00:11:31,-3,19,22
223,RED,P000848,P005099,0 days 00:11:28,2,24,22
223,RED,P006436,PJDR,0 days 00:11:19,1,21,20
223,RED,P012044,P012801,0 days 00:10:49,5,30,25
223,RED,P007960,P009035,0 days 00:10:25,-10,14,24
223,RED,P009035,P012044,0 days 00:09:57,-7,12,19
223,RED,P006436,P007960,0 days 00:09:48,-6,14,20
223,RED,P005099,P009035,0 days 00:09:07,0,17,17
223,RED,P000848,P007960,0 days 00:08:09,-2,19,21
223,RED,P005099,P006436,0 days 00:07:53,4,17,13
223,RED,P011941,P012044,0 days 00:07:39,8,23,15
223,RED,P011941,P012801,0 days 00:07:39,8,23,15
223,RED,P000848,P012801,0 days 00:07:39,8,23,15
223,RED,P000848,P011941,0 days 00:07:39,8,23,15
223,RED,P002553,P008966,0 days 00:07:30,-3,18,21
223,RED,P005099,P008966,0 days 00:07:18,-5,16,21
223,RED,P008966,PJDR,0 days 00:07:10,-5,11,16
223,RED,P002553,P005099,0 days 00:07:08,-3,16,19
223,RED,P012044,PLUO,0 days 00:06:37,-5,6,11
223,RED,P008966,P012044,0 days 00:06:30,-6,11,17
223,RED,P000848,P002553,0 days 00:06:04,-2,11,13
223,RED,P006436,P012801,0 days 00:05:51,4,16,12
223,RED,P006436,P011941,0 days 00:05:51,4,16,12
223,RED,P002553,P012044,0 days 00:05:48,-6,11,17
223,RED,P007960,PJDR,0 days 00:05:24,-11,6,17
223,RED,P000848,P008966,0 days 00:04:48,2,9,7
223,RED,P008966,P012801,0 days 00:04:38,-6,9,15
223,RED,P009035,PLUO,0 days 00:04:32,-4,2,6
223,RED,P002553,PJDR,0 days 00:04:26,-1,9,10
223,RED,P007960,PLUO,0 days 00:04:04,-4,2,6
223,RED,P006436,PLUO,0 days 00:04:04,-4,2,6
223,RED,P005099,P012044,0 days 00:03:29,-4,7,11
223,RED,P007960,P012801,0 days 00:03:22,2,9,7
223,RED,P002553,P012801,0 days 00:03:04,-4,7,11
223,RED,P005099,P012801,0 days 00:03:04,-4,7,11
223,RED,P012801,PJDR,0 days 00:03:02,-5,4,9
223,RED,P002553,P009035,0 days 00:02:44,-4,2,6
223,RED,P008966,PLUO,0 days 00:02:33,-1,4,5
223,RED,P012044,PJDR,0 days 00:02:21,-4,2,6
223,RED,P007960,P008966,0 days 00:02:21,-4,2,6
223,RED,P002553,P006436,0 days 00:02:07,-4,2,6
223,RED,P002553,PLUO,0 days 00:02:05,-1,4,5
223,RED,P007960,P011941,0 days 00:01:48,4,7,3
223,RED,P008966,P009035,0 days 00:01:28,0,0,0
223,RED,P000848,PLUO,0 days 00:01:27,0,2,2
223,RED,P005099,P007960,0 days 00:01:24,-6,0,6
223,RED,P005099,PLUO,0 days 00:01:06,-1,2,3
223,RED,P006436,P008966,0 days 00:01:00,0,0,0
223,BAR,P004866,P012745,0 days 00:25:26,5,48,43
223,BAR,P000925,P002939,0 days 00:23:30,9,46,37
223,BAR,P002939,P012745,0 days 00:23:10,4,45,41
223,BAR,P006435,P012745,0 days 00:21:44,8,44,36
223,BAR,P000925,P012745,0 days 00:20:47,12,42,30
223,BAR,P002939,P004866,0 days 00:20:29,1,38,37
223,BAR,P004866,P006435,0 days 00:19:31,3,37,34
223,BAR,P002939,P006435,0 days 00:19:04,1,35,34
223,BAR,P000925,P006435,0 days 00:16:41,9,32,23
223,BAR,P000925,P004866,0 days 00:16:40,6,30,24
223,BAR,P007519,P009992,0 days 00:15:18,3,36,33
223,BAR,P002939,P009992,0 days 00:13:09,7,34,27
223,BAR,P003196,P007519,0 days 00:10:41,5,26,21
223,BAR,P002939,P007519,0 days 00:10:34,7,29,22
223,BAR,P003196,P004866,0 days 00:09:36,-4,19,23
223,BAR,P003196,P009992,0 days 00:09:04,3,22,19
223,BAR,P003196,P012745,0 days 00:08:46,-1,18,19
223,BAR,P002939,P003196,0 days 00:08:43,-1,23,24
223,BAR,P000925,P009992,0 days 00:08:15,3,19,16
223,BAR,P007519,P012745,0 days 00:07:54,10,20,10
223,BAR,P009992,P012745,0 days 00:07:49,3,16,13
223,BAR,P000925,P007519,0 days 00:07:06,6,19,13
223,BAR,P004866,P009992,0 days 00:07:02,-1,12,13
223,BAR,P000925,P007464,0 days 00:06:45,3,16,13
223,BAR,P007464,P007519,0 days 00:06:07,1,14,13
223,BAR,P004866,P007519,0 days 00:06:04,1,11,10
223,BAR,P002939,P007464,0 days 00:05:51,-2,11,13
223,BAR,P007519,P011244,0 days 00:05:46,0,16,16
223,BAR,P003196,P006435,0 days 00:05:26,-3,12,15
223,BAR,P009992,P011244,0 days 00:05:23,2,16,14
223,BAR,P003196,P011244,0 days 00:05:12,3,16,13
223,BAR,P007464,P009992,0 days 00:04:41,-2,9,11
223,BAR,P002939,P011244,0 days 00:04:22,6,15,9
223,BAR,P006435,P007519,0 days 00:03:03,5,9,4
223,BAR,P006435,P007464,0 days 00:02:36,3,7,4
223,BAR,P007464,P012745,0 days 00:02:36,3,7,4
223,BAR,P004866,P011244,0 days 00:01:07,-3,1,4
223,BAR,P007519,P010641,0 days 00:00:34,-3,0,3
223,BAR,P009992,P010641,0 days 00:00:34,-3,0,3
223,BAR,P010641,P011244,0 days 00:00:34,-3,0,3
223,BAR,P003196,P007464,0 days 00:00:32,-2,0,2
223,BAR,P006435,P011244,0 days 00:00:23,-2,0,2
223,BAR,P003204,P007519,0 days 00:00:17,-3,0,3
223,BAR,P003204,P009992,0 days 00:00:17,-3,0,3
223,BAR,P003204,P010641,0 days 00:00:17,-3,0,3
223,BAR,P003204,P011244,0 days 00:00:17,-3,0,3
223,BAR,P004866,P010641,0 days 00:00:17,0,0,0
224,VIR,P003048,PBCN,0 days 00:22:16,3,51,48
224,VIR,P001844,P009549,0 days 00:21:51,14,52,38
224,VIR,P001844,P003048,0 days 00:21:46,9,53,44
224,VIR,P003048,P009549,0 days 00:20:52,10,48,38
224,VIR,P001844,PBCN,0 days 00:18:05,2,39,37
224,VIR,P003527,P010781,0 days 00:17:36,-2,35,37
224,VIR,P001133,P001844,0 days 00:17:24,2,35,33
224,VIR,P001133,PBCN,0 days 00:17:18,-1,34,35
224,VIR,P009549,PBCN,0 days 00:17:11,3,34,31
224,VIR,P001133,P003048,0 days 00:16:22,1,34,33
224,VIR,P001133,P009549,0 days 00:15:34,4,31,27
224,VIR,P006739,P010781,0 days 00:14:03,-6,26,32
224,VIR,P006739,P008847,0 days 00:12:42,-7,24,31
224,VIR,P003527,P006739,0 days 00:11:56,-13,17,30
224,VIR,P003527,P008847,0 days 00:11:48,-4,21,25
224,VIR,P003048,P010781,0 days 00:11:24,7,35,28
224,VIR,P008847,P010781,0 days 00:11:21,-4,21,25
224,VIR,P003527,P009549,0 days 00:10:34,6,29,23
224,VIR,P010781,PBCN,0 days 00:10:10,-1,25,26
224,VIR,P006739,PBCN,0 days 00:09:16,0,20,20
224,VIR,P003048,P003527,0 days 00:08:21,6,24,18
224,VIR,P001844,P003527,0 days 00:08:13,15,28,13
224,VIR,P009549,P010781,0 days 00:08:01,2,19,17
224,VIR,P008847,PBCN,0 days 00:07:38,2,17,15
224,VIR,P003527,PBCN,0 days 00:07:30,0,16,16
224,VIR,P001844,P010781,0 days 00:07:30,6,23,17
224,VIR,P008847,P009549,0 days 00:06:57,-4,12,16
224,VIR,P001133,P010781,0 days 00:06:07,-2,12,14
224,VIR,P003048,P006739,0 days 00:05:30,1,14,13
224,VIR,P001133,P008847,0 days 00:05:19,1,9,8
224,VIR,P006739,P009549,0 days 00:04:37,-8,6,14
224,VIR,P001133,P003527,0 days 00:04:23,3,9,6
224,VIR,P001133,P006739,0 days 00:04:17,0,8,8
224,VIR,P001844,P008847,0 days 00:02:35,4,6,2
224,VIR,P003048,P008847,0 days 00:02:33,3,9,6
224,VIR,P003527,P004007,0 days 00:00:15,-3,1,4
224,VIR,P004007,P006739,0 days 00:00:15,-3,1,4
224,VIR,P004007,P008847,0 days 00:00:15,-3,1,4
224,VIR,P004007,P009549,0 days 00:00:15,-3,1,4
224,PAR,P009862,P012742,0 days 00:25:50,5,58,53
224,PAR,P007400,P012742,0 days 00:22:25,3,55,52
224,PAR,P007400,P009862,0 days 00:21:37,6,54,48
224,PAR,P011050,P012742,0 days 00:18:38,5,35,30
224,PAR,P009862,P011050,0 days 00:17:47,6,34,28
224,PAR,P011051,P011192,0 days 00:15:55,0,31,31
224,PAR,P007400,P011050,0 days 00:15:20,5,31,26
224,PAR,P003983,P012742,0 days 00:13:25,3,36,33
224,PAR,P004172,P011192,0 days 00:13:18,-6,25,31
224,PAR,P003983,P011051,0 days 00:13:03,-3,34,37
224,PAR,P003983,P009862,0 days 00:12:33,6,35,29
224,PAR,P003983,P007400,0 days 00:12:05,4,36,32
224,PAR,P008987,P009862,0 days 00:11:55,-8,20,28
224,PAR,P011192,P012743,0 days 00:11:26,-6,20,26
224,PAR,P004172,P012743,0 days 00:11:06,-6,20,26
224,PAR,P003983,P011050,0 days 00:11:04,4,23,19
224,PAR,P004172,P011051,0 days 00:10:28,0,23,23
224,PAR,P003983,P011192,0 days 00:09:50,-4,20,24
224,PAR,P003983,P004172,0 days 00:09:49,-2,20,22
224,PAR,P003983,P012743,0 days 00:09:18,-3,18,21
224,PAR,P009862,P011051,0 days 00:09:13,2,24,22
224,PAR,P011051,P012742,0 days 00:09:03,-1,22,23
224,PAR,P011051,P012743,0 days 00:08:59,-2,18,20
224,PAR,P009862,P011192,0 days 00:08:55,-2,13,15
224,PAR,P008987,P012742,0 days 00:08:30,-4,15,19
224,PAR,P007400,P008987,0 days 00:07:51,-3,15,18
224,PAR,P008987,P011050,0 days 00:05:43,-3,8,11
224,PAR,P007400,P011051,0 days 00:05:29,-1,18,19
224,PAR,P011192,P012742,0 days 00:05:27,0,8,8
224,PAR,P009862,P012743,0 days 00:04:38,-8,6,14
224,PAR,P008987,P012743,0 days 00:04:18,-8,6,14
224,PAR,P011050,P011051,0 days 00:04:09,-1,5,6
224,PAR,P004172,P008987,0 days 00:03:48,-6,5,11
224,PAR,P008987,P011192,0 days 00:03:48,-6,5,11
224,PAR,P004172,P009862,0 days 00:03:29,-4,5,9
224,PAR,P011050,P011192,0 days 00:03:00,-2,4,6
224,PAR,P007400,P011192,0 days 00:02:34,0,4,4
224,PAR,P012742,P012743,0 days 00:02:11,-4,4,8
224,PAR,P012096,P012742,0 days 00:01:19,1,3,2
224,PAR,P007400,P012096,0 days 00:01:19,1,3,2
224,PAR,P009862,P012096,0 days 00:01:19,1,3,2
224,PAR,P008987,P012096,0 days 00:01:19,1,3,2
224,PAR,P007400,P012743,0 days 00:01:12,-3,4,7
224,PAR,P003983,P008987,0 days 00:01:02,-3,0,3
224,PAR,P008987,P011051,0 days 00:00:58,0,3,3
224,PAR,P003983,P012096,0 days 00:00:47,2,2,0
224,PAR,P004172,P012096,0 days 00:00:47,2,2,0
224,PAR,P011051,P012096,0 days 00:00:47,2,2,0
224,PAR,P011192,P012096,0 days 00:00:47,2,2,0
224,PAR,P004172,P011050,0 days 00:00:23,-2,0,2
224,PAR,P004172,P007400,0 days 00:00:04,0,0,0
225,ZAL,P002329,P011218,0 days 00:23:07,22,57,35
225,ZAL,P002329,P007513,0 days 00:21:47,17,56,39
225,ZAL,P007513,P011218,0 days 00:17:57,16,49,33
225,ZAL,P005504,P011218,0 days 00:17:38,6,41,35
225,ZAL,P002329,P012715,0 days 00:17:24,11,44,33
225,ZAL,P002329,P005504,0 days 00:17:22,3,43,40
225,ZAL,P011218,P012715,0 days 00:15:59,8,39,31
225,ZAL,P007513,P012715,0 days 00:15:02,13,44,31
225,ZAL,P002676,P011218,0 days 00:13:46,8,20,12
225,ZAL,P002676,P012787,0 days 00:12:30,-3,19,22
225,ZAL,P005504,P007513,0 days 00:12:26,-1,33,34
225,ZAL,P002676,P010390,0 days 00:11:45,2,18,16
225,ZAL,P005504,P012715,0 days 00:11:12,4,31,27
225,ZAL,P002329,P002676,0 days 00:11:07,10,20,10
225,ZAL,P002676,P007109,0 days 00:10:02,-6,12,18
225,ZAL,P007109,P012787,0 days 00:09:15,-5,11,16
225,ZAL,P002329,P010390,0 days 00:08:22,10,15,5
225,ZAL,P002676,P005504,0 days 00:07:34,-1,12,13
225,ZAL,P010390,P011218,0 days 00:07:18,4,10,6
225,ZAL,P002676,P007513,0 days 00:07:14,1,12,11
225,ZAL,P003211,P007109,0 days 00:07:02,2,14,12
225,ZAL,P002329,P007109,0 days 00:06:55,4,14,10
225,ZAL,P002329,P012787,0 days 00:06:50,5,15,10
225,ZAL,P007109,P011218,0 days 00:06:43,0,10,10
225,ZAL,P003211,P010390,0 days 00:06:38,1,10,9
225,ZAL,P007513,P010390,0 days 00:06:35,9,13,4
225,ZAL,P005504,P012787,0 days 00:06:32,1,12,11
225,ZAL,P011218,P012787,0 days 00:06:06,2,10,8
225,ZAL,P002676,P003211,0 days 00:06:05,3,10,7
225,ZAL,P010390,P012787,0 days 00:06:00,-3,8,11
225,ZAL,P007109,P010390,0 days 00:05:45,-2,10,12
225,ZAL,P005504,P007109,0 days 00:05:08,-8,4,12
225,ZAL,P007109,P012715,0 days 00:05:00,8,12,4
225,ZAL,P002329,P003211,0 days 00:04:34,-4,4,8
225,ZAL,P007513,P012787,0 days 00:04:12,-1,7,8
225,ZAL,P003210,P007109,0 days 00:04:05,-5,7,12
225,ZAL,P003211,P012787,0 days 00:03:39,3,7,4
225,ZAL,P007109,P007513,0 days 00:03:37,4,10,6
225,ZAL,P003210,P003211,0 days 00:03:31,-1,7,8
225,ZAL,P003211,P012715,0 days 00:02:51,0,2,2
225,ZAL,P012715,P012787,0 days 00:02:50,5,7,2
225,ZAL,P010390,P012715,0 days 00:02:45,1,3,2
225,ZAL,P002329,P003210,0 days 00:02:44,-2,4,6
225,ZAL,P003211,P011218,0 days 00:02:42,-2,0,2
225,ZAL,P003211,P005504,0 days 00:02:40,-4,2,6
225,ZAL,P002676,P012715,0 days 00:02:37,2,2,0
225,ZAL,P003210,P010390,0 days 00:02:13,-1,5,6
225,ZAL,P003210,P005504,0 days 00:02:00,-4,2,6
225,ZAL,P002676,P003210,0 days 00:01:29,-3,3,6
225,ZAL,P003210,P012787,0 days 00:00:42,-4,0,4
225,ZAL,P003210,P012715,0 days 00:00:08,0,0,0
225,ZAL,P002676,P006860,0 days 00:00:07,-1,0,1
225,ZAL,P003211,P006860,0 days 00:00:07,-1,0,1
225,ZAL,P003211,P007513,0 days 00:00:07,-1,0,1
225,ZAL,P006860,P007513,0 days 00:00:07,-1,0,1
225,ZAL,P006860,P010390,0 days 00:00:07,-1,0,1
225,PAN,P002328,P012774,0 days 00:31:37,-2,60,62
225,PAN,P002328,P003842,0 days 00:29:34,-8,56,64
225,PAN,P003842,P012774,0 days 00:28:36,-10,52,62
225,PAN,P003842,P011204,0 days 00:24:35,-16,44,60
225,PAN,P011204,P012774,0 days 00:24:34,-14,44,58
225,PAN,P002328,P011204,0 days 00:23:57,-8,48,56
225,PAN,P007866,P012774,0 days 00:23:39,-9,43,52
225,PAN,P007866,P011204,0 days 00:23:31,-9,45,54
225,PAN,P002328,P007866,0 days 00:22:30,-5,43,48
225,PAN,P003842,P007866,0 days 00:21:06,-15,37,52
225,PAN,P003842,P007947,0 days 00:15:19,2,24,22
225,PAN,P007947,P012712,0 days 00:13:25,2,22,20
225,PAN,P003842,P012712,0 days 00:13:16,3,23,20
225,PAN,P002328,P012712,0 days 00:12:40,3,23,20
225,PAN,P012712,P012774,0 days 00:12:01,1,19,18
225,PAN,P002328,P007947,0 days 00:11:40,2,20,18
225,PAN,P007947,P012774,0 days 00:11:08,0,16,16
225,PAN,P011204,P012712,0 days 00:08:08,-5,9,14
225,PAN,P007947,P011204,0 days 00:07:07,-6,8,14
225,PAN,P011204,P011221,0 days 00:04:12,-2,6,8
225,PAN,P011221,P012774,0 days 00:04:12,-2,6,8
225,PAN,P007866,P007947,0 days 00:03:22,-4,2,6
225,PAN,P003842,P011209,0 days 00:03:18,-2,2,4
225,PAN,P011204,P011209,0 days 00:03:11,-2,2,4
225,PAN,P007866,P011221,0 days 00:02:44,2,6,4
225,PAN,P002328,P011221,0 days 00:02:44,2,6,4
225,PAN,P011209,P012712,0 days 00:02:09,2,2,0
225,PAN,P007947,P011209,0 days 00:02:02,2,2,0
225,PAN,P003842,P005161,0 days 00:01:37,-2,2,4
225,PAN,P005161,P007866,0 days 00:01:37,-2,2,4
225,PAN,P005161,P007947,0 days 00:01:37,-2,2,4
225,PAN,P005161,P011204,0 days 00:01:37,-2,2,4
225,PAN,P011221,P012712,0 days 00:01:28,-4,0,4
225,PAN,P007947,P011221,0 days 00:01:28,-4,0,4
225,PAN,P007866,P012712,0 days 00:01:26,2,2,0
225,PAN,P007866,P011209,0 days 00:01:09,-4,0,4
225,PAN,P011209,P012774,0 days 00:01:09,-4,0,4
225,PAN,P002328,P006544,0 days 00:00:07,0,0,0
225,PAN,P002328,P011209,0 days 00:00:07,0,0,0
225,PAN,P003842,P006544,0 days 00:00:07,0,0,0
225,PAN,P006544,P011209,0 days 00:00:07,0,0,0
225,PAN,P006544,P012712,0 days 00:00:07,0,0,0
226,MIL,P002849,P007831,0 days 00:22:31,-9,44,53
226,MIL,P000796,P011205,0 days 00:21:18,15,51,36
226,MIL,P000796,P007831,0 days 00:19:19,-8,38,46
226,MIL,P000796,P007032,0 days 00:18:53,9,42,33
226,MIL,P007831,P011205,0 days 00:18:02,-1,39,40
226,MIL,P007032,P011205,0 days 00:17:30,15,41,26
226,MIL,P007032,P007831,0 days 00:16:22,-3,33,36
226,MIL,P000796,P002849,0 days 00:13:25,-9,25,34
226,MIL,P007201,P007831,0 days 00:13:16,-8,22,30
226,MIL,P002849,P007032,0 days 00:12:57,-6,25,31
226,MIL,P002812,P011205,0 days 00:12:37,15,31,16
226,MIL,P002849,P011205,0 days 00:12:35,-3,26,29
226,MIL,P007831,P011224,0 days 00:12:25,-4,23,27
226,MIL,P002812,P012800,0 days 00:11:54,15,26,11
226,MIL,P000796,P002812,0 days 00:11:09,19,30,11
226,MIL,P007201,P011224,0 days 00:10:57,-7,16,23
226,MIL,P007201,P012800,0 days 00:10:55,-2,17,19
226,MIL,P002849,P007201,0 days 00:09:46,-8,17,25
226,MIL,P011205,P012800,0 days 00:09:32,11,22,11
226,MIL,P007032,P012800,0 days 00:08:59,20,24,4
226,MIL,P000796,P012800,0 days 00:08:41,16,22,6
226,MIL,P002812,P011224,0 days 00:08:31,-5,13,18
226,MIL,P007831,P012800,0 days 00:08:17,4,17,13
226,MIL,P002849,P011224,0 days 00:07:51,-3,15,18
226,MIL,P002812,P007032,0 days 00:07:33,20,22,2
226,MIL,P000796,P011224,0 days 00:07:06,0,15,15
226,MIL,P011224,P012800,0 days 00:07:05,-4,10,14
226,MIL,P002812,P007831,0 days 00:06:53,5,16,11
226,MIL,P011205,P011224,0 days 00:06:38,-5,12,17
226,MIL,P002812,P007201,0 days 00:06:36,-3,8,11
226,MIL,P002849,P012800,0 days 00:05:45,4,14,10
226,MIL,P007032,P007201,0 days 00:05:26,-3,9,12
226,MIL,P007201,P011205,0 days 00:05:12,-7,6,13
226,MIL,P001518,P007831,0 days 00:04:55,-4,8,12
226,MIL,P001518,P011224,0 days 00:04:55,-4,8,12
226,MIL,P001518,P007201,0 days 00:04:55,-4,8,12
226,MIL,P001518,P002849,0 days 00:04:55,-4,8,12
226,MIL,P000796,P007201,0 days 00:04:05,-6,5,11
226,MIL,P002812,P002849,0 days 00:00:19,2,2,0
226,MAD,P010357,PTGB,0 days 00:19:34,0,35,35
226,MAD,PCVM,PTGB,0 days 00:19:22,-1,35,36
226,MAD,P010357,PCVM,0 days 00:18:24,2,35,33
226,MAD,P003108,P005791,0 days 00:17:24,3,39,36
226,MAD,P003108,P009005,0 days 00:16:33,4,38,34
226,MAD,P004887,P010357,0 days 00:16:31,-3,31,34
226,MAD,P004887,PTGB,0 days 00:15:46,0,31,31
226,MAD,P003108,P005928,0 days 00:15:33,4,36,32
226,MAD,P005791,P009005,0 days 00:15:26,5,36,31
226,MAD,P005791,P005928,0 days 00:15:13,1,34,33
226,MAD,P004887,PCVM,0 days 00:14:53,0,31,31
226,MAD,P005928,P009005,0 days 00:14:15,4,33,29
226,MAD,P005928,P006540,0 days 00:13:03,-5,25,30
226,MAD,P005791,P006540,0 days 00:12:21,-1,23,24
226,MAD,P003108,P006540,0 days 00:11:08,2,25,23
226,MAD,P006540,P009005,0 days 00:09:50,2,22,20
226,MAD,P006540,P010357,0 days 00:09:09,3,20,17
226,MAD,P004887,P006540,0 days 00:08:36,4,22,18
226,MAD,P010357,PBMT,0 days 00:08:12,-19,4,23
226,MAD,P006540,PTGB,0 days 00:07:54,8,20,12
226,MAD,P006540,PCVM,0 days 00:07:54,8,20,12
226,MAD,P009005,PCVM,0 days 00:07:41,4,16,12
226,MAD,PBMT,PTGB,0 days 00:06:57,-14,4,18
226,MAD,P004887,P009005,0 days 00:06:30,3,13,10
226,MAD,P005791,PCVM,0 days 00:06:29,0,9,9
226,MAD,P001392,P003108,0 days 00:06:25,3,16,13
226,MAD,P001392,P005791,0 days 00:06:25,3,16,13
226,MAD,P001392,P009005,0 days 00:06:25,3,16,13
226,MAD,P004887,PBMT,0 days 00:06:24,-21,0,21
226,MAD,PBMT,PCVM,0 days 00:05:47,-12,4,16
226,MAD,P009005,PTGB,0 days 00:05:41,3,11,8
226,MAD,P005928,PBMT,0 days 00:05:03,-11,3,14
226,MAD,P005791,PTGB,0 days 00:04:46,-3,4,7
226,MAD,P009005,P010357,0 days 00:04:43,6,11,5
226,MAD,P005791,PBMT,0 days 00:04:26,-2,7,9
226,MAD,P001392,P005928,0 days 00:04:25,2,11,9
226,MAD,P005791,P010357,0 days 00:04:18,-2,4,6
226,MAD,P006540,PBMT,0 days 00:03:53,-9,3,12
226,MAD,P004887,P005928,0 days 00:03:25,-6,2,8
226,MAD,P003108,PCVM,0 days 00:02:58,-2,5,7
226,MAD,P005928,P010357,0 days 00:02:25,-7,0,7
226,MAD,P001392,PCVM,0 days 00:02:00,1,5,4
226,MAD,P003108,PBMT,0 days 00:01:58,-2,3,5
226,MAD,P005928,PTGB,0 days 00:01:10,-2,0,2
226,MAD,P003108,P004887,0 days 00:01:07,-1,2,3
226,MAD,P003108,PTGB,0 days 00:00:58,-3,0,3
226,MAD,P009005,PBMT,0 days 00:00:40,-2,0,2
227,IST,P004888,P007200,0 days 00:24:00,3,62,59
227,IST,P004888,PLHK,0 days 00:21:13,1,58,57
227,IST,P007200,P009664,0 days 00:21:02,5,58,53
227,IST,P007200,PLHK,0 days 00:21:00,3,58,55
227,IST,P009664,PLHK,0 days 00:20:00,5,56,51
227,IST,P004888,P009664,0 days 00:20:00,5,56,51
227,IST,P007200,P011078,0 days 00:19:03,0,39,39
227,IST,P011981,P012710,0 days 00:17:41,13,45,32
227,IST,P007200,P011981,0 days 00:16:54,12,42,30
227,IST,P007200,P012710,0 days 00:16:52,10,42,32
227,IST,P007200,P009846,0 days 00:15:17,14,43,29
227,IST,P011078,P012710,0 days 00:14:16,1,30,29
227,IST,P011078,P011981,0 days 00:14:01,5,30,25
227,IST,P009846,P011981,0 days 00:13:50,12,38,26
227,IST,P009846,P012710,0 days 00:12:48,12,36,24
227,IST,P006590,P007200,0 days 00:12:45,18,45,27
227,IST,P004888,P011078,0 days 00:11:57,-5,23,28
227,IST,P004888,P006590,0 days 00:10:05,9,33,24
227,IST,P009846,P011078,0 days 00:09:08,4,21,17
227,IST,P006590,PLHK,0 days 00:08:20,8,28,20
227,IST,P006590,P009664,0 days 00:07:59,10,28,18
227,IST,P011078,PLHK,0 days 00:07:08,-6,14,20
227,IST,P009664,P011078,0 days 00:06:53,-2,14,16
227,IST,P006590,P012710,0 days 00:06:52,7,22,15
227,IST,P006590,P011981,0 days 00:06:31,9,22,13
227,IST,P004888,P012710,0 days 00:06:06,-3,11,14
227,IST,P004888,P011981,0 days 00:04:53,1,9,8
227,IST,P007200,P010516,0 days 00:04:43,-5,11,16
227,IST,P010516,PLHK,0 days 00:04:43,-5,11,16
227,IST,P009664,P010516,0 days 00:04:43,-5,11,16
227,IST,P004888,P010516,0 days 00:04:43,-5,11,16
227,IST,P006590,P009846,0 days 00:04:42,8,17,9
227,IST,P009664,P009846,0 days 00:02:29,2,7,5
227,IST,P006590,P011078,0 days 00:02:10,-1,5,6
227,IST,P004888,P009846,0 days 00:01:27,2,5,3
227,IST,P009846,PLHK,0 days 00:01:27,2,5,3
227,IST,P012710,PLHK,0 days 00:01:17,-4,2,6
227,IST,P009664,P011981,0 days 00:01:02,0,2,2
227,TEL,P009783,P009863,0 days 00:28:00,-13,66,79
227,TEL,P009863,P011199,0 days 00:25:03,-8,57,65
227,TEL,P009783,P011199,0 days 00:24:57,-8,57,65
227,TEL,P007990,P009783,0 days 00:20:34,-7,48,55
227,TEL,P007990,P009863,0 days 00:20:34,-7,48,55
227,TEL,P007990,P011199,0 days 00:18:50,0,45,45
227,TEL,P009783,P011219,0 days 00:16:49,-7,40,47
227,TEL,P009863,P011219,0 days 00:16:49,-7,40,47
227,TEL,P011199,P011219,0 days 00:15:40,-7,36,43
227,TEL,P011193,P012744,0 days 00:14:19,-5,29,34
227,TEL,P007990,P011219,0 days 00:13:31,-6,33,39
227,TEL,P011193,P011971,0 days 00:13:25,-6,28,34
227,TEL,P011193,P011214,0 days 00:13:06,-3,27,30
227,TEL,P011214,P012744,0 days 00:13:00,-3,27,30
227,TEL,P009863,P012744,0 days 00:11:55,2,24,22
227,TEL,P011971,P012744,0 days 00:11:50,-3,23,26
227,TEL,P009783,P012744,0 days 00:11:49,-4,23,27
227,TEL,P011214,P011971,0 days 00:11:44,-3,23,26
227,TEL,P009863,P011193,0 days 00:11:21,-6,24,30
227,TEL,P009783,P011193,0 days 00:11:15,-12,23,35
227,TEL,P011199,P012744,0 days 00:07:41,4,18,14
227,TEL,P011193,P011199,0 days 00:06:23,-6,14,20
227,TEL,P009863,P011214,0 days 00:06:09,-1,15,16
227,TEL,P009783,P011214,0 days 00:06:09,-7,14,21
227,TEL,P007990,P012744,0 days 00:06:08,4,14,10
227,TEL,P004233,P011214,0 days 00:05:33,0,17,17
227,TEL,P009863,P011971,0 days 00:05:20,-1,11,12
227,TEL,P004233,P011193,0 days 00:05:16,-3,12,15
227,TEL,P009783,P011971,0 days 00:05:14,-7,10,17
227,TEL,P004233,P012744,0 days 00:05:14,1,14,13
227,TEL,P004233,P011971,0 days 00:05:04,-1,12,13
227,TEL,P011193,P011219,0 days 00:03:18,-1,7,8
227,TEL,P011199,P011971,0 days 00:02:02,-3,5,8
227,TEL,P007990,P011214,0 days 00:01:50,-1,7,8
227,TEL,P011214,P011219,0 days 00:01:09,0,4,4
227,TEL,P004233,P007990,0 days 00:00:43,-1,5,6
227,TEL,P004233,P009783,0 days 00:00:33,-3,3,6
227,TEL,P004233,P009863,0 days 00:00:33,-3,3,6
227,TEL,P007990,P011193,0 days 00:00:29,-2,0,2
227,TEL,P007990,P011971,0 days 00:00:17,0,0,0
227,TEL,P004233,P011199,0 days 00:00:12,2,2,0
227,TEL,P011199,P011214,0 days 00:00:12,2,2,0
228,PAM,P003960,P010568,0 days 00:20:50,3,38,35
228,PAM,P005356,P011982,0 days 00:16:54,0,29,29
228,PAM,P003960,P012795,0 days 00:16:12,-6,24,30
228,PAM,P011970,P011982,0 days 00:15:39,-6,25,31
228,PAM,P010568,P012795,0 days 00:15:24,-4,24,28
228,PAM,P004863,P011982,0 days 00:14:39,-6,22,28
228,PAM,P003960,P005356,0 days 00:14:03,14,32,18
228,PAM,P004863,P011970,0 days 00:13:11,-5,20,25
228,PAM,P012738,P012795,0 days 00:12:46,-5,20,25
228,PAM,P010568,P012740,0 days 00:12:36,-7,17,24
228,PAM,P010568,P012738,0 days 00:12:15,-8,17,25
228,PAM,P003960,P012740,0 days 00:12:03,-9,15,24
228,PAM,P003960,P011982,0 days 00:11:47,12,26,14
228,PAM,P012740,P012795,0 days 00:11:41,-7,15,22
228,PAM,P003960,P012738,0 days 00:11:35,-5,17,22
228,PAM,P010393,P011982,0 days 00:11:31,-16,13,29
228,PAM,P005356,P010568,0 days 00:11:02,3,23,20
228,PAM,P004863,P010393,0 days 00:10:58,-18,11,29
228,PAM,P010568,P011982,0 days 00:10:37,-1,19,20
228,PAM,P012738,P012740,0 days 00:10:23,-3,15,18
228,PAM,P004863,P005356,0 days 00:09:37,1,16,15
228,PAM,P010393,P011970,0 days 00:09:23,-12,11,23
228,PAM,P005356,P011970,0 days 00:08:43,-2,12,14
228,PAM,P006643,P010393,0 days 00:07:26,-9,10,19
228,PAM,P006643,P011982,0 days 00:07:04,-7,10,17
228,PAM,P003960,P004863,0 days 00:06:28,6,13,7
228,PAM,P011982,P012795,0 days 00:05:50,-5,10,15
228,PAM,P004863,P006643,0 days 00:05:13,-5,8,13
228,PAM,P006643,P011970,0 days 00:05:13,-5,8,13
228,PAM,P005356,P012795,0 days 00:05:11,-2,9,11
228,PAM,P003960,P006433,0 days 00:04:51,8,14,6
228,PAM,P005356,P006433,0 days 00:04:51,8,14,6
228,PAM,P006433,P010568,0 days 00:04:51,8,14,6
228,PAM,P003960,P011970,0 days 00:04:33,5,9,4
228,PAM,P006433,P011982,0 days 00:04:29,9,15,6
228,PAM,P005356,P010393,0 days 00:04:27,-9,3,12
228,PAM,P010393,P012740,0 days 00:03:31,-8,2,10
228,PAM,P006433,P012738,0 days 00:02:55,-1,7,8
228,PAM,P006433,P012795,0 days 00:02:36,3,7,4
228,PAM,P010393,P010568,0 days 00:02:30,-6,2,8
228,PAM,P011982,P012738,0 days 00:02:23,-2,5,7
228,PAM,P006643,P010568,0 days 00:02:13,-4,2,6
228,PAM,P006643,P012740,0 days 00:02:13,-4,2,6
228,PAM,P005356,P012738,0 days 00:01:52,-5,2,7
228,PAM,P011982,P012740,0 days 00:01:51,-2,2,4
228,PAM,P011970,P012738,0 days 00:01:43,1,5,4
228,PAM,P011970,P012795,0 days 00:01:43,1,5,4
228,PAM,P006433,P011970,0 days 00:01:43,1,5,4
228,PAM,P003960,P010393,0 days 00:01:40,-6,0,6
228,PAM,P004863,P012795,0 days 00:01:39,-3,2,5
228,PAM,P004863,P010568,0 days 00:01:29,2,4,2
228,PAM,P004863,P012740,0 days 00:01:18,-4,0,4
228,PAM,P010393,P012795,0 days 00:01:18,-4,0,4
228,PAM,P010568,P011970,0 days 00:00:45,-2,0,2
228,PAM,P003960,P006643,0 days 00:00:22,-2,0,2
228,OLY,P008829,P008855,0 days 00:21:16,10,39,29
228,OLY,P007982,P012878,0 days 00:20:25,4,41,37
228,OLY,P008855,P010612,0 days 00:20:21,11,37,26
228,OLY,P011194,P012878,0 days 00:18:44,3,39,36
228,OLY,P008829,P010612,0 days 00:18:31,13,37,24
228,OLY,P007853,P012878,0 days 00:18:00,2,37,35
228,OLY,P007982,P011194,0 days 00:17:51,7,39,32
228,OLY,P007853,P007982,0 days 00:17:07,6,37,31
228,OLY,P008811,P008829,0 days 00:16:18,9,31,22
228,OLY,P008811,P010612,0 days 00:16:18,9,31,22
228,OLY,P008811,P008855,0 days 00:16:18,9,31,22
228,OLY,P007853,P011194,0 days 00:15:37,5,35,30
228,OLY,P007853,P008855,0 days 00:13:12,3,24,21
228,OLY,P008855,P012878,0 days 00:12:10,-2,20,22
228,OLY,P001255,P012878,0 days 00:11:26,5,25,20
228,OLY,P001255,P007982,0 days 00:09:13,1,19,18
228,OLY,P001255,P011194,0 days 00:09:13,1,19,18
228,OLY,P007853,P008829,0 days 00:09:07,4,16,12
228,OLY,P007982,P008855,0 days 00:09:04,-2,14,16
228,OLY,P007853,P010612,0 days 00:08:46,10,22,12
228,OLY,P010612,P011983,0 days 00:08:31,5,17,12
228,OLY,P008855,P011983,0 days 00:08:31,5,17,12
228,OLY,P008829,P011983,0 days 00:08:31,5,17,12
228,OLY,P008811,P011983,0 days 00:08:31,5,17,12
228,OLY,P001255,P007853,0 days 00:07:45,1,15,14
228,OLY,P008855,P011194,0 days 00:07:34,-3,12,15
228,OLY,P010612,P012878,0 days 00:06:27,5,14,9
228,OLY,P007853,P008811,0 days 00:06:22,7,14,7
228,OLY,P001255,P008855,0 days 00:05:06,1,10,9
228,OLY,P008829,P012878,0 days 00:04:47,1,8,7
228,OLY,P010612,P011194,0 days 00:04:14,1,8,7
228,OLY,P007982,P010612,0 days 00:04:14,1,8,7
228,OLY,P001255,P008829,0 days 00:03:38,1,6,5
228,OLY,P001255,P010612,0 days 00:03:38,1,6,5
228,OLY,P007982,P008829,0 days 00:02:34,-3,2,5
228,OLY,P007853,P010392,0 days 00:02:16,-2,4,6
228,OLY,P010392,P011194,0 days 00:02:16,-2,4,6
228,OLY,P010392,P012878,0 days 00:02:05,-2,4,6
228,OLY,P001255,P008811,0 days 00:01:25,-3,0,3
228,OLY,P007982,P010392,0 days 00:01:12,2,4,2
228,OLY,P008855,P010392,0 days 00:01:04,-4,0,4
228,OLY,P008829,P010392,0 days 00:00:11,0,0,0
228,OLY,P008829,P011194,0 days 00:00:11,0,0,0
229,PAR,P007400,P009862,0 days 00:20:44,-6,45,51
229,PAR,P008987,P009862,0 days 00:18:01,-14,31,45
229,PAR,P004172,P008987,0 days 00:17:25,8,31,23
229,PAR,P008987,P012743,0 days 00:16:55,4,39,35
229,PAR,P007400,P012742,0 days 00:16:28,-10,31,41
229,PAR,P004058,P012743,0 days 00:16:15,12,36,24
229,PAR,P003983,P008987,0 days 00:15:43,3,30,27
229,PAR,P003983,P004172,0 days 00:14:36,8,28,20
229,PAR,P009862,P012742,0 days 00:14:05,-7,29,36
229,PAR,P004058,P008987,0 days 00:12:53,8,28,20
229,PAR,P007400,P008987,0 days 00:12:42,-16,22,38
229,PAR,P008987,P012742,0 days 00:12:33,-13,17,30
229,PAR,P007400,P012743,0 days 00:11:10,-3,24,27
229,PAR,P003983,P012743,0 days 00:11:05,6,28,22
229,PAR,P009862,P012743,0 days 00:10:44,2,26,24
229,PAR,P004172,P012743,0 days 00:10:41,11,26,15
229,PAR,P012096,P012742,0 days 00:10:34,-8,16,24
229,PAR,P007400,P011051,0 days 00:10:25,7,25,18
229,PAR,P009862,P012096,0 days 00:10:08,-5,21,26
229,PAR,P004058,P004172,0 days 00:09:54,9,23,14
229,PAR,P009862,P011051,0 days 00:09:00,10,23,13
229,PAR,P004058,P007400,0 days 00:07:55,3,16,13
229,PAR,P011051,P012742,0 days 00:07:52,0,16,16
229,PAR,P004058,P009862,0 days 00:07:49,6,17,11
229,PAR,P007400,P012096,0 days 00:07:44,-5,16,21
229,PAR,P003983,P004058,0 days 00:07:37,9,20,11
229,PAR,P008987,P012096,0 days 00:07:29,-11,7,18
229,PAR,P004172,P009862,0 days 00:05:51,2,9,7
229,PAR,P012742,P012743,0 days 00:05:38,-4,10,14
229,PAR,P011051,P012096,0 days 00:05:29,3,14,11
229,PAR,P004172,P012096,0 days 00:05:14,-3,5,8
229,PAR,P011051,P012743,0 days 00:04:56,4,11,7
229,PAR,P004058,P011051,0 days 00:04:56,4,11,7
229,PAR,P004172,P012742,0 days 00:04:29,-3,2,5
229,PAR,P003983,P009862,0 days 00:04:09,-3,8,11
229,PAR,P003983,P012742,0 days 00:03:57,-3,2,5
229,PAR,P009862,P011050,0 days 00:03:41,-1,7,8
229,PAR,P011050,P012742,0 days 00:03:41,-1,7,8
229,PAR,P007400,P011050,0 days 00:03:41,-1,7,8
229,PAR,P008987,P011050,0 days 00:03:41,-1,7,8
229,PAR,P003983,P012096,0 days 00:03:40,-3,2,5
229,PAR,P004058,P012742,0 days 00:02:23,-3,2,5
229,PAR,P004058,P012096,0 days 00:01:34,0,3,3
229,PAR,P003983,P007400,0 days 00:01:07,-5,2,7
229,PAR,P003983,P011051,0 days 00:00:58,0,0,0
229,PAR,P004172,P011051,0 days 00:00:58,0,0,0
229,PAR,P008987,P011051,0 days 00:00:58,0,0,0
229,PAR,P004172,P007400,0 days 00:00:32,0,0,0
229,MUN,P001288,P010391,0 days 00:27:16,-1,56,57
229,MUN,P001288,P003583,0 days 00:20:57,-1,44,45
229,MUN,P010391,P011987,0 days 00:18:57,-1,40,41
229,MUN,P001288,P011987,0 days 00:18:23,2,40,38
229,MUN,P003583,P010391,0 days 00:18:03,-1,38,39
229,MUN,P006760,P007975,0 days 00:16:43,1,30,29
229,MUN,P006760,P007639,0 days 00:15:44,6,31,25
229,MUN,P001288,P006760,0 days 00:15:19,-5,30,35
229,MUN,P006760,P010391,0 days 00:14:25,-2,30,32
229,MUN,P001288,P001557,0 days 00:14:16,-3,27,30
229,MUN,P001557,P010391,0 days 00:13:11,-6,24,30
229,MUN,P003583,P007975,0 days 00:12:07,-1,24,25
229,MUN,P001557,P003583,0 days 00:12:02,-2,24,26
229,MUN,P001557,P011987,0 days 00:11:52,-4,22,26
229,MUN,P004508,P006760,0 days 00:11:40,3,21,18
229,MUN,P001288,P007975,0 days 00:11:38,0,23,23
229,MUN,P003583,P011987,0 days 00:11:06,2,26,24
229,MUN,P004508,P007975,0 days 00:10:49,6,20,14
229,MUN,P007639,P010391,0 days 00:10:44,-2,21,23
229,MUN,P001288,P007639,0 days 00:09:49,-2,18,20
229,MUN,P007639,P011987,0 days 00:09:12,-4,17,21
229,MUN,P007975,P010391,0 days 00:09:05,3,20,17
229,MUN,P003583,P006760,0 days 00:08:49,-7,16,23
229,MUN,P004508,P007639,0 days 00:08:46,9,17,8
229,MUN,P006543,P006760,0 days 00:08:17,3,14,11
229,MUN,P007639,P007975,0 days 00:08:11,8,16,8
229,MUN,P006543,P007975,0 days 00:07:43,6,14,8
229,MUN,P006760,P011987,0 days 00:07:14,-3,16,19
229,MUN,P006543,P007639,0 days 00:07:12,6,13,7
229,MUN,P004508,P006543,0 days 00:06:22,7,11,4
229,MUN,P001288,P004508,0 days 00:05:26,-2,10,12
229,MUN,P003583,P004508,0 days 00:03:59,-3,7,10
229,MUN,P004508,P010391,0 days 00:02:53,1,7,6
229,MUN,P007975,P011987,0 days 00:02:33,4,8,4
229,MUN,P001557,P007975,0 days 00:02:23,1,5,4
229,MUN,P001557,P007639,0 days 00:02:14,-1,3,4
229,MUN,P006543,P011987,0 days 00:01:55,-4,3,7
229,MUN,P003583,P006543,0 days 00:01:05,-3,1,4
229,MUN,P001557,P004508,0 days 00:01:05,3,3,0
229,MUN,P006543,P010391,0 days 00:00:34,-3,0,3
229,MUN,P001557,P006760,0 days 00:00:01,0,0,0
230,BAS,P009048,P010444,0 days 00:23:57,12,56,44
230,BAS,P004761,P009048,0 days 00:20:46,13,47,34
230,BAS,P004761,P010444,0 days 00:20:16,17,43,26
230,BAS,P003198,P009048,0 days 00:19:27,7,36,29
230,BAS,P009048,P011948,0 days 00:19:10,1,47,46
230,BAS,P009048,P012201,0 days 00:17:03,7,50,43
230,BAS,P009048,P011085,0 days 00:17:02,5,46,41
230,BAS,P004761,P008850,0 days 00:16:46,7,34,27
230,BAS,P011085,P011948,0 days 00:14:45,-1,37,38
230,BAS,P010444,P012201,0 days 00:14:44,11,42,31
230,BAS,P004761,P012201,0 days 00:14:44,15,42,27
230,BAS,P003198,P010444,0 days 00:14:25,7,26,19
230,BAS,P008850,P010444,0 days 00:13:23,5,24,19
230,BAS,P008850,P009048,0 days 00:13:05,3,26,23
230,BAS,P003198,P011948,0 days 00:12:41,4,28,24
230,BAS,P008850,P012201,0 days 00:11:47,4,30,26
230,BAS,P004603,P009048,0 days 00:11:34,0,28,28
230,BAS,P010444,P011948,0 days 00:11:31,3,31,28
230,BAS,P003198,P004761,0 days 00:10:58,2,15,13
230,BAS,P010444,P011085,0 days 00:09:23,7,30,23
230,BAS,P003198,P011085,0 days 00:08:45,3,21,18
230,BAS,P011085,P012201,0 days 00:08:17,2,25,23
230,BAS,P004603,P011948,0 days 00:07:39,-2,16,18
230,BAS,P004603,P011085,0 days 00:07:39,-2,16,18
230,BAS,P004603,P012201,0 days 00:06:32,0,18,18
230,BAS,P011948,P012201,0 days 00:06:29,-3,19,22
230,BAS,P003198,P008850,0 days 00:06:03,-1,6,7
230,BAS,P003198,P004603,0 days 00:05:02,0,10,10
230,BAS,P004761,P011948,0 days 00:04:25,2,10,8
230,BAS,P004603,P008850,0 days 00:03:55,2,12,10
230,BAS,P004603,P004761,0 days 00:03:55,2,12,10
230,BAS,P004761,P007946,0 days 00:03:10,4,8,4
230,BAS,P007946,P008850,0 days 00:03:10,4,8,4
230,BAS,P007946,P012201,0 days 00:03:10,4,8,4
230,BAS,P007946,P010444,0 days 00:02:54,6,8,2
230,BAS,P004761,P011085,0 days 00:02:17,6,9,3
230,BAS,P008850,P012765,0 days 00:01:19,-2,2,4
230,BAS,P010444,P012765,0 days 00:01:19,-2,2,4
230,BAS,P012201,P012765,0 days 00:01:19,-2,2,4
230,BAS,P003198,P012201,0 days 00:01:15,0,2,2
230,BAS,P008850,P012365,0 days 00:00:48,-2,2,4
230,BAS,P010444,P012365,0 days 00:00:48,-2,2,4
230,BAS,P012201,P012365,0 days 00:00:48,-2,2,4
230,BAS,P012365,P012765,0 days 00:00:48,-2,2,4
230,BAS,P004761,P012765,0 days 00:00:31,0,0,0
230,BAS,P003198,P007946,0 days 00:00:16,-2,0,2
230,ASV,P000229,P004194,0 days 00:20:11,1,52,51
230,ASV,P004194,P011386,0 days 00:17:57,-7,43,50
230,ASV,P012080,P012729,0 days 00:17:30,-14,26,40
230,ASV,P004194,P005094,0 days 00:16:29,-1,38,39
230,ASV,P003526,P004194,0 days 00:15:32,-3,38,41
230,ASV,P012080,PKIR,0 days 00:14:52,-9,24,33
230,ASV,P012729,PKIR,0 days 00:14:52,-9,24,33
230,ASV,P000229,P005094,0 days 00:14:10,0,36,36
230,ASV,P000229,P003526,0 days 00:14:04,0,36,36
230,ASV,P011386,P012731,0 days 00:13:36,-6,24,30
230,ASV,P012080,P012731,0 days 00:13:32,-8,15,23
230,ASV,P012729,P012731,0 days 00:13:05,-4,19,23
230,ASV,P000229,P011386,0 days 00:13:04,-2,36,38
230,ASV,P011386,P012729,0 days 00:11:40,-12,21,33
230,ASV,P005094,P011386,0 days 00:11:27,-1,28,29
230,ASV,P003526,P011225,0 days 00:10:50,0,24,24
230,ASV,P012731,PKIR,0 days 00:10:29,-7,13,20
230,ASV,P003526,P005094,0 days 00:10:21,0,26,26
230,ASV,P011386,P012080,0 days 00:10:03,-11,13,24
230,ASV,P003526,P012729,0 days 00:09:20,-8,20,28
230,ASV,P004194,P012729,0 days 00:08:35,-3,21,24
230,ASV,P004194,P012731,0 days 00:08:26,0,18,18
230,ASV,P003526,P011386,0 days 00:08:25,-6,22,28
230,ASV,P005094,P012731,0 days 00:07:18,-3,12,15
230,ASV,P004194,P011225,0 days 00:07:07,3,16,13
230,ASV,P000229,P011225,0 days 00:07:07,3,16,13
230,ASV,P011386,PKIR,0 days 00:06:16,-7,9,16
230,ASV,P000229,P012731,0 days 00:06:07,1,16,15
230,ASV,P011225,P012729,0 days 00:06:04,0,16,16
230,ASV,P000229,P012729,0 days 00:06:01,1,16,15
230,ASV,P003274,P012731,0 days 00:05:47,-1,5,6
230,ASV,P003274,P012729,0 days 00:05:47,-1,5,6
230,ASV,P003274,P012080,0 days 00:05:47,-1,5,6
230,ASV,P005094,P011225,0 days 00:05:28,-2,10,12
230,ASV,P003526,P012080,0 days 00:05:11,-6,10,16
230,ASV,P003274,PKIR,0 days 00:05:03,-1,5,6
230,ASV,P004194,P012080,0 days 00:04:53,-5,7,12
230,ASV,P011225,P012080,0 days 00:03:59,-3,10,13
230,ASV,P011225,PKIR,0 days 00:03:33,-1,10,11
230,ASV,P005094,P012080,0 days 00:03:29,-3,2,5
230,ASV,P003526,PKIR,0 days 00:03:17,-1,8,9
230,ASV,P005094,P012729,0 days 00:01:10,-2,0,2
230,ASV,P004194,PKIR,0 days 00:01:06,-1,3,4
230,ASV,P003274,P005094,0 days 00:00:44,0,0,0
230,ASV,P011225,P012731,0 days 00:00:16,0,2,2
231,RED,P006436,P012044,0 days 00:27:25,0,69,69
231,RED,P000848,P012044,0 days 00:22:10,-3,54,57
231,RED,P009035,P012044,0 days 00:20:28,-3,51,54
231,RED,P000848,P006436,0 days 00:19:59,0,50,50
231,RED,P002553,P012044,0 days 00:17:33,-11,36,47
231,RED,P000848,P009035,0 days 00:17:02,-3,41,44
231,RED,P006436,P009035,0 days 00:16:14,-2,42,44
231,RED,P002553,P006436,0 days 00:15:52,-8,33,41
231,RED,P002553,P009035,0 days 00:14:56,-11,30,41
231,RED,P007960,P012044,0 days 00:14:00,10,40,30
231,RED,P000848,P002553,0 days 00:13:50,-8,30,38
231,RED,P006436,P007960,0 days 00:13:26,7,37,30
231,RED,P007960,P011941,0 days 00:11:05,6,27,21
231,RED,P006436,P011941,0 days 00:10:51,1,24,23
231,RED,P007960,P012801,0 days 00:10:10,11,25,14
231,RED,P000848,P007960,0 days 00:09:59,7,26,19
231,RED,P011941,P012044,0 days 00:08:44,2,21,19
231,RED,P005099,P007960,0 days 00:08:08,-1,14,15
231,RED,P005099,P012801,0 days 00:07:47,-1,13,14
231,RED,P012044,P012801,0 days 00:07:45,6,21,15
231,RED,P006436,P012801,0 days 00:07:33,3,19,16
231,RED,P000848,P011941,0 days 00:06:52,2,17,15
231,RED,P011941,P012801,0 days 00:06:36,4,13,9
231,RED,P004720,P007960,0 days 00:06:07,2,14,12
231,RED,P008966,P012801,0 days 00:06:05,-2,12,14
231,RED,P004720,P012801,0 days 00:05:50,0,11,11
231,RED,P007960,P009035,0 days 00:05:18,8,19,11
231,RED,P005099,P011941,0 days 00:05:09,0,9,9
231,RED,P004720,P012044,0 days 00:05:03,-2,12,14
231,RED,P004720,P009035,0 days 00:05:02,-2,12,14
231,RED,P002553,P012801,0 days 00:05:00,-6,7,13
231,RED,P007960,P008966,0 days 00:04:13,-2,6,8
231,RED,P004720,P008966,0 days 00:04:13,-2,6,8
231,RED,P004720,P005099,0 days 00:04:13,-2,6,8
231,RED,P005099,P008966,0 days 00:04:13,-2,6,8
231,RED,P005099,P006436,0 days 00:03:33,-4,5,9
231,RED,P002553,P004720,0 days 00:03:09,-6,4,10
231,RED,P009035,P012801,0 days 00:02:35,3,9,6
231,RED,P006436,P008966,0 days 00:02:26,0,6,6
231,RED,P002553,P008966,0 days 00:02:26,0,6,6
231,RED,P008966,P012044,0 days 00:02:26,0,6,6
231,RED,P000848,P012801,0 days 00:02:15,2,6,4
231,RED,P000848,P004720,0 days 00:02:04,-3,4,7
231,RED,P000848,P005099,0 days 00:02:01,2,4,2
231,RED,P002553,P011941,0 days 00:01:39,-3,1,4
231,RED,P002553,P005099,0 days 00:01:39,-3,1,4
231,RED,P005099,P012044,0 days 00:01:34,-3,2,5
231,RED,P004720,P006436,0 days 00:00:49,-1,3,4
231,RED,P004720,P011964,0 days 00:00:34,0,0,0
231,RED,P005099,P011964,0 days 00:00:34,0,0,0
231,RED,P007960,P011964,0 days 00:00:34,0,0,0
231,RED,P008966,P011964,0 days 00:00:34,0,0,0
231,RED,P005099,P009035,0 days 00:00:17,-2,0,2
231,ZAL,P002329,P005504,0 days 00:25:24,2,62,60
231,ZAL,P005504,P011218,0 days 00:23:03,12,62,50
231,ZAL,P005504,P007109,0 days 00:22:38,11,61,50
231,ZAL,P002329,P011218,0 days 00:21:42,12,59,47
231,ZAL,P005504,P007513,0 days 00:20:46,9,57,48
231,ZAL,P002329,P007109,0 days 00:20:26,10,54,44
231,ZAL,P002329,P007513,0 days 00:18:53,8,51,43
231,ZAL,P007109,P011218,0 days 00:18:36,17,54,37
231,ZAL,P007109,P007513,0 days 00:17:58,9,51,42
231,ZAL,P007513,P011218,0 days 00:17:51,11,50,39
231,ZAL,P003211,P005504,0 days 00:12:26,-3,33,36
231,ZAL,P002329,P003211,0 days 00:11:42,1,30,29
231,ZAL,P003211,P011218,0 days 00:10:32,7,31,24
231,ZAL,P002676,P010390,0 days 00:10:01,-1,17,18
231,ZAL,P010390,P012715,0 days 00:09:56,3,19,16
231,ZAL,P002676,P012715,0 days 00:09:41,-2,16,18
231,ZAL,P003211,P007109,0 days 00:08:29,3,25,22
231,ZAL,P003211,P012715,0 days 00:07:53,-1,13,14
231,ZAL,P003211,P012787,0 days 00:07:48,-3,15,18
231,ZAL,P003211,P007513,0 days 00:07:27,0,22,22
231,ZAL,P003211,P010390,0 days 00:07:17,6,14,8
231,ZAL,P002676,P003211,0 days 00:07:06,2,13,11
231,ZAL,P012715,P012787,0 days 00:06:19,-1,11,12
231,ZAL,P002676,P007513,0 days 00:05:53,-6,7,13
231,ZAL,P002676,P012787,0 days 00:05:18,-3,8,11
231,ZAL,P010390,P012787,0 days 00:05:04,5,11,6
231,ZAL,P003210,P007513,0 days 00:05:02,-4,9,13
231,ZAL,P007513,P010390,0 days 00:04:59,-5,7,12
231,ZAL,P007513,P012715,0 days 00:04:30,-4,6,10
231,ZAL,P002676,P011218,0 days 00:04:15,-8,4,12
231,ZAL,P005504,P012787,0 days 00:03:49,-13,4,17
231,ZAL,P002329,P012787,0 days 00:03:11,-8,3,11
231,ZAL,P003210,P007109,0 days 00:02:36,-4,3,7
231,ZAL,P002676,P003210,0 days 00:02:34,0,6,6
231,ZAL,P003210,P010390,0 days 00:02:34,0,6,6
231,ZAL,P002329,P002676,0 days 00:02:29,-4,3,7
231,ZAL,P002329,P003210,0 days 00:02:28,-4,3,7
231,ZAL,P003210,P005504,0 days 00:02:28,-4,3,7
231,ZAL,P003210,P012715,0 days 00:02:26,0,6,6
231,ZAL,P011218,P012715,0 days 00:02:26,-4,2,6
231,ZAL,P002676,P005504,0 days 00:02:19,-6,2,8
231,ZAL,P002329,P012715,0 days 00:02:06,-3,3,6
231,ZAL,P005504,P012715,0 days 00:01:51,-8,0,8
231,ZAL,P010390,P011218,0 days 00:01:50,-2,2,4
231,ZAL,P002329,P010390,0 days 00:01:39,2,4,2
231,ZAL,P007513,P012787,0 days 00:01:29,-2,4,6
231,ZAL,P007109,P012787,0 days 00:01:29,-2,4,6
231,ZAL,P011218,P012787,0 days 00:01:05,-5,0,5
231,ZAL,P002676,P007109,0 days 00:00:08,0,0,0
231,ZAL,P007109,P010390,0 days 00:00:08,0,0,0
232,BAR,P006435,P011244,0 days 00:17:42,31,60,29
232,BAR,P007519,P009992,0 days 00:15:22,-20,18,38
232,BAR,P002939,P011244,0 days 00:14:53,17,48,31
232,BAR,P004866,P006435,0 days 00:14:23,22,50,28
232,BAR,P003204,P011244,0 days 00:14:03,5,28,23
232,BAR,P004866,P011244,0 days 00:13:52,24,50,26
232,BAR,P003204,P009992,0 days 00:13:48,-10,22,32
232,BAR,P007519,P011244,0 days 00:13:02,12,30,18
232,BAR,P003196,P009992,0 days 00:12:17,2,22,20
232,BAR,P003196,P011244,0 days 00:11:51,17,31,14
232,BAR,P002939,P006435,0 days 00:11:43,12,39,27
232,BAR,P000925,P006435,0 days 00:10:48,20,40,20
232,BAR,P000925,P011244,0 days 00:10:48,20,40,20
232,BAR,P000925,P004866,0 days 00:10:20,13,35,22
232,BAR,P009992,P011244,0 days 00:10:20,-2,18,20
232,BAR,P003196,P007519,0 days 00:10:17,3,19,16
232,BAR,P003204,P007519,0 days 00:10:00,-13,13,26
232,BAR,P002939,P004866,0 days 00:09:25,9,33,24
232,BAR,P002939,P003196,0 days 00:08:49,11,23,12
232,BAR,P000925,P002939,0 days 00:08:43,11,31,20
232,BAR,P007464,P009992,0 days 00:08:40,-13,11,24
232,BAR,P003204,P010641,0 days 00:08:37,-16,11,27
232,BAR,P007519,P010641,0 days 00:08:08,-13,11,24
232,BAR,P009992,P010641,0 days 00:08:08,-13,11,24
232,BAR,P009992,P012745,0 days 00:08:06,-3,11,14
232,BAR,P004866,P007519,0 days 00:07:52,15,21,6
232,BAR,P002939,P003204,0 days 00:07:31,10,19,9
232,BAR,P007464,P007519,0 days 00:07:28,-13,9,22
232,BAR,P003196,P012745,0 days 00:07:15,-3,11,14
232,BAR,P003196,P004866,0 days 00:06:57,11,19,8
232,BAR,P003196,P003204,0 days 00:06:57,8,16,8
232,BAR,P003196,P006435,0 days 00:06:49,12,20,8
232,BAR,P002939,P009992,0 days 00:06:32,7,15,8
232,BAR,P006435,P007519,0 days 00:06:30,17,21,4
232,BAR,P007519,P012745,0 days 00:05:22,-7,5,12
232,BAR,P003196,P007464,0 days 00:05:12,-5,7,12
232,BAR,P007464,P012745,0 days 00:05:12,-5,7,12
232,BAR,P010641,P011244,0 days 00:05:09,-8,7,15
232,BAR,P003204,P006435,0 days 00:03:50,7,10,3
232,BAR,P003204,P007464,0 days 00:03:28,-8,4,12
232,BAR,P007464,P010641,0 days 00:03:28,-8,4,12
232,BAR,P000925,P007519,0 days 00:03:27,7,9,2
232,BAR,P004866,P012745,0 days 00:03:25,0,4,4
232,BAR,P002939,P012745,0 days 00:03:15,2,6,4
232,BAR,P004866,P009992,0 days 00:02:54,2,4,2
232,BAR,P000925,P003204,0 days 00:01:50,5,5,0
232,BAR,P000925,P009992,0 days 00:01:22,-2,0,2
232,BAR,P000925,P012745,0 days 00:01:22,-2,0,2
232,BAR,P002939,P007464,0 days 00:01:12,0,2,2
232,BAR,P006435,P012745,0 days 00:00:31,-2,0,2
232,BAR,P002939,P010641,0 days 00:00:29,-3,0,3
232,BAR,P006435,P010641,0 days 00:00:29,-3,0,3
232,BAR,P006435,P009992,0 days 00:00:07,0,0,0
232,BER,P006251,P008967,0 days 00:15:40,-19,28,47
232,BER,P008780,P008967,0 days 00:14:59,-19,28,47
232,BER,P006251,P008780,0 days 00:14:59,-19,28,47
232,BER,P007025,P008384,0 days 00:14:50,10,35,25
232,BER,P003958,P008173,0 days 00:13:49,-10,23,33
232,BER,P008384,P010791,0 days 00:12:56,-5,21,26
232,BER,P008173,P008384,0 days 00:12:42,-1,19,20
232,BER,P007025,P008173,0 days 00:12:27,-7,19,26
232,BER,P008173,P010791,0 days 00:11:26,-9,15,24
232,BER,P006251,P011934,0 days 00:11:10,-16,20,36
232,BER,P008967,P011934,0 days 00:11:10,-16,20,36
232,BER,P007025,P010791,0 days 00:11:04,1,23,22
232,BER,P008780,P011934,0 days 00:10:53,-16,20,36
232,BER,P007025,P008211,0 days 00:09:38,9,28,19
232,BER,P006251,P008384,0 days 00:09:11,-4,16,20
232,BER,P006819,P012721,0 days 00:08:46,8,22,14
232,BER,P003958,P008384,0 days 00:08:46,-1,15,16
232,BER,P006251,P010791,0 days 00:08:10,3,16,13
232,BER,P003958,P007025,0 days 00:08:07,-7,15,22
232,BER,P006819,P008384,0 days 00:07:55,14,24,10
232,BER,P006819,P008211,0 days 00:07:47,-1,16,17
232,BER,P006819,P007025,0 days 00:07:20,5,18,13
232,BER,P008211,P008384,0 days 00:07:14,11,22,11
232,BER,P006819,P008173,0 days 00:07:14,-1,12,13
232,BER,P006251,P008211,0 days 00:07:07,5,26,21
232,BER,P003958,P010791,0 days 00:06:59,-9,11,20
232,BER,P008173,P008211,0 days 00:06:51,-11,8,19
232,BER,P008967,P012721,0 days 00:06:51,-8,6,14
232,BER,P006251,P012721,0 days 00:06:51,-8,6,14
232,BER,P003958,P006819,0 days 00:06:50,-1,12,13
232,BER,P008384,P012721,0 days 00:06:36,13,20,7
232,BER,P003958,P008211,0 days 00:06:27,-11,8,19
232,BER,P008211,P012721,0 days 00:06:19,2,16,14
232,BER,P008780,P012721,0 days 00:06:10,-8,6,14
232,BER,P006251,P007025,0 days 00:05:58,6,12,6
232,BER,P003958,P012721,0 days 00:05:57,1,12,11
232,BER,P008211,P011934,0 days 00:05:12,-1,18,19
232,BER,P008211,P008967,0 days 00:05:12,-1,18,19
232,BER,P008211,P008780,0 days 00:05:12,-1,18,19
232,BER,P006251,P008173,0 days 00:05:08,0,4,4
232,BER,P008211,P010791,0 days 00:05:01,3,14,11
232,BER,P011934,P012721,0 days 00:04:40,-8,2,10
232,BER,P008173,P012721,0 days 00:04:37,1,8,7
232,BER,P007025,P012721,0 days 00:04:33,7,14,7
232,BER,P008384,P008967,0 days 00:04:13,-12,4,16
232,BER,P008384,P008780,0 days 00:03:37,-10,4,14
232,BER,P008967,P010791,0 days 00:02:48,-5,4,9
232,BER,P003958,P008967,0 days 00:02:30,-2,4,6
232,BER,P008780,P010791,0 days 00:02:12,-3,4,7
232,BER,P003958,P008780,0 days 00:01:54,0,4,4
232,BER,P003958,P006251,0 days 00:01:54,0,4,4
232,BER,P008384,P011934,0 days 00:01:32,-7,0,7
232,BER,P008173,P008967,0 days 00:01:17,-2,0,2
232,BER,P006251,P006819,0 days 00:00:24,0,0,0
232,BER,P006819,P008967,0 days 00:00:24,0,0,0
232,BER,P008173,P011934,0 days 00:00:17,0,0,0
232,BER,P003958,P011934,0 days 00:00:07,0,0,0
232,BER,P007025,P011934,0 days 00:00:07,0,0,0
233,PAN,P003842,P012774,0 days 00:32:36,12,60,48
233,PAN,P011204,P012774,0 days 00:30:38,8,54,46
233,PAN,P003842,P011204,0 days 00:29:08,9,52,43
233,PAN,P002328,P011204,0 days 00:20:50,-4,36,40
233,PAN,P012712,P012774,0 days 00:20:32,25,49,24
233,PAN,P003842,P012712,0 days 00:20:10,21,47,26
233,PAN,P002328,P012774,0 days 00:19:31,-3,34,37
233,PAN,P002328,P003842,0 days 00:18:40,-6,32,38
233,PAN,P007866,P011204,0 days 00:17:47,-9,24,33
233,PAN,P011204,P012712,0 days 00:17:29,23,43,20
233,PAN,P007866,P012774,0 days 00:16:15,-6,22,28
233,PAN,P003842,P011209,0 days 00:15:46,7,27,20
233,PAN,P011209,P012774,0 days 00:15:12,12,27,15
233,PAN,P003842,P007866,0 days 00:14:54,-7,20,27
233,PAN,P011209,P012712,0 days 00:14:37,15,31,16
233,PAN,P002328,P007866,0 days 00:14:11,-15,17,32
233,PAN,P011204,P011209,0 days 00:13:09,9,23,14
233,PAN,P002328,P012712,0 days 00:07:44,5,19,14
233,PAN,P007947,P012712,0 days 00:07:15,8,18,10
233,PAN,P007947,P011209,0 days 00:07:11,8,18,10
233,PAN,P007947,P012774,0 days 00:05:07,6,12,6
233,PAN,P011204,P011221,0 days 00:05:06,0,10,10
233,PAN,P003842,P007947,0 days 00:04:54,0,10,10
233,PAN,P007866,P011209,0 days 00:03:52,-2,4,6
233,PAN,P007947,P011221,0 days 00:03:41,2,8,6
233,PAN,P002328,P011221,0 days 00:03:15,-4,4,8
233,PAN,P007866,P011221,0 days 00:03:15,-4,4,8
233,PAN,P011221,P012774,0 days 00:03:09,2,6,4
233,PAN,P007947,P011204,0 days 00:02:49,0,6,6
233,PAN,P011209,P011221,0 days 00:02:43,6,8,2
233,PAN,P011221,P012712,0 days 00:02:43,6,8,2
233,PAN,P002328,P007947,0 days 00:02:03,-10,0,10
233,PAN,P002328,P011209,0 days 00:01:26,-3,2,5
233,PAN,P007866,P007947,0 days 00:01:20,-6,0,6
233,PAN,P007866,P012712,0 days 00:01:02,5,5,0
233,ULK,P001932,P008962,0 days 00:26:14,-10,37,47
233,ULK,P006661,P008962,0 days 00:22:46,-5,35,40
233,ULK,P006961,P011157,0 days 00:17:41,-6,31,37
233,ULK,P001932,P002968,0 days 00:17:35,1,28,27
233,ULK,P002968,P008962,0 days 00:17:35,1,28,27
233,ULK,P001932,P006661,0 days 00:17:33,1,27,26
233,ULK,P006961,P008962,0 days 00:17:15,-16,23,39
233,ULK,P006661,P006961,0 days 00:14:10,-6,23,29
233,ULK,P008962,P011157,0 days 00:13:51,-9,22,31
233,ULK,P002968,P006661,0 days 00:12:53,6,23,17
233,ULK,P006068,P008962,0 days 00:12:28,9,23,14
233,ULK,P006661,P011157,0 days 00:12:27,-2,23,25
233,ULK,P001932,P006961,0 days 00:12:02,-16,12,28
233,ULK,P006068,P006661,0 days 00:11:16,13,26,13
233,ULK,P001932,P006068,0 days 00:11:13,6,20,14
233,ULK,P004004,P008962,0 days 00:10:50,-8,14,22
233,ULK,P002968,P006068,0 days 00:09:31,6,17,11
233,ULK,P006068,P006961,0 days 00:08:52,4,17,13
233,ULK,P001932,P011157,0 days 00:08:38,-9,11,20
233,ULK,P006961,P011052,0 days 00:08:23,5,20,15
233,ULK,P011052,P011157,0 days 00:08:23,5,20,15
233,ULK,P004004,P006661,0 days 00:08:16,-5,10,15
233,ULK,P001932,P004004,0 days 00:08:01,-6,10,16
233,ULK,P006068,P011157,0 days 00:07:14,8,17,9
233,ULK,P006661,P011052,0 days 00:07:08,2,17,15
233,ULK,P001932,P009849,0 days 00:07:03,-9,9,18
233,ULK,P002968,P004004,0 days 00:05:54,-2,8,10
233,ULK,P004004,P011157,0 days 00:05:48,-8,6,14
233,ULK,P009849,P011157,0 days 00:05:45,-8,6,14
233,ULK,P006068,P011052,0 days 00:05:32,8,14,6
233,ULK,P008962,P009849,0 days 00:05:21,-7,7,14
233,ULK,P006961,P009849,0 days 00:04:54,-9,5,14
233,ULK,P005844,P006961,0 days 00:04:44,-7,4,11
233,ULK,P002968,P006961,0 days 00:04:42,-5,5,10
233,ULK,P008962,P011052,0 days 00:04:06,0,9,9
233,ULK,P004004,P006961,0 days 00:03:41,-4,4,8
233,ULK,P001932,P005844,0 days 00:03:25,-6,2,8
233,ULK,P005844,P011157,0 days 00:03:01,-3,4,7
233,ULK,P004004,P009849,0 days 00:02:59,-6,2,8
233,ULK,P005844,P009849,0 days 00:02:34,-4,2,6
233,ULK,P002968,P009849,0 days 00:02:10,-3,3,6
233,ULK,P005844,P008962,0 days 00:02:10,-3,2,5
233,ULK,P005844,P006661,0 days 00:01:43,-4,0,4
233,ULK,P004004,P005844,0 days 00:01:19,-1,2,3
233,ULK,P006068,P009849,0 days 00:00:54,2,2,0
234,VIR,P001844,P009549,0 days 00:20:29,4,36,32
234,VIR,P001133,PBCN,0 days 00:19:22,13,46,33
234,VIR,P008847,P010781,0 days 00:18:54,-2,43,45
234,VIR,P001133,P001844,0 days 00:18:00,9,38,29
234,VIR,P001844,PBCN,0 days 00:16:06,7,33,26
234,VIR,P001133,P003048,0 days 00:15:53,0,25,25
234,VIR,P001133,P009549,0 days 00:15:17,0,26,26
234,VIR,P003048,PBCN,0 days 00:15:11,2,25,23
234,VIR,P001844,P010781,0 days 00:14:23,2,29,27
234,VIR,P009549,PBCN,0 days 00:14:14,3,25,22
234,VIR,P003048,P009549,0 days 00:14:01,3,25,22
234,VIR,P001844,P003048,0 days 00:13:11,5,22,17
234,VIR,P001844,P008847,0 days 00:13:01,2,29,27
234,VIR,P006739,P010781,0 days 00:12:57,-5,28,33
234,VIR,P001133,P010781,0 days 00:11:59,6,30,24
234,VIR,P010781,PBCN,0 days 00:11:02,-1,27,28
234,VIR,P001133,P006739,0 days 00:10:41,-1,21,22
234,VIR,P008847,P009549,0 days 00:09:52,-4,18,22
234,VIR,P009549,P010781,0 days 00:09:52,-4,18,22
234,VIR,P006739,PBCN,0 days 00:08:15,-3,19,22
234,VIR,P006739,P008847,0 days 00:07:54,-3,18,21
234,VIR,P008847,PBCN,0 days 00:07:20,1,21,20
234,VIR,P004554,P006739,0 days 00:07:11,-3,13,16
234,VIR,P004554,P010781,0 days 00:06:31,-1,13,14
234,VIR,P002084,P008847,0 days 00:05:44,-2,12,14
234,VIR,P002084,P010781,0 days 00:05:44,-2,12,14
234,VIR,P001133,P008847,0 days 00:05:34,8,20,12
234,VIR,P003527,P010781,0 days 00:05:19,-6,8,14
234,VIR,P003527,P008847,0 days 00:04:50,-6,8,14
234,VIR,P001133,P004554,0 days 00:04:44,-1,10,11
234,VIR,P004554,PBCN,0 days 00:04:17,-1,9,10
234,VIR,P001844,P002084,0 days 00:04:15,1,9,8
234,VIR,P003527,P009549,0 days 00:04:14,-4,8,12
234,VIR,P002084,P009549,0 days 00:04:07,3,9,6
234,VIR,P001133,P004007,0 days 00:04:05,-4,4,8
234,VIR,P004007,P006739,0 days 00:04:05,-4,4,8
234,VIR,P006739,P009549,0 days 00:04:04,-7,7,14
234,VIR,P001844,P003527,0 days 00:03:22,-3,4,7
234,VIR,P004007,P004554,0 days 00:02:54,-2,4,6
234,VIR,P004007,P010781,0 days 00:02:43,0,4,4
234,VIR,P003048,P006739,0 days 00:02:42,-5,3,8
234,VIR,P004554,P008847,0 days 00:02:27,-2,3,5
234,VIR,P001844,P006739,0 days 00:02:01,1,4,3
234,VIR,P003527,P006739,0 days 00:01:57,-3,4,7
234,VIR,P003048,P010781,0 days 00:01:52,-3,0,3
234,VIR,P002084,PBCN,0 days 00:01:37,-5,3,8
234,VIR,P002084,P006739,0 days 00:01:29,-3,3,6
234,VIR,P004007,P009549,0 days 00:01:22,-4,0,4
234,VIR,P001133,P003527,0 days 00:01:05,-2,0,2
234,VIR,P003048,P004007,0 days 00:00:42,-2,0,2
234,VIR,P004554,P009549,0 days 00:00:40,-2,0,2
234,VIR,P003527,P004007,0 days 00:00:29,0,0,0
234,MCO,P005985,P011226,0 days 00:27:18,-3,53,56
234,MCO,P005985,P010588,0 days 00:19:40,-7,31,38
234,MCO,P005985,P009754,0 days 00:19:04,-6,32,38
234,MCO,P009754,P011226,0 days 00:17:38,-8,33,41
234,MCO,P005985,PLCZ,0 days 00:17:14,-4,26,30
234,MCO,P005985,P011212,0 days 00:16:10,4,29,25
234,MCO,P010588,P011226,0 days 00:15:15,-6,26,32
234,MCO,P009754,P010588,0 days 00:14:48,-5,25,30
234,MCO,P011226,PLCZ,0 days 00:14:34,-1,25,26
234,MCO,P011226,P011231,0 days 00:14:11,-4,30,34
234,MCO,P010588,PLCZ,0 days 00:14:03,-5,18,23
234,MCO,P011212,P011226,0 days 00:13:05,-3,25,28
234,MCO,P005985,P011231,0 days 00:12:51,4,29,25
234,MCO,P011212,P011231,0 days 00:12:40,5,33,28
234,MCO,P009754,P011212,0 days 00:12:09,2,26,24
234,MCO,P009754,PLCZ,0 days 00:12:03,-8,16,24
234,MCO,P002581,P011231,0 days 00:11:49,5,27,22
234,MCO,P002581,P011226,0 days 00:11:25,1,25,24
234,MCO,P002581,P011212,0 days 00:11:15,5,24,19
234,MCO,P002581,P005985,0 days 00:10:54,8,25,17
234,MCO,P009754,P011231,0 days 00:09:48,0,22,22
234,MCO,P002581,P009754,0 days 00:09:43,3,20,17
234,MCO,P010588,P011212,0 days 00:09:17,-3,11,14
234,MCO,P004197,P011231,0 days 00:08:57,13,27,14
234,MCO,P011212,PLCZ,0 days 00:07:51,1,11,10
234,MCO,P002581,P004197,0 days 00:06:49,8,17,9
234,MCO,P004197,P011212,0 days 00:05:18,10,17,7
234,MCO,P004197,P005985,0 days 00:05:18,8,15,7
234,MCO,P005985,P011196,0 days 00:04:59,0,12,12
234,MCO,P011196,P011231,0 days 00:04:14,3,12,9
234,MCO,P011196,P011226,0 days 00:04:03,-3,9,12
234,MCO,P009754,P011196,0 days 00:03:56,1,14,13
234,MCO,P004197,P009754,0 days 00:03:39,5,12,7
234,MCO,P004197,P011226,0 days 00:03:39,3,10,7
234,MCO,P011196,P011212,0 days 00:03:27,3,12,9
234,MCO,P002581,P010588,0 days 00:03:25,2,6,4
234,MCO,P011231,PLCZ,0 days 00:03:11,1,8,7
234,MCO,P004197,P011196,0 days 00:02:08,5,10,5
234,MCO,P010588,P011196,0 days 00:01:57,-1,7,8
234,MCO,P010588,P011231,0 days 00:00:15,-3,0,3
235,BER,P008780,P011934,0 days 00:16:18,-26,21,47
235,BER,P003958,P011934,0 days 00:15:21,-22,26,48
235,BER,P003958,P008780,0 days 00:14:53,-24,21,45
235,BER,P008780,P012720,0 days 00:13:13,-20,20,40
235,BER,P008967,P011934,0 days 00:12:55,-17,19,36
235,BER,P006919,P008211,0 days 00:12:06,-9,21,30
235,BER,P008173,P012721,0 days 00:11:59,-8,22,30
235,BER,P008780,P008967,0 days 00:11:53,-19,14,33
235,BER,P003958,P006919,0 days 00:11:26,-13,13,26
235,BER,P003958,P012720,0 days 00:11:15,-21,15,36
235,BER,P003958,P008967,0 days 00:10:58,-17,12,29
235,BER,P003958,P008211,0 days 00:10:55,-11,20,31
235,BER,P006919,P008780,0 days 00:10:35,-13,14,27
235,BER,P007025,P012721,0 days 00:10:03,-1,23,24
235,BER,P008967,P012720,0 days 00:09:57,-13,14,27
235,BER,P008211,P012721,0 days 00:09:51,2,27,25
235,BER,P006251,P012721,0 days 00:09:37,5,27,22
235,BER,P011934,P012720,0 days 00:09:28,-13,14,27
235,BER,P006919,P012721,0 days 00:08:54,-2,16,18
235,BER,P003958,P012721,0 days 00:08:30,-8,15,23
235,BER,P006251,P008780,0 days 00:07:33,-5,15,20
235,BER,P003958,P008173,0 days 00:07:29,-10,12,22
235,BER,P006251,P007025,0 days 00:07:28,1,19,18
235,BER,P006919,P011934,0 days 00:06:59,-11,7,18
235,BER,P008211,P011934,0 days 00:06:59,-7,13,20
235,BER,P008211,P008780,0 days 00:06:39,-9,9,18
235,BER,P006919,P008967,0 days 00:06:26,-8,5,13
235,BER,P012720,P012721,0 days 00:06:20,-9,12,21
235,BER,P006251,P008173,0 days 00:06:01,4,15,11
235,BER,P006251,P012720,0 days 00:06:00,-1,14,15
235,BER,P006251,P011934,0 days 00:05:55,-2,11,13
235,BER,P006251,P006919,0 days 00:05:36,0,13,13
235,BER,P007025,P012720,0 days 00:05:13,-5,12,17
235,BER,P006919,P008173,0 days 00:04:57,-2,8,10
235,BER,P006251,P008967,0 days 00:04:56,-4,7,11
235,BER,P008173,P008211,0 days 00:04:55,0,15,15
235,BER,P007025,P008173,0 days 00:04:34,-4,7,11
235,BER,P008173,P012720,0 days 00:04:07,-2,9,11
235,BER,P008173,P008967,0 days 00:04:01,-2,5,7
235,BER,P008173,P011934,0 days 00:03:59,0,12,12
235,BER,P007025,P008780,0 days 00:03:59,-1,13,14
235,BER,P006919,P012720,0 days 00:03:46,-8,3,11
235,BER,P003958,P007025,0 days 00:03:39,-2,9,11
235,BER,P007025,P008384,0 days 00:03:38,0,8,8
235,BER,P008780,P012721,0 days 00:03:34,1,12,11
235,BER,P011934,P012721,0 days 00:03:27,0,11,11
235,BER,P008384,P012721,0 days 00:03:23,-4,3,7
235,BER,P008211,P012720,0 days 00:03:17,-8,3,11
235,BER,P006251,P008211,0 days 00:03:08,6,12,6
235,BER,P007025,P008211,0 days 00:02:52,4,8,4
235,BER,P008967,P012721,0 days 00:02:30,-4,0,4
235,BER,P007025,P011934,0 days 00:02:21,2,9,7
235,BER,P006251,P008384,0 days 00:01:58,0,3,3
235,BER,P008173,P008384,0 days 00:01:58,0,3,3
235,BER,P006919,P007025,0 days 00:01:53,2,4,2
235,BER,P006919,P008384,0 days 00:01:30,-4,0,4
235,BER,P008211,P008384,0 days 00:01:30,-4,0,4
235,BER,P008384,P008780,0 days 00:01:27,0,5,5
235,BER,P003958,P008384,0 days 00:01:22,0,5,5
235,BER,P008384,P011934,0 days 00:01:22,0,5,5
235,BER,P008384,P012720,0 days 00:01:12,-4,0,4
235,TEL,P009622,P009863,0 days 00:18:56,16,54,38
235,TEL,P009783,P009863,0 days 00:17:51,26,55,29
235,TEL,P009863,P011199,0 days 00:17:43,26,56,30
235,TEL,P009622,P011199,0 days 00:16:52,20,50,30
235,TEL,P011971,P012744,0 days 00:16:40,10,43,33
235,TEL,P009783,P011199,0 days 00:16:36,23,52,29
235,TEL,P009622,P009783,0 days 00:16:18,21,50,29
235,TEL,P011214,P011971,0 days 00:16:15,7,40,33
235,TEL,P011214,P012744,0 days 00:15:49,6,39,33
235,TEL,P011193,P011971,0 days 00:15:47,19,44,25
235,TEL,P011193,P011214,0 days 00:14:51,13,38,25
235,TEL,P005145,P009863,0 days 00:14:37,19,42,23
235,TEL,P011193,P012744,0 days 00:14:27,14,39,25
235,TEL,P005145,P011199,0 days 00:14:14,17,40,23
235,TEL,P005145,P009783,0 days 00:14:12,20,42,22
235,TEL,P005145,P009622,0 days 00:13:48,17,40,23
235,TEL,P007990,P012744,0 days 00:10:17,5,25,20
235,TEL,P007990,P011971,0 days 00:09:11,11,23,12
235,TEL,P009622,P011971,0 days 00:08:07,-1,21,22
235,TEL,P007990,P011214,0 days 00:07:43,9,21,12
235,TEL,P007990,P011193,0 days 00:07:43,9,21,12
235,TEL,P009863,P011971,0 days 00:07:17,3,21,18
235,TEL,P011199,P011971,0 days 00:06:08,13,20,7
235,TEL,P009622,P012744,0 days 00:05:37,-5,11,16
235,TEL,P004233,P012095,0 days 00:05:04,0,8,8
235,TEL,P009622,P011214,0 days 00:05:03,-4,11,15
235,TEL,P012095,P012744,0 days 00:04:54,0,11,11
235,TEL,P004233,P007990,0 days 00:04:28,-2,6,8
235,TEL,P007990,P012095,0 days 00:04:28,-2,6,8
235,TEL,P011971,P012095,0 days 00:04:24,8,11,3
235,TEL,P009863,P011214,0 days 00:04:11,-4,7,11
235,TEL,P009863,P012744,0 days 00:04:03,-4,8,12
235,TEL,P009783,P011971,0 days 00:03:39,6,13,7
235,TEL,P004233,P005145,0 days 00:03:00,-4,4,8
235,TEL,P005145,P007990,0 days 00:03:00,-4,4,8
235,TEL,P005145,P012095,0 days 00:03:00,-4,4,8
235,TEL,P009622,P011193,0 days 00:02:59,0,7,7
235,TEL,P005145,P012744,0 days 00:02:59,-5,4,9
235,TEL,P009863,P011193,0 days 00:02:58,6,9,3
235,TEL,P011193,P012095,0 days 00:02:56,6,9,3
235,TEL,P004233,P012744,0 days 00:02:34,-4,4,8
235,TEL,P004233,P011199,0 days 00:02:30,4,4,0
235,TEL,P011199,P012095,0 days 00:02:30,4,4,0
235,TEL,P011214,P012095,0 days 00:02:20,4,7,3
235,TEL,P004233,P011971,0 days 00:02:04,4,4,0
235,TEL,P007990,P011199,0 days 00:01:54,2,2,0
235,TEL,P011193,P011199,0 days 00:01:45,8,8,0
235,TEL,P009783,P011193,0 days 00:01:33,5,5,0
235,TEL,P011199,P012744,0 days 00:01:16,3,4,1
235,TEL,P009783,P011214,0 days 00:01:15,3,3,0
235,TEL,P005145,P011193,0 days 00:00:49,2,2,0
235,TEL,P005145,P011214,0 days 00:00:49,2,2,0
235,TEL,P004233,P011193,0 days 00:00:36,2,2,0
236,PAR,P008987,P009862,0 days 00:25:58,12,65,53
236,PAR,P004172,P008987,0 days 00:25:36,4,60,56
236,PAR,P003983,P008987,0 days 00:21:32,13,65,52
236,PAR,P004172,P009862,0 days 00:21:04,13,52,39
236,PAR,P000956,P008987,0 days 00:20:46,7,63,56
236,PAR,P007673,P008987,0 days 00:19:55,0,49,49
236,PAR,P000956,P003983,0 days 00:17:04,11,55,44
236,PAR,P008987,P012743,0 days 00:17:00,7,36,29
236,PAR,P009862,P012743,0 days 00:17:00,7,36,29
236,PAR,P008987,P012096,0 days 00:16:31,2,42,40
236,PAR,P007673,P012096,0 days 00:16:13,4,42,38
236,PAR,P000956,P007673,0 days 00:13:12,3,35,32
236,PAR,P004172,P012743,0 days 00:12:31,6,23,17
236,PAR,P000956,P012096,0 days 00:12:13,0,32,32
236,PAR,P003983,P009862,0 days 00:11:02,11,38,27
236,PAR,P008987,P012742,0 days 00:10:28,-1,17,18
236,PAR,P009862,P012742,0 days 00:10:28,-1,17,18
236,PAR,P012742,P012743,0 days 00:10:28,-1,17,18
236,PAR,P003983,P007673,0 days 00:09:39,5,27,22
236,PAR,P003983,P004172,0 days 00:09:31,4,29,25
236,PAR,P000956,P004172,0 days 00:08:47,-4,27,31
236,PAR,P003983,P012096,0 days 00:08:34,4,24,20
236,PAR,P004172,P012742,0 days 00:08:12,2,13,11
236,PAR,P004172,P007673,0 days 00:07:53,-2,18,20
236,PAR,P004172,P012096,0 days 00:07:50,-2,18,20
236,PAR,P007673,P009862,0 days 00:06:53,-3,14,17
236,PAR,P000956,P009862,0 days 00:06:44,9,28,19
236,PAR,P003983,P012743,0 days 00:06:32,8,19,11
236,PAR,P009862,P012096,0 days 00:04:43,0,10,10
236,PAR,P007673,P012743,0 days 00:02:25,-5,4,9
236,PAR,P007673,P012742,0 days 00:02:16,-3,4,7
236,PAR,P000956,P011051,0 days 00:02:14,-4,3,7
236,PAR,P003983,P011051,0 days 00:02:14,-4,3,7
236,PAR,P008987,P011051,0 days 00:02:14,-4,3,7
236,PAR,P000956,P012743,0 days 00:02:04,6,9,3
236,PAR,P007673,P011051,0 days 00:01:14,1,3,2
236,PAR,P004172,P011051,0 days 00:01:00,-5,0,5
236,IST,P007200,PLHK,0 days 00:23:26,-8,48,56
236,IST,P004888,P006590,0 days 00:21:11,-2,61,63
236,IST,P004888,P007200,0 days 00:21:00,-6,56,62
236,IST,P006590,P007200,0 days 00:20:25,6,61,55
236,IST,P004888,P009664,0 days 00:20:07,1,51,50
236,IST,P006590,P009664,0 days 00:17:37,6,50,44
236,IST,P007200,P009664,0 days 00:15:19,3,41,38
236,IST,P007200,P009513,0 days 00:14:47,-3,24,27
236,IST,P007200,P012710,0 days 00:14:47,-3,24,27
236,IST,P009513,P012710,0 days 00:14:47,-3,24,27
236,IST,P009513,PLHK,0 days 00:14:47,-3,24,27
236,IST,P012710,PLHK,0 days 00:14:47,-3,24,27
236,IST,P004888,P011981,0 days 00:12:52,-3,35,38
236,IST,P006590,P011981,0 days 00:12:37,-1,37,38
236,IST,P006590,PLHK,0 days 00:12:16,1,34,33
236,IST,P007200,P009846,0 days 00:12:11,-13,20,33
236,IST,P004888,PLHK,0 days 00:10:46,-6,28,34
236,IST,P009664,P011981,0 days 00:10:28,0,26,26
236,IST,P009846,PLHK,0 days 00:10:13,-13,12,25
236,IST,P009846,P012710,0 days 00:09:03,-8,10,18
236,IST,P009513,P009846,0 days 00:09:03,-8,10,18
236,IST,P009664,P011078,0 days 00:08:46,-7,17,24
236,IST,P007200,P011981,0 days 00:08:11,-1,25,26
236,IST,P004888,P011078,0 days 00:08:00,-7,15,22
236,IST,P011078,P011981,0 days 00:06:38,-4,14,18
236,IST,P009664,PLHK,0 days 00:06:17,3,19,16
236,IST,P006590,P011078,0 days 00:05:55,-2,14,16
236,IST,P009664,P012788,0 days 00:04:08,-2,8,10
236,IST,P004888,P012788,0 days 00:04:08,-2,8,10
236,IST,P007200,P012788,0 days 00:04:01,-2,8,10
236,IST,P006590,P012710,0 days 00:03:37,6,10,4
236,IST,P007200,P011078,0 days 00:03:37,-5,5,10
236,IST,P006590,P009513,0 days 00:03:37,6,10,4
236,IST,P004888,P009846,0 days 00:03:08,-5,10,15
236,IST,P006590,P009846,0 days 00:03:08,-5,10,15
236,IST,P004888,P009513,0 days 00:02:32,-1,4,5
236,IST,P011078,P012788,0 days 00:02:08,-3,3,6
236,IST,P004888,P012710,0 days 00:02:07,-1,4,5
236,IST,P009846,P011981,0 days 00:01:58,0,8,8
236,IST,P006590,P012788,0 days 00:01:53,1,5,4
236,IST,P011981,PLHK,0 days 00:01:12,-3,3,6
236,IST,P004888,P006372,0 days 00:00:25,0,0,0
236,IST,P006372,P009513,0 days 00:00:25,0,0,0
236,IST,P006372,P009664,0 days 00:00:25,0,0,0
236,IST,P009513,P009664,0 days 00:00:25,0,0,0
236,IST,P006372,P011981,0 days 00:00:18,0,0,0
236,IST,P009513,P011981,0 days 00:00:18,0,0,0
236,IST,P006372,P012788,0 days 00:00:07,0,0,0
236,IST,P009513,P012788,0 days 00:00:07,0,0,0
237,MAD,P001392,P005928,0 days 00:22:28,7,58,51
237,MAD,P005928,P010357,0 days 00:21:55,8,56,48
237,MAD,P005791,P005928,0 days 00:21:43,3,50,47
237,MAD,P001392,P010357,0 days 00:20:51,8,52,44
237,MAD,P001392,P005791,0 days 00:17:24,9,46,37
237,MAD,P005791,P010357,0 days 00:17:16,10,44,34
237,MAD,P003108,P010357,0 days 00:14:27,3,37,34
237,MAD,P003108,P005928,0 days 00:14:24,-3,38,41
237,MAD,P001392,P003108,0 days 00:14:21,1,38,37
237,MAD,P003108,P004887,0 days 00:13:48,-16,23,39
237,MAD,P004887,PCVM,0 days 00:12:41,-7,24,31
237,MAD,P003108,P006540,0 days 00:12:23,-21,24,45
237,MAD,P004887,P006540,0 days 00:10:57,-11,19,30
237,MAD,P003108,PCVM,0 days 00:10:19,-12,17,29
237,MAD,P006540,P009005,0 days 00:10:01,-6,17,23
237,MAD,P006540,PCVM,0 days 00:10:00,-6,19,25
237,MAD,P005928,P006540,0 days 00:08:59,-16,16,32
237,MAD,P003108,P005791,0 days 00:08:48,4,26,22
237,MAD,P004887,P009005,0 days 00:07:59,0,18,18
237,MAD,P009005,P010357,0 days 00:07:56,4,20,16
237,MAD,P004887,P010357,0 days 00:07:35,5,18,13
237,MAD,P006540,PTGB,0 days 00:07:31,-16,6,22
237,MAD,P009005,PCVM,0 days 00:07:27,5,18,13
237,MAD,P003733,P005791,0 days 00:06:52,5,16,11
237,MAD,P003733,P010357,0 days 00:06:52,5,16,11
237,MAD,P003733,P005928,0 days 00:06:52,5,16,11
237,MAD,P001392,P003733,0 days 00:06:47,5,16,11
237,MAD,P005928,P009005,0 days 00:06:40,-11,8,19
237,MAD,P005791,P009005,0 days 00:06:08,-6,8,14
237,MAD,P006540,P010357,0 days 00:05:57,1,17,16
237,MAD,P005791,P006540,0 days 00:05:55,-8,10,18
237,MAD,P003108,P009005,0 days 00:05:37,-5,11,16
237,MAD,P010357,PCVM,0 days 00:05:03,4,12,8
237,MAD,P004887,PTGB,0 days 00:04:45,-11,6,17
237,MAD,PCVM,PTGB,0 days 00:04:45,-11,6,17
237,MAD,P003108,PTGB,0 days 00:04:45,-11,6,17
237,MAD,P001392,P006540,0 days 00:04:13,-5,12,17
237,MAD,P004887,P005928,0 days 00:03:29,-4,6,10
237,MAD,P001392,P004887,0 days 00:03:26,0,6,6
237,MAD,P005928,PTGB,0 days 00:02:46,-5,0,5
237,MAD,P009005,PTGB,0 days 00:02:46,-5,0,5
237,MAD,P005791,PTGB,0 days 00:02:46,-5,0,5
237,MAD,P001392,P009005,0 days 00:01:49,0,4,4
237,MAD,P001392,PCVM,0 days 00:00:29,-1,0,1
237,MAD,P003733,P009005,0 days 00:00:05,0,0,0
237,PAN,P003842,P012774,0 days 00:22:48,12,56,44
237,PAN,P001926,P003842,0 days 00:21:24,8,55,47
237,PAN,P007866,P012774,0 days 00:20:39,-1,45,46
237,PAN,P001926,P012774,0 days 00:20:15,10,49,39
237,PAN,P005161,P012774,0 days 00:20:02,9,50,41
237,PAN,P001926,P005161,0 days 00:19:38,10,49,39
237,PAN,P003842,P005161,0 days 00:19:01,12,51,39
237,PAN,P002328,P011204,0 days 00:19:00,-2,43,45
237,PAN,P012712,P012774,0 days 00:17:46,10,44,34
237,PAN,P007866,P011204,0 days 00:17:33,-1,40,41
237,PAN,P002328,P007866,0 days 00:16:56,-1,40,41
237,PAN,P003842,P007866,0 days 00:16:39,8,44,36
237,PAN,P001926,P007866,0 days 00:14:26,4,35,31
237,PAN,P001926,P012712,0 days 00:13:54,10,34,24
237,PAN,P005161,P012712,0 days 00:13:32,9,35,26
237,PAN,P011204,P012774,0 days 00:13:31,-2,27,29
237,PAN,P003842,P012712,0 days 00:12:45,8,32,24
237,PAN,P002328,P012774,0 days 00:12:39,-4,25,29
237,PAN,P002328,P003842,0 days 00:12:37,9,34,25
237,PAN,P003842,P011204,0 days 00:12:22,7,32,25
237,PAN,P005161,P007866,0 days 00:11:50,7,32,25
237,PAN,P007553,P007866,0 days 00:05:56,-6,12,18
237,PAN,P007553,P012774,0 days 00:05:56,-6,12,18
237,PAN,P007553,P011204,0 days 00:05:26,-7,9,16
237,PAN,P002328,P007553,0 days 00:05:26,-7,9,16
237,PAN,P001926,P011204,0 days 00:05:14,1,13,12
237,PAN,P007866,P012712,0 days 00:05:01,2,12,10
237,PAN,P001926,P002328,0 days 00:04:37,1,13,12
237,PAN,P011204,P012712,0 days 00:04:14,1,9,8
237,PAN,P002328,P012712,0 days 00:03:22,-1,7,8
237,PAN,P002328,P005161,0 days 00:02:23,5,9,4
237,PAN,P005161,P011204,0 days 00:02:08,3,7,4
237,PAN,P005161,P007553,0 days 00:00:30,1,3,2
237,PAN,P007553,P012712,0 days 00:00:30,1,3,2
238,VIR,P006739,P008847,0 days 00:21:33,10,49,39
238,VIR,P009549,PBCN,0 days 00:18:43,2,42,40
238,VIR,P001844,P009549,0 days 00:17:59,3,38,35
238,VIR,P002084,P008847,0 days 00:17:55,17,42,25
238,VIR,P002084,P009549,0 days 00:17:42,4,35,31
238,VIR,P008847,P010781,0 days 00:16:07,13,38,25
238,VIR,P001844,PBCN,0 days 00:16:06,5,38,33
238,VIR,P003527,P008847,0 days 00:16:01,12,35,23
238,VIR,P002084,PBCN,0 days 00:15:59,8,37,29
238,VIR,P006739,P010781,0 days 00:15:39,13,38,25
238,VIR,P003527,P006739,0 days 00:14:11,7,32,25
238,VIR,P002084,P006739,0 days 00:13:46,8,33,25
238,VIR,P001844,P003048,0 days 00:12:12,-4,21,25
238,VIR,P003048,P009549,0 days 00:12:12,-4,21,25
238,VIR,P003048,PBCN,0 days 00:12:12,-4,21,25
238,VIR,P008847,P009549,0 days 00:12:04,7,29,22
238,VIR,P001844,P002084,0 days 00:12:03,5,23,18
238,VIR,P008847,PBCN,0 days 00:11:03,9,33,24
238,VIR,P003527,P010781,0 days 00:11:02,9,25,16
238,VIR,P002084,P003527,0 days 00:08:47,6,18,12
238,VIR,P002084,P010781,0 days 00:08:30,12,22,10
238,VIR,P004554,P008847,0 days 00:07:57,0,16,16
238,VIR,P004554,P006739,0 days 00:07:57,0,16,16
238,VIR,P004554,P010781,0 days 00:07:27,1,16,15
238,VIR,P003527,P004554,0 days 00:07:15,1,14,13
238,VIR,P002084,P003048,0 days 00:07:14,0,14,14
238,VIR,P006739,PBCN,0 days 00:07:09,0,16,16
238,VIR,P006739,P009549,0 days 00:06:57,-4,12,16
238,VIR,P001133,PBCN,0 days 00:06:15,-5,12,17
238,VIR,P001133,P009549,0 days 00:06:15,-5,12,17
238,VIR,P001133,P001844,0 days 00:06:15,-5,12,17
238,VIR,P001844,P008847,0 days 00:05:55,9,17,8
238,VIR,P003527,P009549,0 days 00:05:19,1,10,9
238,VIR,P001133,P003048,0 days 00:04:58,-4,7,11
238,VIR,P010781,PBCN,0 days 00:04:32,3,12,9
238,VIR,P001844,P003527,0 days 00:02:30,1,3,2
238,VIR,P001133,P008847,0 days 00:01:17,-1,5,6
238,VIR,P009549,P010781,0 days 00:00:43,1,1,0
238,VIR,P004554,PBCN,0 days 00:00:42,-1,2,3
238,VIR,P004554,P009549,0 days 00:00:30,-1,0,1
238,VIR,P001844,P010781,0 days 00:00:28,0,0,0
238,VIR,P001844,P006739,0 days 00:00:20,-2,0,2
238,VIR,P003527,PBCN,0 days 00:00:19,3,3,0
238,PAM,P007870,P010568,0 days 00:20:13,4,45,41
238,PAM,P006433,P012795,0 days 00:19:17,6,42,36
238,PAM,P004863,P011982,0 days 00:16:58,-13,28,41
238,PAM,P010568,P012795,0 days 00:16:28,-5,29,34
238,PAM,P007870,P012795,0 days 00:16:12,2,33,31
238,PAM,P006433,P010568,0 days 00:14:52,6,32,26
238,PAM,P011970,P011982,0 days 00:14:50,-13,18,31
238,PAM,P006433,P007870,0 days 00:14:36,13,36,23
238,PAM,P004863,P011970,0 days 00:14:00,-16,15,31
238,PAM,P003960,P006433,0 days 00:13:22,-2,26,28
238,PAM,P003960,P012795,0 days 00:12:46,-4,25,29
238,PAM,P010393,P011982,0 days 00:12:19,-10,25,35
238,PAM,P003960,P010568,0 days 00:11:14,-1,23,24
238,PAM,P003960,P007870,0 days 00:11:14,-1,23,24
238,PAM,P010568,P011982,0 days 00:09:37,4,24,20
238,PAM,P004863,P012738,0 days 00:09:34,-9,13,22
238,PAM,P011982,P012738,0 days 00:09:34,-9,13,22
238,PAM,P011970,P012738,0 days 00:09:24,-11,11,22
238,PAM,P004863,P010393,0 days 00:09:00,-9,19,28
238,PAM,P010393,P012795,0 days 00:08:16,-5,15,20
238,PAM,P006433,P010393,0 days 00:08:04,0,17,17
238,PAM,P007870,P011982,0 days 00:07:53,12,24,12
238,PAM,P010393,P010568,0 days 00:07:16,-7,16,23
238,PAM,P012740,P012795,0 days 00:06:53,-7,11,18
238,PAM,P010393,P012740,0 days 00:06:51,-6,11,17
238,PAM,P010393,P011970,0 days 00:06:40,-11,7,18
238,PAM,P007870,P010393,0 days 00:06:34,1,18,17
238,PAM,P006643,P011982,0 days 00:05:45,-8,5,13
238,PAM,P006643,P011970,0 days 00:05:45,-8,5,13
238,PAM,P004863,P006643,0 days 00:05:45,-8,5,13
238,PAM,P010393,P012738,0 days 00:05:42,-1,13,14
238,PAM,P004863,P010568,0 days 00:05:30,0,15,15
238,PAM,P006433,P011982,0 days 00:05:24,5,12,7
238,PAM,P004863,P007870,0 days 00:05:16,3,15,12
238,PAM,P011982,P012795,0 days 00:05:16,3,10,7
238,PAM,P006433,P012740,0 days 00:05:12,-1,11,12
238,PAM,P006643,P012738,0 days 00:04:12,-4,5,9
238,PAM,P012738,P012795,0 days 00:03:28,2,7,5
238,PAM,P007870,P012740,0 days 00:03:22,-6,4,10
238,PAM,P010568,P011970,0 days 00:02:42,-1,4,5
238,PAM,P007870,P011970,0 days 00:02:40,4,6,2
238,PAM,P003960,P010393,0 days 00:02:37,-4,3,7
238,PAM,P003960,P012740,0 days 00:02:28,-8,2,10
238,PAM,P012738,P012740,0 days 00:02:19,2,5,3
238,PAM,P010568,P012740,0 days 00:02:08,-8,0,8
238,PAM,P006433,P012738,0 days 00:01:59,2,5,3
238,PAM,P006643,P010393,0 days 00:01:33,-4,0,4
238,PAM,P011970,P012795,0 days 00:01:31,0,2,2
238,PAM,P004863,P012795,0 days 00:01:29,0,2,2
238,PAM,P003960,P011982,0 days 00:01:05,-1,1,2
238,PAM,P006433,P011970,0 days 00:00:50,3,3,0
238,PAM,P011982,P012740,0 days 00:00:47,-2,0,2
238,PAM,P003960,P011970,0 days 00:00:38,1,1,0
238,PAM,P004863,P012740,0 days 00:00:20,0,0,0
238,PAM,P011970,P012740,0 days 00:00:20,0,0,0
239,ZAL,P002329,P011218,0 days 00:19:39,-11,35,46
239,ZAL,P002329,P003211,0 days 00:14:00,-4,31,35
239,ZAL,P003211,P007109,0 days 00:13:47,-8,28,36
239,ZAL,P003211,P011218,0 days 00:13:33,-6,28,34
239,ZAL,P011218,P012715,0 days 00:13:25,-11,20,31
239,ZAL,P003210,P003211,0 days 00:12:22,-6,26,32
239,ZAL,P002676,P003211,0 days 00:12:16,-9,23,32
239,ZAL,P005504,P011218,0 days 00:12:13,-9,18,27
239,ZAL,P003211,P010390,0 days 00:12:05,-4,25,29
239,ZAL,P002676,P003210,0 days 00:11:46,0,25,25
239,ZAL,P002329,P005504,0 days 00:11:03,-4,18,22
239,ZAL,P002329,P003210,0 days 00:10:51,-12,21,33
239,ZAL,P002329,P012715,0 days 00:10:48,-8,16,24
239,ZAL,P002676,P007109,0 days 00:10:35,0,23,23
239,ZAL,P003210,P007109,0 days 00:10:09,0,23,23
239,ZAL,P007109,P011218,0 days 00:10:04,-10,18,28
239,ZAL,P005504,P012787,0 days 00:09:38,-8,15,23
239,ZAL,P002329,P007109,0 days 00:09:29,-7,18,25
239,ZAL,P003210,P010390,0 days 00:09:06,-1,20,21
239,ZAL,P002676,P010390,0 days 00:08:56,-4,18,22
239,ZAL,P002329,P006158,0 days 00:08:11,1,17,16
239,ZAL,P002329,P012787,0 days 00:08:02,-6,12,18
239,ZAL,P011218,P012787,0 days 00:08:02,-6,12,18
239,ZAL,P005504,P012715,0 days 00:08:00,-12,8,20
239,ZAL,P002676,P011218,0 days 00:07:35,-7,13,20
239,ZAL,P002676,P012787,0 days 00:07:13,-2,15,17
239,ZAL,P007109,P010390,0 days 00:06:59,-2,14,16
239,ZAL,P002676,P005504,0 days 00:06:53,-7,11,18
239,ZAL,P003210,P006158,0 days 00:06:39,-1,14,15
239,ZAL,P003211,P006158,0 days 00:05:30,2,13,11
239,ZAL,P005504,P006158,0 days 00:05:30,3,13,10
239,ZAL,P010390,P011218,0 days 00:05:29,-1,13,14
239,ZAL,P012715,P012787,0 days 00:05:21,-4,8,12
239,ZAL,P003210,P011218,0 days 00:05:02,-8,9,17
239,ZAL,P006158,P011218,0 days 00:05:02,1,10,9
239,ZAL,P002329,P010390,0 days 00:04:56,-4,11,15
239,ZAL,P003210,P012787,0 days 00:04:56,1,11,10
239,ZAL,P002329,P002676,0 days 00:04:53,-5,9,14
239,ZAL,P003210,P005504,0 days 00:04:52,-4,7,11
239,ZAL,P003211,P005504,0 days 00:04:43,1,10,9
239,ZAL,P003211,P012715,0 days 00:04:10,-1,8,9
239,ZAL,P007109,P012715,0 days 00:04:07,1,8,7
239,ZAL,P003210,P012715,0 days 00:04:05,-1,8,9
239,ZAL,P002676,P012715,0 days 00:04:03,-1,8,9
239,ZAL,P006158,P012787,0 days 00:03:30,-1,7,8
239,ZAL,P002676,P006158,0 days 00:03:30,-1,7,8
239,ZAL,P007109,P012787,0 days 00:03:24,1,8,7
239,ZAL,P006158,P010390,0 days 00:03:09,0,7,7
239,ZAL,P006158,P007109,0 days 00:03:02,-3,4,7
239,ZAL,P010390,P012715,0 days 00:02:44,2,8,6
239,ZAL,P006158,P012715,0 days 00:02:41,-1,4,5
239,ZAL,P003211,P012787,0 days 00:01:58,-1,4,5
239,ZAL,P010390,P012787,0 days 00:00:04,-2,0,2
239,OLY,P001255,P008855,0 days 00:24:01,13,60,47
239,OLY,P008811,P008855,0 days 00:21:00,15,52,37
239,OLY,P007853,P011194,0 days 00:20:33,6,45,39
239,OLY,P001255,P010612,0 days 00:20:00,14,51,37
239,OLY,P008829,P010612,0 days 00:19:31,15,52,37
239,OLY,P001255,P008829,0 days 00:19:27,13,50,37
239,OLY,P001255,P008811,0 days 00:19:11,7,44,37
239,OLY,P008829,P008855,0 days 00:18:11,20,50,30
239,OLY,P008855,P010612,0 days 00:16:22,12,42,30
239,OLY,P008811,P008829,0 days 00:14:53,14,39,25
239,OLY,P008811,P010612,0 days 00:13:04,6,31,25
239,OLY,P007853,P008855,0 days 00:12:56,9,31,22
239,OLY,P008855,P011194,0 days 00:12:56,9,31,22
239,OLY,P001255,P007853,0 days 00:11:17,3,27,24
239,OLY,P007853,P008829,0 days 00:11:10,3,27,24
239,OLY,P007853,P012878,0 days 00:09:58,1,21,20
239,OLY,P011194,P011983,0 days 00:09:56,-3,16,19
239,OLY,P007853,P011983,0 days 00:09:56,-3,16,19
239,OLY,P001255,P012878,0 days 00:08:28,8,25,17
239,OLY,P008855,P012878,0 days 00:08:18,6,21,15
239,OLY,P001255,P011194,0 days 00:08:12,2,19,17
239,OLY,P008829,P011194,0 days 00:08:05,2,19,17
239,OLY,P008811,P011194,0 days 00:07:56,9,21,12
239,OLY,P007853,P008811,0 days 00:07:56,9,21,12
239,OLY,P006302,P011194,0 days 00:07:04,-4,13,17
239,OLY,P006302,P007853,0 days 00:07:04,-4,13,17
239,OLY,P010612,P012878,0 days 00:06:56,8,20,12
239,OLY,P008829,P012878,0 days 00:06:55,4,19,15
239,OLY,P011194,P012878,0 days 00:06:53,0,13,13
239,OLY,P006302,P011983,0 days 00:06:28,-3,11,14
239,OLY,P006302,P008829,0 days 00:06:16,-6,11,17
239,OLY,P008829,P011983,0 days 00:05:40,-5,9,14
239,OLY,P011983,P012878,0 days 00:04:16,2,7,5
239,OLY,P007853,P010612,0 days 00:03:42,4,11,7
239,OLY,P008855,P011983,0 days 00:03:28,0,5,5
239,OLY,P006302,P012878,0 days 00:01:20,-1,2,3
239,OLY,P010612,P011194,0 days 00:00:37,3,3,0
239,OLY,P006302,P010612,0 days 00:00:04,2,2,0
240,BAR,P006435,P012745,0 days 00:22:53,-2,46,48
240,BAR,P002939,P012745,0 days 00:22:29,0,45,45
240,BAR,P000925,P012745,0 days 00:22:27,0,44,44
240,BAR,P000925,P006435,0 days 00:21:55,1,44,43
240,BAR,P002939,P006435,0 days 00:21:20,2,47,45
240,BAR,P000925,P002939,0 days 00:20:32,6,44,38
240,BAR,P004866,P012745,0 days 00:18:24,-3,37,40
240,BAR,P000925,P004866,0 days 00:18:09,1,38,37
240,BAR,P002939,P004866,0 days 00:15:48,1,35,34
240,BAR,P004866,P006435,0 days 00:15:08,-2,35,37
240,BAR,P003478,P007519,0 days 00:11:17,-3,16,19
240,BAR,P003196,P003478,0 days 00:10:46,-3,14,17
240,BAR,P003196,P007519,0 days 00:10:08,-3,12,15
240,BAR,P003196,P012745,0 days 00:08:02,-5,10,15
240,BAR,P009992,P012745,0 days 00:07:59,0,13,13
240,BAR,P003478,PLFW,0 days 00:07:45,-5,11,16
240,BAR,P000925,P009992,0 days 00:07:31,-1,12,13
240,BAR,P007519,P012745,0 days 00:07:08,-4,7,11
240,BAR,P003478,P011244,0 days 00:06:55,-2,9,11
240,BAR,P003478,P012745,0 days 00:06:37,-2,7,9
240,BAR,P003196,P009992,0 days 00:06:03,-4,8,12
240,BAR,P000925,PLFW,0 days 00:05:57,-3,6,9
240,BAR,P012745,PLFW,0 days 00:05:57,-4,7,11
240,BAR,P009992,P011244,0 days 00:05:35,-5,7,12
240,BAR,P003196,P011244,0 days 00:05:35,-5,7,12
240,BAR,P002939,P009992,0 days 00:05:31,0,10,10
240,BAR,P006435,P009992,0 days 00:05:28,0,10,10
240,BAR,P003196,PLFW,0 days 00:05:17,-6,7,13
240,BAR,P004866,PLFW,0 days 00:05:15,-4,6,10
240,BAR,P003478,P009992,0 days 00:05:13,-1,8,9
240,BAR,P007519,PLFW,0 days 00:05:01,-3,9,12
240,BAR,P000925,P003478,0 days 00:04:32,-1,6,7
240,BAR,P003478,P006435,0 days 00:04:27,0,3,3
240,BAR,P009992,PLFW,0 days 00:04:05,-4,4,8
240,BAR,P007519,P009992,0 days 00:04:01,-1,6,7
240,BAR,P007519,P011244,0 days 00:03:33,-2,5,7
240,BAR,P011244,PLFW,0 days 00:03:31,-5,2,7
240,BAR,P003196,P006435,0 days 00:03:08,-3,4,7
240,BAR,P004866,P007519,0 days 00:02:53,-3,4,7
240,BAR,P004866,P009992,0 days 00:02:50,-4,2,6
240,BAR,P003196,P004866,0 days 00:02:48,-7,3,10
240,BAR,P002939,P003196,0 days 00:02:41,-4,3,7
240,BAR,P000925,P007519,0 days 00:02:19,-3,4,7
240,BAR,P006435,P007519,0 days 00:02:14,-2,1,3
240,BAR,P006435,P011244,0 days 00:02:10,0,2,2
240,BAR,P000925,P011244,0 days 00:02:10,0,2,2
240,BAR,P002939,P003478,0 days 00:01:54,1,2,1
240,BAR,P003478,P004866,0 days 00:01:46,0,4,4
240,BAR,P006435,PLFW,0 days 00:01:29,-2,0,2
240,BAR,P002939,P007519,0 days 00:01:14,0,0,0
240,BAR,P004866,P011244,0 days 00:00:47,-3,0,3
240,BAR,P002939,P011244,0 days 00:00:44,2,2,0
240,BAR,P002939,PLFW,0 days 00:00:39,0,0,0
240,MCO,P011212,P011226,0 days 00:24:15,8,40,32
240,MCO,P005985,P010588,0 days 00:24:06,4,45,41
240,MCO,P005985,P011226,0 days 00:18:34,-3,30,33
240,MCO,P005985,P011231,0 days 00:18:09,3,41,38
240,MCO,P008099,P011231,0 days 00:17:45,4,43,39
240,MCO,P011196,P011226,0 days 00:16:32,9,33,24
240,MCO,P005985,P011212,0 days 00:16:12,-2,21,23
240,MCO,P011196,P011212,0 days 00:15:11,9,26,17
240,MCO,P005985,P008099,0 days 00:14:30,2,37,35
240,MCO,P010588,P011212,0 days 00:13:19,1,17,16
240,MCO,P005985,PLCZ,0 days 00:12:30,4,30,26
240,MCO,P010588,PLCZ,0 days 00:12:12,2,28,26
240,MCO,P010588,P011226,0 days 00:12:04,1,17,16
240,MCO,P010588,P011231,0 days 00:12:02,3,28,25
240,MCO,P008099,P010588,0 days 00:10:47,3,28,25
240,MCO,P004790,P011212,0 days 00:10:40,6,19,13
240,MCO,P004790,P011226,0 days 00:10:40,6,19,13
240,MCO,P011231,PLCZ,0 days 00:10:19,3,25,22
240,MCO,P008099,PLCZ,0 days 00:10:19,3,25,22
240,MCO,P011196,P011231,0 days 00:10:16,5,22,17
240,MCO,P005985,P011196,0 days 00:09:56,1,20,19
240,MCO,P011226,P011231,0 days 00:09:19,2,19,17
240,MCO,P011212,P011231,0 days 00:06:57,3,10,7
240,MCO,P008099,P011226,0 days 00:06:55,1,15,14
240,MCO,P008099,P011196,0 days 00:06:37,4,18,14
240,MCO,P011226,P012709,0 days 00:06:06,8,13,5
240,MCO,P011212,P012709,0 days 00:06:06,8,13,5
240,MCO,P004790,P012709,0 days 00:06:06,8,13,5
240,MCO,P004790,P011196,0 days 00:05:22,8,12,4
240,MCO,P011196,P012709,0 days 00:05:22,8,12,4
240,MCO,P010588,P011196,0 days 00:04:56,0,9,9
240,MCO,P002581,P011226,0 days 00:04:46,-7,3,10
240,MCO,P004790,P005985,0 days 00:04:34,-2,6,8
240,MCO,P004790,P010588,0 days 00:04:08,2,6,4
240,MCO,P002581,P005985,0 days 00:04:05,-7,2,9
240,MCO,P002581,P011212,0 days 00:04:03,-4,3,7
240,MCO,P008099,P011212,0 days 00:03:18,2,6,4
240,MCO,P002581,P010588,0 days 00:02:50,0,2,2
240,MCO,P011226,PLCZ,0 days 00:02:29,3,7,4
240,MCO,P011212,PLCZ,0 days 00:02:11,1,5,4
240,MCO,P002581,P004790,0 days 00:01:10,-4,1,5
240,MCO,P002581,P008099,0 days 00:00:49,-3,0,3
240,MCO,P002581,P011231,0 days 00:00:49,-3,0,3
240,MCO,P002581,P012709,0 days 00:00:44,0,1,1
241,MUN,P001288,P007056,0 days 00:23:46,3,45,42
241,MUN,P001288,P003583,0 days 00:22:20,-1,41,42
241,MUN,P003583,P007056,0 days 00:19:22,-2,35,37
241,MUN,P007056,P010391,0 days 00:18:27,10,39,29
241,MUN,P001288,P011987,0 days 00:17:48,-2,32,34
241,MUN,P004508,P010391,0 days 00:17:37,6,30,24
241,MUN,P003583,P011987,0 days 00:17:23,-2,32,34
241,MUN,P007056,P011987,0 days 00:15:09,-4,28,32
241,MUN,P004508,P006760,0 days 00:15:06,2,26,24
241,MUN,P001288,P010391,0 days 00:15:05,7,31,24
241,MUN,P004508,P007056,0 days 00:14:48,16,33,17
241,MUN,P003583,P008985,0 days 00:13:20,-2,28,30
241,MUN,P007056,P008985,0 days 00:12:28,2,26,24
241,MUN,P001288,P008985,0 days 00:12:28,-2,26,28
241,MUN,P003583,P010391,0 days 00:11:42,2,21,19
241,MUN,P006760,P010391,0 days 00:11:42,-1,20,21
241,MUN,P007639,P010391,0 days 00:11:31,6,20,14
241,MUN,P008985,P011987,0 days 00:11:21,1,24,23
241,MUN,P004508,P007639,0 days 00:10:46,4,18,14
241,MUN,P006760,P007639,0 days 00:09:17,1,15,14
241,MUN,P006760,P007056,0 days 00:08:53,9,23,14
241,MUN,P001557,P006760,0 days 00:08:45,-2,11,13
241,MUN,P001557,P004508,0 days 00:08:45,-2,11,13
241,MUN,P001288,P004508,0 days 00:08:19,9,17,8
241,MUN,P001557,P010391,0 days 00:07:00,-10,3,13
241,MUN,P010391,P011987,0 days 00:06:59,3,14,11
241,MUN,P007056,P007639,0 days 00:06:51,11,17,6
241,MUN,P003583,P004508,0 days 00:06:19,4,9,5
241,MUN,P001557,P007639,0 days 00:04:40,-5,3,8
241,MUN,P001557,P003583,0 days 00:04:33,-3,4,7
241,MUN,P001557,P008985,0 days 00:04:30,2,10,8
241,MUN,P004508,P008985,0 days 00:03:44,5,8,3
241,MUN,P006760,P008985,0 days 00:03:44,5,8,3
241,MUN,P001288,P001557,0 days 00:02:40,-3,2,5
241,MUN,P001557,P011987,0 days 00:02:35,0,2,2
241,MUN,P001288,P007639,0 days 00:02:20,5,5,0
241,MUN,P001557,P007056,0 days 00:02:12,3,6,3
241,MUN,P001288,P006760,0 days 00:02:10,0,5,5
241,MUN,P003583,P006760,0 days 00:01:53,0,2,2
241,MUN,P008985,P010391,0 days 00:00:49,1,6,5
241,MUN,P007639,P011987,0 days 00:00:39,2,2,0
241,MUN,P006760,P011987,0 days 00:00:14,2,2,0
241,RED,P006436,P009035,0 days 00:18:49,0,37,37
241,RED,P002553,P006436,0 days 00:18:25,1,40,39
241,RED,P012044,P012801,0 days 00:18:17,4,36,32
241,RED,P002553,P009035,0 days 00:17:31,0,37,37
241,RED,P009035,P012801,0 days 00:15:40,2,31,29
241,RED,P006436,P012801,0 days 00:15:09,1,30,29
241,RED,P009035,P012044,0 days 00:14:36,4,31,27
241,RED,P000848,P005099,0 days 00:13:42,-5,23,28
241,RED,P002553,P012801,0 days 00:12:29,3,30,27
241,RED,P000848,PLUO,0 days 00:11:41,-7,17,24
241,RED,P006436,P012044,0 days 00:11:26,4,27,23
241,RED,P002553,P012044,0 days 00:10:31,4,27,23
241,RED,P000848,P008966,0 days 00:09:53,-7,16,23
241,RED,P000848,P009035,0 days 00:09:47,-2,17,19
241,RED,P007960,P012801,0 days 00:09:31,-2,9,11
241,RED,P000848,P007960,0 days 00:09:22,1,20,19
241,RED,P007960,PLUO,0 days 00:09:18,1,15,14
241,RED,P007960,P012044,0 days 00:09:13,-1,11,12
241,RED,P005099,P009035,0 days 00:08:43,0,17,17
241,RED,P005099,P006436,0 days 00:08:13,-4,10,14
241,RED,P005099,PLUO,0 days 00:07:46,-3,13,16
241,RED,P005099,P007960,0 days 00:07:36,0,13,13
241,RED,P011941,PLUO,0 days 00:07:27,-9,4,13
241,RED,P008966,PLUO,0 days 00:07:27,-8,8,16
241,RED,P000848,P006436,0 days 00:07:22,-3,13,16
241,RED,P000848,P002553,0 days 00:07:22,-3,13,16
241,RED,P005099,P008966,0 days 00:07:16,-7,6,13
241,RED,P007960,P009035,0 days 00:07:15,2,11,9
241,RED,P007960,P008966,0 days 00:06:53,-2,11,13
241,RED,P002553,P005099,0 days 00:06:28,-2,10,12
241,RED,P000848,P012044,0 days 00:05:59,-4,9,13
241,RED,P000848,P011941,0 days 00:05:50,-9,4,13
241,RED,P012044,PLUO,0 days 00:05:32,-4,4,8
241,RED,P011941,P012044,0 days 00:05:32,-4,4,8
241,RED,P008966,P012801,0 days 00:04:43,-1,8,9
241,RED,P008966,P012044,0 days 00:04:32,-3,7,10
241,RED,P008966,P011941,0 days 00:04:23,-8,2,10
241,RED,P004720,P009035,0 days 00:03:33,0,4,4
241,RED,P004720,P007960,0 days 00:03:33,0,4,4
241,RED,P000848,P012801,0 days 00:03:30,-1,8,9
241,RED,P009035,PLUO,0 days 00:03:10,2,7,5
241,RED,P004720,P012801,0 days 00:03:10,0,4,4
241,RED,P004720,P012044,0 days 00:03:10,0,4,4
241,RED,P007960,P011941,0 days 00:03:04,-1,2,3
241,RED,P006436,P007960,0 days 00:03:03,-2,0,2
241,RED,P006436,P008966,0 days 00:02:39,-1,3,4
241,RED,P005099,P012801,0 days 00:02:17,-2,0,2
241,RED,P005099,P011941,0 days 00:01:55,-5,0,5
241,RED,P011941,P012801,0 days 00:01:37,0,0,0
241,RED,P012801,PLUO,0 days 00:01:37,0,0,0
241,RED,P002553,P008966,0 days 00:00:54,1,3,2
241,RED,P004720,P006436,0 days 00:00:23,0,0,0
241,RED,P004720,PLUO,0 days 00:00:23,0,0,0
241,RED,P006436,PLUO,0 days 00:00:23,0,0,0
242,ULK,P001932,P008962,0 days 00:25:55,9,68,59
242,ULK,P001932,P011157,0 days 00:19:48,19,63,44
242,ULK,P006961,P011157,0 days 00:19:03,24,68,44
242,ULK,P004004,P006961,0 days 00:19:02,19,59,40
242,ULK,P008962,P011157,0 days 00:17:25,10,47,37
242,ULK,P001932,P006961,0 days 00:16:16,24,58,34
242,ULK,P004004,P011157,0 days 00:15:05,15,50,35
242,ULK,P001932,P006068,0 days 00:13:52,-6,30,36
242,ULK,P006068,P008962,0 days 00:13:52,-6,30,36
242,ULK,P006961,P008962,0 days 00:12:26,13,38,25
242,ULK,P006961,P011980,0 days 00:11:45,8,39,31
242,ULK,P001932,P004004,0 days 00:11:30,20,40,20
242,ULK,P006661,P011157,0 days 00:11:22,-2,33,35
242,ULK,P004004,P011980,0 days 00:10:58,4,31,27
242,ULK,P006068,P009849,0 days 00:10:15,2,26,24
242,ULK,P001932,P009849,0 days 00:09:02,-1,23,24
242,ULK,P008962,P009849,0 days 00:09:02,-1,23,24
242,ULK,P001932,P006661,0 days 00:08:50,3,25,22
242,ULK,P006661,P011980,0 days 00:08:46,-3,26,29
242,ULK,P004004,P008962,0 days 00:08:45,10,28,18
242,ULK,P006661,P006961,0 days 00:08:32,8,31,23
242,ULK,P006661,P008962,0 days 00:07:45,2,17,15
242,ULK,P011157,P011980,0 days 00:07:25,6,30,24
242,ULK,P006068,P006661,0 days 00:07:18,-4,12,16
242,ULK,P002968,P009849,0 days 00:07:02,-1,18,19
242,ULK,P005844,P006068,0 days 00:05:57,0,12,12
242,ULK,P001932,P002968,0 days 00:05:39,4,17,13
242,ULK,P004004,P006661,0 days 00:05:39,-5,14,19
242,ULK,P006068,P011157,0 days 00:05:22,-5,9,14
242,ULK,P009849,P011980,0 days 00:05:17,-5,9,14
242,ULK,P005844,P006661,0 days 00:04:53,3,10,7
242,ULK,P002968,P004004,0 days 00:04:17,-1,9,10
242,ULK,P002968,P011980,0 days 00:04:17,-1,9,10
242,ULK,P001932,P011980,0 days 00:04:13,9,20,11
242,ULK,P002968,P008962,0 days 00:04:12,2,13,11
242,ULK,P002968,P006068,0 days 00:04:12,2,13,11
242,ULK,P002968,P006961,0 days 00:04:01,1,9,8
242,ULK,P001932,P005844,0 days 00:03:55,-1,8,9
242,ULK,P005844,P008962,0 days 00:03:55,-1,8,9
242,ULK,P009849,P011157,0 days 00:03:50,-3,8,11
242,ULK,P005844,P009849,0 days 00:03:27,-2,6,8
242,ULK,P006961,P009849,0 days 00:03:23,-3,6,9
242,ULK,P004004,P009849,0 days 00:03:15,-6,5,11
242,ULK,P006661,P009849,0 days 00:02:43,-4,4,8
242,ULK,P006068,P011980,0 days 00:02:25,-1,4,5
242,ULK,P005844,P011980,0 days 00:02:23,1,4,3
242,ULK,P006068,P006961,0 days 00:00:23,-2,0,2
242,ULK,P008962,P011980,0 days 00:00:23,-2,0,2
242,ULK,P004004,P005844,0 days 00:00:21,0,0,0
242,ULK,P005844,P006961,0 days 00:00:21,0,0,0
242,ULK,P002968,P006661,0 days 00:00:16,-2,0,2
242,BAS,P004761,P012201,0 days 00:23:43,-15,54,69
242,BAS,P009048,P012201,0 days 00:22:29,-12,56,68
242,BAS,P004761,P007230,0 days 00:20:23,-9,41,50
242,BAS,P004761,P009048,0 days 00:20:11,-14,45,59
242,BAS,P004761,P010444,0 days 00:19:28,-3,43,46
242,BAS,P007230,P010444,0 days 00:18:56,-5,40,45
242,BAS,P009048,P010444,0 days 00:18:11,-9,42,51
242,BAS,P007230,P009048,0 days 00:17:23,-16,35,51
242,BAS,P003198,P009048,0 days 00:17:06,-4,49,53
242,BAS,P003198,P012201,0 days 00:15:41,-1,47,48
242,BAS,P004761,P007946,0 days 00:14:53,-3,32,35
242,BAS,P007230,P012201,0 days 00:12:45,-11,25,36
242,BAS,P003198,P004761,0 days 00:12:41,-3,34,37
242,BAS,P007230,P007946,0 days 00:12:22,-1,26,27
242,BAS,P010444,P012201,0 days 00:11:50,-5,27,32
242,BAS,P003198,P010444,0 days 00:11:50,-6,29,35
242,BAS,P004603,P012201,0 days 00:10:09,-5,30,35
242,BAS,P003198,P011948,0 days 00:08:39,-2,26,28
242,BAS,P009048,P011948,0 days 00:08:39,-2,26,28
242,BAS,P003198,P004603,0 days 00:07:47,0,26,26
242,BAS,P007946,P010444,0 days 00:07:38,2,16,14
242,BAS,P004603,P009048,0 days 00:07:38,-3,24,27
242,BAS,P003198,P007230,0 days 00:07:22,-3,18,21
242,BAS,P007946,P012201,0 days 00:07:15,-5,16,21
242,BAS,P004603,P004761,0 days 00:07:09,-7,17,24
242,BAS,P007946,P011085,0 days 00:06:56,2,14,12
242,BAS,P007230,P011085,0 days 00:06:56,2,14,12
242,BAS,P004761,P011085,0 days 00:06:56,2,14,12
242,BAS,P010444,P011085,0 days 00:06:56,2,14,12
242,BAS,P007230,P011948,0 days 00:05:39,-4,13,17
242,BAS,P010444,P011948,0 days 00:05:39,-4,13,17
242,BAS,P003198,P007946,0 days 00:04:14,-1,11,12
242,BAS,P007946,P009048,0 days 00:03:43,-4,7,11
242,BAS,P011948,P012201,0 days 00:03:00,2,13,11
242,BAS,P004603,P011948,0 days 00:03:00,2,13,11
242,BAS,P004603,P007946,0 days 00:02:31,-2,6,8
242,BAS,P004603,P007230,0 days 00:02:22,-5,4,9
243,ASV,P002100,P012080,0 days 00:25:22,5,52,47
243,ASV,P012080,PKIR,0 days 00:22:12,5,47,42
243,ASV,P002100,P012729,0 days 00:21:54,4,45,41
243,ASV,P012080,P012729,0 days 00:21:43,0,44,44
243,ASV,P002100,PKIR,0 days 00:21:27,7,46,39
243,ASV,P012729,PKIR,0 days 00:19:29,-3,38,41
243,ASV,P011386,P012080,0 days 00:18:16,0,37,37
243,ASV,P000229,P004194,0 days 00:16:31,0,33,33
243,ASV,P011386,P012729,0 days 00:16:28,2,33,31
243,ASV,P011386,PKIR,0 days 00:16:28,2,33,31
243,ASV,P002100,P011386,0 days 00:15:58,5,33,28
243,ASV,P004194,P012731,0 days 00:14:38,-6,26,32
243,ASV,P004194,P011225,0 days 00:14:19,6,30,24
243,ASV,P000229,P012731,0 days 00:14:03,-7,25,32
243,ASV,P003526,P004194,0 days 00:12:05,3,24,21
243,ASV,P003526,P011225,0 days 00:12:05,3,24,21
243,ASV,P011225,P012731,0 days 00:11:09,1,22,21
243,ASV,P003526,P012731,0 days 00:11:09,1,22,21
243,ASV,P000229,P011225,0 days 00:10:19,-1,20,21
243,ASV,P000229,P003526,0 days 00:10:19,-1,20,21
243,ASV,P004194,P012080,0 days 00:08:26,4,19,15
243,ASV,P002100,P004194,0 days 00:08:24,10,19,9
243,ASV,P000229,P012080,0 days 00:07:17,-1,16,17
243,ASV,P002100,P011225,0 days 00:05:56,4,12,8
243,ASV,P000229,P002100,0 days 00:05:14,0,11,11
243,ASV,P011225,P012729,0 days 00:05:06,2,10,8
243,ASV,P012080,P012731,0 days 00:04:14,-9,5,14
243,ASV,P011225,P012080,0 days 00:04:10,0,8,8
243,ASV,P000229,PKIR,0 days 00:03:48,6,12,6
243,ASV,P004194,P012729,0 days 00:03:10,5,8,3
243,ASV,P004194,PKIR,0 days 00:02:43,8,9,1
243,ASV,P002100,P012731,0 days 00:02:31,-3,2,5
243,ASV,P011386,P012731,0 days 00:02:18,-5,4,9
243,ASV,P011225,PKIR,0 days 00:01:56,-3,2,5
243,ASV,P000229,P011386,0 days 00:01:48,-2,4,6
243,ASV,P004194,P011386,0 days 00:01:48,-2,4,6
243,ASV,P002100,P003526,0 days 00:01:46,4,4,0
243,ASV,P000229,P012729,0 days 00:01:05,-2,3,5
243,ASV,P003526,P012729,0 days 00:00:56,2,2,0
243,ASV,P012729,P012731,0 days 00:00:45,-2,1,3
243,ASV,P012731,PKIR,0 days 00:00:45,-2,1,3
243,MIL,P007032,P007831,0 days 00:23:01,8,53,45
243,MIL,P007831,P011205,0 days 00:22:22,13,52,39
243,MIL,P002849,P007831,0 days 00:22:03,-1,48,49
243,MIL,P007831,P012800,0 days 00:21:04,-17,35,52
243,MIL,P002849,P007032,0 days 00:19:23,-8,36,44
243,MIL,P007201,P007831,0 days 00:17:40,6,42,36
243,MIL,P002849,P012800,0 days 00:17:27,-10,35,45
243,MIL,P007032,P007201,0 days 00:16:59,2,35,33
243,MIL,P007032,P012800,0 days 00:15:55,-15,25,40
243,MIL,P002849,P007201,0 days 00:15:13,-11,29,40
243,MIL,P007032,P011205,0 days 00:13:57,17,38,21
243,MIL,P007201,P011205,0 days 00:13:18,11,35,24
243,MIL,P002849,P011205,0 days 00:13:13,3,31,28
243,MIL,P001518,P007831,0 days 00:13:08,-11,19,30
243,MIL,P007201,P012800,0 days 00:13:02,-11,23,34
243,MIL,P002812,P007831,0 days 00:12:27,7,24,17
243,MIL,P002812,P011205,0 days 00:12:13,12,26,14
243,MIL,P001518,P011205,0 days 00:10:23,-5,17,22
243,MIL,P011205,P012800,0 days 00:10:17,-6,20,26
243,MIL,P001518,P007032,0 days 00:08:22,0,17,17
243,MIL,P002812,P007032,0 days 00:07:54,13,22,9
243,MIL,P001518,P002812,0 days 00:07:50,-7,10,17
243,MIL,P001518,P012800,0 days 00:07:43,-10,9,19
243,MIL,P006701,P011205,0 days 00:06:42,-6,4,10
243,MIL,P002812,P012800,0 days 00:06:11,-9,5,14
243,MIL,P007831,P009960,0 days 00:06:08,-1,11,12
243,MIL,P002812,P007201,0 days 00:05:40,14,16,2
243,MIL,P001518,P002849,0 days 00:05:09,1,11,10
243,MIL,P006701,P007831,0 days 00:04:59,-4,4,8
243,MIL,P002849,P009960,0 days 00:04:55,5,11,6
243,MIL,P009960,P011205,0 days 00:04:11,-3,5,8
243,MIL,P002849,P006701,0 days 00:03:45,1,3,2
243,MIL,P006701,P009960,0 days 00:03:14,-2,3,5
243,MIL,P001518,P006701,0 days 00:02:57,-7,1,8
243,MIL,P009960,P012800,0 days 00:02:53,2,8,6
243,MIL,P007032,P009960,0 days 00:01:58,1,6,5
243,MIL,P002812,P006701,0 days 00:01:45,-2,1,3
243,MIL,P006701,P007032,0 days 00:01:43,-2,0,2
243,MIL,P006701,P007201,0 days 00:01:43,-2,0,2
243,MIL,P001518,P009960,0 days 00:01:12,-5,0,5
243,MIL,P007201,P009960,0 days 00:00:01,-1,0,1
244,IST,P004888,P007200,0 days 00:24:47,17,72,55
244,IST,P009846,P011981,0 days 00:17:06,0,41,41
244,IST,P006590,P011981,0 days 00:16:30,6,39,33
244,IST,P004888,P011078,0 days 00:14:50,18,45,27
244,IST,P006590,P009664,0 days 00:14:40,0,31,31
244,IST,P004888,P012710,0 days 00:14:33,10,40,30
244,IST,P007200,P012710,0 days 00:14:33,10,40,30
244,IST,P006590,P009846,0 days 00:13:38,2,33,31
244,IST,P004888,P012788,0 days 00:13:25,23,47,24
244,IST,P011078,P012788,0 days 00:11:16,24,41,17
244,IST,P007200,P011078,0 days 00:11:13,21,41,20
244,IST,P009664,P011981,0 days 00:11:13,1,25,24
244,IST,P009664,P009846,0 days 00:11:07,5,29,24
244,IST,P007200,P012788,0 days 00:10:23,26,43,17
244,IST,P009846,P011078,0 days 00:10:20,3,29,26
244,IST,P007200,P011981,0 days 00:09:51,3,28,25
244,IST,P009664,P011078,0 days 00:09:46,5,25,20
244,IST,P007200,P009846,0 days 00:09:27,5,31,26
244,IST,P004888,P011981,0 days 00:09:20,3,22,19
244,IST,P004888,P006590,0 days 00:09:19,4,20,16
244,IST,P011078,P011981,0 days 00:08:58,-5,18,23
244,IST,P006590,P011078,0 days 00:08:57,-4,16,20
244,IST,P004888,P009513,0 days 00:08:50,-3,23,26
244,IST,P007200,P009513,0 days 00:08:46,-5,21,26
244,IST,P004888,P009846,0 days 00:07:56,3,23,20
244,IST,P009513,P012710,0 days 00:06:44,-6,15,21
244,IST,P009513,P009664,0 days 00:06:39,5,15,10
244,IST,P004888,P009664,0 days 00:06:24,5,17,12
244,IST,P006590,P007200,0 days 00:06:23,5,20,15
244,IST,P009664,P012788,0 days 00:06:18,9,21,12
244,IST,P007200,PLHK,0 days 00:06:08,-8,11,19
244,IST,P004888,PLHK,0 days 00:06:08,-8,11,19
244,IST,P012710,P012788,0 days 00:06:08,14,23,9
244,IST,P009513,PLHK,0 days 00:06:08,-8,11,19
244,IST,P012710,PLHK,0 days 00:06:08,-8,11,19
244,IST,P011078,P012710,0 days 00:05:32,12,19,7
244,IST,P009513,P009846,0 days 00:04:41,6,11,5
244,IST,P009513,P011981,0 days 00:04:37,4,9,5
244,IST,P006590,P009513,0 days 00:04:37,4,9,5
244,IST,P007200,P009664,0 days 00:03:57,10,21,11
244,IST,P006590,P012788,0 days 00:03:27,-1,6,7
244,IST,P009513,P012788,0 days 00:02:42,5,12,7
244,IST,P006590,P012710,0 days 00:02:17,4,6,2
244,IST,P011981,P012710,0 days 00:02:17,4,6,2
244,IST,P009846,P012788,0 days 00:01:57,8,11,3
244,IST,P009513,P011078,0 days 00:00:04,2,2,0
244,MUN,P001288,P008985,0 days 00:21:53,-1,54,55
244,MUN,P001288,P007056,0 days 00:20:42,7,54,47
244,MUN,P003583,P007056,0 days 00:19:30,-2,48,50
244,MUN,P007056,P008985,0 days 00:18:54,1,47,46
244,MUN,P001288,P003583,0 days 00:18:37,-4,48,52
244,MUN,P003583,P008985,0 days 00:18:21,-7,44,51
244,MUN,P007056,P011987,0 days 00:15:48,-10,40,50
244,MUN,P003583,P011987,0 days 00:15:42,-5,43,48
244,MUN,P001288,P011987,0 days 00:14:29,-6,38,44
244,MUN,P008985,P011987,0 days 00:14:03,-7,34,41
244,MUN,P006760,P007975,0 days 00:11:20,-14,18,32
244,MUN,P003583,P007975,0 days 00:11:16,-3,28,31
244,MUN,P001288,P007975,0 days 00:10:36,5,26,21
244,MUN,P007056,P007975,0 days 00:10:13,-1,22,23
244,MUN,P004508,P007975,0 days 00:10:00,-3,19,22
244,MUN,P004508,P007056,0 days 00:09:41,-2,17,19
244,MUN,P004508,P010391,0 days 00:09:26,0,20,20
244,MUN,P001288,P004508,0 days 00:08:03,2,18,16
244,MUN,P001288,P010391,0 days 00:08:03,2,18,16
244,MUN,P007056,P010391,0 days 00:06:51,0,15,15
244,MUN,P005478,P007975,0 days 00:06:32,-8,8,16
244,MUN,P007975,P010391,0 days 00:06:24,-5,10,15
244,MUN,P003583,P006760,0 days 00:06:17,-4,14,18
244,MUN,P001557,P007975,0 days 00:06:06,-8,11,19
244,MUN,P003583,P004508,0 days 00:05:58,-11,9,20
244,MUN,P001557,P006760,0 days 00:05:43,-4,11,15
244,MUN,P006760,P007056,0 days 00:05:37,-10,7,17
244,MUN,P004508,P006760,0 days 00:05:29,-7,9,16
244,MUN,P008985,P010391,0 days 00:05:20,-6,10,16
244,MUN,P004508,P008985,0 days 00:04:55,-4,10,14
244,MUN,P007639,P007975,0 days 00:04:39,-8,7,15
244,MUN,P001288,P005478,0 days 00:04:19,-2,8,10
244,MUN,P001557,P003583,0 days 00:04:18,-10,10,20
244,MUN,P001557,P005478,0 days 00:04:00,-6,4,10
244,MUN,P007975,P008985,0 days 00:03:49,4,10,6
244,MUN,P001288,P001557,0 days 00:03:47,-4,7,11
244,MUN,P005478,P006760,0 days 00:03:41,-4,4,8
244,MUN,P007639,P010391,0 days 00:03:17,-2,7,9
244,MUN,P007975,P011987,0 days 00:03:13,-7,9,16
244,MUN,P004508,P007639,0 days 00:03:05,1,7,6
244,MUN,P001557,P004508,0 days 00:02:31,-4,7,11
244,MUN,P003583,P005478,0 days 00:02:19,-4,4,8
244,MUN,P005478,P010391,0 days 00:02:13,-6,0,6
244,MUN,P001288,P007639,0 days 00:02:11,-1,5,6
244,MUN,P001557,P010391,0 days 00:02:10,-10,0,10
244,MUN,P006760,P011987,0 days 00:02:10,-3,5,8
244,MUN,P005478,P008985,0 days 00:02:00,-2,4,6
244,MUN,P001288,P006760,0 days 00:02:00,2,4,2
244,MUN,P007056,P007639,0 days 00:01:56,-7,2,9
244,MUN,P001557,P008985,0 days 00:01:53,-6,3,9
244,MUN,P006760,P010391,0 days 00:01:41,-6,0,6
244,MUN,P007639,P011987,0 days 00:01:34,-9,0,9
244,MUN,P001557,P011987,0 days 00:01:28,-4,3,7
244,MUN,P006760,P007639,0 days 00:01:22,-6,0,6
244,MUN,P003583,P010391,0 days 00:00:54,-6,0,6
244,MUN,P010391,P011987,0 days 00:00:37,-5,0,5
244,MUN,P004508,P005478,0 days 00:00:32,0,0,0
244,MUN,P005478,P007639,0 days 00:00:32,0,0,0
245,MCO,P010588,PLCZ,0 days 00:20:47,2,47,45
245,MCO,P005985,P010588,0 days 00:20:36,0,46,46
245,MCO,P005985,P011231,0 days 00:19:25,0,42,42
245,MCO,P011212,P011226,0 days 00:19:00,25,55,30
245,MCO,P005985,PLCZ,0 days 00:17:59,-1,40,41
245,MCO,P005985,P011226,0 days 00:16:20,17,48,31
245,MCO,P008099,P010588,0 days 00:14:32,-7,29,36
245,MCO,P008099,PLCZ,0 days 00:14:32,-7,29,36
245,MCO,P008099,P011231,0 days 00:14:21,-5,30,35
245,MCO,P005985,P008099,0 days 00:13:12,-3,29,32
245,MCO,P011196,P011231,0 days 00:13:10,13,38,25
245,MCO,P005985,P011212,0 days 00:12:12,18,34,16
245,MCO,P011196,P011226,0 days 00:12:11,12,36,24
245,MCO,P010588,P011231,0 days 00:12:06,-8,21,29
245,MCO,P011226,P011231,0 days 00:11:22,12,34,22
245,MCO,P011231,PLCZ,0 days 00:10:18,-9,17,26
245,MCO,P005985,P011196,0 days 00:09:56,9,27,18
245,MCO,P010588,P011212,0 days 00:09:32,10,25,15
245,MCO,P010588,P011226,0 days 00:09:23,17,33,16
245,MCO,P011196,P011212,0 days 00:09:14,16,30,14
245,MCO,P011212,P011231,0 days 00:08:25,16,28,12
245,MCO,P011212,PLCZ,0 days 00:07:35,5,18,13
245,MCO,P004197,P011212,0 days 00:07:31,5,16,11
245,MCO,P011226,PLCZ,0 days 00:07:26,12,26,14
245,MCO,P008099,P011226,0 days 00:06:57,10,25,15
245,MCO,P004197,P010588,0 days 00:05:39,11,16,5
245,MCO,P008099,P011212,0 days 00:05:23,0,13,13
245,MCO,P002581,P011212,0 days 00:05:14,3,11,8
245,MCO,P002581,P011226,0 days 00:05:14,3,11,8
245,MCO,P005985,P012709,0 days 00:04:45,-3,10,13
245,MCO,P011196,P012709,0 days 00:04:45,-3,10,13
245,MCO,P011231,P012709,0 days 00:04:45,-3,10,13
245,MCO,P004197,PLCZ,0 days 00:04:31,6,11,5
245,MCO,P004197,P011226,0 days 00:04:28,6,12,6
245,MCO,P004790,P011226,0 days 00:04:06,-2,6,8
245,MCO,P004790,P011212,0 days 00:04:06,-2,6,8
245,MCO,P002581,P004790,0 days 00:04:06,-2,6,8
245,MCO,P008099,P011196,0 days 00:04:03,4,13,9
245,MCO,P002581,P004197,0 days 00:03:00,-1,5,6
245,MCO,P011226,P012709,0 days 00:02:57,-4,6,10
245,MCO,P010588,P011196,0 days 00:02:37,1,6,5
245,MCO,P004790,P005985,0 days 00:02:14,4,6,2
245,MCO,P002581,P005985,0 days 00:02:14,4,6,2
245,MCO,P004197,P004790,0 days 00:01:52,-6,0,6
245,MCO,P010588,P012709,0 days 00:01:48,1,4,3
245,MCO,P004197,P005985,0 days 00:01:43,3,4,1
245,MCO,P004197,P008099,0 days 00:01:20,-4,0,4
245,MCO,P002581,P010588,0 days 00:01:08,5,5,0
245,RED,P002553,P012044,0 days 00:26:31,5,64,59
245,RED,P006436,P009035,0 days 00:24:25,6,61,55
245,RED,P009035,P012044,0 days 00:22:57,13,60,47
245,RED,P006436,P012044,0 days 00:22:27,6,58,52
245,RED,P002553,P009035,0 days 00:21:48,8,57,49
245,RED,P002553,P006436,0 days 00:20:02,4,53,49
245,RED,P004720,P006436,0 days 00:15:34,-4,31,35
245,RED,P004720,P009035,0 days 00:15:11,3,31,28
245,RED,P012044,PLUO,0 days 00:13:25,-4,31,35
245,RED,P002553,PLUO,0 days 00:12:39,-4,29,33
245,RED,P004720,P012044,0 days 00:11:18,8,26,18
245,RED,P006436,PLUO,0 days 00:10:13,-4,25,29
245,RED,P002553,P004720,0 days 00:09:39,6,23,17
245,RED,P009035,PLUO,0 days 00:09:07,3,25,22
245,RED,P005099,P012801,0 days 00:08:45,-20,8,28
245,RED,P008966,P012801,0 days 00:08:22,-16,9,25
245,RED,P005099,P006436,0 days 00:08:15,-7,16,23
245,RED,P005099,P008966,0 days 00:07:25,-14,8,22
245,RED,P008966,P012044,0 days 00:07:02,-6,12,18
245,RED,P011941,P012044,0 days 00:06:56,-10,10,20
245,RED,P005099,P009035,0 days 00:06:46,-3,14,17
245,RED,P000848,P002553,0 days 00:06:16,-7,8,15
245,RED,P005099,P012044,0 days 00:06:03,-1,15,16
245,RED,P002553,P005099,0 days 00:05:50,-7,12,19
245,RED,P000848,P012044,0 days 00:05:45,-2,9,11
245,RED,P004720,P005099,0 days 00:05:43,-9,7,16
245,RED,P005099,P011941,0 days 00:05:32,0,8,8
245,RED,P011941,PLUO,0 days 00:05:15,-7,6,13
245,RED,P006436,P011941,0 days 00:04:58,-7,7,14
245,RED,P006436,P008966,0 days 00:04:33,-8,7,15
245,RED,P012044,P012801,0 days 00:04:28,-5,7,12
245,RED,P008966,P011941,0 days 00:04:21,-3,6,9
245,RED,P004720,P008966,0 days 00:03:47,-8,5,13
245,RED,P002553,P011941,0 days 00:03:41,-10,4,14
245,RED,P011941,P012801,0 days 00:03:35,-3,4,7
245,RED,P000848,P011941,0 days 00:03:20,-4,5,9
245,RED,P002553,P012801,0 days 00:03:18,-9,3,12
245,RED,P000848,PLUO,0 days 00:03:12,0,6,6
245,RED,P009035,P011941,0 days 00:03:03,-2,5,7
245,RED,P004720,P011941,0 days 00:03:03,-2,5,7
245,RED,P000848,P009035,0 days 00:02:55,-1,4,5
245,RED,P006436,P012801,0 days 00:02:49,-10,2,12
245,RED,P004720,P012801,0 days 00:02:49,-10,2,12
245,RED,P002553,P008966,0 days 00:02:48,-6,3,9
245,RED,P000848,P012801,0 days 00:02:25,-9,1,10
245,RED,P000848,P008966,0 days 00:01:55,-6,1,7
245,RED,P008966,P009035,0 days 00:01:48,-1,3,4
245,RED,P008966,PLUO,0 days 00:01:43,0,2,2
245,RED,P000848,P004720,0 days 00:01:36,0,2,2
245,RED,P000848,P005099,0 days 00:01:28,-7,0,7
245,RED,P009035,P012801,0 days 00:01:20,-6,0,6
245,RED,P005099,PLUO,0 days 00:00:57,0,0,0
245,RED,P012801,PLUO,0 days 00:00:57,0,0,0
246,TEL,P009622,P009783,0 days 00:24:17,-2,56,58
246,TEL,P009783,P011199,0 days 00:21:15,1,51,50
246,TEL,P009622,P011199,0 days 00:21:15,1,51,50
246,TEL,P011193,P011971,0 days 00:16:22,8,27,19
246,TEL,P011193,P011214,0 days 00:16:02,7,30,23
246,TEL,P009863,P011199,0 days 00:15:21,0,37,37
246,TEL,P011214,P012744,0 days 00:15:10,3,27,24
246,TEL,P009783,P009863,0 days 00:14:54,-7,35,42
246,TEL,P009622,P009863,0 days 00:14:17,-7,35,42
246,TEL,P011214,P011971,0 days 00:13:47,7,25,18
246,TEL,P011193,P012744,0 days 00:13:24,8,24,16
246,TEL,P011971,P012744,0 days 00:13:10,8,24,16
246,TEL,P005145,P011199,0 days 00:11:56,1,31,30
246,TEL,P005145,P009783,0 days 00:11:56,1,31,30
246,TEL,P005145,P009622,0 days 00:11:56,1,31,30
246,TEL,P009863,P012744,0 days 00:10:45,3,19,16
246,TEL,P009863,P011214,0 days 00:10:33,-11,10,21
246,TEL,P007990,P011214,0 days 00:10:23,10,24,14
246,TEL,P009783,P011214,0 days 00:09:31,-7,17,24
246,TEL,P005145,P009863,0 days 00:09:18,-7,20,27
246,TEL,P009863,P011193,0 days 00:09:01,-1,8,9
246,TEL,P009863,P011971,0 days 00:08:37,-2,8,10
246,TEL,P007990,P009783,0 days 00:08:22,7,19,12
246,TEL,P007990,P012744,0 days 00:08:02,11,21,10
246,TEL,P009622,P011214,0 days 00:07:38,-8,14,22
246,TEL,P007990,P011971,0 days 00:07:29,8,19,11
246,TEL,P007990,P011193,0 days 00:07:08,10,19,9
246,TEL,P007990,P009622,0 days 00:07:06,6,16,10
246,TEL,P009783,P012744,0 days 00:05:23,6,16,10
246,TEL,P009622,P012744,0 days 00:05:23,6,16,10
246,TEL,P011199,P011214,0 days 00:04:50,-5,9,14
246,TEL,P009783,P011193,0 days 00:04:47,0,8,8
246,TEL,P007990,P011199,0 days 00:04:30,4,11,7
246,TEL,P011193,P011199,0 days 00:04:24,1,7,6
246,TEL,P009783,P011971,0 days 00:04:15,-3,3,6
246,TEL,P011199,P012744,0 days 00:03:51,11,13,2
246,TEL,P011199,P011971,0 days 00:03:38,-2,2,4
246,TEL,P005145,P007990,0 days 00:03:30,8,11,3
246,TEL,P009622,P011193,0 days 00:02:54,-1,5,6
246,TEL,P009622,P011971,0 days 00:02:22,-4,0,4
246,TEL,P005145,P011193,0 days 00:00:26,0,0,0
246,TEL,P005145,P011214,0 days 00:00:26,0,0,0
246,TEL,P007990,P009863,0 days 00:00:26,0,0,0
246,ZAL,P002329,P011218,0 days 00:22:53,4,55,51
246,ZAL,P002329,P007109,0 days 00:16:53,8,41,33
246,ZAL,P002676,P010390,0 days 00:16:38,9,33,24
246,ZAL,P002676,P011218,0 days 00:16:20,10,38,28
246,ZAL,P007109,P011218,0 days 00:15:15,12,44,32
246,ZAL,P002329,P010390,0 days 00:15:04,9,33,24
246,ZAL,P002329,P002676,0 days 00:14:53,6,30,24
246,ZAL,P010390,P011218,0 days 00:14:20,11,33,22
246,ZAL,P002329,P005504,0 days 00:13:24,-13,26,39
246,ZAL,P010390,P012715,0 days 00:12:58,-5,18,23
246,ZAL,P011218,P012715,0 days 00:12:23,-5,28,33
246,ZAL,P003210,P003211,0 days 00:10:57,-10,10,20
246,ZAL,P002676,P012715,0 days 00:10:55,-1,21,22
246,ZAL,P002329,P012787,0 days 00:10:47,-1,26,27
246,ZAL,P003210,P012715,0 days 00:10:44,-1,12,13
246,ZAL,P003210,P010390,0 days 00:10:13,-2,12,14
246,ZAL,P003211,P010390,0 days 00:09:54,-7,9,16
246,ZAL,P002329,P003210,0 days 00:09:40,-6,12,18
246,ZAL,P005504,P011218,0 days 00:09:23,-5,23,28
246,ZAL,P002329,P003211,0 days 00:09:15,-12,12,24
246,ZAL,P002676,P007109,0 days 00:09:13,9,22,13
246,ZAL,P002329,P012715,0 days 00:09:11,-7,17,24
246,ZAL,P007109,P012787,0 days 00:08:51,-1,26,27
246,ZAL,P003211,P012715,0 days 00:08:47,-13,7,20
246,ZAL,P011218,P012787,0 days 00:08:28,-1,26,27
246,ZAL,P005504,P007109,0 days 00:07:59,-5,20,25
246,ZAL,P002676,P003210,0 days 00:07:36,-1,8,9
246,ZAL,P005504,P012787,0 days 00:07:22,-3,17,20
246,ZAL,P007109,P010390,0 days 00:06:52,12,17,5
246,ZAL,P003210,P005504,0 days 00:06:04,-7,7,14
246,ZAL,P003210,P012787,0 days 00:05:56,-6,5,11
246,ZAL,P003211,P012787,0 days 00:05:06,-2,8,10
246,ZAL,P003210,P011218,0 days 00:04:52,5,10,5
246,ZAL,P002676,P012787,0 days 00:04:30,-5,6,11
246,ZAL,P003211,P007109,0 days 00:04:27,-2,8,10
246,ZAL,P002676,P003211,0 days 00:04:25,-4,2,6
246,ZAL,P010390,P012787,0 days 00:04:17,-3,5,8
246,ZAL,P012715,P012787,0 days 00:04:03,-6,5,11
246,ZAL,P003210,P007109,0 days 00:04:02,-4,4,8
246,ZAL,P003211,P005504,0 days 00:03:59,-11,5,16
246,ZAL,P003211,P011218,0 days 00:03:46,-7,7,14
246,ZAL,P005504,P012715,0 days 00:03:43,-5,6,11
246,ZAL,P007109,P012715,0 days 00:02:00,-1,6,7
246,ZAL,P002676,P005504,0 days 00:01:42,-3,0,3
247,OLY,P001255,P008811,0 days 00:24:24,9,50,41
247,OLY,P001255,P010612,0 days 00:20:47,4,44,40
247,OLY,P007853,P011194,0 days 00:19:28,-2,31,33
247,OLY,P008811,P010612,0 days 00:19:07,2,39,37
247,OLY,P001255,P008829,0 days 00:18:48,6,39,33
247,OLY,P008811,P008829,0 days 00:18:28,3,36,33
247,OLY,P001255,P007853,0 days 00:17:08,3,32,29
247,OLY,P001255,P007982,0 days 00:15:38,20,32,12
247,OLY,P008829,P010612,0 days 00:15:29,5,32,27
247,OLY,P001255,P011194,0 days 00:13:37,10,28,18
247,OLY,P007982,P008811,0 days 00:12:53,14,29,15
247,OLY,P007982,P011194,0 days 00:12:05,4,22,18
247,OLY,P007853,P007982,0 days 00:11:28,0,17,17
247,OLY,P007853,P008811,0 days 00:11:05,-3,21,24
247,OLY,P007982,P010612,0 days 00:10:55,10,23,13
247,OLY,P007853,P008829,0 days 00:09:49,-1,19,20
247,OLY,P007853,P012878,0 days 00:09:44,-4,13,17
247,OLY,P011194,P012878,0 days 00:09:44,-4,13,17
247,OLY,P007982,P008829,0 days 00:08:56,9,15,6
247,OLY,P006302,P008811,0 days 00:08:45,-2,15,17
247,OLY,P001255,P006302,0 days 00:08:45,-2,15,17
247,OLY,P007853,P010612,0 days 00:07:53,-9,15,24
247,OLY,P010612,P011194,0 days 00:07:41,-1,18,19
247,OLY,P008811,P011194,0 days 00:07:34,4,17,13
247,OLY,P006302,P008829,0 days 00:07:31,-4,15,19
247,OLY,P001255,P012878,0 days 00:07:21,1,11,10
247,OLY,P007982,P012878,0 days 00:06:46,-1,8,9
247,OLY,P006302,P010612,0 days 00:06:05,-3,12,15
247,OLY,P011194,P011983,0 days 00:05:52,-5,7,12
247,OLY,P007853,P011983,0 days 00:05:52,-5,7,12
247,OLY,P008829,P011194,0 days 00:04:14,2,8,6
247,OLY,P006302,P011194,0 days 00:04:06,0,6,6
247,OLY,P006302,P007853,0 days 00:04:06,0,6,6
247,OLY,P008829,P011983,0 days 00:03:54,-1,5,6
247,OLY,P007853,P011965,0 days 00:03:39,1,7,6
247,OLY,P008829,P011965,0 days 00:03:39,1,7,6
247,OLY,P010612,P012878,0 days 00:03:23,-4,5,9
247,OLY,P007982,P011983,0 days 00:02:39,-4,2,6
247,OLY,P011983,P012878,0 days 00:01:58,-4,2,6
247,OLY,P001255,P011965,0 days 00:01:52,1,5,4
247,OLY,P008811,P011965,0 days 00:01:52,1,5,4
247,OLY,P011194,P011965,0 days 00:01:47,0,2,2
247,OLY,P011965,P011983,0 days 00:01:47,0,2,2
247,OLY,P006302,P011983,0 days 00:01:26,-1,3,4
247,VIR,P001133,P006739,0 days 00:20:19,7,41,34
247,VIR,P001844,PBCN,0 days 00:17:42,-10,28,38
247,VIR,P001133,P010781,0 days 00:17:09,-1,27,28
247,VIR,P001844,P008847,0 days 00:14:56,-9,21,30
247,VIR,P001133,P004007,0 days 00:14:48,-3,22,25
247,VIR,P003048,PBCN,0 days 00:14:37,-1,28,29
247,VIR,P001844,P003048,0 days 00:14:37,-1,28,29
247,VIR,P001133,P004554,0 days 00:13:51,0,23,23
247,VIR,P006739,P010781,0 days 00:13:48,6,27,21
247,VIR,P008847,PBCN,0 days 00:13:25,-8,19,27
247,VIR,P001844,P009549,0 days 00:13:07,-11,17,28
247,VIR,P004007,P004554,0 days 00:12:32,1,20,19
247,VIR,P009549,PBCN,0 days 00:12:19,-7,18,25
247,VIR,P008847,P009549,0 days 00:12:15,-9,16,25
247,VIR,P003048,P008847,0 days 00:11:11,-3,19,22
247,VIR,P001133,P001844,0 days 00:11:01,-9,14,23
247,VIR,P001133,P008847,0 days 00:10:56,-3,16,19
247,VIR,P004007,P006739,0 days 00:10:52,-2,18,20
247,VIR,P008847,P010781,0 days 00:10:44,4,23,19
247,VIR,P004554,P006739,0 days 00:10:30,5,21,16
247,VIR,P004007,P010781,0 days 00:10:06,-5,13,18
247,VIR,P003048,P009549,0 days 00:09:38,-5,15,20
247,VIR,P004554,P010781,0 days 00:09:22,-1,13,14
247,VIR,P006739,P008847,0 days 00:08:07,-1,16,17
247,VIR,P001133,P009549,0 days 00:07:57,1,14,13
247,VIR,P003527,P008847,0 days 00:07:02,5,16,11
247,VIR,P003527,P006739,0 days 00:07:02,5,16,11
247,VIR,P001133,PBCN,0 days 00:06:59,-4,12,16
247,VIR,P003527,P010781,0 days 00:06:42,8,16,8
247,VIR,P001133,P003527,0 days 00:06:26,6,14,8
247,VIR,P001844,P010781,0 days 00:06:18,-3,9,12
247,VIR,P001844,P004007,0 days 00:04:30,-2,5,7
247,VIR,P006739,P009549,0 days 00:04:16,3,11,8
247,VIR,P001844,P004554,0 days 00:04:10,-8,3,11
247,VIR,P004007,P009549,0 days 00:04:08,3,8,5
247,VIR,P004554,P009549,0 days 00:03:40,4,9,5
247,VIR,P001844,P006739,0 days 00:03:27,-4,7,11
247,VIR,P001133,P003048,0 days 00:03:26,2,9,7
247,VIR,P010781,PBCN,0 days 00:03:18,0,7,7
247,VIR,P006739,PBCN,0 days 00:03:01,3,9,6
247,VIR,P003048,P010781,0 days 00:02:41,2,7,5
247,VIR,P003048,P006739,0 days 00:02:18,2,6,4
247,VIR,P004007,P008847,0 days 00:02:16,-4,2,6
247,VIR,P004554,PBCN,0 days 00:01:19,-1,3,4
247,VIR,P003527,P009549,0 days 00:00:36,-1,2,3
247,VIR,P001844,P003527,0 days 00:00:20,-3,0,3
247,VIR,P009549,P010781,0 days 00:00:16,2,2,0
248,MAD,P003108,PTGB,0 days 00:25:40,1,59,58
248,MAD,P003108,P010357,0 days 00:24:53,-2,55,57
248,MAD,P005791,P010357,0 days 00:24:00,6,53,47
248,MAD,P010357,PTGB,0 days 00:22:37,1,53,52
248,MAD,P003108,P005928,0 days 00:21:21,-7,42,49
248,MAD,P005928,P010357,0 days 00:21:04,-5,46,51
248,MAD,P003108,P005791,0 days 00:20:21,7,46,39
248,MAD,P005791,PTGB,0 days 00:19:23,9,46,37
248,MAD,P005928,PTGB,0 days 00:18:46,-4,40,44
248,MAD,P005791,P005928,0 days 00:15:53,6,37,31
248,MAD,P006540,P009005,0 days 00:12:27,-9,20,29
248,MAD,P006540,P010357,0 days 00:12:17,-1,24,25
248,MAD,P009005,PCVM,0 days 00:11:40,-10,16,26
248,MAD,P005791,P006540,0 days 00:10:54,1,22,21
248,MAD,P004887,P009005,0 days 00:08:39,-2,17,19
248,MAD,P006540,PCVM,0 days 00:08:36,-8,12,20
248,MAD,P003108,P006540,0 days 00:07:43,1,18,17
248,MAD,P001392,P009005,0 days 00:07:24,-4,10,14
248,MAD,P003108,P004887,0 days 00:07:15,-9,14,23
248,MAD,P003108,P009005,0 days 00:07:15,-6,9,15
248,MAD,P004887,PCVM,0 days 00:07:06,-2,15,17
248,MAD,P001392,PCVM,0 days 00:07:05,-4,10,14
248,MAD,P009005,P010357,0 days 00:06:53,-6,9,15
248,MAD,P005791,P009005,0 days 00:06:28,-6,7,13
248,MAD,P004887,PTGB,0 days 00:06:17,-8,13,21
248,MAD,P005928,P009005,0 days 00:05:43,-1,10,11
248,MAD,P001392,P004887,0 days 00:05:33,-1,10,11
248,MAD,P001392,P006540,0 days 00:05:31,-2,10,12
248,MAD,P006540,PTGB,0 days 00:05:24,5,15,10
248,MAD,P004887,P005928,0 days 00:04:47,-8,9,17
248,MAD,P004887,P006540,0 days 00:04:41,-2,11,13
248,MAD,P005791,PCVM,0 days 00:04:34,-8,1,9
248,MAD,P005928,P006540,0 days 00:03:51,-1,8,9
248,MAD,P004887,P010357,0 days 00:03:14,-8,7,15
248,MAD,P003108,PCVM,0 days 00:03:07,-3,5,8
248,MAD,P009005,PTGB,0 days 00:03:03,0,6,6
248,MAD,P010357,PCVM,0 days 00:03:02,-5,1,6
248,MAD,P001392,P003108,0 days 00:01:53,-2,0,2
248,MAD,P001392,P005791,0 days 00:01:51,-3,0,3
248,MAD,PCVM,PTGB,0 days 00:01:30,0,4,4
248,MAD,P001392,P005928,0 days 00:00:19,0,0,0
248,ULK,P001932,P008962,0 days 00:25:39,6,61,55
248,ULK,P006661,P006961,0 days 00:19:42,7,47,40
248,ULK,P006961,P008962,0 days 00:19:33,12,50,38
248,ULK,P002968,P008962,0 days 00:17:12,-9,35,44
248,ULK,P001932,P002968,0 days 00:17:03,-7,35,42
248,ULK,P006661,P008962,0 days 00:16:15,7,43,36
248,ULK,P004004,P006961,0 days 00:15:31,10,32,22
248,ULK,P001932,P006961,0 days 00:14:30,11,39,28
248,ULK,P001932,P006661,0 days 00:13:54,7,39,32
248,ULK,P004004,P008962,0 days 00:10:45,4,22,18
248,ULK,P006068,P008962,0 days 00:10:34,-2,21,23
248,ULK,P001932,P006068,0 days 00:10:34,-2,21,23
248,ULK,P005844,P006961,0 days 00:10:14,5,22,17
248,ULK,P005844,P006661,0 days 00:10:14,5,22,17
248,ULK,P004004,P011157,0 days 00:10:02,13,27,14
248,ULK,P004004,P006661,0 days 00:10:01,1,19,18
248,ULK,P002968,P006068,0 days 00:09:13,-5,16,21
248,ULK,P008962,P011157,0 days 00:08:56,11,25,14
248,ULK,P002968,P009849,0 days 00:08:53,-5,16,21
248,ULK,P001932,P009849,0 days 00:08:53,-5,16,21
248,ULK,P008962,P009849,0 days 00:08:53,-5,16,21
248,ULK,P006068,P009849,0 days 00:08:53,-5,16,21
248,ULK,P002968,P006961,0 days 00:08:52,-4,19,23
248,ULK,P006961,P011157,0 days 00:08:23,13,23,10
248,ULK,P006961,P011980,0 days 00:07:56,2,14,12
248,ULK,P002968,P006661,0 days 00:07:33,-6,17,23
248,ULK,P004004,P011980,0 days 00:07:05,4,14,10
248,ULK,P006661,P011980,0 days 00:06:43,1,13,12
248,ULK,P004004,P005844,0 days 00:06:13,-3,7,10
248,ULK,P005844,P008962,0 days 00:05:56,6,15,9
248,ULK,P001932,P004004,0 days 00:05:13,3,9,6
248,ULK,P006661,P011157,0 days 00:05:11,9,17,8
248,ULK,P006961,P011052,0 days 00:04:55,0,10,10
248,ULK,P001932,P005844,0 days 00:04:45,8,15,7
248,ULK,P001932,P011157,0 days 00:04:44,6,12,6
248,ULK,P005844,P011980,0 days 00:04:40,-1,7,8
248,ULK,P008962,P011052,0 days 00:04:33,2,12,10
248,ULK,P004004,P011052,0 days 00:04:33,2,12,10
248,ULK,P011052,P011157,0 days 00:04:24,4,12,8
248,ULK,P011157,P011980,0 days 00:02:25,5,7,2
248,ULK,P002968,P004004,0 days 00:01:35,-2,2,4
248,ULK,P006068,P006661,0 days 00:01:19,3,5,2
248,ULK,P006068,P011157,0 days 00:01:19,3,5,2
248,ULK,P006661,P011052,0 days 00:01:00,-2,2,4
248,ULK,P002968,P011052,0 days 00:01:00,-4,0,4
248,ULK,P001932,P011980,0 days 00:00:53,1,1,0
248,ULK,P002968,P011980,0 days 00:00:51,-2,0,2
248,ULK,P011052,P011980,0 days 00:00:51,-2,0,2
248,ULK,P004004,P006068,0 days 00:00:22,0,0,0
248,ULK,P005844,P006068,0 days 00:00:22,0,0,0
248,ULK,P006068,P006961,0 days 00:00:20,0,0,0
248,ULK,P006068,P011052,0 days 00:00:20,0,0,0
248,ULK,P006068,P011980,0 days 00:00:20,0,0,0
249,PAM,P003960,P010568,0 days 00:26:57,-8,45,53
249,PAM,P007870,P010568,0 days 00:22:48,-15,35,50
249,PAM,P003960,P007870,0 days 00:20:46,-10,33,43
249,PAM,P003960,P012795,0 days 00:15:42,7,31,24
249,PAM,P003960,P006433,0 days 00:13:58,-5,24,29
249,PAM,P003960,P006643,0 days 00:13:40,-13,20,33
249,PAM,P006643,P007870,0 days 00:13:40,-13,20,33
249,PAM,P006643,P010568,0 days 00:13:40,-13,20,33
249,PAM,P010568,P012795,0 days 00:13:23,3,24,21
249,PAM,P006433,P010568,0 days 00:12:59,-9,20,29
249,PAM,P006433,P007870,0 days 00:11:47,-11,18,29
249,PAM,P006433,P006643,0 days 00:11:47,-11,18,29
249,PAM,P005356,P010568,0 days 00:11:46,1,24,23
249,PAM,P010393,P012795,0 days 00:10:54,-1,23,24
249,PAM,P010393,P011982,0 days 00:10:36,5,29,24
249,PAM,P005356,P011982,0 days 00:10:17,3,27,24
249,PAM,P011982,P012795,0 days 00:09:53,1,23,22
249,PAM,P000556,P011982,0 days 00:09:52,0,26,26
249,PAM,P003960,P005356,0 days 00:09:46,6,22,16
249,PAM,P005356,P012795,0 days 00:08:57,2,21,19
249,PAM,P005356,P007870,0 days 00:08:34,1,16,15
249,PAM,P000556,P010393,0 days 00:07:59,-3,22,25
249,PAM,P003960,P011982,0 days 00:07:39,2,16,14
249,PAM,P010393,P011970,0 days 00:07:38,-5,21,26
249,PAM,P011970,P011982,0 days 00:07:29,3,23,20
249,PAM,P010568,P011982,0 days 00:07:22,-7,11,18
249,PAM,P007870,P012795,0 days 00:07:12,1,12,11
249,PAM,P000556,P011970,0 days 00:06:59,-3,20,23
249,PAM,P000556,P005356,0 days 00:06:49,-3,18,21
249,PAM,P003960,P010393,0 days 00:06:03,6,13,7
249,PAM,P005356,P010393,0 days 00:05:36,2,18,16
249,PAM,P000556,P012795,0 days 00:04:49,-7,10,17
249,PAM,P005356,P011970,0 days 00:04:43,0,14,14
249,PAM,P007870,P011982,0 days 00:04:30,-3,7,10
249,PAM,P011970,P012795,0 days 00:04:28,-9,9,18
249,PAM,P006433,P010393,0 days 00:03:46,6,8,2
249,PAM,P006433,P012795,0 days 00:03:46,6,8,2
249,PAM,P010393,P010568,0 days 00:03:44,2,6,4
249,PAM,P000556,P007870,0 days 00:02:43,-3,4,7
249,PAM,P006433,P011982,0 days 00:02:34,4,6,2
249,PAM,P000556,P010568,0 days 00:02:02,-5,2,7
249,PAM,P006643,P012795,0 days 00:01:53,-2,2,4
249,PAM,P000556,P006433,0 days 00:01:35,0,2,2
249,PAM,P003960,P011970,0 days 00:01:18,0,3,3
249,PAM,P003960,P012740,0 days 00:01:15,-1,1,2
249,PAM,P007870,P012740,0 days 00:01:15,-1,1,2
249,PAM,P010568,P012740,0 days 00:01:15,-1,1,2
249,PAM,P012740,P012795,0 days 00:01:15,-1,1,2
249,PAM,P007870,P011970,0 days 00:00:41,2,2,0
249,BAR,P000925,P004866,0 days 00:26:01,12,57,45
249,BAR,P000925,P002939,0 days 00:24:41,9,51,42
249,BAR,P004866,P012745,0 days 00:24:19,12,51,39
249,BAR,P002939,P004866,0 days 00:24:04,13,53,40
249,BAR,P000925,P012745,0 days 00:23:10,7,47,40
249,BAR,P002939,P012745,0 days 00:22:33,8,46,38
249,BAR,P006435,P012745,0 days 00:13:54,0,29,29
249,BAR,P004866,P007519,0 days 00:13:33,12,29,17
249,BAR,P007519,P012745,0 days 00:13:33,12,29,17
249,BAR,P004866,P006435,0 days 00:13:32,13,39,26
249,BAR,P002939,P007519,0 days 00:11:47,11,27,16
249,BAR,P006435,PLFW,0 days 00:11:38,-2,30,32
249,BAR,P003196,P006435,0 days 00:11:32,-1,29,30
249,BAR,P000925,P007519,0 days 00:11:12,9,25,16
249,BAR,P003196,PLFW,0 days 00:11:06,-4,27,31
249,BAR,P007464,PLFW,0 days 00:10:07,1,28,27
249,BAR,P000925,P006435,0 days 00:09:06,3,20,17
249,BAR,P003196,P007464,0 days 00:08:47,1,25,24
249,BAR,P006435,P007464,0 days 00:08:47,1,25,24
249,BAR,P004866,P007464,0 days 00:08:35,9,27,18
249,BAR,P002939,P006435,0 days 00:07:54,2,17,15
249,BAR,P004866,PLFW,0 days 00:07:44,6,23,17
249,BAR,P004866,P009992,0 days 00:06:55,-2,12,14
249,BAR,P000925,P009992,0 days 00:06:55,-2,12,14
249,BAR,P003196,P004866,0 days 00:06:53,9,21,12
249,BAR,P003196,P012745,0 days 00:06:03,-2,11,13
249,BAR,P002939,P009992,0 days 00:05:35,-2,9,11
249,BAR,P012745,PLFW,0 days 00:05:34,-5,10,15
249,BAR,P003478,P006435,0 days 00:05:03,-10,5,15
249,BAR,P000925,P007464,0 days 00:04:03,3,10,7
249,BAR,P007464,P009992,0 days 00:04:03,3,10,7
249,BAR,P003196,P003478,0 days 00:03:51,-8,5,13
249,BAR,P003478,PLFW,0 days 00:03:51,-8,5,13
249,BAR,P009992,P012745,0 days 00:02:52,-5,2,7
249,BAR,P003478,P012745,0 days 00:02:51,-6,2,8
249,BAR,P002939,P007464,0 days 00:02:43,3,7,4
249,BAR,P000925,PLFW,0 days 00:02:32,1,6,5
249,BAR,P003196,P007519,0 days 00:02:21,3,4,1
249,BAR,P003478,P007464,0 days 00:02:12,-4,3,7
249,BAR,P007464,P012745,0 days 00:02:03,-1,5,6
249,BAR,P009992,PLFW,0 days 00:01:20,0,3,3
249,BAR,P000925,P003478,0 days 00:01:12,-2,0,2
249,BAR,P002939,P003478,0 days 00:01:12,-2,0,2
249,BAR,P006435,P007519,0 days 00:01:06,2,2,0
249,BAR,P007519,PLFW,0 days 00:00:40,-1,0,1
249,BAR,P002939,P003196,0 days 00:00:35,2,2,0
250,MIL,P007831,P011224,0 days 00:28:34,14,62,48
250,MIL,P007831,P011205,0 days 00:27:55,7,58,51
250,MIL,P002849,P007831,0 days 00:27:18,6,54,48
250,MIL,P011205,P011224,0 days 00:26:19,10,56,46
250,MIL,P002849,P011224,0 days 00:25:44,6,51,45
250,MIL,P002849,P011205,0 days 00:25:03,4,49,45
250,MIL,P007201,P007831,0 days 00:20:29,10,44,34
250,MIL,P007201,P011205,0 days 00:20:29,10,44,34
250,MIL,P007201,P011224,0 days 00:20:29,10,44,34
250,MIL,P002849,P007201,0 days 00:19:08,4,37,33
250,MIL,P000796,P007831,0 days 00:14:02,9,36,27
250,MIL,P000796,P007032,0 days 00:13:36,-8,29,37
250,MIL,P000796,P002812,0 days 00:11:21,-10,24,34
250,MIL,P002812,P007032,0 days 00:11:21,-10,24,34
250,MIL,P000796,P011205,0 days 00:10:19,3,26,23
250,MIL,P000796,P011224,0 days 00:09:26,10,25,15
250,MIL,P000796,P002849,0 days 00:08:32,0,17,17
250,MIL,P000796,P001518,0 days 00:08:02,-9,15,24
250,MIL,P001518,P007032,0 days 00:07:57,-9,15,24
250,MIL,P007032,P012800,0 days 00:06:49,-9,13,22
250,MIL,P000796,P012800,0 days 00:06:49,-9,13,22
250,MIL,P002812,P012800,0 days 00:06:49,-9,13,22
250,MIL,P007032,P007831,0 days 00:06:46,3,17,14
250,MIL,P001518,P002812,0 days 00:06:28,-9,12,21
250,MIL,P001518,P012800,0 days 00:04:56,-9,7,16
250,MIL,P002812,P007831,0 days 00:04:31,1,12,11
250,MIL,P002812,P011205,0 days 00:03:03,-3,7,10
250,MIL,P007032,P011205,0 days 00:03:03,-3,7,10
250,MIL,P002849,P007032,0 days 00:02:37,0,5,5
250,MIL,P007032,P011224,0 days 00:02:15,4,6,2
250,MIL,P001518,P011205,0 days 00:01:37,0,5,5
250,MIL,P001518,P002849,0 days 00:01:34,0,3,3
250,MIL,P001518,P007831,0 days 00:01:34,0,3,3
250,MIL,P007831,P012800,0 days 00:01:31,2,6,4
250,MIL,P002812,P011224,0 days 00:01:29,2,4,2
250,MIL,P000796,P007201,0 days 00:01:21,6,7,1
250,MIL,P002812,P002849,0 days 00:00:22,-2,0,2
250,MIL,P002849,P012800,0 days 00:00:22,-2,0,2
250,PAR,P003983,P008987,0 days 00:31:07,9,70,61
250,PAR,P000956,P003983,0 days 00:21:14,13,50,37
250,PAR,P008987,P012096,0 days 00:20:05,10,47,37
250,PAR,P000956,P008987,0 days 00:19:45,13,47,34
250,PAR,P003983,P012096,0 days 00:19:45,13,47,34
250,PAR,P004172,P008987,0 days 00:16:45,-16,35,51
250,PAR,P003983,P004172,0 days 00:16:28,-7,38,45
250,PAR,P000956,P012096,0 days 00:15:59,18,40,22
250,PAR,P008987,P009862,0 days 00:13:32,13,32,19
250,PAR,P003983,P009862,0 days 00:13:01,13,32,19
250,PAR,P004172,P011051,0 days 00:12:46,-7,24,31
250,PAR,P009862,P012743,0 days 00:11:46,-4,22,26
250,PAR,P009862,P012742,0 days 00:11:41,-1,22,23
250,PAR,P012742,P012743,0 days 00:11:10,-1,22,23
250,PAR,P007673,P008987,0 days 00:10:43,-11,14,25
250,PAR,P000956,P004172,0 days 00:10:38,-2,27,29
250,PAR,P004172,P012096,0 days 00:09:29,-5,24,29
250,PAR,P007673,P012096,0 days 00:09:17,-5,14,19
250,PAR,P003983,P007673,0 days 00:08:57,-2,14,16
250,PAR,P004172,P009862,0 days 00:08:13,-2,14,16
250,PAR,P004172,P012743,0 days 00:08:13,-8,13,21
250,PAR,P003983,P012743,0 days 00:08:07,-5,15,20
250,PAR,P004172,P012742,0 days 00:07:24,-11,10,21
250,PAR,P008987,P012742,0 days 00:07:18,-8,12,20
250,PAR,P011051,P012743,0 days 00:07:07,-2,13,15
250,PAR,P009862,P011051,0 days 00:07:06,1,14,13
250,PAR,P008987,P012743,0 days 00:06:38,-5,12,17
250,PAR,P011051,P012742,0 days 00:06:33,-8,10,18
250,PAR,P003983,P011051,0 days 00:06:13,1,14,13
250,PAR,P008987,P011051,0 days 00:05:39,-5,11,16
250,PAR,P004172,P007673,0 days 00:05:32,-14,7,21
250,PAR,P003983,P012742,0 days 00:05:32,1,12,11
250,PAR,P000956,P009862,0 days 00:05:25,12,16,4
250,PAR,P009862,P012096,0 days 00:05:25,12,16,4
250,PAR,P000956,P007673,0 days 00:05:11,3,7,4
250,PAR,P000956,P011051,0 days 00:04:45,-2,10,12
250,PAR,P000956,P012743,0 days 00:01:59,-3,3,6
250,PAR,P007673,P012742,0 days 00:01:46,-9,0,9
250,PAR,P007673,P011051,0 days 00:00:55,-6,0,6
250,PAR,P007673,P009862,0 days 00:00:31,0,0,0
250,PAR,P012096,P012742,0 days 00:00:20,-3,0,3
251,PAN,P003842,P011204,0 days 00:22:16,14,54,40
251,PAN,P002328,P011204,0 days 00:21:11,10,42,32
251,PAN,P003842,P012774,0 days 00:20:54,8,49,41
251,PAN,P001926,P002328,0 days 00:19:59,18,44,26
251,PAN,P002328,P003842,0 days 00:19:03,15,42,27
251,PAN,P001926,P012712,0 days 00:18:48,21,49,28
251,PAN,P001926,P011204,0 days 00:18:32,16,46,30
251,PAN,P002328,P007866,0 days 00:18:11,6,34,28
251,PAN,P001926,P003842,0 days 00:17:52,15,46,31
251,PAN,P007866,P011204,0 days 00:17:27,3,30,27
251,PAN,P011204,P012774,0 days 00:17:08,9,40,31
251,PAN,P003842,P012712,0 days 00:16:27,19,45,26
251,PAN,P011204,P012712,0 days 00:15:41,14,41,27
251,PAN,P002328,P012712,0 days 00:14:16,13,32,19
251,PAN,P001926,P007866,0 days 00:12:55,1,22,21
251,PAN,P003842,P007866,0 days 00:12:18,-4,20,24
251,PAN,P007866,P012774,0 days 00:11:52,-7,19,26
251,PAN,P002328,P012774,0 days 00:10:19,5,23,18
251,PAN,P001926,P012774,0 days 00:09:39,6,28,22
251,PAN,P012712,P012774,0 days 00:08:48,9,28,19
251,PAN,P001926,P005161,0 days 00:06:30,-2,8,10
251,PAN,P003842,P005161,0 days 00:05:43,-4,6,10
251,PAN,P002328,P005161,0 days 00:05:37,3,9,6
251,PAN,P007866,P012712,0 days 00:04:27,1,8,7
251,PAN,P007553,P011204,0 days 00:04:23,2,8,6
251,PAN,P007553,P007866,0 days 00:04:23,2,8,6
251,PAN,P002328,P007553,0 days 00:04:23,2,8,6
251,PAN,P001926,P007553,0 days 00:04:23,2,8,6
251,PAN,P005161,P012712,0 days 00:04:20,5,7,2
251,PAN,P011209,P012774,0 days 00:03:46,-4,5,9
251,PAN,P003842,P011209,0 days 00:03:31,-3,6,9
251,PAN,P011204,P011209,0 days 00:03:31,-3,6,9
251,PAN,P007866,P011209,0 days 00:02:57,-5,4,9
251,PAN,P005161,P007866,0 days 00:02:50,-5,3,8
251,PAN,P005161,P012774,0 days 00:01:28,-6,0,6
251,PAN,P002328,P011209,0 days 00:01:21,-4,2,6
251,PAN,P005161,P011209,0 days 00:01:17,-2,2,4
251,PAN,P008084,P012774,0 days 00:01:08,2,2,0
251,PAN,P006544,P012774,0 days 00:01:08,2,2,0
251,PAN,P006544,P008084,0 days 00:01:08,2,2,0
251,PAN,P011209,P012712,0 days 00:00:49,-2,2,4
251,PAN,P007553,P008084,0 days 00:00:46,0,0,0
251,PAN,P007553,P011209,0 days 00:00:46,0,0,0
251,PAN,P007553,P012774,0 days 00:00:46,0,0,0
251,PAN,P008084,P011209,0 days 00:00:46,0,0,0
251,PAN,P006544,P011209,0 days 00:00:46,0,0,0
251,PAN,P006544,P007553,0 days 00:00:46,0,0,0
251,PAN,P001926,P011209,0 days 00:00:42,-1,1,2
251,PAN,P005161,P011204,0 days 00:00:35,-1,1,2
251,PAN,P003842,P006544,0 days 00:00:22,2,2,0
251,PAN,P003842,P008084,0 days 00:00:22,2,2,0
251,PAN,P006544,P011204,0 days 00:00:22,2,2,0
251,PAN,P008084,P011204,0 days 00:00:22,2,2,0
251,ASV,P002100,P004194,0 days 00:20:41,-4,38,42
251,ASV,P000229,P011386,0 days 00:18:59,-17,31,48
251,ASV,P002100,P012731,0 days 00:18:22,0,35,35
251,ASV,P002100,P012080,0 days 00:17:29,1,30,29
251,ASV,P005094,P011386,0 days 00:17:21,-14,27,41
251,ASV,P004194,P012731,0 days 00:16:54,1,33,32
251,ASV,P004194,P012080,0 days 00:16:41,0,28,28
251,ASV,P006568,P011386,0 days 00:16:18,-10,23,33
251,ASV,P012080,PKIR,0 days 00:16:13,3,29,26
251,ASV,P012731,PKIR,0 days 00:15:28,4,27,23
251,ASV,P000229,P006568,0 days 00:15:26,-10,23,33
251,ASV,P012080,P012731,0 days 00:15:11,4,27,23
251,ASV,P000229,P005094,0 days 00:15:00,-12,25,37
251,ASV,P005094,P006568,0 days 00:14:59,-11,21,32
251,ASV,P002100,PKIR,0 days 00:14:51,4,27,23
251,ASV,P003526,P005094,0 days 00:14:44,-13,19,32
251,ASV,P004194,PKIR,0 days 00:14:03,3,25,22
251,ASV,P003526,P011386,0 days 00:13:37,-10,20,30
251,ASV,P000229,P003526,0 days 00:10:05,-8,14,22
251,ASV,P003526,P006568,0 days 00:10:04,-7,10,17
251,ASV,P011386,P012731,0 days 00:06:44,-8,14,22
251,ASV,P002100,P003526,0 days 00:06:14,-3,11,14
251,ASV,P004194,P011386,0 days 00:06:09,-11,12,23
251,ASV,P003526,P004194,0 days 00:06:07,-8,11,19
251,ASV,P002100,P011386,0 days 00:05:36,-4,12,16
251,ASV,P000229,P012731,0 days 00:05:33,-8,10,18
251,ASV,P006568,P012731,0 days 00:05:01,-5,8,13
251,ASV,P002100,P005094,0 days 00:04:43,-3,7,10
251,ASV,P004194,P005094,0 days 00:04:36,-8,7,15
251,ASV,P006568,PKIR,0 days 00:04:11,-1,7,8
251,ASV,P000229,P004194,0 days 00:03:29,-9,6,15
251,ASV,P011386,PKIR,0 days 00:03:23,-2,5,7
251,ASV,P000229,PKIR,0 days 00:03:23,-2,5,7
251,ASV,P005094,P012731,0 days 00:02:56,-4,6,10
251,ASV,P005094,P012080,0 days 00:02:53,-2,5,7
251,ASV,P006568,P012080,0 days 00:02:45,1,6,5
251,ASV,P003526,P012080,0 days 00:02:38,-3,3,6
251,ASV,P002100,P006568,0 days 00:02:20,-1,2,3
251,ASV,P000229,P002100,0 days 00:02:04,-2,6,8
251,ASV,P000229,P012080,0 days 00:01:57,0,4,4
251,ASV,P011386,P012080,0 days 00:01:57,0,4,4
251,ASV,P003526,P012731,0 days 00:01:31,0,4,4
251,ASV,P005094,PKIR,0 days 00:01:24,-1,3,4
252,BAS,P004761,P009048,0 days 00:24:23,22,57,35
252,BAS,P007230,P009048,0 days 00:22:21,11,52,41
252,BAS,P004603,P009048,0 days 00:19:16,4,42,38
252,BAS,P004603,P007230,0 days 00:17:52,9,42,33
252,BAS,P004761,P007230,0 days 00:17:34,20,43,23
252,BAS,P009048,P012201,0 days 00:16:36,3,37,34
252,BAS,P009048,P011948,0 days 00:16:22,9,35,26
252,BAS,P004603,P004761,0 days 00:14:26,11,34,23
252,BAS,P010444,P012201,0 days 00:14:25,16,36,20
252,BAS,P004761,P011948,0 days 00:13:15,14,31,17
252,BAS,P010444,P011948,0 days 00:12:24,2,26,24
252,BAS,P004761,P010444,0 days 00:12:01,14,28,14
252,BAS,P009048,P010444,0 days 00:11:34,10,27,17
252,BAS,P007230,P011948,0 days 00:11:28,-2,23,25
252,BAS,P011948,P012201,0 days 00:11:23,6,23,17
252,BAS,P004761,P012201,0 days 00:11:17,10,27,17
252,BAS,P007230,P011085,0 days 00:09:45,9,23,14
252,BAS,P004761,P011085,0 days 00:09:00,9,21,12
252,BAS,P007230,P010444,0 days 00:08:22,0,18,18
252,BAS,P007946,P010444,0 days 00:08:18,1,17,16
252,BAS,P007230,P012201,0 days 00:08:09,0,20,20
252,BAS,P008850,P012201,0 days 00:08:06,-3,17,20
252,BAS,P004603,P011948,0 days 00:08:04,4,16,12
252,BAS,P010444,P011085,0 days 00:07:42,4,14,10
252,BAS,P004603,P012201,0 days 00:07:30,-8,12,20
252,BAS,P009048,P011085,0 days 00:07:20,8,18,10
252,BAS,P007946,P011085,0 days 00:07:18,4,14,10
252,BAS,P004603,P011085,0 days 00:06:56,8,18,10
252,BAS,P004603,P008850,0 days 00:05:36,-6,10,16
252,BAS,P007230,P008850,0 days 00:05:32,-9,11,20
252,BAS,P008850,P009048,0 days 00:05:28,-11,8,19
252,BAS,P007946,P012201,0 days 00:05:19,5,11,6
252,BAS,P011085,P012201,0 days 00:04:55,3,9,6
252,BAS,P007946,P008850,0 days 00:04:50,2,12,10
252,BAS,P008850,P010444,0 days 00:04:42,-3,10,13
252,BAS,P007946,P011948,0 days 00:04:06,-3,7,10
252,BAS,P007230,P007946,0 days 00:03:53,-2,8,10
252,BAS,P008850,P011085,0 days 00:02:58,3,7,4
252,BAS,P011085,P011948,0 days 00:02:38,0,4,4
252,BAS,P008850,P011948,0 days 00:02:12,-6,3,9
252,BAS,P004761,P007946,0 days 00:02:04,3,5,2
252,BAS,P004761,P008850,0 days 00:01:48,-3,2,5
252,BAS,P004603,P007946,0 days 00:00:52,2,2,0
252,BER,P008780,P008967,0 days 00:17:49,-4,37,41
252,BER,P006919,P010791,0 days 00:17:34,7,38,31
252,BER,P006919,P008780,0 days 00:16:25,3,39,36
252,BER,P006919,P012720,0 days 00:14:33,3,29,26
252,BER,P008780,P010791,0 days 00:14:11,7,33,26
252,BER,P008780,P012720,0 days 00:14:05,0,30,30
252,BER,P008211,P008967,0 days 00:14:03,-2,31,33
252,BER,P008967,P010791,0 days 00:13:59,17,41,24
252,BER,P010791,P012720,0 days 00:13:48,1,28,27
252,BER,P006919,P008967,0 days 00:13:42,4,34,30
252,BER,P007025,P012720,0 days 00:12:43,-14,12,26
252,BER,P006919,P008211,0 days 00:11:37,-5,19,24
252,BER,P007025,P007550,0 days 00:10:35,-14,9,23
252,BER,P008211,P010791,0 days 00:10:20,4,26,22
252,BER,P007025,P010791,0 days 00:10:09,-12,13,25
252,BER,P007550,P010791,0 days 00:09:57,-2,21,23
252,BER,P006919,P007025,0 days 00:09:54,-4,12,16
252,BER,P008211,P008780,0 days 00:09:43,-9,15,24
252,BER,P008780,P011934,0 days 00:09:37,-16,12,28
252,BER,P007550,P008211,0 days 00:09:28,1,22,21
252,BER,P008211,P011934,0 days 00:08:51,-12,11,23
252,BER,P006251,P011934,0 days 00:08:33,-14,8,22
252,BER,P006919,P007550,0 days 00:08:28,-4,8,12
252,BER,P011934,P012720,0 days 00:08:18,-11,7,18
252,BER,P008967,P011934,0 days 00:08:10,-14,12,26
252,BER,P008967,P012720,0 days 00:08:06,5,22,17
252,BER,P007550,P012720,0 days 00:08:01,-10,5,15
252,BER,P006251,P012720,0 days 00:07:33,-13,6,19
252,BER,P006251,P008780,0 days 00:07:23,-12,6,18
252,BER,P006919,P011934,0 days 00:07:19,-8,9,17
252,BER,P007025,P011934,0 days 00:06:25,-7,4,11
252,BER,P007550,P011934,0 days 00:06:15,-6,5,11
252,BER,P007025,P008780,0 days 00:05:59,-5,8,13
252,BER,P007550,P011631,0 days 00:05:21,1,16,15
252,BER,P008211,P011631,0 days 00:05:21,1,16,15
252,BER,P010791,P011631,0 days 00:05:21,1,16,15
252,BER,P006251,P008967,0 days 00:05:03,-7,6,13
252,BER,P006251,P007025,0 days 00:04:43,-10,2,12
252,BER,P007550,P008967,0 days 00:04:20,7,16,9
252,BER,P007025,P008211,0 days 00:03:51,-5,5,10
252,BER,P008967,P011631,0 days 00:03:24,6,13,7
252,BER,P006251,P007550,0 days 00:02:23,-5,2,7
252,BER,P006251,P008211,0 days 00:02:13,-4,2,6
252,BER,P007025,P011631,0 days 00:01:57,-5,3,8
252,BER,P008211,P012720,0 days 00:01:17,-1,1,2
252,BER,P006251,P010791,0 days 00:01:13,-3,0,3
253,BER,P008211,P012720,0 days 00:20:54,-10,41,51
253,BER,P008967,P012720,0 days 00:18:28,-3,38,41
253,BER,P003958,P012720,0 days 00:17:47,-3,37,40
253,BER,P008211,P011934,0 days 00:17:44,-1,39,40
253,BER,P011934,P012720,0 days 00:17:06,-9,34,43
253,BER,P008211,P008967,0 days 00:15:38,1,31,30
253,BER,P008967,P011934,0 days 00:14:46,-9,25,34
253,BER,P006251,P008211,0 days 00:13:54,-4,29,33
253,BER,P003958,P008967,0 days 00:13:44,-1,30,31
253,BER,P006251,P011934,0 days 00:12:56,-1,28,29
253,BER,P007550,P010791,0 days 00:12:47,8,32,24
253,BER,P003958,P010791,0 days 00:11:52,3,27,24
253,BER,P006919,P008211,0 days 00:11:49,-5,24,29
253,BER,P003958,P007550,0 days 00:11:12,-2,24,26
253,BER,P006251,P012720,0 days 00:10:58,-5,22,27
253,BER,P007025,P010791,0 days 00:10:48,-4,20,24
253,BER,P003958,P008211,0 days 00:10:46,-2,20,22
253,BER,P007550,P008967,0 days 00:10:15,0,24,24
253,BER,P008967,P010791,0 days 00:09:56,7,27,20
253,BER,P006251,P006919,0 days 00:09:39,-2,21,23
253,BER,P007025,P007550,0 days 00:09:26,4,20,16
253,BER,P006919,P007025,0 days 00:09:10,-4,17,21
253,BER,P006919,P010791,0 days 00:09:10,-4,17,21
253,BER,P010791,P012720,0 days 00:08:47,-2,20,22
253,BER,P006919,P012720,0 days 00:08:24,-6,17,23
253,BER,P006919,P008967,0 days 00:08:22,7,20,13
253,BER,P006251,P008967,0 days 00:08:16,-1,15,16
253,BER,P006919,P011934,0 days 00:08:12,1,20,19
253,BER,P006919,P007550,0 days 00:08:04,2,17,15
253,BER,P003958,P011934,0 days 00:07:35,-7,13,20
253,BER,P007550,P012720,0 days 00:07:30,-1,17,18
253,BER,P003958,P007025,0 days 00:06:47,0,13,13
253,BER,P003958,P006919,0 days 00:06:42,-1,11,12
253,BER,P008211,P010791,0 days 00:04:04,-8,5,13
253,BER,P007025,P008967,0 days 00:04:00,3,10,7
253,BER,P007025,P012720,0 days 00:03:42,-5,6,11
253,BER,P007550,P011934,0 days 00:02:47,-7,2,9
253,BER,P007025,P008211,0 days 00:02:27,-7,3,10
253,BER,P003958,P006251,0 days 00:01:27,-3,1,4
253,BER,P007025,P011934,0 days 00:00:58,1,3,2
253,BER,P006251,P007550,0 days 00:00:36,0,0,0
253,BER,P006251,P007025,0 days 00:00:07,0,0,0
253,BER,P006251,P011631,0 days 00:00:07,0,0,0
253,BER,P007025,P011631,0 days 00:00:07,0,0,0
253,BER,P007550,P011631,0 days 00:00:07,0,0,0
253,BER,P008967,P011631,0 days 00:00:07,0,0,0
253,MCO,P011196,P011212,0 days 00:19:35,16,48,32
253,MCO,P011212,P012515,0 days 00:17:34,18,43,25
253,MCO,P005985,P012515,0 days 00:16:32,5,36,31
253,MCO,P005985,P011231,0 days 00:16:01,2,35,33
253,MCO,P005985,P011212,0 days 00:15:29,-4,28,32
253,MCO,P011196,P012515,0 days 00:15:09,24,40,16
253,MCO,P005985,P010588,0 days 00:13:37,-1,29,30
253,MCO,P011196,P012709,0 days 00:13:04,13,35,22
253,MCO,P011196,P011231,0 days 00:13:02,5,31,26
253,MCO,P005985,PLCZ,0 days 00:12:53,-4,29,33
253,MCO,P005985,P008099,0 days 00:12:09,2,30,28
253,MCO,P011212,P011231,0 days 00:12:02,-7,22,29
253,MCO,P008099,PLCZ,0 days 00:11:39,0,28,28
253,MCO,P005985,P011196,0 days 00:11:35,15,29,14
253,MCO,P011212,P012709,0 days 00:10:47,8,28,20
253,MCO,P010588,PLCZ,0 days 00:10:38,-3,23,26
253,MCO,P004790,P011212,0 days 00:10:02,7,24,17
253,MCO,P008099,P010588,0 days 00:09:24,1,22,21
253,MCO,P010588,P011212,0 days 00:09:24,-4,18,22
253,MCO,P010588,P011231,0 days 00:09:07,-10,14,24
253,MCO,P004790,P011196,0 days 00:09:05,20,29,9
253,MCO,P004790,P012515,0 days 00:08:44,11,22,11
253,MCO,P004790,P012709,0 days 00:08:35,18,27,9
253,MCO,P010588,P012515,0 days 00:08:17,1,20,19
253,MCO,P010588,P011196,0 days 00:07:28,-3,14,17
253,MCO,P012515,P012709,0 days 00:06:47,13,20,7
253,MCO,P008099,P011231,0 days 00:06:40,-1,14,15
253,MCO,P004790,P005985,0 days 00:06:31,1,13,12
253,MCO,P011231,PLCZ,0 days 00:06:27,-3,12,15
253,MCO,P011231,P012709,0 days 00:06:17,0,15,15
253,MCO,P011231,P012515,0 days 00:05:49,6,14,8
253,MCO,P012515,PLCZ,0 days 00:05:44,-4,14,18
253,MCO,P004197,P005985,0 days 00:05:03,-10,8,18
253,MCO,P008099,P012515,0 days 00:04:47,0,13,13
253,MCO,P002581,P011212,0 days 00:04:45,-11,4,15
253,MCO,P002581,P005985,0 days 00:04:45,-11,4,15
253,MCO,P010588,P012709,0 days 00:04:29,-5,8,13
253,MCO,P002581,P004790,0 days 00:03:44,-6,4,10
253,MCO,P004197,P011231,0 days 00:03:16,-6,6,12
253,MCO,P002581,P004197,0 days 00:02:48,-9,2,11
253,MCO,P004197,P011212,0 days 00:02:48,-9,2,11
253,MCO,P004790,P011231,0 days 00:02:18,7,9,2
253,MCO,P005985,P012709,0 days 00:02:17,5,7,2
253,MCO,P004197,PLCZ,0 days 00:02:15,-1,6,7
253,MCO,P004197,P008099,0 days 00:02:15,-1,6,7
253,MCO,P002581,P012515,0 days 00:01:57,-2,2,4
253,MCO,P011212,PLCZ,0 days 00:01:56,-1,4,5
253,MCO,P004197,P004790,0 days 00:01:47,-4,2,6
253,MCO,P002581,P011231,0 days 00:01:01,-5,0,5
253,MCO,P008099,P011212,0 days 00:00:42,3,3,0
253,MCO,P004790,P008099,0 days 00:00:30,2,2,0
253,MCO,P008099,P011196,0 days 00:00:30,2,2,0
254,BAR,P004866,P012745,0 days 00:20:45,8,55,47
254,BAR,P002939,P006435,0 days 00:19:48,-3,40,43
254,BAR,P000925,P004866,0 days 00:18:56,8,50,42
254,BAR,P000925,P006435,0 days 00:17:38,-4,39,43
254,BAR,P000925,P002939,0 days 00:17:16,-6,40,46
254,BAR,P000925,P012745,0 days 00:17:10,7,46,39
254,BAR,P007519,PLFW,0 days 00:15:29,19,41,22
254,BAR,P002939,P004866,0 days 00:15:19,-2,39,41
254,BAR,P002939,P012745,0 days 00:15:03,-3,37,40
254,BAR,P003478,P011244,0 days 00:13:09,9,29,20
254,BAR,P006435,P011244,0 days 00:12:07,6,22,16
254,BAR,P004866,P006435,0 days 00:11:49,-4,29,33
254,BAR,P004866,P007519,0 days 00:11:47,10,30,20
254,BAR,P006435,P012745,0 days 00:11:33,-5,27,32
254,BAR,P011244,PLFW,0 days 00:11:08,9,28,19
254,BAR,P003196,P011244,0 days 00:10:22,11,23,12
254,BAR,P007519,P012745,0 days 00:10:19,14,30,16
254,BAR,P000925,P007519,0 days 00:09:57,13,27,14
254,BAR,P007519,P011244,0 days 00:09:55,9,25,16
254,BAR,P003196,P003478,0 days 00:09:53,13,23,10
254,BAR,P003478,P006435,0 days 00:09:12,1,14,13
254,BAR,P004866,PLFW,0 days 00:08:17,8,20,12
254,BAR,P002939,P011244,0 days 00:08:15,2,13,11
254,BAR,P002939,P003478,0 days 00:07:59,1,11,10
254,BAR,P003196,PLFW,0 days 00:07:47,6,20,14
254,BAR,P003196,P007519,0 days 00:07:47,6,20,14
254,BAR,P000925,P011244,0 days 00:07:46,-2,14,16
254,BAR,P000925,PLFW,0 days 00:07:40,11,20,9
254,BAR,P012745,PLFW,0 days 00:06:49,12,20,8
254,BAR,P003196,P006435,0 days 00:06:02,5,10,5
254,BAR,P002939,P003196,0 days 00:06:02,5,10,5
254,BAR,P003478,PLFW,0 days 00:05:46,7,18,11
254,BAR,P003478,P007519,0 days 00:04:33,7,15,8
254,BAR,P003196,P004866,0 days 00:03:56,-2,7,9
254,BAR,P006435,PLFW,0 days 00:03:52,4,9,5
254,BAR,P004866,P011244,0 days 00:03:35,-2,6,8
254,BAR,P002939,P007519,0 days 00:03:30,2,10,8
254,BAR,P003196,P012745,0 days 00:03:27,0,7,7
254,BAR,P000925,P003478,0 days 00:03:21,-7,4,11
254,BAR,P006435,P007519,0 days 00:02:39,4,6,2
254,BAR,P011244,P012745,0 days 00:01:15,2,4,2
254,BAR,P003478,P012745,0 days 00:01:07,1,2,1
254,PAR,P003983,P008987,0 days 00:27:33,5,62,57
254,PAR,P008987,P009862,0 days 00:20:46,-3,48,51
254,PAR,P003983,P009862,0 days 00:18:26,3,46,43
254,PAR,P008987,P011051,0 days 00:17:04,-4,30,34
254,PAR,P003983,P012743,0 days 00:15:48,2,36,34
254,PAR,P007400,P008987,0 days 00:14:51,-1,36,37
254,PAR,P003983,P011051,0 days 00:14:26,3,30,27
254,PAR,P009862,P012743,0 days 00:14:03,-2,32,34
254,PAR,P003983,P007400,0 days 00:13:04,5,32,27
254,PAR,P008987,P012743,0 days 00:12:50,4,32,28
254,PAR,P004172,P009862,0 days 00:12:26,-8,24,32
254,PAR,P007400,P011051,0 days 00:12:21,1,28,27
254,PAR,P000956,P003983,0 days 00:12:05,0,20,20
254,PAR,P000956,P008987,0 days 00:11:35,-3,20,23
254,PAR,P007400,P009862,0 days 00:11:23,-11,22,33
254,PAR,P003983,P007673,0 days 00:10:05,-2,16,18
254,PAR,P000956,P011051,0 days 00:09:55,1,16,15
254,PAR,P004172,P008987,0 days 00:09:46,-3,20,23
254,PAR,P007673,P008987,0 days 00:09:45,-7,12,19
254,PAR,P009862,P011051,0 days 00:09:41,-7,18,25
254,PAR,P004172,P012743,0 days 00:08:35,-6,18,24
254,PAR,P007673,P011051,0 days 00:07:43,-8,6,14
254,PAR,P000956,P007400,0 days 00:07:41,1,18,17
254,PAR,P003983,P004172,0 days 00:07:22,0,18,18
254,PAR,P000956,P007673,0 days 00:06:52,-6,6,12
254,PAR,P004172,P012742,0 days 00:06:37,-12,6,18
254,PAR,P007400,P012742,0 days 00:06:00,-15,8,23
254,PAR,P009862,P012742,0 days 00:05:28,-12,6,18
254,PAR,P007673,P009862,0 days 00:05:23,-2,10,12
254,PAR,P007673,P012743,0 days 00:05:00,-1,10,11
254,PAR,P007400,P012743,0 days 00:04:39,-3,8,11
254,PAR,P000956,P012096,0 days 00:04:38,-6,8,14
254,PAR,P011051,P012742,0 days 00:04:33,-7,4,11
254,PAR,P004172,P011051,0 days 00:04:33,-7,4,11
254,PAR,P004172,P007400,0 days 00:04:13,-9,4,13
254,PAR,P008987,P012742,0 days 00:04:11,-9,6,15
254,PAR,P003983,P012096,0 days 00:03:15,-4,4,8
254,PAR,P000956,P012743,0 days 00:02:58,-2,4,6
254,PAR,P007673,P012096,0 days 00:02:58,-2,4,6
254,PAR,P012096,P012743,0 days 00:02:58,-2,4,6
254,PAR,P008987,P012096,0 days 00:02:55,-7,6,13
254,PAR,P012096,P012742,0 days 00:02:38,-5,6,11
254,PAR,P007400,P012096,0 days 00:02:04,-8,4,12
254,PAR,P004172,P007673,0 days 00:01:33,-4,0,4
254,PAR,P007673,P012742,0 days 00:01:33,-4,0,4
254,PAR,P000956,P012742,0 days 00:01:23,-2,4,6
254,PAR,P009862,P012096,0 days 00:01:15,-3,2,5
254,PAR,P012742,P012743,0 days 00:01:13,-6,0,6
254,PAR,P000956,P009862,0 days 00:01:05,-3,0,3
254,PAR,P004172,P012096,0 days 00:00:51,1,2,1
255,OLY,P001255,P008811,0 days 00:21:44,0,30,30
255,OLY,P001255,P008855,0 days 00:19:12,11,40,29
255,OLY,P008811,P010612,0 days 00:19:09,-4,22,26
255,OLY,P008811,P008855,0 days 00:18:46,6,30,24
255,OLY,P001255,P010612,0 days 00:18:22,-1,22,23
255,OLY,P001255,P008829,0 days 00:18:04,6,30,24
255,OLY,P008829,P010612,0 days 00:16:45,4,22,18
255,OLY,P008811,P008829,0 days 00:16:45,4,22,18
255,OLY,P008829,P008855,0 days 00:15:28,6,27,21
255,OLY,P007853,P011194,0 days 00:15:13,0,28,28
255,OLY,P008855,P010612,0 days 00:13:28,4,19,15
255,OLY,P011194,P012878,0 days 00:13:24,6,30,24
255,OLY,P007853,P012878,0 days 00:13:20,2,25,23
255,OLY,P007982,P008829,0 days 00:13:08,0,26,26
255,OLY,P007982,P011194,0 days 00:13:03,-5,22,27
255,OLY,P007853,P007982,0 days 00:12:16,0,22,22
255,OLY,P007982,P012878,0 days 00:10:52,4,27,23
255,OLY,P008855,P011194,0 days 00:10:51,10,26,16
255,OLY,P008829,P012878,0 days 00:09:51,0,23,23
255,OLY,P007853,P008829,0 days 00:08:32,-2,15,17
255,OLY,P008829,P011194,0 days 00:07:51,-2,15,17
255,OLY,P008811,P011194,0 days 00:07:42,-6,11,17
255,OLY,P008855,P012878,0 days 00:07:42,10,23,13
255,OLY,P007982,P008811,0 days 00:07:37,-7,6,13
255,OLY,P007853,P008855,0 days 00:07:25,5,13,8
255,OLY,P001255,P007982,0 days 00:06:22,-3,11,14
255,OLY,P001255,P011194,0 days 00:05:53,0,13,13
255,OLY,P011194,P011965,0 days 00:05:49,4,11,7
255,OLY,P008855,P011965,0 days 00:05:49,4,11,7
255,OLY,P007982,P010612,0 days 00:05:41,-8,3,11
255,OLY,P007982,P008855,0 days 00:04:57,7,15,8
255,OLY,P011965,P012878,0 days 00:04:41,4,11,7
255,OLY,P007853,P011965,0 days 00:03:47,0,6,6
255,OLY,P007853,P008811,0 days 00:02:43,-2,3,5
255,OLY,P010612,P011194,0 days 00:02:24,-8,0,8
255,OLY,P001255,P012878,0 days 00:02:22,6,13,7
255,OLY,P001255,P011983,0 days 00:02:14,1,8,7
255,OLY,P011194,P011983,0 days 00:02:14,1,8,7
255,OLY,P008855,P011983,0 days 00:02:14,1,8,7
255,OLY,P008811,P011983,0 days 00:02:14,1,8,7
255,OLY,P001255,P011965,0 days 00:02:02,4,5,1
255,OLY,P008811,P011965,0 days 00:01:08,0,0,0
255,OLY,P007853,P010612,0 days 00:00:47,-3,0,3
255,OLY,P001255,P007853,0 days 00:00:09,0,0,0
255,PAN,P007866,P012774,0 days 00:29:54,-2,48,50
255,PAN,P011204,P012774,0 days 00:29:03,5,53,48
255,PAN,P003842,P012774,0 days 00:28:47,-10,43,53
255,PAN,P007866,P011204,0 days 00:27:58,5,53,48
255,PAN,P003842,P007866,0 days 00:27:24,-5,39,44
255,PAN,P003842,P011204,0 days 00:25:26,1,41,40
255,PAN,P001926,P007866,0 days 00:18:13,-3,35,38
255,PAN,P001926,P003842,0 days 00:18:04,-5,25,30
255,PAN,P002328,P007866,0 days 00:17:00,-4,25,29
255,PAN,P001926,P012774,0 days 00:14:25,-7,25,32
255,PAN,P003842,P005161,0 days 00:13:30,-1,21,22
255,PAN,P001926,P011204,0 days 00:13:18,3,30,27
255,PAN,P002328,P012774,0 days 00:12:50,-7,15,22
255,PAN,P002328,P011204,0 days 00:12:28,-1,22,23
255,PAN,P002328,P003842,0 days 00:10:20,-10,6,16
255,PAN,P005161,P012774,0 days 00:09:33,-2,18,20
255,PAN,P005161,P007866,0 days 00:09:08,-1,14,15
255,PAN,P011204,P012712,0 days 00:09:03,-4,16,20
255,PAN,P005161,P011204,0 days 00:08:48,2,16,14
255,PAN,P001926,P002328,0 days 00:07:40,-8,13,21
255,PAN,P003842,P012712,0 days 00:07:25,-6,9,15
255,PAN,P001926,P005161,0 days 00:06:07,-3,5,8
255,PAN,P012712,P012774,0 days 00:06:00,-6,9,15
255,PAN,P007553,P011204,0 days 00:04:44,5,9,4
255,PAN,P007553,P012774,0 days 00:04:44,5,9,4
255,PAN,P007553,P007866,0 days 00:04:44,5,9,4
255,PAN,P002328,P007553,0 days 00:04:44,5,9,4
255,PAN,P001926,P012712,0 days 00:04:37,-5,7,12
255,PAN,P005161,P012712,0 days 00:04:22,0,7,7
255,PAN,P007866,P012712,0 days 00:04:19,-3,9,12
255,PAN,P002328,P012712,0 days 00:02:50,-4,7,11
255,PAN,P002328,P005161,0 days 00:02:32,1,3,2
256,BAS,P004761,P007230,0 days 00:26:44,15,55,40
256,BAS,P004761,P009048,0 days 00:21:44,11,51,40
256,BAS,P007230,P009048,0 days 00:20:50,12,49,37
256,BAS,P004603,P004761,0 days 00:19:59,8,42,34
256,BAS,P004603,P007230,0 days 00:19:59,8,42,34
256,BAS,P004603,P009048,0 days 00:16:57,6,37,31
256,BAS,P009048,P011948,0 days 00:15:17,-3,36,39
256,BAS,P004761,P012201,0 days 00:14:50,10,32,22
256,BAS,P007230,P011948,0 days 00:14:47,3,31,28
256,BAS,P004761,P011948,0 days 00:14:34,2,28,26
256,BAS,P010444,P011948,0 days 00:13:08,10,34,24
256,BAS,P010444,P012201,0 days 00:12:52,0,30,30
256,BAS,P007230,P012201,0 days 00:12:31,14,30,16
256,BAS,P009048,P012201,0 days 00:12:06,12,35,23
256,BAS,P007946,P012201,0 days 00:11:52,1,21,20
256,BAS,P004603,P011948,0 days 00:11:41,-5,22,27
256,BAS,P003198,P010444,0 days 00:11:31,-1,27,28
256,BAS,P004603,P012201,0 days 00:11:06,13,26,13
256,BAS,P003198,P012201,0 days 00:10:58,-1,26,27
256,BAS,P007946,P010444,0 days 00:10:02,3,17,14
256,BAS,P004761,P010444,0 days 00:09:46,4,18,14
256,BAS,P011948,P012201,0 days 00:09:37,3,24,21
256,BAS,P003198,P011948,0 days 00:09:33,2,25,23
256,BAS,P007946,P011948,0 days 00:09:32,8,20,12
256,BAS,P009048,P010444,0 days 00:08:35,4,26,22
256,BAS,P004761,P007946,0 days 00:08:01,1,9,8
256,BAS,P007230,P010444,0 days 00:07:27,8,16,8
256,BAS,P003198,P007946,0 days 00:07:23,1,16,15
256,BAS,P007230,P007946,0 days 00:06:36,4,9,5
256,BAS,P003198,P009048,0 days 00:05:32,-2,14,16
256,BAS,P004603,P007946,0 days 00:04:26,2,8,6
256,BAS,P003198,P004761,0 days 00:03:22,-3,5,8
256,BAS,P003198,P004603,0 days 00:01:24,0,3,3
256,BAS,P003198,P008850,0 days 00:01:07,0,4,4
256,BAS,P008850,P009048,0 days 00:01:07,0,4,4
256,BAS,P008850,P010444,0 days 00:01:07,0,4,4
256,BAS,P008850,P011948,0 days 00:01:07,0,4,4
256,BAS,P003198,P007230,0 days 00:00:50,0,0,0
256,MIL,P000796,P007831,0 days 00:25:52,-1,51,52
256,MIL,P002849,P007831,0 days 00:24:43,-8,41,49
256,MIL,P007831,P011224,0 days 00:24:43,-12,37,49
256,MIL,P000796,P002849,0 days 00:22:54,-1,43,44
256,MIL,P002849,P011224,0 days 00:22:33,-9,37,46
256,MIL,P000796,P011205,0 days 00:20:57,3,42,39
256,MIL,P000796,P011224,0 days 00:20:13,-2,38,40
256,MIL,P007831,P011205,0 days 00:18:13,-1,32,33
256,MIL,P002849,P011205,0 days 00:15:28,-4,24,28
256,MIL,P000796,P007201,0 days 00:14:53,-5,33,38
256,MIL,P007201,P007831,0 days 00:14:32,-15,23,38
256,MIL,P007201,P011205,0 days 00:14:28,-8,34,42
256,MIL,P011205,P011224,0 days 00:12:47,-5,19,24
256,MIL,P002849,P007201,0 days 00:10:45,-10,17,27
256,MIL,P005670,P007201,0 days 00:10:36,-1,28,29
256,MIL,P007201,P011224,0 days 00:10:27,-17,12,29
256,MIL,P005670,P011205,0 days 00:08:34,5,28,23
256,MIL,P000796,P005670,0 days 00:06:55,0,19,19
256,MIL,P002812,P007831,0 days 00:05:36,-7,3,10
256,MIL,P002812,P006509,0 days 00:04:59,-8,3,11
256,MIL,P006509,P007201,0 days 00:04:46,0,11,11
256,MIL,P005670,P007831,0 days 00:04:43,-7,9,16
256,MIL,P002812,P007201,0 days 00:04:40,-11,2,13
256,MIL,P000796,P007032,0 days 00:04:26,2,11,9
256,MIL,P006509,P011205,0 days 00:04:25,0,11,11
256,MIL,P002812,P011224,0 days 00:04:15,-9,1,10
256,MIL,P002812,P007032,0 days 00:04:07,-3,4,7
256,MIL,P006721,P011205,0 days 00:04:03,7,14,7
256,MIL,P005670,P006721,0 days 00:04:03,7,14,7
256,MIL,P006721,P007201,0 days 00:04:03,7,14,7
256,MIL,P007032,P007831,0 days 00:03:57,2,11,9
256,MIL,P007032,P011205,0 days 00:03:51,-6,4,10
256,MIL,P002812,P011205,0 days 00:03:38,-3,4,7
256,MIL,P007032,P011224,0 days 00:02:49,-3,9,12
256,MIL,P002849,P007032,0 days 00:02:49,-3,9,12
256,MIL,P005670,P011224,0 days 00:02:48,-8,2,10
256,MIL,P006509,P007032,0 days 00:02:46,-5,2,7
256,MIL,P005670,P006509,0 days 00:02:37,5,9,4
256,MIL,P002812,P005670,0 days 00:02:31,-6,0,6
256,MIL,P007032,P007201,0 days 00:02:30,-8,2,10
256,MIL,P006509,P007831,0 days 00:02:13,-3,1,4
256,MIL,P006509,P011224,0 days 00:02:13,-3,1,4
256,MIL,P006509,P006721,0 days 00:02:08,5,9,4
256,MIL,P000796,P006721,0 days 00:01:55,2,5,3
256,MIL,P002812,P002849,0 days 00:01:52,-3,1,4
256,MIL,P002849,P006509,0 days 00:01:52,-3,1,4
256,MIL,P000796,P002812,0 days 00:01:50,2,2,0
256,MIL,P002849,P005670,0 days 00:01:04,1,3,2
256,MIL,P000796,P006509,0 days 00:00:29,0,0,0
256,MIL,P005670,P007032,0 days 00:00:29,0,0,0
257,RED,P006436,P012044,0 days 00:24:37,-11,42,53
257,RED,P009035,P012801,0 days 00:24:34,-4,50,54
257,RED,P012044,P012801,0 days 00:23:58,-13,41,54
257,RED,P009035,P012044,0 days 00:23:08,-7,43,50
257,RED,P006436,P009035,0 days 00:22:42,-4,45,49
257,RED,P006436,P012801,0 days 00:22:28,-11,39,50
257,RED,P002553,P006436,0 days 00:17:05,-5,27,32
257,RED,P002553,P012044,0 days 00:16:44,-5,27,32
257,RED,P002553,P009035,0 days 00:16:07,-5,27,32
257,RED,P007960,P012801,0 days 00:15:20,5,39,34
257,RED,P002553,P012801,0 days 00:15:16,-8,20,28
257,RED,P005099,P007960,0 days 00:13:17,4,35,31
257,RED,P007960,P012044,0 days 00:12:02,-9,25,34
257,RED,P005099,P012801,0 days 00:11:16,8,30,22
257,RED,P005099,P009035,0 days 00:11:01,7,32,25
257,RED,P007960,P009035,0 days 00:10:23,2,27,25
257,RED,P005099,P012044,0 days 00:09:47,-3,23,26
257,RED,P007960,P011941,0 days 00:08:31,0,19,19
257,RED,P011941,P012801,0 days 00:08:15,2,14,12
257,RED,P011941,P012044,0 days 00:07:56,-7,14,21
257,RED,P006436,P007960,0 days 00:07:56,-5,20,25
257,RED,P005099,P011941,0 days 00:07:16,1,14,13
257,RED,P005099,P006436,0 days 00:07:12,2,23,21
257,RED,P008966,P011941,0 days 00:05:32,3,12,9
257,RED,P007960,P008966,0 days 00:05:19,5,14,9
257,RED,P002553,P005099,0 days 00:05:05,3,11,8
257,RED,P006436,P011941,0 days 00:04:32,-5,7,12
257,RED,P008966,P012801,0 days 00:04:12,3,11,8
257,RED,P008966,P012044,0 days 00:04:12,-1,8,9
257,RED,P005099,P008966,0 days 00:03:48,4,9,5
257,RED,P011964,P012801,0 days 00:03:35,7,10,3
257,RED,P009035,P011964,0 days 00:03:35,7,10,3
257,RED,P004720,P011941,0 days 00:02:58,-2,2,4
257,RED,P004720,P005099,0 days 00:02:42,-3,2,5
257,RED,P004720,P012801,0 days 00:02:42,-1,2,3
257,RED,P002553,P011941,0 days 00:02:36,0,2,2
257,RED,P007960,P011964,0 days 00:02:04,5,5,0
257,RED,P005099,P011964,0 days 00:02:04,5,5,0
257,RED,P002553,P004720,0 days 00:01:59,0,2,2
257,RED,P006436,P011964,0 days 00:01:31,2,5,3
257,RED,P011964,P012044,0 days 00:01:31,2,5,3
257,RED,P004720,P007960,0 days 00:01:04,-3,0,3
257,RED,P006436,P008966,0 days 00:00:47,-2,0,2
257,RED,P008966,P009035,0 days 00:00:34,0,2,2
257,RED,P004720,P006436,0 days 00:00:26,-1,0,1
257,RED,P004720,P012044,0 days 00:00:21,-2,0,2
257,TEL,P009622,P009783,0 days 00:26:35,8,58,50
257,TEL,P009622,P011199,0 days 00:26:27,9,60,51
257,TEL,P009783,P009863,0 days 00:26:13,4,60,56
257,TEL,P009783,P011199,0 days 00:26:13,8,59,51
257,TEL,P009622,P009863,0 days 00:25:37,12,60,48
257,TEL,P009863,P011199,0 days 00:23:48,10,59,49
257,TEL,P009863,P012744,0 days 00:18:01,11,42,31
257,TEL,P009622,P012744,0 days 00:15:28,9,36,27
257,TEL,P011199,P012744,0 days 00:13:07,7,32,25
257,TEL,P007990,P009783,0 days 00:12:24,-3,28,31
257,TEL,P007990,P011199,0 days 00:12:00,0,29,29
257,TEL,P009783,P012744,0 days 00:10:56,8,26,18
257,TEL,P007990,P009622,0 days 00:10:31,-1,24,25
257,TEL,P009863,P011214,0 days 00:10:04,-3,17,20
257,TEL,P007990,P009863,0 days 00:09:50,-6,23,29
257,TEL,P005145,P009783,0 days 00:09:46,-2,17,19
257,TEL,P005145,P009863,0 days 00:09:46,-2,17,19
257,TEL,P005145,P011199,0 days 00:08:47,-3,15,18
257,TEL,P009863,P011971,0 days 00:08:05,3,17,14
257,TEL,P009622,P011214,0 days 00:07:52,-5,10,15
257,TEL,P009783,P011214,0 days 00:07:50,-8,11,19
257,TEL,P005145,P009622,0 days 00:06:54,-1,11,12
257,TEL,P011971,P012744,0 days 00:06:21,1,13,12
257,TEL,P011214,P011971,0 days 00:06:17,-1,11,12
257,TEL,P009622,P011971,0 days 00:06:08,9,13,4
257,TEL,P011214,P012744,0 days 00:05:46,0,10,10
257,TEL,P011193,P011971,0 days 00:05:32,-5,9,14
257,TEL,P011199,P011971,0 days 00:05:16,6,12,6
257,TEL,P007990,P011214,0 days 00:05:12,-10,4,14
257,TEL,P009783,P011971,0 days 00:04:36,4,10,6
257,TEL,P011193,P012744,0 days 00:04:17,-6,6,12
257,TEL,P011193,P011214,0 days 00:04:12,-1,9,10
257,TEL,P009863,P011193,0 days 00:04:12,-1,9,10
257,TEL,P007990,P011971,0 days 00:03:57,3,7,4
257,TEL,P005145,P007990,0 days 00:02:54,-1,6,7
257,TEL,P011199,P011214,0 days 00:02:38,-5,2,7
257,TEL,P007990,P012744,0 days 00:01:36,-2,3,5
257,TEL,P009622,P011193,0 days 00:01:20,-4,0,4
257,TEL,P011193,P011199,0 days 00:01:20,-4,0,4
257,TEL,P009783,P011193,0 days 00:01:15,1,3,2
257,TEL,P005145,P011214,0 days 00:00:57,1,2,1
258,ULK,P001932,P008962,0 days 00:17:47,18,51,33
258,ULK,P006068,P008962,0 days 00:17:11,9,43,34
258,ULK,P001932,P009849,0 days 00:16:12,12,44,32
258,ULK,P008962,P009849,0 days 00:16:03,17,45,28
258,ULK,P001932,P006068,0 days 00:15:33,14,41,27
258,ULK,P006068,P009849,0 days 00:14:28,16,39,23
258,ULK,P004004,P011157,0 days 00:13:48,10,41,31
258,ULK,P006661,P011157,0 days 00:13:45,6,34,28
258,ULK,P006961,P011980,0 days 00:12:32,12,43,31
258,ULK,P006661,P006961,0 days 00:12:26,14,38,24
258,ULK,P008962,P011157,0 days 00:10:53,1,27,26
258,ULK,P004004,P006661,0 days 00:10:45,10,32,22
258,ULK,P006661,P011980,0 days 00:10:36,6,30,24
258,ULK,P011052,P011980,0 days 00:10:00,6,33,27
258,ULK,P006661,P008962,0 days 00:09:19,7,28,21
258,ULK,P004004,P008962,0 days 00:09:18,0,24,24
258,ULK,P006961,P011157,0 days 00:09:17,14,29,15
258,ULK,P001932,P002968,0 days 00:09:15,8,23,15
258,ULK,P002968,P009849,0 days 00:09:15,8,23,15
258,ULK,P002968,P008962,0 days 00:09:15,8,23,15
258,ULK,P002968,P006068,0 days 00:09:15,8,23,15
258,ULK,P005844,P011980,0 days 00:08:59,6,33,27
258,ULK,P005844,P009849,0 days 00:08:54,14,37,23
258,ULK,P005844,P011052,0 days 00:08:31,6,31,25
258,ULK,P006961,P011052,0 days 00:08:02,2,26,24
258,ULK,P004004,P006961,0 days 00:07:48,14,27,13
258,ULK,P011157,P011980,0 days 00:06:59,6,19,13
258,ULK,P009849,P011980,0 days 00:06:50,2,24,22
258,ULK,P005844,P006961,0 days 00:06:33,2,24,22
258,ULK,P006068,P011157,0 days 00:05:45,-2,14,16
258,ULK,P001932,P011157,0 days 00:05:38,-3,12,15
258,ULK,P009849,P011052,0 days 00:05:22,6,22,16
258,ULK,P005844,P006661,0 days 00:05:20,6,21,15
258,ULK,P006661,P009849,0 days 00:05:20,4,18,14
258,ULK,P006661,P011052,0 days 00:04:38,0,11,11
258,ULK,P001932,P006661,0 days 00:04:32,3,15,12
258,ULK,P004004,P011980,0 days 00:04:30,10,17,7
258,ULK,P004004,P006068,0 days 00:04:10,-3,11,14
258,ULK,P009849,P011157,0 days 00:03:54,-4,6,10
258,ULK,P001932,P005844,0 days 00:03:32,8,15,7
258,ULK,P006961,P009849,0 days 00:03:24,2,15,13
258,ULK,P005844,P006068,0 days 00:03:19,6,10,4
258,ULK,P006961,P008962,0 days 00:03:18,4,10,6
258,ULK,P005844,P008962,0 days 00:03:04,8,13,5
258,ULK,P001932,P004004,0 days 00:03:03,0,9,9
258,ULK,P006068,P006661,0 days 00:02:59,-4,5,9
258,ULK,P006068,P011980,0 days 00:01:58,4,7,3
258,ULK,P006068,P011052,0 days 00:01:58,4,7,3
258,ULK,P004004,P009849,0 days 00:01:50,-1,3,4
258,ULK,P011052,P011157,0 days 00:01:29,0,2,2
258,ULK,P001932,P011980,0 days 00:01:28,-4,2,6
258,PAM,P003960,P007870,0 days 00:19:50,-13,38,51
258,PAM,P010393,P011970,0 days 00:17:34,-15,42,57
258,PAM,P006433,P007870,0 days 00:16:35,-15,29,44
258,PAM,P003960,P010568,0 days 00:16:16,-13,28,41
258,PAM,P007870,P010568,0 days 00:16:16,-13,28,41
258,PAM,P003960,P006433,0 days 00:16:05,-13,29,42
258,PAM,P011970,P012738,0 days 00:15:03,-13,36,49
258,PAM,P010393,P012738,0 days 00:15:03,-13,36,49
258,PAM,P006433,P010568,0 days 00:14:12,-9,25,34
258,PAM,P007870,P012795,0 days 00:13:23,-12,29,41
258,PAM,P007870,P011982,0 days 00:11:55,-3,26,29
258,PAM,P004863,P010393,0 days 00:11:09,-9,25,34
258,PAM,P003960,P011982,0 days 00:10:30,-2,20,22
258,PAM,P006433,P011982,0 days 00:10:19,-4,18,22
258,PAM,P010393,P012795,0 days 00:10:03,-1,27,28
258,PAM,P003960,P012795,0 days 00:09:45,-11,18,29
258,PAM,P004863,P011970,0 days 00:09:44,-9,19,28
258,PAM,P010568,P011982,0 days 00:09:24,-2,18,20
258,PAM,P006643,P010393,0 days 00:08:31,-6,25,31
258,PAM,P006643,P011970,0 days 00:08:31,-6,25,31
258,PAM,P006643,P012738,0 days 00:08:31,-6,25,31
258,PAM,P005356,P010393,0 days 00:08:02,-10,21,31
258,PAM,P011970,P012795,0 days 00:07:27,1,19,18
258,PAM,P004863,P012795,0 days 00:07:24,5,22,17
258,PAM,P005356,P007870,0 days 00:07:12,-8,16,24
258,PAM,P006433,P012795,0 days 00:07:11,-13,11,24
258,PAM,P010568,P012795,0 days 00:06:52,-11,10,21
258,PAM,P005356,P011970,0 days 00:06:51,-9,19,28
258,PAM,P004863,P012738,0 days 00:06:32,-7,11,18
258,PAM,P012738,P012795,0 days 00:06:25,0,16,16
258,PAM,P004863,P007870,0 days 00:06:18,2,20,18
258,PAM,P005356,P012795,0 days 00:05:43,-5,13,18
258,PAM,P005356,P012738,0 days 00:05:22,-6,16,22
258,PAM,P005356,P006643,0 days 00:05:22,-6,16,22
258,PAM,P007870,P010393,0 days 00:05:07,-4,14,18
258,PAM,P004863,P011982,0 days 00:04:52,-6,12,18
258,PAM,P010393,P011982,0 days 00:04:41,-8,10,18
258,PAM,P003960,P005356,0 days 00:04:32,-4,11,15
258,PAM,P011970,P011982,0 days 00:03:57,-7,6,13
258,PAM,P004863,P005356,0 days 00:03:40,0,9,9
258,PAM,P011982,P012738,0 days 00:03:16,-7,4,11
258,PAM,P007870,P011970,0 days 00:03:12,-2,8,10
258,PAM,P006643,P012795,0 days 00:03:09,0,9,9
258,PAM,P005356,P010568,0 days 00:02:04,-4,3,7
258,PAM,P011982,P012795,0 days 00:01:50,-1,6,7
258,PAM,P003960,P004863,0 days 00:01:41,4,6,2
258,PAM,P005356,P006433,0 days 00:01:28,-4,4,8
258,PAM,P003960,P011970,0 days 00:00:41,0,2,2
258,PAM,P006433,P010393,0 days 00:00:30,-2,0,2
259,VIR,P001133,P009549,0 days 00:19:32,-11,28,39
259,VIR,P009549,PBCN,0 days 00:19:26,-9,29,38
259,VIR,P008847,P010781,0 days 00:18:55,-4,40,44
259,VIR,P001133,P006739,0 days 00:18:01,-17,24,41
259,VIR,P004554,P006739,0 days 00:17:52,-9,26,35
259,VIR,P004554,P009549,0 days 00:17:22,-4,28,32
259,VIR,P001133,P004554,0 days 00:16:56,-9,24,33
259,VIR,P001133,PBCN,0 days 00:15:54,-11,20,31
259,VIR,P006739,P009549,0 days 00:15:45,-3,24,27
259,VIR,P004554,PBCN,0 days 00:13:03,-5,18,23
259,VIR,P006739,PBCN,0 days 00:12:09,-9,14,23
259,VIR,P004007,P010781,0 days 00:11:38,-8,24,32
259,VIR,P009549,P010781,0 days 00:11:35,-5,21,26
259,VIR,P004007,P008847,0 days 00:10:16,-7,20,27
259,VIR,P010781,PBCN,0 days 00:09:54,2,24,22
259,VIR,P004007,P006739,0 days 00:09:31,-5,22,27
259,VIR,P008847,P009549,0 days 00:08:58,-3,15,18
259,VIR,P002084,P010781,0 days 00:08:14,5,23,18
259,VIR,P008847,PBCN,0 days 00:08:03,3,20,17
259,VIR,P001133,P010781,0 days 00:07:36,-8,14,22
259,VIR,P002084,P008847,0 days 00:07:18,3,19,16
259,VIR,P003048,P010781,0 days 00:06:52,-1,15,16
259,VIR,P003527,P004554,0 days 00:06:09,-3,12,15
259,VIR,P001133,P004007,0 days 00:05:58,-12,10,22
259,VIR,P004007,P004554,0 days 00:05:52,-7,8,15
259,VIR,P003527,P006739,0 days 00:05:43,0,12,12
259,VIR,P005553,P010781,0 days 00:05:35,2,13,11
259,VIR,P003048,P005553,0 days 00:05:35,2,13,11
259,VIR,P003048,P008847,0 days 00:05:35,2,13,11
259,VIR,P005553,P008847,0 days 00:05:35,2,13,11
259,VIR,P006739,P010781,0 days 00:05:34,-3,14,17
259,VIR,P004007,P009549,0 days 00:05:32,-1,12,13
259,VIR,P001133,P008847,0 days 00:05:09,-7,8,15
259,VIR,P003527,P004007,0 days 00:04:59,-5,8,13
259,VIR,P006739,P008847,0 days 00:04:58,-3,12,15
259,VIR,P002084,P004007,0 days 00:04:42,3,14,11
259,VIR,P002084,P006739,0 days 00:04:11,1,12,11
259,VIR,P002084,P009549,0 days 00:04:03,4,11,7
259,VIR,P001133,P003527,0 days 00:03:53,-4,6,10
259,VIR,P003048,PBCN,0 days 00:03:34,-3,9,12
259,VIR,P002084,PBCN,0 days 00:03:32,2,9,7
259,VIR,P003527,P009549,0 days 00:03:26,3,10,7
259,VIR,P003048,P004007,0 days 00:03:18,2,6,4
259,VIR,P004007,P005553,0 days 00:02:58,0,4,4
259,VIR,P005553,PBCN,0 days 00:02:37,2,9,7
259,VIR,P004554,P010781,0 days 00:02:13,-1,4,5
259,VIR,P003048,P009549,0 days 00:01:17,-3,2,5
259,VIR,P001133,P003048,0 days 00:00:57,-5,0,5
259,VIR,P004554,P008847,0 days 00:00:53,-2,0,2
259,VIR,P001133,P002084,0 days 00:00:36,0,2,2
259,VIR,P003527,P010781,0 days 00:00:26,-3,0,3
259,VIR,P002084,P003048,0 days 00:00:20,2,2,0
259,MAD,P005791,P010357,0 days 00:21:35,12,45,33
259,MAD,P005928,P010357,0 days 00:21:07,15,47,32
259,MAD,P006540,P010357,0 days 00:19:39,11,42,31
259,MAD,P005791,P006540,0 days 00:19:27,11,42,31
259,MAD,P005791,P005928,0 days 00:17:04,9,33,24
259,MAD,P003733,P005791,0 days 00:17:03,10,33,23
259,MAD,P009005,PTGB,0 days 00:16:56,6,40,34
259,MAD,P003108,P009005,0 days 00:16:34,1,38,37
259,MAD,P005928,P006540,0 days 00:16:15,6,30,24
259,MAD,P003733,P010357,0 days 00:16:04,11,31,20
259,MAD,P003733,P005928,0 days 00:15:54,11,31,20
259,MAD,P003733,P006540,0 days 00:14:37,8,28,20
259,MAD,P003108,PTGB,0 days 00:14:21,-4,30,34
259,MAD,P004887,P009005,0 days 00:13:59,7,35,28
259,MAD,P003108,P004887,0 days 00:13:14,5,33,28
259,MAD,P004887,PTGB,0 days 00:11:52,3,29,26
259,MAD,P003108,P010623,0 days 00:11:16,-3,22,25
259,MAD,P010623,PTGB,0 days 00:11:04,-3,24,27
259,MAD,P009005,P010623,0 days 00:10:25,-1,22,23
259,MAD,P005928,P009005,0 days 00:08:37,2,22,20
259,MAD,P004887,P005928,0 days 00:08:00,4,22,18
259,MAD,P003108,P005928,0 days 00:07:59,5,21,16
259,MAD,P005791,P009005,0 days 00:07:46,0,17,17
259,MAD,P009005,P010357,0 days 00:07:23,10,22,12
259,MAD,P005791,PTGB,0 days 00:07:15,0,17,17
259,MAD,P004887,P010623,0 days 00:06:32,3,15,12
259,MAD,P003108,P005791,0 days 00:06:01,-3,10,13
259,MAD,P010357,PTGB,0 days 00:06:00,5,18,13
259,MAD,P005791,P010623,0 days 00:05:41,-7,11,18
259,MAD,P005928,PTGB,0 days 00:05:20,0,14,14
259,MAD,P003108,P010357,0 days 00:04:53,5,13,8
259,MAD,P006540,P009005,0 days 00:04:21,4,10,6
259,MAD,P004887,P010357,0 days 00:04:03,6,14,8
259,MAD,P006540,PTGB,0 days 00:03:40,5,12,7
259,MAD,P003108,P003733,0 days 00:02:26,2,5,3
259,MAD,P010357,P010623,0 days 00:01:48,-3,4,7
259,MAD,P003733,P010623,0 days 00:01:09,-1,2,3
259,MAD,P003733,P009005,0 days 00:00:59,-1,2,3
259,MAD,P006540,P010623,0 days 00:00:57,-1,4,5
259,MAD,P004887,P006540,0 days 00:00:28,0,0,0
259,MAD,P003108,P006540,0 days 00:00:16,0,0,0
260,MUN,P001288,P007056,0 days 00:23:23,10,41,31
260,MUN,P001288,P011987,0 days 00:20:18,-1,29,30
260,MUN,P007056,P011987,0 days 00:19:48,7,31,24
260,MUN,P001288,P008985,0 days 00:18:01,7,32,25
260,MUN,P001288,P003583,0 days 00:17:37,-2,28,30
260,MUN,P007056,P008985,0 days 00:17:01,5,30,25
260,MUN,P006760,P010391,0 days 00:16:36,-2,27,29
260,MUN,P007639,P010391,0 days 00:15:54,2,21,19
260,MUN,P003583,P007056,0 days 00:15:29,2,26,24
260,MUN,P003583,P008985,0 days 00:14:13,7,27,20
260,MUN,P003583,P011987,0 days 00:14:06,-5,20,25
260,MUN,P007056,P010391,0 days 00:13:11,13,23,10
260,MUN,P006760,P007639,0 days 00:12:51,-3,16,19
260,MUN,P008985,P011987,0 days 00:12:48,0,18,18
260,MUN,P001557,P010391,0 days 00:12:29,0,21,21
260,MUN,P001288,P010391,0 days 00:12:11,7,23,16
260,MUN,P001557,P006760,0 days 00:11:46,-2,19,21
260,MUN,P001557,P007639,0 days 00:10:08,-5,14,19
260,MUN,P006760,P007975,0 days 00:09:57,-9,8,17
260,MUN,P007639,P007975,0 days 00:09:57,-9,8,17
260,MUN,P007975,P010391,0 days 00:09:57,-9,8,17
260,MUN,P003583,P010391,0 days 00:09:39,1,17,16
260,MUN,P010391,P011987,0 days 00:09:06,6,17,11
260,MUN,P001557,P007975,0 days 00:08:17,-9,8,17
260,MUN,P007056,P007639,0 days 00:07:55,9,11,2
260,MUN,P008985,P010391,0 days 00:07:37,10,19,9
260,MUN,P007639,P011987,0 days 00:06:45,13,17,4
260,MUN,P006760,P008985,0 days 00:05:31,4,11,7
260,MUN,P006760,P007056,0 days 00:05:25,3,8,5
260,MUN,P001288,P007639,0 days 00:05:12,7,9,2
260,MUN,P006760,P011987,0 days 00:05:08,-3,8,11
260,MUN,P001288,P006760,0 days 00:04:07,-5,6,11
260,MUN,P007639,P008985,0 days 00:03:30,2,4,2
260,MUN,P003583,P006760,0 days 00:03:03,-3,5,8
260,MUN,P001557,P008985,0 days 00:02:59,5,7,2
260,MUN,P001557,P003583,0 days 00:02:21,5,7,2
260,MUN,P007056,P007975,0 days 00:02:12,-1,2,3
260,MUN,P001557,P011987,0 days 00:01:13,4,6,2
260,MUN,P001288,P001557,0 days 00:00:43,2,2,0
260,MUN,P001288,P007975,0 days 00:00:32,-1,2,3
260,MUN,P003583,P007975,0 days 00:00:32,-1,2,3
260,MUN,P007975,P011987,0 days 00:00:32,-1,2,3
260,ZAL,P002329,P011218,0 days 00:24:55,-3,36,39
260,ZAL,P003210,P012715,0 days 00:20:18,5,39,34
260,ZAL,P003210,P010390,0 days 00:17:09,-3,28,31
260,ZAL,P010390,P012715,0 days 00:17:08,-2,29,31
260,ZAL,P002329,P010390,0 days 00:15:39,-11,21,32
260,ZAL,P002329,P012715,0 days 00:14:38,-6,23,29
260,ZAL,P011218,P012715,0 days 00:12:30,6,25,19
260,ZAL,P002329,P003210,0 days 00:12:03,-4,19,23
260,ZAL,P010390,P011218,0 days 00:11:59,2,22,20
260,ZAL,P002329,P007513,0 days 00:11:56,-6,12,18
260,ZAL,P005504,P011218,0 days 00:11:22,-6,11,17
260,ZAL,P002329,P005504,0 days 00:11:22,-6,11,17
260,ZAL,P002676,P003210,0 days 00:11:19,7,22,15
260,ZAL,P007513,P011218,0 days 00:10:31,-5,11,16
260,ZAL,P005504,P012787,0 days 00:09:59,2,17,15
260,ZAL,P002676,P012715,0 days 00:09:47,8,21,13
260,ZAL,P002676,P011218,0 days 00:09:46,-2,9,11
260,ZAL,P002329,P002676,0 days 00:09:40,-5,8,13
260,ZAL,P002676,P012787,0 days 00:08:58,5,14,9
260,ZAL,P002676,P010390,0 days 00:08:43,-7,10,17
260,ZAL,P007109,P011218,0 days 00:08:31,2,11,9
260,ZAL,P002329,P007109,0 days 00:08:31,2,11,9
260,ZAL,P003210,P011218,0 days 00:08:23,9,20,11
260,ZAL,P002676,P005504,0 days 00:08:08,5,14,9
260,ZAL,P007109,P007513,0 days 00:07:41,2,11,9
260,ZAL,P003211,P010390,0 days 00:07:34,-9,6,15
260,ZAL,P003211,P012715,0 days 00:07:27,-9,6,15
260,ZAL,P012715,P012787,0 days 00:07:18,1,15,14
260,ZAL,P005504,P012715,0 days 00:07:17,4,15,11
260,ZAL,P002329,P012787,0 days 00:06:54,-8,5,13
260,ZAL,P011218,P012787,0 days 00:06:08,-5,5,10
260,ZAL,P005504,P007513,0 days 00:06:04,-1,6,7
260,ZAL,P003210,P003211,0 days 00:06:03,-9,4,13
260,ZAL,P002676,P007513,0 days 00:05:48,-2,9,11
260,ZAL,P003210,P012787,0 days 00:05:27,4,12,8
260,ZAL,P005504,P007109,0 days 00:05:19,-1,6,7
260,ZAL,P002329,P003211,0 days 00:05:14,-9,2,11
260,ZAL,P003210,P005504,0 days 00:04:41,7,12,5
260,ZAL,P007513,P010390,0 days 00:04:02,-7,4,11
260,ZAL,P002676,P003211,0 days 00:03:03,-2,4,6
260,ZAL,P002676,P007109,0 days 00:02:36,5,5,0
260,ZAL,P003211,P011218,0 days 00:02:07,-2,2,4
260,ZAL,P003210,P007513,0 days 00:01:57,0,4,4
260,ZAL,P007513,P012715,0 days 00:01:17,1,3,2
260,ZAL,P007109,P012787,0 days 00:00:50,0,0,0
260,ZAL,P010390,P012787,0 days 00:00:46,-3,0,3
260,ZAL,P003211,P007109,0 days 00:00:36,-2,0,2
260,ZAL,P003211,P007513,0 days 00:00:36,-2,0,2
261,ASV,P002100,P012080,0 days 00:22:19,7,53,46
261,ASV,P002100,P011225,0 days 00:21:54,2,49,47
261,ASV,P011225,P012080,0 days 00:20:13,5,47,42
261,ASV,P012080,P012731,0 days 00:19:58,-2,44,46
261,ASV,P002100,P012731,0 days 00:18:59,2,44,42
261,ASV,P005094,P006568,0 days 00:18:53,10,37,27
261,ASV,P011225,P012731,0 days 00:18:16,4,44,40
261,ASV,P002100,P005094,0 days 00:17:44,4,40,36
261,ASV,P005094,P012080,0 days 00:17:14,4,38,34
261,ASV,P006568,P011386,0 days 00:16:08,7,32,25
261,ASV,P005094,P011386,0 days 00:15:53,13,35,22
261,ASV,P005094,P011225,0 days 00:15:46,-3,31,34
261,ASV,P000229,P011386,0 days 00:14:47,1,26,25
261,ASV,P000229,P005094,0 days 00:13:57,6,26,20
261,ASV,P003526,P005094,0 days 00:13:28,7,25,18
261,ASV,P003526,P006568,0 days 00:13:28,7,25,18
261,ASV,P000229,P006568,0 days 00:13:08,4,23,19
261,ASV,P005094,P012731,0 days 00:12:46,0,29,29
261,ASV,P003526,P011386,0 days 00:11:28,12,23,11
261,ASV,P000229,P003526,0 days 00:10:53,9,20,11
261,ASV,P012731,PKIR,0 days 00:07:50,-2,19,21
261,ASV,P002100,P006568,0 days 00:07:11,1,16,15
261,ASV,P012080,PKIR,0 days 00:07:07,-4,16,20
261,ASV,P006568,P012080,0 days 00:06:51,-2,14,16
261,ASV,P011225,PKIR,0 days 00:06:13,1,16,15
261,ASV,P002100,PKIR,0 days 00:05:58,3,16,13
261,ASV,P011386,P012080,0 days 00:05:22,-7,9,16
261,ASV,P006568,P011225,0 days 00:04:11,-2,7,9
261,ASV,P000229,P012080,0 days 00:03:16,-9,3,12
261,ASV,P002100,P011386,0 days 00:03:02,3,9,6
261,ASV,P011386,P012731,0 days 00:02:39,-7,3,10
261,ASV,P002100,P003526,0 days 00:02:35,-2,5,7
261,ASV,P000229,PKIR,0 days 00:02:04,-8,3,11
261,ASV,P003526,P011225,0 days 00:02:00,-5,2,7
261,ASV,P000229,P012731,0 days 00:01:58,-5,3,8
261,ASV,P011386,PKIR,0 days 00:01:49,-6,3,9
261,ASV,P006568,P012731,0 days 00:01:14,-2,2,4
261,ASV,P005094,PKIR,0 days 00:00:55,-1,3,4
261,ASV,P000229,P011225,0 days 00:00:19,-2,0,2
261,ASV,P006568,PKIR,0 days 00:00:12,-3,0,3
261,ASV,P000229,P002100,0 days 00:00:02,0,0,0
261,IST,P004888,P007200,0 days 00:30:31,-10,56,66
261,IST,P004888,P011078,0 days 00:22:50,6,53,47
261,IST,P006590,P011981,0 days 00:20:44,1,48,47
261,IST,P004888,P006590,0 days 00:19:09,2,45,43
261,IST,P006590,P011078,0 days 00:17:46,1,45,44
261,IST,P007200,P011078,0 days 00:17:03,-3,37,40
261,IST,P004888,P011981,0 days 00:17:02,4,40,36
261,IST,P011078,P011981,0 days 00:15:39,3,40,37
261,IST,P009664,P011078,0 days 00:13:45,-8,24,32
261,IST,P004888,PLHK,0 days 00:13:28,-7,18,25
261,IST,P007200,PLHK,0 days 00:13:28,-7,18,25
261,IST,P006590,P007200,0 days 00:13:22,-7,29,36
261,IST,P009846,P011981,0 days 00:12:38,9,32,23
261,IST,P006590,P009846,0 days 00:12:38,9,32,23
261,IST,P007200,P011981,0 days 00:11:15,-5,24,29
261,IST,P007200,P012710,0 days 00:11:09,-5,16,21
261,IST,P004888,P012710,0 days 00:11:09,-5,16,21
261,IST,P004888,P009664,0 days 00:10:03,-5,16,21
261,IST,P007200,P009664,0 days 00:10:03,-5,16,21
261,IST,P009846,P011078,0 days 00:09:29,6,24,18
261,IST,P004888,P009846,0 days 00:08:56,12,24,12
261,IST,P009513,P012710,0 days 00:08:23,-5,11,16
261,IST,P004888,P009513,0 days 00:08:23,-5,11,16
261,IST,P007200,P009513,0 days 00:08:23,-5,11,16
261,IST,P012710,PLHK,0 days 00:07:50,-2,12,14
261,IST,P009513,PLHK,0 days 00:07:00,-7,7,14
261,IST,P011078,PLHK,0 days 00:06:28,0,11,11
261,IST,P006590,P009664,0 days 00:05:49,-5,13,18
261,IST,P009664,PLHK,0 days 00:05:38,-5,6,11
261,IST,P009664,P009846,0 days 00:03:42,-3,8,11
261,IST,P009664,P011981,0 days 00:03:42,-3,8,11
261,IST,P004888,P012788,0 days 00:03:41,4,9,5
261,IST,P007200,P012788,0 days 00:03:41,4,9,5
261,IST,P007200,P009846,0 days 00:03:09,3,8,5
261,IST,P009664,P012788,0 days 00:02:18,2,5,3
261,IST,P011078,P012788,0 days 00:02:18,2,5,3
261,IST,P006590,P012710,0 days 00:01:56,-5,0,5
261,IST,P011981,P012710,0 days 00:01:56,-5,0,5
261,IST,P009513,P012788,0 days 00:01:23,2,4,2
261,IST,P012710,P012788,0 days 00:01:23,2,4,2
261,IST,P011078,P012710,0 days 00:00:50,5,5,0
262,BER,P003958,P008967,0 days 00:25:27,11,55,44
262,BER,P003958,P008780,0 days 00:23:56,6,49,43
262,BER,P008780,P008967,0 days 00:23:30,8,49,41
262,BER,P003958,P010791,0 days 00:23:01,15,52,37
262,BER,P008967,P010791,0 days 00:22:27,17,52,35
262,BER,P008780,P010791,0 days 00:21:38,9,46,37
262,BER,P010791,P012720,0 days 00:16:47,15,40,25
262,BER,P006919,P010791,0 days 00:15:24,4,28,24
262,BER,P003958,P012720,0 days 00:14:01,4,32,28
262,BER,P006919,P008780,0 days 00:13:32,-2,23,25
262,BER,P003958,P006919,0 days 00:13:24,-2,23,25
262,BER,P006919,P008967,0 days 00:13:05,0,23,23
262,BER,P008967,P012720,0 days 00:12:45,11,32,21
262,BER,P008780,P012720,0 days 00:11:14,6,26,20
262,BER,P006251,P006919,0 days 00:10:24,-3,19,22
262,BER,P006251,P008211,0 days 00:09:47,-4,22,26
262,BER,P008211,P012720,0 days 00:09:43,-3,22,25
262,BER,P007025,P011934,0 days 00:09:15,-17,16,33
262,BER,P006251,P012720,0 days 00:08:59,-10,16,26
262,BER,P006251,P011934,0 days 00:08:43,-14,16,30
262,BER,P006251,P007025,0 days 00:08:25,-12,16,28
262,BER,P006919,P008211,0 days 00:06:45,3,14,11
262,BER,P008211,P011934,0 days 00:06:11,-10,14,24
262,BER,P011934,P012720,0 days 00:06:05,-21,8,29
262,BER,P008211,P010791,0 days 00:05:41,9,14,5
262,BER,P006919,P012720,0 days 00:05:18,-1,8,9
262,BER,P006919,P011934,0 days 00:05:16,-3,8,11
262,BER,P007025,P008211,0 days 00:05:11,-5,14,19
262,BER,P007025,P012720,0 days 00:05:05,-16,8,24
262,BER,P006251,P010791,0 days 00:04:18,3,8,5
262,BER,P006919,P007025,0 days 00:04:10,-1,8,9
262,BER,P007550,P011934,0 days 00:03:57,-12,2,14
262,BER,P007025,P007550,0 days 00:03:57,-12,2,14
262,BER,P006251,P007550,0 days 00:03:07,-7,2,9
262,BER,P003958,P011934,0 days 00:02:20,-8,0,8
262,BER,P003958,P008211,0 days 00:02:05,3,6,3
262,BER,P008211,P008967,0 days 00:02:05,3,6,3
262,BER,P007550,P012720,0 days 00:02:03,-9,0,9
262,BER,P006919,P007550,0 days 00:01:54,-3,2,5
262,BER,P006251,P008967,0 days 00:01:45,-3,3,6
262,BER,P006251,P008780,0 days 00:01:38,-3,3,6
262,BER,P008967,P011934,0 days 00:01:37,-3,0,3
262,BER,P003958,P006251,0 days 00:01:30,-3,3,6
262,BER,P003958,P007025,0 days 00:00:50,-5,0,5
262,BER,P003958,P007550,0 days 00:00:50,-5,0,5
262,BER,P008780,P011934,0 days 00:00:48,0,0,0
262,BER,P007025,P008967,0 days 00:00:07,0,0,0
262,MAD,P003733,P010357,0 days 00:21:43,7,50,43
262,MAD,P003108,P005791,0 days 00:21:22,5,47,42
262,MAD,P003108,P005928,0 days 00:20:55,1,47,46
262,MAD,P005791,P005928,0 days 00:18:05,0,39,39
262,MAD,P003733,P004887,0 days 00:16:33,4,36,32
262,MAD,P004887,P010357,0 days 00:16:33,4,36,32
262,MAD,P009005,P010357,0 days 00:16:08,4,32,28
262,MAD,P001392,P005791,0 days 00:15:38,-3,30,33
262,MAD,P001392,P003108,0 days 00:15:38,-3,30,33
262,MAD,P003108,P010357,0 days 00:15:17,18,46,28
262,MAD,P001392,P005928,0 days 00:15:00,-5,28,33
262,MAD,P010357,P010623,0 days 00:14:48,4,31,27
262,MAD,P005928,P010357,0 days 00:13:50,15,41,26
262,MAD,P003733,P009005,0 days 00:13:29,1,26,25
262,MAD,P005791,P010357,0 days 00:11:57,15,36,21
262,MAD,P009005,P010623,0 days 00:11:43,2,24,22
262,MAD,P003733,P010623,0 days 00:11:31,-1,23,24
262,MAD,P004887,P009005,0 days 00:11:24,3,23,20
262,MAD,P005928,P009213,0 days 00:11:22,-12,14,26
262,MAD,P005791,P009213,0 days 00:11:22,-12,14,26
262,MAD,P003108,P009213,0 days 00:11:22,-12,14,26
262,MAD,P001392,P009213,0 days 00:11:22,-12,14,26
262,MAD,P003733,P005928,0 days 00:10:12,8,27,19
262,MAD,P004887,P010623,0 days 00:09:34,1,20,19
262,MAD,P003108,P003733,0 days 00:08:22,6,24,18
262,MAD,P004887,P005928,0 days 00:06:59,3,16,13
262,MAD,P003108,P010623,0 days 00:05:44,5,13,8
262,MAD,P005791,P010623,0 days 00:05:14,3,11,8
262,MAD,P003108,P004887,0 days 00:05:09,1,13,12
262,MAD,P003733,P005791,0 days 00:05:02,3,14,11
262,MAD,P005791,P009005,0 days 00:04:36,1,9,8
262,MAD,P005928,P009005,0 days 00:04:25,2,8,6
262,MAD,P001392,P010357,0 days 00:04:16,9,16,7
262,MAD,P003108,P009005,0 days 00:02:47,3,6,3
262,MAD,P001392,P010623,0 days 00:00:38,2,2,0
263,IST,P004888,P007200,0 days 00:24:35,6,55,49
263,IST,P006590,P012788,0 days 00:19:45,6,37,31
263,IST,P006590,P009846,0 days 00:18:49,8,37,29
263,IST,P009846,P012788,0 days 00:18:49,8,37,29
263,IST,P009664,P009846,0 days 00:18:14,12,38,26
263,IST,P007200,PLHK,0 days 00:16:22,8,40,32
263,IST,P004888,PLHK,0 days 00:16:22,8,40,32
263,IST,P011078,P012788,0 days 00:15:02,-2,25,27
263,IST,P009664,P011078,0 days 00:14:59,2,28,26
263,IST,P006590,P009664,0 days 00:14:44,6,28,22
263,IST,P009664,P012788,0 days 00:14:44,6,28,22
263,IST,P007200,P012710,0 days 00:14:32,3,33,30
263,IST,P004888,P012710,0 days 00:14:32,3,33,30
263,IST,P006590,P011078,0 days 00:14:23,3,25,22
263,IST,P012710,PLHK,0 days 00:13:53,8,33,25
263,IST,P009846,P011078,0 days 00:13:27,5,25,20
263,IST,P007200,P009513,0 days 00:12:31,8,28,20
263,IST,P009513,P012710,0 days 00:12:31,8,28,20
263,IST,P009513,PLHK,0 days 00:12:31,8,28,20
263,IST,P004888,P009513,0 days 00:12:31,8,28,20
263,IST,P007200,P009846,0 days 00:08:52,9,22,13
263,IST,P007200,P009664,0 days 00:07:41,6,20,14
263,IST,P004888,P009846,0 days 00:07:35,8,19,11
263,IST,P007200,P012788,0 days 00:06:57,-4,12,16
263,IST,P006590,P007200,0 days 00:06:18,1,12,11
263,IST,P004888,P011078,0 days 00:05:51,-8,12,20
263,IST,P004888,P009664,0 days 00:05:43,4,15,11
263,IST,P004888,P012788,0 days 00:05:40,-5,9,14
263,IST,P007200,P011078,0 days 00:05:10,-9,10,19
263,IST,P004888,P006590,0 days 00:05:01,0,9,9
263,IST,P011078,PLHK,0 days 00:03:35,-2,10,12
263,IST,P004888,P011981,0 days 00:03:14,4,8,4
263,IST,P009846,P011981,0 days 00:03:14,4,8,4
263,IST,P009664,P011981,0 days 00:03:14,4,8,4
263,IST,P007200,P011981,0 days 00:03:14,4,8,4
263,IST,P009664,PLHK,0 days 00:02:29,0,7,7
263,IST,P011078,P012710,0 days 00:02:01,-5,5,10
263,IST,P012710,P012788,0 days 00:00:39,-5,0,5
263,IST,P009846,PLHK,0 days 00:00:16,2,2,0
263,OLY,P001255,P008829,0 days 00:26:03,3,54,51
263,OLY,P008829,P010612,0 days 00:25:57,-3,54,57
263,OLY,P008811,P008855,0 days 00:23:56,-4,49,53
263,OLY,P008811,P008829,0 days 00:23:48,-5,45,50
263,OLY,P001255,P010612,0 days 00:22:00,7,52,45
263,OLY,P008829,P008855,0 days 00:21:38,-3,45,48
263,OLY,P008811,P010612,0 days 00:20:00,1,45,44
263,OLY,P008855,P010612,0 days 00:20:00,1,45,44
263,OLY,P001255,P008811,0 days 00:19:51,5,43,38
263,OLY,P001255,P008855,0 days 00:17:41,7,43,36
263,OLY,P007982,P012878,0 days 00:13:54,-7,23,30
263,OLY,P001255,P007982,0 days 00:12:30,-4,17,21
263,OLY,P007982,P008829,0 days 00:10:00,-8,11,19
263,OLY,P007982,P011194,0 days 00:10:00,-6,16,22
263,OLY,P001255,P012878,0 days 00:08:42,2,17,15
263,OLY,P011194,P012878,0 days 00:07:42,-5,12,17
263,OLY,P007982,P010392,0 days 00:07:30,-10,10,20
263,OLY,P010392,P011194,0 days 00:07:30,-10,10,20
263,OLY,P007982,P008855,0 days 00:07:17,-9,10,19
263,OLY,P007853,P007982,0 days 00:06:46,-1,8,9
263,OLY,P008829,P012878,0 days 00:06:12,-2,11,13
263,OLY,P007982,P008811,0 days 00:06:06,-7,4,11
263,OLY,P010612,P012878,0 days 00:05:57,-4,9,13
263,OLY,P007982,P010612,0 days 00:05:57,-4,9,13
263,OLY,P008855,P010392,0 days 00:05:39,-5,10,15
263,OLY,P008855,P011194,0 days 00:05:39,-5,10,15
263,OLY,P010392,P012878,0 days 00:05:12,-9,6,15
263,OLY,P001255,P007853,0 days 00:04:55,4,8,4
263,OLY,P007853,P012878,0 days 00:04:36,1,8,7
263,OLY,P007853,P011194,0 days 00:04:21,-1,6,7
263,OLY,P010612,P011983,0 days 00:03:57,-10,2,12
263,OLY,P008855,P011983,0 days 00:03:57,-10,2,12
263,OLY,P008829,P011983,0 days 00:03:57,-10,2,12
263,OLY,P008811,P011983,0 days 00:03:57,-10,2,12
263,OLY,P008855,P012878,0 days 00:03:21,-4,6,10
263,OLY,P001255,P011194,0 days 00:02:30,4,6,2
263,OLY,P007853,P008829,0 days 00:02:25,0,2,2
263,OLY,P008811,P010392,0 days 00:02:18,-1,4,5
263,OLY,P008811,P011194,0 days 00:02:18,-1,4,5
263,OLY,P007853,P008811,0 days 00:02:10,-2,0,2
263,OLY,P007853,P010392,0 days 00:01:51,-5,0,5
264,TEL,P009783,P009863,0 days 00:30:01,14,83,69
264,TEL,P009783,P011199,0 days 00:27:13,20,74,54
264,TEL,P009863,P011199,0 days 00:25:33,16,68,52
264,TEL,P009863,P012744,0 days 00:21:00,12,59,47
264,TEL,P009622,P009783,0 days 00:20:18,-2,45,47
264,TEL,P009622,P009863,0 days 00:19:25,-2,45,47
264,TEL,P011199,P012744,0 days 00:19:06,11,52,41
264,TEL,P009783,P012744,0 days 00:18:45,13,55,42
264,TEL,P007990,P009783,0 days 00:18:28,10,52,42
264,TEL,P009622,P011199,0 days 00:17:37,0,36,36
264,TEL,P007990,P009863,0 days 00:14:31,15,46,31
264,TEL,P007990,P012744,0 days 00:13:55,20,44,24
264,TEL,P007990,P011199,0 days 00:13:48,18,44,26
264,TEL,P009622,P012744,0 days 00:10:17,-6,22,28
264,TEL,P005145,P009783,0 days 00:09:54,4,25,21
264,TEL,P005145,P009863,0 days 00:09:54,4,25,21
264,TEL,P005145,P009622,0 days 00:09:19,6,25,19
264,TEL,P007990,P011971,0 days 00:07:35,-8,8,16
264,TEL,P005145,P011199,0 days 00:06:50,7,18,11
264,TEL,P011214,P011971,0 days 00:06:31,-9,8,17
264,TEL,P007990,P009622,0 days 00:06:25,-2,13,15
264,TEL,P011193,P011971,0 days 00:06:20,-5,14,19
264,TEL,P009783,P011971,0 days 00:06:08,-7,10,17
264,TEL,P011193,P011214,0 days 00:05:45,-9,8,17
264,TEL,P011971,P012744,0 days 00:05:07,0,10,10
264,TEL,P009622,P011971,0 days 00:05:02,0,10,10
264,TEL,P007990,P011214,0 days 00:04:45,-8,3,11
264,TEL,P009863,P011971,0 days 00:04:38,1,12,11
264,TEL,P009783,P011214,0 days 00:04:24,-9,7,16
264,TEL,P011199,P011971,0 days 00:04:15,-4,4,8
264,TEL,P011214,P012744,0 days 00:04:05,-4,5,9
264,TEL,P007990,P011193,0 days 00:04:00,-8,3,11
264,TEL,P009783,P011193,0 days 00:03:45,-7,5,12
264,TEL,P009863,P011214,0 days 00:03:36,-3,7,10
264,TEL,P005145,P007990,0 days 00:03:13,-5,7,12
264,TEL,P011193,P012744,0 days 00:03:01,2,9,7
264,TEL,P009863,P011193,0 days 00:02:46,3,11,8
264,TEL,P009622,P011214,0 days 00:01:18,-2,2,4
264,TEL,P009622,P011193,0 days 00:00:35,4,6,2
264,TEL,P005145,P011193,0 days 00:00:26,0,0,0
264,TEL,P011193,P011199,0 days 00:00:26,0,0,0
264,ASV,P005094,P011225,0 days 00:24:07,-12,56,68
264,ASV,P005094,P006568,0 days 00:22:05,-10,49,59
264,ASV,P006568,P011225,0 days 00:19:48,-3,49,52
264,ASV,P002100,P012080,0 days 00:18:23,-5,43,48
264,ASV,P002100,P004194,0 days 00:15:48,-3,33,36
264,ASV,P000229,P005094,0 days 00:15:38,-6,30,36
264,ASV,P011386,P012080,0 days 00:14:49,1,29,28
264,ASV,P000229,P006568,0 days 00:14:31,-7,27,34
264,ASV,P004194,P012080,0 days 00:13:39,0,29,29
264,ASV,P000229,P011225,0 days 00:13:35,-3,28,31
264,ASV,P012080,P012731,0 days 00:13:01,9,32,23
264,ASV,P002100,P012731,0 days 00:13:01,9,32,23
264,ASV,P003526,P005094,0 days 00:12:51,-4,24,28
264,ASV,P003526,P011225,0 days 00:12:51,-4,24,28
264,ASV,P002100,P011386,0 days 00:12:44,4,27,23
264,ASV,P004194,P012731,0 days 00:12:06,4,27,23
264,ASV,P003526,P006568,0 days 00:11:59,0,24,24
264,ASV,P011386,P012731,0 days 00:11:55,6,27,21
264,ASV,P004194,P011386,0 days 00:11:35,3,24,21
264,ASV,P002100,P011225,0 days 00:11:24,-6,33,39
264,ASV,P002100,P005094,0 days 00:11:19,-11,28,39
264,ASV,P000229,P003526,0 days 00:10:16,-1,20,21
264,ASV,P005094,P012080,0 days 00:08:43,-19,16,35
264,ASV,P002100,P006568,0 days 00:08:29,2,27,25
264,ASV,P006568,P012080,0 days 00:08:00,-9,19,28
264,ASV,P011225,P012080,0 days 00:06:45,-11,19,30
264,ASV,P011225,PKIR,0 days 00:05:30,5,18,13
264,ASV,P005094,PKIR,0 days 00:05:30,5,18,13
264,ASV,P004194,P011225,0 days 00:04:01,-6,9,15
264,ASV,P004194,P005094,0 days 00:03:42,-7,6,13
264,ASV,P002100,PKIR,0 days 00:03:37,5,13,8
264,ASV,P000229,P012080,0 days 00:03:19,-5,5,10
264,ASV,P006568,P011386,0 days 00:03:12,-2,5,7
264,ASV,P006568,PKIR,0 days 00:03:01,4,11,7
264,ASV,P005094,P011386,0 days 00:02:54,-5,2,7
264,ASV,P002100,P003526,0 days 00:02:35,-3,4,7
264,ASV,P000229,P011386,0 days 00:02:03,-3,2,5
264,ASV,P000229,PKIR,0 days 00:02:03,0,5,5
264,ASV,P011225,P012731,0 days 00:02:01,4,8,4
264,ASV,P004194,PKIR,0 days 00:01:29,1,4,3
264,ASV,P012731,PKIR,0 days 00:01:19,1,3,2
264,ASV,P000229,P012731,0 days 00:01:07,1,3,2
264,ASV,P005094,P012731,0 days 00:01:07,1,3,2
264,ASV,P006568,P012731,0 days 00:00:55,5,5,0
264,ASV,P003526,P004194,0 days 00:00:52,-4,0,4
264,ASV,P012080,PKIR,0 days 00:00:17,-1,0,1
264,ASV,P011225,P011386,0 days 00:00:02,0,0,0
264,ASV,P011386,PKIR,0 days 00:00:02,0,0,0
265,PAR,P009862,P012096,0 days 00:26:35,6,58,52
265,PAR,P012096,P012743,0 days 00:24:41,14,59,45
265,PAR,P004172,P012096,0 days 00:23:19,4,52,48
265,PAR,P007400,P012096,0 days 00:21:54,0,44,44
265,PAR,P012096,P012742,0 days 00:21:51,7,52,45
265,PAR,P004172,P012743,0 days 00:18:33,10,45,35
265,PAR,P004172,P012742,0 days 00:17:38,7,42,35
265,PAR,P012742,P012743,0 days 00:17:13,13,45,32
265,PAR,P009862,P012742,0 days 00:15:37,4,35,31
265,PAR,P004172,P009862,0 days 00:15:15,4,36,32
265,PAR,P009862,P012743,0 days 00:14:41,10,35,25
265,PAR,P007400,P009862,0 days 00:13:51,4,28,24
265,PAR,P003983,P012096,0 days 00:12:05,-1,23,24
265,PAR,P003983,P009862,0 days 00:11:55,5,26,21
265,PAR,P007400,P012743,0 days 00:11:17,1,24,23
265,PAR,P007673,P012096,0 days 00:09:47,-8,20,28
265,PAR,P003983,P007400,0 days 00:09:42,2,19,17
265,PAR,P004172,P007400,0 days 00:08:23,-2,15,17
265,PAR,P007673,P012742,0 days 00:07:47,-3,17,20
265,PAR,P007400,P012742,0 days 00:06:45,1,15,14
265,PAR,P007673,P012743,0 days 00:06:03,6,17,11
265,PAR,P000956,P003983,0 days 00:05:23,-1,14,15
265,PAR,P009862,P011051,0 days 00:05:10,-3,7,10
265,PAR,P007400,P011051,0 days 00:05:10,-3,7,10
265,PAR,P003983,P011051,0 days 00:04:56,-3,7,10
265,PAR,P011051,P012096,0 days 00:04:56,-3,7,10
265,PAR,P004172,P007673,0 days 00:04:32,-4,9,13
265,PAR,P000956,P009862,0 days 00:04:25,2,13,11
265,PAR,P004058,P012743,0 days 00:04:21,-2,7,9
265,PAR,P004058,P012096,0 days 00:04:21,-2,7,9
265,PAR,P004058,P007400,0 days 00:04:21,-2,7,9
265,PAR,P004058,P004172,0 days 00:04:21,-2,7,9
265,PAR,P007400,P007673,0 days 00:04:18,-2,9,11
265,PAR,P003983,P007673,0 days 00:04:06,-8,7,15
265,PAR,P007673,P009862,0 days 00:03:59,-8,6,14
265,PAR,P000956,P012096,0 days 00:03:59,-1,10,11
265,PAR,P000956,P007673,0 days 00:03:30,-5,7,12
265,PAR,P000956,P007400,0 days 00:02:51,1,8,7
265,PAR,P003983,P012743,0 days 00:01:55,4,4,0
265,PAR,P000956,P011050,0 days 00:01:24,0,4,4
265,PAR,P003983,P011050,0 days 00:01:24,0,4,4
265,PAR,P007673,P011050,0 days 00:01:24,0,4,4
265,PAR,P009862,P011050,0 days 00:01:24,0,4,4
265,PAR,P003983,P004172,0 days 00:01:15,-1,2,3
265,PAR,P003983,P012742,0 days 00:01:15,-1,2,3
265,PAR,P007673,P011051,0 days 00:00:14,0,0,0
265,PAR,P011051,P012742,0 days 00:00:14,0,0,0
265,BAS,P009048,P010444,0 days 00:22:08,2,50,48
265,BAS,P004761,P009048,0 days 00:21:35,0,48,48
265,BAS,P004761,P012201,0 days 00:18:18,-7,36,43
265,BAS,P010444,P012201,0 days 00:17:45,-1,34,35
265,BAS,P004761,P010444,0 days 00:17:30,5,41,36
265,BAS,P004761,P007230,0 days 00:17:07,-15,31,46
265,BAS,P009048,P011948,0 days 00:13:51,-1,29,30
265,BAS,P007230,P009048,0 days 00:13:44,-9,27,36
265,BAS,P009048,P012201,0 days 00:13:31,-4,26,30
265,BAS,P004761,P011948,0 days 00:13:15,0,29,29
265,BAS,P003198,P010444,0 days 00:12:49,3,29,26
265,BAS,P007230,P012201,0 days 00:11:44,-11,18,29
265,BAS,P007946,P012201,0 days 00:11:25,-1,22,23
265,BAS,P010444,P011948,0 days 00:10:47,4,22,18
265,BAS,P010444,P012765,0 days 00:10:16,5,23,18
265,BAS,P011948,P012201,0 days 00:09:37,1,19,18
265,BAS,P007230,P010444,0 days 00:09:29,-4,18,22
265,BAS,P009048,P012765,0 days 00:09:05,5,21,16
265,BAS,P004603,P004761,0 days 00:09:03,-8,17,25
265,BAS,P007230,P011948,0 days 00:08:45,-8,13,21
265,BAS,P003198,P009048,0 days 00:08:25,0,19,19
265,BAS,P004603,P011948,0 days 00:07:46,-2,16,18
265,BAS,P011948,P012765,0 days 00:07:36,0,16,16
265,BAS,P003198,P012765,0 days 00:07:11,3,16,13
265,BAS,P003198,P012201,0 days 00:06:59,2,15,13
265,BAS,P003198,P004761,0 days 00:06:33,-1,15,16
265,BAS,P003198,P011948,0 days 00:06:28,2,13,11
265,BAS,P004761,P007946,0 days 00:06:15,-6,12,18
265,BAS,P004603,P007230,0 days 00:06:11,-8,9,17
265,BAS,P007946,P011948,0 days 00:05:59,0,11,11
265,BAS,P003198,P007946,0 days 00:05:27,4,13,9
265,BAS,P004603,P009048,0 days 00:05:16,-5,9,14
265,BAS,P010444,P011085,0 days 00:04:46,4,14,10
265,BAS,P004603,P007946,0 days 00:04:43,-1,10,11
265,BAS,P004603,P012201,0 days 00:04:43,-1,10,11
265,BAS,P004761,P012765,0 days 00:04:27,8,12,4
265,BAS,P007230,P007946,0 days 00:04:24,-6,4,10
265,BAS,P007946,P010444,0 days 00:04:14,3,8,5
265,BAS,P003198,P011085,0 days 00:03:38,3,10,7
265,BAS,P007946,P011085,0 days 00:03:13,3,8,5
265,BAS,P011085,P012201,0 days 00:03:13,3,8,5
265,BAS,P012201,P012765,0 days 00:02:29,-1,4,5
265,BAS,P003198,P004603,0 days 00:02:14,1,5,4
265,BAS,P004761,P011085,0 days 00:01:33,1,6,5
265,BAS,P009048,P011085,0 days 00:01:33,1,6,5
265,BAS,P007230,P011085,0 days 00:01:08,1,4,3
265,BAS,P003198,P008850,0 days 00:00:28,-1,1,2
265,BAS,P004761,P008850,0 days 00:00:28,-1,1,2
265,BAS,P008850,P009048,0 days 00:00:28,-1,1,2
265,BAS,P008850,P010444,0 days 00:00:28,-1,1,2
266,ZAL,P002329,P007513,0 days 00:21:18,7,53,46
266,ZAL,P002329,P011218,0 days 00:21:00,11,60,49
266,ZAL,P007513,P011218,0 days 00:17:47,9,48,39
266,ZAL,P002329,P002676,0 days 00:16:21,17,43,26
266,ZAL,P005504,P011218,0 days 00:16:16,11,46,35
266,ZAL,P002329,P005504,0 days 00:15:33,11,46,35
266,ZAL,P002676,P011218,0 days 00:15:33,13,41,28
266,ZAL,P002676,P007513,0 days 00:15:29,15,38,23
266,ZAL,P002676,P010390,0 days 00:14:14,10,31,21
266,ZAL,P005504,P007513,0 days 00:13:59,3,35,32
266,ZAL,P010390,P012787,0 days 00:12:55,5,27,22
266,ZAL,P002676,P005504,0 days 00:12:01,14,33,19
266,ZAL,P002329,P010390,0 days 00:11:30,-4,24,28
266,ZAL,P002676,P012787,0 days 00:10:36,6,21,15
266,ZAL,P007513,P010390,0 days 00:09:55,5,23,18
266,ZAL,P003211,P010390,0 days 00:08:48,3,20,17
266,ZAL,P003211,P012787,0 days 00:08:38,3,20,17
266,ZAL,P010390,P011218,0 days 00:07:09,-1,17,18
266,ZAL,P002676,P003210,0 days 00:06:58,3,17,14
266,ZAL,P002329,P012715,0 days 00:06:45,-7,15,22
266,ZAL,P006860,P010390,0 days 00:06:35,10,20,10
266,ZAL,P003210,P010390,0 days 00:06:31,5,10,5
266,ZAL,P002676,P006860,0 days 00:06:15,8,16,8
266,ZAL,P005504,P012715,0 days 00:06:13,-3,15,18
266,ZAL,P006860,P012787,0 days 00:06:05,9,18,9
266,ZAL,P003210,P012787,0 days 00:05:57,7,10,3
266,ZAL,P002676,P003211,0 days 00:05:47,2,13,11
266,ZAL,P007513,P012715,0 days 00:05:39,-6,12,18
266,ZAL,P002329,P012787,0 days 00:05:38,-3,12,15
266,ZAL,P012715,P012787,0 days 00:05:17,1,8,7
266,ZAL,P002329,P003210,0 days 00:05:10,2,13,11
266,ZAL,P003210,P005504,0 days 00:05:02,4,15,11
266,ZAL,P003211,P012715,0 days 00:04:48,-5,5,10
266,ZAL,P003210,P012715,0 days 00:04:45,0,8,8
266,ZAL,P010390,P012715,0 days 00:04:43,-2,5,7
266,ZAL,P006860,P011218,0 days 00:04:40,-2,11,13
266,ZAL,P011218,P012715,0 days 00:04:36,-5,12,17
266,ZAL,P003210,P003211,0 days 00:04:13,1,7,6
266,ZAL,P006860,P007513,0 days 00:03:21,-1,8,9
266,ZAL,P003211,P006860,0 days 00:03:19,8,13,5
266,ZAL,P002329,P006860,0 days 00:03:11,0,10,10
266,ZAL,P011218,P012787,0 days 00:03:08,-4,5,9
266,ZAL,P003210,P007513,0 days 00:03:06,-3,5,8
266,ZAL,P005504,P012787,0 days 00:02:59,2,6,4
266,ZAL,P005504,P006860,0 days 00:02:51,-2,6,8
266,ZAL,P003210,P011218,0 days 00:02:35,2,10,8
266,ZAL,P007513,P012787,0 days 00:02:23,2,5,3
266,ZAL,P003211,P007513,0 days 00:01:51,0,2,2
266,ZAL,P002329,P003211,0 days 00:01:46,-6,4,10
266,ZAL,P003211,P005504,0 days 00:01:38,0,2,2
266,ZAL,P003210,P006860,0 days 00:01:27,2,2,0
266,ZAL,P002676,P012715,0 days 00:01:18,-5,0,5
266,ZAL,P003211,P011218,0 days 00:01:16,-6,2,8
266,ZAL,P002676,P012784,0 days 00:00:48,1,3,2
266,ZAL,P003210,P012784,0 days 00:00:48,1,3,2
266,ZAL,P007513,P012784,0 days 00:00:48,1,3,2
266,ZAL,P010390,P012784,0 days 00:00:48,1,3,2
266,VIR,P001133,P006739,0 days 00:23:14,-3,55,58
266,VIR,P006739,PBCN,0 days 00:22:54,-5,45,50
266,VIR,P003527,P005553,0 days 00:20:48,-12,38,50
266,VIR,P001133,PBCN,0 days 00:16:54,0,39,39
266,VIR,P003527,P008847,0 days 00:16:50,-12,36,48
266,VIR,P003527,P006739,0 days 00:15:58,-4,32,36
266,VIR,P005553,P008847,0 days 00:15:35,-10,32,42
266,VIR,P001133,P003527,0 days 00:15:06,-2,34,36
266,VIR,P001133,P005553,0 days 00:15:06,-2,34,36
266,VIR,P003527,P010781,0 days 00:12:23,-9,21,30
266,VIR,P005553,P006739,0 days 00:12:19,-7,24,31
266,VIR,P001133,P008847,0 days 00:11:44,-4,28,32
266,VIR,P001133,P004554,0 days 00:11:30,-5,27,32
266,VIR,P004554,PBCN,0 days 00:11:30,-5,27,32
266,VIR,P004554,P006739,0 days 00:11:30,-5,27,32
266,VIR,P004007,P006739,0 days 00:11:12,6,27,21
266,VIR,P004007,PBCN,0 days 00:11:02,2,23,21
266,VIR,P001133,P010781,0 days 00:10:55,-4,25,29
266,VIR,P003527,PBCN,0 days 00:10:25,-7,12,19
266,VIR,P006739,P008847,0 days 00:09:11,-7,20,27
266,VIR,P001133,P004007,0 days 00:09:07,1,20,19
266,VIR,P005553,P010781,0 days 00:08:32,-5,14,19
266,VIR,P010781,PBCN,0 days 00:08:29,-9,14,23
266,VIR,P008847,P010781,0 days 00:08:05,-5,18,23
266,VIR,P003048,PBCN,0 days 00:07:43,-2,10,12
266,VIR,P003048,P003527,0 days 00:07:40,-6,8,14
266,VIR,P006739,P010781,0 days 00:07:24,-3,18,21
266,VIR,P005553,PBCN,0 days 00:06:38,-6,8,14
266,VIR,P004007,P004554,0 days 00:06:32,-2,14,16
266,VIR,P003048,P006739,0 days 00:06:30,4,12,8
266,VIR,P003048,P004007,0 days 00:05:51,4,13,9
266,VIR,P003048,P010781,0 days 00:05:42,-7,5,12
266,VIR,P004554,P010781,0 days 00:04:58,-3,13,16
266,VIR,P003527,P004007,0 days 00:04:30,0,11,11
266,VIR,P001133,P003048,0 days 00:03:08,3,6,3
266,VIR,P003048,P005553,0 days 00:02:59,-5,0,5
266,VIR,P004007,P010781,0 days 00:02:56,-3,8,11
266,VIR,P008847,PBCN,0 days 00:02:25,-4,2,6
266,VIR,P004007,P008847,0 days 00:02:03,-3,6,9
266,VIR,P003048,P008847,0 days 00:01:27,-3,2,5
266,VIR,P004007,P005553,0 days 00:01:15,-1,2,3
267,MCO,P011212,P011226,0 days 00:20:49,-1,47,48
267,MCO,P005985,P010588,0 days 00:20:03,-16,36,52
267,MCO,P011226,P011231,0 days 00:17:49,-3,38,41
267,MCO,P011212,P011231,0 days 00:17:28,1,39,38
267,MCO,P005985,P009754,0 days 00:17:27,-17,28,45
267,MCO,P011196,P011226,0 days 00:15:58,2,32,30
267,MCO,P009754,P010588,0 days 00:15:25,-17,23,40
267,MCO,P011196,P011212,0 days 00:14:50,7,32,25
267,MCO,P005985,P011226,0 days 00:14:27,-10,30,40
267,MCO,P011196,P011231,0 days 00:14:25,8,34,26
267,MCO,P011231,P012709,0 days 00:13:27,2,31,29
267,MCO,P005985,P011196,0 days 00:12:20,0,25,25
267,MCO,P011212,P012709,0 days 00:11:25,1,24,23
267,MCO,P005985,P011212,0 days 00:11:25,1,28,27
267,MCO,P010588,P011226,0 days 00:11:06,-13,20,33
267,MCO,P010588,PLCZ,0 days 00:11:03,-15,19,34
267,MCO,P009754,PLCZ,0 days 00:11:03,-15,19,34
267,MCO,P005985,PLCZ,0 days 00:11:03,-15,19,34
267,MCO,P011226,P012709,0 days 00:10:59,-1,23,24
267,MCO,P011196,P012709,0 days 00:10:31,3,23,20
267,MCO,P005985,P011231,0 days 00:10:10,-5,22,27
267,MCO,P004197,P010588,0 days 00:10:00,-5,17,22
267,MCO,P010588,P011212,0 days 00:09:48,-2,23,25
267,MCO,P004197,P005985,0 days 00:08:55,-6,14,20
267,MCO,P004197,P009754,0 days 00:08:55,-6,14,20
267,MCO,P004197,PLCZ,0 days 00:07:41,-6,12,18
267,MCO,P010588,P012709,0 days 00:06:29,-10,13,23
267,MCO,P010588,P011196,0 days 00:05:45,-4,7,11
267,MCO,P009754,P011196,0 days 00:05:37,0,9,9
267,MCO,P010588,P011231,0 days 00:05:13,-5,10,15
267,MCO,P005985,P012709,0 days 00:04:56,-6,12,18
267,MCO,P009754,P012709,0 days 00:04:17,-5,10,15
267,MCO,P002581,P011212,0 days 00:03:34,-2,10,12
267,MCO,P002581,P011226,0 days 00:03:34,-2,10,12
267,MCO,P002581,P005985,0 days 00:03:34,-2,10,12
267,MCO,P009754,P011226,0 days 00:03:19,-8,2,10
267,MCO,P009754,P011231,0 days 00:02:49,-2,5,7
267,MCO,P002581,P010588,0 days 00:02:16,3,8,5
267,MCO,P012709,PLCZ,0 days 00:02:15,-5,5,10
267,MCO,P002581,P011231,0 days 00:01:18,-5,2,7
267,MCO,P004197,P011196,0 days 00:01:14,0,2,2
267,MCO,P011226,PLCZ,0 days 00:01:07,-4,2,6
267,MCO,P004197,P011212,0 days 00:01:05,1,3,2
267,MCO,P004197,P011231,0 days 00:01:05,1,3,2
267,MCO,P004197,P012709,0 days 00:01:05,1,3,2
267,MCO,P009754,P011212,0 days 00:00:56,2,2,0
267,MIL,P000796,P007831,0 days 00:24:36,19,64,45
267,MIL,P000796,P011224,0 days 00:23:09,14,63,49
267,MIL,P007831,P011224,0 days 00:22:15,21,62,41
267,MIL,P006509,P011224,0 days 00:19:55,14,52,38
267,MIL,P000796,P002849,0 days 00:18:57,15,57,42
267,MIL,P000796,P006509,0 days 00:18:53,10,49,39
267,MIL,P006509,P007831,0 days 00:16:10,17,43,26
267,MIL,P002849,P011224,0 days 00:15:52,13,47,34
267,MIL,P002849,P006509,0 days 00:15:02,4,38,34
267,MIL,P002849,P007831,0 days 00:14:24,18,45,27
267,MIL,P007831,P011205,0 days 00:13:42,15,42,27
267,MIL,P007201,P011205,0 days 00:13:36,-3,24,27
267,MIL,P000796,P011205,0 days 00:13:29,9,38,29
267,MIL,P007032,P011205,0 days 00:13:27,0,27,27
267,MIL,P007032,P007201,0 days 00:10:22,-2,17,19
267,MIL,P002812,P006509,0 days 00:09:57,4,20,16
267,MIL,P007201,P007831,0 days 00:09:48,6,21,15
267,MIL,P011205,P011224,0 days 00:09:43,4,29,25
267,MIL,P006509,P011205,0 days 00:09:32,-1,20,21
267,MIL,P002849,P011205,0 days 00:08:52,2,26,24
267,MIL,P000796,P007032,0 days 00:08:23,2,20,18
267,MIL,P002812,P011205,0 days 00:08:13,2,18,16
267,MIL,P006509,P007032,0 days 00:08:11,-6,15,21
267,MIL,P006509,P007201,0 days 00:07:42,-2,11,13
267,MIL,P002812,P007201,0 days 00:07:37,0,14,14
267,MIL,P002812,P007831,0 days 00:07:35,9,22,13
267,MIL,P000796,P007201,0 days 00:07:07,3,14,11
267,MIL,P002812,P011224,0 days 00:07:05,1,15,14
267,MIL,P007032,P007831,0 days 00:06:30,7,17,10
267,MIL,P007201,P011224,0 days 00:06:23,-2,11,13
267,MIL,P002849,P007032,0 days 00:06:20,-4,15,19
267,MIL,P002812,P007032,0 days 00:05:53,0,12,12
267,MIL,P000796,P002812,0 days 00:03:26,0,7,7
267,MIL,P007032,P011224,0 days 00:02:50,-5,5,10
267,MIL,P002849,P007201,0 days 00:01:13,-4,0,4
267,MIL,P002812,P005670,0 days 00:00:33,0,0,0
267,MIL,P002812,P006701,0 days 00:00:33,0,0,0
267,MIL,P005670,P006509,0 days 00:00:33,0,0,0
267,MIL,P005670,P006701,0 days 00:00:33,0,0,0
267,MIL,P005670,P011205,0 days 00:00:33,0,0,0
267,MIL,P006509,P006701,0 days 00:00:33,0,0,0
267,MIL,P006701,P011205,0 days 00:00:33,0,0,0
268,RED,P007960,P009035,0 days 00:23:26,0,46,46
268,RED,P009035,P011964,0 days 00:22:00,-2,39,41
268,RED,P007960,P011964,0 days 00:20:59,-2,37,39
268,RED,P000848,P007960,0 days 00:19:47,-6,38,44
268,RED,P005099,P009035,0 days 00:19:44,-7,33,40
268,RED,P000848,P009035,0 days 00:17:30,2,41,39
268,RED,P000848,PJDR,0 days 00:16:24,0,39,39
268,RED,P000848,P011964,0 days 00:15:38,0,33,33
268,RED,P005099,P007960,0 days 00:15:26,3,26,23
268,RED,P009035,P012801,0 days 00:15:06,-9,23,32
268,RED,P005099,P012801,0 days 00:14:07,-4,21,25
268,RED,P009035,PJDR,0 days 00:12:39,0,29,29
268,RED,P007960,PJDR,0 days 00:12:06,-7,24,31
268,RED,P005099,P011964,0 days 00:12:04,-1,19,20
268,RED,P011964,PJDR,0 days 00:11:13,1,24,23
268,RED,P005099,P006436,0 days 00:10:39,-5,18,23
268,RED,P006436,P009035,0 days 00:09:49,-4,23,27
268,RED,P000848,P005099,0 days 00:08:39,-2,16,18
268,RED,P007960,P012801,0 days 00:07:52,0,12,12
268,RED,P011964,P012801,0 days 00:07:39,0,10,10
268,RED,P000848,P006436,0 days 00:07:32,3,18,15
268,RED,P006436,P012801,0 days 00:07:30,-9,13,22
268,RED,P002553,P009035,0 days 00:06:53,-3,13,16
268,RED,P002553,P006436,0 days 00:05:19,-2,9,11
268,RED,P002553,P005099,0 days 00:05:05,-2,9,11
268,RED,P002553,P012801,0 days 00:05:05,-2,9,11
268,RED,P006436,P011941,0 days 00:04:47,-4,6,10
268,RED,P000848,P011941,0 days 00:04:47,-4,6,10
268,RED,P006436,P007960,0 days 00:04:29,-1,9,10
268,RED,P000848,P002553,0 days 00:04:16,-5,8,13
268,RED,P002553,PJDR,0 days 00:04:16,-5,8,13
268,RED,P006436,PJDR,0 days 00:04:16,1,13,12
268,RED,P007960,P011941,0 days 00:03:44,-6,2,8
268,RED,P000848,P008966,0 days 00:03:09,-2,9,11
268,RED,P008966,PJDR,0 days 00:03:09,-2,9,11
268,RED,P008966,P009035,0 days 00:03:04,-5,7,12
268,RED,P006436,P008966,0 days 00:03:04,-5,7,12
268,RED,P005099,P011941,0 days 00:02:50,-1,2,3
268,RED,P006436,P011964,0 days 00:02:18,2,6,4
268,RED,P002553,P008966,0 days 00:02:14,-4,4,8
268,RED,P002553,P007960,0 days 00:02:11,-3,4,7
268,RED,P008966,P012801,0 days 00:02:09,-7,2,9
268,RED,P005099,P008966,0 days 00:02:09,-7,2,9
268,RED,P011941,PJDR,0 days 00:01:57,-3,4,7
268,RED,P004720,PJDR,0 days 00:01:51,-2,4,6
268,RED,P004720,P008966,0 days 00:01:51,-2,4,6
268,RED,P002553,P004720,0 days 00:01:51,-2,4,6
268,RED,P000848,P004720,0 days 00:01:51,-2,4,6
268,RED,P011941,P011964,0 days 00:01:03,2,4,2
268,RED,P012801,PJDR,0 days 00:00:52,-5,0,5
268,RED,P007960,P008966,0 days 00:00:23,-2,0,2
268,RED,P002553,P011964,0 days 00:00:14,0,0,0
268,RED,P004720,P006436,0 days 00:00:13,0,2,2
268,RED,P004720,P007960,0 days 00:00:13,0,2,2
268,RED,P004720,P009035,0 days 00:00:13,0,2,2
268,RED,P004720,P012801,0 days 00:00:13,0,2,2
268,RED,P005099,PJDR,0 days 00:00:09,2,2,0
268,RED,P000848,P012801,0 days 00:00:03,0,0,0
268,PAN,P003842,P012774,0 days 00:34:33,15,78,63
268,PAN,P007866,P012774,0 days 00:29:51,9,66,57
268,PAN,P003842,P007866,0 days 00:28:54,13,61,48
268,PAN,P003842,P011204,0 days 00:28:12,8,59,51
268,PAN,P011204,P012774,0 days 00:27:38,8,61,53
268,PAN,P001926,P012774,0 days 00:24:54,9,62,53
268,PAN,P002328,P007866,0 days 00:24:29,11,53,42
268,PAN,P001926,P003842,0 days 00:24:04,13,57,44
268,PAN,P002328,P003842,0 days 00:22:45,15,48,33
268,PAN,P002328,P012774,0 days 00:22:14,10,50,40
268,PAN,P007866,P011204,0 days 00:21:59,6,44,38
268,PAN,P001926,P007866,0 days 00:19:15,7,45,38
268,PAN,P001926,P011204,0 days 00:17:05,6,40,34
268,PAN,P002328,P011204,0 days 00:14:22,7,28,21
268,PAN,P001926,P002328,0 days 00:12:32,5,30,25
268,PAN,P012712,P012774,0 days 00:08:42,1,20,19
268,PAN,P011204,P012712,0 days 00:08:39,1,20,19
268,PAN,P003842,P012712,0 days 00:08:27,1,20,19
268,PAN,P001926,P012712,0 days 00:08:06,3,20,17
268,PAN,P001926,P007553,0 days 00:02:40,-3,6,9
268,PAN,P007553,P007866,0 days 00:02:40,-3,6,9
268,PAN,P007553,P012774,0 days 00:02:40,-3,6,9
268,PAN,P002328,P007553,0 days 00:01:28,-4,3,7
268,PAN,P007553,P011204,0 days 00:01:12,1,3,2
268,PAN,P007866,P012712,0 days 00:00:48,-2,0,2
268,PAN,P011209,P012774,0 days 00:00:24,-1,1,2
268,PAN,P007866,P011209,0 days 00:00:24,-1,1,2
268,PAN,P011204,P011209,0 days 00:00:21,-1,1,2
268,PAN,P003842,P011209,0 days 00:00:17,-1,1,2
268,PAN,P006544,P007866,0 days 00:00:04,0,0,0
268,PAN,P006544,P011204,0 days 00:00:04,0,0,0
268,PAN,P006544,P011209,0 days 00:00:04,0,0,0
268,PAN,P006544,P012774,0 days 00:00:04,0,0,0
268,PAN,P002328,P011209,0 days 00:00:03,0,0,0
268,PAN,P002328,P012712,0 days 00:00:03,0,0,0
268,PAN,P011209,P012712,0 days 00:00:03,0,0,0
269,ULK,P001932,P008962,0 days 00:21:38,9,44,35
269,ULK,P001932,P011157,0 days 00:20:25,6,43,37
269,ULK,P008962,P011157,0 days 00:19:05,3,39,36
269,ULK,P004004,P008962,0 days 00:16:13,-2,33,35
269,ULK,P006661,P006961,0 days 00:15:58,18,47,29
269,ULK,P006961,P008962,0 days 00:14:22,10,34,24
269,ULK,P002968,P004004,0 days 00:13:57,10,34,24
269,ULK,P001932,P006961,0 days 00:13:57,11,34,23
269,ULK,P004004,P006661,0 days 00:13:56,9,36,27
269,ULK,P006661,P008962,0 days 00:13:53,7,35,28
269,ULK,P001932,P006661,0 days 00:13:44,4,32,28
269,ULK,P008962,P010560,0 days 00:13:40,-5,23,28
269,ULK,P006961,P011157,0 days 00:12:42,5,34,29
269,ULK,P008962,P009849,0 days 00:12:26,-1,20,21
269,ULK,P006661,P011157,0 days 00:11:42,3,31,28
269,ULK,P004004,P006961,0 days 00:11:26,13,31,18
269,ULK,P009849,P010560,0 days 00:11:16,-3,18,21
269,ULK,P002968,P008962,0 days 00:10:49,2,24,22
269,ULK,P009849,P011157,0 days 00:10:36,5,20,15
269,ULK,P002968,P006661,0 days 00:10:36,13,29,16
269,ULK,P010560,P011157,0 days 00:10:05,0,18,18
269,ULK,P006068,P006661,0 days 00:08:59,9,25,16
269,ULK,P001932,P004004,0 days 00:08:39,-1,16,17
269,ULK,P001932,P009849,0 days 00:08:19,4,14,10
269,ULK,P006068,P006961,0 days 00:08:19,6,23,17
269,ULK,P002968,P006961,0 days 00:08:01,14,23,9
269,ULK,P004004,P011157,0 days 00:07:57,-4,16,20
269,ULK,P001932,P010560,0 days 00:07:09,2,12,10
269,ULK,P004004,P006068,0 days 00:06:47,8,17,9
269,ULK,P004004,P010560,0 days 00:06:13,-4,11,15
269,ULK,P006068,P011157,0 days 00:05:48,-2,15,17
269,ULK,P001932,P002968,0 days 00:04:55,4,11,7
269,ULK,P001932,P006068,0 days 00:04:16,1,10,9
269,ULK,P004004,P009849,0 days 00:04:07,-5,6,11
269,ULK,P002968,P010560,0 days 00:03:35,-5,5,10
269,ULK,P002968,P006068,0 days 00:03:29,8,10,2
269,ULK,P006661,P010560,0 days 00:02:06,1,5,4
269,ULK,P002968,P009849,0 days 00:01:50,-6,0,6
269,ULK,P006961,P009849,0 days 00:01:10,2,2,0
269,ULK,P005844,P006961,0 days 00:01:07,0,0,0
269,ULK,P005844,P008962,0 days 00:01:07,0,0,0
269,ULK,P006068,P008962,0 days 00:00:51,-3,0,3
269,ULK,P001932,P005844,0 days 00:00:34,0,0,0
269,ULK,P005844,P006661,0 days 00:00:34,0,0,0
269,ULK,P004004,P005844,0 days 00:00:33,0,0,0
269,ULK,P005844,P006068,0 days 00:00:33,0,0,0
269,ULK,P006068,P010560,0 days 00:00:18,-3,0,3
269,ULK,P006961,P010560,0 days 00:00:18,-3,0,3
269,BAR,P002939,P012745,0 days 00:21:05,-17,33,50
269,BAR,P000925,P002939,0 days 00:17:31,-9,31,40
269,BAR,P000925,P012745,0 days 00:16:17,-9,26,35
269,BAR,P003196,PLFW,0 days 00:15:30,-1,33,34
269,BAR,P002939,P006435,0 days 00:15:19,-8,27,35
269,BAR,P000925,P006435,0 days 00:13:57,-10,23,33
269,BAR,P011244,PLFW,0 days 00:13:18,4,26,22
269,BAR,P002939,P004866,0 days 00:12:52,-16,14,30
269,BAR,P004866,P012745,0 days 00:12:52,-16,14,30
269,BAR,P003196,P011244,0 days 00:12:49,8,28,20
269,BAR,P006435,P012745,0 days 00:12:16,-7,20,27
269,BAR,P000925,P004866,0 days 00:11:27,-15,12,27
269,BAR,P009992,PLFW,0 days 00:11:09,8,31,23
269,BAR,P003478,P012745,0 days 00:09:19,6,23,17
269,BAR,P002939,P003478,0 days 00:09:12,7,22,15
269,BAR,P003196,P009992,0 days 00:08:57,8,24,16
269,BAR,P003478,PLFW,0 days 00:08:56,-4,16,20
269,BAR,P003478,P011244,0 days 00:08:49,-3,15,18
269,BAR,P004866,P006435,0 days 00:08:46,-14,10,24
269,BAR,P009992,P011244,0 days 00:08:20,13,24,11
269,BAR,P012745,PLFW,0 days 00:07:55,-9,16,25
269,BAR,P000925,P003478,0 days 00:07:52,3,15,12
269,BAR,P003196,P003478,0 days 00:07:37,-2,15,17
269,BAR,P002939,PLFW,0 days 00:07:27,-6,13,19
269,BAR,P006435,PLFW,0 days 00:07:24,-10,6,16
269,BAR,P003478,P006435,0 days 00:07:13,0,15,15
269,BAR,P006435,P011244,0 days 00:07:05,-9,9,18
269,BAR,P002939,P003196,0 days 00:06:54,-6,9,15
269,BAR,P002939,P009992,0 days 00:06:49,-5,14,19
269,BAR,P003196,P004866,0 days 00:05:39,3,13,10
269,BAR,P009992,P012745,0 days 00:05:33,-6,12,18
269,BAR,P003196,P006435,0 days 00:05:24,-6,6,12
269,BAR,P002939,P011244,0 days 00:05:09,2,12,10
269,BAR,P003196,P012745,0 days 00:05:01,-11,7,18
269,BAR,P003478,P009992,0 days 00:04:58,6,14,8
269,BAR,P000925,PLFW,0 days 00:04:53,-6,6,12
269,BAR,P004866,P011244,0 days 00:04:50,5,13,8
269,BAR,P004866,P009992,0 days 00:04:50,5,13,8
269,BAR,P004866,PLFW,0 days 00:04:50,5,13,8
269,BAR,P003196,P007519,0 days 00:03:29,-5,5,10
269,BAR,P003478,P004866,0 days 00:03:17,0,4,4
269,BAR,P000925,P011244,0 days 00:03:14,-4,5,9
269,BAR,P000925,P009992,0 days 00:02:53,-2,6,8
269,BAR,P007519,P012745,0 days 00:02:51,-5,5,10
269,BAR,P003478,P007519,0 days 00:02:40,-3,5,8
269,BAR,P007519,PLFW,0 days 00:02:40,-3,5,8
269,BAR,P010641,P012745,0 days 00:02:39,2,8,6
269,BAR,P003478,P010641,0 days 00:02:39,2,8,6
269,BAR,P009992,P010641,0 days 00:02:03,1,6,5
269,BAR,P002939,P010641,0 days 00:01:49,0,5,5
269,BAR,P010641,PLFW,0 days 00:00:50,2,3,1
269,BAR,P002939,P007519,0 days 00:00:49,-2,0,2
269,BAR,P004866,P007519,0 days 00:00:49,-2,0,2
269,BAR,P007519,P011244,0 days 00:00:38,0,0,0
269,BAR,P004866,P010641,0 days 00:00:36,1,2,1
270,PAM,P010568,P011982,0 days 00:25:22,8,49,41
270,PAM,P004863,P011982,0 days 00:25:21,9,45,36
270,PAM,P010393,P011982,0 days 00:25:13,13,51,38
270,PAM,P004863,P010393,0 days 00:23:14,9,44,35
270,PAM,P010393,P010568,0 days 00:21:49,10,46,36
270,PAM,P004863,P010568,0 days 00:21:23,6,40,34
270,PAM,P003960,P010568,0 days 00:20:30,6,44,38
270,PAM,P003960,P011982,0 days 00:19:15,8,41,33
270,PAM,P003960,P010393,0 days 00:17:49,10,42,32
270,PAM,P003960,P004863,0 days 00:16:57,7,34,27
270,PAM,P005356,P012795,0 days 00:09:21,-1,13,14
270,PAM,P000556,P005356,0 days 00:08:49,-4,15,19
270,PAM,P000556,P012795,0 days 00:08:25,-5,12,17
270,PAM,P006433,P012795,0 days 00:08:02,-2,13,15
270,PAM,P000556,P012739,0 days 00:07:54,-10,7,17
270,PAM,P010568,P012795,0 days 00:07:47,-2,11,13
270,PAM,P004863,P012795,0 days 00:07:15,-1,7,8
270,PAM,P011982,P012795,0 days 00:06:49,1,6,5
270,PAM,P000556,P006433,0 days 00:06:39,-2,11,13
270,PAM,P005356,P006433,0 days 00:06:39,-2,11,13
270,PAM,P012739,P012795,0 days 00:06:36,-10,5,15
270,PAM,P010393,P012795,0 days 00:06:22,0,7,7
270,PAM,P010568,P012739,0 days 00:06:14,-5,7,12
270,PAM,P003960,P012795,0 days 00:06:03,-2,9,11
270,PAM,P006433,P012739,0 days 00:05:28,-10,4,14
270,PAM,P003960,P006433,0 days 00:05:18,2,11,9
270,PAM,P005356,P011982,0 days 00:04:51,-1,6,7
270,PAM,P010568,P012740,0 days 00:04:40,0,8,8
270,PAM,P005356,P010393,0 days 00:04:38,-1,6,7
270,PAM,P000556,P011982,0 days 00:04:37,-1,8,9
270,PAM,P004863,P005356,0 days 00:04:24,1,6,5
270,PAM,P000556,P010568,0 days 00:04:18,1,8,7
270,PAM,P003960,P005356,0 days 00:03:42,-1,6,7
270,PAM,P005356,P012739,0 days 00:03:41,-8,2,10
270,PAM,P011982,P012739,0 days 00:03:19,-3,4,7
270,PAM,P000556,P004863,0 days 00:03:15,-2,6,8
270,PAM,P011982,P012740,0 days 00:03:08,2,7,5
270,PAM,P000556,P003960,0 days 00:03:00,1,6,5
270,PAM,P000556,P012740,0 days 00:02:54,-1,3,4
270,PAM,P012739,P012740,0 days 00:02:54,-1,3,4
270,PAM,P006433,P010568,0 days 00:02:37,3,8,5
270,PAM,P000556,P010393,0 days 00:02:17,-1,4,5
270,PAM,P003960,P012739,0 days 00:02:15,-4,2,6
270,PAM,P010393,P012740,0 days 00:01:46,1,5,4
270,PAM,P012740,P012795,0 days 00:01:32,-2,1,3
270,PAM,P003960,P012740,0 days 00:01:27,1,5,4
270,PAM,P004863,P012739,0 days 00:01:19,-1,2,3
270,PAM,P006433,P011982,0 days 00:01:09,0,3,3
270,PAM,P006433,P010393,0 days 00:00:52,3,3,0
270,PAM,P005356,P010568,0 days 00:00:32,1,3,2
270,PAM,P005356,P012740,0 days 00:00:19,0,0,0
270,MUN,P001288,P011987,0 days 00:22:56,-1,40,41
270,MUN,P001288,P003583,0 days 00:20:31,2,35,33
270,MUN,P003583,P011987,0 days 00:19:35,4,35,31
270,MUN,P001288,P007056,0 days 00:19:32,-9,30,39
270,MUN,P007975,P010391,0 days 00:17:13,-3,24,27
270,MUN,P001288,P008985,0 days 00:16:38,-3,29,32
270,MUN,P008985,P011987,0 days 00:16:38,-3,29,32
270,MUN,P007056,P011987,0 days 00:16:35,-6,27,33
270,MUN,P003583,P008985,0 days 00:14:53,5,29,24
270,MUN,P007056,P008985,0 days 00:14:08,-8,21,29
270,MUN,P003583,P007056,0 days 00:13:11,-2,21,23
270,MUN,P001557,P007975,0 days 00:10:40,3,21,18
270,MUN,P001288,P007975,0 days 00:10:24,-2,15,17
270,MUN,P007056,P010391,0 days 00:10:22,-7,14,21
270,MUN,P007056,P007975,0 days 00:10:21,-5,16,21
270,MUN,P001288,P010391,0 days 00:10:19,1,14,13
270,MUN,P001557,P010391,0 days 00:08:53,0,16,16
270,MUN,P005460,P007975,0 days 00:08:38,7,20,13
270,MUN,P005460,P010391,0 days 00:07:08,6,17,11
270,MUN,P010391,P011987,0 days 00:07:07,3,10,7
270,MUN,P006543,P007975,0 days 00:06:57,4,14,10
270,MUN,P001557,P005460,0 days 00:06:52,4,16,12
270,MUN,P006543,P010391,0 days 00:06:41,3,13,10
270,MUN,P003583,P010391,0 days 00:06:41,1,8,7
270,MUN,P005460,P006543,0 days 00:06:24,6,14,8
270,MUN,P006760,P010391,0 days 00:06:07,0,9,9
270,MUN,P006760,P007056,0 days 00:06:05,-11,5,16
270,MUN,P007975,P011987,0 days 00:05:55,1,10,9
270,MUN,P001557,P006543,0 days 00:05:44,2,11,9
270,MUN,P001557,P007056,0 days 00:05:41,-3,8,11
270,MUN,P003583,P007975,0 days 00:05:38,-3,6,9
270,MUN,P006760,P007975,0 days 00:04:48,1,8,7
270,MUN,P001288,P006760,0 days 00:04:31,-9,5,14
270,MUN,P005478,P007975,0 days 00:04:27,0,11,11
270,MUN,P006760,P011987,0 days 00:03:03,-9,1,10
270,MUN,P005478,P007056,0 days 00:03:00,1,7,6
270,MUN,P001288,P005478,0 days 00:02:59,1,8,7
270,MUN,P005478,P011987,0 days 00:02:59,1,8,7
270,MUN,P006543,P006760,0 days 00:02:51,1,4,3
270,MUN,P008985,P010391,0 days 00:02:38,5,8,3
270,MUN,P001557,P005478,0 days 00:02:06,-1,3,4
270,MUN,P005460,P007056,0 days 00:02:01,0,5,5
270,MUN,P006543,P007056,0 days 00:01:56,-2,2,4
270,MUN,P005478,P010391,0 days 00:01:47,-1,3,4
270,MUN,P005460,P006760,0 days 00:01:47,3,4,1
270,MUN,P006760,P008985,0 days 00:01:45,-8,0,8
270,MUN,P006543,P011987,0 days 00:01:41,0,2,2
270,MUN,P006543,P008985,0 days 00:01:39,1,3,2
270,MUN,P007975,P008985,0 days 00:01:39,1,3,2
270,MUN,P001557,P008985,0 days 00:01:39,1,3,2
270,MUN,P005460,P008985,0 days 00:01:31,1,3,2
270,MUN,P003583,P005478,0 days 00:01:27,-1,4,5
270,MUN,P001288,P001557,0 days 00:01:15,2,2,0
270,MUN,P001557,P006760,0 days 00:00:31,0,0,0
270,MUN,P001557,P011987,0 days 00:00:27,2,2,0
270,MUN,P001288,P006543,0 days 00:00:24,1,1,0
270,MUN,P005478,P006543,0 days 00:00:19,0,0,0
270,MUN,P001288,P005460,0 days 00:00:15,1,1,0
270,MUN,P001557,P003583,0 days 00:00:08,2,2,0
271,IST,P009846,P011078,0 days 00:21:00,15,54,39
271,IST,P009664,P009846,0 days 00:20:02,11,48,37
271,IST,P006590,P009664,0 days 00:19:34,14,48,34
271,IST,P009664,P011078,0 days 00:18:57,11,47,36
271,IST,P009846,P011981,0 days 00:17:21,12,43,31
271,IST,P006590,P009846,0 days 00:17:15,15,43,28
271,IST,P006590,P011078,0 days 00:16:10,15,42,27
271,IST,P009664,P011981,0 days 00:15:58,14,39,25
271,IST,P004888,P012710,0 days 00:14:40,-14,24,38
271,IST,P011078,P011981,0 days 00:14:31,11,37,26
271,IST,P012710,PLHK,0 days 00:14:19,-4,26,30
271,IST,P006590,P011981,0 days 00:13:43,15,36,21
271,IST,P007200,P012710,0 days 00:13:36,-1,26,27
271,IST,P007200,PLHK,0 days 00:13:34,-2,28,30
271,IST,P004888,P009513,0 days 00:12:43,-10,20,30
271,IST,P009513,P012710,0 days 00:12:43,-10,20,30
271,IST,P004888,PLHK,0 days 00:11:20,-9,18,27
271,IST,P009513,PLHK,0 days 00:11:20,-9,18,27
271,IST,P004888,P007200,0 days 00:10:37,-6,18,24
271,IST,P007200,P009513,0 days 00:10:03,-4,18,22
271,IST,P004888,P006590,0 days 00:08:09,-6,13,19
271,IST,P004888,P009664,0 days 00:07:44,-1,14,15
271,IST,P004888,P011981,0 days 00:07:22,-4,13,17
271,IST,P006590,P012788,0 days 00:07:14,-2,14,16
271,IST,P004888,P009846,0 days 00:06:48,-2,13,15
271,IST,P004888,P011078,0 days 00:06:31,-6,12,18
271,IST,P009664,P012788,0 days 00:05:51,-1,12,13
271,IST,P011078,P012788,0 days 00:05:51,-1,12,13
271,IST,P011078,P012710,0 days 00:04:56,1,12,11
271,IST,P009846,P012710,0 days 00:04:22,3,12,9
271,IST,P007200,P011078,0 days 00:04:05,0,10,10
271,IST,P004888,P012788,0 days 00:03:42,-2,7,9
271,IST,P009846,P012788,0 days 00:03:32,0,7,7
271,IST,P007200,P009846,0 days 00:03:31,2,10,8
271,IST,P009846,PLHK,0 days 00:03:31,2,10,8
271,IST,P011078,PLHK,0 days 00:03:31,2,10,8
271,IST,P006590,P009513,0 days 00:02:54,-8,2,10
271,IST,P006590,P012710,0 days 00:02:40,-6,2,8
271,IST,P011981,P012710,0 days 00:01:57,-4,4,8
271,IST,P009513,P012788,0 days 00:01:23,-1,2,3
271,IST,P012710,P012788,0 days 00:01:23,-1,2,3
271,IST,P006590,PLHK,0 days 00:01:17,-5,0,5
271,IST,P007200,P011981,0 days 00:00:34,-2,0,2
271,IST,P007200,P009664,0 days 00:00:32,-3,2,5
271,IST,P009664,PLHK,0 days 00:00:32,-3,2,5
271,IST,P009513,P009664,0 days 00:00:14,-2,0,2
271,IST,P009513,P009846,0 days 00:00:14,-2,0,2
271,IST,P009513,P011981,0 days 00:00:14,-2,0,2
271,BER,P008780,P008967,0 days 00:24:24,11,58,47
271,BER,P003958,P008967,0 days 00:23:01,9,52,43
271,BER,P003958,P008780,0 days 00:23:01,9,52,43
271,BER,P006919,P010791,0 days 00:21:13,3,43,40
271,BER,P003958,P006919,0 days 00:20:17,9,46,37
271,BER,P006919,P008780,0 days 00:20:08,11,50,39
271,BER,P006919,P008967,0 days 00:20:08,11,50,39
271,BER,P003958,P010791,0 days 00:19:11,4,39,35
271,BER,P008780,P010791,0 days 00:17:39,4,37,33
271,BER,P008967,P010791,0 days 00:17:39,4,37,33
271,BER,P011934,P012720,0 days 00:15:39,-4,28,32
271,BER,P007025,P008211,0 days 00:14:13,-13,23,36
271,BER,P008211,P012720,0 days 00:14:04,-12,24,36
271,BER,P006251,P011934,0 days 00:12:46,-2,26,28
271,BER,P007025,P012720,0 days 00:12:41,-13,21,34
271,BER,P006251,P008211,0 days 00:12:02,-11,20,31
271,BER,P006251,P012720,0 days 00:12:02,-11,20,31
271,BER,P008211,P011934,0 days 00:11:23,-4,20,24
271,BER,P006251,P007025,0 days 00:10:39,-12,17,29
271,BER,P007025,P011934,0 days 00:10:00,-5,17,22
271,BER,P008967,P011934,0 days 00:08:08,8,24,16
271,BER,P008780,P011934,0 days 00:06:45,7,21,14
271,BER,P008967,P012720,0 days 00:05:39,1,11,10
271,BER,P003958,P011934,0 days 00:05:22,5,15,10
271,BER,P008780,P012720,0 days 00:04:16,0,8,8
271,BER,P003958,P012720,0 days 00:04:16,0,8,8
271,BER,P007025,P010791,0 days 00:04:13,-8,6,14
271,BER,P008211,P010791,0 days 00:04:13,-8,6,14
271,BER,P006919,P007025,0 days 00:03:34,-1,6,7
271,BER,P006919,P008211,0 days 00:03:34,-1,6,7
271,BER,P006251,P008967,0 days 00:02:46,3,9,6
271,BER,P010791,P012720,0 days 00:02:41,-8,4,12
271,BER,P006919,P011934,0 days 00:02:29,7,13,6
271,BER,P006919,P012720,0 days 00:02:02,-1,4,5
271,BER,P003958,P007025,0 days 00:01:32,0,2,2
271,BER,P003958,P008211,0 days 00:01:32,0,2,2
271,BER,P006251,P006919,0 days 00:01:23,2,6,4
271,BER,P006251,P008780,0 days 00:01:23,2,6,4
271,BER,P008211,P008967,0 days 00:01:23,1,3,2
271,BER,P006251,P010791,0 days 00:00:39,-7,0,7
272,OLY,P008811,P008829,0 days 00:23:04,11,45,34
272,OLY,P001255,P008829,0 days 00:20:00,-1,31,32
272,OLY,P007853,P010392,0 days 00:19:39,19,49,30
272,OLY,P008829,P008855,0 days 00:19:08,-2,32,34
272,OLY,P001255,P010612,0 days 00:18:41,3,29,26
272,OLY,P008829,P010612,0 days 00:18:41,3,29,26
272,OLY,P001255,P008811,0 days 00:18:24,2,31,29
272,OLY,P008811,P010612,0 days 00:17:05,6,29,23
272,OLY,P008811,P008855,0 days 00:16:55,2,28,26
272,OLY,P001255,P008855,0 days 00:16:34,4,28,24
272,OLY,P007853,P007982,0 days 00:16:08,16,37,21
272,OLY,P007982,P010392,0 days 00:15:47,18,37,19
272,OLY,P007853,P012878,0 days 00:15:20,8,35,27
272,OLY,P010392,P012878,0 days 00:15:20,8,35,27
272,OLY,P008855,P010612,0 days 00:15:15,8,26,18
272,OLY,P007982,P008829,0 days 00:15:06,6,31,25
272,OLY,P007982,P012878,0 days 00:13:04,4,23,19
272,OLY,P007853,P008829,0 days 00:12:34,11,30,19
272,OLY,P008829,P010392,0 days 00:12:13,13,30,17
272,OLY,P008829,P012878,0 days 00:09:30,-1,16,17
272,OLY,P007982,P008811,0 days 00:07:49,3,19,16
272,OLY,P007853,P011194,0 days 00:07:26,6,19,13
272,OLY,P011194,P012878,0 days 00:07:26,6,19,13
272,OLY,P010392,P011194,0 days 00:07:26,6,19,13
272,OLY,P007982,P011194,0 days 00:05:47,1,11,10
272,OLY,P001255,P007982,0 days 00:04:45,-9,5,14
272,OLY,P007853,P008811,0 days 00:04:40,9,14,5
272,OLY,P008811,P010392,0 days 00:04:19,11,14,3
272,OLY,P007853,P008855,0 days 00:04:13,-1,12,13
272,OLY,P008855,P010392,0 days 00:03:52,1,12,11
272,OLY,P008855,P012878,0 days 00:03:52,1,12,11
272,OLY,P007982,P010612,0 days 00:03:26,-5,3,8
272,OLY,P007982,P008855,0 days 00:01:40,-6,2,8
272,OLY,P008855,P011194,0 days 00:01:39,5,8,3
272,OLY,P001255,P012878,0 days 00:01:36,-3,0,3
272,OLY,P010612,P012878,0 days 00:01:36,-3,0,3
272,ASV,P011225,P012080,0 days 00:21:26,-16,32,48
272,ASV,P004194,P012080,0 days 00:17:56,-1,30,31
272,ASV,P011225,P012729,0 days 00:16:13,-18,24,42
272,ASV,P006568,P011225,0 days 00:15:52,-12,27,39
272,ASV,P004194,P012731,0 days 00:14:45,2,22,20
272,ASV,P002100,P012731,0 days 00:14:38,-6,20,26
272,ASV,P006568,P012729,0 days 00:14:29,-14,21,35
272,ASV,P012080,P012729,0 days 00:14:21,-11,26,37
272,ASV,P000229,P012080,0 days 00:13:50,2,29,27
272,ASV,P000229,P011225,0 days 00:13:50,2,29,27
272,ASV,P002100,PKIR,0 days 00:13:04,-5,19,24
272,ASV,P012080,P012731,0 days 00:12:35,0,19,19
272,ASV,P004194,P011225,0 days 00:12:26,-6,17,23
272,ASV,P002100,P004194,0 days 00:12:23,-7,16,23
272,ASV,P011225,P012731,0 days 00:12:05,0,20,20
272,ASV,P002100,P011386,0 days 00:11:42,2,20,18
272,ASV,P006568,PKIR,0 days 00:11:25,-8,16,24
272,ASV,P002100,P011225,0 days 00:11:23,-14,12,26
272,ASV,P002100,P006568,0 days 00:10:42,-5,16,21
272,ASV,P002100,P012080,0 days 00:10:01,-7,13,20
272,ASV,P011225,PKIR,0 days 00:09:57,-8,15,23
272,ASV,P006568,P012080,0 days 00:09:00,-10,15,25
272,ASV,P012729,PKIR,0 days 00:08:39,-12,9,21
272,ASV,P000229,P012729,0 days 00:08:37,-5,17,22
272,ASV,P002100,P012729,0 days 00:08:27,-6,12,18
272,ASV,P000229,P006568,0 days 00:08:17,-7,15,22
272,ASV,P011386,P012731,0 days 00:07:53,1,12,11
272,ASV,P004194,P011386,0 days 00:07:52,5,16,11
272,ASV,P012731,PKIR,0 days 00:07:30,1,13,12
272,ASV,P011386,PKIR,0 days 00:06:12,-3,7,10
272,ASV,P000229,P004194,0 days 00:05:33,9,14,5
272,ASV,P004194,P012729,0 days 00:05:33,-3,11,14
272,ASV,P011386,P012080,0 days 00:05:30,5,13,8
272,ASV,P006568,P012731,0 days 00:05:13,-1,10,11
272,ASV,P000229,P012731,0 days 00:05:13,7,12,5
272,ASV,P004194,PKIR,0 days 00:04:44,-3,6,9
272,ASV,P006568,P011386,0 days 00:03:50,-3,4,7
272,ASV,P011386,P012729,0 days 00:03:49,1,8,7
272,ASV,P012080,PKIR,0 days 00:03:05,-6,3,9
273,PAR,P003983,P007400,0 days 00:26:15,-9,60,69
273,PAR,P007400,P009862,0 days 00:25:37,1,62,61
273,PAR,P009862,P012743,0 days 00:24:27,5,55,50
273,PAR,P007400,P012743,0 days 00:21:22,7,56,49
273,PAR,P003983,P009862,0 days 00:19:28,1,51,50
273,PAR,P009862,P012096,0 days 00:18:55,-3,33,36
273,PAR,P007400,P011051,0 days 00:18:02,-16,31,47
273,PAR,P003983,P012743,0 days 00:17:59,3,45,42
273,PAR,P004172,P009862,0 days 00:16:47,-4,24,28
273,PAR,P012096,P012743,0 days 00:14:41,-2,28,30
273,PAR,P007400,P012096,0 days 00:14:29,-11,31,42
273,PAR,P003983,P011051,0 days 00:14:03,-13,27,40
273,PAR,P003983,P012096,0 days 00:12:53,-9,31,40
273,PAR,P009862,P011051,0 days 00:12:09,-8,22,30
273,PAR,P004172,P012743,0 days 00:10:24,6,17,11
273,PAR,P009862,P012742,0 days 00:10:13,3,16,13
273,PAR,P011051,P012743,0 days 00:09:41,1,21,20
273,PAR,P004172,P007400,0 days 00:09:11,-1,19,20
273,PAR,P004172,P012096,0 days 00:08:33,-5,5,10
273,PAR,P012096,P012742,0 days 00:07:41,-10,5,15
273,PAR,P012742,P012743,0 days 00:07:30,7,16,9
273,PAR,P004172,P012742,0 days 00:07:24,4,12,8
273,PAR,P007400,P012742,0 days 00:07:13,-9,11,20
273,PAR,P011051,P012742,0 days 00:06:54,-16,4,20
273,PAR,P000956,P003983,0 days 00:06:30,4,14,10
273,PAR,P000956,P007400,0 days 00:06:30,4,14,10
273,PAR,P003983,P004172,0 days 00:05:51,-2,12,14
273,PAR,P004172,P011051,0 days 00:05:26,-8,7,15
273,PAR,P000956,P011051,0 days 00:04:46,1,9,8
273,PAR,P011051,P012096,0 days 00:04:43,-13,3,16
273,PAR,P000956,P012743,0 days 00:03:37,1,6,5
273,PAR,P004058,P004172,0 days 00:03:32,-6,0,6
273,PAR,P004058,P012096,0 days 00:03:32,-6,0,6
273,PAR,P004058,P009862,0 days 00:03:32,-6,0,6
273,PAR,P000956,P012096,0 days 00:02:53,3,8,5
273,PAR,P004058,P012743,0 days 00:02:35,-4,0,4
273,PAR,P003983,P012742,0 days 00:02:01,-11,0,11
273,PAR,P000956,P009862,0 days 00:01:44,3,5,2
273,PAR,P004058,P007400,0 days 00:00:57,-2,0,2
273,MAD,P001392,P003108,0 days 00:22:13,18,54,36
273,MAD,P003108,P005928,0 days 00:20:10,10,50,40
273,MAD,P005928,P010357,0 days 00:17:59,10,48,38
273,MAD,P003108,P010357,0 days 00:17:53,13,52,39
273,MAD,P003108,P004887,0 days 00:17:45,17,41,24
273,MAD,P003108,P009005,0 days 00:17:06,5,33,28
273,MAD,P005791,P010357,0 days 00:16:08,-4,37,41
273,MAD,P003733,P010357,0 days 00:15:21,-7,26,33
273,MAD,P004887,P009005,0 days 00:14:51,4,27,23
273,MAD,P001392,P005928,0 days 00:14:46,11,39,28
273,MAD,P001392,P004887,0 days 00:13:17,15,28,13
273,MAD,P001392,P009005,0 days 00:11:34,6,19,13
273,MAD,P004887,P005928,0 days 00:10:53,10,22,12
273,MAD,P001392,P010357,0 days 00:10:47,12,35,23
273,MAD,P003108,P005791,0 days 00:10:46,5,32,27
273,MAD,P003108,P003733,0 days 00:10:41,1,29,28
273,MAD,P005928,P009005,0 days 00:09:17,-4,12,16
273,MAD,P001392,P005791,0 days 00:09:04,3,26,23
273,MAD,P003733,P009005,0 days 00:08:37,-3,20,23
273,MAD,P003733,P006540,0 days 00:08:18,-4,14,18
273,MAD,P003733,P010623,0 days 00:08:12,-7,14,21
273,MAD,P006540,P010357,0 days 00:08:09,-5,13,18
273,MAD,P005791,P006540,0 days 00:08:09,-5,13,18
273,MAD,P003733,P005791,0 days 00:08:01,-5,13,18
273,MAD,P005791,P005928,0 days 00:07:59,1,24,23
273,MAD,P003733,P004887,0 days 00:07:33,0,19,19
273,MAD,P003733,P005928,0 days 00:07:20,-2,13,15
273,MAD,P005791,P010623,0 days 00:07:16,-5,9,14
273,MAD,P004887,P010357,0 days 00:06:46,11,18,7
273,MAD,P010357,P010623,0 days 00:06:19,-7,7,14
273,MAD,P006540,P010623,0 days 00:06:19,-7,7,14
273,MAD,P009005,P010623,0 days 00:05:33,4,11,7
273,MAD,P003108,P010623,0 days 00:05:33,4,11,7
273,MAD,P009005,P010357,0 days 00:05:10,-3,8,11
273,MAD,P004887,P010623,0 days 00:04:36,2,9,7
273,MAD,P001392,P010623,0 days 00:03:40,4,4,0
273,MAD,P009005,P011649,0 days 00:02:46,4,7,3
273,MAD,P004887,P011649,0 days 00:02:46,4,7,3
273,MAD,P003108,P011649,0 days 00:02:46,4,7,3
273,MAD,P001392,P011649,0 days 00:02:46,4,7,3
273,MAD,P003108,P006540,0 days 00:02:07,3,7,4
273,MAD,P001392,P003733,0 days 00:01:09,-1,4,5
273,MAD,P005791,P009005,0 days 00:00:57,2,2,0
273,MAD,P004887,P006540,0 days 00:00:17,1,1,0
273,MAD,P006540,P009005,0 days 00:00:17,1,1,0
273,MAD,P001392,P006540,0 days 00:00:08,0,0,0
274,ZAL,P002676,P010390,0 days 00:20:25,15,48,33
274,ZAL,P007513,P011218,0 days 00:19:47,-1,46,47
274,ZAL,P002329,P011218,0 days 00:14:50,-7,27,34
274,ZAL,P002329,P007513,0 days 00:14:46,-4,29,33
274,ZAL,P007513,P010390,0 days 00:14:27,3,32,29
274,ZAL,P002329,P010390,0 days 00:14:12,0,30,30
274,ZAL,P010390,P011218,0 days 00:13:56,-1,29,30
274,ZAL,P003211,P012715,0 days 00:13:33,19,40,21
274,ZAL,P003211,P010390,0 days 00:13:29,13,37,24
274,ZAL,P010390,P012715,0 days 00:13:14,16,38,22
274,ZAL,P002676,P011218,0 days 00:12:53,5,31,26
274,ZAL,P002676,P007513,0 days 00:12:20,3,30,27
274,ZAL,P010390,P012787,0 days 00:11:49,16,30,14
274,ZAL,P012715,P012787,0 days 00:11:32,15,30,15
274,ZAL,P005504,P011218,0 days 00:10:58,3,26,23
274,ZAL,P002676,P012715,0 days 00:10:44,13,27,14
274,ZAL,P002676,P003211,0 days 00:10:09,14,26,12
274,ZAL,P003210,P010390,0 days 00:10:04,6,20,14
274,ZAL,P003210,P007513,0 days 00:09:04,12,24,12
274,ZAL,P005504,P007513,0 days 00:08:43,0,21,21
274,ZAL,P003211,P012787,0 days 00:08:38,14,26,12
274,ZAL,P011218,P012715,0 days 00:07:53,5,19,14
274,ZAL,P002676,P003210,0 days 00:07:22,9,21,12
274,ZAL,P002329,P002676,0 days 00:07:02,-3,15,18
274,ZAL,P003210,P011218,0 days 00:07:01,4,17,13
274,ZAL,P002676,P012787,0 days 00:06:57,10,18,8
274,ZAL,P002329,P005504,0 days 00:06:25,1,14,13
274,ZAL,P002329,P003210,0 days 00:05:59,3,12,9
274,ZAL,P005504,P006860,0 days 00:05:31,-4,11,15
274,ZAL,P002329,P003211,0 days 00:05:23,3,15,12
274,ZAL,P002329,P012787,0 days 00:05:15,6,12,6
274,ZAL,P003211,P011218,0 days 00:05:01,1,12,11
274,ZAL,P007513,P012787,0 days 00:04:42,3,8,5
274,ZAL,P005504,P012715,0 days 00:04:31,3,9,6
274,ZAL,P003210,P003211,0 days 00:04:25,-6,6,12
274,ZAL,P006860,P007513,0 days 00:04:23,-2,9,11
274,ZAL,P006860,P011218,0 days 00:04:23,-2,9,11
274,ZAL,P002329,P006860,0 days 00:04:23,-2,9,11
274,ZAL,P002329,P012715,0 days 00:04:13,7,13,6
274,ZAL,P007513,P012715,0 days 00:03:41,0,10,10
274,ZAL,P003210,P005504,0 days 00:03:25,0,10,10
274,ZAL,P003211,P005504,0 days 00:03:15,0,7,7
274,ZAL,P011218,P012787,0 days 00:02:54,1,4,3
274,ZAL,P003210,P012787,0 days 00:02:41,2,4,2
274,ZAL,P005504,P012787,0 days 00:02:24,1,4,3
274,ZAL,P002676,P005504,0 days 00:02:04,2,8,6
274,ZAL,P003210,P012715,0 days 00:01:39,-2,2,4
274,ZAL,P003210,P006860,0 days 00:01:08,-2,2,4
274,ZAL,P003210,P012784,0 days 00:01:08,-2,2,4
274,ZAL,P003211,P006860,0 days 00:01:08,-2,2,4
274,ZAL,P003211,P012784,0 days 00:01:08,-2,2,4
274,ZAL,P005504,P012784,0 days 00:01:08,-2,2,4
274,ZAL,P006860,P012784,0 days 00:01:08,-2,2,4
274,ZAL,P003211,P007513,0 days 00:00:47,-2,3,5
274,BAS,P004761,P009048,0 days 00:27:19,-5,58,63
274,BAS,P011948,P012201,0 days 00:20:32,-16,36,52
274,BAS,P009048,P012201,0 days 00:19:41,-4,42,46
274,BAS,P009048,P011948,0 days 00:18:53,0,41,41
274,BAS,P010444,P011948,0 days 00:18:22,-6,34,40
274,BAS,P010444,P012201,0 days 00:18:21,-7,32,39
274,BAS,P004761,P011948,0 days 00:18:16,5,43,38
274,BAS,P004761,P010444,0 days 00:17:32,1,36,35
274,BAS,P004761,P012201,0 days 00:16:55,2,40,38
274,BAS,P009048,P010444,0 days 00:14:50,0,30,30
274,BAS,P007230,P009048,0 days 00:14:40,-11,24,35
274,BAS,P004761,P007230,0 days 00:14:36,-4,28,32
274,BAS,P004603,P004761,0 days 00:12:38,-1,30,31
274,BAS,P004603,P009048,0 days 00:12:05,-3,28,31
274,BAS,P007230,P011948,0 days 00:11:18,-3,21,24
274,BAS,P004603,P007230,0 days 00:09:19,0,18,18
274,BAS,P011085,P012201,0 days 00:08:17,-10,14,24
274,BAS,P003198,P007230,0 days 00:08:12,-8,11,19
274,BAS,P010444,P012765,0 days 00:08:02,-2,14,16
274,BAS,P010444,P011085,0 days 00:07:53,-13,10,23
274,BAS,P003198,P009048,0 days 00:07:14,-8,9,17
274,BAS,P011948,P012765,0 days 00:05:46,-4,10,14
274,BAS,P012201,P012765,0 days 00:05:45,-5,8,13
274,BAS,P011085,P011948,0 days 00:05:42,-10,6,16
274,BAS,P004761,P012765,0 days 00:05:23,1,10,9
274,BAS,P004603,P011948,0 days 00:05:12,3,15,12
274,BAS,P004761,P011085,0 days 00:05:09,-5,12,17
274,BAS,P009048,P011085,0 days 00:05:09,-5,12,17
274,BAS,P007230,P010444,0 days 00:04:53,-2,10,12
274,BAS,P007230,P012201,0 days 00:04:41,-6,6,12
274,BAS,P003198,P004761,0 days 00:04:28,-2,7,9
274,BAS,P003198,P004603,0 days 00:04:28,-2,7,9
274,BAS,P003198,P012201,0 days 00:04:17,-4,6,10
274,BAS,P004603,P012201,0 days 00:03:52,1,14,13
274,BAS,P003198,P011948,0 days 00:03:44,-6,4,10
274,BAS,P007230,P012765,0 days 00:03:07,-1,6,7
274,BAS,P007946,P012201,0 days 00:03:03,-7,2,9
274,BAS,P007946,P011948,0 days 00:03:03,-7,2,9
274,BAS,P007946,P011085,0 days 00:03:03,-7,2,9
274,BAS,P007946,P010444,0 days 00:03:03,-7,2,9
274,BAS,P004603,P011085,0 days 00:02:58,-2,8,10
274,BAS,P009048,P012765,0 days 00:02:41,0,4,4
274,BAS,P011085,P012765,0 days 00:02:39,-3,4,7
274,BAS,P007230,P011085,0 days 00:02:34,-5,4,9
274,BAS,P003198,P012765,0 days 00:00:25,-2,0,2
275,MCO,P005985,P010588,0 days 00:23:56,16,56,40
275,MCO,P005985,P008099,0 days 00:23:26,8,53,45
275,MCO,P011196,P011226,0 days 00:19:47,-8,37,45
275,MCO,P008099,P010588,0 days 00:19:13,12,44,32
275,MCO,P005985,P011226,0 days 00:19:09,1,37,36
275,MCO,P005985,PLCZ,0 days 00:16:32,8,36,28
275,MCO,P005985,P011231,0 days 00:15:17,14,38,24
275,MCO,P005985,P011196,0 days 00:14:45,3,31,28
275,MCO,P010588,PLCZ,0 days 00:14:35,8,31,23
275,MCO,P008099,PLCZ,0 days 00:13:58,7,29,22
275,MCO,P008099,P011226,0 days 00:13:53,-6,28,34
275,MCO,P010588,P011226,0 days 00:13:53,0,29,29
275,MCO,P008099,P011231,0 days 00:12:56,4,29,25
275,MCO,P011231,PLCZ,0 days 00:12:48,10,32,22
275,MCO,P011212,P011226,0 days 00:10:47,0,17,17
275,MCO,P010588,P011231,0 days 00:10:27,13,27,14
275,MCO,P011196,P012709,0 days 00:09:36,-12,10,22
275,MCO,P004790,P005985,0 days 00:09:18,-3,15,18
275,MCO,P011196,P011212,0 days 00:09:15,4,17,13
275,MCO,P010588,P011196,0 days 00:09:00,5,25,20
275,MCO,P011226,P012709,0 days 00:08:40,-17,8,25
275,MCO,P008099,P011196,0 days 00:08:38,-7,20,27
275,MCO,P011196,P011231,0 days 00:07:39,-7,10,17
275,MCO,P011231,P012709,0 days 00:07:39,-7,10,17
275,MCO,P011226,P011231,0 days 00:07:31,-7,12,19
275,MCO,P011212,P011231,0 days 00:07:26,-1,15,16
275,MCO,P005985,P011212,0 days 00:07:19,8,16,8
275,MCO,P010588,P011212,0 days 00:05:52,1,12,11
275,MCO,P004790,P011196,0 days 00:05:48,-2,6,8
275,MCO,P004790,P011226,0 days 00:05:40,-2,8,10
275,MCO,P011212,P012709,0 days 00:05:39,-6,8,14
275,MCO,P004790,P011231,0 days 00:04:53,1,11,10
275,MCO,P004790,P008099,0 days 00:04:16,-4,9,13
275,MCO,P011226,PLCZ,0 days 00:04:08,-5,4,9
275,MCO,P004790,P012709,0 days 00:03:17,-3,2,5
275,MCO,P005985,P012709,0 days 00:03:14,-3,2,5
275,MCO,P011212,PLCZ,0 days 00:02:58,-2,7,9
275,MCO,P004790,PLCZ,0 days 00:02:21,-3,5,8
275,MCO,P004790,P011212,0 days 00:01:51,4,4,0
275,MCO,P008099,P012709,0 days 00:01:07,-6,0,6
275,MCO,P008099,P011212,0 days 00:00:45,0,0,0
275,MCO,P010588,P012709,0 days 00:00:24,-3,0,3
275,MCO,P012709,PLCZ,0 days 00:00:24,-3,0,3
275,PAM,P010568,P012795,0 days 00:24:10,-9,42,51
275,PAM,P003960,P010568,0 days 00:23:22,-10,39,49
275,PAM,P003960,P012795,0 days 00:21:22,-13,34,47
275,PAM,P004863,P011982,0 days 00:18:51,14,45,31
275,PAM,P010568,P011982,0 days 00:12:53,14,34,20
275,PAM,P011982,P012795,0 days 00:11:59,7,30,23
275,PAM,P006433,P010568,0 days 00:11:18,-12,19,31
275,PAM,P006433,P012795,0 days 00:11:06,-13,16,29
275,PAM,P003960,P011982,0 days 00:11:01,16,30,14
275,PAM,P000556,P004863,0 days 00:10:54,6,23,17
275,PAM,P000556,P011982,0 days 00:10:45,6,23,17
275,PAM,P003960,P006433,0 days 00:10:10,-11,14,25
275,PAM,P005356,P012795,0 days 00:09:31,-8,16,24
275,PAM,P000556,P012740,0 days 00:08:50,2,17,15
275,PAM,P010393,P012795,0 days 00:08:38,-8,10,18
275,PAM,P004863,P012738,0 days 00:08:35,0,20,20
275,PAM,P010393,P010568,0 days 00:08:30,-8,10,18
275,PAM,P000556,P005356,0 days 00:08:18,-2,14,16
275,PAM,P003960,P005356,0 days 00:08:09,0,17,17
275,PAM,P005356,P011982,0 days 00:08:00,10,24,14
275,PAM,P011982,P012738,0 days 00:07:57,2,24,22
275,PAM,P011982,P012740,0 days 00:07:52,-2,13,15
275,PAM,P005356,P010568,0 days 00:07:33,-4,15,19
275,PAM,P010393,P011982,0 days 00:07:31,0,10,10
275,PAM,P004863,P012740,0 days 00:07:18,-2,13,15
275,PAM,P004863,P012795,0 days 00:07:16,6,18,12
275,PAM,P000556,P010568,0 days 00:06:50,-4,10,14
275,PAM,P004863,P010568,0 days 00:06:48,11,18,7
275,PAM,P000556,P012795,0 days 00:06:41,-5,9,14
275,PAM,P003960,P004863,0 days 00:06:30,12,19,7
275,PAM,P006433,P010393,0 days 00:06:23,-12,6,18
275,PAM,P000556,P003960,0 days 00:06:12,1,15,14
275,PAM,P000556,P010393,0 days 00:06:06,0,6,6
275,PAM,P004863,P010393,0 days 00:06:01,2,8,6
275,PAM,P004863,P005356,0 days 00:05:55,7,16,9
275,PAM,P003960,P010393,0 days 00:05:27,-10,4,14
275,PAM,P010568,P012738,0 days 00:05:18,2,13,11
275,PAM,P000556,P012738,0 days 00:05:08,0,11,11
275,PAM,P012738,P012795,0 days 00:05:07,-5,9,14
275,PAM,P003960,P012738,0 days 00:04:56,0,9,9
275,PAM,P010393,P012740,0 days 00:04:38,0,4,4
275,PAM,P012738,P012740,0 days 00:04:07,-1,10,11
275,PAM,P006433,P012738,0 days 00:03:00,-2,7,9
275,PAM,P006433,P011982,0 days 00:02:55,1,11,10
275,PAM,P012740,P012795,0 days 00:02:22,4,4,0
275,PAM,P005356,P012738,0 days 00:02:16,0,9,9
275,PAM,P010568,P012740,0 days 00:02:14,4,4,0
275,PAM,P005356,P010393,0 days 00:02:10,0,2,2
275,PAM,P003960,P012740,0 days 00:00:47,3,3,0
275,PAM,P005356,P006433,0 days 00:00:12,1,3,2
275,PAM,P004863,P006433,0 days 00:00:08,0,0,0
276,MIL,P000796,P007831,0 days 00:26:43,7,55,48
276,MIL,P007831,P011224,0 days 00:24:36,7,51,44
276,MIL,P000796,P011224,0 days 00:23:28,7,48,41
276,MIL,P002849,P007831,0 days 00:21:02,1,44,43
276,MIL,P007831,P011205,0 days 00:19:18,6,38,32
276,MIL,P002849,P011224,0 days 00:19:13,6,40,34
276,MIL,P000796,P002849,0 days 00:18:10,1,36,35
276,MIL,P002849,P006509,0 days 00:17:18,-10,33,43
276,MIL,P000796,P011205,0 days 00:16:05,10,35,25
276,MIL,P011205,P011224,0 days 00:15:10,8,31,23
276,MIL,P006509,P007831,0 days 00:14:26,-8,30,38
276,MIL,P006509,P011224,0 days 00:12:40,-5,26,31
276,MIL,P009960,P011205,0 days 00:11:47,4,23,19
276,MIL,P007201,P011205,0 days 00:11:41,-6,17,23
276,MIL,P000796,P006509,0 days 00:11:34,-8,22,30
276,MIL,P002849,P011205,0 days 00:10:24,2,19,17
276,MIL,P006509,P007201,0 days 00:09:47,-2,19,21
276,MIL,P006509,P011205,0 days 00:09:00,-7,13,20
276,MIL,P005670,P009960,0 days 00:08:40,3,16,13
276,MIL,P005670,P011205,0 days 00:08:40,3,16,13
276,MIL,P007201,P009960,0 days 00:07:33,-4,11,15
276,MIL,P005670,P007201,0 days 00:07:30,-2,11,13
276,MIL,P007831,P009960,0 days 00:07:27,4,15,11
276,MIL,P007201,P007831,0 days 00:07:21,-4,14,18
276,MIL,P002849,P007201,0 days 00:05:44,-2,11,13
276,MIL,P007201,P011224,0 days 00:04:44,-2,9,11
276,MIL,P005670,P007831,0 days 00:04:23,1,8,7
276,MIL,P000796,P009960,0 days 00:04:14,8,12,4
276,MIL,P006509,P009960,0 days 00:04:03,0,8,8
276,MIL,P005670,P006509,0 days 00:04:00,2,8,6
276,MIL,P002849,P006701,0 days 00:03:45,-2,5,7
276,MIL,P009960,P011224,0 days 00:03:24,1,7,6
276,MIL,P000796,P002812,0 days 00:03:03,-2,4,6
276,MIL,P002812,P011224,0 days 00:03:03,-2,4,6
276,MIL,P002812,P011205,0 days 00:03:03,-2,4,6
276,MIL,P002812,P007831,0 days 00:03:03,-2,4,6
276,MIL,P006701,P007831,0 days 00:02:53,0,5,5
276,MIL,P006509,P006701,0 days 00:02:36,-2,5,7
276,MIL,P006701,P007201,0 days 00:02:36,-2,5,7
276,MIL,P000796,P007201,0 days 00:01:16,0,3,3
276,MIL,P000796,P005670,0 days 00:01:10,5,5,0
276,MIL,P000796,P006701,0 days 00:01:09,0,0,0
276,MIL,P006701,P011224,0 days 00:01:09,0,0,0
276,MIL,P006701,P011205,0 days 00:00:52,-2,0,2
276,MIL,P005670,P011224,0 days 00:00:17,0,0,0
276,ULK,P006661,P006961,0 days 00:22:29,10,49,39
276,ULK,P006661,P008962,0 days 00:18:21,14,42,28
276,ULK,P004004,P006661,0 days 00:18:15,6,38,32
276,ULK,P006961,P008962,0 days 00:18:09,-2,36,38
276,ULK,P004004,P006961,0 days 00:16:20,-2,32,34
276,ULK,P001932,P006961,0 days 00:16:18,-13,25,38
276,ULK,P001932,P008962,0 days 00:16:03,-16,24,40
276,ULK,P004004,P008962,0 days 00:15:40,4,34,30
276,ULK,P004004,P011157,0 days 00:15:16,-3,24,27
276,ULK,P009849,P011157,0 days 00:13:51,0,28,28
276,ULK,P008962,P011157,0 days 00:13:49,-5,27,32
276,ULK,P004004,P009849,0 days 00:12:48,14,30,16
276,ULK,P006661,P011157,0 days 00:12:11,2,24,22
276,ULK,P001932,P011157,0 days 00:12:07,-4,26,30
276,ULK,P001932,P006661,0 days 00:12:06,1,23,22
276,ULK,P008962,P009849,0 days 00:11:26,5,29,24
276,ULK,P001932,P004004,0 days 00:10:31,-7,15,22
276,ULK,P001932,P009849,0 days 00:10:01,2,22,20
276,ULK,P006961,P011157,0 days 00:09:38,-7,18,25
276,ULK,P004004,P011980,0 days 00:08:43,4,15,11
276,ULK,P006661,P009849,0 days 00:08:27,15,26,11
276,ULK,P001932,P005844,0 days 00:06:38,-3,8,11
276,ULK,P005844,P006961,0 days 00:06:38,-3,8,11
276,ULK,P005844,P008962,0 days 00:06:33,-3,8,11
276,ULK,P001932,P011980,0 days 00:06:09,2,11,9
276,ULK,P006068,P011157,0 days 00:05:54,-7,10,17
276,ULK,P006661,P011980,0 days 00:05:44,-2,8,10
276,ULK,P002968,P011980,0 days 00:05:40,2,10,8
276,ULK,P005844,P006661,0 days 00:05:34,2,8,6
276,ULK,P009849,P011980,0 days 00:05:30,2,9,7
276,ULK,P002968,P006661,0 days 00:05:10,-1,8,9
276,ULK,P002968,P006961,0 days 00:05:10,-1,8,9
276,ULK,P006961,P011980,0 days 00:04:48,0,8,8
276,ULK,P001932,P006068,0 days 00:04:40,-2,10,12
276,ULK,P011157,P011980,0 days 00:04:38,0,7,7
276,ULK,P006961,P009849,0 days 00:04:37,9,18,9
276,ULK,P002968,P004004,0 days 00:04:27,3,8,5
276,ULK,P006068,P008962,0 days 00:03:23,-1,8,9
276,ULK,P006068,P009849,0 days 00:03:16,-1,8,9
276,ULK,P006068,P006661,0 days 00:03:07,-7,2,9
276,ULK,P006068,P006961,0 days 00:03:05,-7,2,9
276,ULK,P001932,P002968,0 days 00:02:27,0,4,4
276,ULK,P004004,P006068,0 days 00:02:00,-6,0,6
276,ULK,P004004,P005844,0 days 00:01:04,-5,0,5
276,ULK,P002968,P009849,0 days 00:00:52,2,2,0
276,ULK,P002968,P006068,0 days 00:00:22,-1,0,1
276,ULK,P005844,P006068,0 days 00:00:05,0,0,0
277,RED,P005099,P009035,0 days 00:19:01,2,43,41
277,RED,P000848,P009035,0 days 00:17:22,14,49,35
277,RED,P007960,P009035,0 days 00:15:52,3,35,32
277,RED,P005099,P007960,0 days 00:15:32,3,38,35
277,RED,P005099,P006436,0 days 00:14:10,4,30,26
277,RED,P002553,P006436,0 days 00:12:48,4,28,24
277,RED,P005099,P011964,0 days 00:12:30,-3,20,23
277,RED,P000848,P007960,0 days 00:12:19,6,30,24
277,RED,P000848,PJDR,0 days 00:12:18,6,30,24
277,RED,P006436,P009035,0 days 00:12:03,15,33,18
277,RED,P005099,P008966,0 days 00:11:57,10,37,27
277,RED,P002553,PJDR,0 days 00:11:24,3,27,24
277,RED,P000848,P005099,0 days 00:11:18,4,30,26
277,RED,P000848,P002553,0 days 00:11:11,5,28,23
277,RED,P009035,PJDR,0 days 00:11:08,17,33,16
277,RED,P009035,P011964,0 days 00:10:37,-1,18,19
277,RED,P000848,P008966,0 days 00:10:27,0,27,27
277,RED,P007960,P011964,0 days 00:10:09,-1,20,21
277,RED,P006436,P008966,0 days 00:09:59,4,28,24
277,RED,P008966,P009035,0 days 00:09:40,9,31,22
277,RED,P002553,P005099,0 days 00:09:07,3,18,15
277,RED,P006436,PJDR,0 days 00:09:00,12,26,14
277,RED,P009035,P012801,0 days 00:08:49,-3,17,20
277,RED,P005099,P012801,0 days 00:08:33,-4,12,16
277,RED,P000848,P011964,0 days 00:08:12,1,16,15
277,RED,P000848,P006436,0 days 00:07:57,2,20,18
277,RED,P002553,P009035,0 days 00:07:48,8,21,13
277,RED,P007960,P008966,0 days 00:07:38,2,21,19
277,RED,P008966,PJDR,0 days 00:07:31,7,19,12
277,RED,P011964,P012801,0 days 00:07:17,-3,11,14
277,RED,P002553,P008966,0 days 00:06:42,0,15,15
277,RED,P002553,P007960,0 days 00:05:50,2,14,12
277,RED,P006436,P012801,0 days 00:05:43,3,11,8
277,RED,P006436,P011964,0 days 00:05:32,-1,7,8
277,RED,P002553,P012801,0 days 00:05:31,4,14,10
277,RED,P012801,PJDR,0 days 00:04:40,5,15,10
277,RED,P008966,P012801,0 days 00:04:40,4,12,8
277,RED,P007960,PJDR,0 days 00:04:17,0,7,7
277,RED,P007960,P012801,0 days 00:04:10,-4,6,10
277,RED,P002553,P011964,0 days 00:03:59,-1,7,8
277,RED,P000848,P012801,0 days 00:03:20,2,10,8
277,RED,P006436,P007960,0 days 00:03:20,1,9,8
277,RED,P011964,PJDR,0 days 00:03:11,1,7,6
277,RED,P005099,PJDR,0 days 00:02:59,5,8,3
277,RED,P008966,P011964,0 days 00:01:05,0,2,2
277,RED,P004720,P005099,0 days 00:00:21,0,0,0
277,RED,P004720,P006436,0 days 00:00:12,0,0,0
277,RED,P004720,P011964,0 days 00:00:12,0,0,0
277,RED,P002553,P004720,0 days 00:00:12,0,0,0
277,RED,P004720,P008966,0 days 00:00:09,0,0,0
277,RED,P004720,P007960,0 days 00:00:09,0,0,0
277,RED,P004720,P012801,0 days 00:00:09,0,0,0
277,VIR,P001133,PBCN,0 days 00:24:30,-6,50,56
277,VIR,P003527,P010781,0 days 00:22:03,-13,43,56
277,VIR,P001133,P010781,0 days 00:19:10,-9,36,45
277,VIR,P001133,P003048,0 days 00:18:43,-1,41,42
277,VIR,P010781,PBCN,0 days 00:17:21,-1,33,34
277,VIR,P003048,PBCN,0 days 00:17:19,-2,38,40
277,VIR,P001133,P006739,0 days 00:17:06,-5,36,41
277,VIR,P008847,P010781,0 days 00:16:15,0,27,27
277,VIR,P006739,PBCN,0 days 00:14:45,-2,31,33
277,VIR,P003527,P008847,0 days 00:13:11,-4,25,29
277,VIR,P001133,P003527,0 days 00:13:00,-11,25,36
277,VIR,P003048,P006739,0 days 00:11:43,-1,26,27
277,VIR,P003048,P010781,0 days 00:11:35,-3,25,28
277,VIR,P002084,P010781,0 days 00:11:19,0,24,24
277,VIR,P002084,P003527,0 days 00:11:06,0,24,24
277,VIR,P001133,P004007,0 days 00:10:45,-11,23,34
277,VIR,P003527,PBCN,0 days 00:10:39,-3,22,25
277,VIR,P005553,P010781,0 days 00:09:50,-1,16,17
277,VIR,P002084,P008847,0 days 00:09:41,4,21,17
277,VIR,P004007,P006739,0 days 00:09:18,-9,19,28
277,VIR,P004007,PBCN,0 days 00:09:11,-7,19,26
277,VIR,P006739,P010781,0 days 00:08:58,1,21,20
277,VIR,P005553,P008847,0 days 00:08:51,-2,13,15
277,VIR,P008847,PBCN,0 days 00:08:45,-3,14,17
277,VIR,P003048,P004007,0 days 00:08:26,-6,18,24
277,VIR,P001133,P008847,0 days 00:08:14,-8,10,18
277,VIR,P003048,P003527,0 days 00:07:51,-1,16,17
277,VIR,P003527,P005553,0 days 00:06:57,-1,11,12
277,VIR,P006739,P008847,0 days 00:06:32,0,14,14
277,VIR,P003527,P006739,0 days 00:05:28,-1,15,16
277,VIR,P002084,P005553,0 days 00:05:17,5,11,6
277,VIR,P001133,P005553,0 days 00:05:07,-9,5,14
277,VIR,P005553,PBCN,0 days 00:03:45,-3,5,8
277,VIR,P003527,P004007,0 days 00:03:29,-10,7,17
277,VIR,P004007,P010781,0 days 00:02:45,-10,7,17
277,VIR,P002084,PBCN,0 days 00:02:37,-1,4,5
277,VIR,P002084,P006739,0 days 00:02:03,0,6,6
277,VIR,P003048,P005553,0 days 00:01:42,-2,3,5
277,VIR,P002084,P004007,0 days 00:01:35,-4,3,7
277,VIR,P002084,P003048,0 days 00:00:49,-4,1,5
277,VIR,P001133,P002084,0 days 00:00:49,0,2,2
277,VIR,P004007,P008847,0 days 00:00:47,-3,0,3
277,VIR,P005553,P006739,0 days 00:00:43,-3,0,3
278,MUN,P001288,P003583,0 days 00:26:07,-3,43,46
278,MUN,P001288,P011987,0 days 00:24:00,-13,40,53
278,MUN,P001288,P008985,0 days 00:21:13,-9,39,48
278,MUN,P003583,P011987,0 days 00:20:22,-9,33,42
278,MUN,P008985,P011987,0 days 00:17:51,-11,35,46
278,MUN,P003583,P008985,0 days 00:17:35,-5,32,37
278,MUN,P003583,P010391,0 days 00:15:12,-4,21,25
278,MUN,P001288,P001557,0 days 00:15:07,6,29,23
278,MUN,P001557,P003583,0 days 00:15:07,6,29,23
278,MUN,P001288,P010391,0 days 00:14:56,1,21,20
278,MUN,P001557,P011987,0 days 00:12:47,5,26,21
278,MUN,P010391,P011987,0 days 00:11:03,-2,16,18
278,MUN,P006760,P007975,0 days 00:11:03,-9,23,32
278,MUN,P005460,P006760,0 days 00:10:45,6,29,23
278,MUN,P006760,P008985,0 days 00:10:31,5,29,24
278,MUN,P006543,P006760,0 days 00:10:15,-8,24,32
278,MUN,P006760,P011987,0 days 00:09:51,-11,18,29
278,MUN,P001557,P008985,0 days 00:09:33,-1,18,19
278,MUN,P005460,P006543,0 days 00:09:11,3,24,21
278,MUN,P006543,P007975,0 days 00:08:38,-12,18,30
278,MUN,P001557,P010391,0 days 00:07:41,8,14,6
278,MUN,P005460,P007975,0 days 00:07:34,-1,18,19
278,MUN,P007975,P011987,0 days 00:06:54,-17,5,22
278,MUN,P001288,P006760,0 days 00:06:32,-3,12,15
278,MUN,P005460,P011987,0 days 00:06:30,4,16,12
278,MUN,P008985,P010391,0 days 00:06:24,-1,10,11
278,MUN,P005460,P008985,0 days 00:06:19,11,22,11
278,MUN,P006543,P011987,0 days 00:05:44,-5,11,16
278,MUN,P003583,P007975,0 days 00:05:41,-10,5,15
278,MUN,P007975,P008985,0 days 00:05:35,4,16,12
278,MUN,P001288,P007975,0 days 00:05:25,-5,5,10
278,MUN,P006543,P008985,0 days 00:04:45,8,17,9
278,MUN,P007975,P010391,0 days 00:04:21,-12,2,14
278,MUN,P001288,P005478,0 days 00:04:06,-5,6,11
278,MUN,P005478,P008985,0 days 00:04:06,-5,6,11
278,MUN,P005478,P011987,0 days 00:03:54,-13,4,17
278,MUN,P003583,P006760,0 days 00:03:10,-4,5,9
278,MUN,P005478,P006760,0 days 00:02:52,-13,2,15
278,MUN,P006760,P010391,0 days 00:02:09,-7,2,9
278,MUN,P003583,P005478,0 days 00:02:02,2,4,2
278,MUN,P001288,P005460,0 days 00:01:34,3,5,2
278,MUN,P006543,P010391,0 days 00:01:23,-7,2,9
278,MUN,P005460,P010391,0 days 00:01:07,-2,2,4
278,MUN,P005478,P010391,0 days 00:01:00,2,2,0
278,MUN,P005478,P006543,0 days 00:00:48,-6,0,6
278,MUN,P005478,P007975,0 days 00:00:48,-6,0,6
278,MUN,P003583,P006543,0 days 00:00:16,-5,0,5
278,MUN,P001557,P007975,0 days 00:00:13,0,0,0
278,TEL,P009783,P011199,0 days 00:25:18,19,58,39
278,TEL,P009622,P009863,0 days 00:25:15,8,49,41
278,TEL,P009622,P011199,0 days 00:24:39,14,52,38
278,TEL,P009783,P009863,0 days 00:24:22,7,47,40
278,TEL,P009622,P009783,0 days 00:24:16,18,54,36
278,TEL,P009863,P011199,0 days 00:23:38,5,43,38
278,TEL,P009783,P011971,0 days 00:16:53,3,37,34
278,TEL,P009863,P012744,0 days 00:15:32,7,33,26
278,TEL,P009622,P012744,0 days 00:14:05,10,31,21
278,TEL,P011199,P012744,0 days 00:12:46,11,29,18
278,TEL,P007990,P011971,0 days 00:12:00,14,38,24
278,TEL,P009783,P012744,0 days 00:11:54,13,29,16
278,TEL,P011193,P011971,0 days 00:11:13,2,31,29
278,TEL,P011199,P011971,0 days 00:10:49,2,24,22
278,TEL,P009783,P011193,0 days 00:10:05,-1,21,22
278,TEL,P007990,P009783,0 days 00:09:59,10,28,18
278,TEL,P011214,P011971,0 days 00:09:56,4,27,23
278,TEL,P009622,P011971,0 days 00:09:32,4,20,16
278,TEL,P007990,P011193,0 days 00:09:17,5,27,22
278,TEL,P009783,P011214,0 days 00:09:03,-2,17,19
278,TEL,P009863,P011971,0 days 00:08:59,-6,15,21
278,TEL,P011193,P011214,0 days 00:08:48,0,23,23
278,TEL,P007990,P011214,0 days 00:07:31,5,21,16
278,TEL,P005145,P011199,0 days 00:07:21,-4,9,13
278,TEL,P005145,P009863,0 days 00:07:21,-4,9,13
278,TEL,P005145,P009622,0 days 00:07:21,-4,9,13
278,TEL,P005145,P009783,0 days 00:05:34,1,9,8
278,TEL,P009863,P011214,0 days 00:04:36,-2,10,12
278,TEL,P011214,P012744,0 days 00:04:33,-2,12,14
278,TEL,P007990,P011199,0 days 00:04:29,9,17,8
278,TEL,P011971,P012744,0 days 00:03:38,1,12,11
278,TEL,P011193,P011199,0 days 00:03:28,0,8,8
278,TEL,P011193,P012744,0 days 00:03:14,-1,10,11
278,TEL,P009622,P011214,0 days 00:03:05,1,6,5
278,TEL,P009863,P011193,0 days 00:02:59,-5,4,9
278,TEL,P007990,P009622,0 days 00:02:43,9,11,2
278,TEL,P007990,P012744,0 days 00:01:47,2,8,6
278,TEL,P005145,P012744,0 days 00:01:47,-5,0,5
278,TEL,P007990,P009863,0 days 00:00:14,2,2,0
279,PAN,P003842,P007866,0 days 00:32:51,13,78,65
279,PAN,P001926,P007866,0 days 00:31:18,28,81,53
279,PAN,P002328,P007866,0 days 00:29:13,1,62,61
279,PAN,P001926,P003842,0 days 00:29:11,14,70,56
279,PAN,P007866,P012774,0 days 00:27:11,15,67,52
279,PAN,P001926,P012774,0 days 00:26:57,13,64,51
279,PAN,P003842,P012774,0 days 00:25:04,1,56,55
279,PAN,P002328,P003842,0 days 00:24:17,-1,51,52
279,PAN,P003842,P011204,0 days 00:23:11,9,52,43
279,PAN,P001926,P002328,0 days 00:22:44,14,54,40
279,PAN,P007866,P011204,0 days 00:21:51,13,54,41
279,PAN,P002328,P012774,0 days 00:18:37,1,40,39
279,PAN,P001926,P011204,0 days 00:17:38,17,46,29
279,PAN,P011204,P012774,0 days 00:13:28,6,32,26
279,PAN,P002328,P011204,0 days 00:13:17,-1,27,28
279,PAN,P012712,P012774,0 days 00:03:33,-5,4,9
279,PAN,P001926,P012712,0 days 00:03:30,-3,4,7
279,PAN,P007553,P007866,0 days 00:03:22,-4,5,9
279,PAN,P002328,P007553,0 days 00:03:22,-4,5,9
279,PAN,P002328,P011209,0 days 00:03:04,-6,3,9
279,PAN,P007866,P011209,0 days 00:03:04,-6,3,9
279,PAN,P011204,P011209,0 days 00:03:04,-6,3,9
279,PAN,P007553,P012774,0 days 00:02:46,1,5,4
279,PAN,P001926,P007553,0 days 00:02:46,1,5,4
279,PAN,P003842,P011209,0 days 00:02:28,-1,3,4
279,PAN,P003842,P012712,0 days 00:02:16,-9,0,9
279,PAN,P011204,P012712,0 days 00:02:13,-7,0,7
279,PAN,P002328,P012712,0 days 00:01:20,2,4,2
279,PAN,P007866,P012712,0 days 00:01:20,2,4,2
279,PAN,P002328,P007947,0 days 00:00:58,-2,2,4
279,PAN,P003842,P007947,0 days 00:00:58,-2,2,4
279,PAN,P007866,P007947,0 days 00:00:58,-2,2,4
279,PAN,P007947,P011204,0 days 00:00:58,-2,2,4
279,PAN,P007553,P011204,0 days 00:00:36,-5,0,5
279,PAN,P007553,P011209,0 days 00:00:36,-5,0,5
279,BAR,P002939,P012745,0 days 00:22:50,-8,44,52
279,BAR,P000925,P012745,0 days 00:22:14,-15,37,52
279,BAR,P000925,P002939,0 days 00:21:11,-7,39,46
279,BAR,P000925,P004866,0 days 00:19:13,-4,35,39
279,BAR,P004866,P012745,0 days 00:18:48,-7,33,40
279,BAR,P002939,P004866,0 days 00:17:35,-3,34,37
279,BAR,P000925,P007519,0 days 00:14:31,0,29,29
279,BAR,P002939,P007519,0 days 00:14:31,-2,29,31
279,BAR,P007519,P012745,0 days 00:13:39,0,27,27
279,BAR,P004866,P007519,0 days 00:13:33,-1,27,28
279,BAR,P003196,P006435,0 days 00:12:19,1,28,27
279,BAR,P004866,P006435,0 days 00:11:50,-14,17,31
279,BAR,P006435,P012745,0 days 00:11:32,-5,22,27
279,BAR,P006435,PLFW,0 days 00:10:58,-2,21,23
279,BAR,P011244,PLFW,0 days 00:10:37,1,23,22
279,BAR,P002939,P003478,0 days 00:10:17,-2,24,26
279,BAR,P003196,P011244,0 days 00:10:02,0,22,22
279,BAR,P003478,PLFW,0 days 00:09:54,5,26,21
279,BAR,P003196,P003478,0 days 00:09:50,11,29,18
279,BAR,P003196,PLFW,0 days 00:09:40,3,23,20
279,BAR,P002939,P006435,0 days 00:09:31,-5,18,23
279,BAR,P003478,P006435,0 days 00:09:31,7,24,17
279,BAR,P006435,P011244,0 days 00:09:23,1,19,18
279,BAR,P000925,P006435,0 days 00:09:02,-8,13,21
279,BAR,P003478,P011244,0 days 00:08:15,6,21,15
279,BAR,P003478,P012745,0 days 00:07:40,-2,18,20
279,BAR,P002939,P003196,0 days 00:06:41,2,19,17
279,BAR,P000925,P003478,0 days 00:06:05,-7,10,17
279,BAR,P000925,PLFW,0 days 00:05:52,-7,9,16
279,BAR,P004866,PLFW,0 days 00:05:38,-9,6,15
279,BAR,P012745,PLFW,0 days 00:04:55,-5,9,14
279,BAR,P003196,P004866,0 days 00:04:52,-8,7,15
279,BAR,P004866,P011244,0 days 00:04:51,-2,9,11
279,BAR,P002939,P011244,0 days 00:04:36,6,14,8
279,BAR,P002939,PLFW,0 days 00:04:16,-1,11,12
279,BAR,P003196,P012745,0 days 00:04:14,6,14,8
279,BAR,P000925,P011244,0 days 00:03:04,4,8,4
279,BAR,P003478,P007519,0 days 00:02:08,-2,4,6
279,BAR,P007519,P011244,0 days 00:01:36,0,4,4
279,BAR,P006435,P007519,0 days 00:01:18,-3,2,5
279,BAR,P003196,P007519,0 days 00:01:10,-3,2,5
279,BAR,P007519,PLFW,0 days 00:00:18,-1,0,1
280,MUN,P001288,P003583,0 days 00:25:06,-7,43,50
280,MUN,P001288,P006760,0 days 00:25:02,-11,43,54
280,MUN,P001288,P011987,0 days 00:23:06,-8,40,48
280,MUN,P003583,P011987,0 days 00:22:27,-7,39,46
280,MUN,P006760,P011987,0 days 00:21:49,-11,35,46
280,MUN,P003583,P006760,0 days 00:21:10,-10,34,44
280,MUN,P007975,P010391,0 days 00:17:43,0,41,41
280,MUN,P001288,P008985,0 days 00:17:00,-9,27,36
280,MUN,P003583,P008985,0 days 00:17:00,-9,27,36
280,MUN,P006760,P008985,0 days 00:17:00,-9,27,36
280,MUN,P008985,P011987,0 days 00:17:00,-9,27,36
280,MUN,P006543,P007975,0 days 00:12:49,5,34,29
280,MUN,P006543,P010391,0 days 00:12:21,2,31,29
280,MUN,P005460,P010391,0 days 00:10:55,-5,27,32
280,MUN,P005460,P007975,0 days 00:10:16,-4,26,30
280,MUN,P001288,P007975,0 days 00:10:12,2,23,21
280,MUN,P001288,P010391,0 days 00:09:41,-3,22,25
280,MUN,P003583,P007975,0 days 00:07:19,1,12,11
280,MUN,P005460,P006543,0 days 00:07:03,-4,18,22
280,MUN,P010391,P012123,0 days 00:06:58,2,16,14
280,MUN,P007975,P012123,0 days 00:06:58,2,16,14
280,MUN,P006543,P012123,0 days 00:06:58,2,16,14
280,MUN,P006760,P007975,0 days 00:06:41,4,17,13
280,MUN,P006760,P010391,0 days 00:06:38,2,19,17
280,MUN,P005478,P010391,0 days 00:06:16,-1,9,10
280,MUN,P005478,P007975,0 days 00:06:16,-1,9,10
280,MUN,P003583,P010391,0 days 00:06:09,-3,10,13
280,MUN,P005478,P006543,0 days 00:04:56,1,9,8
280,MUN,P005460,P006760,0 days 00:04:54,3,15,12
280,MUN,P001288,P005460,0 days 00:04:29,-2,12,14
280,MUN,P007975,P011987,0 days 00:04:14,3,10,7
280,MUN,P010391,P011987,0 days 00:03:43,-2,9,11
280,MUN,P005478,P012123,0 days 00:03:02,6,9,3
280,MUN,P005460,P012123,0 days 00:02:59,-2,7,9
280,MUN,P003583,P006543,0 days 00:02:44,3,7,4
280,MUN,P001288,P006543,0 days 00:02:24,4,10,6
280,MUN,P005460,P005478,0 days 00:01:54,-5,0,5
280,MUN,P001288,P005478,0 days 00:01:20,-2,0,2
280,MUN,P003583,P005478,0 days 00:01:20,-2,0,2
280,MUN,P005460,P011987,0 days 00:01:10,-1,3,4
280,MUN,P006543,P006760,0 days 00:01:02,4,6,2
280,MUN,P006543,P011987,0 days 00:00:59,3,5,2
280,MUN,P003583,P012123,0 days 00:00:57,-2,0,2
280,BAR,P000925,P006435,0 days 00:18:29,-2,38,40
280,BAR,P012745,PLFW,0 days 00:15:55,0,36,36
280,BAR,P003196,P012745,0 days 00:14:23,10,36,26
280,BAR,P000925,P004866,0 days 00:14:18,1,26,25
280,BAR,P004866,P006435,0 days 00:13:39,5,29,24
280,BAR,P003196,P009992,0 days 00:13:11,14,35,21
280,BAR,P002939,P011244,0 days 00:12:52,4,28,24
280,BAR,P004866,P012745,0 days 00:12:49,3,28,25
280,BAR,P002939,P006435,0 days 00:12:35,1,27,26
280,BAR,P006435,P011244,0 days 00:12:28,-6,19,25
280,BAR,P000925,P002939,0 days 00:12:10,-2,24,26
280,BAR,P000925,P011244,0 days 00:11:55,-6,19,25
280,BAR,P002939,P003478,0 days 00:11:54,6,30,24
280,BAR,P003196,PLFW,0 days 00:11:33,4,28,24
280,BAR,P003196,P003478,0 days 00:10:54,13,30,17
280,BAR,P009992,P012745,0 days 00:10:44,4,22,18
280,BAR,P004866,PLFW,0 days 00:10:41,-1,22,23
280,BAR,P003478,P009992,0 days 00:10:05,12,28,16
280,BAR,P002939,P003196,0 days 00:09:07,13,25,12
280,BAR,P003478,P012745,0 days 00:08:53,8,25,17
280,BAR,P009992,PLFW,0 days 00:08:49,-1,17,18
280,BAR,P002939,P009992,0 days 00:08:42,10,22,12
280,BAR,P000925,P012745,0 days 00:08:38,-1,19,20
280,BAR,P002939,P012745,0 days 00:08:25,7,21,14
280,BAR,P003478,P011244,0 days 00:08:16,-3,17,20
280,BAR,P006435,P012745,0 days 00:08:15,4,24,20
280,BAR,P004866,P011244,0 days 00:07:46,0,13,13
280,BAR,P002939,P004866,0 days 00:07:07,5,15,10
280,BAR,P003478,P006435,0 days 00:07:04,-7,14,21
280,BAR,P004866,P007519,0 days 00:06:49,0,13,13
280,BAR,P003196,P004866,0 days 00:06:17,2,15,13
280,BAR,P000925,P003478,0 days 00:06:15,-8,12,20
280,BAR,P000925,PLFW,0 days 00:05:19,-2,10,12
280,BAR,P003196,P007519,0 days 00:05:05,-1,9,10
280,BAR,P003196,P011244,0 days 00:05:04,5,13,8
280,BAR,P009992,P011244,0 days 00:04:31,5,13,8
280,BAR,P006435,P007519,0 days 00:04:07,-5,4,9
280,BAR,P007519,P011244,0 days 00:04:07,-5,4,9
280,BAR,P007519,P012745,0 days 00:04:02,1,9,8
280,BAR,P007519,PLFW,0 days 00:04:02,1,9,8
280,BAR,P006435,PLFW,0 days 00:04:01,2,12,10
280,BAR,P003478,PLFW,0 days 00:03:55,3,12,9
280,BAR,P000925,P007519,0 days 00:03:04,-3,4,7
280,BAR,P004866,P009992,0 days 00:02:54,-3,3,6
280,BAR,P002939,PLFW,0 days 00:02:16,0,4,4
280,BAR,P003196,P006435,0 days 00:02:14,0,5,5
280,BAR,P000925,P009992,0 days 00:02:04,-5,0,5
280,BAR,P003478,P007519,0 days 00:01:20,-4,0,4
280,BAR,P011244,PLFW,0 days 00:00:57,2,2,0
281,ASV,P002100,P012080,0 days 00:19:29,0,40,40
281,ASV,P000229,P011225,0 days 00:19:08,-10,34,44
281,ASV,P006568,P012080,0 days 00:18:50,4,34,30
281,ASV,P004194,P011225,0 days 00:17:03,-6,38,44
281,ASV,P000229,P004194,0 days 00:16:52,-6,33,39
281,ASV,P012080,P012731,0 days 00:15:55,-10,21,31
281,ASV,P002100,P006568,0 days 00:15:11,8,30,22
281,ASV,P006568,P012731,0 days 00:14:59,-4,21,25
281,ASV,P011225,P012080,0 days 00:14:40,-14,29,43
281,ASV,P011225,P012731,0 days 00:14:16,3,30,27
281,ASV,P002100,P012731,0 days 00:13:46,-8,21,29
281,ASV,P011386,P012080,0 days 00:13:45,4,25,21
281,ASV,P012080,PKIR,0 days 00:13:43,-9,33,42
281,ASV,P002100,P011386,0 days 00:12:39,1,22,21
281,ASV,P006568,P011386,0 days 00:10:51,3,20,17
281,ASV,P000229,P012731,0 days 00:09:49,5,23,18
281,ASV,P003526,P004194,0 days 00:09:44,4,19,15
281,ASV,P000229,P003526,0 days 00:09:44,4,19,15
281,ASV,P003526,P011225,0 days 00:09:27,7,19,12
281,ASV,P000229,P012080,0 days 00:09:13,-13,14,27
281,ASV,P004194,P012080,0 days 00:08:56,-11,20,31
281,ASV,P004194,PKIR,0 days 00:08:56,-11,20,31
281,ASV,P002100,P011225,0 days 00:08:41,-5,22,27
281,ASV,P002100,PKIR,0 days 00:08:09,0,23,23
281,ASV,P006568,P011225,0 days 00:07:59,1,14,13
281,ASV,P011386,P012731,0 days 00:07:49,-4,10,14
281,ASV,P011225,PKIR,0 days 00:07:30,-14,18,32
281,ASV,P004194,P012731,0 days 00:06:10,9,19,10
281,ASV,P011386,PKIR,0 days 00:05:56,8,15,7
281,ASV,P000229,PKIR,0 days 00:05:34,-9,10,19
281,ASV,P002100,P004194,0 days 00:05:13,-6,14,20
281,ASV,P011225,P012729,0 days 00:05:08,-6,4,10
281,ASV,P004194,P012729,0 days 00:05:08,-6,4,10
281,ASV,P000229,P012729,0 days 00:05:08,-6,4,10
281,ASV,P003526,P012729,0 days 00:04:47,-4,4,8
281,ASV,P003526,P012731,0 days 00:04:40,11,15,4
281,ASV,P006568,PKIR,0 days 00:03:51,8,13,5
281,ASV,P000229,P006568,0 days 00:03:39,-4,4,8
281,ASV,P004194,P011386,0 days 00:02:54,1,5,4
281,ASV,P000229,P002100,0 days 00:01:51,-4,4,8
281,ASV,P000229,P011386,0 days 00:01:06,3,3,0
281,ASV,P012731,PKIR,0 days 00:00:56,-6,0,6
281,ASV,P002100,P012729,0 days 00:00:21,-2,0,2
281,ASV,P003526,P012080,0 days 00:00:17,-3,0,3
281,ASV,P003526,PKIR,0 days 00:00:17,-3,0,3
281,MCO,P011212,P011226,0 days 00:25:34,13,58,45
281,MCO,P011226,P011231,0 days 00:25:05,11,58,47
281,MCO,P011212,P011231,0 days 00:22:32,9,48,39
281,MCO,P011196,P011226,0 days 00:19:34,7,41,34
281,MCO,P005985,P011226,0 days 00:19:09,27,61,34
281,MCO,P005985,P010588,0 days 00:17:15,4,40,36
281,MCO,P011196,P011212,0 days 00:16:10,7,32,25
281,MCO,P011196,P011231,0 days 00:15:57,5,32,27
281,MCO,P005985,P011212,0 days 00:15:18,23,46,23
281,MCO,P005985,P009754,0 days 00:14:26,-3,29,32
281,MCO,P005985,P011231,0 days 00:13:41,21,44,23
281,MCO,P005985,PLCZ,0 days 00:12:43,2,27,25
281,MCO,P009754,P010588,0 days 00:11:53,-5,19,24
281,MCO,P009754,P011226,0 days 00:11:22,5,27,22
281,MCO,P010588,PLCZ,0 days 00:11:18,-3,20,23
281,MCO,P009754,PLCZ,0 days 00:10:52,-2,19,21
281,MCO,P005985,P011196,0 days 00:10:01,11,27,16
281,MCO,P009754,P011196,0 days 00:09:47,1,19,18
281,MCO,P009754,P011231,0 days 00:08:56,3,20,17
281,MCO,P004197,P009754,0 days 00:08:19,-7,10,17
281,MCO,P004197,P005985,0 days 00:08:19,-7,10,17
281,MCO,P004197,P010588,0 days 00:08:19,-7,10,17
281,MCO,P004197,PLCZ,0 days 00:08:19,-7,10,17
281,MCO,P010588,P011226,0 days 00:07:48,11,28,17
281,MCO,P009754,P011212,0 days 00:07:31,1,12,11
281,MCO,P010588,P011212,0 days 00:06:30,9,23,14
281,MCO,P002581,P011226,0 days 00:05:23,-4,8,12
281,MCO,P002581,P011231,0 days 00:05:23,-4,8,12
281,MCO,P002581,P011212,0 days 00:05:13,-3,7,10
281,MCO,P011226,P012709,0 days 00:05:01,-11,4,15
281,MCO,P011231,P012709,0 days 00:05:01,-11,4,15
281,MCO,P011212,P012709,0 days 00:05:01,-11,4,15
281,MCO,P010588,P011196,0 days 00:03:37,2,9,7
281,MCO,P002581,P005985,0 days 00:03:32,2,8,6
281,MCO,P011226,PLCZ,0 days 00:03:16,9,15,6
281,MCO,P011196,P012709,0 days 00:03:10,-5,4,9
281,MCO,P011212,PLCZ,0 days 00:02:59,4,10,6
281,MCO,P010588,P011231,0 days 00:02:20,5,11,6
281,MCO,P002581,P012709,0 days 00:01:51,-6,0,6
281,MCO,P011231,PLCZ,0 days 00:01:25,5,7,2
281,MCO,P002581,P009754,0 days 00:00:10,-1,1,2
282,BAS,P007230,P009048,0 days 00:19:22,-14,36,50
282,BAS,P004603,P011948,0 days 00:18:47,-16,36,52
282,BAS,P004761,P009048,0 days 00:17:56,-1,34,35
282,BAS,P009048,P011948,0 days 00:16:07,-1,35,36
282,BAS,P007230,P011948,0 days 00:15:51,-18,28,46
282,BAS,P004761,P010444,0 days 00:15:38,0,29,29
282,BAS,P004603,P007230,0 days 00:15:10,-19,24,43
282,BAS,P004761,P007230,0 days 00:14:50,-15,24,39
282,BAS,P004761,P011085,0 days 00:14:20,-11,23,34
282,BAS,P011948,P012201,0 days 00:14:14,-6,32,38
282,BAS,P004603,P012201,0 days 00:14:05,-8,30,38
282,BAS,P004603,P012765,0 days 00:12:53,-15,22,37
282,BAS,P009048,P010444,0 days 00:12:18,6,25,19
282,BAS,P004761,P011948,0 days 00:12:12,-9,21,30
282,BAS,P003198,P004761,0 days 00:11:29,1,25,24
282,BAS,P003198,P009048,0 days 00:11:29,1,25,24
282,BAS,P009048,P011085,0 days 00:11:25,-3,21,24
282,BAS,P010444,P011085,0 days 00:11:08,-5,18,23
282,BAS,P004603,P009048,0 days 00:10:15,-9,18,27
282,BAS,P004603,P004761,0 days 00:10:05,-21,10,31
282,BAS,P011948,P012765,0 days 00:09:42,-7,20,27
282,BAS,P007230,P012201,0 days 00:09:27,-9,18,27
282,BAS,P009048,P012201,0 days 00:09:11,-5,20,25
282,BAS,P004761,P012765,0 days 00:08:36,-19,10,29
282,BAS,P007230,P011085,0 days 00:08:26,-6,14,20
282,BAS,P004603,P011085,0 days 00:07:57,-2,16,18
282,BAS,P011085,P012765,0 days 00:07:37,2,18,16
282,BAS,P003198,P010444,0 days 00:07:20,6,16,10
282,BAS,P003198,P011948,0 days 00:06:12,4,15,11
282,BAS,P012201,P012765,0 days 00:05:44,1,14,13
282,BAS,P003198,P011085,0 days 00:05:17,-3,10,13
282,BAS,P007230,P010444,0 days 00:04:58,0,9,9
282,BAS,P007230,P012765,0 days 00:04:55,-10,6,16
282,BAS,P010444,P011948,0 days 00:04:30,5,11,6
282,BAS,P011085,P012201,0 days 00:04:17,8,14,6
282,BAS,P003198,P007230,0 days 00:04:09,-5,9,14
282,BAS,P011085,P011948,0 days 00:04:01,8,14,6
282,BAS,P004603,P010444,0 days 00:03:20,-6,4,10
282,BAS,P010444,P012765,0 days 00:03:20,-6,4,10
282,BAS,P004761,P012201,0 days 00:01:02,-5,0,5
282,BAS,P009048,P012765,0 days 00:00:25,2,2,0
282,IST,P004888,P007200,0 days 00:26:33,27,75,48
282,IST,P004888,P012710,0 days 00:21:26,29,60,31
282,IST,P007200,P012710,0 days 00:21:17,30,62,32
282,IST,P004888,P009513,0 days 00:16:30,28,49,21
282,IST,P007200,P009513,0 days 00:16:05,30,49,19
282,IST,P009513,P012710,0 days 00:16:05,30,49,19
282,IST,P006590,P011078,0 days 00:13:47,-2,29,31
282,IST,P004888,PLHK,0 days 00:13:44,13,38,25
282,IST,P007200,PLHK,0 days 00:13:44,13,38,25
282,IST,P007200,P011981,0 days 00:12:52,17,35,18
282,IST,P006590,P009846,0 days 00:12:47,-4,22,26
282,IST,P004888,P011981,0 days 00:12:31,15,36,21
282,IST,P009846,P011078,0 days 00:11:05,-4,20,24
282,IST,P004888,P011078,0 days 00:10:57,-6,23,29
282,IST,P012710,PLHK,0 days 00:10:49,17,32,15
282,IST,P009513,PLHK,0 days 00:10:49,17,32,15
282,IST,P011078,P011981,0 days 00:10:47,3,24,21
282,IST,P009664,P009846,0 days 00:10:06,-3,20,23
282,IST,P006590,P011981,0 days 00:09:02,1,19,18
282,IST,P011981,P012710,0 days 00:08:43,15,24,9
282,IST,P011078,P012710,0 days 00:08:13,-1,16,17
282,IST,P011078,P012788,0 days 00:08:00,-7,14,21
282,IST,P007200,P011078,0 days 00:07:55,2,22,20
282,IST,P006590,P009664,0 days 00:07:27,1,14,13
282,IST,P009846,P011981,0 days 00:06:35,-1,10,11
282,IST,P009664,P011078,0 days 00:06:26,-1,12,13
282,IST,P006590,P012788,0 days 00:06:21,-4,10,14
282,IST,P009846,P012788,0 days 00:06:06,-4,10,14
282,IST,P009513,P011981,0 days 00:05:16,13,17,4
282,IST,P009664,P011981,0 days 00:05:14,1,7,6
282,IST,P004888,P006590,0 days 00:05:10,-3,12,15
282,IST,P004888,P009846,0 days 00:05:07,-9,9,18
282,IST,P012710,P012788,0 days 00:04:40,-4,7,11
282,IST,P007200,P009664,0 days 00:04:37,-4,8,12
282,IST,P007200,P009846,0 days 00:04:27,-3,10,13
282,IST,P006590,P007200,0 days 00:04:15,3,13,10
282,IST,P004888,P009664,0 days 00:03:20,-6,6,12
282,IST,P006590,P012710,0 days 00:03:07,0,5,5
282,IST,P004888,P012788,0 days 00:03:01,-6,4,10
282,IST,P009664,PLHK,0 days 00:02:55,-4,6,10
282,IST,P009846,P012710,0 days 00:02:52,0,5,5
282,IST,P009846,PLHK,0 days 00:02:39,-4,6,10
282,IST,P009664,P012788,0 days 00:02:13,0,7,7
282,IST,P007200,P012788,0 days 00:01:39,-3,4,7
282,IST,P004888,P006372,0 days 00:00:25,-2,0,2
282,IST,P006372,P009513,0 days 00:00:25,-2,0,2
282,IST,P006372,P009664,0 days 00:00:25,-2,0,2
282,IST,P006372,P011078,0 days 00:00:25,-2,0,2
282,IST,P009513,P009664,0 days 00:00:25,-2,0,2
282,IST,P009513,P011078,0 days 00:00:25,-2,0,2
282,IST,P011078,PLHK,0 days 00:00:16,0,0,0
283,TEL,P009783,P009863,0 days 00:26:06,11,59,48
283,TEL,P009622,P009863,0 days 00:25:50,10,58,48
283,TEL,P009622,P009783,0 days 00:24:53,11,56,45
283,TEL,P009863,P011199,0 days 00:24:14,17,61,44
283,TEL,P009783,P011199,0 days 00:24:11,18,61,43
283,TEL,P009622,P011199,0 days 00:23:45,15,58,43
283,TEL,P009863,P012744,0 days 00:12:12,1,34,33
283,TEL,P011199,P012744,0 days 00:11:59,-2,31,33
283,TEL,P011193,P011214,0 days 00:11:50,0,27,27
283,TEL,P007990,P011214,0 days 00:11:29,0,27,27
283,TEL,P009783,P012744,0 days 00:11:08,-8,25,33
283,TEL,P005145,P009783,0 days 00:10:37,8,24,16
283,TEL,P009622,P012744,0 days 00:09:56,-1,27,28
283,TEL,P007990,P011193,0 days 00:09:38,-3,20,23
283,TEL,P005145,P009863,0 days 00:09:30,11,24,13
283,TEL,P009622,P011971,0 days 00:08:42,14,24,10
283,TEL,P009783,P011214,0 days 00:08:22,-14,9,23
283,TEL,P005145,P011199,0 days 00:08:20,7,19,12
283,TEL,P005145,P009622,0 days 00:07:55,4,16,12
283,TEL,P011214,P012744,0 days 00:07:42,0,18,18
283,TEL,P011193,P012744,0 days 00:07:40,1,18,17
283,TEL,P009863,P011971,0 days 00:07:07,13,19,6
283,TEL,P011199,P011971,0 days 00:06:51,11,17,6
283,TEL,P009783,P011971,0 days 00:06:51,11,17,6
283,TEL,P009783,P011193,0 days 00:06:42,-6,12,18
283,TEL,P007990,P009783,0 days 00:05:31,-6,9,15
283,TEL,P007990,P012744,0 days 00:05:28,-2,11,13
283,TEL,P005145,P011193,0 days 00:04:49,7,15,8
283,TEL,P005145,P011214,0 days 00:04:24,4,12,8
283,TEL,P009863,P011214,0 days 00:04:19,-3,7,10
283,TEL,P011214,P011971,0 days 00:04:15,8,16,8
283,TEL,P007990,P011971,0 days 00:03:59,6,14,8
283,TEL,P011214,P012095,0 days 00:03:58,-3,7,10
283,TEL,P009622,P011214,0 days 00:03:56,-2,7,9
283,TEL,P009622,P012095,0 days 00:03:56,-2,7,9
283,TEL,P011193,P011199,0 days 00:03:20,2,9,7
283,TEL,P005145,P007990,0 days 00:03:14,0,7,7
283,TEL,P011199,P011214,0 days 00:02:57,-2,6,8
283,TEL,P007990,P011199,0 days 00:02:55,-1,6,7
283,TEL,P009863,P011193,0 days 00:02:37,6,10,4
283,TEL,P011971,P012744,0 days 00:02:24,5,9,4
283,TEL,P011193,P011971,0 days 00:02:24,5,9,4
283,TEL,P009863,P012095,0 days 00:02:09,-6,0,6
283,TEL,P009783,P012095,0 days 00:02:07,-5,0,5
283,TEL,P005145,P012744,0 days 00:02:07,3,7,4
283,TEL,P007990,P009622,0 days 00:01:51,3,7,4
283,TEL,P007990,P012095,0 days 00:01:51,3,7,4
283,TEL,P011971,P012095,0 days 00:01:51,3,7,4
283,TEL,P011199,P012095,0 days 00:00:04,-1,0,1
283,TEL,P012095,P012744,0 days 00:00:04,-1,0,1
283,PAM,P003960,P012795,0 days 00:18:31,-3,39,42
283,PAM,P003960,P010568,0 days 00:17:47,-1,36,37
283,PAM,P010568,P012795,0 days 00:17:43,-9,33,42
283,PAM,P003960,P011982,0 days 00:17:35,2,40,38
283,PAM,P003960,P004863,0 days 00:17:21,5,37,32
283,PAM,P004863,P010568,0 days 00:16:04,0,30,30
283,PAM,P011982,P012795,0 days 00:15:39,-4,35,39
283,PAM,P006433,P012740,0 days 00:14:11,-4,30,34
283,PAM,P004863,P012795,0 days 00:14:01,2,27,25
283,PAM,P005356,P012740,0 days 00:13:53,-5,28,33
283,PAM,P010568,P011982,0 days 00:13:45,1,30,29
283,PAM,P004863,P011982,0 days 00:11:48,10,28,18
283,PAM,P005356,P011982,0 days 00:11:29,-9,21,30
283,PAM,P005356,P006433,0 days 00:11:02,-3,22,25
283,PAM,P006433,P011982,0 days 00:10:52,-16,20,36
283,PAM,P011982,P012740,0 days 00:10:33,-6,22,28
283,PAM,P006433,P010393,0 days 00:09:49,1,24,23
283,PAM,P010393,P012740,0 days 00:09:48,1,23,22
283,PAM,P005356,P010393,0 days 00:09:02,1,21,20
283,PAM,P000556,P010393,0 days 00:08:43,0,19,19
283,PAM,P010393,P012795,0 days 00:08:20,-12,10,22
283,PAM,P000556,P005356,0 days 00:08:06,1,18,17
283,PAM,P000556,P012740,0 days 00:08:04,1,18,17
283,PAM,P003960,P005356,0 days 00:07:45,-4,14,18
283,PAM,P010393,P010568,0 days 00:07:30,-12,8,20
283,PAM,P004863,P010393,0 days 00:07:29,-12,7,19
283,PAM,P006433,P012795,0 days 00:06:48,-12,14,26
283,PAM,P000556,P006433,0 days 00:06:34,4,16,12
283,PAM,P004863,P005356,0 days 00:06:29,-3,13,16
283,PAM,P003960,P012740,0 days 00:06:23,-4,13,17
283,PAM,P005356,P010568,0 days 00:05:16,0,11,11
283,PAM,P003960,P006433,0 days 00:04:47,-8,8,16
283,PAM,P012740,P012795,0 days 00:04:44,0,12,12
283,PAM,P004863,P012740,0 days 00:04:26,-1,10,11
283,PAM,P003960,P010393,0 days 00:04:22,-6,4,10
283,PAM,P000556,P004863,0 days 00:04:22,-5,8,13
283,PAM,P010393,P011982,0 days 00:04:17,-5,8,13
283,PAM,P000556,P012795,0 days 00:02:54,-2,6,8
283,PAM,P000556,P010568,0 days 00:02:52,-2,6,8
283,PAM,P006433,P010568,0 days 00:02:51,-5,6,11
283,PAM,P005356,P012738,0 days 00:02:50,-5,4,9
283,PAM,P006433,P012738,0 days 00:02:50,-5,4,9
283,PAM,P011982,P012738,0 days 00:02:50,-5,4,9
283,PAM,P005356,P012795,0 days 00:02:28,-5,4,9
283,PAM,P012738,P012740,0 days 00:02:26,-2,4,6
283,PAM,P000556,P003960,0 days 00:02:17,-1,5,6
283,PAM,P012738,P012795,0 days 00:00:24,-3,0,3
284,PAR,P009862,P012743,0 days 00:31:46,-2,56,58
284,PAR,P009862,P012742,0 days 00:29:56,2,58,56
284,PAR,P012742,P012743,0 days 00:28:03,12,59,47
284,PAR,P009862,P012096,0 days 00:27:25,-10,43,53
284,PAR,P004172,P012743,0 days 00:26:55,11,54,43
284,PAR,P012096,P012743,0 days 00:26:09,-4,43,47
284,PAR,P004172,P012742,0 days 00:24:57,10,54,44
284,PAR,P004172,P009862,0 days 00:24:42,5,50,45
284,PAR,P012096,P012742,0 days 00:23:01,-2,41,43
284,PAR,P004172,P012096,0 days 00:21:36,1,38,37
284,PAR,P007400,P009862,0 days 00:13:12,-10,20,30
284,PAR,P007400,P012742,0 days 00:10:32,4,23,19
284,PAR,P007400,P012743,0 days 00:10:16,-1,19,20
284,PAR,P007400,P011051,0 days 00:09:26,-1,14,15
284,PAR,P009862,P011051,0 days 00:06:53,-5,8,13
284,PAR,P011051,P012742,0 days 00:06:19,2,11,9
284,PAR,P007673,P009862,0 days 00:06:00,-9,7,16
284,PAR,P007673,P012096,0 days 00:05:49,-11,5,16
284,PAR,P004172,P007400,0 days 00:05:39,8,18,10
284,PAR,P003983,P009862,0 days 00:05:37,-6,5,11
284,PAR,P011051,P012743,0 days 00:05:01,0,7,7
284,PAR,P007673,P012743,0 days 00:04:56,-5,7,12
284,PAR,P011050,P011051,0 days 00:04:17,-1,5,6
284,PAR,P007400,P011050,0 days 00:04:17,-1,5,6
284,PAR,P009862,P011050,0 days 00:04:17,-1,5,6
284,PAR,P003983,P012743,0 days 00:04:10,-3,3,6
284,PAR,P007673,P012742,0 days 00:03:54,-2,7,9
284,PAR,P007400,P007673,0 days 00:03:21,-9,2,11
284,PAR,P007400,P012096,0 days 00:03:10,-11,0,11
284,PAR,P003983,P007400,0 days 00:03:07,-3,3,6
284,PAR,P003983,P011051,0 days 00:03:07,-3,3,6
284,PAR,P011050,P012742,0 days 00:03:02,0,3,3
284,PAR,P004172,P011051,0 days 00:02:41,4,8,4
284,PAR,P003983,P004172,0 days 00:02:30,-3,2,5
284,PAR,P003983,P012096,0 days 00:02:30,-3,2,5
284,PAR,P003983,P011050,0 days 00:01:15,-1,2,3
284,PAR,P003983,P012742,0 days 00:00:12,-2,0,2
284,OLY,P001255,P008811,0 days 00:30:00,8,59,51
284,OLY,P001255,P008855,0 days 00:29:05,6,55,49
284,OLY,P008811,P008855,0 days 00:29:05,6,55,49
284,OLY,P001255,P010612,0 days 00:20:00,-10,31,41
284,OLY,P008811,P010612,0 days 00:20:00,-10,31,41
284,OLY,P007982,P010392,0 days 00:19:52,13,41,28
284,OLY,P008855,P010612,0 days 00:19:05,-12,27,39
284,OLY,P007982,P008811,0 days 00:13:45,18,37,19
284,OLY,P001255,P007982,0 days 00:13:45,18,37,19
284,OLY,P008829,P010612,0 days 00:13:36,-7,19,26
284,OLY,P008829,P008855,0 days 00:13:28,-9,17,26
284,OLY,P008811,P008829,0 days 00:13:28,-9,17,26
284,OLY,P001255,P008829,0 days 00:13:28,-9,17,26
284,OLY,P007982,P008855,0 days 00:12:50,16,33,17
284,OLY,P006589,P007982,0 days 00:10:36,3,17,14
284,OLY,P007853,P007982,0 days 00:10:00,-3,15,18
284,OLY,P007982,P012878,0 days 00:10:00,-3,15,18
284,OLY,P001255,P010392,0 days 00:10:00,18,28,10
284,OLY,P008855,P010392,0 days 00:10:00,18,28,10
284,OLY,P008811,P010392,0 days 00:10:00,18,28,10
284,OLY,P007853,P012878,0 days 00:10:00,-3,15,18
284,OLY,P010392,P012878,0 days 00:09:52,-5,13,18
284,OLY,P007853,P010392,0 days 00:09:52,-5,13,18
284,OLY,P006589,P010392,0 days 00:09:41,1,13,12
284,OLY,P006589,P012878,0 days 00:09:41,1,13,12
284,OLY,P006589,P007853,0 days 00:09:41,1,13,12
284,OLY,P007982,P010612,0 days 00:03:53,2,11,9
284,OLY,P007853,P010612,0 days 00:02:55,1,7,6
284,OLY,P001255,P007853,0 days 00:02:47,-1,5,6
284,OLY,P007853,P008811,0 days 00:02:47,-1,5,6
284,OLY,P007853,P008855,0 days 00:02:47,-1,5,6
284,OLY,P001255,P006589,0 days 00:00:55,2,4,2
284,OLY,P006589,P008811,0 days 00:00:55,2,4,2
284,OLY,P006589,P010612,0 days 00:00:55,2,4,2
284,OLY,P007853,P008829,0 days 00:00:19,-4,2,6
284,OLY,P007982,P008829,0 days 00:00:19,-4,2,6
284,OLY,P008829,P012878,0 days 00:00:19,-4,2,6
284,OLY,P008829,P010392,0 days 00:00:11,-6,0,6
284,OLY,P010612,P012878,0 days 00:00:08,2,2,0
285,ZAL,P002329,P002676,0 days 00:25:15,13,54,41
285,ZAL,P002329,P011218,0 days 00:24:48,13,54,41
285,ZAL,P002676,P011218,0 days 00:24:48,13,54,41
285,ZAL,P002676,P007513,0 days 00:19:20,1,28,27
285,ZAL,P007513,P011218,0 days 00:19:03,-2,27,29
285,ZAL,P002676,P005504,0 days 00:18:46,2,35,33
285,ZAL,P005504,P011218,0 days 00:18:46,2,35,33
285,ZAL,P002329,P005504,0 days 00:18:46,2,35,33
285,ZAL,P002329,P007513,0 days 00:17:45,2,25,23
285,ZAL,P005504,P007513,0 days 00:14:33,0,20,20
285,ZAL,P010390,P012715,0 days 00:14:09,0,32,32
285,ZAL,P010390,P012787,0 days 00:12:39,13,35,22
285,ZAL,P002676,P010390,0 days 00:11:44,11,29,18
285,ZAL,P003211,P010390,0 days 00:10:28,-2,22,24
285,ZAL,P003211,P012715,0 days 00:10:01,-2,22,24
285,ZAL,P012715,P012787,0 days 00:09:22,4,21,17
285,ZAL,P007513,P010390,0 days 00:09:22,-2,20,22
285,ZAL,P002676,P012787,0 days 00:09:11,13,31,18
285,ZAL,P010390,P011218,0 days 00:09:10,9,26,17
285,ZAL,P003210,P010390,0 days 00:08:31,4,21,17
285,ZAL,P003210,P012715,0 days 00:08:31,4,21,17
285,ZAL,P011218,P012787,0 days 00:06:54,14,29,15
285,ZAL,P003210,P012787,0 days 00:06:49,2,12,10
285,ZAL,P003211,P007513,0 days 00:06:32,-4,13,17
285,ZAL,P002329,P010390,0 days 00:06:29,11,19,8
285,ZAL,P007513,P012715,0 days 00:06:10,-4,15,19
285,ZAL,P002676,P003210,0 days 00:05:53,-2,12,14
285,ZAL,P003211,P012787,0 days 00:05:42,3,14,11
285,ZAL,P002329,P012787,0 days 00:05:31,12,24,12
285,ZAL,P002676,P012715,0 days 00:05:15,0,10,10
285,ZAL,P003210,P003211,0 days 00:04:46,3,12,9
285,ZAL,P003211,P011218,0 days 00:03:22,1,10,9
285,ZAL,P011218,P012715,0 days 00:03:08,-2,7,9
285,ZAL,P003210,P007513,0 days 00:02:31,3,10,7
285,ZAL,P005504,P012787,0 days 00:02:14,3,10,7
285,ZAL,P002676,P003211,0 days 00:01:48,1,3,2
285,ZAL,P002329,P003210,0 days 00:01:45,-4,2,6
285,ZAL,P003210,P005504,0 days 00:01:45,-4,2,6
285,ZAL,P003210,P011218,0 days 00:01:45,-4,2,6
285,ZAL,P007513,P012787,0 days 00:01:36,0,4,4
285,ZAL,P002329,P003211,0 days 00:00:41,3,3,0
285,ZAL,P003210,P006860,0 days 00:00:36,1,1,0
285,ZAL,P003210,P010184,0 days 00:00:36,1,1,0
285,ZAL,P006860,P007513,0 days 00:00:36,1,1,0
285,ZAL,P006860,P010184,0 days 00:00:36,1,1,0
285,ZAL,P007513,P010184,0 days 00:00:36,1,1,0
285,ZAL,P003211,P006860,0 days 00:00:23,1,1,0
285,ZAL,P003211,P010184,0 days 00:00:23,1,1,0
285,ZAL,P003211,P005504,0 days 00:00:14,3,3,0
285,ZAL,P006860,P012787,0 days 00:00:13,0,0,0
285,ZAL,P010184,P012787,0 days 00:00:13,0,0,0
285,MIL,P002849,P007831,0 days 00:25:03,-11,41,52
285,MIL,P000796,P007831,0 days 00:22:48,-10,36,46
285,MIL,P000796,P011224,0 days 00:21:58,-12,36,48
285,MIL,P006509,P007831,0 days 00:21:27,-11,33,44
285,MIL,P007831,P011224,0 days 00:20:15,-6,35,41
285,MIL,P002849,P011224,0 days 00:19:22,-4,35,39
285,MIL,P006509,P011224,0 days 00:19:12,-6,30,36
285,MIL,P000796,P006509,0 days 00:19:01,-12,27,39
285,MIL,P000796,P002849,0 days 00:18:12,-12,27,39
285,MIL,P007032,P011205,0 days 00:17:30,-3,35,38
285,MIL,P002849,P006509,0 days 00:17:16,-7,25,32
285,MIL,P007201,P011205,0 days 00:13:08,-1,27,28
285,MIL,P007032,P007201,0 days 00:12:41,-1,27,28
285,MIL,P007831,P011205,0 days 00:12:37,-5,25,30
285,MIL,P002849,P011205,0 days 00:11:36,-7,21,28
285,MIL,P007032,P007831,0 days 00:09:19,0,17,17
285,MIL,P002849,P007032,0 days 00:09:10,-4,16,20
285,MIL,P000796,P011205,0 days 00:07:25,-2,19,21
285,MIL,P011205,P011224,0 days 00:07:01,1,23,22
285,MIL,P009960,P011205,0 days 00:06:42,-3,16,19
285,MIL,P007201,P007831,0 days 00:06:20,0,12,12
285,MIL,P007032,P011224,0 days 00:05:58,1,18,17
285,MIL,P007032,P009960,0 days 00:05:50,-1,13,14
285,MIL,P007831,P009960,0 days 00:05:39,-2,12,14
285,MIL,P000796,P007032,0 days 00:05:30,0,11,11
285,MIL,P002849,P007201,0 days 00:05:29,0,10,10
285,MIL,P009960,P011224,0 days 00:05:28,-1,14,15
285,MIL,P007201,P009960,0 days 00:05:09,-3,11,14
285,MIL,P000796,P009960,0 days 00:04:52,-2,10,12
285,MIL,P006509,P009960,0 days 00:04:47,-5,8,13
285,MIL,P007201,P011224,0 days 00:04:35,3,15,12
285,MIL,P002812,P002849,0 days 00:03:48,1,9,8
285,MIL,P002812,P007831,0 days 00:03:48,1,9,8
285,MIL,P006509,P011205,0 days 00:02:51,-6,3,9
285,MIL,P002812,P011205,0 days 00:02:45,-3,3,6
285,MIL,P000796,P007201,0 days 00:02:30,2,6,4
285,MIL,P002812,P006509,0 days 00:01:59,1,6,5
285,MIL,P002812,P007032,0 days 00:01:49,0,3,3
285,MIL,P005670,P011205,0 days 00:01:37,-3,0,3
285,MIL,P005670,P009960,0 days 00:01:37,-3,0,3
285,MIL,P005670,P007201,0 days 00:01:37,-3,0,3
285,MIL,P005670,P007032,0 days 00:01:37,-3,0,3
285,MIL,P002812,P011224,0 days 00:01:03,4,6,2
285,MIL,P006509,P007201,0 days 00:01:03,-1,0,1
285,MIL,P006509,P007032,0 days 00:00:36,-1,0,1
286,ULK,P001932,P008962,0 days 00:17:38,14,47,33
286,ULK,P001932,P010560,0 days 00:17:16,13,45,32
286,ULK,P001932,P009849,0 days 00:15:53,15,45,30
286,ULK,P008962,P009849,0 days 00:15:53,15,45,30
286,ULK,P008962,P010560,0 days 00:15:17,14,42,28
286,ULK,P009849,P010560,0 days 00:15:17,14,42,28
286,ULK,P006661,P006961,0 days 00:14:48,18,37,19
286,ULK,P006661,P011052,0 days 00:13:56,16,36,20
286,ULK,P006961,P011052,0 days 00:13:28,17,35,18
286,ULK,P006661,P011980,0 days 00:12:39,3,23,20
286,ULK,P001932,P002968,0 days 00:11:59,7,28,21
286,ULK,P002968,P010560,0 days 00:11:59,7,28,21
286,ULK,P005844,P008962,0 days 00:11:08,15,30,15
286,ULK,P011052,P011980,0 days 00:11:07,0,23,23
286,ULK,P006661,P008962,0 days 00:11:01,21,32,11
286,ULK,P002968,P008962,0 days 00:10:00,8,25,17
286,ULK,P002968,P009849,0 days 00:10:00,8,25,17
286,ULK,P005844,P011052,0 days 00:09:45,6,23,17
286,ULK,P008962,P011052,0 days 00:09:18,20,33,13
286,ULK,P005844,P006661,0 days 00:09:18,10,20,10
286,ULK,P008962,P011157,0 days 00:08:48,16,32,16
286,ULK,P006961,P008962,0 days 00:08:24,19,28,9
286,ULK,P006661,P011157,0 days 00:08:02,10,21,11
286,ULK,P006961,P011157,0 days 00:07:58,12,23,11
286,ULK,P005844,P011980,0 days 00:07:39,4,17,13
286,ULK,P001932,P011157,0 days 00:07:38,6,22,16
286,ULK,P006961,P011980,0 days 00:07:25,-2,12,14
286,ULK,P011201,P011980,0 days 00:07:07,5,18,13
286,ULK,P005844,P011201,0 days 00:06:40,4,17,13
286,ULK,P005844,P006961,0 days 00:06:30,5,13,8
286,ULK,P011052,P011157,0 days 00:06:17,11,19,8
286,ULK,P008962,P011201,0 days 00:06:15,6,17,11
286,ULK,P008962,P011980,0 days 00:06:02,8,17,9
286,ULK,P009849,P011157,0 days 00:05:53,7,20,13
286,ULK,P010560,P011157,0 days 00:05:17,6,17,11
286,ULK,P011157,P011980,0 days 00:05:07,1,9,8
286,ULK,P011052,P011201,0 days 00:04:20,-2,11,13
286,ULK,P006661,P011201,0 days 00:03:53,2,8,6
286,ULK,P001932,P006661,0 days 00:03:44,-2,5,7
286,ULK,P002968,P006661,0 days 00:03:20,-1,7,8
286,ULK,P002968,P011980,0 days 00:03:20,-1,7,8
286,ULK,P001932,P006961,0 days 00:02:21,0,5,5
286,ULK,P001932,P011980,0 days 00:01:59,-1,3,4
286,ULK,P006661,P010560,0 days 00:01:59,-1,3,4
286,ULK,P010560,P011980,0 days 00:01:59,-1,3,4
286,ULK,P002968,P006961,0 days 00:01:21,0,4,4
286,ULK,P002968,P011052,0 days 00:01:21,0,4,4
286,ULK,P011157,P011201,0 days 00:00:40,-1,1,2
286,ULK,P006961,P009849,0 days 00:00:36,1,3,2
286,ULK,P006961,P011201,0 days 00:00:25,-2,0,2
286,BER,P006251,P006919,0 days 00:16:24,-29,23,52
286,BER,P008780,P008967,0 days 00:16:21,-9,32,41
286,BER,P012720,P012721,0 days 00:15:21,-14,22,36
286,BER,P008780,P010791,0 days 00:14:33,6,34,28
286,BER,P010791,P012721,0 days 00:13:43,-3,24,27
286,BER,P008967,P010791,0 days 00:13:27,3,31,28
286,BER,P006919,P008780,0 days 00:13:25,-7,29,36
286,BER,P008967,P012721,0 days 00:12:30,-1,27,28
286,BER,P006919,P010791,0 days 00:12:15,0,29,29
286,BER,P006919,P008967,0 days 00:11:16,-5,25,30
286,BER,P006251,P008780,0 days 00:11:02,-13,19,32
286,BER,P010791,P012720,0 days 00:10:56,-12,16,28
286,BER,P007025,P012721,0 days 00:10:55,-2,19,21
286,BER,P008211,P012721,0 days 00:10:51,-5,16,21
286,BER,P008211,P012720,0 days 00:10:41,-15,14,29
286,BER,P006251,P008967,0 days 00:10:14,-11,19,30
286,BER,P007025,P010791,0 days 00:09:47,-6,14,20
286,BER,P008780,P012721,0 days 00:09:13,5,19,14
286,BER,P007025,P012720,0 days 00:08:48,-7,12,19
286,BER,P006251,P010791,0 days 00:08:41,-5,17,22
286,BER,P007025,P008211,0 days 00:08:34,-1,12,13
286,BER,P008967,P012720,0 days 00:07:31,-5,12,17
286,BER,P008780,P012720,0 days 00:07:14,-6,11,17
286,BER,P006819,P006919,0 days 00:06:55,-22,6,28
286,BER,P006251,P006819,0 days 00:06:55,-22,6,28
286,BER,P006819,P008967,0 days 00:06:55,-13,11,24
286,BER,P006251,P007025,0 days 00:06:16,-8,7,15
286,BER,P007025,P007550,0 days 00:06:14,-8,11,19
286,BER,P006251,P012720,0 days 00:06:14,-12,7,19
286,BER,P006919,P007025,0 days 00:06:02,-9,8,17
286,BER,P008211,P010791,0 days 00:05:51,-4,8,12
286,BER,P007550,P010791,0 days 00:05:47,-11,7,18
286,BER,P006819,P012721,0 days 00:05:46,-3,12,15
286,BER,P007550,P012721,0 days 00:05:42,-6,12,18
286,BER,P006819,P012720,0 days 00:05:40,-12,7,19
286,BER,P006819,P008211,0 days 00:05:35,-8,7,15
286,BER,P006919,P012720,0 days 00:04:49,-12,6,18
286,BER,P006819,P007025,0 days 00:04:47,-4,10,14
286,BER,P007550,P008967,0 days 00:04:31,-2,10,12
286,BER,P006919,P007550,0 days 00:04:23,-11,4,15
286,BER,P006251,P007550,0 days 00:04:23,-11,4,15
286,BER,P006819,P007550,0 days 00:04:18,-6,9,15
286,BER,P007025,P008780,0 days 00:04:04,2,8,6
286,BER,P006819,P008780,0 days 00:03:53,-10,4,14
286,BER,P006251,P008211,0 days 00:03:45,-5,5,10
286,BER,P007550,P012720,0 days 00:03:26,-9,5,14
286,BER,P006251,P012721,0 days 00:02:46,0,5,5
286,BER,P007025,P008967,0 days 00:02:21,-1,7,8
286,BER,P006919,P012721,0 days 00:02:13,5,8,3
286,BER,P006919,P008211,0 days 00:02:10,-6,2,8
286,BER,P008211,P008780,0 days 00:01:55,4,4,0
286,BER,P007550,P008211,0 days 00:01:36,-4,2,6
286,BER,P008211,P008967,0 days 00:01:06,0,2,2
287,MAD,P003108,P010357,0 days 00:21:42,23,68,45
287,MAD,P010357,PTGB,0 days 00:19:04,5,51,46
287,MAD,P006540,P010357,0 days 00:17:47,13,57,44
287,MAD,P005791,P006540,0 days 00:17:20,2,45,43
287,MAD,P010357,PBMT,0 days 00:17:15,7,46,39
287,MAD,P003108,PBMT,0 days 00:17:05,8,44,36
287,MAD,P005791,P010357,0 days 00:16:58,6,49,43
287,MAD,P005791,PTGB,0 days 00:16:27,8,49,41
287,MAD,P003108,P006540,0 days 00:14:28,21,50,29
287,MAD,P003108,P005791,0 days 00:12:28,16,42,26
287,MAD,P003108,PCVM,0 days 00:12:25,0,27,27
287,MAD,P003108,PTGB,0 days 00:11:03,21,41,20
287,MAD,P006540,PTGB,0 days 00:10:42,4,33,29
287,MAD,P010357,PCVM,0 days 00:10:34,1,24,23
287,MAD,PBMT,PCVM,0 days 00:10:32,-3,21,24
287,MAD,P006540,PBMT,0 days 00:10:01,5,28,23
287,MAD,P005791,PBMT,0 days 00:09:54,3,26,23
287,MAD,P006540,P011649,0 days 00:08:53,-6,16,22
287,MAD,P005791,P011649,0 days 00:08:53,-6,16,22
287,MAD,P006540,PCVM,0 days 00:08:51,7,24,17
287,MAD,PBMT,PTGB,0 days 00:08:29,8,25,17
287,MAD,P009213,P010623,0 days 00:08:26,1,20,19
287,MAD,P003108,P009213,0 days 00:07:43,-1,21,22
287,MAD,P006540,P009213,0 days 00:07:42,5,20,15
287,MAD,P009213,P010357,0 days 00:06:41,-6,12,18
287,MAD,P010623,P011649,0 days 00:05:44,1,11,10
287,MAD,P005791,P010623,0 days 00:05:44,1,11,10
287,MAD,P005791,P009213,0 days 00:05:44,1,11,10
287,MAD,P006540,P010623,0 days 00:05:44,1,11,10
287,MAD,P009213,P011649,0 days 00:05:44,1,11,10
287,MAD,P001392,P003733,0 days 00:05:33,-7,9,16
287,MAD,P009213,PCVM,0 days 00:04:56,-2,9,11
287,MAD,P001392,P009213,0 days 00:04:22,-5,9,14
287,MAD,P003733,P009213,0 days 00:04:22,-5,9,14
287,MAD,P010357,P011649,0 days 00:03:09,-7,5,12
287,MAD,P011649,PTGB,0 days 00:03:09,-7,5,12
287,MAD,P009213,PBMT,0 days 00:03:08,-4,6,10
287,MAD,P001392,P010357,0 days 00:02:51,-7,0,7
287,MAD,P001392,PTGB,0 days 00:02:51,-7,0,7
287,MAD,P003733,P010357,0 days 00:02:51,-7,0,7
287,MAD,P003733,PTGB,0 days 00:02:51,-7,0,7
287,MAD,P001392,P010623,0 days 00:02:42,0,9,9
287,MAD,P003108,P003733,0 days 00:02:42,0,9,9
287,MAD,P003108,P010623,0 days 00:02:42,0,9,9
287,MAD,P001392,P003108,0 days 00:02:42,0,9,9
287,MAD,P003733,P010623,0 days 00:02:42,0,9,9
287,MAD,P005791,PCVM,0 days 00:02:22,-3,3,6
287,MAD,P009213,PTGB,0 days 00:01:40,-5,0,5
287,MAD,P001392,P005791,0 days 00:01:11,-2,0,2
287,MAD,P003733,P005791,0 days 00:01:11,-2,0,2
287,RED,P000848,P005099,0 days 00:22:10,5,53,48
287,RED,P005099,P009035,0 days 00:19:35,-13,39,52
287,RED,P000848,P009035,0 days 00:16:33,-5,36,41
287,RED,P005099,P011964,0 days 00:14:12,4,37,33
287,RED,P000848,P006436,0 days 00:14:02,-1,38,39
287,RED,P000848,P007960,0 days 00:13:39,-2,34,36
287,RED,P005099,P006436,0 days 00:13:31,-10,29,39
287,RED,P000848,PLUO,0 days 00:12:16,-1,27,28
287,RED,P006436,P011964,0 days 00:12:00,0,28,28
287,RED,P000848,P011941,0 days 00:11:23,11,32,21
287,RED,P000848,P011964,0 days 00:11:23,0,28,28
287,RED,P006436,P009035,0 days 00:10:48,-9,21,30
287,RED,P000848,P002553,0 days 00:10:27,4,27,23
287,RED,P011941,P012801,0 days 00:10:26,2,29,27
287,RED,P005099,P007960,0 days 00:10:25,6,25,19
287,RED,P005099,PLUO,0 days 00:10:07,-9,18,27
287,RED,P000848,P012801,0 days 00:10:06,-9,26,35
287,RED,P009035,P011964,0 days 00:10:04,-4,21,25
287,RED,P005099,P011941,0 days 00:09:53,17,29,12
287,RED,P009035,PLUO,0 days 00:09:31,-9,18,27
287,RED,P007960,P012801,0 days 00:07:36,-12,17,29
287,RED,P002553,P007960,0 days 00:07:33,3,22,19
287,RED,P005099,P012801,0 days 00:07:24,-4,17,21
287,RED,P012801,PLUO,0 days 00:07:17,-3,15,18
287,RED,P008966,P012801,0 days 00:07:08,-7,14,21
287,RED,P007960,P011941,0 days 00:06:54,3,17,14
287,RED,P002553,P005099,0 days 00:06:30,2,12,10
287,RED,P002553,P011941,0 days 00:06:29,2,15,13
287,RED,P008966,PLUO,0 days 00:06:13,-2,13,15
287,RED,P007960,PLUO,0 days 00:05:48,-5,12,17
287,RED,P002553,P012801,0 days 00:05:19,-7,15,22
287,RED,P007960,P009035,0 days 00:05:14,-1,12,13
287,RED,P000848,P008966,0 days 00:05:01,-4,11,15
287,RED,P011941,PLUO,0 days 00:05:00,4,12,8
287,RED,P004720,P012801,0 days 00:04:47,2,13,11
287,RED,P011941,P011964,0 days 00:04:08,8,16,8
287,RED,P004720,P005099,0 days 00:04:03,4,13,9
287,RED,P004720,P011941,0 days 00:04:03,4,13,9
287,RED,P002553,PLUO,0 days 00:04:02,-6,5,11
287,RED,P006436,P012801,0 days 00:03:42,-3,10,13
287,RED,P008966,P011941,0 days 00:03:34,5,10,5
287,RED,P002553,P006436,0 days 00:03:24,-5,9,14
287,RED,P011964,P012801,0 days 00:02:49,4,9,5
287,RED,P006436,P007960,0 days 00:02:42,0,9,9
287,RED,P009035,P012801,0 days 00:02:42,-3,3,6
287,RED,P002553,P009035,0 days 00:02:36,-5,3,8
287,RED,P004720,P007960,0 days 00:02:35,-2,4,6
287,RED,P005099,P008966,0 days 00:02:30,-6,4,10
287,RED,P006436,P011941,0 days 00:02:18,4,7,3
287,RED,P004720,P011964,0 days 00:02:12,4,9,5
287,RED,P008966,P009035,0 days 00:01:53,-3,3,6
287,RED,P007960,P008966,0 days 00:01:18,-6,0,6
287,RED,P006436,PLUO,0 days 00:00:54,-5,0,5
287,RED,P000848,P004720,0 days 00:00:32,-2,0,2
287,RED,P004720,P008966,0 days 00:00:32,-2,0,2
287,RED,P006436,P008966,0 days 00:00:23,-3,1,4
287,RED,P004720,P006436,0 days 00:00:12,0,0,0
287,RED,P004720,P009035,0 days 00:00:12,0,0,0
288,VIR,P001133,P004007,0 days 00:23:22,-3,44,47
288,VIR,P001133,PBCN,0 days 00:22:41,-3,45,48
288,VIR,P006739,PBCN,0 days 00:22:25,4,46,42
288,VIR,P001133,P006739,0 days 00:22:21,-3,46,49
288,VIR,P001133,P003048,0 days 00:19:18,-2,41,43
288,VIR,P003048,P006739,0 days 00:18:33,-1,39,40
288,VIR,P004007,PBCN,0 days 00:17:38,-5,33,38
288,VIR,P003048,PBCN,0 days 00:17:33,0,36,36
288,VIR,P003048,P004007,0 days 00:16:56,-1,34,35
288,VIR,P004007,P006739,0 days 00:16:39,-2,32,34
288,VIR,P004554,P010781,0 days 00:13:49,2,28,26
288,VIR,P001133,P010781,0 days 00:11:57,0,25,25
288,VIR,P006739,P010781,0 days 00:11:34,9,30,21
288,VIR,P001844,P010781,0 days 00:10:48,-6,16,22
288,VIR,P003527,P010781,0 days 00:08:25,-6,16,22
288,VIR,P002084,P010781,0 days 00:08:21,-3,16,19
288,VIR,P002084,P004554,0 days 00:08:03,-3,16,19
288,VIR,P004554,P006739,0 days 00:07:57,9,20,11
288,VIR,P001844,P004007,0 days 00:07:51,0,14,14
288,VIR,P004007,P010781,0 days 00:07:36,1,13,12
288,VIR,P002084,P003527,0 days 00:07:28,-3,14,17
288,VIR,P010781,PBCN,0 days 00:07:14,6,17,11
288,VIR,P008847,P010781,0 days 00:07:13,6,13,7
288,VIR,P003527,P004554,0 days 00:07:10,-3,14,17
288,VIR,P004007,P008847,0 days 00:07:03,-2,10,12
288,VIR,P001133,P001844,0 days 00:06:30,0,12,12
288,VIR,P001133,P008847,0 days 00:06:26,-2,10,12
288,VIR,P001844,P008847,0 days 00:06:17,0,10,10
288,VIR,P001844,P004554,0 days 00:05:52,-7,8,15
288,VIR,P001844,P002084,0 days 00:05:15,-7,8,15
288,VIR,P004554,PBCN,0 days 00:05:09,5,12,7
288,VIR,P001844,P003527,0 days 00:04:31,-7,6,13
288,VIR,P003048,P010781,0 days 00:03:59,-1,10,11
288,VIR,P003527,P006739,0 days 00:03:54,1,10,9
288,VIR,P008847,PBCN,0 days 00:03:28,2,7,5
288,VIR,P001133,P004554,0 days 00:03:20,0,7,7
288,VIR,P002084,P006739,0 days 00:03:06,4,8,4
288,VIR,P006739,P008847,0 days 00:02:35,3,5,2
288,VIR,P004554,P008847,0 days 00:02:26,5,5,0
288,VIR,P001844,PBCN,0 days 00:01:43,-1,4,5
288,VIR,P004007,P004554,0 days 00:01:30,0,2,2
288,VIR,P003048,P003527,0 days 00:01:06,-3,2,5
288,VIR,P001133,P003527,0 days 00:00:57,-3,2,5
288,VIR,P002084,P004007,0 days 00:00:53,0,2,2
288,VIR,P001844,P003048,0 days 00:00:41,0,2,2
288,VIR,P002084,P003048,0 days 00:00:18,0,0,0
288,VIR,P003527,PBCN,0 days 00:00:09,0,0,0
288,PAN,P003842,P012774,0 days 00:31:49,-10,58,68
288,PAN,P001926,P012774,0 days 00:30:03,7,62,55
288,PAN,P007866,P012774,0 days 00:27:36,-5,52,57
288,PAN,P001926,P003842,0 days 00:27:14,7,61,54
288,PAN,P003842,P007866,0 days 00:27:04,1,55,54
288,PAN,P001926,P007866,0 days 00:25:29,10,59,49
288,PAN,P011204,P012774,0 days 00:23:56,-12,41,53
288,PAN,P003842,P011204,0 days 00:23:24,-6,44,50
288,PAN,P007866,P011204,0 days 00:22:48,-4,43,47
288,PAN,P001926,P011204,0 days 00:19:01,7,44,37
288,PAN,P002328,P012774,0 days 00:13:10,-1,22,23
288,PAN,P002328,P003842,0 days 00:12:36,4,29,25
288,PAN,P001926,P002328,0 days 00:12:05,9,29,20
288,PAN,P002328,P007866,0 days 00:12:04,7,29,22
288,PAN,P012712,P012774,0 days 00:09:38,0,18,18
288,PAN,P003842,P012712,0 days 00:07:31,-4,14,18
288,PAN,P003842,P005161,0 days 00:07:10,1,15,14
288,PAN,P001926,P012712,0 days 00:06:50,4,14,10
288,PAN,P005161,P012774,0 days 00:06:40,1,15,14
288,PAN,P002328,P011204,0 days 00:06:00,4,15,11
288,PAN,P005161,P012712,0 days 00:05:10,-2,9,11
288,PAN,P011221,P012774,0 days 00:05:02,5,12,7
288,PAN,P001926,P011221,0 days 00:04:42,7,12,5
288,PAN,P011204,P012712,0 days 00:03:54,-1,9,10
288,PAN,P001926,P005161,0 days 00:03:52,5,11,6
288,PAN,P002328,P012712,0 days 00:03:22,-1,4,5
288,PAN,P005161,P011204,0 days 00:03:18,-4,4,8
288,PAN,P007866,P011221,0 days 00:02:55,1,8,7
288,PAN,P011204,P011221,0 days 00:02:55,1,8,7
288,PAN,P002328,P011221,0 days 00:02:27,2,4,2
288,PAN,P011221,P012712,0 days 00:02:07,4,4,0
288,PAN,P005161,P007866,0 days 00:02:00,3,6,3
288,PAN,P003842,P011209,0 days 00:01:32,-5,0,5
288,PAN,P007866,P011209,0 days 00:01:32,-5,0,5
288,PAN,P011204,P011209,0 days 00:01:32,-5,0,5
288,PAN,P011209,P012774,0 days 00:01:02,-5,0,5
288,PAN,P005161,P011209,0 days 00:00:30,0,0,0
289,BER,P008780,P008967,0 days 00:23:47,0,58,58
289,BER,P008967,P011934,0 days 00:22:18,-3,52,55
289,BER,P008780,P011934,0 days 00:21:18,2,49,47
289,BER,P003958,P008967,0 days 00:20:57,7,59,52
289,BER,P003958,P012720,0 days 00:20:44,0,52,52
289,BER,P003958,P008780,0 days 00:19:13,9,57,48
289,BER,P008780,P012720,0 days 00:18:06,8,52,44
289,BER,P003958,P011934,0 days 00:16:16,10,48,38
289,BER,P011934,P012720,0 days 00:15:54,11,46,35
289,BER,P008967,P012720,0 days 00:15:14,8,47,39
289,BER,P007025,P010791,0 days 00:09:47,-10,10,20
289,BER,P010791,P012720,0 days 00:09:31,-11,14,25
289,BER,P008211,P011934,0 days 00:09:18,-12,12,24
289,BER,P007025,P007550,0 days 00:08:48,-5,12,17
289,BER,P003958,P010791,0 days 00:08:47,-8,14,22
289,BER,P006251,P011934,0 days 00:08:45,-13,9,22
289,BER,P007025,P012720,0 days 00:08:36,-12,12,24
289,BER,P007550,P010791,0 days 00:08:17,-10,7,17
289,BER,P003958,P007550,0 days 00:07:45,-5,12,17
289,BER,P006251,P008780,0 days 00:07:26,-9,6,15
289,BER,P008211,P008967,0 days 00:07:25,-13,7,20
289,BER,P006251,P008211,0 days 00:07:17,-11,7,18
289,BER,P003958,P007025,0 days 00:06:35,-5,12,17
289,BER,P007550,P012720,0 days 00:06:32,-10,7,17
289,BER,P006251,P008967,0 days 00:06:02,-13,4,17
289,BER,P008211,P008780,0 days 00:05:35,-7,4,11
289,BER,P008967,P012721,0 days 00:05:31,-6,9,15
289,BER,P006251,P012720,0 days 00:05:15,-2,10,12
289,BER,P007550,P008211,0 days 00:05:07,3,10,7
289,BER,P008211,P012721,0 days 00:04:48,0,8,8
289,BER,P008780,P010791,0 days 00:04:47,0,12,12
289,BER,P008780,P012721,0 days 00:04:20,-1,9,10
289,BER,P011934,P012721,0 days 00:04:14,-6,7,13
289,BER,P003958,P012721,0 days 00:04:13,5,12,7
289,BER,P010791,P012721,0 days 00:03:33,1,5,4
289,BER,P003958,P008211,0 days 00:03:22,3,10,7
289,BER,P008967,P010791,0 days 00:03:17,0,9,9
289,BER,P006251,P012721,0 days 00:03:10,-6,5,11
289,BER,P007550,P012721,0 days 00:03:06,4,5,1
289,BER,P007550,P008967,0 days 00:02:51,-2,5,7
289,BER,P008211,P012720,0 days 00:02:43,0,5,5
289,BER,P006251,P010791,0 days 00:02:32,-2,5,7
289,BER,P006251,P007025,0 days 00:02:32,-2,5,7
289,BER,P007025,P008211,0 days 00:02:16,5,5,0
289,BER,P007025,P012721,0 days 00:02:16,5,5,0
289,BER,P006251,P007550,0 days 00:02:09,-2,5,7
289,BER,P007025,P008780,0 days 00:02:04,-2,5,7
289,BER,P007550,P011934,0 days 00:02:01,-1,5,6
289,BER,P008211,P010791,0 days 00:01:45,0,0,0
289,BER,P012720,P012721,0 days 00:01:21,0,3,3
289,BER,P007025,P008967,0 days 00:00:34,-2,2,4
289,PAR,P008987,P009862,0 days 00:24:09,3,61,58
289,PAR,P007400,P008987,0 days 00:23:17,8,58,50
289,PAR,P007400,P009862,0 days 00:23:16,9,62,53
289,PAR,P008987,P012742,0 days 00:21:47,11,54,43
289,PAR,P009862,P012743,0 days 00:18:41,1,43,42
289,PAR,P007400,P012742,0 days 00:18:05,5,44,39
289,PAR,P007400,P012096,0 days 00:16:10,5,38,33
289,PAR,P003983,P007400,0 days 00:15:53,8,37,29
289,PAR,P009862,P012742,0 days 00:15:33,5,42,37
289,PAR,P011051,P012742,0 days 00:13:23,-1,27,28
289,PAR,P008987,P012743,0 days 00:13:05,-5,28,33
289,PAR,P009862,P012096,0 days 00:12:46,10,33,23
289,PAR,P003983,P009862,0 days 00:12:32,5,32,27
289,PAR,P007400,P012743,0 days 00:11:35,0,28,28
289,PAR,P012742,P012743,0 days 00:11:02,0,26,26
289,PAR,P003983,P008987,0 days 00:10:17,2,22,20
289,PAR,P008987,P011051,0 days 00:09:59,4,22,18
289,PAR,P003983,P012096,0 days 00:09:55,8,26,18
289,PAR,P000956,P007400,0 days 00:09:08,0,19,19
289,PAR,P009862,P011051,0 days 00:07:43,2,16,14
289,PAR,P003983,P012743,0 days 00:07:39,1,17,16
289,PAR,P007400,P011050,0 days 00:07:18,6,17,11
289,PAR,P008987,P011050,0 days 00:07:18,6,17,11
289,PAR,P011050,P012742,0 days 00:07:18,6,17,11
289,PAR,P011051,P012743,0 days 00:07:06,1,15,14
289,PAR,P007400,P011051,0 days 00:06:54,-1,13,14
289,PAR,P000956,P011051,0 days 00:06:54,-1,13,14
289,PAR,P008987,P012096,0 days 00:06:33,3,17,14
289,PAR,P000956,P012742,0 days 00:06:17,-2,12,14
289,PAR,P000956,P012096,0 days 00:06:15,-3,12,15
289,PAR,P012096,P012743,0 days 00:05:36,6,15,9
289,PAR,P000956,P008987,0 days 00:05:07,4,13,9
289,PAR,P011051,P012096,0 days 00:04:01,-4,6,10
289,PAR,P009862,P011050,0 days 00:03:57,3,12,9
289,PAR,P003983,P012742,0 days 00:03:55,5,9,4
289,PAR,P012096,P012742,0 days 00:03:24,-5,5,10
289,PAR,P003983,P011050,0 days 00:03:21,3,5,2
289,PAR,P000956,P009862,0 days 00:02:51,2,7,5
290,MCO,P005985,P010588,0 days 00:26:05,3,43,40
290,MCO,P010588,PLCZ,0 days 00:19:34,16,36,20
290,MCO,P005985,PLCZ,0 days 00:19:29,16,36,20
290,MCO,P011212,P011226,0 days 00:17:52,-8,29,37
290,MCO,P010588,P011226,0 days 00:16:52,-8,27,35
290,MCO,P005985,P011231,0 days 00:16:17,3,29,26
290,MCO,P009754,P011212,0 days 00:15:39,4,30,26
290,MCO,P005985,P011226,0 days 00:15:01,-5,25,30
290,MCO,P011196,P011212,0 days 00:14:44,-4,26,30
290,MCO,P011212,P011231,0 days 00:14:40,0,31,31
290,MCO,P005985,P011212,0 days 00:14:14,6,27,21
290,MCO,P009754,P011226,0 days 00:13:53,-7,26,33
290,MCO,P010588,P011231,0 days 00:13:42,-5,21,26
290,MCO,P009754,P011231,0 days 00:13:24,-6,26,32
290,MCO,P008099,PLCZ,0 days 00:12:28,4,16,12
290,MCO,P008099,P010588,0 days 00:12:28,4,16,12
290,MCO,P010588,P011212,0 days 00:12:11,-2,19,21
290,MCO,P005985,P008099,0 days 00:11:58,4,16,12
290,MCO,P011226,P011231,0 days 00:11:37,-11,21,32
290,MCO,P009754,P011196,0 days 00:11:14,3,24,21
290,MCO,P005985,P009754,0 days 00:10:45,7,24,17
290,MCO,P011196,P011226,0 days 00:10:27,-9,16,25
290,MCO,P011196,P011231,0 days 00:10:24,3,24,21
290,MCO,P011231,PLCZ,0 days 00:10:15,4,14,10
290,MCO,P011226,PLCZ,0 days 00:09:43,8,18,10
290,MCO,P008099,P011231,0 days 00:09:25,4,14,10
290,MCO,P009754,P010588,0 days 00:08:12,-1,16,17
290,MCO,P005985,P011196,0 days 00:07:47,-2,12,14
290,MCO,P009754,PLCZ,0 days 00:06:17,8,14,6
290,MCO,P011212,PLCZ,0 days 00:05:30,8,10,2
290,MCO,P010588,P011196,0 days 00:04:20,-7,2,9
290,MCO,P008099,P011226,0 days 00:03:03,0,2,2
290,MCO,P008099,P011212,0 days 00:00:30,0,0,0
290,ZAL,P002329,P011218,0 days 00:26:27,-1,43,44
290,ZAL,P007513,P011218,0 days 00:24:33,0,39,39
290,ZAL,P010390,P011218,0 days 00:21:35,7,37,30
290,ZAL,P007513,P010390,0 days 00:20:21,9,37,28
290,ZAL,P011218,P012715,0 days 00:19:54,0,36,36
290,ZAL,P002329,P007513,0 days 00:19:18,3,32,29
290,ZAL,P002329,P012715,0 days 00:18:57,1,38,37
290,ZAL,P002329,P010390,0 days 00:18:34,4,30,26
290,ZAL,P002329,P012787,0 days 00:16:12,-3,29,32
290,ZAL,P012715,P012787,0 days 00:14:18,-10,20,30
290,ZAL,P010390,P012715,0 days 00:13:13,4,25,21
290,ZAL,P007513,P012715,0 days 00:12:13,4,25,21
290,ZAL,P002329,P003210,0 days 00:11:58,3,23,20
290,ZAL,P011218,P012787,0 days 00:10:45,-8,13,21
290,ZAL,P002676,P011218,0 days 00:10:40,-3,18,21
290,ZAL,P002329,P002676,0 days 00:09:43,-3,16,19
290,ZAL,P007109,P012787,0 days 00:08:00,-1,16,17
290,ZAL,P003210,P011218,0 days 00:07:52,3,12,9
290,ZAL,P003210,P012787,0 days 00:07:46,2,17,15
290,ZAL,P002676,P007513,0 days 00:07:14,-5,8,13
290,ZAL,P003210,P012715,0 days 00:07:14,2,15,13
290,ZAL,P003210,P007513,0 days 00:06:36,4,11,7
290,ZAL,P003210,P010390,0 days 00:06:36,4,11,7
290,ZAL,P003210,P007109,0 days 00:06:30,3,16,13
290,ZAL,P002329,P007109,0 days 00:06:13,3,16,13
290,ZAL,P003211,P012787,0 days 00:05:59,-2,7,9
290,ZAL,P007109,P012715,0 days 00:05:21,-4,9,13
290,ZAL,P002329,P003211,0 days 00:05:10,-2,7,9
290,ZAL,P002676,P010390,0 days 00:04:32,0,6,6
290,ZAL,P002676,P012715,0 days 00:04:23,2,12,10
290,ZAL,P010390,P012787,0 days 00:04:04,-4,2,6
290,ZAL,P003211,P012715,0 days 00:04:01,-7,0,7
290,ZAL,P002676,P012787,0 days 00:03:26,2,10,8
290,ZAL,P007513,P012787,0 days 00:03:04,-4,2,6
290,ZAL,P003210,P003211,0 days 00:02:56,3,7,4
290,ZAL,P003211,P007109,0 days 00:02:56,3,7,4
290,ZAL,P002329,P005504,0 days 00:02:42,-5,2,7
290,ZAL,P005504,P007513,0 days 00:02:42,-5,2,7
290,ZAL,P005504,P011218,0 days 00:02:42,-5,2,7
290,ZAL,P002676,P005504,0 days 00:02:42,-5,2,7
290,ZAL,P003211,P010390,0 days 00:02:29,-4,0,4
290,ZAL,P003211,P011218,0 days 00:02:28,-5,0,5
290,ZAL,P007109,P007513,0 days 00:01:30,-4,0,4
290,ZAL,P007109,P011218,0 days 00:01:30,-4,0,4
290,ZAL,P003211,P007513,0 days 00:00:41,-2,0,2
290,ZAL,P002329,P006860,0 days 00:00:30,0,0,0
290,ZAL,P006860,P011218,0 days 00:00:30,0,0,0
290,ZAL,P006860,P012715,0 days 00:00:30,0,0,0
290,ZAL,P006860,P012787,0 days 00:00:30,0,0,0
291,RED,P000848,P005099,0 days 00:25:30,-9,52,61
291,RED,P000848,P009035,0 days 00:24:25,-5,52,57
291,RED,P006436,P009035,0 days 00:24:08,15,66,51
291,RED,P005099,P009035,0 days 00:24:01,-3,52,55
291,RED,P009035,PJDR,0 days 00:22:52,4,56,52
291,RED,P000848,P006436,0 days 00:19:32,9,52,43
291,RED,P005099,P006436,0 days 00:18:43,11,52,41
291,RED,P006436,PJDR,0 days 00:18:18,11,51,40
291,RED,P005099,P011964,0 days 00:16:42,0,34,34
291,RED,P009035,P011964,0 days 00:15:08,0,29,29
291,RED,P002553,P006436,0 days 00:14:15,-2,32,34
291,RED,P005099,PJDR,0 days 00:14:01,0,32,32
291,RED,P000848,P011964,0 days 00:14:00,-3,27,30
291,RED,P000848,PJDR,0 days 00:13:43,0,32,32
291,RED,P006436,P011964,0 days 00:12:02,11,31,20
291,RED,P002553,PJDR,0 days 00:10:49,-2,22,24
291,RED,P002553,P009035,0 days 00:09:11,0,22,22
291,RED,P000848,P002553,0 days 00:08:31,4,20,16
291,RED,P006436,P012044,0 days 00:06:46,-2,14,16
291,RED,P012044,PJDR,0 days 00:06:46,-2,14,16
291,RED,P005099,P007960,0 days 00:06:34,-5,11,16
291,RED,P009035,P012044,0 days 00:06:31,-2,14,16
291,RED,P000848,P007960,0 days 00:05:57,-8,8,16
291,RED,P007960,P009035,0 days 00:05:53,-5,11,16
291,RED,P002553,P012044,0 days 00:05:43,-4,12,16
291,RED,P007960,PJDR,0 days 00:05:42,-4,8,12
291,RED,P002553,P005099,0 days 00:05:30,-2,10,12
291,RED,P005099,PLUO,0 days 00:04:51,-8,2,10
291,RED,P009035,PLUO,0 days 00:04:51,-8,2,10
291,RED,P011964,PLUO,0 days 00:04:51,-8,2,10
291,RED,P011964,PJDR,0 days 00:03:45,5,9,4
291,RED,P000848,PLUO,0 days 00:03:44,-6,2,8
291,RED,P002553,P011964,0 days 00:02:37,2,7,5
291,RED,P002553,P011941,0 days 00:02:27,-4,3,7
291,RED,P006436,P011941,0 days 00:02:27,-4,3,7
291,RED,P005099,P011941,0 days 00:02:12,-4,3,7
291,RED,P000848,P011941,0 days 00:01:30,-2,3,5
291,RED,PJDR,PLUO,0 days 00:01:07,-2,0,2
291,RED,P011964,P012044,0 days 00:01:03,2,2,0
291,RED,P011941,PJDR,0 days 00:00:57,-2,0,2
291,RED,P007960,P011964,0 days 00:00:52,-1,3,4
291,RED,P002553,P007960,0 days 00:00:41,0,0,0
291,RED,P006436,P007960,0 days 00:00:37,3,3,0
291,RED,P011941,P012044,0 days 00:00:15,0,0,0
291,OLY,P001255,P008855,0 days 00:27:50,1,59,58
291,OLY,P008811,P008855,0 days 00:20:03,-6,36,42
291,OLY,P001255,P008811,0 days 00:20:00,5,44,39
291,OLY,P001255,P008829,0 days 00:15:14,6,33,27
291,OLY,P008811,P008829,0 days 00:15:08,6,33,27
291,OLY,P001255,P010612,0 days 00:14:51,4,31,27
291,OLY,P008811,P010612,0 days 00:14:51,4,31,27
291,OLY,P008855,P010612,0 days 00:14:51,4,31,27
291,OLY,P008829,P008855,0 days 00:14:11,-1,26,27
291,OLY,P007982,P012878,0 days 00:12:43,-1,32,33
291,OLY,P008855,P011965,0 days 00:12:28,1,31,30
291,OLY,P001255,P011965,0 days 00:12:28,1,31,30
291,OLY,P001255,P007982,0 days 00:11:13,11,37,26
291,OLY,P008855,P012878,0 days 00:10:24,2,26,24
291,OLY,P006589,P007853,0 days 00:10:00,-6,19,25
291,OLY,P008829,P010612,0 days 00:09:59,5,20,15
291,OLY,P001255,P012878,0 days 00:09:54,4,26,22
291,OLY,P011965,P012878,0 days 00:09:54,4,26,22
291,OLY,P007982,P008855,0 days 00:09:03,3,26,23
291,OLY,P001255,P010392,0 days 00:08:23,4,19,15
291,OLY,P010392,P012878,0 days 00:07:36,1,13,12
291,OLY,P007853,P012878,0 days 00:06:47,-4,12,16
291,OLY,P006589,P012878,0 days 00:06:40,-4,12,16
291,OLY,P007982,P011965,0 days 00:06:39,1,20,19
291,OLY,P007982,P010392,0 days 00:06:32,6,18,12
291,OLY,P008855,P010392,0 days 00:06:13,-4,8,12
291,OLY,P007853,P007982,0 days 00:06:10,-2,12,14
291,OLY,P006589,P007982,0 days 00:06:10,-2,12,14
291,OLY,P007853,P011983,0 days 00:05:38,-4,12,16
291,OLY,P006589,P011983,0 days 00:05:38,-4,12,16
291,OLY,P008829,P010392,0 days 00:05:09,1,13,12
291,OLY,P008811,P010392,0 days 00:05:09,1,13,12
291,OLY,P007982,P008811,0 days 00:04:34,10,17,7
291,OLY,P006589,P010392,0 days 00:04:22,-2,7,9
291,OLY,P007853,P010392,0 days 00:04:22,-2,7,9
291,OLY,P007853,P008855,0 days 00:03:57,-4,7,11
291,OLY,P008855,P011983,0 days 00:03:50,-4,7,11
291,OLY,P006589,P008855,0 days 00:03:50,-4,7,11
291,OLY,P010392,P011965,0 days 00:03:14,3,6,3
291,OLY,P010612,P011965,0 days 00:02:28,-3,5,8
291,OLY,P008811,P011965,0 days 00:02:28,-3,5,8
291,OLY,P007982,P010612,0 days 00:02:24,2,6,4
291,OLY,P011983,P012878,0 days 00:02:18,-2,5,7
291,OLY,P007982,P008829,0 days 00:02:16,8,11,3
291,OLY,P006589,P008811,0 days 00:02:13,-3,3,6
291,OLY,P008811,P011983,0 days 00:02:13,-3,3,6
291,OLY,P007853,P008811,0 days 00:02:13,-3,3,6
291,OLY,P007982,P011983,0 days 00:01:48,0,5,5
291,OLY,P006589,P008829,0 days 00:01:07,1,4,3
291,OLY,P007853,P008829,0 days 00:01:07,1,4,3
291,OLY,P008829,P011983,0 days 00:01:07,1,4,3
291,OLY,P001255,P007853,0 days 00:00:07,0,0,0
291,OLY,P007853,P011965,0 days 00:00:07,0,0,0
291,OLY,P008829,P011965,0 days 00:00:06,0,0,0
292,BAR,P000925,P002939,0 days 00:23:00,16,53,37
292,BAR,P000925,P006435,0 days 00:22:20,18,58,40
292,BAR,P002939,P006435,0 days 00:21:34,19,55,36
292,BAR,P002939,P004866,0 days 00:19:08,10,38,28
292,BAR,P004866,P006435,0 days 00:17:24,13,40,27
292,BAR,P000925,P012745,0 days 00:16:05,5,39,34
292,BAR,P000925,P004866,0 days 00:15:35,5,29,24
292,BAR,P002939,P012745,0 days 00:15:09,10,39,29
292,BAR,P002939,P003478,0 days 00:14:17,6,34,28
292,BAR,P000925,P003478,0 days 00:13:31,5,35,30
292,BAR,P006435,P012745,0 days 00:13:15,11,39,28
292,BAR,P004866,P011244,0 days 00:13:11,9,26,17
292,BAR,P002939,P011244,0 days 00:12:40,6,26,20
292,BAR,P006435,P011244,0 days 00:12:36,14,32,18
292,BAR,P004866,P012745,0 days 00:12:06,-3,28,31
292,BAR,P003478,P012745,0 days 00:11:11,-4,23,27
292,BAR,P003196,PLFW,0 days 00:10:05,-15,21,36
292,BAR,P000925,P011244,0 days 00:09:46,9,23,14
292,BAR,P003478,P006435,0 days 00:09:29,10,31,21
292,BAR,P003478,P011244,0 days 00:09:16,1,25,24
292,BAR,P003478,PLFW,0 days 00:08:53,-16,17,33
292,BAR,P003196,P004866,0 days 00:07:52,-4,20,24
292,BAR,P011244,PLFW,0 days 00:07:32,-3,20,23
292,BAR,P003478,P004866,0 days 00:06:46,-2,10,12
292,BAR,P004866,PLFW,0 days 00:06:40,-5,16,21
292,BAR,P012745,PLFW,0 days 00:06:20,-15,10,25
292,BAR,P003196,P011244,0 days 00:06:18,-4,15,19
292,BAR,P007519,P012745,0 days 00:05:11,-14,8,22
292,BAR,P007519,PLFW,0 days 00:05:11,-14,8,22
292,BAR,P003196,P003478,0 days 00:05:06,-13,8,21
292,BAR,P003196,P012745,0 days 00:04:59,-10,10,20
292,BAR,P006435,PLFW,0 days 00:04:48,5,16,11
292,BAR,P003196,P006435,0 days 00:04:02,6,13,7
292,BAR,P000925,PLFW,0 days 00:03:47,-3,9,12
292,BAR,P003196,P007519,0 days 00:03:47,-11,6,17
292,BAR,P003478,P007519,0 days 00:03:02,-7,4,11
292,BAR,P002939,P003196,0 days 00:02:59,-5,7,12
292,BAR,P010641,P011244,0 days 00:02:21,4,5,1
292,BAR,P004866,P010641,0 days 00:02:21,4,5,1
292,BAR,P003478,P010641,0 days 00:02:21,4,5,1
292,BAR,P002939,P010641,0 days 00:02:21,4,5,1
292,BAR,P002939,PLFW,0 days 00:02:12,-6,3,9
292,BAR,P004866,P007519,0 days 00:02:09,-7,4,11
292,BAR,P000925,P007519,0 days 00:01:24,-3,2,5
292,TEL,P009783,P009863,0 days 00:28:02,-10,57,67
292,TEL,P009622,P009863,0 days 00:23:41,-24,36,60
292,TEL,P009622,P009783,0 days 00:22:42,-23,35,58
292,TEL,P009783,P011199,0 days 00:21:41,-25,33,58
292,TEL,P009622,P011199,0 days 00:21:25,-26,32,58
292,TEL,P009863,P011199,0 days 00:21:25,-26,32,58
292,TEL,P007990,P011214,0 days 00:15:42,23,51,28
292,TEL,P011193,P011214,0 days 00:15:32,19,51,32
292,TEL,P007990,P011193,0 days 00:15:31,18,48,30
292,TEL,P011214,P012744,0 days 00:10:12,7,29,22
292,TEL,P011193,P012744,0 days 00:10:06,9,31,22
292,TEL,P007990,P012744,0 days 00:10:06,9,31,22
292,TEL,P009783,P011193,0 days 00:09:48,14,31,17
292,TEL,P009863,P011214,0 days 00:08:42,11,27,16
292,TEL,P009783,P011214,0 days 00:08:36,11,26,15
292,TEL,P009863,P011193,0 days 00:08:08,13,29,16
292,TEL,P007990,P009783,0 days 00:07:35,13,23,10
292,TEL,P009863,P011971,0 days 00:07:25,-8,16,24
292,TEL,P009783,P011971,0 days 00:07:25,-8,16,24
292,TEL,P009622,P011971,0 days 00:06:37,-11,11,22
292,TEL,P011199,P011971,0 days 00:06:37,-11,11,22
292,TEL,P005145,P009863,0 days 00:06:19,-3,6,9
292,TEL,P005145,P009783,0 days 00:06:19,-3,6,9
292,TEL,P005145,P009622,0 days 00:06:19,-3,6,9
292,TEL,P005145,P011199,0 days 00:06:19,-3,6,9
292,TEL,P007990,P009863,0 days 00:05:58,15,22,7
292,TEL,P011214,P011219,0 days 00:05:14,-3,12,15
292,TEL,P011193,P011219,0 days 00:05:14,-3,12,15
292,TEL,P007990,P011219,0 days 00:05:14,-3,12,15
292,TEL,P011214,P011971,0 days 00:05:11,14,22,8
292,TEL,P011193,P011971,0 days 00:05:11,14,22,8
292,TEL,P009783,P012744,0 days 00:05:05,-7,5,12
292,TEL,P011971,P012744,0 days 00:04:23,11,17,6
292,TEL,P007990,P011971,0 days 00:04:23,11,17,6
292,TEL,P011219,P012744,0 days 00:04:21,-2,12,14
292,TEL,P011193,P011199,0 days 00:04:10,0,9,9
292,TEL,P011199,P012744,0 days 00:03:51,-5,5,10
292,TEL,P009863,P012744,0 days 00:03:50,-7,3,10
292,TEL,P009622,P012744,0 days 00:03:50,-7,3,10
292,TEL,P009783,P011219,0 days 00:03:27,-6,4,10
292,TEL,P009622,P011214,0 days 00:03:22,-2,5,7
292,TEL,P009622,P011193,0 days 00:02:48,0,7,7
292,TEL,P011199,P011219,0 days 00:02:34,-5,4,9
292,TEL,P009863,P011219,0 days 00:02:34,-5,4,9
292,TEL,P009622,P011219,0 days 00:02:34,-5,4,9
292,TEL,P007990,P011199,0 days 00:01:53,1,3,2
292,TEL,P007990,P009622,0 days 00:01:26,5,5,0
292,TEL,P011199,P011214,0 days 00:01:13,-4,1,5
293,PAM,P007870,P010568,0 days 00:21:34,-18,29,47
293,PAM,P007870,P011982,0 days 00:18:05,-14,27,41
293,PAM,P010568,P011982,0 days 00:17:16,-17,24,41
293,PAM,P010393,P011970,0 days 00:14:12,-14,28,42
293,PAM,P010568,P012795,0 days 00:14:04,-6,18,24
293,PAM,P003960,P010568,0 days 00:13:49,-11,22,33
293,PAM,P007870,P012795,0 days 00:13:14,-3,19,22
293,PAM,P011982,P012795,0 days 00:12:41,-5,23,28
293,PAM,P005356,P011970,0 days 00:12:26,-13,26,39
293,PAM,P010393,P012795,0 days 00:11:44,-1,26,27
293,PAM,P000556,P011970,0 days 00:10:55,-16,21,37
293,PAM,P011970,P012795,0 days 00:10:12,1,27,26
293,PAM,P003960,P007870,0 days 00:10:04,-16,15,31
293,PAM,P004863,P012795,0 days 00:10:02,-8,16,24
293,PAM,P005356,P010393,0 days 00:09:51,-16,16,32
293,PAM,P003960,P011982,0 days 00:09:21,-15,13,28
293,PAM,P000556,P010393,0 days 00:09:09,-16,14,30
293,PAM,P007870,P012740,0 days 00:09:05,0,20,20
293,PAM,P010568,P012740,0 days 00:09:05,0,20,20
293,PAM,P003960,P005356,0 days 00:08:57,-19,7,26
293,PAM,P003960,P010393,0 days 00:08:20,-11,9,20
293,PAM,P004863,P007870,0 days 00:07:45,-8,11,19
293,PAM,P004863,P010568,0 days 00:07:38,-8,6,14
293,PAM,P000556,P005356,0 days 00:07:22,-18,9,27
293,PAM,P005356,P011982,0 days 00:07:11,-6,14,20
293,PAM,P000556,P004863,0 days 00:07:08,0,19,19
293,PAM,P005356,P007870,0 days 00:06:48,-3,12,15
293,PAM,P003960,P011970,0 days 00:06:41,-11,7,18
293,PAM,P010393,P010568,0 days 00:06:32,5,10,5
293,PAM,P004863,P011970,0 days 00:06:20,0,19,19
293,PAM,P005356,P010568,0 days 00:06:19,-1,7,8
293,PAM,P011982,P012740,0 days 00:06:18,0,17,17
293,PAM,P004863,P010393,0 days 00:06:13,0,14,14
293,PAM,P011970,P011982,0 days 00:05:51,-1,15,16
293,PAM,P003960,P012740,0 days 00:04:56,-6,11,17
293,PAM,P007870,P011970,0 days 00:04:40,2,13,11
293,PAM,P000556,P003960,0 days 00:04:35,-16,2,18
293,PAM,P003960,P012795,0 days 00:04:31,-2,6,8
293,PAM,P004863,P011982,0 days 00:04:28,-7,2,9
293,PAM,P000556,P012795,0 days 00:04:21,2,12,10
293,PAM,P010568,P011970,0 days 00:04:11,4,8,4
293,PAM,P012740,P012795,0 days 00:04:09,6,9,3
293,PAM,P004863,P005356,0 days 00:03:56,0,9,9
293,PAM,P005356,P012795,0 days 00:03:46,0,12,12
293,PAM,P010393,P011982,0 days 00:02:57,-3,9,12
293,PAM,P007870,P010393,0 days 00:02:47,0,3,3
293,PAM,P010393,P012740,0 days 00:02:47,0,3,3
293,PAM,P000556,P007870,0 days 00:02:34,0,7,7
293,PAM,P003960,P004863,0 days 00:02:22,-1,4,5
293,PAM,P000556,P010568,0 days 00:00:48,0,0,0
293,ASV,P005094,P011225,0 days 00:20:20,19,54,35
293,ASV,P011225,PKIR,0 days 00:19:31,18,51,33
293,ASV,P002100,P005094,0 days 00:18:25,26,52,26
293,ASV,P006568,P011225,0 days 00:17:16,14,43,29
293,ASV,P005094,PKIR,0 days 00:17:07,24,45,21
293,ASV,P003526,P004194,0 days 00:16:10,8,35,27
293,ASV,P004194,P011386,0 days 00:16:00,11,38,27
293,ASV,P005094,P006568,0 days 00:15:48,15,41,26
293,ASV,P006568,PKIR,0 days 00:15:46,17,39,22
293,ASV,P000229,P004194,0 days 00:15:29,7,39,32
293,ASV,P002100,P006568,0 days 00:14:51,16,36,20
293,ASV,P002100,P011225,0 days 00:14:29,16,38,22
293,ASV,P002100,PKIR,0 days 00:13:46,23,38,15
293,ASV,P004194,P005094,0 days 00:13:20,19,39,20
293,ASV,P000229,P011386,0 days 00:12:31,-2,26,28
293,ASV,P000229,P011225,0 days 00:12:10,7,34,27
293,ASV,P003526,P005094,0 days 00:12:01,10,35,25
293,ASV,P000229,P003526,0 days 00:12:00,0,25,25
293,ASV,P003526,P011386,0 days 00:11:05,-2,18,20
293,ASV,P000229,P005094,0 days 00:10:43,8,28,20
293,ASV,P004194,P011225,0 days 00:09:23,9,29,20
293,ASV,P005094,P011386,0 days 00:08:48,15,26,11
293,ASV,P000229,PKIR,0 days 00:08:34,1,21,20
293,ASV,P011386,PKIR,0 days 00:07:29,8,22,14
293,ASV,P003526,P011225,0 days 00:07:08,5,21,16
293,ASV,P002100,P004194,0 days 00:06:42,10,16,6
293,ASV,P002100,P003526,0 days 00:06:13,3,14,11
293,ASV,P000229,P006568,0 days 00:06:05,-7,7,14
293,ASV,P004194,PKIR,0 days 00:06:01,9,20,11
293,ASV,P002100,P011386,0 days 00:05:30,10,14,4
293,ASV,P003526,P006568,0 days 00:05:10,-8,4,12
293,ASV,P006568,P011386,0 days 00:05:08,-6,2,8
293,ASV,P011225,P011386,0 days 00:04:40,2,14,12
293,ASV,P004194,P006568,0 days 00:03:40,-5,0,5
293,ASV,P000229,P012731,0 days 00:02:32,-2,4,6
293,ASV,P003526,P012731,0 days 00:02:32,-2,4,6
293,ASV,P004194,P012731,0 days 00:01:59,0,4,4
293,ASV,P011225,P012731,0 days 00:01:39,2,4,2
293,ASV,P011386,P012731,0 days 00:00:53,-4,0,4
293,ASV,P003526,PKIR,0 days 00:00:33,-2,0,2
293,ASV,P012731,PKIR,0 days 00:00:33,-2,0,2
294,MIL,P000796,P007831,0 days 00:25:25,27,64,37
294,MIL,P000796,P011224,0 days 00:23:52,25,61,36
294,MIL,P007831,P011224,0 days 00:23:11,24,59,35
294,MIL,P007831,P009960,0 days 00:15:25,7,34,27
294,MIL,P006509,P011224,0 days 00:15:14,21,41,20
294,MIL,P000796,P006509,0 days 00:14:54,21,39,18
294,MIL,P006509,P007831,0 days 00:14:54,21,39,18
294,MIL,P007032,P011205,0 days 00:14:47,-8,27,35
294,MIL,P007831,P011205,0 days 00:14:07,1,31,30
294,MIL,P000796,P002849,0 days 00:13:33,11,33,22
294,MIL,P002849,P011224,0 days 00:13:22,11,33,22
294,MIL,P002849,P006509,0 days 00:12:49,8,30,22
294,MIL,P009960,P011205,0 days 00:12:29,-7,22,29
294,MIL,P002849,P007831,0 days 00:11:51,12,31,19
294,MIL,P000796,P009960,0 days 00:11:40,14,30,16
294,MIL,P000796,P011205,0 days 00:11:31,5,27,22
294,MIL,P009960,P011224,0 days 00:11:05,9,27,18
294,MIL,P011205,P011224,0 days 00:09:37,2,24,22
294,MIL,P001518,P011205,0 days 00:09:10,-5,17,22
294,MIL,P006509,P011205,0 days 00:08:35,-6,18,24
294,MIL,P006509,P007032,0 days 00:08:15,-6,16,22
294,MIL,P006509,P009960,0 days 00:07:22,12,20,8
294,MIL,P007032,P009960,0 days 00:06:33,-3,11,14
294,MIL,P007032,P007831,0 days 00:06:32,-2,11,13
294,MIL,P002849,P011205,0 days 00:06:10,3,17,14
294,MIL,P001518,P007032,0 days 00:06:07,-2,13,15
294,MIL,P002812,P011205,0 days 00:05:45,-2,12,14
294,MIL,P001518,P006509,0 days 00:05:31,-6,11,17
294,MIL,P007201,P011205,0 days 00:05:25,-7,9,16
294,MIL,P007032,P007201,0 days 00:05:25,-7,9,16
294,MIL,P002812,P007032,0 days 00:04:59,-5,9,14
294,MIL,P001518,P002812,0 days 00:03:51,-3,9,12
294,MIL,P001518,P011224,0 days 00:03:45,-3,4,7
294,MIL,P001518,P009960,0 days 00:03:37,-1,6,7
294,MIL,P002812,P006509,0 days 00:03:18,-5,7,12
294,MIL,P002849,P007032,0 days 00:03:15,0,7,7
294,MIL,P000796,P007032,0 days 00:03:15,1,5,4
294,MIL,P006509,P007201,0 days 00:03:04,0,7,7
294,MIL,P002849,P007201,0 days 00:03:04,0,7,7
294,MIL,P001518,P007831,0 days 00:02:39,2,4,2
294,MIL,P002812,P007831,0 days 00:02:27,3,5,2
294,MIL,P000796,P001518,0 days 00:02:24,-1,2,3
294,MIL,P001518,P002849,0 days 00:02:24,-1,2,3
294,MIL,P007201,P007831,0 days 00:02:21,-7,2,9
294,MIL,P007201,P009960,0 days 00:02:21,-7,2,9
294,MIL,P000796,P002812,0 days 00:01:54,1,3,2
294,MIL,P002812,P011224,0 days 00:00:46,3,3,0
294,VIR,P006739,PBCN,0 days 00:21:54,-7,40,47
294,VIR,P001133,P006739,0 days 00:14:32,-26,18,44
294,VIR,P003527,P010781,0 days 00:14:16,-7,25,32
294,VIR,P001133,PBCN,0 days 00:13:52,-15,24,39
294,VIR,P003048,PBCN,0 days 00:13:49,0,31,31
294,VIR,P001133,P003048,0 days 00:13:04,-2,28,30
294,VIR,P003048,P004007,0 days 00:12:14,4,27,23
294,VIR,P002084,PBCN,0 days 00:11:58,7,25,18
294,VIR,P002084,P006739,0 days 00:11:58,7,25,18
294,VIR,P001133,P004007,0 days 00:11:48,-5,22,27
294,VIR,P008847,P010781,0 days 00:11:36,-2,22,24
294,VIR,P001133,P001844,0 days 00:11:13,-11,23,34
294,VIR,P003048,P006739,0 days 00:11:02,-3,22,25
294,VIR,P004007,PBCN,0 days 00:10:39,0,23,23
294,VIR,P004554,P006739,0 days 00:10:36,-8,18,26
294,VIR,P001844,P008847,0 days 00:10:34,-8,19,27
294,VIR,P001133,P010781,0 days 00:10:25,-17,15,32
294,VIR,P001844,P003527,0 days 00:10:12,-5,19,24
294,VIR,P001844,P010781,0 days 00:09:56,-5,19,24
294,VIR,P003527,P008847,0 days 00:09:48,-5,19,24
294,VIR,P001133,P003527,0 days 00:09:03,-9,14,23
294,VIR,P002084,P010781,0 days 00:08:41,5,16,11
294,VIR,P004007,P006739,0 days 00:08:26,-6,14,20
294,VIR,P004554,PBCN,0 days 00:07:43,-3,15,18
294,VIR,P002084,P008847,0 days 00:07:17,5,14,9
294,VIR,P006739,P010781,0 days 00:07:07,-7,8,15
294,VIR,P005553,PBCN,0 days 00:06:39,2,15,13
294,VIR,P005553,P006739,0 days 00:06:39,2,15,13
294,VIR,P002084,P005553,0 days 00:06:39,2,15,13
294,VIR,P002084,P004554,0 days 00:06:20,4,15,11
294,VIR,P001844,P002084,0 days 00:06:15,0,11,11
294,VIR,P001844,PBCN,0 days 00:05:56,-1,15,16
294,VIR,P002084,P003527,0 days 00:05:29,2,11,9
294,VIR,P004554,P005553,0 days 00:05:19,2,13,11
294,VIR,P001844,P003048,0 days 00:05:14,1,15,14
294,VIR,P001133,P008847,0 days 00:05:05,-10,8,18
294,VIR,P004554,P010781,0 days 00:05:04,-8,5,13
294,VIR,P001133,P004554,0 days 00:04:24,-12,3,15
294,VIR,P010781,PBCN,0 days 00:04:14,-2,5,7
294,VIR,P001844,P006739,0 days 00:03:43,-7,6,13
294,VIR,P001844,P004007,0 days 00:03:37,0,9,9
294,VIR,P003527,P004554,0 days 00:03:01,-5,3,8
294,VIR,P003527,P006739,0 days 00:02:53,-5,3,8
294,VIR,P002084,P003048,0 days 00:02:41,4,7,3
294,VIR,P006739,P008847,0 days 00:02:34,0,3,3
294,VIR,P008847,PBCN,0 days 00:02:00,3,3,0
294,VIR,P003048,P003527,0 days 00:01:43,3,3,0
294,VIR,P003527,P004007,0 days 00:01:43,3,3,0
294,VIR,P003048,P010781,0 days 00:01:40,2,4,2
294,VIR,P004007,P010781,0 days 00:01:40,2,4,2
294,VIR,P003048,P005553,0 days 00:01:33,-1,3,4
294,VIR,P002084,P004007,0 days 00:01:21,4,5,1
294,VIR,P001133,P002084,0 days 00:01:09,-4,0,4
294,VIR,P004007,P008847,0 days 00:00:34,-3,0,3
294,VIR,P004007,P004554,0 days 00:00:21,-2,0,2
294,VIR,P001133,P005553,0 days 00:00:13,-1,1,2
294,VIR,P004007,P005553,0 days 00:00:13,-1,1,2
294,VIR,P005553,P010781,0 days 00:00:13,-1,1,2
294,VIR,P001844,P004554,0 days 00:00:08,0,0,0
295,MUN,P003583,P006760,0 days 00:24:00,-1,48,49
295,MUN,P003583,P011987,0 days 00:22:37,-3,42,45
295,MUN,P006760,P011987,0 days 00:22:36,-1,43,44
295,MUN,P001288,P011987,0 days 00:22:26,-4,41,45
295,MUN,P001288,P003583,0 days 00:21:25,-6,40,46
295,MUN,P001288,P006760,0 days 00:20:43,-7,38,45
295,MUN,P003583,P008985,0 days 00:17:31,5,38,33
295,MUN,P008985,P011987,0 days 00:16:09,2,33,31
295,MUN,P006760,P010391,0 days 00:16:09,-1,32,33
295,MUN,P010391,P011987,0 days 00:15:17,-3,26,29
295,MUN,P006760,P008985,0 days 00:15:13,4,33,29
295,MUN,P001288,P008985,0 days 00:14:58,1,29,28
295,MUN,P003583,P010391,0 days 00:14:07,0,29,29
295,MUN,P001288,P010391,0 days 00:13:08,-8,21,29
295,MUN,P001557,P010391,0 days 00:13:00,0,26,26
295,MUN,P007975,P010391,0 days 00:12:08,-12,20,32
295,MUN,P005460,P010391,0 days 00:09:58,-5,16,21
295,MUN,P001557,P007975,0 days 00:09:45,-8,16,24
295,MUN,P006543,P010391,0 days 00:08:24,-2,14,16
295,MUN,P006543,P007975,0 days 00:06:48,-4,12,16
295,MUN,P005460,P007975,0 days 00:06:46,-7,11,18
295,MUN,P005460,P006543,0 days 00:06:19,-2,11,13
295,MUN,P001557,P006543,0 days 00:06:06,0,12,12
295,MUN,P001557,P005460,0 days 00:06:04,-3,11,14
295,MUN,P001557,P006760,0 days 00:05:56,5,14,9
295,MUN,P008985,P010391,0 days 00:05:21,5,14,9
295,MUN,P006760,P007975,0 days 00:04:22,-3,8,11
295,MUN,P001288,P005460,0 days 00:03:54,-2,5,7
295,MUN,P007639,P010391,0 days 00:03:44,-2,6,8
295,MUN,P001557,P007639,0 days 00:03:44,-2,6,8
295,MUN,P005460,P006760,0 days 00:03:39,-3,5,8
295,MUN,P001557,P011987,0 days 00:03:21,0,5,5
295,MUN,P005460,P011987,0 days 00:03:12,2,5,3
295,MUN,P001557,P003583,0 days 00:03:12,5,9,4
295,MUN,P007639,P007975,0 days 00:03:03,-5,3,8
295,MUN,P001288,P007975,0 days 00:02:23,-4,4,8
295,MUN,P003583,P007975,0 days 00:02:19,0,6,6
295,MUN,P001288,P006543,0 days 00:02:18,-2,2,4
295,MUN,P006543,P007639,0 days 00:02:05,0,3,3
295,MUN,P007639,P011987,0 days 00:01:40,-2,3,5
295,MUN,P006543,P011987,0 days 00:01:36,2,2,0
295,MUN,P007975,P011987,0 days 00:00:58,-5,0,5
295,MUN,P001557,P008985,0 days 00:00:52,3,5,2
295,MUN,P006760,P007639,0 days 00:00:42,3,3,0
295,MUN,P001288,P007639,0 days 00:00:01,0,0,0
295,MUN,P003583,P007639,0 days 00:00:01,0,0,0
295,PAN,P003842,P011204,0 days 00:20:46,6,45,39
295,PAN,P003842,P012712,0 days 00:19:42,14,52,38
295,PAN,P003842,P012774,0 days 00:18:57,4,39,35
295,PAN,P011204,P012712,0 days 00:17:54,12,45,33
295,PAN,P005161,P012712,0 days 00:15:55,9,42,33
295,PAN,P001926,P005161,0 days 00:15:28,-3,29,32
295,PAN,P012712,P012774,0 days 00:15:11,9,38,29
295,PAN,P001926,P012712,0 days 00:15:02,3,32,29
295,PAN,P005161,P012774,0 days 00:14:49,0,28,28
295,PAN,P011204,P012774,0 days 00:14:38,0,26,26
295,PAN,P003842,P005161,0 days 00:14:32,4,33,29
295,PAN,P007866,P012774,0 days 00:14:04,-8,17,25
295,PAN,P002328,P011204,0 days 00:13:06,5,25,20
295,PAN,P001926,P012774,0 days 00:13:00,-1,23,24
295,PAN,P002328,P012774,0 days 00:12:57,-3,23,26
295,PAN,P001926,P003842,0 days 00:11:09,4,24,20
295,PAN,P005161,P011204,0 days 00:10:50,-3,24,27
295,PAN,P002328,P003842,0 days 00:10:50,2,23,21
295,PAN,P007866,P011204,0 days 00:10:24,-6,14,20
295,PAN,P011221,P012774,0 days 00:10:16,-3,16,19
295,PAN,P001926,P011204,0 days 00:10:03,6,22,16
295,PAN,P005161,P007866,0 days 00:09:08,-6,14,20
295,PAN,P002328,P012712,0 days 00:08:34,2,19,17
295,PAN,P001926,P011221,0 days 00:08:32,-3,14,17
295,PAN,P001926,P007866,0 days 00:08:27,-2,12,14
295,PAN,P002328,P007866,0 days 00:07:49,-2,9,11
295,PAN,P003842,P007866,0 days 00:07:08,-4,8,12
295,PAN,P007866,P011221,0 days 00:06:55,-4,9,13
295,PAN,P005161,P011221,0 days 00:06:47,-3,11,14
295,PAN,P005161,P007947,0 days 00:05:15,10,19,9
295,PAN,P007947,P012712,0 days 00:05:15,10,19,9
295,PAN,P001926,P002328,0 days 00:04:39,0,8,8
295,PAN,P003842,P007947,0 days 00:04:16,10,16,6
295,PAN,P002328,P011221,0 days 00:03:29,0,5,5
295,PAN,P011221,P012712,0 days 00:03:21,1,7,6
295,PAN,P007947,P012774,0 days 00:03:04,6,10,4
295,PAN,P007866,P012712,0 days 00:02:54,0,6,6
295,PAN,P007947,P011204,0 days 00:02:11,4,9,5
295,PAN,P011204,P011221,0 days 00:01:44,0,2,2
295,PAN,P007866,P007947,0 days 00:00:59,0,3,3
296,ULK,P001932,P008962,0 days 00:24:13,-8,43,51
296,ULK,P006661,P010560,0 days 00:18:18,9,42,33
296,ULK,P006661,P008962,0 days 00:17:56,-2,48,50
296,ULK,P004004,P006661,0 days 00:17:00,2,42,40
296,ULK,P008962,P010560,0 days 00:15:24,-3,30,33
296,ULK,P005844,P006661,0 days 00:14:31,6,38,32
296,ULK,P006661,P011157,0 days 00:14:09,1,31,30
296,ULK,P001932,P006661,0 days 00:13:26,0,32,32
296,ULK,P001932,P010560,0 days 00:13:16,-1,24,25
296,ULK,P006961,P008962,0 days 00:11:39,-4,24,28
296,ULK,P004004,P011157,0 days 00:11:33,-1,25,26
296,ULK,P005844,P008962,0 days 00:11:18,1,31,30
296,ULK,P010560,P011157,0 days 00:11:13,3,24,21
296,ULK,P004004,P011980,0 days 00:11:04,8,21,13
296,ULK,P006661,P011980,0 days 00:10:47,8,21,13
296,ULK,P004004,P006961,0 days 00:10:36,-3,22,25
296,ULK,P008962,P011157,0 days 00:10:36,-7,23,30
296,ULK,P001932,P006961,0 days 00:09:30,-4,14,18
296,ULK,P001932,P005844,0 days 00:09:09,1,21,20
296,ULK,P001932,P009849,0 days 00:08:54,-6,8,14
296,ULK,P005844,P010560,0 days 00:08:51,2,18,16
296,ULK,P006661,P006961,0 days 00:08:45,0,22,22
296,ULK,P008962,P009849,0 days 00:08:41,-6,8,14
296,ULK,P001932,P011157,0 days 00:08:28,-5,17,22
296,ULK,P005844,P006961,0 days 00:08:22,1,23,22
296,ULK,P004004,P008962,0 days 00:08:19,-8,24,32
296,ULK,P004004,P005844,0 days 00:07:47,2,20,18
296,ULK,P004004,P010560,0 days 00:07:24,6,18,12
296,ULK,P006961,P009849,0 days 00:06:49,-2,8,10
296,ULK,P001932,P002968,0 days 00:06:46,-3,5,8
296,ULK,P002968,P008962,0 days 00:06:46,-3,5,8
296,ULK,P002968,P009849,0 days 00:06:46,-3,5,8
296,ULK,P006961,P011980,0 days 00:06:18,0,9,9
296,ULK,P002968,P006961,0 days 00:06:10,-3,5,8
296,ULK,P011157,P011980,0 days 00:05:39,6,11,5
296,ULK,P005844,P011980,0 days 00:05:38,2,10,8
296,ULK,P010560,P011980,0 days 00:05:16,8,12,4
296,ULK,P001932,P004004,0 days 00:03:49,-6,8,14
296,ULK,P006961,P011157,0 days 00:03:22,-1,5,6
296,ULK,P005844,P009849,0 days 00:02:08,-3,3,6
296,ULK,P009849,P010560,0 days 00:02:05,-4,0,4
296,ULK,P002968,P010560,0 days 00:00:36,0,0,0
296,ULK,P006961,P010560,0 days 00:00:17,0,0,0
296,ULK,P001932,P011980,0 days 00:00:13,0,0,0
296,ULK,P009849,P011980,0 days 00:00:13,0,0,0
296,IST,P004888,P007200,0 days 00:31:27,9,71,62
296,IST,P004888,P012710,0 days 00:20:30,7,40,33
296,IST,P007200,P012710,0 days 00:19:10,7,37,30
296,IST,P006590,P009846,0 days 00:18:42,-2,42,44
296,IST,P004888,PLHK,0 days 00:17:28,9,34,25
296,IST,P012710,PLHK,0 days 00:16:40,12,34,22
296,IST,P004888,P009513,0 days 00:16:33,12,34,22
296,IST,P009513,P012710,0 days 00:16:26,12,34,22
296,IST,P007200,PLHK,0 days 00:16:08,9,31,22
296,IST,P009513,PLHK,0 days 00:15:50,12,34,22
296,IST,P007200,P009513,0 days 00:15:06,12,31,19
296,IST,P004888,P006590,0 days 00:14:19,4,40,36
296,IST,P004888,P012788,0 days 00:12:55,2,37,35
296,IST,P006590,P007200,0 days 00:12:52,4,37,33
296,IST,P007200,P012788,0 days 00:12:48,2,37,35
296,IST,P004888,P009846,0 days 00:12:24,2,34,32
296,IST,P007200,P009846,0 days 00:12:17,2,34,32
296,IST,P006590,P012788,0 days 00:11:04,6,34,28
296,IST,P009846,P012788,0 days 00:10:24,3,31,28
296,IST,P006590,P011981,0 days 00:09:01,-9,11,20
296,IST,P009846,P011981,0 days 00:08:18,-5,11,16
296,IST,P009664,P009846,0 days 00:07:54,-10,8,18
296,IST,P009846,P011078,0 days 00:07:06,-7,8,15
296,IST,P011078,P011981,0 days 00:07:06,-7,8,15
296,IST,P009664,P011078,0 days 00:07:06,-7,8,15
296,IST,P009664,P011981,0 days 00:07:06,-7,8,15
296,IST,P006590,P009664,0 days 00:07:06,-7,8,15
296,IST,P006590,P011078,0 days 00:07:06,-7,8,15
296,IST,P006590,P012710,0 days 00:02:43,-1,6,7
296,IST,P004888,P011078,0 days 00:02:41,-4,3,7
296,IST,P007200,P011078,0 days 00:02:41,-4,3,7
296,IST,P011078,P012710,0 days 00:02:41,-4,3,7
296,IST,P007200,P011981,0 days 00:02:31,-2,3,5
296,IST,P004888,P011981,0 days 00:02:31,-2,3,5
296,IST,P012710,P012788,0 days 00:02:31,-1,6,7
296,IST,P011078,P012788,0 days 00:01:51,-4,3,7
296,IST,P006590,P009513,0 days 00:01:27,0,3,3
296,IST,P006590,PLHK,0 days 00:01:20,0,3,3
296,IST,P011981,P012710,0 days 00:01:19,-4,0,4
296,IST,P011078,PLHK,0 days 00:00:50,0,0,0
296,IST,P004888,P009664,0 days 00:00:48,-3,0,3
296,IST,P007200,P009664,0 days 00:00:48,-3,0,3
296,IST,P009664,PLHK,0 days 00:00:48,-3,0,3
296,IST,P009846,PLHK,0 days 00:00:48,-3,0,3
296,IST,P009513,P011981,0 days 00:00:36,0,0,0
296,IST,P009513,P009846,0 days 00:00:07,0,0,0
296,IST,P009513,P012788,0 days 00:00:07,0,0,0
297,MAD,P005928,P010357,0 days 00:25:30,11,68,57
297,MAD,P003108,P005928,0 days 00:21:20,7,55,48
297,MAD,P003108,P010357,0 days 00:20:29,10,55,45
297,MAD,P005791,P005928,0 days 00:18:24,5,42,37
297,MAD,P003108,P005791,0 days 00:18:23,3,40,37
297,MAD,P005791,P010357,0 days 00:17:32,6,40,34
297,MAD,P001392,P003108,0 days 00:17:14,5,37,32
297,MAD,P009005,PTGB,0 days 00:17:01,-6,36,42
297,MAD,P006540,P009005,0 days 00:16:25,-8,36,44
297,MAD,P006540,PTGB,0 days 00:16:10,-3,36,39
297,MAD,P001392,P010357,0 days 00:14:58,7,37,30
297,MAD,P001392,P005928,0 days 00:14:58,7,37,30
297,MAD,P009005,PCVM,0 days 00:13:38,-14,21,35
297,MAD,P001392,P005791,0 days 00:13:12,5,30,25
297,MAD,P004887,P009005,0 days 00:12:42,-12,19,31
297,MAD,P004887,PCVM,0 days 00:12:42,-12,19,31
297,MAD,P004887,P006540,0 days 00:11:29,-6,27,33
297,MAD,PCVM,PTGB,0 days 00:11:15,-9,21,30
297,MAD,P006540,PCVM,0 days 00:11:15,-9,21,30
297,MAD,P005928,P006540,0 days 00:10:40,3,33,30
297,MAD,P006540,P010357,0 days 00:10:39,1,31,30
297,MAD,P004887,PTGB,0 days 00:10:19,-7,19,26
297,MAD,P005928,P009005,0 days 00:06:01,-2,15,17
297,MAD,P005928,PTGB,0 days 00:05:46,3,15,12
297,MAD,P003108,P006540,0 days 00:05:38,0,18,18
297,MAD,P005791,P006540,0 days 00:05:17,1,14,13
297,MAD,P003108,P004887,0 days 00:05:12,1,15,14
297,MAD,P009005,P010357,0 days 00:05:09,-1,13,14
297,MAD,P010357,PTGB,0 days 00:04:54,4,13,9
297,MAD,P001392,P004887,0 days 00:04:02,0,7,7
297,MAD,P003108,P009005,0 days 00:03:22,-10,0,10
297,MAD,P004887,P005928,0 days 00:02:49,6,15,9
297,MAD,P004887,P010357,0 days 00:02:49,6,15,9
297,MAD,P001392,P009005,0 days 00:02:30,-8,0,8
297,MAD,P001392,PCVM,0 days 00:02:23,-5,0,5
297,MAD,P003108,PCVM,0 days 00:02:23,-5,0,5
297,MAD,P005791,P009005,0 days 00:01:48,-3,4,7
297,MAD,P005791,PTGB,0 days 00:01:48,-3,4,7
297,MAD,P005791,PCVM,0 days 00:00:56,-2,2,4
297,MAD,P003108,PTGB,0 days 00:00:51,-3,0,3
297,MAD,P001392,P006540,0 days 00:00:07,-3,0,3
297,BAS,P007230,P012201,0 days 00:28:16,11,70,59
297,BAS,P007230,P009048,0 days 00:26:42,14,72,58
297,BAS,P011948,P012201,0 days 00:26:37,19,65,46
297,BAS,P009048,P012201,0 days 00:26:17,10,60,50
297,BAS,P010444,P012201,0 days 00:25:57,16,65,49
297,BAS,P007230,P011948,0 days 00:25:18,17,69,52
297,BAS,P010444,P011948,0 days 00:24:31,22,65,43
297,BAS,P009048,P011948,0 days 00:24:28,13,64,51
297,BAS,P007230,P010444,0 days 00:23:11,19,66,47
297,BAS,P009048,P010444,0 days 00:20:26,16,56,40
297,BAS,P007230,P011085,0 days 00:11:43,-5,28,33
297,BAS,P011085,P012201,0 days 00:09:59,-8,20,28
297,BAS,P012201,P012765,0 days 00:08:50,-2,19,21
297,BAS,P009048,P011085,0 days 00:08:13,1,21,20
297,BAS,P003198,P009048,0 days 00:07:37,-15,12,27
297,BAS,P010444,P012765,0 days 00:07:15,3,17,14
297,BAS,P004603,P009048,0 days 00:06:54,-10,12,22
297,BAS,P003198,P012201,0 days 00:06:51,-3,9,12
297,BAS,P007230,P012765,0 days 00:06:27,-7,14,21
297,BAS,P004603,P007230,0 days 00:06:08,-12,12,24
297,BAS,P003198,P011948,0 days 00:05:57,-5,10,15
297,BAS,P011085,P011948,0 days 00:05:34,3,16,13
297,BAS,P003198,P004603,0 days 00:05:30,-10,10,20
297,BAS,P011948,P012765,0 days 00:05:20,4,12,8
297,BAS,P004603,P012201,0 days 00:05:20,-8,6,14
297,BAS,P010444,P011085,0 days 00:04:54,0,16,16
297,BAS,P003198,P010444,0 days 00:04:30,0,7,7
297,BAS,P003198,P004761,0 days 00:04:03,-5,7,12
297,BAS,P004603,P004761,0 days 00:04:03,-5,7,12
297,BAS,P004761,P009048,0 days 00:04:03,-5,7,12
297,BAS,P011085,P012765,0 days 00:03:30,-6,7,13
297,BAS,P003198,P007230,0 days 00:03:09,-7,8,15
297,BAS,P004603,P011085,0 days 00:02:59,-5,4,9
297,BAS,P003198,P012765,0 days 00:02:23,5,5,0
297,BAS,P004761,P012201,0 days 00:02:21,-3,2,5
297,BAS,P004761,P007230,0 days 00:01:42,-2,5,7
297,BAS,P004603,P012765,0 days 00:01:35,-5,2,7
297,BAS,P004603,P011948,0 days 00:01:27,-5,3,8
298,IST,P004888,P012710,0 days 00:17:55,13,35,22
298,IST,P009664,P009846,0 days 00:17:39,23,47,24
298,IST,P004888,P007200,0 days 00:16:45,15,38,23
298,IST,P009846,P012788,0 days 00:16:01,22,46,24
298,IST,P007200,P012710,0 days 00:15:36,12,36,24
298,IST,P012710,PLHK,0 days 00:14:52,8,26,18
298,IST,P004888,PLHK,0 days 00:14:52,8,26,18
298,IST,P007200,P009513,0 days 00:14:27,10,31,21
298,IST,P009513,P012710,0 days 00:14:27,10,31,21
298,IST,P004888,P009513,0 days 00:14:23,12,31,19
298,IST,P009664,P012788,0 days 00:13:21,15,35,20
298,IST,P007200,PLHK,0 days 00:13:15,8,26,18
298,IST,P009513,PLHK,0 days 00:13:15,8,26,18
298,IST,P006590,P011078,0 days 00:12:30,26,38,12
298,IST,P009846,P011078,0 days 00:12:19,28,44,16
298,IST,P009664,P011078,0 days 00:09:09,21,30,9
298,IST,P006590,P012788,0 days 00:08:47,19,31,12
298,IST,P011078,P012788,0 days 00:08:47,19,31,12
298,IST,P006372,P009664,0 days 00:08:33,8,19,11
298,IST,P006590,P009846,0 days 00:08:22,23,32,9
298,IST,P006372,P009846,0 days 00:07:57,6,17,11
298,IST,P009513,P012788,0 days 00:07:55,5,17,12
298,IST,P011078,P012710,0 days 00:07:22,8,20,12
298,IST,P006372,P009513,0 days 00:06:47,1,12,11
298,IST,P009513,P009846,0 days 00:06:47,1,12,11
298,IST,P006372,P012788,0 days 00:06:47,1,12,11
298,IST,P009513,P009664,0 days 00:06:47,1,12,11
298,IST,P006590,P009664,0 days 00:06:18,18,23,5
298,IST,P006590,P012710,0 days 00:06:12,8,15,7
298,IST,P011078,P011981,0 days 00:06:04,10,19,9
298,IST,P012710,P012788,0 days 00:05:40,12,20,8
298,IST,P009846,P011981,0 days 00:05:24,10,17,7
298,IST,P004888,P012788,0 days 00:05:19,8,16,8
298,IST,P007200,P009846,0 days 00:05:06,3,14,11
298,IST,P009664,P011981,0 days 00:04:54,10,14,4
298,IST,P007200,P009664,0 days 00:04:00,1,9,8
298,IST,P009846,P012710,0 days 00:03:46,9,16,7
298,IST,P004888,P006590,0 days 00:03:32,1,4,3
298,IST,P004888,P011078,0 days 00:03:32,1,4,3
298,IST,P007200,P012788,0 days 00:03:27,7,12,5
298,IST,P007200,P011078,0 days 00:02:54,-2,7,9
298,IST,P007200,P011981,0 days 00:02:51,-2,7,9
298,IST,P004888,P009846,0 days 00:02:19,3,7,4
298,IST,P004888,P009664,0 days 00:02:19,3,7,4
298,IST,P006590,P011981,0 days 00:02:03,7,7,0
298,IST,P006372,P011078,0 days 00:01:46,7,7,0
298,IST,P006372,P011981,0 days 00:01:46,7,7,0
298,IST,P011078,PLHK,0 days 00:01:37,0,0,0
298,IST,P006590,PLHK,0 days 00:01:37,0,0,0
298,IST,P011981,P012710,0 days 00:01:10,0,5,5
298,IST,P006372,P006590,0 days 00:00:36,2,2,0
298,IST,P009513,P011078,0 days 00:00:04,-2,0,2
298,IST,P009513,P011981,0 days 00:00:04,-2,0,2
298,IST,P006590,P007200,0 days 00:00:03,0,0,0
298,RED,P006436,P009035,0 days 00:19:02,-13,31,44
298,RED,P000848,P002553,0 days 00:17:55,-13,28,41
298,RED,P000848,P009035,0 days 00:16:07,-9,25,34
298,RED,P002553,P006436,0 days 00:15:59,-6,27,33
298,RED,P000848,P006436,0 days 00:15:50,-7,25,32
298,RED,P002553,P009035,0 days 00:14:45,-8,23,31
298,RED,P005099,P006436,0 days 00:13:29,-1,25,26
298,RED,P009035,P012044,0 days 00:13:03,-22,15,37
298,RED,P006436,P012044,0 days 00:12:21,-13,19,32
298,RED,P002553,P005099,0 days 00:11:55,-13,20,33
298,RED,P002553,P012044,0 days 00:11:49,-10,13,23
298,RED,P000848,P005099,0 days 00:11:39,-7,21,28
298,RED,P011964,P012801,0 days 00:10:00,-13,11,24
298,RED,P005836,PJDR,0 days 00:09:38,-15,15,30
298,RED,P012044,PLUO,0 days 00:09:21,-19,5,24
298,RED,P012044,PJDR,0 days 00:08:49,-9,13,22
298,RED,P005099,P009035,0 days 00:08:45,-4,16,20
298,RED,P002553,PJDR,0 days 00:07:44,-10,10,20
298,RED,P008966,P012044,0 days 00:07:39,-7,9,16
298,RED,P000848,P012044,0 days 00:07:38,-7,9,16
298,RED,P006436,P011964,0 days 00:06:55,-4,11,15
298,RED,P008966,P011964,0 days 00:06:47,-1,11,12
298,RED,P008966,P012801,0 days 00:06:47,-1,11,12
298,RED,P005099,P011964,0 days 00:06:39,-2,11,13
298,RED,P006436,P008966,0 days 00:06:32,1,13,12
298,RED,P008966,PLUO,0 days 00:06:08,-7,5,12
298,RED,P008966,PJDR,0 days 00:05:53,-5,7,12
298,RED,P005099,P012801,0 days 00:05:33,-3,9,12
298,RED,P011964,P012044,0 days 00:05:31,-18,2,20
298,RED,P012801,PLUO,0 days 00:05:31,-18,2,20
298,RED,PJDR,PLUO,0 days 00:05:28,-8,4,12
298,RED,P005836,P012044,0 days 00:05:22,-7,9,16
298,RED,P005099,P008966,0 days 00:05:01,1,9,8
298,RED,P006436,P012801,0 days 00:05:01,1,9,8
298,RED,P011964,PLUO,0 days 00:04:59,-14,2,16
298,RED,P012044,P012801,0 days 00:04:59,-14,2,16
298,RED,P005099,P005836,0 days 00:04:48,-12,6,18
298,RED,P002553,P005836,0 days 00:04:48,-12,6,18
298,RED,P005099,PJDR,0 days 00:04:33,-10,6,16
298,RED,P006436,PJDR,0 days 00:04:27,-4,10,14
298,RED,P005836,PLUO,0 days 00:04:20,-12,4,16
298,RED,P002553,PLUO,0 days 00:04:18,-10,1,11
298,RED,P009035,P011964,0 days 00:04:07,-14,2,16
298,RED,P000848,PJDR,0 days 00:03:27,-7,5,12
298,RED,P009035,PJDR,0 days 00:03:13,-6,6,12
298,RED,P002553,P008966,0 days 00:03:11,0,4,4
298,RED,P000848,P005836,0 days 00:03:10,-5,5,10
298,RED,P005836,P008966,0 days 00:02:42,-5,3,8
298,RED,P005836,P009035,0 days 00:02:40,-2,6,8
298,RED,P005836,P006436,0 days 00:02:40,-2,6,8
298,RED,P009035,PLUO,0 days 00:02:13,-9,0,9
298,RED,P009035,P012801,0 days 00:02:13,-9,0,9
298,RED,P005099,PLUO,0 days 00:01:38,-7,1,8
298,RED,P002553,P012801,0 days 00:01:32,-7,0,7
298,RED,P000848,P011964,0 days 00:01:22,-1,2,3
298,RED,P002553,P011964,0 days 00:01:00,-3,0,3
298,RED,P005836,P012801,0 days 00:00:32,-4,0,4
298,RED,P005099,P012044,0 days 00:00:16,-2,0,2
298,RED,P011964,PJDR,0 days 00:00:16,-2,0,2
299,MCO,P005985,P010588,0 days 00:20:32,9,57,48
299,MCO,P005985,P011226,0 days 00:18:10,3,46,43
299,MCO,P010588,P011226,0 days 00:18:10,3,46,43
299,MCO,P005985,PLCZ,0 days 00:17:39,7,43,36
299,MCO,P011226,PLCZ,0 days 00:17:03,-1,37,38
299,MCO,P009754,P011231,0 days 00:16:12,-9,29,38
299,MCO,P005985,P009754,0 days 00:15:08,-4,35,39
299,MCO,P009754,P011212,0 days 00:14:51,-6,24,30
299,MCO,P011212,P011231,0 days 00:14:43,-7,23,30
299,MCO,P009754,P011226,0 days 00:13:46,-3,28,31
299,MCO,P009754,P011196,0 days 00:13:39,-3,24,27
299,MCO,P010588,PLCZ,0 days 00:13:15,5,34,29
299,MCO,P011196,P011212,0 days 00:11:57,3,24,21
299,MCO,P004197,P010588,0 days 00:11:55,5,32,27
299,MCO,P004197,PLCZ,0 days 00:11:55,5,32,27
299,MCO,P004197,P011226,0 days 00:11:55,5,32,27
299,MCO,P004197,P005985,0 days 00:11:55,5,32,27
299,MCO,P011196,P011231,0 days 00:11:16,-1,20,21
299,MCO,P011226,P011231,0 days 00:10:02,0,23,23
299,MCO,P005985,P011231,0 days 00:09:15,-4,19,23
299,MCO,P005985,P011196,0 days 00:08:51,-5,14,19
299,MCO,P009754,P010588,0 days 00:08:25,4,25,21
299,MCO,P011212,P011226,0 days 00:07:55,-1,14,15
299,MCO,P009754,PLCZ,0 days 00:07:41,-5,11,16
299,MCO,P011196,P011226,0 days 00:06:31,2,14,12
299,MCO,P005985,P011212,0 days 00:06:06,-2,11,13
299,MCO,P005985,P012709,0 days 00:06:01,4,16,12
299,MCO,P004790,P005985,0 days 00:05:39,5,12,7
299,MCO,P011231,PLCZ,0 days 00:05:27,-5,6,11
299,MCO,P004790,P011231,0 days 00:05:02,4,8,4
299,MCO,P004790,P009754,0 days 00:04:53,1,8,7
299,MCO,P004790,P012709,0 days 00:04:45,2,9,7
299,MCO,P004790,PLCZ,0 days 00:04:24,2,9,7
299,MCO,P012709,PLCZ,0 days 00:04:24,2,9,7
299,MCO,P009754,P012709,0 days 00:04:01,3,13,10
299,MCO,P011212,PLCZ,0 days 00:04:00,-6,3,9
299,MCO,P010588,P011196,0 days 00:03:38,1,7,6
299,MCO,P004790,P011196,0 days 00:03:23,3,5,2
299,MCO,P004790,P011212,0 days 00:03:02,3,5,2
299,MCO,P010588,P011231,0 days 00:02:23,1,9,8
299,MCO,P011231,P012709,0 days 00:02:00,1,3,2
299,MCO,P002581,P005985,0 days 00:01:20,2,7,5
299,MCO,P002581,P009754,0 days 00:01:20,2,7,5
299,MCO,P002581,P010588,0 days 00:01:20,2,7,5
299,MCO,P002581,P012709,0 days 00:01:16,2,7,5
299,MCO,P010588,P012709,0 days 00:01:16,2,7,5
299,MCO,P010588,P011212,0 days 00:01:14,4,4,0
299,MCO,P011196,P012709,0 days 00:00:21,0,0,0
299,MCO,P002581,P011231,0 days 00:00:04,0,0,0
299,MUN,P001288,P011987,0 days 00:26:05,5,68,63
299,MUN,P007056,P011987,0 days 00:20:55,-1,50,51
299,MUN,P001288,P007056,0 days 00:18:49,-6,43,49
299,MUN,P007975,P011987,0 days 00:16:08,18,46,28
299,MUN,P006760,P010391,0 days 00:13:56,-7,21,28
299,MUN,P008985,P011987,0 days 00:13:43,-5,28,33
299,MUN,P006760,P011987,0 days 00:13:42,14,38,24
299,MUN,P007056,P008985,0 days 00:13:35,-6,25,31
299,MUN,P007975,P010391,0 days 00:12:57,0,24,24
299,MUN,P001288,P008985,0 days 00:12:40,-2,28,30
299,MUN,P007056,P010391,0 days 00:12:15,-1,22,23
299,MUN,P007639,P011987,0 days 00:12:04,-4,27,31
299,MUN,P010391,P011987,0 days 00:11:48,2,27,25
299,MUN,P006760,P007975,0 days 00:11:45,9,29,20
299,MUN,P001288,P007975,0 days 00:11:18,12,35,23
299,MUN,P007056,P007639,0 days 00:11:01,-1,27,28
299,MUN,P001288,P007639,0 days 00:11:01,-1,27,28
299,MUN,P007056,P007975,0 days 00:10:49,5,29,24
299,MUN,P005478,P006760,0 days 00:10:42,7,26,19
299,MUN,P005478,P011987,0 days 00:10:35,5,27,22
299,MUN,P005478,P007975,0 days 00:09:47,5,21,16
299,MUN,P007639,P008985,0 days 00:09:28,-2,21,23
299,MUN,P006760,P008985,0 days 00:08:40,-5,11,16
299,MUN,P001557,P006760,0 days 00:08:35,-13,6,19
299,MUN,P005478,P010391,0 days 00:08:18,-12,11,23
299,MUN,P001288,P005478,0 days 00:07:51,4,23,19
299,MUN,P001288,P006760,0 days 00:07:49,11,27,16
299,MUN,P001557,P010391,0 days 00:07:32,-10,6,16
299,MUN,P006760,P007056,0 days 00:07:11,1,14,13
299,MUN,P001288,P010391,0 days 00:06:58,-4,16,20
299,MUN,P001557,P008985,0 days 00:05:19,-6,4,10
299,MUN,P008985,P010391,0 days 00:04:16,-3,4,7
299,MUN,P001557,P007056,0 days 00:04:16,-3,4,7
299,MUN,P001557,P007975,0 days 00:03:16,-7,2,9
299,MUN,P001557,P005478,0 days 00:03:16,-7,2,9
299,MUN,P005478,P007056,0 days 00:02:53,-8,2,10
299,MUN,P001288,P006543,0 days 00:02:49,-3,5,8
299,MUN,P006543,P011987,0 days 00:02:49,-3,5,8
299,MUN,P007639,P007975,0 days 00:02:36,-2,6,8
299,MUN,P006543,P006760,0 days 00:02:33,-2,4,6
299,MUN,P006543,P008985,0 days 00:02:29,-2,4,6
299,MUN,P005478,P008985,0 days 00:01:46,-1,3,4
299,MUN,P001557,P007639,0 days 00:01:03,-3,0,3
299,MUN,P001557,P011987,0 days 00:01:03,-3,0,3
299,MUN,P006760,P007639,0 days 00:01:03,-3,0,3
299,MUN,P006543,P010391,0 days 00:00:20,-1,1,2
299,MUN,P005478,P006543,0 days 00:00:16,-1,1,2
300,TEL,P009622,P009863,0 days 00:21:03,4,48,44
300,TEL,P009863,P011199,0 days 00:19:21,7,48,41
300,TEL,P009622,P011199,0 days 00:18:53,7,48,41
300,TEL,P009622,P009783,0 days 00:16:30,6,42,36
300,TEL,P009783,P009863,0 days 00:15:47,12,44,32
300,TEL,P009783,P011199,0 days 00:15:03,10,40,30
300,TEL,P011193,P011214,0 days 00:13:34,1,27,26
300,TEL,P011193,P012095,0 days 00:12:43,3,29,26
300,TEL,P011193,P011971,0 days 00:12:18,4,29,25
300,TEL,P004233,P009863,0 days 00:12:10,-5,24,29
300,TEL,P011971,P012095,0 days 00:11:36,2,27,25
300,TEL,P005145,P009863,0 days 00:11:00,8,33,25
300,TEL,P011193,P011219,0 days 00:10:25,6,30,24
300,TEL,P011214,P012095,0 days 00:10:14,-1,19,20
300,TEL,P005145,P011199,0 days 00:09:56,7,29,22
300,TEL,P011214,P011971,0 days 00:09:49,0,19,19
300,TEL,P004233,P009622,0 days 00:09:36,-7,15,22
300,TEL,P005145,P009783,0 days 00:09:28,7,29,22
300,TEL,P005145,P009622,0 days 00:09:28,7,29,22
300,TEL,P011219,P012095,0 days 00:08:36,1,21,20
300,TEL,P011214,P011219,0 days 00:08:27,-1,13,14
300,TEL,P004233,P011219,0 days 00:08:10,-4,15,19
300,TEL,P009863,P011219,0 days 00:08:10,-4,17,21
300,TEL,P011193,P012744,0 days 00:07:56,-2,15,17
300,TEL,P004233,P011199,0 days 00:07:26,-4,15,19
300,TEL,P011219,P011971,0 days 00:06:48,3,19,16
300,TEL,P011214,P012744,0 days 00:06:35,0,12,12
300,TEL,P011971,P012744,0 days 00:05:33,-1,8,9
300,TEL,P009622,P011219,0 days 00:05:32,-9,6,15
300,TEL,P009783,P011971,0 days 00:04:52,4,16,12
300,TEL,P012095,P012744,0 days 00:04:52,-1,8,9
300,TEL,P009863,P011214,0 days 00:04:52,0,8,8
300,TEL,P009863,P011193,0 days 00:04:49,3,15,12
300,TEL,P009783,P011193,0 days 00:04:21,3,16,13
300,TEL,P004233,P009783,0 days 00:04:20,1,11,10
300,TEL,P009783,P011219,0 days 00:04:16,1,14,13
300,TEL,P009622,P011971,0 days 00:04:09,0,8,8
300,TEL,P004233,P011214,0 days 00:03:48,-1,2,3
300,TEL,P009622,P011214,0 days 00:03:35,-4,2,6
300,TEL,P009863,P012744,0 days 00:03:34,-1,7,8
300,TEL,P009783,P012095,0 days 00:03:32,-1,10,11
300,TEL,P004233,P011193,0 days 00:03:17,2,9,7
300,TEL,P011199,P011219,0 days 00:02:41,-3,6,9
300,TEL,P009863,P011971,0 days 00:02:05,4,6,2
300,TEL,P011199,P011971,0 days 00:02:03,4,6,2
300,TEL,P009622,P012744,0 days 00:01:44,0,0,0
300,TEL,P011199,P012744,0 days 00:01:33,0,0,0
300,TEL,P005145,P011193,0 days 00:01:32,1,4,3
300,TEL,P005145,P012744,0 days 00:01:32,1,4,3
300,TEL,P009622,P011193,0 days 00:01:25,-1,2,3
300,TEL,P004233,P011971,0 days 00:01:11,0,2,2
300,TEL,P009783,P011214,0 days 00:01:06,-3,2,5
300,TEL,P009783,P012744,0 days 00:01:05,0,0,0
300,TEL,P005145,P011214,0 days 00:01:04,1,4,3
300,TEL,P011219,P012744,0 days 00:00:59,-2,3,5
300,TEL,P004233,P012744,0 days 00:00:57,-2,3,5
300,TEL,P004233,P012095,0 days 00:00:45,0,0,0
300,TEL,P009863,P012095,0 days 00:00:45,0,2,2
300,TEL,P009622,P012095,0 days 00:00:41,-3,0,3
300,TEL,P011193,P011199,0 days 00:00:28,0,0,0
300,MIL,P007831,P011224,0 days 00:23:38,2,56,54
300,MIL,P000796,P007831,0 days 00:18:40,-5,47,52
300,MIL,P000796,P011224,0 days 00:18:23,-2,45,47
300,MIL,P009960,P011224,0 days 00:15:15,0,28,28
300,MIL,P000796,P006509,0 days 00:14:16,-6,35,41
300,MIL,P007831,P009960,0 days 00:14:05,0,28,28
300,MIL,P000796,P002849,0 days 00:12:44,-9,28,37
300,MIL,P006701,P007201,0 days 00:11:56,2,25,23
300,MIL,P007032,P007201,0 days 00:11:54,-4,23,27
300,MIL,P002849,P007831,0 days 00:11:41,-5,28,33
300,MIL,P002849,P011224,0 days 00:11:41,-5,28,33
300,MIL,P001518,P007032,0 days 00:11:40,-3,20,23
300,MIL,P002812,P006509,0 days 00:11:25,4,30,26
300,MIL,P006509,P007831,0 days 00:11:23,-5,30,35
300,MIL,P001518,P007201,0 days 00:11:01,-3,20,23
300,MIL,P006701,P009960,0 days 00:10:45,5,25,20
300,MIL,P006509,P011224,0 days 00:10:27,-2,28,30
300,MIL,P007201,P009960,0 days 00:10:11,5,25,20
300,MIL,P000796,P009960,0 days 00:09:53,-8,17,25
300,MIL,P002812,P007032,0 days 00:08:22,-2,14,16
300,MIL,P006509,P007032,0 days 00:08:02,-4,17,21
300,MIL,P002849,P009960,0 days 00:07:34,-5,14,19
300,MIL,P001518,P006701,0 days 00:07:19,-1,11,12
300,MIL,P000796,P002812,0 days 00:07:09,6,21,15
300,MIL,P006701,P007032,0 days 00:07:07,-2,14,16
300,MIL,P007032,P009960,0 days 00:07:04,-3,14,17
300,MIL,P001518,P009960,0 days 00:06:59,3,14,11
300,MIL,P002812,P007201,0 days 00:06:34,-8,9,17
300,MIL,P001518,P002812,0 days 00:06:32,-5,9,14
300,MIL,P002849,P006509,0 days 00:06:13,-8,14,22
300,MIL,P006701,P011224,0 days 00:05:54,4,11,7
300,MIL,P006701,P007831,0 days 00:05:54,4,11,7
300,MIL,P007201,P011224,0 days 00:05:20,4,11,7
300,MIL,P002812,P007831,0 days 00:05:19,3,16,13
300,MIL,P006509,P007201,0 days 00:05:11,-6,12,18
300,MIL,P007201,P007831,0 days 00:04:51,1,11,10
300,MIL,P002812,P011224,0 days 00:04:23,6,14,8
300,MIL,P001518,P006509,0 days 00:04:16,-2,9,11
300,MIL,P000796,P007032,0 days 00:03:32,-1,5,6
300,MIL,P001518,P011224,0 days 00:03:01,1,3,2
300,MIL,P006509,P009960,0 days 00:02:50,-9,3,12
300,MIL,P000796,P005670,0 days 00:02:44,3,7,4
300,MIL,P002812,P005670,0 days 00:02:44,3,7,4
300,MIL,P005670,P006509,0 days 00:02:44,3,7,4
300,MIL,P002812,P006701,0 days 00:02:16,-3,0,3
300,MIL,P001518,P007831,0 days 00:01:51,1,3,2
300,MIL,P005670,P007032,0 days 00:01:50,3,5,2
300,MIL,P000796,P001518,0 days 00:01:25,1,3,2
300,MIL,P007032,P011224,0 days 00:01:10,0,0,0
300,MIL,P002849,P007032,0 days 00:01:03,-4,0,4
300,MIL,P005670,P007831,0 days 00:00:54,0,2,2
300,MIL,P006509,P006701,0 days 00:00:53,-1,3,4
300,MIL,P000796,P007201,0 days 00:00:02,-3,0,3
301,PAN,P002328,P012774,0 days 00:24:40,8,48,40
301,PAN,P001926,P012774,0 days 00:22:42,14,52,38
301,PAN,P001926,P002328,0 days 00:22:26,22,51,29
301,PAN,P001926,P003842,0 days 00:19:38,6,47,41
301,PAN,P002328,P003842,0 days 00:17:56,1,36,35
301,PAN,P001926,P012712,0 days 00:17:23,14,40,26
301,PAN,P007866,P012774,0 days 00:16:31,-2,33,35
301,PAN,P002328,P007866,0 days 00:15:44,3,34,31
301,PAN,P003842,P012774,0 days 00:15:24,-5,32,37
301,PAN,P002328,P012712,0 days 00:15:15,9,29,20
301,PAN,P003842,P012712,0 days 00:14:58,-5,29,34
301,PAN,P012712,P012774,0 days 00:14:46,6,31,25
301,PAN,P001926,P007866,0 days 00:12:20,4,29,25
301,PAN,P011221,P012774,0 days 00:11:54,14,27,13
301,PAN,P001926,P011221,0 days 00:10:05,12,22,10
301,PAN,P003842,P007947,0 days 00:09:46,-3,19,22
301,PAN,P011204,P012774,0 days 00:09:42,-8,18,26
301,PAN,P003842,P007866,0 days 00:09:10,5,23,18
301,PAN,P002328,P011221,0 days 00:09:05,16,22,6
301,PAN,P007866,P011204,0 days 00:08:07,-3,12,15
301,PAN,P007947,P012712,0 days 00:07:44,-6,13,19
301,PAN,P002328,P011204,0 days 00:07:31,-2,13,15
301,PAN,P002328,P007947,0 days 00:07:21,-4,14,18
301,PAN,P011221,P012712,0 days 00:06:30,13,16,3
301,PAN,P001926,P007947,0 days 00:05:42,3,14,11
301,PAN,P007866,P011221,0 days 00:05:25,1,11,10
301,PAN,P001926,P011204,0 days 00:04:48,-4,11,15
301,PAN,P003842,P005161,0 days 00:04:37,4,10,6
301,PAN,P005161,P012712,0 days 00:04:37,4,10,6
301,PAN,P007553,P011204,0 days 00:03:58,-5,5,10
301,PAN,P007553,P012774,0 days 00:03:58,-5,5,10
301,PAN,P002328,P007553,0 days 00:03:58,-5,5,10
301,PAN,P007553,P007866,0 days 00:03:58,-5,5,10
301,PAN,P001926,P005161,0 days 00:03:48,1,10,9
301,PAN,P011204,P011221,0 days 00:03:43,2,7,5
301,PAN,P003842,P011204,0 days 00:03:20,-4,9,13
301,PAN,P005161,P012774,0 days 00:03:06,1,8,7
301,PAN,P011204,P012712,0 days 00:02:55,-4,9,13
301,PAN,P005161,P007947,0 days 00:02:25,1,5,4
301,PAN,P007947,P012774,0 days 00:02:21,-7,2,9
301,PAN,P007866,P007947,0 days 00:02:02,3,6,3
301,PAN,P005161,P011209,0 days 00:01:43,1,3,2
301,PAN,P007947,P011209,0 days 00:01:43,1,3,2
301,PAN,P011209,P012712,0 days 00:01:43,1,3,2
301,PAN,P003842,P011209,0 days 00:01:43,1,3,2
301,PAN,P005161,P007866,0 days 00:00:54,-2,3,5
301,PAN,P005161,P011221,0 days 00:00:54,-2,3,5
301,PAN,P007866,P012712,0 days 00:00:01,0,0,0
301,BER,P008967,P012720,0 days 00:21:25,-2,39,41
301,BER,P006251,P010791,0 days 00:19:01,-2,34,36
301,BER,P010791,P012720,0 days 00:16:14,-7,26,33
301,BER,P008967,P010791,0 days 00:16:10,-2,28,30
301,BER,P006251,P008967,0 days 00:15:58,0,30,30
301,BER,P007550,P012720,0 days 00:15:36,-22,20,42
301,BER,P006251,P012720,0 days 00:13:46,3,28,25
301,BER,P012720,P012721,0 days 00:12:41,-17,17,34
301,BER,P011934,P012721,0 days 00:11:30,1,25,24
301,BER,P007550,P010791,0 days 00:11:05,-14,17,31
301,BER,P006919,P008211,0 days 00:10:38,8,25,17
301,BER,P007550,P012721,0 days 00:10:17,-14,12,26
301,BER,P008780,P008967,0 days 00:10:07,3,22,19
301,BER,P008780,P012720,0 days 00:09:55,5,22,17
301,BER,P007550,P008967,0 days 00:09:02,-9,16,25
301,BER,P011934,P012720,0 days 00:08:57,-9,11,20
301,BER,P006251,P007550,0 days 00:08:56,-6,17,23
301,BER,P006919,P011934,0 days 00:08:47,5,24,19
301,BER,P006919,P010791,0 days 00:08:43,-11,8,19
301,BER,P006919,P012721,0 days 00:08:26,-1,18,19
301,BER,P006919,P007550,0 days 00:08:26,-11,15,26
301,BER,P006251,P008780,0 days 00:07:58,6,16,10
301,BER,P008967,P012721,0 days 00:07:52,4,20,16
301,BER,P008211,P011934,0 days 00:07:36,6,21,15
301,BER,P008780,P010791,0 days 00:07:28,4,14,10
301,BER,P008211,P008967,0 days 00:07:13,5,12,7
301,BER,P006919,P008967,0 days 00:07:05,-1,11,12
301,BER,P008211,P010791,0 days 00:06:59,0,9,9
301,BER,P008967,P011934,0 days 00:06:48,1,14,13
301,BER,P007550,P011934,0 days 00:06:42,-4,15,19
301,BER,P006251,P008211,0 days 00:06:24,0,9,9
301,BER,P006919,P012720,0 days 00:06:05,-13,2,15
301,BER,P008211,P012720,0 days 00:06:05,-4,5,9
301,BER,P006251,P006919,0 days 00:05:52,-3,8,11
301,BER,P008211,P012721,0 days 00:05:23,5,15,10
301,BER,P007550,P008211,0 days 00:05:11,0,14,14
301,BER,P008780,P012721,0 days 00:05:01,-2,10,12
301,BER,P008780,P011934,0 days 00:04:37,-2,7,9
301,BER,P006819,P012721,0 days 00:03:24,0,8,8
301,BER,P006819,P008967,0 days 00:03:24,0,8,8
301,BER,P006819,P012720,0 days 00:03:24,0,8,8
301,BER,P006919,P008780,0 days 00:03:04,-1,4,5
301,BER,P006919,P011631,0 days 00:02:54,4,13,9
301,BER,P011631,P011934,0 days 00:02:54,4,13,9
301,BER,P006819,P007550,0 days 00:02:30,-2,3,5
301,BER,P010791,P012721,0 days 00:02:16,-8,0,8
301,BER,P007550,P008780,0 days 00:02:00,-1,2,3
301,BER,P008211,P011631,0 days 00:01:59,2,8,6
301,BER,P011631,P012721,0 days 00:01:50,4,7,3
301,BER,P007550,P011631,0 days 00:01:23,3,9,6
301,BER,P006819,P008780,0 days 00:00:54,2,5,3
301,BER,P008211,P008780,0 days 00:00:52,2,2,0
301,BER,P006251,P011934,0 days 00:00:37,2,2,0
301,BER,P008967,P011631,0 days 00:00:24,-3,0,3
301,BER,P011631,P012720,0 days 00:00:12,2,2,0
302,ZAL,P002329,P007513,0 days 00:25:32,6,44,38
302,ZAL,P002329,P011218,0 days 00:25:06,3,42,39
302,ZAL,P007513,P011218,0 days 00:23:00,2,37,35
302,ZAL,P002329,P012715,0 days 00:19:56,5,38,33
302,ZAL,P007513,P012715,0 days 00:18:40,5,33,28
302,ZAL,P002329,P010390,0 days 00:17:46,8,35,27
302,ZAL,P011218,P012715,0 days 00:17:17,3,30,27
302,ZAL,P010390,P011218,0 days 00:16:36,5,30,25
302,ZAL,P007513,P010390,0 days 00:14:55,10,30,20
302,ZAL,P002329,P007109,0 days 00:12:29,-8,14,22
302,ZAL,P007109,P011218,0 days 00:12:20,-9,10,19
302,ZAL,P005504,P012715,0 days 00:11:30,-4,19,23
302,ZAL,P002329,P005504,0 days 00:10:19,-5,17,22
302,ZAL,P010390,P012715,0 days 00:10:05,12,23,11
302,ZAL,P007109,P010390,0 days 00:09:08,-7,10,17
302,ZAL,P002329,P012787,0 days 00:09:06,-2,17,19
302,ZAL,P007109,P007513,0 days 00:08:31,-7,7,14
302,ZAL,P007109,P012787,0 days 00:07:58,-5,9,14
302,ZAL,P002329,P003210,0 days 00:07:53,-9,9,18
302,ZAL,P005504,P007513,0 days 00:07:32,-2,12,14
302,ZAL,P007109,P010184,0 days 00:07:00,-4,4,8
302,ZAL,P010390,P012787,0 days 00:07:00,-2,8,10
302,ZAL,P003210,P012787,0 days 00:06:50,0,13,13
302,ZAL,P005504,P011218,0 days 00:06:28,-3,10,13
302,ZAL,P010184,P011218,0 days 00:06:28,-6,2,8
302,ZAL,P012715,P012787,0 days 00:05:14,3,12,9
302,ZAL,P010184,P012787,0 days 00:05:07,4,8,4
302,ZAL,P003210,P007109,0 days 00:05:02,-3,6,9
302,ZAL,P003210,P012715,0 days 00:05:02,-1,9,10
302,ZAL,P003210,P005504,0 days 00:05:02,-1,9,10
302,ZAL,P005504,P012787,0 days 00:04:54,2,11,9
302,ZAL,P011218,P012787,0 days 00:04:45,-5,5,10
302,ZAL,P007513,P010184,0 days 00:04:38,-1,4,5
302,ZAL,P002329,P006860,0 days 00:04:08,-4,4,8
302,ZAL,P006860,P007109,0 days 00:03:43,-2,4,6
302,ZAL,P010184,P012715,0 days 00:03:11,0,4,4
302,ZAL,P003210,P006860,0 days 00:03:06,0,4,4
302,ZAL,P002329,P010184,0 days 00:03:01,2,4,2
302,ZAL,P006860,P011218,0 days 00:02:49,-2,2,4
302,ZAL,P010184,P010390,0 days 00:02:28,-3,0,3
302,ZAL,P003210,P010184,0 days 00:02:11,5,6,1
302,ZAL,P007513,P012787,0 days 00:02:10,5,5,0
302,ZAL,P005504,P010184,0 days 00:02:07,5,6,1
302,ZAL,P003210,P007513,0 days 00:01:59,-4,2,6
302,ZAL,P006860,P012787,0 days 00:01:56,0,4,4
302,ZAL,P003210,P010390,0 days 00:01:56,-3,2,5
302,ZAL,P006860,P007513,0 days 00:01:39,-2,2,4
302,ZAL,P007109,P012715,0 days 00:01:33,-3,0,3
302,ZAL,P003210,P011218,0 days 00:01:15,0,0,0
302,ZAL,P006860,P010390,0 days 00:01:02,0,2,2
302,ZAL,P006860,P010184,0 days 00:00:37,2,2,0
302,MAD,P005791,P006540,0 days 00:19:55,9,32,23
302,MAD,P003108,P004887,0 days 00:19:03,-4,32,36
302,MAD,P005791,P009005,0 days 00:17:58,6,28,22
302,MAD,P006540,P009005,0 days 00:17:41,9,28,19
302,MAD,P003108,P010357,0 days 00:17:21,-1,28,29
302,MAD,P004887,P010357,0 days 00:16:13,-1,28,29
302,MAD,P006540,PTGB,0 days 00:15:00,9,24,15
302,MAD,P003733,P005791,0 days 00:14:54,-1,22,23
302,MAD,P001392,P003108,0 days 00:14:48,0,28,28
302,MAD,P003733,P006540,0 days 00:14:37,2,22,20
302,MAD,P003108,PTGB,0 days 00:14:12,2,22,20
302,MAD,P001392,P004887,0 days 00:14:03,0,28,28
302,MAD,P001392,P010357,0 days 00:13:35,0,26,26
302,MAD,P005791,PTGB,0 days 00:13:24,7,22,15
302,MAD,P003733,P009005,0 days 00:13:03,-1,18,19
302,MAD,P009005,PTGB,0 days 00:12:51,2,20,18
302,MAD,P003108,P010623,0 days 00:12:48,-5,22,27
302,MAD,P004887,P010623,0 days 00:12:25,-5,22,27
302,MAD,P010357,P010623,0 days 00:10:24,-4,18,22
302,MAD,P001392,P010623,0 days 00:10:03,-2,20,22
302,MAD,P009005,P010623,0 days 00:09:34,-2,14,16
302,MAD,P010357,PTGB,0 days 00:08:48,3,14,11
302,MAD,P003108,P006540,0 days 00:08:41,6,12,6
302,MAD,P006540,P010623,0 days 00:08:18,-1,10,11
302,MAD,P004887,PTGB,0 days 00:08:15,-2,12,14
302,MAD,P003108,P009005,0 days 00:08:02,1,14,13
302,MAD,P003733,PTGB,0 days 00:07:44,0,12,12
302,MAD,P005791,P010623,0 days 00:07:33,-1,10,11
302,MAD,P003733,P010623,0 days 00:07:10,-1,10,11
302,MAD,P003108,P005791,0 days 00:06:20,4,10,6
302,MAD,P006540,P010357,0 days 00:05:37,-1,6,7
302,MAD,P001392,PTGB,0 days 00:04:45,2,8,6
302,MAD,P004887,P006540,0 days 00:03:23,-1,2,3
302,MAD,P005791,P010357,0 days 00:02:59,0,4,4
302,MAD,P004887,P009005,0 days 00:02:50,-3,4,7
302,MAD,P003733,P010357,0 days 00:01:51,0,4,4
302,MAD,P010623,PTGB,0 days 00:01:37,-3,2,5
302,MAD,P001392,P009005,0 days 00:01:13,0,2,2
302,MAD,P001392,P005791,0 days 00:00:45,0,0,0
302,MAD,P003108,P003733,0 days 00:00:17,-3,0,3
303,VIR,P001133,P001844,0 days 00:18:56,-4,39,43
303,VIR,P002084,P010781,0 days 00:16:12,7,45,38
303,VIR,P001133,PBCN,0 days 00:16:08,-4,33,37
303,VIR,P001844,PBCN,0 days 00:15:37,-13,30,43
303,VIR,P006739,P010781,0 days 00:13:49,4,31,27
303,VIR,P003527,P010781,0 days 00:13:31,11,34,23
303,VIR,P001844,P003048,0 days 00:13:23,0,30,30
303,VIR,P008847,P010781,0 days 00:12:36,-1,27,28
303,VIR,P001133,P009549,0 days 00:11:46,1,26,25
303,VIR,P001844,P009549,0 days 00:11:46,1,26,25
303,VIR,P009549,PBCN,0 days 00:11:46,1,26,25
303,VIR,P001844,P010781,0 days 00:10:38,6,31,25
303,VIR,P001133,P003048,0 days 00:10:31,-1,21,22
303,VIR,P003048,PBCN,0 days 00:10:31,-1,21,22
303,VIR,P003527,P008847,0 days 00:10:26,3,23,20
303,VIR,P002084,P006739,0 days 00:10:22,6,25,19
303,VIR,P002084,P003527,0 days 00:10:05,7,26,19
303,VIR,P003048,P009549,0 days 00:09:24,-1,19,20
303,VIR,P004007,P010781,0 days 00:08:56,-6,23,29
303,VIR,P001133,P010781,0 days 00:08:55,1,19,18
303,VIR,P002084,P008847,0 days 00:08:39,-2,19,21
303,VIR,P001844,P004554,0 days 00:08:11,-7,20,27
303,VIR,P004007,P004554,0 days 00:08:05,-16,15,31
303,VIR,P006739,P008847,0 days 00:07:59,0,17,17
303,VIR,P001133,P004554,0 days 00:07:55,-6,16,22
303,VIR,P003527,P006739,0 days 00:07:45,6,18,12
303,VIR,P002084,P004007,0 days 00:07:32,-5,20,25
303,VIR,P001844,P004007,0 days 00:07:28,-11,15,26
303,VIR,P004554,P010781,0 days 00:06:54,-1,19,20
303,VIR,P001844,P002084,0 days 00:06:35,-2,19,21
303,VIR,P004554,PBCN,0 days 00:06:31,-5,13,18
303,VIR,P003048,P010781,0 days 00:05:37,10,18,8
303,VIR,P001844,P003527,0 days 00:05:06,7,14,7
303,VIR,P002084,P003048,0 days 00:04:57,8,16,8
303,VIR,P004007,P006739,0 days 00:04:08,-6,9,15
303,VIR,P001133,P004007,0 days 00:04:04,-12,4,16
303,VIR,P002084,P004554,0 days 00:04:01,-4,11,15
303,VIR,P001133,P008847,0 days 00:03:57,1,8,7
303,VIR,P001844,P008847,0 days 00:03:57,1,8,7
303,VIR,P001133,P006739,0 days 00:03:54,-4,6,10
303,VIR,P004554,P006739,0 days 00:03:45,-3,7,10
303,VIR,P001133,P003527,0 days 00:03:26,4,8,4
303,VIR,P010781,PBCN,0 days 00:03:20,1,9,8
303,VIR,P003048,P003527,0 days 00:03:05,8,11,3
303,VIR,P004007,PBCN,0 days 00:02:40,-11,1,12
303,VIR,P003048,P006739,0 days 00:02:32,5,7,2
303,VIR,P006739,PBCN,0 days 00:02:23,2,4,2
303,VIR,P004554,P009549,0 days 00:02:22,2,7,5
303,VIR,P002084,PBCN,0 days 00:02:05,-7,3,10
303,VIR,P003048,P004007,0 days 00:01:52,0,5,5
303,VIR,P004007,P008847,0 days 00:01:39,-1,4,5
303,VIR,P008847,PBCN,0 days 00:01:11,-5,2,7
303,VIR,P003527,PBCN,0 days 00:00:40,-2,2,4
303,VIR,P001844,P006739,0 days 00:00:27,-2,0,2
303,BAS,P004761,P009048,0 days 00:32:12,9,78,69
303,BAS,P004761,P011948,0 days 00:28:32,12,74,62
303,BAS,P009048,P011948,0 days 00:26:45,10,67,57
303,BAS,P010444,P011948,0 days 00:23:28,14,60,46
303,BAS,P004761,P010444,0 days 00:21:19,15,59,44
303,BAS,P004761,P012201,0 days 00:20:19,-12,40,52
303,BAS,P007230,P010444,0 days 00:19:30,18,56,38
303,BAS,P009048,P010444,0 days 00:19:29,16,52,36
303,BAS,P007230,P011948,0 days 00:18:21,17,49,32
303,BAS,P009048,P012201,0 days 00:17:49,-10,35,45
303,BAS,P007230,P009048,0 days 00:17:09,17,48,31
303,BAS,P004761,P007230,0 days 00:16:39,18,50,32
303,BAS,P011948,P012201,0 days 00:15:39,-11,31,42
303,BAS,P004603,P004761,0 days 00:14:29,-9,28,37
303,BAS,P004603,P009048,0 days 00:14:19,-9,28,37
303,BAS,P004603,P012201,0 days 00:13:35,-7,28,35
303,BAS,P010444,P012201,0 days 00:09:47,-5,20,25
303,BAS,P004603,P011948,0 days 00:08:36,-6,18,24
303,BAS,P008850,P012201,0 days 00:06:33,-1,14,15
303,BAS,P004761,P008850,0 days 00:06:06,-6,10,16
303,BAS,P004603,P008850,0 days 00:05:53,-3,10,13
303,BAS,P008850,P009048,0 days 00:05:53,-3,10,13
303,BAS,P010444,P012765,0 days 00:03:55,-3,9,12
303,BAS,P011948,P012765,0 days 00:03:52,0,9,9
303,BAS,P007230,P012201,0 days 00:03:46,0,9,9
303,BAS,P004761,P012765,0 days 00:03:36,-3,9,12
303,BAS,P012201,P012765,0 days 00:03:26,-2,7,9
303,BAS,P007946,P010444,0 days 00:02:07,0,6,6
303,BAS,P007946,P012201,0 days 00:02:07,0,6,6
303,BAS,P007230,P007946,0 days 00:02:07,0,6,6
303,BAS,P009048,P011085,0 days 00:01:36,-2,2,4
303,BAS,P010444,P011085,0 days 00:01:36,-2,2,4
303,BAS,P011085,P011948,0 days 00:01:36,-2,2,4
303,BAS,P007946,P011948,0 days 00:01:27,-2,2,4
303,BAS,P007230,P011085,0 days 00:01:09,-2,0,2
303,BAS,P007230,P012765,0 days 00:01:08,-1,2,3
303,BAS,P004603,P007230,0 days 00:00:54,-2,0,2
303,BAS,P007230,P008850,0 days 00:00:53,-1,4,5
303,BAS,P008850,P010444,0 days 00:00:53,-1,4,5
303,BAS,P007946,P008850,0 days 00:00:40,2,4,2
303,BAS,P011085,P012201,0 days 00:00:27,0,2,2
303,BAS,P008850,P012765,0 days 00:00:13,-3,0,3
303,BAS,P004603,P012765,0 days 00:00:10,0,0,0
304,ASV,P012080,P012731,0 days 00:21:03,5,44,39
304,ASV,P002100,P011225,0 days 00:20:24,3,42,39
304,ASV,P002100,P006568,0 days 00:19:45,-3,34,37
304,ASV,P006568,P011225,0 days 00:17:53,-5,32,37
304,ASV,P005094,P006568,0 days 00:16:48,3,32,29
304,ASV,P005094,P011225,0 days 00:16:37,0,33,33
304,ASV,P002100,P005094,0 days 00:16:30,4,32,28
304,ASV,P004194,P012080,0 days 00:16:19,13,39,26
304,ASV,P004194,P012731,0 days 00:15:55,14,39,25
304,ASV,P003526,P005094,0 days 00:14:21,2,26,24
304,ASV,P000229,P012080,0 days 00:14:02,9,30,21
304,ASV,P000229,P012731,0 days 00:13:38,10,30,20
304,ASV,P011225,P012080,0 days 00:13:27,-7,25,32
304,ASV,P000229,P004194,0 days 00:12:52,10,27,17
304,ASV,P003526,P011225,0 days 00:12:45,3,26,23
304,ASV,P003526,P006568,0 days 00:12:36,5,26,21
304,ASV,P002100,P003526,0 days 00:12:18,6,26,20
304,ASV,P011386,P012080,0 days 00:12:12,9,25,16
304,ASV,P011225,P012731,0 days 00:12:05,-7,21,28
304,ASV,P002100,P012080,0 days 00:11:36,-7,20,27
304,ASV,P004194,P011386,0 days 00:11:08,8,23,15
304,ASV,P000229,P011386,0 days 00:10:18,12,21,9
304,ASV,P011386,P012731,0 days 00:10:04,10,23,13
304,ASV,P006568,P012080,0 days 00:07:57,-10,8,18
304,ASV,P002100,P012731,0 days 00:07:29,-5,14,19
304,ASV,P005094,P012080,0 days 00:06:00,-4,9,13
304,ASV,P004194,P011225,0 days 00:05:50,4,16,12
304,ASV,P000229,P011225,0 days 00:04:45,-5,9,14
304,ASV,P002100,P004194,0 days 00:04:05,2,12,10
304,ASV,P006568,P012731,0 days 00:03:45,-8,2,10
304,ASV,P005094,P011386,0 days 00:03:44,-2,2,4
304,ASV,P002100,P011386,0 days 00:03:30,-4,4,8
304,ASV,P000229,P005094,0 days 00:02:49,-4,3,7
304,ASV,P006568,P011386,0 days 00:02:40,0,2,2
304,ASV,P005094,P012731,0 days 00:02:29,-3,3,6
304,ASV,P003526,P011386,0 days 00:01:36,-1,0,1
304,ASV,P003526,P012731,0 days 00:01:06,-2,0,2
304,ASV,P004194,P005094,0 days 00:01:04,-2,0,2
304,ASV,P003526,PKIR,0 days 00:01:02,-2,0,2
304,ASV,P005094,PKIR,0 days 00:01:02,-2,0,2
304,ASV,P011225,PKIR,0 days 00:01:02,-2,0,2
304,ASV,P012731,PKIR,0 days 00:01:02,-2,0,2
304,ASV,P000229,P003526,0 days 00:01:01,-2,0,2
304,ASV,P000229,P006568,0 days 00:00:48,-2,0,2
304,ASV,P003526,P004194,0 days 00:00:39,-1,0,1
304,ASV,P000229,P002100,-1 days +23:59:59,0,0,0
304,BAR,P010641,PLFW,0 days 00:15:34,-1,28,29
304,BAR,P003478,PLFW,0 days 00:15:12,4,27,23
304,BAR,P003478,P007519,0 days 00:14:57,2,29,27
304,BAR,P007464,P010641,0 days 00:14:55,-17,20,37
304,BAR,P007519,PLFW,0 days 00:14:15,-6,22,28
304,BAR,P009992,P012745,0 days 00:13:18,-1,28,29
304,BAR,P010641,P012745,0 days 00:12:20,-7,17,24
304,BAR,P002939,P009992,0 days 00:11:37,-7,19,26
304,BAR,P003478,P011244,0 days 00:11:34,7,24,17
304,BAR,P003204,P010641,0 days 00:10:22,0,18,18
304,BAR,P012745,PLFW,0 days 00:10:09,0,17,17
304,BAR,P002939,P012745,0 days 00:10:01,-5,19,24
304,BAR,P007464,P012745,0 days 00:09:39,-10,13,23
304,BAR,P000925,P003478,0 days 00:09:33,3,17,14
304,BAR,P000925,P007519,0 days 00:09:33,3,17,14
304,BAR,P003478,P010641,0 days 00:09:24,1,19,18
304,BAR,P007464,PLFW,0 days 00:09:23,-8,18,26
304,BAR,P007519,P011244,0 days 00:09:16,2,19,17
304,BAR,P000925,PLFW,0 days 00:09:00,4,16,12
304,BAR,P003204,PLFW,0 days 00:08:35,2,15,13
304,BAR,P007519,P010641,0 days 00:08:27,-9,14,23
304,BAR,P000925,P011244,0 days 00:08:22,3,15,12
304,BAR,P011244,PLFW,0 days 00:08:20,7,15,8
304,BAR,P009992,P010641,0 days 00:08:15,-5,11,16
304,BAR,P007464,P009992,0 days 00:08:03,-5,13,18
304,BAR,P003204,P003478,0 days 00:07:51,2,16,14
304,BAR,P000925,P012745,0 days 00:07:50,2,19,17
304,BAR,P004866,P012745,0 days 00:07:44,7,21,14
304,BAR,P004866,P009992,0 days 00:06:51,2,15,13
304,BAR,P000925,P009992,0 days 00:06:39,2,17,15
304,BAR,P003204,P011244,0 days 00:06:38,5,14,9
304,BAR,P002939,P007464,0 days 00:06:23,-6,7,13
304,BAR,P002939,P010641,0 days 00:06:23,-6,7,13
304,BAR,P007464,P007519,0 days 00:05:59,-6,10,16
304,BAR,P000925,P004866,0 days 00:05:50,-1,12,13
304,BAR,P010641,P011244,0 days 00:05:21,2,9,7
304,BAR,P003204,P007519,0 days 00:05:18,-3,11,14
304,BAR,P000925,P002939,0 days 00:05:14,-1,12,13
304,BAR,P002939,P004866,0 days 00:05:14,-1,12,13
304,BAR,P004866,PLFW,0 days 00:04:39,6,9,3
304,BAR,P003478,P007464,0 days 00:04:38,-1,10,11
304,BAR,P007519,P012745,0 days 00:04:23,-7,2,9
304,BAR,P004866,P010641,0 days 00:04:03,6,9,3
304,BAR,P009992,PLFW,0 days 00:03:17,4,9,5
304,BAR,P003204,P007464,0 days 00:03:15,-6,4,10
304,BAR,P003204,P004866,0 days 00:03:02,3,6,3
304,BAR,P003478,P012745,0 days 00:02:47,-2,2,4
304,BAR,P003204,P012745,0 days 00:02:29,3,6,3
304,BAR,P004866,P011244,0 days 00:02:09,-2,0,2
304,BAR,P000925,P003204,0 days 00:01:58,2,6,4
304,BAR,P002939,P011244,0 days 00:01:36,-2,0,2
304,BAR,P009992,P011244,0 days 00:01:36,-2,0,2
304,BAR,P000925,P007464,0 days 00:00:49,3,5,2
305,OLY,P008855,P010612,0 days 00:24:33,1,48,47
305,OLY,P001255,P010612,0 days 00:23:53,-5,43,48
305,OLY,P001255,P008855,0 days 00:23:37,-1,44,45
305,OLY,P008811,P008855,0 days 00:23:24,-1,44,45
305,OLY,P008811,P010612,0 days 00:22:00,2,45,43
305,OLY,P001255,P008811,0 days 00:21:41,0,40,40
305,OLY,P007853,P007982,0 days 00:17:49,4,32,28
305,OLY,P008829,P008855,0 days 00:15:54,-9,23,32
305,OLY,P008811,P008829,0 days 00:13:51,-10,17,27
305,OLY,P007853,P008855,0 days 00:13:49,3,31,28
305,OLY,P007853,P008811,0 days 00:13:45,5,31,26
305,OLY,P006589,P007982,0 days 00:12:27,6,24,18
305,OLY,P008829,P010612,0 days 00:11:21,-5,15,20
305,OLY,P007982,P010392,0 days 00:11:13,9,25,16
305,OLY,P006589,P008811,0 days 00:10:56,10,28,18
305,OLY,P006589,P010612,0 days 00:10:55,3,24,21
305,OLY,P001255,P006589,0 days 00:10:53,-3,18,21
305,OLY,P007982,P008811,0 days 00:10:14,5,22,17
305,OLY,P006589,P007853,0 days 00:10:06,4,18,14
305,OLY,P007853,P010392,0 days 00:09:44,6,19,13
305,OLY,P001255,P008829,0 days 00:09:27,-8,10,18
305,OLY,P006589,P012878,0 days 00:09:21,1,14,13
305,OLY,P006589,P008855,0 days 00:09:14,5,20,15
305,OLY,P007853,P008829,0 days 00:08:56,-2,16,18
305,OLY,P006589,P010392,0 days 00:08:44,10,22,12
305,OLY,P001255,P007853,0 days 00:07:47,-1,16,17
305,OLY,P007982,P012878,0 days 00:07:35,0,10,10
305,OLY,P007853,P010612,0 days 00:07:16,4,20,16
305,OLY,P008811,P010392,0 days 00:07:09,5,17,12
305,OLY,P007982,P008829,0 days 00:07:07,-3,13,16
305,OLY,P007982,P008855,0 days 00:06:38,1,13,12
305,OLY,P007853,P012878,0 days 00:06:21,3,10,7
305,OLY,P003941,P007853,0 days 00:04:27,-2,7,9
305,OLY,P003941,P008829,0 days 00:04:27,-2,7,9
305,OLY,P003941,P008855,0 days 00:04:27,-2,7,9
305,OLY,P001255,P012878,0 days 00:04:15,-5,4,9
305,OLY,P010392,P012878,0 days 00:04:04,4,8,4
305,OLY,P001255,P007982,0 days 00:03:39,-5,1,6
305,OLY,P010612,P012878,0 days 00:03:00,-2,4,6
305,OLY,P008855,P012878,0 days 00:02:48,3,6,3
305,OLY,P007982,P010612,0 days 00:02:48,2,8,6
305,OLY,P003941,P007982,0 days 00:02:38,-3,4,7
305,OLY,P008829,P010392,0 days 00:02:29,-1,3,4
305,OLY,P003941,P010612,0 days 00:01:49,1,3,2
305,OLY,P010392,P010612,0 days 00:01:29,3,6,3
305,ULK,P001932,P008962,0 days 00:24:12,7,50,43
305,ULK,P002968,P008962,0 days 00:20:47,6,38,32
305,ULK,P008962,P010560,0 days 00:18:28,5,35,30
305,ULK,P009849,P010560,0 days 00:17:50,11,35,24
305,ULK,P008962,P009849,0 days 00:17:08,13,37,24
305,ULK,P005844,P006661,0 days 00:16:28,-9,30,39
305,ULK,P004004,P006661,0 days 00:16:17,-3,34,37
305,ULK,P001932,P002968,0 days 00:15:46,6,29,23
305,ULK,P006661,P006961,0 days 00:15:10,-8,26,34
305,ULK,P001932,P009849,0 days 00:14:49,11,29,18
305,ULK,P001932,P010560,0 days 00:14:47,5,27,22
305,ULK,P001932,P006661,0 days 00:13:56,-12,23,35
305,ULK,P001932,P005844,0 days 00:13:27,-8,20,28
305,ULK,P002968,P010560,0 days 00:13:19,7,27,20
305,ULK,P005844,P006068,0 days 00:12:54,-7,21,28
305,ULK,P006068,P006661,0 days 00:12:54,-8,21,29
305,ULK,P006068,P006961,0 days 00:12:39,-6,21,27
305,ULK,P006661,P008962,0 days 00:12:35,-9,20,29
305,ULK,P004004,P005844,0 days 00:12:22,-3,25,28
305,ULK,P002968,P009849,0 days 00:11:42,11,27,16
305,ULK,P005844,P006961,0 days 00:11:35,-5,21,26
305,ULK,P001932,P004004,0 days 00:09:47,1,21,20
305,ULK,P004004,P008962,0 days 00:09:47,1,21,20
305,ULK,P005844,P008962,0 days 00:09:24,-3,16,19
305,ULK,P004004,P006961,0 days 00:09:04,3,22,19
305,ULK,P002968,P006661,0 days 00:08:55,-9,8,17
305,ULK,P004004,P006068,0 days 00:07:44,-1,16,17
305,ULK,P001932,P006961,0 days 00:06:55,-4,13,17
305,ULK,P008962,P011052,0 days 00:06:50,-2,10,12
305,ULK,P002968,P011052,0 days 00:06:05,-1,9,10
305,ULK,P005844,P010560,0 days 00:06:05,-3,7,10
305,ULK,P001932,P006068,0 days 00:05:52,-7,5,12
305,ULK,P005844,P009849,0 days 00:05:50,-1,7,8
305,ULK,P002968,P004004,0 days 00:05:03,2,9,7
305,ULK,P010560,P011052,0 days 00:05:00,-2,8,10
305,ULK,P002968,P006961,0 days 00:04:43,-1,5,6
305,ULK,P006961,P008962,0 days 00:04:12,1,10,9
305,ULK,P006661,P011052,0 days 00:03:49,-4,2,6
305,ULK,P009849,P011052,0 days 00:03:23,2,8,6
305,ULK,P006961,P011052,0 days 00:02:12,0,2,2
305,ULK,P006661,P010560,0 days 00:01:52,-6,0,6
305,ULK,P006068,P010560,0 days 00:01:19,-2,0,2
305,ULK,P005844,P011052,0 days 00:01:07,-1,1,2
305,ULK,P002968,P006068,0 days 00:01:04,-1,0,1
305,ULK,P006068,P009849,0 days 00:01:04,0,0,0
305,ULK,P001932,P011980,0 days 00:00:45,1,3,2
305,ULK,P008962,P011980,0 days 00:00:45,1,3,2
305,ULK,P009849,P011980,0 days 00:00:40,3,3,0
305,ULK,P006961,P011980,0 days 00:00:27,0,2,2
305,ULK,P010560,P011980,0 days 00:00:23,-1,1,2
305,ULK,P006961,P009849,0 days 00:00:22,2,2,0
305,ULK,P006068,P011052,0 days 00:00:22,0,0,0
305,ULK,P006961,P010560,0 days 00:00:05,-2,0,2
306,PAR,P009862,P011192,0 days 00:26:18,17,57,40
306,PAR,P004172,P011192,0 days 00:20:56,14,47,33
306,PAR,P004172,P009862,0 days 00:20:55,8,45,37
306,PAR,P007400,P009862,0 days 00:20:15,9,44,35
306,PAR,P007400,P008987,0 days 00:17:46,-1,32,33
306,PAR,P009862,P012096,0 days 00:17:05,9,33,24
306,PAR,P011192,P012096,0 days 00:16:21,9,33,24
306,PAR,P007400,P011192,0 days 00:16:18,13,37,24
306,PAR,P007400,P012743,0 days 00:14:55,7,31,24
306,PAR,P008987,P009862,0 days 00:14:49,-3,24,27
306,PAR,P003983,P004172,0 days 00:13:52,8,29,21
306,PAR,P008987,P011192,0 days 00:13:50,3,24,21
306,PAR,P003983,P011192,0 days 00:13:46,8,29,21
306,PAR,P011192,P012743,0 days 00:12:31,12,29,17
306,PAR,P004172,P012743,0 days 00:11:26,8,25,17
306,PAR,P003983,P008987,0 days 00:11:23,-4,15,19
306,PAR,P008987,P012743,0 days 00:10:53,3,20,17
306,PAR,P004172,P007400,0 days 00:10:49,4,25,21
306,PAR,P003983,P009862,0 days 00:10:48,6,22,16
306,PAR,P003983,P012096,0 days 00:09:44,8,20,12
306,PAR,P009862,P012743,0 days 00:09:36,9,23,14
306,PAR,P004172,P012096,0 days 00:09:06,8,20,12
306,PAR,P003983,P012743,0 days 00:09:01,0,15,15
306,PAR,P008987,P012096,0 days 00:08:43,1,13,12
306,PAR,P004172,P008987,0 days 00:08:27,-6,12,18
306,PAR,P007400,P012096,0 days 00:07:21,1,13,12
306,PAR,P000956,P008987,0 days 00:06:19,-2,10,12
306,PAR,P000956,P007400,0 days 00:06:19,-2,10,12
306,PAR,P000956,P012743,0 days 00:06:06,-3,9,12
306,PAR,P003983,P007400,0 days 00:05:23,0,10,10
306,PAR,P000956,P003983,0 days 00:05:19,-2,8,10
306,PAR,P007400,P011051,0 days 00:03:10,-3,6,9
306,PAR,P008987,P011051,0 days 00:03:10,-3,6,9
306,PAR,P009862,P011051,0 days 00:03:10,-3,6,9
306,PAR,P004172,P011051,0 days 00:02:57,-4,5,9
306,PAR,P000956,P009862,0 days 00:01:00,0,2,2
306,PAR,P000956,P011051,0 days 00:00:13,1,1,0
306,PAM,P007870,P011982,0 days 00:15:07,-1,27,28
306,PAM,P005356,P010393,0 days 00:14:37,-13,18,31
306,PAM,P000556,P011970,0 days 00:13:35,-4,24,28
306,PAM,P011970,P011982,0 days 00:13:32,4,27,23
306,PAM,P010568,P012738,0 days 00:13:22,-7,21,28
306,PAM,P005356,P012795,0 days 00:13:12,-8,20,28
306,PAM,P007870,P011970,0 days 00:11:56,1,22,21
306,PAM,P000556,P010750,0 days 00:11:49,-3,19,22
306,PAM,P010393,P012795,0 days 00:11:45,-10,16,26
306,PAM,P010393,P010568,0 days 00:11:30,-11,13,24
306,PAM,P010568,P012795,0 days 00:11:03,-2,19,21
306,PAM,P007870,P010750,0 days 00:10:35,4,21,17
306,PAM,P010750,P011982,0 days 00:10:35,4,21,17
306,PAM,P006643,P010393,0 days 00:10:23,-5,14,19
306,PAM,P006643,P012740,0 days 00:10:20,-10,15,25
306,PAM,P010393,P012738,0 days 00:09:53,-13,9,22
306,PAM,P010750,P011970,0 days 00:09:51,1,18,17
306,PAM,P000556,P007870,0 days 00:09:35,-2,17,19
306,PAM,P000556,P011982,0 days 00:09:35,-2,17,19
306,PAM,P012738,P012795,0 days 00:09:26,-4,15,19
306,PAM,P005356,P010568,0 days 00:08:40,-8,11,19
306,PAM,P005356,P012738,0 days 00:07:03,-10,7,17
306,PAM,P005356,P010750,0 days 00:06:41,-2,10,12
306,PAM,P006643,P010750,0 days 00:06:31,-3,9,12
306,PAM,P010568,P012740,0 days 00:06:23,-8,8,16
306,PAM,P006643,P010568,0 days 00:06:23,-8,8,16
306,PAM,P000556,P006643,0 days 00:06:19,-8,8,16
306,PAM,P012738,P012740,0 days 00:06:17,-8,8,16
306,PAM,P006643,P012738,0 days 00:06:17,-8,8,16
306,PAM,P005356,P006643,0 days 00:05:57,-5,7,12
306,PAM,P010393,P010750,0 days 00:05:57,-5,7,12
306,PAM,P000556,P012738,0 days 00:05:50,1,14,13
306,PAM,P000556,P005356,0 days 00:05:13,2,9,7
306,PAM,P000556,P010568,0 days 00:05:06,8,16,8
306,PAM,P011970,P012795,0 days 00:04:54,10,14,4
306,PAM,P011970,P012738,0 days 00:04:44,1,10,9
306,PAM,P011982,P012740,0 days 00:04:41,-4,7,11
306,PAM,P006643,P011982,0 days 00:04:37,0,9,9
306,PAM,P011970,P012740,0 days 00:04:35,-4,7,11
306,PAM,P006643,P011970,0 days 00:04:31,0,9,9
306,PAM,P000556,P010393,0 days 00:04:29,-1,6,7
306,PAM,P010393,P012740,0 days 00:04:26,0,7,7
306,PAM,P010750,P012795,0 days 00:04:09,0,7,7
306,PAM,P000556,P012740,0 days 00:04:05,-7,6,13
306,PAM,P000556,P012795,0 days 00:04:00,8,12,4
306,PAM,P007870,P012740,0 days 00:03:05,-7,2,9
306,PAM,P006643,P012795,0 days 00:03:05,-2,5,7
306,PAM,P006643,P007870,0 days 00:03:01,-3,4,7
306,PAM,P007870,P012795,0 days 00:02:31,4,6,2
306,PAM,P011982,P012795,0 days 00:02:31,4,6,2
306,PAM,P007870,P010568,0 days 00:02:27,-5,2,7
306,PAM,P010568,P011982,0 days 00:02:27,-5,2,7
306,PAM,P010568,P011970,0 days 00:02:23,6,8,2
306,PAM,P005356,P007870,0 days 00:02:11,5,7,2
306,PAM,P005356,P011982,0 days 00:02:11,5,7,2
306,PAM,P010393,P011970,0 days 00:01:36,3,5,2
306,PAM,P010393,P011982,0 days 00:01:36,3,5,2
306,PAM,P005356,P011970,0 days 00:01:27,2,4,2
307,TEL,P009783,P011199,0 days 00:24:13,21,73,52
307,TEL,P009783,P009863,0 days 00:23:38,21,69,48
307,TEL,P009863,P011199,0 days 00:23:06,21,69,48
307,TEL,P009622,P009863,0 days 00:22:19,26,66,40
307,TEL,P009622,P011199,0 days 00:22:18,28,72,44
307,TEL,P009622,P009783,0 days 00:22:14,28,70,42
307,TEL,P011193,P011971,0 days 00:15:14,1,41,40
307,TEL,P011193,P012744,0 days 00:14:49,9,44,35
307,TEL,P011214,P012744,0 days 00:14:16,9,38,29
307,TEL,P009863,P011971,0 days 00:14:08,1,40,39
307,TEL,P011193,P011214,0 days 00:13:43,7,38,31
307,TEL,P011214,P011971,0 days 00:12:35,8,36,28
307,TEL,P011971,P012744,0 days 00:12:34,10,38,28
307,TEL,P005145,P009783,0 days 00:12:14,8,30,22
307,TEL,P005145,P009622,0 days 00:12:14,8,30,22
307,TEL,P005145,P011199,0 days 00:12:14,8,30,22
307,TEL,P005145,P009863,0 days 00:12:14,8,30,22
307,TEL,P009622,P011971,0 days 00:11:59,10,33,23
307,TEL,P009863,P011193,0 days 00:10:56,5,36,31
307,TEL,P009622,P012744,0 days 00:10:23,10,29,19
307,TEL,P009622,P011193,0 days 00:09:53,14,33,19
307,TEL,P009863,P012744,0 days 00:08:54,8,29,21
307,TEL,P011199,P011971,0 days 00:07:49,-1,21,22
307,TEL,P009863,P011214,0 days 00:07:37,2,21,19
307,TEL,P009622,P011214,0 days 00:07:24,4,15,11
307,TEL,P009783,P011971,0 days 00:07:13,-1,19,20
307,TEL,P011193,P011199,0 days 00:06:29,3,21,18
307,TEL,P009783,P011193,0 days 00:05:54,3,19,16
307,TEL,P011199,P012744,0 days 00:03:46,4,14,10
307,TEL,P009783,P012744,0 days 00:03:32,4,12,8
307,TEL,P005145,P011193,0 days 00:01:55,-1,2,3
307,TEL,P005145,P011214,0 days 00:01:55,-1,2,3
307,TEL,P005145,P012095,0 days 00:01:55,-1,2,3
307,TEL,P005145,P012744,0 days 00:01:55,-1,2,3
307,TEL,P011193,P012095,0 days 00:01:55,-1,2,3
307,TEL,P011214,P012095,0 days 00:01:55,-1,2,3
307,TEL,P012095,P012744,0 days 00:01:55,-1,2,3
307,TEL,P009783,P011214,0 days 00:00:42,0,0,0
307,TEL,P011199,P011214,0 days 00:00:01,0,0,0
307,BAS,P007230,P009048,0 days 00:26:22,-14,54,68
307,BAS,P004603,P009048,0 days 00:25:40,-11,56,67
307,BAS,P007230,P011948,0 days 00:24:31,-17,55,72
307,BAS,P004603,P007230,0 days 00:23:22,-7,51,58
307,BAS,P009048,P011948,0 days 00:20:09,-11,50,61
307,BAS,P004603,P011948,0 days 00:16:20,-5,42,47
307,BAS,P004761,P007230,0 days 00:15:46,-24,22,46
307,BAS,P004761,P009048,0 days 00:14:23,-21,23,44
307,BAS,P007230,P011085,0 days 00:13:42,-6,32,38
307,BAS,P009048,P011085,0 days 00:12:21,-1,32,33
307,BAS,P004761,P011948,0 days 00:12:02,-23,24,47
307,BAS,P010444,P011948,0 days 00:11:18,-15,23,38
307,BAS,P004603,P004761,0 days 00:11:05,-18,15,33
307,BAS,P007230,P010444,0 days 00:10:39,-16,18,34
307,BAS,P004603,P011085,0 days 00:10:02,0,26,26
307,BAS,P011085,P011948,0 days 00:09:44,-3,25,28
307,BAS,P004761,P010444,0 days 00:08:52,-13,17,30
307,BAS,P004761,P012201,0 days 00:08:34,-8,15,23
307,BAS,P009048,P012201,0 days 00:08:03,-8,15,23
307,BAS,P007946,P011948,0 days 00:07:57,1,22,21
307,BAS,P007230,P007946,0 days 00:07:57,1,22,21
307,BAS,P004603,P012201,0 days 00:07:14,-9,10,19
307,BAS,P010444,P012765,0 days 00:06:46,-7,12,19
307,BAS,P010444,P011085,0 days 00:06:32,-8,12,20
307,BAS,P011085,P012765,0 days 00:06:01,-5,12,17
307,BAS,P003198,P009048,0 days 00:05:57,1,15,14
307,BAS,P009048,P010444,0 days 00:05:37,-4,14,18
307,BAS,P007230,P012201,0 days 00:04:56,-5,5,10
307,BAS,P003198,P011085,0 days 00:04:14,-6,10,16
307,BAS,P007946,P009048,0 days 00:04:12,5,13,8
307,BAS,P004603,P007946,0 days 00:04:12,5,13,8
307,BAS,P003198,P004603,0 days 00:04:09,-1,9,10
307,BAS,P003198,P007230,0 days 00:04:09,-1,9,10
307,BAS,P007230,P012765,0 days 00:03:54,-5,6,11
307,BAS,P007946,P010444,0 days 00:03:45,-4,9,13
307,BAS,P004761,P007946,0 days 00:03:45,-4,9,13
307,BAS,P011948,P012765,0 days 00:03:44,-5,6,11
307,BAS,P011948,P012201,0 days 00:03:07,-3,10,13
307,BAS,P004761,P011085,0 days 00:02:59,-3,3,6
307,BAS,P003198,P010444,0 days 00:02:21,-2,6,8
307,BAS,P003198,P012765,0 days 00:02:21,-2,6,8
307,BAS,P004761,P012765,0 days 00:01:49,-6,0,6
307,BAS,P009048,P012765,0 days 00:01:48,2,6,4
307,BAS,P003198,P011948,0 days 00:01:40,1,3,2
307,BAS,P010444,P012201,0 days 00:01:20,1,5,4
307,BAS,P007230,P008850,0 days 00:00:46,2,2,0
307,BAS,P003198,P008850,0 days 00:00:36,2,2,0
307,BAS,P004603,P008850,0 days 00:00:36,2,2,0
307,BAS,P008850,P009048,0 days 00:00:36,2,2,0
307,BAS,P003198,P004761,0 days 00:00:33,-4,0,4
307,BAS,P011085,P012201,0 days 00:00:31,0,0,0
307,BAS,P012201,P012765,0 days 00:00:31,0,0,0
307,BAS,P008850,P010444,0 days 00:00:10,0,0,0
307,BAS,P008850,P011085,0 days 00:00:10,0,0,0
307,BAS,P008850,P012765,0 days 00:00:10,0,0,0
308,IST,P004888,P007200,0 days 00:25:51,4,47,43
308,IST,P004888,PLHK,0 days 00:21:02,12,45,33
308,IST,P007200,PLHK,0 days 00:20:39,5,40,35
308,IST,P009513,PLHK,0 days 00:15:55,3,32,29
308,IST,P004888,P009513,0 days 00:15:55,3,32,29
308,IST,P007200,P009513,0 days 00:15:55,3,32,29
308,IST,P007200,P011981,0 days 00:13:18,-7,18,25
308,IST,P004888,P006590,0 days 00:13:08,2,20,18
308,IST,P011981,PLHK,0 days 00:12:08,-7,16,23
308,IST,P006590,P009846,0 days 00:12:05,-6,13,19
308,IST,P006590,P007200,0 days 00:11:30,-3,15,18
308,IST,P007200,P012710,0 days 00:11:27,2,25,23
308,IST,P004888,P012710,0 days 00:11:27,2,25,23
308,IST,P004888,P011981,0 days 00:10:04,2,17,15
308,IST,P006590,P012788,0 days 00:09:59,-4,8,12
308,IST,P006590,P011078,0 days 00:09:48,-3,11,14
308,IST,P006590,P009664,0 days 00:09:43,0,10,10
308,IST,P012710,PLHK,0 days 00:09:41,7,25,18
308,IST,P009846,P011078,0 days 00:09:23,-4,12,16
308,IST,P006590,PLHK,0 days 00:09:15,-1,15,16
308,IST,P009513,P012710,0 days 00:09:02,5,23,18
308,IST,P009664,P011078,0 days 00:08:54,-2,10,12
308,IST,P007200,P009846,0 days 00:08:16,-2,13,15
308,IST,P009846,P012788,0 days 00:07:46,1,8,7
308,IST,P006590,P011981,0 days 00:07:19,-6,10,16
308,IST,P009846,P011981,0 days 00:07:03,-10,8,18
308,IST,P009513,P011981,0 days 00:06:53,-2,9,11
308,IST,P009664,P009846,0 days 00:06:49,2,10,8
308,IST,P011078,P011981,0 days 00:06:28,-1,13,14
308,IST,P007200,P009664,0 days 00:06:23,2,12,10
308,IST,P004888,P012788,0 days 00:05:57,-6,4,10
308,IST,P004888,P009664,0 days 00:05:41,-2,6,8
308,IST,P011078,P012788,0 days 00:05:17,0,4,4
308,IST,P009664,P012788,0 days 00:05:17,0,4,4
308,IST,P007200,P012788,0 days 00:04:42,-4,4,8
308,IST,P011078,PLHK,0 days 00:04:31,-3,7,10
308,IST,P009846,PLHK,0 days 00:04:11,-7,5,12
308,IST,P009664,P011981,0 days 00:03:55,1,9,8
308,IST,P004888,P009846,0 days 00:03:55,2,7,5
308,IST,P009664,PLHK,0 days 00:03:18,-1,3,4
308,IST,P004888,P011078,0 days 00:03:12,1,5,4
308,IST,P007200,P011078,0 days 00:02:47,0,6,6
308,IST,P006590,P012710,0 days 00:02:25,-3,2,5
308,IST,P012710,P012788,0 days 00:00:58,-3,0,3
308,IST,P011981,P012710,0 days 00:00:48,-2,0,2
308,VIR,P003527,P010781,0 days 00:23:31,10,38,28
308,VIR,P003048,PBCN,0 days 00:17:43,2,35,33
308,VIR,P001133,P003048,0 days 00:17:26,-4,33,37
308,VIR,P002084,P010781,0 days 00:17:17,-4,23,27
308,VIR,P001133,PBCN,0 days 00:16:37,-7,29,36
308,VIR,P001844,P010781,0 days 00:16:01,-2,24,26
308,VIR,P002084,P003527,0 days 00:15:56,-1,23,24
308,VIR,P001844,P003527,0 days 00:14:44,-2,21,23
308,VIR,P001133,P010781,0 days 00:13:09,8,24,16
308,VIR,P001133,P006739,0 days 00:13:08,7,28,21
308,VIR,P006739,P010781,0 days 00:13:04,16,25,9
308,VIR,P001844,P003048,0 days 00:12:46,-14,19,33
308,VIR,P002084,P004554,0 days 00:12:30,5,23,18
308,VIR,P003527,P004554,0 days 00:12:30,5,23,18
308,VIR,P004554,P010781,0 days 00:12:30,5,23,18
308,VIR,P001133,P001844,0 days 00:12:29,-18,17,35
308,VIR,P001844,P002084,0 days 00:12:06,0,19,19
308,VIR,P001844,PBCN,0 days 00:11:25,-10,19,29
308,VIR,P006739,PBCN,0 days 00:11:16,2,23,21
308,VIR,P003048,P010781,0 days 00:11:02,14,25,11
308,VIR,P003048,P006739,0 days 00:10:44,9,27,18
308,VIR,P001844,P004554,0 days 00:10:34,4,19,15
308,VIR,P010781,PBCN,0 days 00:10:13,11,21,10
308,VIR,P003527,P006739,0 days 00:06:51,11,13,2
308,VIR,P001133,P003527,0 days 00:05:39,3,9,6
308,VIR,P009549,PBCN,0 days 00:05:30,-5,7,12
308,VIR,P001844,P009549,0 days 00:05:30,-5,7,12
308,VIR,P001133,P009549,0 days 00:05:30,-5,7,12
308,VIR,P003048,P009549,0 days 00:05:30,-5,7,12
308,VIR,P003527,P008847,0 days 00:05:21,1,5,4
308,VIR,P008847,P010781,0 days 00:05:21,1,5,4
308,VIR,P003048,P003527,0 days 00:04:53,6,10,4
308,VIR,P006739,P008847,0 days 00:04:25,3,5,2
308,VIR,P001844,P006739,0 days 00:03:29,-7,7,14
308,VIR,P002084,P006739,0 days 00:03:15,-5,0,5
308,VIR,P002084,P008847,0 days 00:02:47,-4,0,4
308,VIR,P003527,PBCN,0 days 00:02:43,6,6,0
308,VIR,P001133,P008847,0 days 00:02:34,5,5,0
308,VIR,P001133,P002084,0 days 00:02:00,-5,0,5
308,VIR,P002084,P009549,0 days 00:01:56,1,4,3
308,VIR,P003527,P009549,0 days 00:01:56,1,4,3
308,VIR,P004554,P009549,0 days 00:01:56,1,4,3
308,VIR,P009549,P010781,0 days 00:01:56,1,4,3
308,VIR,P002084,PBCN,0 days 00:01:21,-3,0,3
308,VIR,P001844,P008847,0 days 00:00:56,-2,0,2
309,BAS,P007230,P009048,0 days 00:31:05,13,73,60
309,BAS,P004761,P009048,0 days 00:22:35,-2,49,51
309,BAS,P004761,P007230,0 days 00:22:22,-4,49,53
309,BAS,P007230,P011085,0 days 00:21:46,15,48,33
309,BAS,P007230,P011948,0 days 00:21:19,20,58,38
309,BAS,P009048,P011948,0 days 00:20:41,15,58,43
309,BAS,P009048,P010444,0 days 00:20:27,-3,41,44
309,BAS,P009048,P011085,0 days 00:19:09,13,43,30
309,BAS,P007230,P010444,0 days 00:18:49,1,38,37
309,BAS,P004603,P007230,0 days 00:16:56,13,43,30
309,BAS,P004603,P009048,0 days 00:15:23,17,43,26
309,BAS,P010444,P011948,0 days 00:14:25,0,32,32
309,BAS,P004761,P010444,0 days 00:13:47,-4,29,33
309,BAS,P004603,P011085,0 days 00:11:29,11,29,18
309,BAS,P004603,P011948,0 days 00:10:56,23,37,14
309,BAS,P004761,P011948,0 days 00:10:39,4,30,26
309,BAS,P010444,P011085,0 days 00:10:17,4,19,15
309,BAS,P004761,P011085,0 days 00:09:56,0,19,19
309,BAS,P004603,P004761,0 days 00:09:18,-2,20,22
309,BAS,P011085,P011948,0 days 00:09:07,13,25,12
309,BAS,P008850,P009048,0 days 00:08:15,-4,12,16
309,BAS,P008850,P010444,0 days 00:07:39,-2,12,14
309,BAS,P007230,P008850,0 days 00:06:03,-3,7,10
309,BAS,P008850,P011948,0 days 00:05:05,3,11,8
309,BAS,P007230,P012765,0 days 00:04:40,1,8,7
309,BAS,P011948,P012765,0 days 00:04:10,5,8,3
309,BAS,P003198,P008850,0 days 00:03:45,-5,5,10
309,BAS,P003198,P010444,0 days 00:03:45,-5,5,10
309,BAS,P003198,P009048,0 days 00:03:45,-5,5,10
309,BAS,P004603,P008850,0 days 00:03:09,0,6,6
309,BAS,P003198,P011948,0 days 00:03:02,-3,5,8
309,BAS,P008850,P011085,0 days 00:02:43,2,4,2
309,BAS,P010444,P012765,0 days 00:02:37,2,5,3
309,BAS,P011085,P012765,0 days 00:02:37,2,5,3
309,BAS,P004761,P008850,0 days 00:02:30,-10,0,10
309,BAS,P004603,P012765,0 days 00:02:03,-1,3,4
309,BAS,P008850,P012765,0 days 00:02:03,-1,3,4
309,BAS,P003198,P004761,0 days 00:00:43,-2,0,2
309,BAS,P004761,P012765,0 days 00:00:30,-4,0,4
309,BAS,P004603,P010444,0 days 00:00:30,3,3,0
309,VIR,P001133,P001844,0 days 00:17:48,-13,26,39
309,VIR,P001844,PBCN,0 days 00:17:33,-10,32,42
309,VIR,P001844,P009549,0 days 00:15:39,-12,24,36
309,VIR,P003527,P010781,0 days 00:15:06,3,34,31
309,VIR,P009549,PBCN,0 days 00:15:00,-5,29,34
309,VIR,P001133,PBCN,0 days 00:15:00,-12,25,37
309,VIR,P001133,P009549,0 days 00:14:34,-19,17,36
309,VIR,P002084,P010781,0 days 00:13:12,2,29,27
309,VIR,P003048,PBCN,0 days 00:12:30,-11,21,32
309,VIR,P002084,P003527,0 days 00:12:20,-2,25,27
309,VIR,P001844,P003048,0 days 00:12:16,-13,19,32
309,VIR,P001133,P006739,0 days 00:11:08,-6,20,26
309,VIR,P006739,P010781,0 days 00:10:48,-2,24,26
309,VIR,P003527,P006739,0 days 00:10:29,3,23,20
309,VIR,P002084,P008847,0 days 00:10:12,-3,20,23
309,VIR,P003527,P008847,0 days 00:10:09,-3,20,23
309,VIR,P001133,P003048,0 days 00:10:05,-15,12,27
309,VIR,P003527,P009549,0 days 00:09:39,4,21,17
309,VIR,P008847,P010781,0 days 00:09:11,-2,18,20
309,VIR,P001844,P003527,0 days 00:09:03,-1,15,16
309,VIR,P004554,P010781,0 days 00:08:44,1,21,20
309,VIR,P003048,P009549,0 days 00:08:26,-9,13,22
309,VIR,P004554,P009549,0 days 00:08:18,-4,16,20
309,VIR,P009549,P010781,0 days 00:07:56,-1,17,18
309,VIR,P001133,P004554,0 days 00:07:55,-5,18,23
309,VIR,P002084,P009549,0 days 00:07:46,4,19,15
309,VIR,P001133,P010781,0 days 00:06:25,-3,14,17
309,VIR,P001844,P006739,0 days 00:06:15,-2,9,11
309,VIR,P001133,P003527,0 days 00:05:58,3,12,9
309,VIR,P002084,P006739,0 days 00:05:55,2,13,11
309,VIR,P004554,P006739,0 days 00:05:54,-2,14,16
309,VIR,P006739,P008847,0 days 00:05:20,3,12,9
309,VIR,P001844,P002084,0 days 00:05:15,-2,9,11
309,VIR,P004554,PBCN,0 days 00:04:52,2,13,11
309,VIR,P006739,P009549,0 days 00:04:33,-7,3,10
309,VIR,P003527,P004554,0 days 00:04:28,4,13,9
309,VIR,P006739,PBCN,0 days 00:04:08,-1,8,9
309,VIR,P001844,P008847,0 days 00:04:02,-4,5,9
309,VIR,P001844,P010781,0 days 00:03:55,-2,6,8
309,VIR,P002084,P004554,0 days 00:03:51,5,10,5
309,VIR,P002084,PBCN,0 days 00:03:44,5,10,5
309,VIR,P003527,PBCN,0 days 00:03:30,6,11,5
309,VIR,P010781,PBCN,0 days 00:03:17,6,11,5
309,VIR,P003048,P006739,0 days 00:03:13,-3,5,8
309,VIR,P003048,P003527,0 days 00:03:09,4,9,5
309,VIR,P001844,P004554,0 days 00:03:02,-1,7,8
309,VIR,P008847,P009549,0 days 00:02:29,-3,5,8
309,VIR,P003048,P010781,0 days 00:01:49,3,5,2
309,VIR,P001133,P002084,0 days 00:01:32,2,4,2
309,VIR,P002084,P004007,0 days 00:00:29,-1,1,2
309,VIR,P003527,P004007,0 days 00:00:29,-1,1,2
309,VIR,P004007,P006739,0 days 00:00:29,-1,1,2
309,VIR,P004007,P010781,0 days 00:00:29,-1,1,2
309,VIR,P008847,PBCN,0 days 00:00:22,0,0,0
309,VIR,P001133,P008847,0 days 00:00:19,0,0,0
310,MAD,P005791,P010357,0 days 00:17:59,20,50,30
310,MAD,P004887,PCVM,0 days 00:16:36,1,37,36
310,MAD,P005928,P010357,0 days 00:16:04,23,46,23
310,MAD,P006540,P010357,0 days 00:15:52,23,47,24
310,MAD,P005791,P005928,0 days 00:15:48,23,46,23
310,MAD,P005928,P006540,0 days 00:15:42,22,43,21
310,MAD,P005791,P006540,0 days 00:15:36,23,47,24
310,MAD,P004887,P009005,0 days 00:13:51,1,24,23
310,MAD,P004887,PTGB,0 days 00:13:48,6,30,24
310,MAD,P009005,PCVM,0 days 00:12:49,3,24,21
310,MAD,P003733,P004887,0 days 00:12:36,-3,24,27
310,MAD,P003108,P005928,0 days 00:11:23,9,28,19
310,MAD,PCVM,PTGB,0 days 00:11:22,9,27,18
310,MAD,P004887,PBMT,0 days 00:11:13,-2,25,27
310,MAD,P003108,P005791,0 days 00:11:12,12,32,20
310,MAD,P003108,P010357,0 days 00:10:51,12,32,20
310,MAD,P003733,PCVM,0 days 00:10:47,-4,21,25
310,MAD,P003108,P006540,0 days 00:10:29,11,29,18
310,MAD,P003733,P010357,0 days 00:10:25,-9,20,29
310,MAD,P009005,PTGB,0 days 00:10:21,5,20,15
310,MAD,P009005,P010357,0 days 00:10:00,6,22,16
310,MAD,P010357,PCVM,0 days 00:09:59,-9,21,30
310,MAD,P004887,P010357,0 days 00:09:53,-7,20,27
310,MAD,P005928,P009005,0 days 00:09:03,6,18,12
310,MAD,PBMT,PCVM,0 days 00:08:52,-1,22,23
310,MAD,P006540,P009005,0 days 00:08:21,8,18,10
310,MAD,P005791,P009005,0 days 00:08:01,8,18,10
310,MAD,PBMT,PTGB,0 days 00:08:00,4,19,15
310,MAD,P003733,PTGB,0 days 00:06:47,5,14,9
310,MAD,P010357,PTGB,0 days 00:05:55,0,13,13
310,MAD,P003733,P009005,0 days 00:05:51,0,8,8
310,MAD,P009005,PBMT,0 days 00:05:39,5,16,11
310,MAD,P010357,PBMT,0 days 00:05:34,-7,9,16
310,MAD,P003733,PBMT,0 days 00:05:34,-7,9,16
310,MAD,P003108,PTGB,0 days 00:03:47,-3,3,6
310,MAD,P003108,P009005,0 days 00:03:27,-4,0,4
310,MAD,P003108,PCVM,0 days 00:03:11,-1,4,5
310,MAD,P003108,P004887,0 days 00:02:50,-4,0,4
310,MAD,P005791,PCVM,0 days 00:02:48,-3,4,7
310,MAD,P005928,PTGB,0 days 00:02:33,-3,3,6
310,MAD,P005791,PTGB,0 days 00:02:28,-1,3,4
310,MAD,P004887,P005928,0 days 00:02:11,-4,0,4
310,MAD,P006540,PCVM,0 days 00:01:55,-1,4,5
310,MAD,P004887,P006540,0 days 00:01:29,-2,0,2
310,MAD,P003733,P005791,0 days 00:00:32,-2,0,2
310,MAD,P005928,PCVM,0 days 00:00:16,0,0,0
310,MAD,P001392,P004887,0 days 00:00:05,-2,0,2
310,MAD,P001392,P009005,0 days 00:00:05,-2,0,2
310,MAD,P001392,PCVM,0 days 00:00:05,-2,0,2
310,MAD,P001392,PTGB,0 days 00:00:03,-2,0,2
310,MAD,P001392,P003108,0 days 00:00:02,0,0,0
310,BAS,P007230,P009048,0 days 00:26:14,-10,51,61
310,BAS,P004761,P007230,0 days 00:22:25,-3,45,48
310,BAS,P004761,P009048,0 days 00:22:25,-3,45,48
310,BAS,P004761,P010444,0 days 00:20:54,4,46,42
310,BAS,P009048,P010444,0 days 00:19:41,-6,39,45
310,BAS,P007230,P010444,0 days 00:18:21,-6,37,43
310,BAS,P004761,P011948,0 days 00:17:12,-6,27,33
310,BAS,P009048,P011085,0 days 00:16:01,-8,35,43
310,BAS,P010444,P011948,0 days 00:15:17,-14,23,37
310,BAS,P007230,P011085,0 days 00:14:41,-8,33,41
310,BAS,P003198,P012765,0 days 00:12:26,-6,21,27
310,BAS,P009048,P011948,0 days 00:12:13,-12,18,30
310,BAS,P007230,P011948,0 days 00:12:13,-12,18,30
310,BAS,P010444,P011085,0 days 00:12:12,-13,29,42
310,BAS,P004761,P011085,0 days 00:10:52,-1,27,28
310,BAS,P004603,P011085,0 days 00:10:20,2,17,15
310,BAS,P011085,P012765,0 days 00:09:24,-1,16,17
310,BAS,P004603,P012765,0 days 00:07:59,2,13,11
310,BAS,P003198,P010444,0 days 00:07:55,-6,15,21
310,BAS,P004603,P009048,0 days 00:07:53,-4,14,18
310,BAS,P004603,P007230,0 days 00:07:53,-4,14,18
310,BAS,P003198,P011085,0 days 00:07:51,-3,13,16
310,BAS,P004603,P004761,0 days 00:07:26,-10,9,19
310,BAS,P010444,P012765,0 days 00:07:20,-6,13,19
310,BAS,P003198,P008850,0 days 00:07:18,2,13,11
310,BAS,P008850,P011085,0 days 00:07:18,2,13,11
310,BAS,P011948,P012765,0 days 00:06:28,-8,10,18
310,BAS,P003198,P011948,0 days 00:06:28,-8,10,18
310,BAS,P008850,P012765,0 days 00:05:58,2,11,9
310,BAS,P004761,P012765,0 days 00:05:55,-3,10,13
310,BAS,P003198,P004761,0 days 00:05:55,-3,10,13
310,BAS,P003198,P004603,0 days 00:05:51,0,8,8
310,BAS,P004603,P008850,0 days 00:04:10,4,8,4
310,BAS,P008850,P010444,0 days 00:03:24,-1,6,7
310,BAS,P004603,P011948,0 days 00:03:24,-6,5,11
310,BAS,P007230,P012765,0 days 00:02:53,2,5,3
310,BAS,P009048,P012765,0 days 00:02:53,2,5,3
310,BAS,P008850,P009048,0 days 00:01:36,1,3,2
310,BAS,P011085,P011948,0 days 00:01:29,-14,1,15
310,BAS,P003198,P009048,0 days 00:01:20,0,2,2
310,BAS,P004761,P008850,0 days 00:00:16,1,1,0
310,BAS,P007230,P008850,0 days 00:00:16,1,1,0
311,BAR,P004866,P012745,0 days 00:22:25,-2,36,38
311,BAR,P006435,P012745,0 days 00:20:36,-3,35,38
311,BAR,P000925,P012745,0 days 00:19:21,-6,30,36
311,BAR,P004866,P006435,0 days 00:18:46,-3,29,32
311,BAR,P000925,P004866,0 days 00:17:46,-5,27,32
311,BAR,P000925,P006435,0 days 00:17:38,-7,28,35
311,BAR,P002939,P006435,0 days 00:16:54,-5,22,27
311,BAR,P002939,P012745,0 days 00:15:13,-7,17,24
311,BAR,P003196,P003478,0 days 00:15:09,4,34,30
311,BAR,P012745,PLFW,0 days 00:13:07,3,32,29
311,BAR,P002939,P004866,0 days 00:12:32,-9,14,23
311,BAR,P000925,P002939,0 days 00:12:22,-10,15,25
311,BAR,P003478,P011244,0 days 00:11:40,2,26,24
311,BAR,P003196,P007519,0 days 00:11:00,0,28,28
311,BAR,P003478,P007519,0 days 00:10:47,-3,25,28
311,BAR,P003196,P011244,0 days 00:10:23,5,24,19
311,BAR,P004866,PLFW,0 days 00:09:53,7,22,15
311,BAR,P003196,PLFW,0 days 00:09:50,2,29,27
311,BAR,P002939,P003478,0 days 00:09:48,4,15,11
311,BAR,P002939,P003196,0 days 00:09:32,5,14,9
311,BAR,P007519,PLFW,0 days 00:09:26,-2,25,27
311,BAR,P003196,P012745,0 days 00:08:59,2,19,17
311,BAR,P006435,PLFW,0 days 00:08:40,5,21,16
311,BAR,P000925,PLFW,0 days 00:08:16,1,17,16
311,BAR,P003478,PLFW,0 days 00:08:13,-4,24,28
311,BAR,P003196,P006435,0 days 00:07:56,7,15,8
311,BAR,P007519,P012745,0 days 00:07:18,-1,14,15
311,BAR,P003478,P006435,0 days 00:06:48,3,14,11
311,BAR,P007519,P011244,0 days 00:06:42,-1,18,19
311,BAR,P002939,P011244,0 days 00:06:41,2,12,10
311,BAR,P003478,P012745,0 days 00:06:21,-2,13,15
311,BAR,P011244,PLFW,0 days 00:04:59,0,14,14
311,BAR,P006435,P011244,0 days 00:04:58,3,8,5
311,BAR,P003196,P004866,0 days 00:04:39,3,9,6
311,BAR,P002939,P007519,0 days 00:04:34,0,7,7
311,BAR,P004866,P007519,0 days 00:03:13,1,7,6
311,BAR,P000925,P007519,0 days 00:03:00,-2,4,6
311,BAR,P000925,P003478,0 days 00:02:52,-4,5,9
311,BAR,P000925,P011244,0 days 00:01:17,-3,2,5
311,BAR,P003478,P004866,0 days 00:00:26,0,0,0
311,OLY,P007982,P010612,0 days 00:19:36,-3,44,47
311,OLY,P006589,P008811,0 days 00:17:25,4,31,27
311,OLY,P007853,P010612,0 days 00:16:57,-4,28,32
311,OLY,P010612,P011194,0 days 00:15:38,1,32,31
311,OLY,P007853,P007982,0 days 00:15:34,-6,27,33
311,OLY,P008811,P010612,0 days 00:13:01,10,27,17
311,OLY,P007982,P008811,0 days 00:12:42,-2,28,30
311,OLY,P010612,P012878,0 days 00:12:40,0,24,24
311,OLY,P011194,P012878,0 days 00:12:40,0,24,24
311,OLY,P008811,P008855,0 days 00:12:31,4,20,16
311,OLY,P007853,P008829,0 days 00:11:52,-1,23,24
311,OLY,P008855,P010612,0 days 00:11:49,11,19,8
311,OLY,P007853,P008811,0 days 00:11:30,5,22,17
311,OLY,P008829,P010612,0 days 00:11:11,7,22,15
311,OLY,P006589,P008855,0 days 00:10:42,3,18,15
311,OLY,P006589,P007982,0 days 00:10:26,-3,20,23
311,OLY,P008811,P008829,0 days 00:10:13,9,17,8
311,OLY,P007982,P011194,0 days 00:10:04,-6,20,26
311,OLY,P008829,P008855,0 days 00:09:09,3,12,9
311,OLY,P006589,P008829,0 days 00:08:57,6,13,7
311,OLY,P006589,P010612,0 days 00:08:56,8,17,9
311,OLY,P006589,P007853,0 days 00:08:45,1,16,15
311,OLY,P007982,P012878,0 days 00:08:29,-6,14,20
311,OLY,P007982,P011983,0 days 00:07:53,-8,17,25
311,OLY,P007982,P008829,0 days 00:07:00,0,17,17
311,OLY,P010392,P010612,0 days 00:06:42,7,19,12
311,OLY,P007853,P008855,0 days 00:06:21,-2,8,10
311,OLY,P010392,P012878,0 days 00:06:07,10,19,9
311,OLY,P007853,P011194,0 days 00:06:07,-4,5,9
311,OLY,P010392,P011194,0 days 00:06:07,10,19,9
311,OLY,P008811,P011983,0 days 00:05:49,-5,13,18
311,OLY,P008855,P011194,0 days 00:05:34,7,12,5
311,OLY,P003941,P007853,0 days 00:05:06,-3,10,13
311,OLY,P003941,P008829,0 days 00:05:06,-3,10,13
311,OLY,P003941,P010612,0 days 00:05:00,-1,10,11
311,OLY,P006589,P011983,0 days 00:04:29,-3,9,12
311,OLY,P007853,P012878,0 days 00:04:29,-7,1,8
311,OLY,P008855,P010392,0 days 00:04:11,6,10,4
311,OLY,P008855,P012878,0 days 00:04:11,6,10,4
311,OLY,P010612,P011983,0 days 00:04:10,-4,10,14
311,OLY,P007982,P008855,0 days 00:03:49,-6,7,13
311,OLY,P008855,P011983,0 days 00:03:43,-4,7,11
311,OLY,P003941,P007982,0 days 00:03:28,-1,9,10
311,OLY,P011194,P011983,0 days 00:03:24,-5,8,13
311,OLY,P008811,P011194,0 days 00:02:43,-1,6,7
311,OLY,P007982,P010392,0 days 00:02:31,1,9,8
311,OLY,P011983,P012878,0 days 00:02:04,-3,4,7
311,OLY,P003941,P008855,0 days 00:01:44,-4,1,5
311,OLY,P007853,P010392,0 days 00:00:35,-3,0,3
311,OLY,P008829,P010392,0 days 00:00:29,-3,0,3
311,OLY,P008829,P011194,0 days 00:00:15,2,2,0
311,OLY,P008811,P010392,0 days 00:00:06,0,0,0
312,MCO,P005985,P011231,0 days 00:31:14,2,61,59
312,MCO,P005985,P010588,0 days 00:30:56,-6,62,68
312,MCO,P005985,P011212,0 days 00:26:50,-9,50,59
312,MCO,P005985,P009754,0 days 00:23:37,-7,49,56
312,MCO,P011212,P011231,0 days 00:23:21,4,47,43
312,MCO,P005985,P011226,0 days 00:23:06,-10,43,53
312,MCO,P010588,P011231,0 days 00:22:15,4,47,43
312,MCO,P005985,PLCZ,0 days 00:21:05,4,46,42
312,MCO,P011212,P011226,0 days 00:20:57,-6,37,43
312,MCO,P010588,P011226,0 days 00:20:10,-6,39,45
312,MCO,P009754,P011231,0 days 00:19:56,-2,42,44
312,MCO,P009754,P010588,0 days 00:18:37,-7,41,48
312,MCO,P011226,P011231,0 days 00:18:28,0,33,33
312,MCO,P010588,P011212,0 days 00:18:17,-6,37,43
312,MCO,P011231,PLCZ,0 days 00:18:05,6,40,34
312,MCO,P009754,PLCZ,0 days 00:15:06,6,34,28
312,MCO,P010588,PLCZ,0 days 00:13:16,7,35,28
312,MCO,P011212,PLCZ,0 days 00:12:53,4,32,28
312,MCO,P009754,P011212,0 days 00:10:58,-7,24,31
312,MCO,P009754,P011226,0 days 00:10:12,-7,22,29
312,MCO,P011196,P011226,0 days 00:07:44,-1,13,14
312,MCO,P011196,P011212,0 days 00:07:01,1,13,12
312,MCO,P011226,PLCZ,0 days 00:06:16,-3,13,16
312,MCO,P011196,P011231,0 days 00:04:59,1,10,9
312,MCO,P008099,P011196,0 days 00:04:15,1,8,7
312,MCO,P008099,P011226,0 days 00:04:15,1,8,7
312,MCO,P008099,P011231,0 days 00:04:15,1,8,7
312,MCO,P008099,P011212,0 days 00:03:32,3,8,5
312,MCO,P005985,P011196,0 days 00:03:29,-2,5,7
312,MCO,P010588,P011196,0 days 00:02:45,-2,3,5
312,MCO,P008099,P009754,0 days 00:00:43,-2,0,2
312,MCO,P009754,P011196,0 days 00:00:43,-2,0,2
312,MCO,P004790,P005985,0 days 00:00:11,0,0,0
312,MCO,P004790,P011212,0 days 00:00:11,0,0,0
312,MCO,P004790,P011231,0 days 00:00:11,0,0,0
312,MCO,P004790,PLCZ,0 days 00:00:11,0,0,0
312,ULK,P001932,P008962,0 days 00:30:53,1,63,62
312,ULK,P008962,P009849,0 days 00:28:38,3,62,59
312,ULK,P008962,P011980,0 days 00:28:07,18,66,48
312,ULK,P001932,P009849,0 days 00:27:06,5,60,55
312,ULK,P009849,P011980,0 days 00:26:22,15,67,52
312,ULK,P001932,P011980,0 days 00:25:08,16,58,42
312,ULK,P004004,P008962,0 days 00:24:20,21,55,34
312,ULK,P004004,P011980,0 days 00:22:09,22,54,32
312,ULK,P001932,P004004,0 days 00:19:12,16,43,27
312,ULK,P004004,P009849,0 days 00:17:33,19,46,27
312,ULK,P006961,P008962,0 days 00:11:26,-8,22,30
312,ULK,P001932,P006961,0 days 00:10:47,-12,19,31
312,ULK,P006961,P009849,0 days 00:09:59,-5,21,26
312,ULK,P006661,P008962,0 days 00:08:58,-3,15,18
312,ULK,P006661,P010560,0 days 00:08:35,0,16,16
312,ULK,P005844,P006661,0 days 00:08:32,-3,16,19
312,ULK,P004004,P006661,0 days 00:08:24,1,14,13
312,ULK,P006961,P011980,0 days 00:07:43,5,23,18
312,ULK,P008962,P010560,0 days 00:07:09,-2,13,15
312,ULK,P002968,P006961,0 days 00:06:53,-6,13,19
312,ULK,P004004,P005844,0 days 00:06:29,1,12,11
312,ULK,P004004,P010560,0 days 00:06:26,1,12,11
312,ULK,P005844,P010560,0 days 00:06:26,1,12,11
312,ULK,P002968,P009849,0 days 00:06:11,-3,13,16
312,ULK,P005844,P008962,0 days 00:05:26,-5,9,14
312,ULK,P001932,P002968,0 days 00:05:08,-6,7,13
312,ULK,P010560,P011980,0 days 00:04:24,-4,8,12
312,ULK,P009849,P010560,0 days 00:04:24,-4,8,12
312,ULK,P011052,P011980,0 days 00:04:21,-1,9,10
312,ULK,P004004,P006068,0 days 00:04:16,-3,7,10
312,ULK,P006068,P006661,0 days 00:04:16,-3,7,10
312,ULK,P004004,P011052,0 days 00:04:12,0,7,7
312,ULK,P001932,P006661,0 days 00:04:04,-4,6,10
312,ULK,P002968,P008962,0 days 00:03:50,-6,4,10
312,ULK,P006068,P010560,0 days 00:03:41,-1,7,8
312,ULK,P005844,P006068,0 days 00:03:41,-1,7,8
312,ULK,P006661,P011980,0 days 00:03:32,1,6,5
312,ULK,P008962,P011052,0 days 00:03:30,3,7,4
312,ULK,P004004,P006961,0 days 00:03:18,5,10,5
312,ULK,P002968,P011980,0 days 00:03:03,0,9,9
312,ULK,P006961,P011052,0 days 00:03:03,0,8,8
312,ULK,P001932,P005844,0 days 00:02:44,-7,4,11
312,ULK,P005844,P006961,0 days 00:02:41,-7,4,11
312,ULK,P001932,P010560,0 days 00:02:15,-3,4,7
312,ULK,P006661,P009849,0 days 00:02:09,-1,4,5
312,ULK,P006661,P006961,0 days 00:02:06,-4,4,8
312,ULK,P002968,P004004,0 days 00:01:21,1,4,3
312,ULK,P009849,P011052,0 days 00:01:08,-2,3,5
312,ULK,P002968,P011052,0 days 00:01:06,-4,2,6
312,ULK,P001932,P011052,0 days 00:01:04,0,0,0
312,ULK,P005844,P009849,0 days 00:00:38,-3,0,3
312,ULK,P001932,P006068,0 days 00:00:35,-2,0,2
312,ULK,P006068,P008962,0 days 00:00:35,-2,0,2
312,ULK,P005844,P011980,0 days 00:00:03,0,0,0
313,PAN,P001926,P003842,0 days 00:27:41,-16,54,70
313,PAN,P003842,P011204,0 days 00:22:43,6,50,44
313,PAN,P001926,P002328,0 days 00:21:47,-5,47,52
313,PAN,P001926,P007866,0 days 00:21:00,-13,46,59
313,PAN,P002328,P003842,0 days 00:20:52,1,46,45
313,PAN,P011204,P012712,0 days 00:18:36,14,41,27
313,PAN,P003842,P012712,0 days 00:17:36,6,38,32
313,PAN,P001926,P011204,0 days 00:17:32,-1,33,34
313,PAN,P003842,P012774,0 days 00:17:16,-7,37,44
313,PAN,P001926,P012774,0 days 00:17:03,-14,35,49
313,PAN,P003842,P007866,0 days 00:16:23,-13,35,48
313,PAN,P002328,P007866,0 days 00:16:12,-5,38,43
313,PAN,P001926,P012712,0 days 00:12:57,-3,21,24
313,PAN,P002328,P011204,0 days 00:12:55,7,29,22
313,PAN,P007866,P012774,0 days 00:12:18,-13,25,38
313,PAN,P002328,P012774,0 days 00:10:32,-3,25,28
313,PAN,P012712,P012774,0 days 00:09:05,2,21,19
313,PAN,P002328,P012712,0 days 00:08:47,2,17,15
313,PAN,P003842,P007947,0 days 00:08:34,3,24,21
313,PAN,P007947,P012712,0 days 00:08:34,8,22,14
313,PAN,P011204,P012774,0 days 00:08:21,0,19,19
313,PAN,P007866,P011204,0 days 00:07:45,-1,16,17
313,PAN,P007947,P011204,0 days 00:07:42,12,22,10
313,PAN,P007947,P012774,0 days 00:03:48,5,11,6
313,PAN,P002328,P007947,0 days 00:03:45,-1,9,10
313,PAN,P007866,P011209,0 days 00:03:14,-7,6,13
313,PAN,P003842,P011209,0 days 00:03:14,-7,6,13
313,PAN,P001926,P011209,0 days 00:03:14,-7,6,13
313,PAN,P001926,P011221,0 days 00:02:58,0,9,9
313,PAN,P011221,P012774,0 days 00:02:58,0,9,9
313,PAN,P007866,P011221,0 days 00:02:58,0,9,9
313,PAN,P002328,P011221,0 days 00:02:58,0,9,9
313,PAN,P001926,P005161,0 days 00:02:44,1,4,3
313,PAN,P005161,P011204,0 days 00:02:44,1,4,3
313,PAN,P005161,P012712,0 days 00:02:44,1,4,3
313,PAN,P007947,P011209,0 days 00:02:30,2,7,5
313,PAN,P001926,P007947,0 days 00:02:16,-6,5,11
313,PAN,P011209,P012774,0 days 00:02:03,-6,2,8
313,PAN,P007866,P012712,0 days 00:01:39,0,2,2
313,PAN,P003842,P005161,0 days 00:01:37,-1,2,3
313,PAN,P007866,P007947,0 days 00:01:24,-2,5,7
313,PAN,P011204,P011209,0 days 00:01:19,3,3,0
313,PAN,P011204,P011221,0 days 00:01:19,3,3,0
313,PAN,P011209,P011221,0 days 00:01:19,3,3,0
313,PAN,P011209,P012712,0 days 00:01:19,3,3,0
313,PAN,P011221,P012712,0 days 00:01:19,3,3,0
313,PAN,P007947,P011221,0 days 00:01:19,3,3,0
313,PAN,P005161,P007866,0 days 00:01:07,2,2,0
313,TEL,P009622,P009783,0 days 00:27:48,-5,57,62
313,TEL,P009783,P009863,0 days 00:23:29,-8,49,57
313,TEL,P009622,P011199,0 days 00:22:56,-9,48,57
313,TEL,P009783,P011199,0 days 00:22:35,-8,48,56
313,TEL,P009622,P009863,0 days 00:19:52,-11,39,50
313,TEL,P009863,P011199,0 days 00:18:25,-8,38,46
313,TEL,P011193,P012744,0 days 00:16:39,16,48,32
313,TEL,P009622,P011193,0 days 00:15:41,1,33,32
313,TEL,P011193,P011214,0 days 00:15:04,15,42,27
313,TEL,P009783,P011193,0 days 00:13:14,2,28,26
313,TEL,P005145,P011199,0 days 00:12:44,-1,30,31
313,TEL,P005145,P009783,0 days 00:12:44,-1,30,31
313,TEL,P005145,P009622,0 days 00:12:44,-1,30,31
313,TEL,P011214,P012744,0 days 00:12:05,15,40,25
313,TEL,P005145,P009863,0 days 00:11:42,2,28,26
313,TEL,P009622,P012744,0 days 00:11:40,10,30,20
313,TEL,P009622,P011214,0 days 00:10:55,6,25,19
313,TEL,P011193,P011971,0 days 00:10:23,7,24,17
313,TEL,P011214,P011971,0 days 00:10:01,3,22,19
313,TEL,P009783,P012744,0 days 00:08:44,11,25,14
313,TEL,P011971,P012744,0 days 00:08:17,7,24,17
313,TEL,P009622,P011971,0 days 00:07:55,1,15,14
313,TEL,P009863,P011193,0 days 00:07:47,0,19,19
313,TEL,P009783,P011214,0 days 00:07:21,9,20,11
313,TEL,P009863,P012744,0 days 00:06:11,8,20,12
313,TEL,P011193,P011199,0 days 00:05:42,-6,10,16
313,TEL,P009863,P011214,0 days 00:05:14,3,17,14
313,TEL,P009863,P011219,0 days 00:04:24,3,10,7
313,TEL,P009783,P011219,0 days 00:03:52,1,8,7
313,TEL,P009863,P011971,0 days 00:03:24,2,9,7
313,TEL,P011199,P012744,0 days 00:03:19,0,6,6
313,TEL,P007990,P011199,0 days 00:03:17,-7,3,10
313,TEL,P007990,P009863,0 days 00:03:12,-7,3,10
313,TEL,P007990,P009783,0 days 00:03:12,-7,3,10
313,TEL,P007990,P009622,0 days 00:03:12,-7,3,10
313,TEL,P009622,P011219,0 days 00:02:45,3,8,5
313,TEL,P009783,P011971,0 days 00:02:41,-2,0,2
313,TEL,P011219,P012744,0 days 00:02:16,1,3,2
313,TEL,P011199,P011219,0 days 00:02:08,2,7,5
313,TEL,P011193,P011219,0 days 00:01:39,0,2,2
313,TEL,P005145,P011193,0 days 00:01:02,-3,2,5
313,TEL,P011199,P011214,0 days 00:00:36,1,2,1
313,TEL,P011219,P011971,0 days 00:00:32,2,2,0
313,TEL,P011199,P011971,0 days 00:00:22,0,0,0
313,TEL,P007990,P011193,0 days 00:00:05,0,0,0
313,TEL,P007990,P011971,0 days 00:00:05,0,0,0
313,TEL,P007990,P012744,0 days 00:00:05,0,0,0
314,MAD,P003108,P005928,0 days 00:21:24,9,53,44
314,MAD,P005791,P010357,0 days 00:21:05,12,57,45
314,MAD,P005928,P010357,0 days 00:20:43,7,51,44
314,MAD,P005791,P005928,0 days 00:18:08,4,46,42
314,MAD,P003108,P010357,0 days 00:18:03,9,47,38
314,MAD,P003108,P006540,0 days 00:16:45,-1,37,38
314,MAD,P005928,P006540,0 days 00:16:45,-1,37,38
314,MAD,P003108,P005791,0 days 00:16:11,6,42,36
314,MAD,P009005,PCVM,0 days 00:14:30,2,38,36
314,MAD,P004887,PCVM,0 days 00:13:42,-4,33,37
314,MAD,P004887,PBMT,0 days 00:13:32,-13,28,41
314,MAD,P005791,P006540,0 days 00:12:41,-2,28,30
314,MAD,P006540,P010357,0 days 00:12:41,-2,28,30
314,MAD,P009005,PTGB,0 days 00:11:44,16,35,19
314,MAD,P004887,P009005,0 days 00:11:33,-6,27,33
314,MAD,P003108,P004887,0 days 00:11:07,4,25,21
314,MAD,PCVM,PTGB,0 days 00:10:30,19,34,15
314,MAD,P010357,PTGB,0 days 00:10:29,19,36,17
314,MAD,PBMT,PCVM,0 days 00:09:29,-14,19,33
314,MAD,P004887,P005928,0 days 00:08:46,-2,19,21
314,MAD,P004887,PTGB,0 days 00:08:42,13,25,12
314,MAD,P003108,PTGB,0 days 00:08:40,18,28,10
314,MAD,P005791,PTGB,0 days 00:08:24,14,29,15
314,MAD,P009005,PBMT,0 days 00:08:03,-15,16,31
314,MAD,P005928,PBMT,0 days 00:07:38,-4,17,21
314,MAD,P005928,PTGB,0 days 00:06:37,8,20,12
314,MAD,P003108,PBMT,0 days 00:05:59,-6,11,17
314,MAD,P003108,PCVM,0 days 00:05:55,1,14,13
314,MAD,P010357,PCVM,0 days 00:05:19,12,19,7
314,MAD,P003108,P009005,0 days 00:05:12,0,11,11
314,MAD,P009005,P010357,0 days 00:05:07,8,17,9
314,MAD,P005791,P009005,0 days 00:04:54,6,15,9
314,MAD,P006540,PBMT,0 days 00:04:44,-2,9,11
314,MAD,P004887,P006540,0 days 00:04:43,-2,9,11
314,MAD,P005928,P009005,0 days 00:04:05,-8,9,17
314,MAD,P005928,PCVM,0 days 00:03:34,-5,8,13
314,MAD,P004887,P010357,0 days 00:03:31,6,10,4
314,MAD,PBMT,PTGB,0 days 00:03:21,1,9,8
314,MAD,P005791,PCVM,0 days 00:02:57,8,11,3
314,MAD,P010357,PBMT,0 days 00:01:26,1,3,2
314,MAD,P006540,P009005,0 days 00:00:40,-3,0,3
314,MAD,P006540,PCVM,0 days 00:00:40,-3,0,3
314,MAD,P006540,PTGB,0 days 00:00:01,0,0,0
314,BAS,P004761,P009048,0 days 00:27:11,3,69,66
314,BAS,P007230,P009048,0 days 00:25:42,-18,51,69
314,BAS,P004761,P007230,0 days 00:25:39,-3,58,61
314,BAS,P009048,P010444,0 days 00:21:22,2,54,52
314,BAS,P004761,P010444,0 days 00:18:20,6,49,43
314,BAS,P004603,P007230,0 days 00:16:54,-10,34,44
314,BAS,P007230,P011948,0 days 00:14:28,-15,28,43
314,BAS,P004603,P004761,0 days 00:14:22,-1,33,34
314,BAS,P007230,P010444,0 days 00:14:19,-6,30,36
314,BAS,P009048,P011085,0 days 00:13:35,9,37,28
314,BAS,P004603,P009048,0 days 00:13:07,-15,23,38
314,BAS,P010444,P011085,0 days 00:12:40,12,37,25
314,BAS,P004761,P011085,0 days 00:12:40,12,37,25
314,BAS,P004603,P011948,0 days 00:11:41,-11,22,33
314,BAS,P008850,P009048,0 days 00:11:20,-14,21,35
314,BAS,P009048,P011948,0 days 00:10:54,-22,17,39
314,BAS,P003198,P009048,0 days 00:10:42,6,30,24
314,BAS,P007230,P008850,0 days 00:09:36,-11,19,30
314,BAS,P004761,P011948,0 days 00:09:07,-4,22,26
314,BAS,P003198,P004761,0 days 00:08:58,9,28,19
314,BAS,P003198,P010444,0 days 00:08:58,9,28,19
314,BAS,P007230,P012765,0 days 00:08:06,4,19,15
314,BAS,P004761,P012765,0 days 00:08:06,4,19,15
314,BAS,P004603,P012765,0 days 00:08:06,4,19,15
314,BAS,P003198,P011085,0 days 00:06:50,10,24,14
314,BAS,P007230,P011085,0 days 00:06:45,-1,13,14
314,BAS,P008850,P011948,0 days 00:06:23,-13,8,21
314,BAS,P004603,P008850,0 days 00:06:15,-8,11,19
314,BAS,P008850,P010444,0 days 00:05:05,-6,10,16
314,BAS,P004761,P008850,0 days 00:04:57,-1,13,14
314,BAS,P010444,P011948,0 days 00:04:44,-9,8,17
314,BAS,P009048,P012765,0 days 00:04:03,-3,6,9
314,BAS,P011948,P012765,0 days 00:04:03,7,13,6
314,BAS,P003198,P011948,0 days 00:01:57,-5,2,7
314,BAS,P003198,P007230,0 days 00:01:55,1,4,3
314,BAS,P003198,P004603,0 days 00:01:44,-3,2,5
314,BAS,P003198,P008850,0 days 00:01:44,-3,2,5
314,BAS,P004603,P007946,0 days 00:01:28,-5,0,5
314,BAS,P004761,P007946,0 days 00:01:28,-5,0,5
314,BAS,P007230,P007946,0 days 00:01:28,-5,0,5
314,BAS,P007946,P011948,0 days 00:01:28,-5,0,5
314,BAS,P004603,P011085,0 days 00:00:55,-3,0,3
314,BAS,P011085,P011948,0 days 00:00:55,-3,0,3
315,BAR,P004866,P012745,0 days 00:21:14,3,44,41
315,BAR,P000925,P012745,0 days 00:20:57,-1,37,38
315,BAR,P002939,P012745,0 days 00:19:31,12,41,29
315,BAR,P000925,P004866,0 days 00:18:11,2,34,32
315,BAR,P004866,P006435,0 days 00:17:28,-3,32,35
315,BAR,P000925,P006435,0 days 00:16:30,2,32,30
315,BAR,P006435,P012745,0 days 00:15:48,-6,29,35
315,BAR,P003196,P007519,0 days 00:15:07,15,33,18
315,BAR,P012745,PLFW,0 days 00:14:44,-1,25,26
315,BAR,P004866,PLFW,0 days 00:14:17,1,27,26
315,BAR,P007519,P012745,0 days 00:14:13,15,35,20
315,BAR,P000925,PLFW,0 days 00:14:01,5,24,19
315,BAR,P003478,P007519,0 days 00:13:41,5,25,20
315,BAR,P002939,P003478,0 days 00:13:24,7,28,21
315,BAR,P002939,P007519,0 days 00:12:34,12,32,20
315,BAR,P003196,P003478,0 days 00:12:25,7,24,17
315,BAR,P002939,P003196,0 days 00:11:33,9,31,22
315,BAR,P006435,PLFW,0 days 00:11:26,-6,21,27
315,BAR,P003196,P012745,0 days 00:11:11,11,28,17
315,BAR,P003478,P012745,0 days 00:10:54,7,21,14
315,BAR,P000925,P002939,0 days 00:10:43,-2,17,19
315,BAR,P002939,P004866,0 days 00:08:37,5,20,15
315,BAR,P002939,P006435,0 days 00:07:35,-6,15,21
315,BAR,P007519,PLFW,0 days 00:06:33,2,8,6
315,BAR,P003196,P011244,0 days 00:06:12,-5,9,14
315,BAR,P003196,PLFW,0 days 00:06:05,-8,6,14
315,BAR,P003478,P011244,0 days 00:05:57,0,9,9
315,BAR,P003478,PLFW,0 days 00:05:34,1,3,2
315,BAR,P004866,P007519,0 days 00:05:26,9,15,6
315,BAR,P011244,PLFW,0 days 00:05:22,-2,5,7
315,BAR,P007519,P011244,0 days 00:04:54,-1,5,6
315,BAR,P003196,P004866,0 days 00:04:43,4,13,9
315,BAR,P000925,P003478,0 days 00:04:26,0,6,6
315,BAR,P000925,P007519,0 days 00:04:00,-1,7,8
315,BAR,P006435,P011244,0 days 00:02:58,-1,7,8
315,BAR,P002939,P011244,0 days 00:02:45,-5,7,12
315,BAR,P002939,PLFW,0 days 00:02:22,-4,1,5
315,BAR,P003196,P006435,0 days 00:02:16,-9,4,13
315,BAR,P000925,P011244,0 days 00:01:40,3,3,0
315,BAR,P004866,P011244,0 days 00:01:40,3,3,0
315,BAR,P003478,P006435,0 days 00:01:03,1,4,3
315,OLY,P008829,P008855,0 days 00:26:41,-6,44,50
315,OLY,P008811,P008829,0 days 00:20:33,-10,33,43
315,OLY,P008811,P008855,0 days 00:19:25,-3,33,36
315,OLY,P006589,P008829,0 days 00:16:22,-2,32,34
315,OLY,P007853,P011194,0 days 00:15:05,5,29,24
315,OLY,P006589,P008811,0 days 00:14:40,-9,25,34
315,OLY,P006589,P008855,0 days 00:14:30,3,30,27
315,OLY,P008855,P010612,0 days 00:14:29,-3,26,29
315,OLY,P008829,P010612,0 days 00:14:05,-15,21,36
315,OLY,P008855,P011194,0 days 00:13:58,-7,19,26
315,OLY,P007982,P008829,0 days 00:13:35,-7,21,28
315,OLY,P006589,P010612,0 days 00:13:12,-11,21,32
315,OLY,P008811,P010612,0 days 00:12:28,-13,19,32
315,OLY,P007853,P008855,0 days 00:11:48,-8,15,23
315,OLY,P007982,P011194,0 days 00:10:57,6,22,16
315,OLY,P007853,P012878,0 days 00:10:53,3,23,20
315,OLY,P007982,P008855,0 days 00:10:50,2,19,17
315,OLY,P011194,P012878,0 days 00:10:00,7,23,16
315,OLY,P007853,P007982,0 days 00:09:40,1,18,17
315,OLY,P008829,P011194,0 days 00:09:26,-5,12,17
315,OLY,P007982,P008811,0 days 00:08:15,-6,12,18
315,OLY,P007853,P008829,0 days 00:08:09,-10,8,18
315,OLY,P003941,P008829,0 days 00:07:16,-3,11,14
315,OLY,P003941,P008855,0 days 00:07:16,-3,11,14
315,OLY,P007982,P012878,0 days 00:07:05,7,18,11
315,OLY,P003941,P007853,0 days 00:06:52,-8,6,14
315,OLY,P010392,P012878,0 days 00:06:51,4,16,12
315,OLY,P010392,P011194,0 days 00:06:51,4,16,12
315,OLY,P007853,P010392,0 days 00:06:51,4,16,12
315,OLY,P008811,P011194,0 days 00:05:53,-1,8,9
315,OLY,P007982,P010392,0 days 00:05:28,9,16,7
315,OLY,P006589,P007982,0 days 00:05:02,4,13,9
315,OLY,P010612,P012878,0 days 00:04:46,1,9,8
315,OLY,P007853,P010612,0 days 00:04:36,-1,7,8
315,OLY,P008855,P012878,0 days 00:04:32,-2,7,9
315,OLY,P003941,P007982,0 days 00:04:17,1,7,6
315,OLY,P003941,P011194,0 days 00:04:07,-4,4,8
315,OLY,P010612,P011194,0 days 00:03:43,3,7,4
315,OLY,P007982,P010612,0 days 00:03:19,-9,2,11
315,OLY,P008829,P012878,0 days 00:01:37,-2,2,4
315,OLY,P008855,P010392,0 days 00:01:23,-5,0,5
315,OLY,P003941,P006589,0 days 00:00:58,5,5,0
315,OLY,P007853,P008811,0 days 00:00:58,2,2,0
315,OLY,P006589,P012878,0 days 00:00:44,2,2,0
315,OLY,P003941,P010612,0 days 00:00:34,0,0,0
316,MCO,P009754,P011212,0 days 00:22:52,16,52,36
316,MCO,P011212,P011226,0 days 00:18:40,-11,34,45
316,MCO,P005985,P010588,0 days 00:18:15,-5,43,48
316,MCO,P005985,P011231,0 days 00:17:15,8,43,35
316,MCO,P011212,P011231,0 days 00:17:02,-4,28,32
316,MCO,P005985,P011212,0 days 00:16:44,15,46,31
316,MCO,P005985,PLCZ,0 days 00:16:39,-2,40,42
316,MCO,P009754,P011231,0 days 00:16:02,1,26,25
316,MCO,P010588,PLCZ,0 days 00:15:53,7,42,35
316,MCO,P009754,P011226,0 days 00:13:30,1,29,28
316,MCO,P005985,P009754,0 days 00:12:42,21,38,17
316,MCO,P002581,P009754,0 days 00:12:40,4,22,18
316,MCO,P002581,P011212,0 days 00:12:40,4,22,18
316,MCO,P011231,PLCZ,0 days 00:12:19,-3,31,34
316,MCO,P010588,P011212,0 days 00:11:48,3,28,25
316,MCO,P008099,P010588,0 days 00:11:41,-3,31,34
316,MCO,P002581,P011231,0 days 00:11:34,3,17,14
316,MCO,P005985,P008099,0 days 00:11:24,-7,26,33
316,MCO,P010588,P011231,0 days 00:11:09,-6,24,30
316,MCO,P010588,P011226,0 days 00:10:40,-2,26,28
316,MCO,P011212,PLCZ,0 days 00:10:27,5,27,22
316,MCO,P011226,P011231,0 days 00:09:47,-18,9,27
316,MCO,P008099,PLCZ,0 days 00:09:17,3,27,24
316,MCO,P009754,P010588,0 days 00:09:03,8,27,19
316,MCO,P008099,P011231,0 days 00:09:00,-1,22,23
316,MCO,P011226,PLCZ,0 days 00:08:25,6,25,19
316,MCO,P005985,P011226,0 days 00:08:04,-8,20,28
316,MCO,P002581,P011226,0 days 00:07:44,-7,10,17
316,MCO,P002581,P005985,0 days 00:06:02,12,17,5
316,MCO,P009754,PLCZ,0 days 00:05:56,16,24,8
316,MCO,P005985,P011196,0 days 00:05:27,-2,15,17
316,MCO,P010588,P011196,0 days 00:05:27,-2,15,17
316,MCO,P009754,P011196,0 days 00:03:49,3,11,8
316,MCO,P011196,P011212,0 days 00:03:03,4,11,7
316,MCO,P008099,P011196,0 days 00:02:24,-6,4,10
316,MCO,P008099,P009754,0 days 00:01:42,2,7,5
316,MCO,P011196,P011226,0 days 00:01:38,-5,4,9
316,MCO,P008099,P011226,0 days 00:01:16,0,7,7
316,ULK,P008962,P009849,0 days 00:24:08,-12,53,65
316,ULK,P001932,P009849,0 days 00:19:45,-10,43,53
316,ULK,P006661,P008962,0 days 00:19:03,-4,45,49
316,ULK,P001932,P008962,0 days 00:17:07,-4,38,42
316,ULK,P005844,P009849,0 days 00:17:06,-4,44,48
316,ULK,P004004,P011980,0 days 00:16:02,5,35,30
316,ULK,P006661,P011980,0 days 00:15:31,3,31,28
316,ULK,P001932,P005844,0 days 00:14:12,5,37,32
316,ULK,P005844,P006661,0 days 00:14:09,-4,32,36
316,ULK,P005844,P008962,0 days 00:14:09,0,37,37
316,ULK,P006661,P009849,0 days 00:14:02,-11,31,42
316,ULK,P004004,P006661,0 days 00:13:11,11,32,21
316,ULK,P001932,P011980,0 days 00:12:36,-8,24,32
316,ULK,P004004,P005844,0 days 00:12:29,-4,21,25
316,ULK,P005844,P011980,0 days 00:10:51,0,21,21
316,ULK,P001932,P004004,0 days 00:10:38,0,25,25
316,ULK,P005844,P010560,0 days 00:10:32,-4,17,21
316,ULK,P006961,P009849,0 days 00:10:18,5,28,23
316,ULK,P006961,P008962,0 days 00:10:18,5,28,23
316,ULK,P006661,P010560,0 days 00:10:05,-5,17,22
316,ULK,P008962,P010560,0 days 00:10:02,-1,23,24
316,ULK,P008962,P011980,0 days 00:09:43,-2,19,21
316,ULK,P001932,P006661,0 days 00:09:43,-1,24,25
316,ULK,P010560,P011980,0 days 00:09:42,7,18,11
316,ULK,P004004,P010560,0 days 00:09:42,7,18,11
316,ULK,P004004,P008962,0 days 00:08:20,4,20,16
316,ULK,P009849,P011980,0 days 00:07:51,-13,12,25
316,ULK,P005844,P006961,0 days 00:06:32,11,23,12
316,ULK,P004004,P009849,0 days 00:06:22,-7,13,20
316,ULK,P001932,P006961,0 days 00:05:34,-2,12,14
316,ULK,P009849,P010560,0 days 00:05:26,-6,11,17
316,ULK,P001932,P010560,0 days 00:05:03,6,12,6
316,ULK,P006661,P006961,0 days 00:04:44,7,16,9
316,ULK,P001932,P002968,0 days 00:03:46,-6,5,11
316,ULK,P002968,P006961,0 days 00:03:46,-6,5,11
316,ULK,P002968,P008962,0 days 00:03:46,-6,5,11
316,ULK,P002968,P009849,0 days 00:03:46,-6,5,11
317,PAN,P003842,P007866,0 days 00:30:02,19,74,55
317,PAN,P007866,P012774,0 days 00:25:34,8,62,54
317,PAN,P001926,P005161,0 days 00:24:27,29,69,40
317,PAN,P001926,P007866,0 days 00:24:16,21,60,39
317,PAN,P001926,P003842,0 days 00:23:58,25,60,35
317,PAN,P005161,P007866,0 days 00:22:45,19,60,41
317,PAN,P003842,P012774,0 days 00:21:03,15,55,40
317,PAN,P003842,P005161,0 days 00:20:08,30,60,30
317,PAN,P002328,P003842,0 days 00:16:19,-3,32,35
317,PAN,P001926,P012774,0 days 00:15:17,17,41,24
317,PAN,P005161,P012774,0 days 00:14:36,13,41,28
317,PAN,P002328,P007866,0 days 00:14:34,-9,25,34
317,PAN,P007866,P011204,0 days 00:14:22,5,36,31
317,PAN,P003842,P011204,0 days 00:12:37,8,36,28
317,PAN,P002328,P012774,0 days 00:10:43,-7,21,28
317,PAN,P001926,P002328,0 days 00:10:40,-1,18,19
317,PAN,P011204,P012774,0 days 00:09:34,-1,21,22
317,PAN,P005161,P011221,0 days 00:07:35,-5,14,19
317,PAN,P005161,P011204,0 days 00:07:30,8,20,12
317,PAN,P002328,P011204,0 days 00:06:52,-3,16,19
317,PAN,P001926,P007947,0 days 00:06:21,2,14,12
317,PAN,P002328,P005161,0 days 00:06:17,1,13,12
317,PAN,P005161,P007947,0 days 00:06:10,-4,14,18
317,PAN,P001926,P011221,0 days 00:05:25,0,14,14
317,PAN,P001926,P011204,0 days 00:05:08,6,15,9
317,PAN,P011221,P012774,0 days 00:04:42,-5,7,12
317,PAN,P007866,P011221,0 days 00:04:22,-5,7,12
317,PAN,P002328,P007947,0 days 00:04:06,-1,9,10
317,PAN,P007947,P011221,0 days 00:03:38,-2,7,9
317,PAN,P003842,P007947,0 days 00:03:37,-2,7,9
317,PAN,P011209,P011221,0 days 00:02:20,1,5,4
317,PAN,P007866,P007947,0 days 00:02:17,-10,0,10
317,PAN,P011204,P011221,0 days 00:02:05,-3,0,3
317,PAN,P007947,P011209,0 days 00:02:00,1,5,4
317,PAN,P005161,P011209,0 days 00:02:00,1,5,4
317,PAN,P001926,P011209,0 days 00:02:00,1,5,4
317,PAN,P007947,P012774,0 days 00:01:27,-8,0,8
317,PAN,P002328,P011221,0 days 00:01:13,-1,2,3
317,PAN,P008084,P011204,0 days 00:00:20,0,0,0
317,PAN,P008084,P011209,0 days 00:00:20,0,0,0
317,PAN,P008084,P011221,0 days 00:00:20,0,0,0
317,PAN,P008084,P012774,0 days 00:00:20,0,0,0
317,PAN,P011204,P011209,0 days 00:00:20,0,0,0
317,PAN,P011209,P012774,0 days 00:00:20,0,0,0
317,TEL,P009622,P009783,0 days 00:27:53,-19,51,70
317,TEL,P009783,P011193,0 days 00:20:14,-6,44,50
317,TEL,P009622,P011199,0 days 00:19:19,-15,35,50
317,TEL,P009783,P011199,0 days 00:18:46,-14,35,49
317,TEL,P011193,P011214,0 days 00:17:10,5,41,36
317,TEL,P011214,P012744,0 days 00:16:17,10,39,29
317,TEL,P007990,P009783,0 days 00:16:05,-7,28,35
317,TEL,P011193,P011971,0 days 00:15:57,-4,36,40
317,TEL,P009783,P011214,0 days 00:15:51,6,36,30
317,TEL,P007990,P009622,0 days 00:15:37,-7,27,34
317,TEL,P011193,P012744,0 days 00:15:32,8,40,32
317,TEL,P009783,P012744,0 days 00:13:53,11,35,24
317,TEL,P009622,P011193,0 days 00:13:40,-15,24,39
317,TEL,P009783,P011971,0 days 00:13:33,-4,30,34
317,TEL,P007990,P011199,0 days 00:12:51,-7,24,31
317,TEL,P011971,P012744,0 days 00:11:20,0,27,27
317,TEL,P005145,P009622,0 days 00:11:08,-5,22,27
317,TEL,P011214,P011971,0 days 00:11:04,11,31,20
317,TEL,P005145,P007990,0 days 00:10:48,-3,22,25
317,TEL,P005145,P011199,0 days 00:10:48,-3,22,25
317,TEL,P005145,P009783,0 days 00:10:48,-3,22,25
317,TEL,P009622,P011214,0 days 00:08:57,-1,16,17
317,TEL,P009622,P012744,0 days 00:08:53,0,16,16
317,TEL,P009622,P011971,0 days 00:08:10,-15,11,26
317,TEL,P011193,P011219,0 days 00:07:34,-13,11,24
317,TEL,P011193,P011199,0 days 00:06:28,-8,11,19
317,TEL,P011214,P011219,0 days 00:06:02,-10,9,19
317,TEL,P011199,P011971,0 days 00:05:51,-13,7,20
317,TEL,P011219,P012744,0 days 00:03:57,-1,8,9
317,TEL,P007990,P011214,0 days 00:03:39,-1,4,5
317,TEL,P009783,P011219,0 days 00:03:37,-12,3,15
317,TEL,P011219,P011971,0 days 00:03:34,-1,8,9
317,TEL,P007990,P012744,0 days 00:03:11,-1,3,4
317,TEL,P009622,P011219,0 days 00:02:59,-11,2,13
317,TEL,P007990,P011971,0 days 00:02:11,-4,2,6
317,TEL,P011199,P011219,0 days 00:01:32,-3,2,5
317,TEL,P011199,P012744,0 days 00:01:29,3,4,1
317,TEL,P007990,P011193,0 days 00:01:09,-1,1,2
317,TEL,P007990,P011219,0 days 00:01:01,-1,1,2
317,TEL,P005145,P011193,0 days 00:00:20,-2,0,2
317,TEL,P005145,P011971,0 days 00:00:20,-2,0,2
317,TEL,P005145,P012744,0 days 00:00:20,-2,0,2
317,TEL,P011199,P011214,0 days 00:00:12,0,0,0
318,BAS,P009048,P011085,0 days 00:27:54,4,65,61
318,BAS,P010444,P011085,0 days 00:24:36,1,58,57
318,BAS,P009048,P010444,0 days 00:23:36,-2,55,57
318,BAS,P004761,P009048,0 days 00:22:37,1,59,58
318,BAS,P009048,P011948,0 days 00:20:28,-4,49,53
318,BAS,P004761,P011085,0 days 00:19:25,13,54,41
318,BAS,P004761,P010444,0 days 00:19:11,1,51,50
318,BAS,P003198,P009048,0 days 00:16:59,7,44,37
318,BAS,P007230,P009048,0 days 00:16:10,-9,32,41
318,BAS,P010444,P011948,0 days 00:15:10,-8,36,44
318,BAS,P007230,P010444,0 days 00:14:05,-16,27,43
318,BAS,P007230,P011085,0 days 00:13:35,-5,27,32
318,BAS,P011085,P011948,0 days 00:13:22,0,29,29
318,BAS,P004761,P007230,0 days 00:12:52,-11,32,43
318,BAS,P004603,P009048,0 days 00:12:23,3,33,30
318,BAS,P007230,P011948,0 days 00:11:22,-14,19,33
318,BAS,P003198,P011085,0 days 00:11:06,6,26,20
318,BAS,P004761,P011948,0 days 00:10:57,-9,30,39
318,BAS,P003198,P011948,0 days 00:09:46,-3,25,28
318,BAS,P003198,P004761,0 days 00:09:23,3,22,19
318,BAS,P003198,P010444,0 days 00:09:09,5,23,18
318,BAS,P004603,P011948,0 days 00:09:08,-1,23,24
318,BAS,P003198,P004603,0 days 00:07:50,2,21,19
318,BAS,P004603,P004761,0 days 00:07:27,-5,18,23
318,BAS,P004603,P007230,0 days 00:05:07,1,12,11
318,BAS,P004603,P011085,0 days 00:04:28,4,10,6
318,BAS,P004761,P012765,0 days 00:04:01,-5,10,15
318,BAS,P010444,P012765,0 days 00:04:01,-5,10,15
318,BAS,P011948,P012765,0 days 00:03:50,-5,10,15
318,BAS,P008850,P009048,0 days 00:03:49,4,15,11
318,BAS,P003198,P008850,0 days 00:03:09,8,15,7
318,BAS,P008850,P011948,0 days 00:03:09,8,15,7
318,BAS,P004603,P008850,0 days 00:03:09,8,15,7
318,BAS,P007230,P012765,0 days 00:03:02,-6,7,13
318,BAS,P011085,P012765,0 days 00:01:10,1,3,2
318,BAS,P008850,P010444,0 days 00:00:40,-4,0,4
318,BAS,P008850,P011085,0 days 00:00:40,-4,0,4
318,BAS,P004761,P008850,0 days 00:00:39,-4,0,4
318,BAS,P003198,P007230,0 days 00:00:34,0,0,0
318,BAS,P007230,P008850,0 days 00:00:01,0,0,0
318,MAD,P005791,P010357,0 days 00:28:04,11,70,59
318,MAD,P003108,P005791,0 days 00:26:11,1,62,61
318,MAD,P003108,P005928,0 days 00:24:39,-5,55,60
318,MAD,P003108,P010357,0 days 00:24:16,4,58,54
318,MAD,P005791,P005928,0 days 00:21:16,3,46,43
318,MAD,P005928,P010357,0 days 00:21:03,3,45,42
318,MAD,P005928,P009005,0 days 00:14:04,-1,31,32
318,MAD,P003108,P009005,0 days 00:13:14,0,34,34
318,MAD,P009005,P010357,0 days 00:12:51,10,35,25
318,MAD,P003108,PTGB,0 days 00:12:50,-1,36,37
318,MAD,P005791,P009005,0 days 00:12:26,11,33,22
318,MAD,P006540,P010357,0 days 00:12:16,-7,24,31
318,MAD,P005928,P006540,0 days 00:12:16,-7,24,31
318,MAD,P005791,P006540,0 days 00:12:16,-7,24,31
318,MAD,P003108,P006540,0 days 00:12:16,-7,24,31
318,MAD,P009005,PTGB,0 days 00:11:39,-4,28,32
318,MAD,P010357,PCVM,0 days 00:09:57,10,35,25
318,MAD,P005791,PCVM,0 days 00:09:19,11,32,21
318,MAD,P005791,PTGB,0 days 00:09:17,5,25,20
318,MAD,P005928,PTGB,0 days 00:09:00,-4,20,24
318,MAD,P004887,P009005,0 days 00:08:57,-8,24,32
318,MAD,PCVM,PTGB,0 days 00:08:45,8,29,21
318,MAD,P010357,PTGB,0 days 00:08:24,7,23,16
318,MAD,P004887,PTGB,0 days 00:07:39,-5,20,25
318,MAD,P009005,PCVM,0 days 00:07:38,8,28,20
318,MAD,P009005,PBMT,0 days 00:06:51,4,23,19
318,MAD,PBMT,PCVM,0 days 00:06:38,6,23,17
318,MAD,P003108,PCVM,0 days 00:06:10,4,20,16
318,MAD,P004887,P005928,0 days 00:05:21,-7,13,20
318,MAD,P010357,PBMT,0 days 00:04:33,2,16,14
318,MAD,P003108,P004887,0 days 00:04:19,-6,11,17
318,MAD,P004887,PBMT,0 days 00:03:36,-1,11,12
318,MAD,P004887,PCVM,0 days 00:03:36,-1,11,12
318,MAD,P005791,PBMT,0 days 00:03:15,5,12,7
318,MAD,P004887,P010357,0 days 00:02:20,-4,6,10
318,MAD,PBMT,PTGB,0 days 00:02:18,2,7,5
318,MAD,P005928,PCVM,0 days 00:00:17,2,2,0
318,MAD,P003108,PBMT,0 days 00:00:13,-2,0,2
319,OLY,P007853,P011194,0 days 00:26:32,7,53,46
319,OLY,P007982,P011194,0 days 00:25:51,7,50,43
319,OLY,P007853,P007982,0 days 00:25:26,7,50,43
319,OLY,P007982,P012878,0 days 00:22:07,10,49,39
319,OLY,P008855,P011194,0 days 00:20:59,8,43,35
319,OLY,P007982,P008855,0 days 00:20:59,-4,37,41
319,OLY,P008811,P008855,0 days 00:20:55,-10,31,41
319,OLY,P011194,P012878,0 days 00:20:39,14,46,32
319,OLY,P007853,P012878,0 days 00:20:28,14,46,32
319,OLY,P008829,P008855,0 days 00:18:15,-9,27,36
319,OLY,P007853,P008855,0 days 00:17:53,2,34,32
319,OLY,P008811,P010612,0 days 00:16:56,-5,24,29
319,OLY,P008811,P008829,0 days 00:16:49,-5,24,29
319,OLY,P008855,P010612,0 days 00:15:08,-3,24,27
319,OLY,P008855,P012878,0 days 00:15:07,3,30,27
319,OLY,P008829,P010612,0 days 00:14:21,-3,21,24
319,OLY,P007982,P010392,0 days 00:11:05,1,25,24
319,OLY,P008855,P010392,0 days 00:10:00,-11,14,25
319,OLY,P008829,P010392,0 days 00:09:56,-11,14,25
319,OLY,P008811,P011194,0 days 00:09:08,-1,16,17
319,OLY,P010392,P012878,0 days 00:08:32,3,22,19
319,OLY,P008811,P010392,0 days 00:08:28,-7,11,18
319,OLY,P007982,P008811,0 days 00:07:45,-9,7,16
319,OLY,P010392,P011194,0 days 00:07:04,7,19,12
319,OLY,P007853,P010392,0 days 00:07:00,7,19,12
319,OLY,P007853,P008811,0 days 00:05:59,-7,7,14
319,OLY,P010392,P010612,0 days 00:05:55,-5,8,13
319,OLY,P010612,P011194,0 days 00:05:54,4,12,8
319,OLY,P006589,P008855,0 days 00:05:12,-4,4,8
319,OLY,P006589,P010612,0 days 00:05:12,-4,4,8
319,OLY,P006589,P008829,0 days 00:05:12,-4,4,8
319,OLY,P006589,P008811,0 days 00:05:12,-4,4,8
319,OLY,P007982,P008829,0 days 00:04:22,-6,6,12
319,OLY,P008829,P011194,0 days 00:03:21,6,9,3
319,OLY,P007853,P010612,0 days 00:02:45,-2,3,5
319,OLY,P007982,P010612,0 days 00:01:53,-2,0,2
319,OLY,P008829,P012878,0 days 00:01:35,-4,3,7
319,OLY,P007853,P008829,0 days 00:00:05,0,0,0
319,BAR,P000925,P012745,0 days 00:30:58,1,57,56
319,BAR,P006435,P012745,0 days 00:22:55,4,45,41
319,BAR,P004866,P012745,0 days 00:22:46,-1,35,36
319,BAR,P000925,P004866,0 days 00:22:37,-1,35,36
319,BAR,P000925,P006435,0 days 00:21:21,5,43,38
319,BAR,P002939,P012745,0 days 00:21:14,2,39,37
319,BAR,P002939,P006435,0 days 00:20:58,4,46,42
319,BAR,P000925,P002939,0 days 00:18:43,1,37,36
319,BAR,P003478,P012745,0 days 00:17:49,3,35,32
319,BAR,P002939,P003478,0 days 00:16:47,7,35,28
319,BAR,P003478,P006435,0 days 00:16:43,3,38,35
319,BAR,P012745,PLFW,0 days 00:16:40,0,29,29
319,BAR,P002939,P004866,0 days 00:14:05,-5,20,25
319,BAR,P003196,P003478,0 days 00:13:43,1,25,24
319,BAR,P004866,P006435,0 days 00:13:09,1,21,20
319,BAR,P000925,PLFW,0 days 00:12:15,0,20,20
319,BAR,P000925,P003478,0 days 00:11:12,2,24,22
319,BAR,P002939,P003196,0 days 00:09:28,1,16,15
319,BAR,P006435,PLFW,0 days 00:08:54,0,13,13
319,BAR,P007519,P012745,0 days 00:08:51,-2,14,16
319,BAR,P004866,PLFW,0 days 00:08:41,4,15,11
319,BAR,P003196,P006435,0 days 00:08:31,-1,16,17
319,BAR,P003478,PLFW,0 days 00:07:59,-4,14,18
319,BAR,P003478,P011244,0 days 00:07:06,0,14,14
319,BAR,P003196,P011244,0 days 00:07:01,0,14,14
319,BAR,P002939,P011244,0 days 00:06:57,0,14,14
319,BAR,P006435,P011244,0 days 00:06:57,0,14,14
319,BAR,P003196,P012745,0 days 00:06:56,1,11,10
319,BAR,P003196,P007519,0 days 00:05:26,2,9,7
319,BAR,P003478,P007519,0 days 00:05:17,2,9,7
319,BAR,P002939,P007519,0 days 00:04:32,-2,5,7
319,BAR,P003196,PLFW,0 days 00:04:25,0,9,9
319,BAR,P007519,PLFW,0 days 00:04:19,0,9,9
319,BAR,P004866,P007519,0 days 00:03:52,-4,5,9
319,BAR,P000925,P007519,0 days 00:03:34,-4,5,9
319,BAR,P000925,P009992,0 days 00:03:27,0,7,7
319,BAR,P009992,P012745,0 days 00:03:27,0,7,7
319,BAR,P009992,PLFW,0 days 00:03:27,0,7,7
319,BAR,P004866,P009992,0 days 00:03:13,2,7,5
319,BAR,P003478,P004866,0 days 00:02:50,0,2,2
319,BAR,P003196,P004866,0 days 00:00:18,0,0,0
319,BAR,P003478,P009992,0 days 00:00:14,-2,0,2
319,BAR,P004866,P011244,0 days 00:00:09,0,0,0
319,BAR,P007519,P011244,0 days 00:00:09,0,0,0
319,BAR,P000925,P011244,0 days 00:00:05,0,0,0
320,ULK,P001932,P008962,0 days 00:25:31,5,52,47
320,ULK,P001932,P005844,0 days 00:20:43,3,41,38
320,ULK,P005844,P008962,0 days 00:20:31,0,40,40
320,ULK,P001932,P010560,0 days 00:17:20,5,37,32
320,ULK,P006661,P008962,0 days 00:17:06,-4,39,43
320,ULK,P008962,P010560,0 days 00:15:45,5,32,27
320,ULK,P006661,P006961,0 days 00:15:37,7,40,33
320,ULK,P005844,P009849,0 days 00:15:20,2,33,31
320,ULK,P008962,P009849,0 days 00:14:50,4,31,27
320,ULK,P004004,P006661,0 days 00:14:28,0,33,33
320,ULK,P004004,P006961,0 days 00:14:05,13,35,22
320,ULK,P001932,P009849,0 days 00:14:02,3,27,24
320,ULK,P009849,P010560,0 days 00:13:55,4,27,23
320,ULK,P005844,P010560,0 days 00:13:35,4,27,23
320,ULK,P006961,P008962,0 days 00:13:07,6,31,25
320,ULK,P004004,P008962,0 days 00:12:39,-2,24,26
320,ULK,P006661,P011980,0 days 00:10:58,11,27,16
320,ULK,P001932,P006661,0 days 00:10:43,-6,22,28
320,ULK,P005844,P006961,0 days 00:08:29,7,23,16
320,ULK,P001932,P006961,0 days 00:07:53,8,19,11
320,ULK,P004004,P011980,0 days 00:07:47,10,19,9
320,ULK,P001932,P004004,0 days 00:07:37,-1,14,15
320,ULK,P006961,P011980,0 days 00:07:16,10,19,9
320,ULK,P004004,P006068,0 days 00:06:37,6,18,12
320,ULK,P008962,P011980,0 days 00:06:28,6,16,10
320,ULK,P006068,P006661,0 days 00:06:26,4,16,12
320,ULK,P005844,P006661,0 days 00:05:51,-8,14,22
320,ULK,P004004,P005844,0 days 00:04:55,0,10,10
320,ULK,P006068,P006961,0 days 00:04:09,6,12,6
320,ULK,P006961,P009849,0 days 00:04:09,4,14,10
320,ULK,P006068,P011980,0 days 00:03:58,4,10,6
320,ULK,P006661,P010560,0 days 00:03:45,1,8,7
320,ULK,P001932,P011980,0 days 00:03:42,1,8,7
320,ULK,P006661,P009849,0 days 00:03:39,2,11,9
320,ULK,P002968,P006961,0 days 00:03:35,-3,6,9
320,ULK,P002968,P006661,0 days 00:03:35,-3,6,9
320,ULK,P001932,P006068,0 days 00:03:13,-2,8,10
320,ULK,P010560,P011980,0 days 00:03:11,1,8,7
320,ULK,P002968,P008962,0 days 00:03:03,-4,5,9
320,ULK,P002968,P004004,0 days 00:02:37,-5,3,8
320,ULK,P006068,P008962,0 days 00:02:28,0,6,6
320,ULK,P006961,P010560,0 days 00:01:32,2,5,3
320,ULK,P004004,P009849,0 days 00:01:07,3,6,3
320,ULK,P002968,P009849,0 days 00:00:58,2,3,1
320,ULK,P006068,P010560,0 days 00:00:45,-2,2,4
320,ULK,P002968,P011980,0 days 00:00:32,1,1,0
320,ULK,P004004,P010560,0 days 00:00:28,0,2,2
320,MCO,P005985,P011226,0 days 00:25:25,-6,48,54
320,MCO,P005985,PLCZ,0 days 00:23:22,0,46,46
320,MCO,P009754,P011231,0 days 00:21:44,-7,44,51
320,MCO,P011226,PLCZ,0 days 00:20:49,-2,39,41
320,MCO,P011226,P011231,0 days 00:20:32,-15,34,49
320,MCO,P005985,P011231,0 days 00:19:19,-2,42,44
320,MCO,P009754,P011226,0 days 00:18:43,-7,31,38
320,MCO,P005985,P009754,0 days 00:17:42,6,39,33
320,MCO,P011212,P011231,0 days 00:15:47,-5,33,38
320,MCO,P009754,PLCZ,0 days 00:14:35,1,31,30
320,MCO,P005985,P011212,0 days 00:12:59,0,32,32
320,MCO,P011231,PLCZ,0 days 00:12:26,-1,28,29
320,MCO,P011212,P011226,0 days 00:11:43,-13,19,32
320,MCO,P004790,PLCZ,0 days 00:11:33,0,20,20
320,MCO,P004790,P005985,0 days 00:11:33,0,20,20
320,MCO,P004790,P011226,0 days 00:11:21,0,20,20
320,MCO,P008099,P011226,0 days 00:11:13,-4,22,26
320,MCO,P009754,P011212,0 days 00:10:10,-1,23,24
320,MCO,P002581,P011226,0 days 00:10:04,-7,19,26
320,MCO,P002581,P011231,0 days 00:09:46,-8,17,25
320,MCO,P005985,P008099,0 days 00:08:56,-4,17,21
320,MCO,P008099,PLCZ,0 days 00:08:07,-4,15,19
320,MCO,P002581,P011212,0 days 00:07:27,-7,16,23
320,MCO,P004790,P008099,0 days 00:06:58,-2,12,14
320,MCO,P002581,P009754,0 days 00:06:00,-2,11,13
320,MCO,P002581,P005985,0 days 00:05:33,-6,11,17
320,MCO,P008099,P009754,0 days 00:05:14,-3,10,13
320,MCO,P011196,P011231,0 days 00:05:09,-2,9,11
320,MCO,P011196,P011212,0 days 00:05:09,-2,9,11
320,MCO,P009754,P011196,0 days 00:05:09,-2,9,11
320,MCO,P011212,PLCZ,0 days 00:05:04,2,13,11
320,MCO,P008099,P011231,0 days 00:04:41,-4,9,13
320,MCO,P002581,P008099,0 days 00:04:38,-2,10,12
320,MCO,P004790,P009754,0 days 00:03:39,3,6,3
320,MCO,P005985,P011196,0 days 00:03:03,4,9,5
320,MCO,P011196,P011226,0 days 00:02:06,-6,0,6
320,MCO,P008099,P011212,0 days 00:01:13,-1,5,6
320,MCO,P004790,P011212,0 days 00:01:08,-1,2,3
321,TEL,P009783,P011199,0 days 00:28:44,-3,64,67
321,TEL,P009622,P011199,0 days 00:26:09,3,60,57
321,TEL,P009622,P009783,0 days 00:26:07,1,59,58
321,TEL,P009622,P012744,0 days 00:17:31,-7,37,44
321,TEL,P009783,P012744,0 days 00:16:16,-14,33,47
321,TEL,P011199,P012744,0 days 00:15:38,-9,34,43
321,TEL,P011193,P012744,0 days 00:15:23,-9,30,39
321,TEL,P011214,P012744,0 days 00:13:52,8,28,20
321,TEL,P005145,P009622,0 days 00:12:30,8,27,19
321,TEL,P009622,P011971,0 days 00:12:24,-1,27,28
321,TEL,P005145,P011199,0 days 00:12:21,8,27,19
321,TEL,P005145,P009783,0 days 00:12:21,8,27,19
321,TEL,P011193,P011214,0 days 00:12:01,2,23,21
321,TEL,P011971,P012744,0 days 00:12:00,10,29,19
321,TEL,P007990,P009622,0 days 00:11:49,15,29,14
321,TEL,P007990,P011199,0 days 00:11:40,15,29,14
321,TEL,P007990,P009783,0 days 00:11:40,15,29,14
321,TEL,P009622,P011193,0 days 00:11:11,-16,20,36
321,TEL,P009783,P011193,0 days 00:10:54,-20,19,39
321,TEL,P011199,P011971,0 days 00:10:08,-1,23,24
321,TEL,P009783,P011971,0 days 00:09:32,-5,20,25
321,TEL,P005145,P007990,0 days 00:09:30,12,22,10
321,TEL,P011193,P011199,0 days 00:09:20,-15,19,34
321,TEL,P011219,P012744,0 days 00:08:47,-3,14,17
321,TEL,P011193,P011219,0 days 00:08:22,-5,12,17
321,TEL,P009622,P011214,0 days 00:07:44,3,15,12
321,TEL,P011214,P011219,0 days 00:07:44,2,14,12
321,TEL,P011214,P011971,0 days 00:06:16,13,17,4
321,TEL,P011193,P011971,0 days 00:05:51,4,12,8
321,TEL,P009783,P011214,0 days 00:05:26,1,11,10
321,TEL,P011199,P011214,0 days 00:04:21,7,12,5
321,TEL,P009622,P011219,0 days 00:03:55,-2,6,8
321,TEL,P011219,P011971,0 days 00:02:51,8,8,0
321,TEL,P009783,P011219,0 days 00:02:44,-7,2,9
321,TEL,P007990,P011971,0 days 00:01:58,0,4,4
321,TEL,P005145,P011193,0 days 00:01:52,-4,2,6
321,TEL,P005145,P012744,0 days 00:01:17,0,3,3
321,TEL,P011199,P011219,0 days 00:01:03,-5,0,5
321,TEL,P007990,P011193,0 days 00:00:30,3,3,0
321,TEL,P005145,P011219,0 days 00:00:09,0,0,0
321,TEL,P007990,P011219,0 days 00:00:09,0,0,0
321,PAN,P003842,P011204,0 days 00:28:37,0,62,62
321,PAN,P003842,P012774,0 days 00:27:43,-1,61,62
321,PAN,P011204,P012774,0 days 00:23:59,2,56,54
321,PAN,P003842,P005161,0 days 00:22:00,12,51,39
321,PAN,P005161,P012774,0 days 00:20:47,12,50,38
321,PAN,P007866,P011204,0 days 00:20:07,-16,35,51
321,PAN,P003842,P007866,0 days 00:19:28,-17,32,49
321,PAN,P005161,P011204,0 days 00:19:07,10,43,33
321,PAN,P007947,P012774,0 days 00:16:35,10,46,36
321,PAN,P001926,P003842,0 days 00:15:31,6,34,28
321,PAN,P001926,P005161,0 days 00:15:24,2,28,26
321,PAN,P007866,P012774,0 days 00:15:19,-17,26,43
321,PAN,P003842,P007947,0 days 00:13:44,4,35,31
321,PAN,P005161,P007947,0 days 00:13:39,8,34,26
321,PAN,P001926,P011204,0 days 00:13:33,7,31,24
321,PAN,P001926,P012774,0 days 00:12:32,4,28,24
321,PAN,P001926,P007866,0 days 00:10:36,-2,20,22
321,PAN,P007947,P011204,0 days 00:10:00,7,30,23
321,PAN,P005161,P007866,0 days 00:09:43,-7,13,20
321,PAN,P002328,P012774,0 days 00:06:51,-8,10,18
321,PAN,P002328,P005161,0 days 00:06:26,-1,12,13
321,PAN,P002328,P007553,0 days 00:06:18,-3,10,13
321,PAN,P005161,P007553,0 days 00:05:49,-1,10,11
321,PAN,P002328,P007947,0 days 00:05:40,1,12,11
321,PAN,P001926,P007947,0 days 00:05:25,1,11,10
321,PAN,P007866,P007947,0 days 00:05:02,0,14,14
321,PAN,P007553,P007947,0 days 00:04:39,1,10,9
321,PAN,P007553,P012774,0 days 00:04:12,-1,8,9
321,PAN,P001926,P002328,0 days 00:03:45,-6,2,8
321,PAN,P001926,P007553,0 days 00:03:45,-6,2,8
321,PAN,P002328,P003842,0 days 00:02:39,-7,2,9
321,PAN,P002328,P007866,0 days 00:02:31,-9,0,9
321,PAN,P002328,P011204,0 days 00:01:38,-7,0,7
321,PAN,P011204,P011221,0 days 00:00:54,-2,0,2
321,PAN,P003842,P011209,0 days 00:00:45,3,3,0
321,PAN,P011209,P012774,0 days 00:00:45,3,3,0
321,PAN,P011204,P011209,0 days 00:00:45,3,3,0
321,PAN,P001926,P011221,0 days 00:00:45,-2,0,2
321,PAN,P007866,P011221,0 days 00:00:45,-2,0,2
321,PAN,P005161,P011221,0 days 00:00:45,-2,0,2
321,PAN,P005161,P011209,0 days 00:00:36,3,3,0
321,PAN,P007553,P007866,0 days 00:00:29,-2,0,2
321,PAN,P003842,P011221,0 days 00:00:09,0,0,0
321,PAN,P011209,P011221,0 days 00:00:09,0,0,0
321,PAN,P011221,P012774,0 days 00:00:09,0,0,0
323,OLY,P003941,P007853,0 days 00:21:47,31,60,29
323,OLY,P008829,P010612,0 days 00:19:44,1,37,36
323,OLY,P007853,P011194,0 days 00:17:09,34,49,15
323,OLY,P007853,P007982,0 days 00:16:30,25,46,21
323,OLY,P008811,P010612,0 days 00:15:41,1,27,26
323,OLY,P008811,P008829,0 days 00:15:27,1,27,26
323,OLY,P001255,P008811,0 days 00:15:20,0,27,27
323,OLY,P003941,P011194,0 days 00:14:37,32,44,12
323,OLY,P003941,P007982,0 days 00:13:58,23,41,18
323,OLY,P007982,P011194,0 days 00:13:18,26,38,12
323,OLY,P007853,P008855,0 days 00:13:09,24,34,10
323,OLY,P001255,P010612,0 days 00:12:48,-2,22,24
323,OLY,P001255,P008829,0 days 00:12:34,-2,22,24
323,OLY,P001255,P008855,0 days 00:10:39,3,25,22
323,OLY,P003941,P008855,0 days 00:10:16,21,29,8
323,OLY,P008855,P011194,0 days 00:10:16,21,29,8
323,OLY,P007853,P008829,0 days 00:10:03,2,21,19
323,OLY,P008829,P008855,0 days 00:09:27,-2,19,21
323,OLY,P008811,P008855,0 days 00:09:27,-2,19,21
323,OLY,P008855,P010612,0 days 00:09:27,-2,19,21
323,OLY,P007982,P008829,0 days 00:09:26,2,16,14
323,OLY,P007982,P008811,0 days 00:08:46,5,13,8
323,OLY,P003941,P011965,0 days 00:08:46,2,21,19
323,OLY,P001255,P007982,0 days 00:08:46,5,13,8
323,OLY,P007853,P011965,0 days 00:08:46,2,21,19
323,OLY,P007853,P010612,0 days 00:07:33,3,15,12
323,OLY,P003941,P008829,0 days 00:07:10,-1,16,17
323,OLY,P007982,P010612,0 days 00:07:10,3,10,7
323,OLY,P001255,P011194,0 days 00:06:51,10,16,6
323,OLY,P001255,P007853,0 days 00:06:37,10,16,6
323,OLY,P008829,P011965,0 days 00:06:37,-1,14,15
323,OLY,P007982,P008855,0 days 00:06:11,13,18,5
323,OLY,P007853,P008811,0 days 00:05:25,5,10,5
323,OLY,P007982,P011965,0 days 00:05:02,2,13,11
323,OLY,P003941,P010612,0 days 00:04:40,0,10,10
323,OLY,P001255,P003941,0 days 00:04:05,8,11,3
323,OLY,P010612,P011965,0 days 00:03:44,0,8,8
323,OLY,P008811,P011194,0 days 00:02:46,2,5,3
323,OLY,P011194,P011965,0 days 00:02:09,3,7,4
323,OLY,P003941,P010392,0 days 00:01:49,8,8,0
323,OLY,P007853,P010392,0 days 00:01:49,8,8,0
323,OLY,P007982,P010392,0 days 00:01:49,8,8,0
323,OLY,P010392,P011194,0 days 00:01:49,8,8,0
323,OLY,P010612,P011194,0 days 00:00:37,0,0,0
323,BAR,P000925,P012745,0 days 00:15:07,-10,27,37
323,BAR,P003196,P011244,0 days 00:14:59,-19,12,31
323,BAR,P004866,P012745,0 days 00:13:46,-4,30,34
323,BAR,P009992,P011244,0 days 00:13:22,-15,16,31
323,BAR,P004866,P006435,0 days 00:13:17,-6,21,27
323,BAR,P003196,P009992,0 days 00:12:12,-11,19,30
323,BAR,P000925,P006435,0 days 00:11:49,2,24,22
323,BAR,P004866,P009992,0 days 00:11:15,-6,21,27
323,BAR,P006435,P012745,0 days 00:11:05,2,24,22
323,BAR,P004866,P011244,0 days 00:10:47,-8,12,20
323,BAR,P007519,P011244,0 days 00:10:41,-14,12,26
323,BAR,P003478,P011244,0 days 00:10:20,-17,8,25
323,BAR,P000925,P004866,0 days 00:10:00,-5,19,24
323,BAR,P012745,PLFW,0 days 00:09:58,-6,24,30
323,BAR,P002939,P004866,0 days 00:09:51,-8,11,19
323,BAR,P003196,P004866,0 days 00:09:38,-4,15,19
323,BAR,P002939,P006435,0 days 00:09:22,-6,7,13
323,BAR,P003196,P003478,0 days 00:09:08,-14,8,22
323,BAR,P000925,PLFW,0 days 00:09:05,-4,22,26
323,BAR,P002939,P012745,0 days 00:08:55,-3,14,17
323,BAR,P009992,PLFW,0 days 00:08:53,-14,11,25
323,BAR,P003478,PLFW,0 days 00:08:45,-15,9,24
323,BAR,P002939,P003196,0 days 00:08:31,-4,13,17
323,BAR,P003478,P009992,0 days 00:08:26,-12,9,21
323,BAR,P007519,P009992,0 days 00:07:56,-7,10,17
323,BAR,P004866,PLFW,0 days 00:07:33,1,21,20
323,BAR,P000925,P002939,0 days 00:07:15,-9,5,14
323,BAR,P003196,PLFW,0 days 00:07:13,-10,8,18
323,BAR,P004866,P007519,0 days 00:07:09,-5,10,15
323,BAR,P002939,P011244,0 days 00:06:51,-10,4,14
323,BAR,P006435,PLFW,0 days 00:06:43,5,19,14
323,BAR,P011244,PLFW,0 days 00:06:20,-8,6,14
323,BAR,P000925,P003478,0 days 00:06:20,-8,8,16
323,BAR,P009992,P012745,0 days 00:06:19,-3,14,17
323,BAR,P002939,P003478,0 days 00:05:56,-5,7,12
323,BAR,P003196,P007519,0 days 00:05:17,-8,4,12
323,BAR,P003478,P012745,0 days 00:05:08,-5,8,13
323,BAR,P003478,P007519,0 days 00:05:00,-17,2,19
323,BAR,P006435,P011244,0 days 00:05:00,-3,2,5
323,BAR,P009992,P010641,0 days 00:04:55,-3,8,11
323,BAR,P010641,P011244,0 days 00:04:55,-3,8,11
323,BAR,P007519,P010641,0 days 00:04:55,-3,8,11
323,BAR,P004866,P010641,0 days 00:04:55,-3,8,11
323,BAR,P003196,P006435,0 days 00:04:16,-3,2,5
323,BAR,P003196,P012745,0 days 00:03:46,1,11,10
323,BAR,P002939,P007519,0 days 00:03:31,-10,2,12
323,BAR,P002939,P009992,0 days 00:02:52,3,9,6
323,BAR,P003478,P006435,0 days 00:02:48,5,5,0
323,BAR,P000925,P009992,0 days 00:02:34,-4,3,7
323,BAR,P000925,P007519,0 days 00:01:57,-11,0,11
323,BAR,P007519,P012745,0 days 00:01:28,-8,0,8
323,BAR,P000925,P011244,0 days 00:01:13,-3,0,3
323,BAR,P007519,PLFW,0 days 00:00:42,-5,0,5
323,BAR,P003478,P004866,0 days 00:00:01,0,0,0
324,ULK,P005844,P008962,0 days 00:27:37,1,44,43
324,ULK,P001932,P008962,0 days 00:25:06,-8,39,47
324,ULK,P001932,P005844,0 days 00:21:55,-4,36,40
324,ULK,P006661,P008962,0 days 00:19:05,-1,34,35
324,ULK,P005844,P006661,0 days 00:19:05,7,38,31
324,ULK,P006961,P008962,0 days 00:18:08,-2,24,26
324,ULK,P005844,P006961,0 days 00:17:02,3,25,22
324,ULK,P004004,P006661,0 days 00:16:32,4,31,27
324,ULK,P006661,P006961,0 days 00:15:20,-1,22,23
324,ULK,P004004,P006961,0 days 00:14:32,3,23,20
324,ULK,P004004,P005844,0 days 00:14:29,8,28,20
324,ULK,P008962,P009849,0 days 00:14:06,-2,18,20
324,ULK,P005844,P009849,0 days 00:13:27,-5,15,20
324,ULK,P001932,P006661,0 days 00:13:19,-5,24,29
324,ULK,P005844,P010560,0 days 00:13:08,-3,17,20
324,ULK,P004004,P008962,0 days 00:12:02,5,24,19
324,ULK,P001932,P009849,0 days 00:11:54,-3,15,18
324,ULK,P001932,P010560,0 days 00:11:18,-3,17,20
324,ULK,P008962,P010560,0 days 00:11:11,-3,17,20
324,ULK,P001932,P006961,0 days 00:10:03,-7,11,18
324,ULK,P006961,P009849,0 days 00:09:10,-1,12,13
324,ULK,P006661,P010560,0 days 00:08:12,-2,11,13
324,ULK,P006661,P011980,0 days 00:07:53,-5,10,15
324,ULK,P006961,P011980,0 days 00:07:26,-5,10,15
324,ULK,P004004,P011980,0 days 00:05:12,0,10,10
324,ULK,P009849,P010560,0 days 00:04:56,-1,6,7
324,ULK,P002968,P006961,0 days 00:04:49,2,9,7
324,ULK,P002968,P004004,0 days 00:04:10,-1,6,7
324,ULK,P002968,P006661,0 days 00:04:10,-1,6,7
324,ULK,P001932,P004004,0 days 00:03:57,0,11,11
324,ULK,P005844,P011980,0 days 00:03:25,1,9,8
324,ULK,P002968,P008962,0 days 00:02:55,3,8,5
324,ULK,P001932,P011980,0 days 00:02:41,-5,0,5
324,ULK,P008962,P011980,0 days 00:02:34,-5,0,5
324,ULK,P004004,P009849,0 days 00:02:12,1,3,2
324,ULK,P002968,P011980,0 days 00:01:54,-1,1,2
324,ULK,P004004,P010560,0 days 00:01:50,0,0,0
324,ULK,P006961,P010560,0 days 00:01:30,0,0,0
324,ULK,P001932,P002968,0 days 00:00:39,3,3,0
324,ULK,P002968,P009849,0 days 00:00:39,3,3,0
324,ULK,P010560,P011980,0 days 00:00:27,0,0,0
324,MCO,P005985,P011231,0 days 00:24:21,-2,38,40
324,MCO,P011212,P011226,0 days 00:24:05,6,40,34
324,MCO,P009754,PLCZ,0 days 00:22:02,-3,31,34
324,MCO,P005985,P009754,0 days 00:20:19,10,42,32
324,MCO,P005985,P011212,0 days 00:19:24,14,40,26
324,MCO,P005985,P011226,0 days 00:18:52,8,39,31
324,MCO,P011196,P011212,0 days 00:18:01,9,28,19
324,MCO,P011196,P011226,0 days 00:17:29,3,27,24
324,MCO,P005985,PLCZ,0 days 00:17:06,3,30,27
324,MCO,P009754,P011226,0 days 00:14:55,-1,25,26
324,MCO,P005985,P011196,0 days 00:14:45,7,29,22
324,MCO,P004197,P005985,0 days 00:14:17,3,23,20
324,MCO,P004197,P011231,0 days 00:14:09,3,23,20
324,MCO,P009754,P011212,0 days 00:13:25,5,23,18
324,MCO,P009754,P011231,0 days 00:12:47,-2,20,22
324,MCO,P011231,PLCZ,0 days 00:12:46,0,20,20
324,MCO,P004197,P009754,0 days 00:12:15,3,20,17
324,MCO,P004197,PLCZ,0 days 00:12:07,3,20,17
324,MCO,P011226,PLCZ,0 days 00:11:50,-8,13,21
324,MCO,P011212,P011231,0 days 00:11:34,0,18,18
324,MCO,P009754,P011196,0 days 00:11:00,0,17,17
324,MCO,P011212,PLCZ,0 days 00:10:52,-7,11,18
324,MCO,P011226,P011231,0 days 00:10:12,-5,15,20
324,MCO,P011196,P011231,0 days 00:09:19,-2,13,15
324,MCO,P011196,PLCZ,0 days 00:05:52,-5,3,8
324,MCO,P002581,P011212,0 days 00:05:29,-3,9,12
324,MCO,P002581,P011226,0 days 00:05:29,-3,9,12
324,MCO,P002581,P005985,0 days 00:03:32,1,7,6
324,MCO,P002581,PLCZ,0 days 00:03:13,-3,4,7
324,MCO,P002581,P011231,0 days 00:02:16,0,5,5
324,MCO,P004197,P011196,0 days 00:02:10,0,3,3
324,MCO,P004197,P011212,0 days 00:02:10,0,3,3
324,MCO,P002581,P009754,0 days 00:01:57,-4,2,6
325,TEL,P009622,P009783,0 days 00:29:11,-14,55,69
325,TEL,P009783,P011199,0 days 00:27:42,-9,56,65
325,TEL,P009622,P011199,0 days 00:27:04,-8,52,60
325,TEL,P009783,P011193,0 days 00:18:46,3,42,39
325,TEL,P009622,P011193,0 days 00:17:39,-2,35,37
325,TEL,P011193,P011199,0 days 00:17:24,7,41,34
325,TEL,P011193,P011214,0 days 00:16:15,6,39,33
325,TEL,P009783,P011214,0 days 00:11:43,2,28,26
325,TEL,P011193,P012744,0 days 00:11:28,0,29,29
325,TEL,P009622,P011214,0 days 00:11:17,-2,24,26
325,TEL,P007990,P011971,0 days 00:11:02,3,26,23
325,TEL,P011214,P012744,0 days 00:10:37,-2,24,26
325,TEL,P007990,P009783,0 days 00:09:22,-10,16,26
325,TEL,P007990,P009622,0 days 00:08:30,-12,11,23
325,TEL,P009783,P011971,0 days 00:08:24,-2,17,19
325,TEL,P011193,P011971,0 days 00:08:00,13,22,9
325,TEL,P011199,P011971,0 days 00:07:45,-5,14,19
325,TEL,P011199,P011214,0 days 00:07:38,6,18,12
325,TEL,P009622,P011971,0 days 00:07:32,-4,12,16
325,TEL,P005145,P011199,0 days 00:07:27,-8,16,24
325,TEL,P007990,P011193,0 days 00:07:17,7,17,10
325,TEL,P007990,P011199,0 days 00:07:10,-12,9,21
325,TEL,P009863,P011199,0 days 00:07:04,-6,16,22
325,TEL,P005145,P009863,0 days 00:07:04,-6,16,22
325,TEL,P007990,P011214,0 days 00:07:01,10,21,11
325,TEL,P011193,P011219,0 days 00:06:33,-1,17,18
325,TEL,P007990,P012744,0 days 00:06:22,6,20,14
325,TEL,P005145,P009622,0 days 00:06:04,-9,11,20
325,TEL,P005145,P009783,0 days 00:05:56,-10,10,20
325,TEL,P011214,P011971,0 days 00:05:49,10,17,7
325,TEL,P009783,P012744,0 days 00:05:46,-6,15,21
325,TEL,P009622,P009863,0 days 00:05:41,-7,11,18
325,TEL,P009783,P009863,0 days 00:05:33,-8,10,18
325,TEL,P011971,P012744,0 days 00:05:23,6,16,10
325,TEL,P009783,P011219,0 days 00:05:17,2,15,13
325,TEL,P009622,P012744,0 days 00:05:13,-6,10,16
325,TEL,P009622,P011219,0 days 00:04:41,0,11,11
325,TEL,P011199,P011219,0 days 00:04:06,4,12,8
325,TEL,P011199,P012744,0 days 00:04:04,3,14,11
325,TEL,P011219,P012744,0 days 00:03:08,-4,8,12
325,TEL,P011214,P011219,0 days 00:02:27,-5,5,10
325,TEL,P009863,P012744,0 days 00:01:52,1,6,5
325,TEL,P005145,P011193,0 days 00:01:46,-1,5,6
325,TEL,P009863,P011193,0 days 00:01:44,0,5,5
325,TEL,P005145,P012744,0 days 00:01:31,2,6,4
325,TEL,P009863,P011214,0 days 00:00:21,-1,0,1
325,TEL,P009863,P011971,0 days 00:00:21,-1,0,1
325,PAN,P003842,P007866,0 days 00:34:41,11,83,72
325,PAN,P001926,P003842,0 days 00:33:44,11,84,73
325,PAN,P007866,P012774,0 days 00:31:31,10,83,73
325,PAN,P001926,P007866,0 days 00:31:01,11,80,69
325,PAN,P003842,P012774,0 days 00:30:43,17,80,63
325,PAN,P001926,P012774,0 days 00:27:16,17,77,60
325,PAN,P003842,P005161,0 days 00:25:59,12,66,54
325,PAN,P001926,P005161,0 days 00:25:41,13,69,56
325,PAN,P005161,P007866,0 days 00:23:44,12,62,50
325,PAN,P005161,P012774,0 days 00:21:01,18,59,41
325,PAN,P002328,P003842,0 days 00:12:42,0,28,28
325,PAN,P001926,P002328,0 days 00:12:42,1,31,30
325,PAN,P002328,P007866,0 days 00:11:41,-6,26,32
325,PAN,P002328,P012774,0 days 00:08:45,-3,23,26
325,PAN,P007866,P011204,0 days 00:08:45,-9,10,19
325,PAN,P003842,P011204,0 days 00:08:24,-4,13,17
325,PAN,P011204,P012774,0 days 00:05:32,-6,10,16
325,PAN,P002328,P005161,0 days 00:05:29,1,15,14
325,PAN,P002328,P011204,0 days 00:05:14,-7,7,14
325,PAN,P001926,P011204,0 days 00:05:02,-5,7,12
325,PAN,P007866,P011209,0 days 00:04:43,1,6,5
325,PAN,P003842,P011209,0 days 00:04:15,1,6,5
325,PAN,P011209,P012774,0 days 00:04:02,1,6,5
325,PAN,P011204,P011209,0 days 00:03:50,1,6,5
325,PAN,P005161,P011204,0 days 00:03:19,-4,5,9
325,PAN,P007866,P011221,0 days 00:02:10,-6,2,8
325,PAN,P011204,P011221,0 days 00:02:10,-6,2,8
325,PAN,P002328,P011221,0 days 00:01:42,-6,2,8
325,PAN,P011221,P012774,0 days 00:01:42,-6,2,8
325,PAN,P005161,P011209,0 days 00:00:59,0,0,0
325,PAN,P005161,P011221,0 days 00:00:28,0,0,0
325,PAN,P011209,P011221,0 days 00:00:28,0,0,0
325,PAN,P001926,P011209,0 days 00:00:22,0,0,0
325,PAN,P002328,P011209,0 days 00:00:13,0,0,0
327,BAR,P000925,P002939,0 days 00:24:11,-6,38,44
327,BAR,P000925,P012745,0 days 00:23:21,-7,32,39
327,BAR,P002939,P012745,0 days 00:22:58,-8,30,38
327,BAR,P000925,P006435,0 days 00:20:54,1,35,34
327,BAR,P002939,P006435,0 days 00:19:15,2,33,31
327,BAR,P006435,P012745,0 days 00:19:03,1,27,26
327,BAR,P000925,P004866,0 days 00:17:01,-4,19,23
327,BAR,P004866,P006435,0 days 00:16:47,5,22,17
327,BAR,P003478,P012745,0 days 00:16:21,-4,28,32
327,BAR,P004866,P012745,0 days 00:16:17,-3,16,19
327,BAR,P003478,PLFW,0 days 00:15:35,-4,19,23
327,BAR,P012745,PLFW,0 days 00:14:10,-9,17,26
327,BAR,P002939,P004866,0 days 00:13:35,-3,15,18
327,BAR,P002939,P003478,0 days 00:12:49,-7,23,30
327,BAR,P000925,P003478,0 days 00:12:23,-3,25,28
327,BAR,P003196,PLFW,0 days 00:12:23,3,17,14
327,BAR,P003196,P003478,0 days 00:10:17,-2,12,14
327,BAR,P003478,P006435,0 days 00:08:26,1,20,19
327,BAR,P000925,PLFW,0 days 00:07:30,-7,9,16
327,BAR,P003196,P012745,0 days 00:07:30,0,10,10
327,BAR,P003478,P007519,0 days 00:06:43,0,10,10
327,BAR,P003478,P011244,0 days 00:06:19,-1,9,10
327,BAR,P002939,PLFW,0 days 00:06:17,-10,5,15
327,BAR,P006435,P011244,0 days 00:06:10,5,15,10
327,BAR,P004866,PLFW,0 days 00:06:05,0,9,9
327,BAR,P006435,PLFW,0 days 00:05:58,4,9,5
327,BAR,P007519,PLFW,0 days 00:05:51,2,10,8
327,BAR,P003196,P007519,0 days 00:05:51,2,10,8
327,BAR,P011244,PLFW,0 days 00:05:43,5,9,4
327,BAR,P003196,P011244,0 days 00:04:53,3,7,4
327,BAR,P003196,P006435,0 days 00:04:19,5,7,2
327,BAR,P000925,P011244,0 days 00:04:16,0,10,10
327,BAR,P007519,P012745,0 days 00:03:44,2,8,6
327,BAR,P002939,P011244,0 days 00:03:26,-2,8,10
327,BAR,P007519,P011244,0 days 00:02:59,-2,2,4
327,BAR,P004866,P011244,0 days 00:02:50,4,8,4
327,BAR,P002939,P003196,0 days 00:02:13,-4,0,4
327,BAR,P003196,P004866,0 days 00:02:06,5,5,0
327,BAR,P003478,P004866,0 days 00:01:47,0,2,2
327,BAR,P000925,P007519,0 days 00:00:52,-2,0,2
327,BAR,P002939,P007519,0 days 00:00:52,-2,0,2
327,OLY,P007853,P007982,0 days 00:22:22,3,41,38
327,OLY,P003941,P007982,0 days 00:20:01,-1,34,35
327,OLY,P003941,P007853,0 days 00:19:58,-3,32,35
327,OLY,P001255,P008855,0 days 00:18:00,6,33,27
327,OLY,P001255,P007982,0 days 00:16:12,2,29,27
327,OLY,P001255,P011194,0 days 00:15:59,2,24,22
327,OLY,P001255,P010612,0 days 00:15:46,-2,19,21
327,OLY,P001255,P003941,0 days 00:15:44,4,29,25
327,OLY,P003941,P011194,0 days 00:14:29,4,22,18
327,OLY,P007982,P008829,0 days 00:12:46,-1,18,19
327,OLY,P001255,P007853,0 days 00:12:41,4,25,21
327,OLY,P001255,P008811,0 days 00:12:18,-2,15,17
327,OLY,P008855,P011194,0 days 00:11:23,3,18,15
327,OLY,P003941,P008855,0 days 00:11:08,5,23,18
327,OLY,P008811,P010612,0 days 00:10:28,-9,7,16
327,OLY,P008855,P010612,0 days 00:10:26,-1,14,15
327,OLY,P008829,P010612,0 days 00:10:03,-1,12,13
327,OLY,P007853,P008855,0 days 00:09:32,8,22,14
327,OLY,P010612,P011194,0 days 00:09:25,2,15,13
327,OLY,P007853,P008829,0 days 00:09:18,3,16,13
327,OLY,P007982,P011194,0 days 00:09:14,-1,12,13
327,OLY,P007853,P011194,0 days 00:09:14,-1,12,13
327,OLY,P007982,P010612,0 days 00:09:08,6,17,11
327,OLY,P008811,P008855,0 days 00:08:50,2,13,11
327,OLY,P007982,P008855,0 days 00:07:43,7,21,14
327,OLY,P003941,P010612,0 days 00:07:02,10,18,8
327,OLY,P003941,P008829,0 days 00:06:52,1,12,11
327,OLY,P001255,P008829,0 days 00:06:43,-6,2,8
327,OLY,P008811,P008829,0 days 00:06:18,-6,2,8
327,OLY,P007853,P010392,0 days 00:05:50,-4,6,10
327,OLY,P007982,P010392,0 days 00:05:50,-4,6,10
327,OLY,P003941,P010392,0 days 00:05:50,-4,6,10
327,OLY,P007982,P008811,0 days 00:05:18,3,10,7
327,OLY,P008829,P010392,0 days 00:05:08,-2,6,8
327,OLY,P008811,P011194,0 days 00:04:10,-3,5,8
327,OLY,P007853,P010612,0 days 00:03:45,5,10,5
327,OLY,P008829,P008855,0 days 00:02:50,-2,0,2
327,OLY,P007853,P012878,0 days 00:02:26,2,4,2
327,OLY,P007982,P012878,0 days 00:02:26,2,4,2
327,OLY,P008829,P012878,0 days 00:02:26,2,4,2
327,OLY,P010612,P012878,0 days 00:02:01,2,4,2
327,OLY,P007853,P008811,0 days 00:01:50,7,8,1
327,OLY,P010392,P011194,0 days 00:00:42,-2,0,2
327,OLY,P001255,P012878,0 days 00:00:25,0,0,0
328,MCO,P005985,P010588,0 days 00:28:38,-5,45,50
328,MCO,P011212,P011226,0 days 00:27:26,12,61,49
328,MCO,P005985,PLCZ,0 days 00:27:01,4,45,41
328,MCO,P005985,P011212,0 days 00:25:56,0,50,50
328,MCO,P005985,P011226,0 days 00:22:44,11,50,39
328,MCO,P010588,PLCZ,0 days 00:22:38,-1,35,36
328,MCO,P011212,P011231,0 days 00:21:16,-2,40,42
328,MCO,P011226,P011231,0 days 00:20:01,3,41,38
328,MCO,P009754,PLCZ,0 days 00:19:36,-11,21,32
328,MCO,P005985,P009754,0 days 00:18:12,-11,20,31
328,MCO,P011212,PLCZ,0 days 00:17:25,7,34,27
328,MCO,P009754,P010588,0 days 00:16:49,-9,17,26
328,MCO,P010588,P011212,0 days 00:16:40,-1,33,34
328,MCO,P005985,P011231,0 days 00:15:06,-5,27,32
328,MCO,P011226,PLCZ,0 days 00:14:38,18,34,16
328,MCO,P010588,P011226,0 days 00:13:55,8,32,24
328,MCO,P009754,P011212,0 days 00:12:24,-4,21,25
328,MCO,P004197,P005985,0 days 00:10:30,-6,10,16
328,MCO,P004197,P009754,0 days 00:10:30,-6,10,16
328,MCO,P004197,PLCZ,0 days 00:10:30,-6,10,16
328,MCO,P004197,P010588,0 days 00:10:30,-6,10,16
328,MCO,P009754,P011226,0 days 00:09:35,4,21,17
328,MCO,P011196,P011212,0 days 00:09:09,0,21,21
328,MCO,P011196,P011226,0 days 00:09:09,0,21,21
328,MCO,P011196,P011231,0 days 00:09:09,0,21,21
328,MCO,P009754,P011231,0 days 00:08:26,1,18,17
328,MCO,P011231,PLCZ,0 days 00:07:36,1,13,12
328,MCO,P010588,P011231,0 days 00:05:22,-6,8,14
328,MCO,P005985,P011196,0 days 00:05:21,-4,9,13
328,MCO,P009754,P011196,0 days 00:03:48,4,12,8
328,ULK,P001932,P008962,0 days 00:34:37,-1,61,62
328,ULK,P001932,P006661,0 days 00:28:38,4,50,46
328,ULK,P006661,P008962,0 days 00:27:15,4,50,46
328,ULK,P004004,P008962,0 days 00:21:07,-10,37,47
328,ULK,P001932,P004004,0 days 00:20:26,-3,37,40
328,ULK,P001932,P005844,0 days 00:20:09,-8,30,38
328,ULK,P004004,P006661,0 days 00:19:54,4,42,38
328,ULK,P005844,P006661,0 days 00:18:31,-4,27,31
328,ULK,P004004,P005844,0 days 00:17:37,0,30,30
328,ULK,P005844,P008962,0 days 00:16:57,-10,26,36
328,ULK,P004004,P011980,0 days 00:12:47,8,31,23
328,ULK,P001932,P006961,0 days 00:12:26,0,19,19
328,ULK,P004004,P006961,0 days 00:12:21,2,22,20
328,ULK,P006661,P011980,0 days 00:12:20,8,31,23
328,ULK,P001932,P010560,0 days 00:12:13,2,19,17
328,ULK,P008962,P010560,0 days 00:12:13,2,19,17
328,ULK,P005844,P006961,0 days 00:11:36,7,21,14
328,ULK,P006661,P006961,0 days 00:11:29,4,22,18
328,ULK,P006961,P008962,0 days 00:11:06,-7,17,24
328,ULK,P006961,P011980,0 days 00:10:18,5,19,14
328,ULK,P006661,P010560,0 days 00:10:07,6,16,10
328,ULK,P006661,P011157,0 days 00:09:56,4,16,12
328,ULK,P001932,P011980,0 days 00:08:59,3,18,15
328,ULK,P010560,P011157,0 days 00:08:46,9,16,7
328,ULK,P008962,P011157,0 days 00:08:46,9,16,7
328,ULK,P001932,P011157,0 days 00:08:46,9,16,7
328,ULK,P005844,P011980,0 days 00:06:35,6,11,5
328,ULK,P008962,P011980,0 days 00:06:28,1,16,15
328,ULK,P002968,P006961,0 days 00:04:28,0,11,11
328,ULK,P002968,P008962,0 days 00:03:53,-6,5,11
328,ULK,P002968,P009849,0 days 00:03:34,-6,5,11
328,ULK,P006961,P009849,0 days 00:03:34,-6,5,11
328,ULK,P008962,P009849,0 days 00:03:34,-6,5,11
328,ULK,P005844,P010560,0 days 00:03:27,-7,3,10
328,ULK,P001932,P009849,0 days 00:02:31,-1,5,6
328,ULK,P001932,P002968,0 days 00:02:31,-1,5,6
328,ULK,P004004,P010560,0 days 00:02:06,-4,3,7
328,ULK,P002968,P004004,0 days 00:01:57,1,6,5
328,ULK,P004004,P011157,0 days 00:01:10,-5,0,5
328,ULK,P006961,P011157,0 days 00:01:10,-5,0,5
328,ULK,P011157,P011980,0 days 00:01:10,-5,0,5
328,ULK,P004004,P009849,0 days 00:01:03,-5,0,5
328,ULK,P002968,P006661,0 days 00:00:54,6,6,0
328,ULK,P002968,P011980,0 days 00:00:35,6,6,0
329,PAN,P003842,P012774,0 days 00:34:17,7,71,64
329,PAN,P005161,P012774,0 days 00:27:15,6,54,48
329,PAN,P003842,P005161,0 days 00:26:30,8,54,46
329,PAN,P007866,P012774,0 days 00:24:24,-2,46,48
329,PAN,P003842,P007866,0 days 00:23:17,0,46,46
329,PAN,P005161,P007866,0 days 00:22:55,-2,43,45
329,PAN,P001926,P012774,0 days 00:17:58,-1,35,36
329,PAN,P001926,P003842,0 days 00:16:09,-1,33,34
329,PAN,P001926,P005161,0 days 00:14:07,-1,26,27
329,PAN,P012712,P012774,0 days 00:14:03,8,30,22
329,PAN,P003842,P011204,0 days 00:14:00,6,30,24
329,PAN,P011204,P012774,0 days 00:13:07,5,27,22
329,PAN,P011209,P012774,0 days 00:12:02,6,26,20
329,PAN,P007866,P011204,0 days 00:12:02,5,26,21
329,PAN,P001926,P012712,0 days 00:11:06,4,24,20
329,PAN,P003842,P012712,0 days 00:11:06,6,26,20
329,PAN,P005161,P011204,0 days 00:10:56,6,22,16
329,PAN,P003842,P011209,0 days 00:10:41,4,24,20
329,PAN,P001926,P007866,0 days 00:09:12,-8,14,22
329,PAN,P002328,P012774,0 days 00:07:05,6,16,10
329,PAN,P005161,P011209,0 days 00:06:19,1,14,13
329,PAN,P007866,P011209,0 days 00:06:18,-3,12,15
329,PAN,P005161,P012712,0 days 00:06:07,3,12,9
329,PAN,P011209,P012712,0 days 00:05:58,5,12,7
329,PAN,P002328,P012712,0 days 00:04:50,5,10,5
329,PAN,P002328,P003842,0 days 00:04:40,2,12,10
329,PAN,P001926,P011209,0 days 00:04:22,-3,8,11
329,PAN,P011221,P012774,0 days 00:03:09,5,7,2
329,PAN,P002328,P011209,0 days 00:02:55,4,4,0
329,PAN,P002328,P011204,0 days 00:02:39,1,8,7
329,PAN,P001926,P011221,0 days 00:02:35,1,5,4
329,PAN,P002328,P011221,0 days 00:02:25,4,4,0
329,PAN,P011221,P012712,0 days 00:02:25,4,4,0
329,PAN,P002328,P007866,0 days 00:02:15,1,6,5
329,PAN,P011209,P011221,0 days 00:02:08,0,2,2
329,PAN,P001926,P011204,0 days 00:01:32,0,3,3
329,PAN,P001926,P002328,0 days 00:01:31,1,4,3
329,PAN,P005161,P011221,0 days 00:01:31,-1,3,4
329,PAN,P007866,P011221,0 days 00:01:31,-1,3,4
329,PAN,P011204,P012712,0 days 00:01:11,-1,2,3
329,PAN,P007866,P012712,0 days 00:00:54,-2,0,2
329,PAN,P011204,P011209,0 days 00:00:33,2,2,0
329,TEL,P009622,P009783,0 days 00:27:41,-7,48,55
329,TEL,P009622,P011199,0 days 00:27:23,1,50,49
329,TEL,P009783,P011199,0 days 00:25:02,-1,45,46
329,TEL,P007990,P011199,0 days 00:21:03,3,42,39
329,TEL,P007990,P009622,0 days 00:20:23,2,37,35
329,TEL,P007990,P009783,0 days 00:19:12,-2,32,34
329,TEL,P005145,P009622,0 days 00:16:07,4,31,27
329,TEL,P005145,P011199,0 days 00:16:07,4,31,27
329,TEL,P005145,P009783,0 days 00:15:20,2,29,27
329,TEL,P009783,P011193,0 days 00:14:33,-4,27,31
329,TEL,P009622,P011193,0 days 00:13:57,-11,22,33
329,TEL,P011193,P011214,0 days 00:12:55,-9,24,33
329,TEL,P005145,P007990,0 days 00:12:44,6,25,19
329,TEL,P011193,P011199,0 days 00:12:12,-4,22,26
329,TEL,P009622,P012744,0 days 00:11:27,-7,18,25
329,TEL,P011193,P012744,0 days 00:10:17,-12,18,30
329,TEL,P011214,P012744,0 days 00:09:58,-9,18,27
329,TEL,P009622,P011971,0 days 00:09:35,-3,17,20
329,TEL,P009783,P011214,0 days 00:08:36,-1,16,17
329,TEL,P007990,P012744,0 days 00:08:20,-2,15,17
329,TEL,P009622,P011214,0 days 00:08:15,-7,13,20
329,TEL,P007990,P011971,0 days 00:08:09,-1,15,16
329,TEL,P007990,P011214,0 days 00:07:45,-5,12,17
329,TEL,P011193,P011971,0 days 00:07:31,-5,11,16
329,TEL,P011199,P012744,0 days 00:07:26,-4,14,18
329,TEL,P011971,P012744,0 days 00:07:11,-2,13,15
329,TEL,P011199,P011971,0 days 00:07:06,1,13,12
329,TEL,P009783,P011971,0 days 00:06:30,-1,13,14
329,TEL,P007990,P011193,0 days 00:06:12,-5,10,15
329,TEL,P009783,P012744,0 days 00:06:10,-6,10,16
329,TEL,P011214,P011971,0 days 00:05:46,-5,10,15
329,TEL,P011199,P011214,0 days 00:04:57,0,11,11
329,TEL,P005145,P011193,0 days 00:03:23,-2,6,8
329,TEL,P005145,P012744,0 days 00:00:47,2,2,0
330,MAD,P003108,P005928,0 days 00:28:22,10,62,52
330,MAD,P005928,P006540,0 days 00:26:09,13,54,41
330,MAD,P003108,P006540,0 days 00:24:36,12,51,39
330,MAD,P003108,P005791,0 days 00:22:30,10,45,35
330,MAD,P005791,P005928,0 days 00:19:52,12,42,30
330,MAD,P005791,P006540,0 days 00:18:14,12,38,26
330,MAD,P003108,P010357,0 days 00:16:03,4,32,28
330,MAD,P005928,P010357,0 days 00:13:03,10,32,22
330,MAD,P005791,P010357,0 days 00:11:30,9,25,16
330,MAD,P004887,P010357,0 days 00:11:14,4,29,25
330,MAD,P010357,PCVM,0 days 00:11:12,3,26,23
330,MAD,P003108,P004887,0 days 00:10:49,-8,20,28
330,MAD,P005928,P009213,0 days 00:10:34,-2,20,22
330,MAD,P003108,P009213,0 days 00:10:34,-2,20,22
330,MAD,P005791,P009213,0 days 00:10:30,1,20,19
330,MAD,P006540,P009213,0 days 00:10:30,1,20,19
330,MAD,P004887,P005928,0 days 00:10:03,-1,23,24
330,MAD,P004887,PCVM,0 days 00:09:55,3,23,20
330,MAD,P003108,PCVM,0 days 00:09:26,-7,11,18
330,MAD,P006540,P010357,0 days 00:09:21,9,21,12
330,MAD,P004887,PTGB,0 days 00:09:16,-2,19,21
330,MAD,P003108,PTGB,0 days 00:09:10,-2,19,21
330,MAD,P004887,P006540,0 days 00:07:55,1,16,15
330,MAD,P010357,PTGB,0 days 00:06:59,0,13,13
330,MAD,P005928,PTGB,0 days 00:06:57,4,19,15
330,MAD,P001392,P010357,0 days 00:06:19,5,19,14
330,MAD,P001392,PCVM,0 days 00:06:12,5,19,14
330,MAD,P004887,PBMT,0 days 00:05:32,5,19,14
330,MAD,PBMT,PCVM,0 days 00:05:32,5,19,14
330,MAD,P010357,PBMT,0 days 00:05:08,8,19,11
330,MAD,P001392,PBMT,0 days 00:05:08,8,19,11
330,MAD,P001392,P004887,0 days 00:05:08,8,19,11
330,MAD,P006540,PTGB,0 days 00:04:53,3,12,9
330,MAD,P005791,PCVM,0 days 00:04:39,-2,7,9
330,MAD,P005928,PCVM,0 days 00:04:36,1,8,7
330,MAD,PCVM,PTGB,0 days 00:03:46,-5,3,8
330,MAD,P006540,PCVM,0 days 00:02:58,1,4,3
330,MAD,P005791,PTGB,0 days 00:01:27,1,3,2
330,MAD,P001392,P003108,0 days 00:01:11,-3,0,3
330,MAD,P001392,P005791,0 days 00:01:11,-3,0,3
330,MAD,P003108,PBMT,0 days 00:00:24,-3,0,3
330,MAD,PBMT,PTGB,0 days 00:00:24,-3,0,3
330,MAD,P003108,P003733,0 days 00:00:11,-3,0,3
330,MAD,P001392,P003733,0 days 00:00:07,0,0,0
330,MAD,P003733,P005791,0 days 00:00:07,0,0,0
330,MAD,P003733,P010357,0 days 00:00:07,0,0,0
330,MAD,P003733,P004887,0 days 00:00:04,-3,0,3
330,MAD,P003733,P005928,0 days 00:00:04,-3,0,3
330,MAD,P003733,P009213,0 days 00:00:04,-3,0,3
330,MAD,P004887,P009213,0 days 00:00:04,-3,0,3
330,OLY,P008811,P008829,0 days 00:23:55,-7,45,52
330,OLY,P007853,P007982,0 days 00:21:44,-9,42,51
330,OLY,P008829,P008855,0 days 00:21:17,0,44,44
330,OLY,P008811,P008855,0 days 00:20:20,-3,41,44
330,OLY,P007982,P008829,0 days 00:18:58,6,42,36
330,OLY,P007982,P008811,0 days 00:18:36,0,41,41
330,OLY,P001255,P008829,0 days 00:18:09,3,38,35
330,OLY,P001255,P008811,0 days 00:17:59,-3,37,40
330,OLY,P007982,P008855,0 days 00:16:36,1,34,33
330,OLY,P008811,P010612,0 days 00:15:07,-14,24,38
330,OLY,P001255,P007982,0 days 00:14:54,2,33,31
330,OLY,P001255,P008855,0 days 00:14:51,3,32,29
330,OLY,P007853,P008829,0 days 00:14:46,0,28,28
330,OLY,P007853,P008811,0 days 00:13:27,-9,24,33
330,OLY,P007853,P010612,0 days 00:13:25,-11,23,34
330,OLY,P008829,P010612,0 days 00:12:50,-9,19,28
330,OLY,P007853,P008855,0 days 00:12:48,-5,20,25
330,OLY,P003941,P007853,0 days 00:10:10,2,17,15
330,OLY,P007982,P010612,0 days 00:10:00,-6,21,27
330,OLY,P001255,P010612,0 days 00:09:10,-6,18,24
330,OLY,P008855,P010612,0 days 00:09:09,-9,12,21
330,OLY,P003941,P007982,0 days 00:08:49,-1,14,15
330,OLY,P007853,P011194,0 days 00:07:54,-9,11,20
330,OLY,P001255,P007853,0 days 00:07:41,1,17,16
330,OLY,P007982,P011194,0 days 00:07:30,-9,11,20
330,OLY,P003941,P008855,0 days 00:06:22,-2,8,10
330,OLY,P008855,P011194,0 days 00:05:25,-5,5,10
330,OLY,P003941,P011194,0 days 00:05:25,-5,5,10
330,OLY,P003941,P008829,0 days 00:04:45,7,12,5
330,OLY,P001255,P003941,0 days 00:03:36,4,9,5
330,OLY,P010612,P011194,0 days 00:02:53,-4,6,10
330,OLY,P007853,P012878,0 days 00:02:29,-4,6,10
330,OLY,P007982,P012878,0 days 00:02:29,-4,6,10
330,OLY,P010612,P012878,0 days 00:02:29,-4,6,10
330,OLY,P011194,P012878,0 days 00:02:29,-4,6,10
330,OLY,P003941,P010612,0 days 00:01:33,3,3,0
331,PAN,P003842,P012774,0 days 00:29:20,9,53,44
331,PAN,P003842,P007866,0 days 00:23:57,9,46,37
331,PAN,P007866,P012774,0 days 00:22:06,4,41,37
331,PAN,P005161,P011204,0 days 00:21:47,17,42,25
331,PAN,P005161,P012774,0 days 00:21:46,16,43,27
331,PAN,P011204,P012774,0 days 00:21:36,18,42,24
331,PAN,P003842,P011204,0 days 00:19:48,21,39,18
331,PAN,P003842,P005161,0 days 00:18:07,14,35,21
331,PAN,P001926,P012774,0 days 00:17:10,5,33,28
331,PAN,P007866,P011204,0 days 00:16:19,16,31,15
331,PAN,P001926,P003842,0 days 00:15:09,-1,25,26
331,PAN,P002328,P003842,0 days 00:13:40,0,23,23
331,PAN,P002328,P007866,0 days 00:13:39,0,23,23
331,PAN,P001926,P002328,0 days 00:13:28,3,26,23
331,PAN,P002328,P012774,0 days 00:13:13,1,26,25
331,PAN,P005161,P007866,0 days 00:12:10,9,25,16
331,PAN,P001926,P007866,0 days 00:11:17,-7,17,24
331,PAN,P011204,P011209,0 days 00:08:13,1,11,10
331,PAN,P011204,P011221,0 days 00:06:13,-4,7,11
331,PAN,P002328,P011204,0 days 00:05:40,6,10,4
331,PAN,P012712,P012774,0 days 00:05:30,2,12,10
331,PAN,P003842,P011209,0 days 00:05:14,4,9,5
331,PAN,P001926,P011204,0 days 00:04:47,9,9,0
331,PAN,P011221,P012712,0 days 00:04:44,-1,10,11
331,PAN,P001926,P005161,0 days 00:04:42,5,10,5
331,PAN,P005161,P011209,0 days 00:04:29,-4,4,8
331,PAN,P011221,P012774,0 days 00:04:13,2,10,8
331,PAN,P005161,P011221,0 days 00:03:45,-4,5,9
331,PAN,P011204,P012712,0 days 00:03:45,-4,5,9
331,PAN,P005161,P012712,0 days 00:03:45,-4,5,9
331,PAN,P002328,P011209,0 days 00:03:44,5,7,2
331,PAN,P007866,P011209,0 days 00:03:44,5,7,2
331,PAN,P011209,P012774,0 days 00:03:22,-1,4,5
331,PAN,P011209,P011221,0 days 00:02:59,-3,2,5
331,PAN,P001926,P012712,0 days 00:02:52,3,7,4
331,PAN,P002328,P012712,0 days 00:02:52,3,7,4
331,PAN,P002328,P011221,0 days 00:02:51,3,7,4
331,PAN,P007866,P011221,0 days 00:02:28,0,2,2
331,PAN,P003842,P012712,0 days 00:01:53,0,2,2
331,PAN,P001926,P011221,0 days 00:01:35,3,5,2
331,PAN,P011209,P012712,0 days 00:01:07,-3,0,3
331,PAN,P002328,P005161,0 days 00:01:01,3,3,0
331,ULK,P001932,P008962,0 days 00:30:44,-10,44,54
331,ULK,P004004,P008962,0 days 00:22:11,1,33,32
331,ULK,P001932,P004004,0 days 00:22:09,-2,30,32
331,ULK,P001932,P006661,0 days 00:18:32,-20,19,39
331,ULK,P001932,P002968,0 days 00:16:59,-1,34,35
331,ULK,P006961,P008962,0 days 00:16:58,4,35,31
331,ULK,P002968,P008962,0 days 00:16:27,4,37,33
331,ULK,P006661,P008962,0 days 00:16:25,-19,16,35
331,ULK,P001932,P006961,0 days 00:16:05,3,32,29
331,ULK,P002968,P006961,0 days 00:14:38,9,35,26
331,ULK,P001932,P011980,0 days 00:14:03,-8,13,21
331,ULK,P002968,P004004,0 days 00:13:29,1,23,22
331,ULK,P004004,P011980,0 days 00:13:27,-10,10,20
331,ULK,P006661,P011980,0 days 00:13:26,-12,13,25
331,ULK,P004004,P006961,0 days 00:12:04,2,21,19
331,ULK,P008962,P011980,0 days 00:11:05,-5,10,15
331,ULK,P002968,P006661,0 days 00:11:04,-7,15,22
331,ULK,P004004,P006661,0 days 00:09:54,-9,7,16
331,ULK,P009849,P011980,0 days 00:08:59,-3,12,15
331,ULK,P006661,P010560,0 days 00:07:47,-14,8,22
331,ULK,P001932,P010560,0 days 00:07:04,-8,8,16
331,ULK,P006661,P009849,0 days 00:06:21,-6,7,13
331,ULK,P002968,P009849,0 days 00:05:39,-4,5,9
331,ULK,P008962,P010560,0 days 00:05:31,-9,5,14
331,ULK,P004004,P009849,0 days 00:05:24,1,8,7
331,ULK,P006661,P006961,0 days 00:05:20,1,11,10
331,ULK,P006961,P011980,0 days 00:04:52,-1,4,5
331,ULK,P002968,P011980,0 days 00:04:46,-5,2,7
331,ULK,P005844,P010560,0 days 00:03:56,-2,8,10
331,ULK,P010560,P011980,0 days 00:03:37,-2,8,10
331,ULK,P005844,P006661,0 days 00:03:37,-2,8,10
331,ULK,P005844,P011980,0 days 00:03:37,-2,8,10
331,ULK,P001932,P009849,0 days 00:03:34,1,5,4
331,ULK,P008962,P011157,0 days 00:03:22,-8,0,8
331,ULK,P006661,P011157,0 days 00:03:22,-8,0,8
331,ULK,P001932,P011157,0 days 00:03:22,-8,0,8
331,ULK,P010560,P011157,0 days 00:03:22,-8,0,8
331,ULK,P008962,P009849,0 days 00:03:02,6,8,2
331,ULK,P006961,P009849,0 days 00:02:21,3,5,2
331,ULK,P001932,P005844,0 days 00:02:16,1,3,2
331,ULK,P009849,P010560,0 days 00:02:04,-3,5,8
331,ULK,P005844,P009849,0 days 00:02:04,-3,5,8
331,ULK,P002968,P010560,0 days 00:01:50,-1,5,6
331,ULK,P006961,P010560,0 days 00:01:02,3,5,2
331,ULK,P004004,P005844,0 days 00:00:43,0,0,0
331,ULK,P005844,P008962,0 days 00:00:43,0,0,0
331,ULK,P005844,P006961,0 days 00:00:24,0,0,0
331,ULK,P004004,P010560,0 days 00:00:19,0,0,0
332,OLY,P007982,P010392,0 days 00:21:36,1,48,47
332,OLY,P003941,P007982,0 days 00:17:47,13,49,36
332,OLY,P007853,P007982,0 days 00:16:19,4,41,37
332,OLY,P007982,P008829,0 days 00:16:06,-2,38,40
332,OLY,P001255,P008829,0 days 00:15:23,-1,30,31
332,OLY,P008829,P008855,0 days 00:15:05,-3,26,29
332,OLY,P003941,P010392,0 days 00:14:07,7,35,28
332,OLY,P001255,P010612,0 days 00:13:54,-8,20,28
332,OLY,P010392,P012878,0 days 00:13:54,-4,27,31
332,OLY,P008829,P010612,0 days 00:13:54,-8,20,28
332,OLY,P007853,P010392,0 days 00:13:16,-2,30,32
332,OLY,P008829,P010392,0 days 00:13:03,2,32,30
332,OLY,P007982,P012878,0 days 00:12:39,-2,25,27
332,OLY,P008855,P010612,0 days 00:12:08,-3,18,21
332,OLY,P001255,P008855,0 days 00:12:08,-3,18,21
332,OLY,P008811,P008855,0 days 00:11:32,-4,15,19
332,OLY,P008811,P008829,0 days 00:11:32,-4,15,19
332,OLY,P007853,P008829,0 days 00:11:29,6,31,25
332,OLY,P008811,P010612,0 days 00:10:57,-4,15,19
332,OLY,P001255,P008811,0 days 00:10:57,-4,15,19
332,OLY,P003941,P008829,0 days 00:10:48,3,32,29
332,OLY,P003941,P007853,0 days 00:09:09,12,29,17
332,OLY,P007853,P012878,0 days 00:07:10,-8,12,20
332,OLY,P010392,P011965,0 days 00:06:50,7,18,11
332,OLY,P011965,P012878,0 days 00:06:44,4,15,11
332,OLY,P001255,P003941,0 days 00:06:22,3,19,16
332,OLY,P007982,P011194,0 days 00:05:55,1,16,15
332,OLY,P008829,P012878,0 days 00:05:54,-4,9,13
332,OLY,P003941,P011965,0 days 00:05:45,4,12,8
332,OLY,P003941,P012878,0 days 00:05:45,4,12,8
332,OLY,P007982,P011965,0 days 00:05:29,6,13,7
332,OLY,P007853,P011194,0 days 00:04:56,1,13,12
332,OLY,P001255,P007982,0 days 00:04:55,4,16,12
332,OLY,P003941,P008855,0 days 00:04:32,1,13,12
332,OLY,P010392,P011194,0 days 00:04:09,-4,9,13
332,OLY,P008855,P010392,0 days 00:03:56,0,10,10
332,OLY,P003941,P011194,0 days 00:03:40,5,10,5
332,OLY,P001255,P007853,0 days 00:03:15,12,17,5
332,OLY,P007982,P008855,0 days 00:02:57,0,8,8
332,OLY,P003941,P010612,0 days 00:02:57,-4,5,9
332,OLY,P011194,P012878,0 days 00:02:15,-4,6,10
332,OLY,P001255,P011194,0 days 00:01:46,5,7,2
332,OLY,P007982,P010612,0 days 00:01:46,-5,2,7
332,OLY,P008855,P011965,0 days 00:00:59,0,2,2
332,OLY,P008855,P012878,0 days 00:00:59,0,2,2
332,OLY,P011194,P011965,0 days 00:00:59,0,3,3
332,OLY,P007982,P008811,0 days 00:00:35,0,0,0
332,OLY,P008811,P010392,0 days 00:00:35,0,0,0
332,OLY,P001255,P010392,0 days 00:00:22,1,3,2
332,OLY,P001255,P011965,0 days 00:00:22,1,3,2
332,OLY,P001255,P012878,0 days 00:00:16,-2,0,2
332,OLY,P007853,P011965,0 days 00:00:06,3,3,0
332,OLY,P008829,P011965,0 days 00:00:06,3,3,0
332,ULK,P006661,P010560,0 days 00:24:18,12,55,43
332,ULK,P001932,P006661,0 days 00:23:39,5,47,42
332,ULK,P006661,P008962,0 days 00:21:50,18,54,36
332,ULK,P008962,P010560,0 days 00:21:50,18,54,36
332,ULK,P001932,P010560,0 days 00:21:09,8,44,36
332,ULK,P002968,P006661,0 days 00:18:55,11,39,28
332,ULK,P002968,P010560,0 days 00:18:55,11,39,28
332,ULK,P001932,P008962,0 days 00:18:41,14,43,29
332,ULK,P002968,P008962,0 days 00:17:35,16,39,23
332,ULK,P001932,P002968,0 days 00:16:57,6,31,25
332,ULK,P004004,P011157,0 days 00:13:11,-8,29,37
332,ULK,P009849,P011157,0 days 00:12:20,-10,26,36
332,ULK,P004004,P009849,0 days 00:12:00,-7,26,33
332,ULK,P009849,P011980,0 days 00:11:30,-6,24,30
332,ULK,P011157,P011980,0 days 00:10:38,-4,24,28
332,ULK,P004004,P011980,0 days 00:10:18,-1,24,25
332,ULK,P001932,P011980,0 days 00:10:12,-10,15,25
332,ULK,P009849,P011052,0 days 00:06:59,-6,15,21
332,ULK,P001932,P011157,0 days 00:06:57,3,19,16
332,ULK,P004004,P011052,0 days 00:06:07,-4,15,19
332,ULK,P011052,P011157,0 days 00:06:07,-4,15,19
332,ULK,P008962,P011157,0 days 00:05:35,-8,13,21
332,ULK,P004004,P008962,0 days 00:05:30,-4,13,17
332,ULK,P011052,P011980,0 days 00:05:17,0,13,13
332,ULK,P001932,P004004,0 days 00:05:14,-1,11,12
332,ULK,P001932,P009849,0 days 00:05:14,-1,11,12
332,ULK,P005844,P006661,0 days 00:04:59,-5,8,13
332,ULK,P001932,P005844,0 days 00:04:59,-5,8,13
332,ULK,P006661,P011980,0 days 00:04:58,-9,4,13
332,ULK,P005844,P011980,0 days 00:04:30,-6,4,10
332,ULK,P011201,P011980,0 days 00:03:42,-8,3,11
332,ULK,P005844,P011201,0 days 00:03:22,-5,3,8
332,ULK,P004004,P010560,0 days 00:03:09,4,11,7
332,ULK,P004004,P006661,0 days 00:03:09,4,11,7
332,ULK,P006661,P011157,0 days 00:02:54,3,11,8
332,ULK,P010560,P011157,0 days 00:02:54,3,11,8
332,ULK,P008962,P009849,0 days 00:02:41,-11,2,13
332,ULK,P006661,P011201,0 days 00:02:30,-3,3,6
332,ULK,P001932,P011201,0 days 00:02:30,-3,3,6
332,ULK,P005844,P010560,0 days 00:02:29,-2,5,7
332,ULK,P010560,P011980,0 days 00:02:28,-6,1,7
332,ULK,P002968,P004004,0 days 00:01:58,5,8,3
332,ULK,P008962,P011052,0 days 00:01:42,-6,2,8
332,ULK,P005844,P008962,0 days 00:01:21,-1,4,5
332,ULK,P002968,P011980,0 days 00:01:20,-5,0,5
332,ULK,P009849,P011201,0 days 00:01:12,-5,0,5
332,ULK,P008962,P011980,0 days 00:00:59,-5,0,5
332,ULK,P005844,P009849,0 days 00:00:52,-2,0,2
332,ULK,P005844,P011052,0 days 00:00:52,-2,0,2
332,ULK,P011052,P011201,0 days 00:00:52,-2,0,2
332,ULK,P008962,P011201,0 days 00:00:20,-3,0,3
332,ULK,P011157,P011201,0 days 00:00:20,-3,0,3
332,ULK,P002968,P009849,0 days 00:00:00,0,0,0
332,ULK,P006661,P009849,0 days 00:00:00,0,0,0
333,MAD,P003108,P006540,0 days 00:25:52,2,60,58
333,MAD,P005928,P006540,0 days 00:20:55,1,50,49
333,MAD,P003108,P005928,0 days 00:20:39,4,52,48
333,MAD,P003108,P005791,0 days 00:18:51,-4,33,37
333,MAD,P005791,P006540,0 days 00:18:04,-12,28,40
333,MAD,P003108,PTGB,0 days 00:15:38,-6,33,39
333,MAD,P005791,P005928,0 days 00:14:51,-8,26,34
333,MAD,P006540,P010357,0 days 00:13:28,-18,14,32
333,MAD,P006540,PTGB,0 days 00:12:18,-9,26,35
333,MAD,P003108,P010357,0 days 00:12:06,-10,15,25
333,MAD,P005791,PTGB,0 days 00:11:57,-10,22,32
333,MAD,P010357,PCVM,0 days 00:11:13,-10,17,27
333,MAD,P003108,P004887,0 days 00:11:09,5,32,27
333,MAD,P003108,PCVM,0 days 00:10:49,-6,16,22
333,MAD,P005928,PTGB,0 days 00:10:29,0,24,24
333,MAD,PBMT,PCVM,0 days 00:10:12,-9,15,24
333,MAD,PCVM,PTGB,0 days 00:10:03,-20,12,32
333,MAD,P004887,PCVM,0 days 00:08:57,-9,13,22
333,MAD,P004887,P010357,0 days 00:08:53,-3,17,20
333,MAD,P005791,P010357,0 days 00:08:44,-16,3,19
333,MAD,P004887,P006540,0 days 00:08:36,10,30,20
333,MAD,P005928,P010357,0 days 00:08:21,-10,8,18
333,MAD,P004887,PTGB,0 days 00:07:26,-4,14,18
333,MAD,P004887,P005928,0 days 00:07:19,8,26,18
333,MAD,P006540,PCVM,0 days 00:07:15,-6,11,17
333,MAD,P003108,P009213,0 days 00:07:09,6,25,19
333,MAD,P006540,P009213,0 days 00:07:09,6,25,19
333,MAD,PBMT,PTGB,0 days 00:07:03,-8,10,18
333,MAD,P010357,PTGB,0 days 00:06:35,-20,5,25
333,MAD,P005791,PCVM,0 days 00:06:33,-5,8,13
333,MAD,P004887,PBMT,0 days 00:06:27,-8,9,17
333,MAD,P005928,P009213,0 days 00:06:06,5,22,17
333,MAD,P010357,PBMT,0 days 00:05:10,-3,9,12
333,MAD,P003108,PBMT,0 days 00:04:42,-5,6,11
333,MAD,P001392,PBMT,0 days 00:04:06,4,11,7
333,MAD,P001392,PCVM,0 days 00:04:02,2,9,7
333,MAD,P001392,P010357,0 days 00:03:59,1,9,8
333,MAD,P001392,P004887,0 days 00:03:37,2,9,7
333,MAD,P005791,PBMT,0 days 00:03:22,-1,6,7
333,MAD,P005791,P009213,0 days 00:03:20,4,10,6
333,MAD,P004887,P009213,0 days 00:02:48,3,14,11
333,MAD,P009213,P010357,0 days 00:01:03,1,3,2
333,MAD,P001392,PTGB,0 days 00:00:53,3,4,1
333,MAD,P009213,PCVM,0 days 00:00:44,3,3,0
333,MAD,P001392,P003108,0 days 00:00:21,-2,0,2
333,MAD,P001392,P009213,0 days 00:00:21,0,2,2
333,MAD,P001392,P006540,0 days 00:00:19,-2,0,2
333,MAD,P009213,PBMT,0 days 00:00:02,2,2,0
333,MAD,P009213,PTGB,0 days 00:00:02,2,2,0
333,MAD,P001392,P005791,0 days 00:00:02,0,0,0
333,PAN,P003842,P011204,0 days 00:25:53,18,67,49
333,PAN,P003842,P012774,0 days 00:20:54,9,54,45
333,PAN,P011204,P012774,0 days 00:20:04,12,53,41
333,PAN,P001926,P003842,0 days 00:19:38,4,43,39
333,PAN,P001926,P011204,0 days 00:17:38,12,42,30
333,PAN,P007866,P012774,0 days 00:17:16,3,48,45
333,PAN,P011204,P012712,0 days 00:16:42,12,34,22
333,PAN,P007866,P011204,0 days 00:15:59,6,47,41
333,PAN,P003842,P012712,0 days 00:15:56,8,34,26
333,PAN,P003842,P005161,0 days 00:15:29,4,36,32
333,PAN,P005161,P011204,0 days 00:15:24,5,38,33
333,PAN,P003842,P007866,0 days 00:14:00,3,41,38
333,PAN,P001926,P012774,0 days 00:13:14,11,37,26
333,PAN,P003842,P007947,0 days 00:12:31,10,28,18
333,PAN,P001926,P012712,0 days 00:12:02,-6,20,26
333,PAN,P001926,P007866,0 days 00:10:38,15,34,19
333,PAN,P007947,P012712,0 days 00:10:37,10,26,16
333,PAN,P005161,P012774,0 days 00:09:40,-5,26,31
333,PAN,P007947,P011204,0 days 00:09:34,11,24,13
333,PAN,P005161,P007866,0 days 00:08:58,-7,24,31
333,PAN,P001926,P005161,0 days 00:08:49,6,17,11
333,PAN,P012712,P012774,0 days 00:06:38,4,11,7
333,PAN,P001926,P002328,0 days 00:06:16,-4,11,15
333,PAN,P005161,P012712,0 days 00:06:06,7,13,6
333,PAN,P001926,P007947,0 days 00:05:53,-3,10,13
333,PAN,P002328,P012712,0 days 00:05:14,-5,10,15
333,PAN,P003842,P011209,0 days 00:05:01,7,14,7
333,PAN,P005161,P007947,0 days 00:05:00,8,12,4
333,PAN,P007947,P012774,0 days 00:04:50,5,8,3
333,PAN,P005161,P011209,0 days 00:03:56,0,6,6
333,PAN,P007947,P011209,0 days 00:03:56,5,10,5
333,PAN,P002328,P003842,0 days 00:03:30,-3,7,10
333,PAN,P011221,P012712,0 days 00:03:10,-2,5,7
333,PAN,P011204,P011221,0 days 00:03:10,-2,5,7
333,PAN,P002328,P011221,0 days 00:03:10,-2,5,7
333,PAN,P002328,P011204,0 days 00:03:10,-2,5,7
333,PAN,P001926,P011209,0 days 00:03:06,2,6,4
333,PAN,P011204,P011209,0 days 00:02:58,0,9,9
333,PAN,P002328,P012774,0 days 00:02:53,-1,5,6
333,PAN,P001926,P011221,0 days 00:02:46,-1,4,5
333,PAN,P011209,P012712,0 days 00:02:08,2,9,7
333,PAN,P002328,P007866,0 days 00:01:26,0,2,2
333,PAN,P011209,P012774,0 days 00:01:19,-2,2,4
333,PAN,P002328,P011209,0 days 00:00:51,-1,3,4
333,PAN,P007866,P007947,0 days 00:00:43,2,2,0
333,PAN,P007866,P012712,0 days 00:00:43,2,2,0
333,PAN,P007866,P011209,0 days 00:00:37,-4,0,4
333,PAN,P011209,P011221,0 days 00:00:24,-1,1,2
333,PAN,P002328,P005161,0 days 00:00:10,-2,0,2
