GAMECODE,CODETEAM,joueur_1,joueur_2,TIME,DELTA_SCORE,OFF,DEF
1,BER,P006919,P008780,0 days 00:23:42,-8,40,48
1,BER,P007025,P008780,0 days 00:21:09,-7,34,41
1,BER,P008780,P010791,0 days 00:20:22,-5,35,40
1,BER,P006919,P007025,0 days 00:19:36,-10,29,39
1,BER,P006919,P010791,0 days 00:16:46,-14,23,37
1,BER,P007025,P010791,0 days 00:16:10,-12,23,35
1,BER,P006919,P012604,0 days 00:15:11,0,32,32
1,BER,P008062,P012721,0 days 00:14:18,-6,31,37
1,BER,P011934,P012604,0 days 00:14:09,-10,26,36
1,BER,P008173,P011934,0 days 00:13:39,-12,28,40
1,BER,P008780,P012604,0 days 00:13:38,2,30,28
1,BER,P008173,P012721,0 days 00:13:12,-5,28,33
1,BER,P008062,P008173,0 days 00:12:42,-11,25,36
1,BER,P008062,P012604,0 days 00:12:36,-9,26,35
1,BER,P012604,P012721,0 days 00:12:32,-2,29,31
1,BER,P008062,P011934,0 days 00:12:03,-11,25,36
1,BER,P008173,P012604,0 days 00:11:12,-8,22,30
1,BER,P007025,P012604,0 days 00:11:08,-1,22,23
1,BER,P011934,P012721,0 days 00:11:06,-9,23,32
1,BER,P008780,P011631,0 days 00:10:49,0,17,17
1,BER,P010791,P011631,0 days 00:10:49,0,17,17
1,BER,P007025,P011631,0 days 00:08:46,-6,10,16
1,BER,P006919,P011934,0 days 00:07:57,-3,13,16
1,BER,P006919,P011631,0 days 00:07:16,-9,5,14
1,BER,P008780,P011934,0 days 00:07:00,-1,11,12
1,BER,P010791,P012604,0 days 00:06:42,-4,13,17
1,BER,P008780,P012721,0 days 00:06:23,15,23,8
1,BER,P008173,P010791,0 days 00:05:39,4,15,11
1,BER,P010791,P012721,0 days 00:05:39,8,17,9
1,BER,P007025,P011934,0 days 00:05:24,0,8,8
1,BER,P010791,P011934,0 days 00:04:54,-2,10,12
1,BER,P006919,P008173,0 days 00:03:45,-1,7,8
1,BER,P008173,P008780,0 days 00:03:36,5,10,5
1,BER,P006919,P008062,0 days 00:03:33,-1,8,9
1,BER,P011631,P012721,0 days 00:03:33,9,12,3
1,BER,P006919,P012721,0 days 00:03:26,6,11,5
1,BER,P008062,P010791,0 days 00:02:39,1,7,6
1,BER,P008062,P008780,0 days 00:02:33,3,8,5
1,BER,P007025,P012721,0 days 00:02:23,8,10,2
1,BER,P008173,P011631,0 days 00:01:27,4,5,1
1,BER,P008062,P011631,0 days 00:00:36,2,2,0
1,PAN,P003842,P012774,0 days 00:24:19,14,52,38
1,PAN,P011204,P012712,0 days 00:21:16,-4,49,53
1,PAN,P009622,P012774,0 days 00:18:04,20,43,23
1,PAN,P002328,P003842,0 days 00:17:15,11,36,25
1,PAN,P002328,P012774,0 days 00:15:53,12,31,19
1,PAN,P003842,P007866,0 days 00:14:56,8,30,22
1,PAN,P007866,P012774,0 days 00:14:56,8,30,22
1,PAN,P003842,P009622,0 days 00:13:43,9,28,19
1,PAN,P012712,P012774,0 days 00:13:29,1,31,30
1,PAN,P011204,P012774,0 days 00:13:29,1,31,30
1,PAN,P005353,P011204,0 days 00:12:52,2,30,28
1,PAN,P005353,P012712,0 days 00:12:52,2,30,28
1,PAN,P002328,P007866,0 days 00:12:05,6,23,17
1,PAN,P001926,P003842,0 days 00:11:42,4,29,25
1,PAN,P002328,P009622,0 days 00:10:40,12,23,11
1,PAN,P001926,P012774,0 days 00:10:20,5,24,19
1,PAN,P001926,P012712,0 days 00:09:32,5,30,25
1,PAN,P001926,P011204,0 days 00:09:32,5,30,25
1,PAN,P004088,P012712,0 days 00:09:24,-9,15,24
1,PAN,P004088,P011204,0 days 00:09:24,-9,15,24
1,PAN,P005353,P012774,0 days 00:09:18,2,20,18
1,PAN,P007866,P009622,0 days 00:08:28,8,20,12
1,PAN,P003842,P011204,0 days 00:08:24,-6,19,25
1,PAN,P003842,P012712,0 days 00:08:24,-6,19,25
1,PAN,P004088,P012774,0 days 00:08:14,2,14,12
1,PAN,P009622,P011204,0 days 00:07:55,1,17,16
1,PAN,P009622,P012712,0 days 00:07:55,1,17,16
1,PAN,P005353,P009622,0 days 00:07:52,7,20,13
1,PAN,P003842,P004088,0 days 00:07:35,2,12,10
1,PAN,P004088,P005353,0 days 00:07:04,-4,15,19
1,PAN,P001926,P002328,0 days 00:06:35,-1,13,14
1,PAN,P001926,P007866,0 days 00:06:28,0,10,10
1,PAN,P004088,P009622,0 days 00:06:07,2,12,10
1,PAN,P001926,P004088,0 days 00:05:33,1,13,12
1,PAN,P001926,P005353,0 days 00:04:18,1,11,10
1,PAN,P004088,P007866,0 days 00:02:51,2,7,5
1,PAN,P002328,P004088,0 days 00:02:24,5,5,0
1,PAN,P002328,P005353,0 days 00:01:24,1,3,2
1,PAN,P003842,P005353,0 days 00:01:24,1,3,2
1,PAN,P002328,P011204,0 days 00:01:22,-1,5,6
1,PAN,P002328,P012712,0 days 00:01:22,-1,5,6
1,PAN,P003842,P011209,0 days 00:00:50,-5,0,5
1,PAN,P011204,P011209,0 days 00:00:50,-5,0,5
1,PAN,P011209,P012712,0 days 00:00:50,-5,0,5
1,PAN,P011209,P012774,0 days 00:00:50,-5,0,5
2,MCO,P008099,P011212,0 days 00:21:26,4,51,47
2,MCO,P002581,P011226,0 days 00:20:36,4,49,45
2,MCO,P011226,PLCZ,0 days 00:19:23,2,40,38
2,MCO,P011212,P011231,0 days 00:18:31,8,48,40
2,MCO,P005844,P008099,0 days 00:18:08,6,41,35
2,MCO,P005844,P011212,0 days 00:18:08,6,41,35
2,MCO,P005985,P011226,0 days 00:17:57,6,39,33
2,MCO,P002581,P005985,0 days 00:17:18,6,39,33
2,MCO,P008099,P011231,0 days 00:17:03,8,43,35
2,MCO,P005844,P011231,0 days 00:16:45,12,42,30
2,MCO,P002581,PLCZ,0 days 00:16:44,5,38,33
2,MCO,P011212,P011226,0 days 00:15:44,7,40,33
2,MCO,P005985,PLCZ,0 days 00:15:37,9,35,26
2,MCO,P005763,P005985,0 days 00:14:20,4,30,26
2,MCO,P005763,P011226,0 days 00:13:43,1,27,26
2,MCO,P002581,P005763,0 days 00:13:04,1,27,26
2,MCO,P005763,PLCZ,0 days 00:12:51,4,28,24
2,MCO,P008099,P011226,0 days 00:11:30,2,28,26
2,MCO,P011212,PLCZ,0 days 00:10:40,3,23,20
2,MCO,P011226,P011231,0 days 00:10:04,6,27,21
2,MCO,P005844,P011226,0 days 00:08:51,4,18,14
2,MCO,P008099,PLCZ,0 days 00:07:54,-2,16,18
2,MCO,P002581,P011212,0 days 00:07:32,3,22,19
2,MCO,P005844,PLCZ,0 days 00:06:47,2,13,11
2,MCO,P011212,P013365,0 days 00:06:25,0,15,15
2,MCO,P011231,P013365,0 days 00:06:25,0,15,15
2,MCO,P008099,P013365,0 days 00:06:25,0,15,15
2,MCO,P005844,P013365,0 days 00:06:25,0,15,15
2,MCO,P005985,P011212,0 days 00:04:14,5,12,7
2,MCO,P011231,PLCZ,0 days 00:04:08,5,11,6
2,MCO,P002581,P011231,0 days 00:03:52,-1,11,12
2,MCO,P005985,P011231,0 days 00:03:34,3,10,7
2,MCO,P002581,P008099,0 days 00:03:18,-2,10,12
2,MCO,P005763,P011231,0 days 00:02:06,3,5,2
2,MCO,P005763,P005844,0 days 00:01:16,3,3,0
2,MCO,P005844,P005985,0 days 00:01:16,3,3,0
2,MIL,P000796,P007831,0 days 00:27:19,-15,53,68
2,MIL,P007831,P011199,0 days 00:21:43,-12,41,53
2,MIL,P000796,P011199,0 days 00:20:43,-9,41,50
2,MIL,P000796,P006085,0 days 00:18:37,-5,46,51
2,MIL,P006085,P007831,0 days 00:18:37,-5,46,51
2,MIL,P008987,P013384,0 days 00:15:16,1,34,33
2,MIL,P001392,P007831,0 days 00:13:32,-11,16,27
2,MIL,P008985,P011199,0 days 00:13:11,-14,19,33
2,MIL,P007831,P008985,0 days 00:13:11,-14,19,33
2,MIL,P000796,P001392,0 days 00:12:50,-10,16,26
2,MIL,P006085,P011199,0 days 00:12:42,-2,34,36
2,MIL,P000796,P008985,0 days 00:12:11,-11,19,30
2,MIL,P001392,P008985,0 days 00:11:17,-6,12,18
2,MIL,P013384,P013386,0 days 00:11:00,8,27,19
2,MIL,P008987,P013386,0 days 00:11:00,8,27,19
2,MIL,P006085,P008987,0 days 00:10:38,-9,18,27
2,MIL,P008985,P008987,0 days 00:10:38,6,25,19
2,MIL,P001392,P011199,0 days 00:10:31,-9,11,20
2,MIL,P008985,P013384,0 days 00:09:38,9,25,16
2,MIL,P008985,P013386,0 days 00:09:38,9,25,16
2,MIL,P001518,P006085,0 days 00:09:28,-4,20,24
2,MIL,P006085,P013384,0 days 00:09:02,-9,15,24
2,MIL,P001518,P011199,0 days 00:08:24,-5,18,23
2,MIL,P001518,P007831,0 days 00:07:43,-2,18,20
2,MIL,P000796,P001518,0 days 00:07:25,0,18,18
2,MIL,P006085,P008985,0 days 00:06:53,-2,18,20
2,MIL,P006085,P013386,0 days 00:06:11,-4,10,14
2,MIL,P007831,P008987,0 days 00:06:11,-7,10,17
2,MIL,P000796,P008987,0 days 00:05:11,-4,10,14
2,MIL,P006509,P013384,0 days 00:04:21,5,14,9
2,MIL,P006509,P013386,0 days 00:04:21,5,14,9
2,MIL,P006509,P008985,0 days 00:04:21,5,14,9
2,MIL,P006509,P008987,0 days 00:04:21,5,14,9
2,MIL,P001392,P008987,0 days 00:04:11,4,8,4
2,MIL,P001392,P006085,0 days 00:04:08,0,9,9
2,MIL,P000796,P013384,0 days 00:03:35,-4,7,11
2,MIL,P007831,P013384,0 days 00:03:35,-4,7,11
2,MIL,P001392,P013386,0 days 00:03:18,3,7,4
2,MIL,P001518,P008987,0 days 00:02:21,-6,2,8
2,MIL,P001518,P013384,0 days 00:02:03,-4,2,6
2,MIL,P001392,P013384,0 days 00:01:53,5,5,0
2,MIL,P008987,P011199,0 days 00:01:41,-6,0,6
2,MIL,P000796,P013386,0 days 00:01:25,-2,2,4
2,MIL,P007831,P013386,0 days 00:01:25,-2,2,4
2,MIL,P001518,P013386,0 days 00:01:22,-1,2,3
2,MIL,P011199,P013384,0 days 00:00:41,-3,0,3
2,MIL,P001518,P008985,0 days 00:00:18,-2,0,2
3,ZAL,P002676,P007513,0 days 00:20:18,0,42,42
3,ZAL,P007513,P011983,0 days 00:20:09,-1,37,38
3,ZAL,P002676,P011983,0 days 00:17:59,3,37,34
3,ZAL,P002676,P005504,0 days 00:17:50,-3,34,37
3,ZAL,P005504,P007513,0 days 00:15:33,-6,27,33
3,ZAL,P005504,P011983,0 days 00:15:12,-1,28,29
3,ZAL,P002676,P007975,0 days 00:14:13,7,33,26
3,ZAL,P007513,P007975,0 days 00:13:34,6,34,28
3,ZAL,P002329,P012622,0 days 00:13:30,3,13,10
3,ZAL,P011983,P012622,0 days 00:11:20,9,22,13
3,ZAL,P003048,P012622,0 days 00:11:19,0,16,16
3,ZAL,P005504,P007975,0 days 00:11:11,3,22,19
3,ZAL,P003048,P007513,0 days 00:10:56,11,30,19
3,ZAL,P011925,P011983,0 days 00:09:57,3,16,13
3,ZAL,P007975,P011983,0 days 00:09:52,5,21,16
3,ZAL,P002329,P003048,0 days 00:09:23,7,17,10
3,ZAL,P002676,P011925,0 days 00:08:58,-6,16,22
3,ZAL,P011925,P012622,0 days 00:08:53,-3,10,13
3,ZAL,P007029,P012622,0 days 00:08:19,-7,6,13
3,ZAL,P003048,P007029,0 days 00:08:16,3,17,14
3,ZAL,P002676,P012622,0 days 00:08:07,0,21,21
3,ZAL,P007513,P012622,0 days 00:08:06,1,17,16
3,ZAL,P002329,P011983,0 days 00:07:40,5,11,6
3,ZAL,P002329,P007029,0 days 00:07:31,2,10,8
3,ZAL,P003048,P011983,0 days 00:07:17,5,16,11
3,ZAL,P002676,P003048,0 days 00:06:59,3,19,16
3,ZAL,P005504,P011925,0 days 00:06:58,-11,8,19
3,ZAL,P007513,P011925,0 days 00:06:47,-1,12,13
3,ZAL,P002329,P011925,0 days 00:06:42,2,6,4
3,ZAL,P002329,P007513,0 days 00:06:11,5,15,10
3,ZAL,P007975,P012622,0 days 00:06:08,6,13,7
3,ZAL,P007029,P007975,0 days 00:05:54,5,14,9
3,ZAL,P005504,P012622,0 days 00:05:53,-1,14,15
3,ZAL,P003048,P007975,0 days 00:05:46,8,19,11
3,ZAL,P007029,P011925,0 days 00:05:43,-7,6,13
3,ZAL,P003048,P011925,0 days 00:05:32,3,10,7
3,ZAL,P002676,P007029,0 days 00:04:52,-4,10,14
3,ZAL,P011051,P012622,0 days 00:04:25,4,4,0
3,ZAL,P002329,P011051,0 days 00:04:25,4,4,0
3,ZAL,P007029,P007513,0 days 00:04:22,5,14,9
3,ZAL,P002329,P007975,0 days 00:03:31,4,8,4
3,ZAL,P011051,P011925,0 days 00:03:10,4,4,0
3,ZAL,P011051,P011983,0 days 00:03:10,4,4,0
3,ZAL,P005504,P007029,0 days 00:02:52,-5,3,8
3,ZAL,P002329,P005504,0 days 00:01:23,-4,0,4
3,ZAL,P007029,P011051,0 days 00:01:15,0,0,0
3,ZAL,P007975,P011051,0 days 00:00:47,0,0,0
3,ZAL,P002329,P003210,0 days 00:00:28,0,0,0
3,ZAL,P003210,P007029,0 days 00:00:28,0,0,0
3,ZAL,P003210,P011051,0 days 00:00:28,0,0,0
3,ZAL,P003210,P012622,0 days 00:00:28,0,0,0
3,BAR,P003478,P006435,0 days 00:18:59,6,34,28
3,BAR,P002939,P012745,0 days 00:18:40,7,36,29
3,BAR,P002939,P009862,0 days 00:18:06,-17,25,42
3,BAR,P000925,P006435,0 days 00:15:44,8,22,14
3,BAR,P003478,P013379,0 days 00:15:42,-11,25,36
3,BAR,P009862,P012745,0 days 00:15:30,-3,27,30
3,BAR,P000925,P002939,0 days 00:15:10,-2,22,24
3,BAR,P000925,P003478,0 days 00:14:50,-6,18,24
3,BAR,P006435,P013379,0 days 00:14:10,2,27,25
3,BAR,P006435,P012745,0 days 00:13:59,12,29,17
3,BAR,P002939,P003478,0 days 00:13:55,3,32,29
3,BAR,P002939,P006435,0 days 00:13:22,15,31,16
3,BAR,P009862,P013379,0 days 00:13:18,-9,24,33
3,BAR,P009862,P012795,0 days 00:13:11,-9,18,27
3,BAR,P002939,P012795,0 days 00:11:42,-12,16,28
3,BAR,P003196,P009862,0 days 00:11:34,-4,23,27
3,BAR,P002939,P013379,0 days 00:11:31,-9,21,30
3,BAR,P003478,P012745,0 days 00:10:56,9,24,15
3,BAR,P000925,P013379,0 days 00:10:28,-12,7,19
3,BAR,P000925,P012745,0 days 00:10:20,5,17,12
3,BAR,P002939,P003196,0 days 00:09:34,-5,17,22
3,BAR,P000925,P009862,0 days 00:09:22,-12,10,22
3,BAR,P012745,P012795,0 days 00:09:13,-8,13,21
3,BAR,P006435,P009862,0 days 00:08:21,4,19,15
3,BAR,P003196,P012795,0 days 00:08:07,-7,12,19
3,BAR,P003478,P009862,0 days 00:07:52,-10,16,26
3,BAR,P012795,P013379,0 days 00:07:37,0,15,15
3,BAR,P003196,P012745,0 days 00:07:05,-4,12,16
3,BAR,P012745,P013379,0 days 00:06:33,5,16,11
3,BAR,P010106,P013379,0 days 00:06:32,2,6,4
3,BAR,P006435,P010106,0 days 00:05:35,-3,2,5
3,BAR,P003478,P010106,0 days 00:05:14,-5,0,5
3,BAR,P000925,P010106,0 days 00:04:48,-5,0,5
3,BAR,P003196,P013379,0 days 00:04:29,0,11,11
3,BAR,P010106,P012745,0 days 00:03:36,1,6,5
3,BAR,P003196,P003478,0 days 00:03:27,3,11,8
3,BAR,P000925,P012795,0 days 00:02:30,-4,0,4
3,BAR,P009862,P010106,0 days 00:02:14,4,6,2
3,BAR,P003196,P006435,0 days 00:02:00,1,6,5
3,BAR,P010106,P012795,0 days 00:01:53,2,4,2
3,BAR,P006435,P012795,0 days 00:01:46,-1,6,7
3,BAR,P003478,P012795,0 days 00:01:05,-1,4,5
4,BAS,P012080,P012201,0 days 00:26:18,10,58,48
4,BAS,P007230,P012080,0 days 00:24:56,-5,54,59
4,BAS,P007230,P012201,0 days 00:22:33,-2,49,51
4,BAS,P011196,P012201,0 days 00:22:20,4,49,45
4,BAS,P012201,P013367,0 days 00:20:52,10,52,42
4,BAS,P012080,P013367,0 days 00:20:14,4,49,45
4,BAS,P011196,P012080,0 days 00:19:26,7,45,38
4,BAS,P007230,P013367,0 days 00:18:10,-1,45,46
4,BAS,P007230,P011196,0 days 00:17:07,-1,36,37
4,BAS,P011196,P013367,0 days 00:16:51,9,43,34
4,BAS,P011948,P012201,0 days 00:15:32,11,34,23
4,BAS,P008072,P011948,0 days 00:13:40,4,31,27
4,BAS,P012201,P012597,0 days 00:13:30,-3,20,23
4,BAS,P008072,P012201,0 days 00:12:37,4,27,23
4,BAS,P011948,P012597,0 days 00:11:47,0,20,20
4,BAS,P011948,P012080,0 days 00:11:00,11,28,17
4,BAS,P008072,P012080,0 days 00:10:59,1,25,24
4,BAS,P008072,P012597,0 days 00:10:49,3,22,19
4,BAS,P012080,P012597,0 days 00:10:39,4,21,17
4,BAS,P007230,P008072,0 days 00:09:33,-3,25,28
4,BAS,P007230,P012597,0 days 00:08:58,-3,16,19
4,BAS,P011948,P013367,0 days 00:07:17,8,22,14
4,BAS,P007230,P011948,0 days 00:07:15,-1,19,20
4,BAS,P011085,P012201,0 days 00:06:55,-3,11,14
4,BAS,P011085,P011948,0 days 00:06:55,-3,11,14
4,BAS,P011196,P011948,0 days 00:05:59,5,15,10
4,BAS,P011085,P012597,0 days 00:05:52,-4,7,11
4,BAS,P011196,P012597,0 days 00:05:29,-5,6,11
4,BAS,P008072,P013367,0 days 00:05:20,-2,13,15
4,BAS,P008072,P011085,0 days 00:04:47,0,9,9
4,BAS,P011085,P011196,0 days 00:02:08,-3,2,5
4,BAS,P004058,P008072,0 days 00:01:03,1,4,3
4,BAS,P004058,P011085,0 days 00:01:03,1,4,3
4,BAS,P004058,P011948,0 days 00:01:03,1,4,3
4,BAS,P004058,P012201,0 days 00:01:03,1,4,3
4,PAR,P011981,P012720,0 days 00:22:33,-10,38,48
4,PAR,P007870,P011981,0 days 00:21:51,-8,38,46
4,PAR,P010781,P012720,0 days 00:20:39,3,39,36
4,PAR,P004761,P011981,0 days 00:20:32,3,45,42
4,PAR,P004761,P007870,0 days 00:20:20,7,47,40
4,PAR,P010781,P011981,0 days 00:20:03,-3,35,38
4,PAR,P007870,P012720,0 days 00:17:46,-6,28,34
4,PAR,P004761,P006760,0 days 00:17:31,-2,44,46
4,PAR,P004761,P010781,0 days 00:17:29,2,43,41
4,PAR,P006591,P013369,0 days 00:17:05,-7,35,42
4,PAR,P007870,P013369,0 days 00:16:54,-6,38,44
4,PAR,P004761,P012720,0 days 00:16:22,4,37,33
4,PAR,P007870,P010781,0 days 00:15:52,3,31,28
4,PAR,P006591,P007870,0 days 00:15:33,-8,30,38
4,PAR,P006760,P011981,0 days 00:14:51,-6,30,36
4,PAR,P006760,P007870,0 days 00:14:16,-2,32,34
4,PAR,P006760,P010781,0 days 00:13:56,-3,32,35
4,PAR,P011981,P013369,0 days 00:13:05,-6,26,32
4,PAR,P006760,P013369,0 days 00:12:36,2,29,27
4,PAR,P004761,P013369,0 days 00:12:03,6,31,25
4,PAR,P006591,P011981,0 days 00:11:57,-6,24,30
4,PAR,P006760,P012720,0 days 00:11:40,-1,24,25
4,PAR,P004761,P006591,0 days 00:11:27,4,25,21
4,PAR,P006591,P006760,0 days 00:09:42,0,21,21
4,PAR,P012720,P013369,0 days 00:05:19,-11,5,16
4,PAR,P006591,P012720,0 days 00:04:57,-11,5,16
4,PAR,P010781,P013369,0 days 00:02:54,2,8,6
4,PAR,P006591,P010781,0 days 00:00:47,0,0,0
5,MUN,P007056,P007201,0 days 00:23:21,10,54,44
5,MUN,P011224,P011987,0 days 00:23:11,21,66,45
5,MUN,P001288,P007201,0 days 00:22:50,-14,44,58
5,MUN,P007201,P011987,0 days 00:20:47,-4,45,49
5,MUN,P001557,P011987,0 days 00:18:36,15,53,38
5,MUN,P001557,P011224,0 days 00:17:06,19,51,32
5,MUN,P007201,P011224,0 days 00:17:03,7,41,34
5,MUN,P007201,P010391,0 days 00:16:52,-11,33,44
5,MUN,P001288,P010391,0 days 00:16:17,-4,36,40
5,MUN,P001288,P007056,0 days 00:15:42,0,31,31
5,MUN,P007056,P011987,0 days 00:13:25,12,33,21
5,MUN,P011244,P011987,0 days 00:13:20,1,33,32
5,MUN,P001288,P004508,0 days 00:13:05,-2,27,29
5,MUN,P004508,P007201,0 days 00:13:05,-2,27,29
5,MUN,P004508,P010391,0 days 00:13:05,-2,27,29
5,MUN,P007056,P011224,0 days 00:12:33,14,31,17
5,MUN,P001557,P007201,0 days 00:12:28,1,28,27
5,MUN,P007056,P010391,0 days 00:12:24,-1,26,27
5,MUN,P004508,P007056,0 days 00:11:32,1,24,23
5,MUN,P011224,P011244,0 days 00:11:06,8,31,23
5,MUN,P001288,P011987,0 days 00:10:02,-7,22,29
5,MUN,P001557,P007056,0 days 00:09:15,13,26,13
5,MUN,P001557,P011244,0 days 00:09:14,7,25,18
5,MUN,P007201,P011244,0 days 00:09:02,-11,16,27
5,MUN,P001288,P011224,0 days 00:07:10,2,20,18
5,MUN,P001288,P011244,0 days 00:05:39,-9,11,20
5,MUN,P001557,P007639,0 days 00:04:15,6,17,11
5,MUN,P007639,P011987,0 days 00:04:15,6,17,11
5,MUN,P007639,P011244,0 days 00:04:15,6,17,11
5,MUN,P007639,P011224,0 days 00:04:15,6,17,11
5,MUN,P010391,P011987,0 days 00:04:04,-4,11,15
5,MUN,P010391,P011244,0 days 00:03:47,-10,5,15
5,MUN,P001557,P010391,0 days 00:01:47,1,7,6
5,MUN,P001288,P001557,0 days 00:01:43,-2,5,7
5,MUN,P007056,P011244,0 days 00:01:36,3,3,0
5,MUN,P004508,P011244,0 days 00:01:33,-3,3,6
5,MUN,P010391,P011224,0 days 00:00:20,7,7,0
5,MAD,P005928,P006540,0 days 00:19:54,8,47,39
5,MAD,P005791,P005928,0 days 00:19:34,3,45,42
5,MAD,P003733,P005928,0 days 00:17:06,9,42,33
5,MAD,P003583,P009005,0 days 00:16:26,-7,40,47
5,MAD,P005791,P006540,0 days 00:16:06,0,34,34
5,MAD,P005928,P009005,0 days 00:14:54,2,33,31
5,MAD,P009005,P013378,0 days 00:14:27,-9,34,43
5,MAD,P006540,P009213,0 days 00:14:04,1,29,28
5,MAD,P003733,P005791,0 days 00:14:04,12,38,26
5,MAD,P009005,PTGB,0 days 00:13:55,-16,23,39
5,MAD,P005928,P009213,0 days 00:12:31,2,29,27
5,MAD,P003733,P009213,0 days 00:12:28,4,29,25
5,MAD,P003733,P006540,0 days 00:12:28,4,29,25
5,MAD,P005791,P009213,0 days 00:12:28,4,29,25
5,MAD,P006540,P009005,0 days 00:11:48,-3,25,28
5,MAD,P009005,P011247,0 days 00:11:38,-11,23,34
5,MAD,P003583,P011247,0 days 00:10:07,-10,21,31
5,MAD,P005928,PTGB,0 days 00:09:32,-9,15,24
5,MAD,P003583,P013378,0 days 00:08:40,-8,25,33
5,MAD,P005791,P009005,0 days 00:08:37,-2,18,20
5,MAD,P003583,P006540,0 days 00:08:10,1,20,19
5,MAD,P009005,P011649,0 days 00:07:28,2,22,20
5,MAD,P011247,P013378,0 days 00:07:24,-9,16,25
5,MAD,P003583,P011649,0 days 00:07:17,2,22,20
5,MAD,P005791,PTGB,0 days 00:06:57,-7,13,20
5,MAD,P013378,PTGB,0 days 00:06:24,-14,8,22
5,MAD,P005928,P013378,0 days 00:06:03,3,14,11
5,MAD,P011247,P011649,0 days 00:05:22,-1,16,17
5,MAD,P003583,P005928,0 days 00:05:19,6,15,9
5,MAD,P005791,P013378,0 days 00:04:52,-1,9,10
5,MAD,P003733,P009005,0 days 00:04:38,5,13,8
5,MAD,P003733,PTGB,0 days 00:04:38,5,13,8
5,MAD,P007630,P009005,0 days 00:04:38,-4,9,13
5,MAD,P003583,PTGB,0 days 00:04:29,-6,8,14
5,MAD,P006540,P011247,0 days 00:04:14,-2,7,9
5,MAD,P006540,P011649,0 days 00:03:58,2,11,9
5,MAD,P011649,P013378,0 days 00:03:30,0,11,11
5,MAD,P011247,PTGB,0 days 00:03:23,-4,4,8
5,MAD,P007630,PTGB,0 days 00:03:21,-1,6,7
5,MAD,P006540,P013378,0 days 00:03:21,5,12,7
5,MAD,P007630,P013378,0 days 00:03:04,-1,7,8
5,MAD,P006540,PTGB,0 days 00:03:01,-12,2,14
5,MAD,P005928,P007630,0 days 00:02:29,-3,2,5
5,MAD,P003583,P007630,0 days 00:02:09,-1,7,8
5,MAD,P005928,P011649,0 days 00:02:06,3,6,3
5,MAD,P009005,P009213,0 days 00:01:39,-5,0,5
5,MAD,P003583,P009213,0 days 00:01:39,-5,0,5
5,MAD,P009213,P011247,0 days 00:01:36,-3,0,3
5,MAD,P003733,P007630,0 days 00:01:34,-3,2,5
5,MAD,P005791,P011247,0 days 00:01:31,-1,2,3
5,MAD,P003583,P003733,0 days 00:01:28,0,2,2
5,MAD,P007630,P011247,0 days 00:01:17,-3,3,6
5,MAD,P005791,P011649,0 days 00:00:11,0,0,0
5,MAD,P009213,P013378,0 days 00:00:03,-2,0,2
6,TEL,P011193,P013382,0 days 00:26:15,16,65,49
6,TEL,P011193,P011214,0 days 00:24:02,7,56,49
6,TEL,P009754,P011193,0 days 00:23:23,21,67,46
6,TEL,P009754,P011214,0 days 00:22:45,8,54,46
6,TEL,P011214,P013382,0 days 00:22:37,4,50,46
6,TEL,P009754,P013382,0 days 00:20:47,19,59,40
6,TEL,P011219,P013382,0 days 00:19:22,6,51,45
6,TEL,P011193,P011219,0 days 00:18:39,9,51,42
6,TEL,P009754,P011219,0 days 00:15:34,9,47,38
6,TEL,P011214,P011219,0 days 00:15:19,4,40,36
6,TEL,P006835,P007519,0 days 00:15:06,-11,24,35
6,TEL,P006835,P007990,0 days 00:12:59,-4,22,26
6,TEL,P007990,P013382,0 days 00:10:48,5,20,15
6,TEL,P006835,P011214,0 days 00:10:27,-6,18,24
6,TEL,P006835,P011193,0 days 00:10:14,10,27,17
6,TEL,P006835,P009754,0 days 00:09:56,11,29,18
6,TEL,P007990,P011214,0 days 00:09:40,0,18,18
6,TEL,P006835,P013382,0 days 00:09:39,4,21,17
6,TEL,P007519,P007990,0 days 00:09:25,-9,14,23
6,TEL,P007519,P011214,0 days 00:09:06,-5,16,21
6,TEL,P007990,P011193,0 days 00:08:47,9,18,9
6,TEL,P006835,P011219,0 days 00:07:10,1,14,13
6,TEL,P007990,P011219,0 days 00:06:55,-4,7,11
6,TEL,P007990,P009754,0 days 00:06:18,10,14,4
6,TEL,P007519,P009754,0 days 00:05:44,0,12,12
6,TEL,P004233,P007519,0 days 00:04:22,-8,7,15
6,TEL,P004233,P006835,0 days 00:04:22,-8,7,15
6,TEL,P007519,P011193,0 days 00:04:04,0,8,8
6,TEL,P007519,P011219,0 days 00:03:50,-4,3,7
6,TEL,P007519,P013382,0 days 00:03:22,-6,2,8
6,TEL,P007990,P013381,0 days 00:03:22,1,5,4
6,TEL,P006835,P013381,0 days 00:03:22,1,5,4
6,TEL,P007519,P013381,0 days 00:03:15,1,5,4
6,TEL,P011219,P013381,0 days 00:03:07,-1,3,4
6,TEL,P004233,P007990,0 days 00:02:45,-6,5,11
6,TEL,P006835,P007855,0 days 00:02:17,-2,5,7
6,TEL,P007855,P007990,0 days 00:02:17,-2,5,7
6,TEL,P004233,P011214,0 days 00:02:12,-6,2,8
6,TEL,P004233,P007855,0 days 00:02:10,-2,5,7
6,TEL,P007519,P007855,0 days 00:02:10,-2,5,7
6,TEL,P004233,P009754,0 days 00:01:37,-2,2,4
6,TEL,P011214,P013381,0 days 00:00:08,2,2,0
6,TEL,P007855,P013381,0 days 00:00:07,0,0,0
6,TEL,P007855,P013382,0 days 00:00:07,0,0,0
6,TEL,P013381,P013382,0 days 00:00:07,0,0,0
6,ASV,P007027,P011225,0 days 00:23:38,-13,45,58
6,ASV,P004194,P007027,0 days 00:22:14,-12,44,56
6,ASV,P004194,P011225,0 days 00:20:52,-16,40,56
6,ASV,P007027,P010545,0 days 00:16:43,-4,40,44
6,ASV,P004194,P010545,0 days 00:15:45,-4,38,42
6,ASV,P010545,P011225,0 days 00:15:06,-6,36,42
6,ASV,P012731,P013371,0 days 00:14:09,4,31,27
6,ASV,P000229,P007027,0 days 00:13:51,-11,19,30
6,ASV,P000229,P004194,0 days 00:13:31,-10,18,28
6,ASV,P002100,P012731,0 days 00:13:22,3,30,27
6,ASV,P008991,P012731,0 days 00:13:15,8,32,24
6,ASV,P000229,P011225,0 days 00:13:04,-12,18,30
6,ASV,P000229,P008991,0 days 00:12:57,-3,31,34
6,ASV,P002100,P013371,0 days 00:12:46,3,28,25
6,ASV,P000229,P012731,0 days 00:12:07,-1,27,28
6,ASV,P008991,P013371,0 days 00:10:51,5,27,22
6,ASV,P002100,P008991,0 days 00:09:49,6,26,20
6,ASV,P003526,P007027,0 days 00:09:21,0,22,22
6,ASV,P000229,P013371,0 days 00:08:53,4,25,21
6,ASV,P003526,P004194,0 days 00:08:50,-6,19,25
6,ASV,P000229,P002100,0 days 00:08:06,3,24,21
6,ASV,P003526,P010545,0 days 00:07:58,-3,19,22
6,ASV,P007027,P008991,0 days 00:07:57,-3,12,15
6,ASV,P003526,P011225,0 days 00:07:44,-2,18,20
6,ASV,P008991,P011225,0 days 00:07:32,-2,11,13
6,ASV,P003526,P012731,0 days 00:07:00,3,11,8
6,ASV,P007027,P012731,0 days 00:06:22,-1,8,9
6,ASV,P003526,P013371,0 days 00:06:16,2,10,8
6,ASV,P011225,P012731,0 days 00:06:12,-2,7,9
6,ASV,P004194,P012731,0 days 00:05:31,-6,4,10
6,ASV,P000229,P010545,0 days 00:05:19,-2,10,12
6,ASV,P004194,P013371,0 days 00:04:55,1,8,7
6,ASV,P002100,P003526,0 days 00:04:39,0,6,6
6,ASV,P004194,P008991,0 days 00:04:31,-5,6,11
6,ASV,P003526,P008991,0 days 00:04:12,6,7,1
6,ASV,P002100,P004194,0 days 00:03:33,-3,4,7
6,ASV,P011225,PKIR,0 days 00:03:26,1,11,10
6,ASV,P010545,PKIR,0 days 00:03:26,1,11,10
6,ASV,P007027,PKIR,0 days 00:03:26,1,11,10
6,ASV,P004194,PKIR,0 days 00:03:26,1,11,10
6,ASV,P007027,P013371,0 days 00:03:00,3,7,4
6,ASV,P010545,P013371,0 days 00:01:37,2,4,2
6,ASV,P002100,P011225,0 days 00:01:13,0,2,2
6,ASV,P010545,P012731,0 days 00:00:58,0,2,2
6,ASV,P011225,P013371,0 days 00:00:37,0,0,0
7,ULK,P008962,P009783,0 days 00:24:37,14,52,38
7,ULK,P009783,P009863,0 days 00:23:05,16,52,36
7,ULK,P008962,P009863,0 days 00:20:46,23,52,29
7,ULK,P004004,P009783,0 days 00:18:46,2,36,34
7,ULK,P004004,P008962,0 days 00:18:17,4,36,32
7,ULK,P002849,P009863,0 days 00:17:44,0,37,37
7,ULK,P002849,P011205,0 days 00:17:37,11,39,28
7,ULK,P004004,P009863,0 days 00:16:08,9,39,30
7,ULK,P004004,PLMG,0 days 00:15:32,6,33,27
7,ULK,P009783,PLMG,0 days 00:15:32,6,33,27
7,ULK,P009863,P011205,0 days 00:15:25,5,33,28
7,ULK,P008962,PLMG,0 days 00:15:03,8,33,25
7,ULK,P009863,PLMG,0 days 00:13:20,12,33,21
7,ULK,P009783,P011205,0 days 00:12:57,1,20,19
7,ULK,P008962,P011205,0 days 00:12:31,7,23,16
7,ULK,P002849,P010560,0 days 00:10:28,2,24,22
7,ULK,P010560,P011205,0 days 00:09:54,6,23,17
7,ULK,P002968,P009863,0 days 00:09:38,-5,20,25
7,ULK,P002849,P002968,0 days 00:09:38,-5,20,25
7,ULK,P002849,P009783,0 days 00:09:28,4,19,15
7,ULK,P009863,P010560,0 days 00:08:28,-2,20,22
7,ULK,P002968,P011205,0 days 00:07:48,-2,16,18
7,ULK,P002849,P008962,0 days 00:07:17,11,19,8
7,ULK,P002968,P010560,0 days 00:07:08,-3,17,20
7,ULK,P007182,P011205,0 days 00:05:54,6,10,4
7,ULK,P007182,P008962,0 days 00:05:21,-1,8,9
7,ULK,P007182,P009783,0 days 00:04:37,-4,5,9
7,ULK,P004004,P011205,0 days 00:03:27,-5,1,6
7,ULK,P007182,P010560,0 days 00:03:16,5,7,2
7,ULK,P004004,P007182,0 days 00:03:14,-4,3,7
7,ULK,P002849,P007182,0 days 00:02:52,4,6,2
7,ULK,P008962,P010560,0 days 00:02:44,2,6,4
7,ULK,P008104,P010560,0 days 00:02:35,3,5,2
7,ULK,P008104,P011205,0 days 00:02:35,3,5,2
7,ULK,P007182,P008104,0 days 00:02:35,3,5,2
7,ULK,P002968,P009783,0 days 00:02:30,-2,3,5
7,ULK,P002849,P004004,0 days 00:02:19,-5,4,9
7,ULK,P011205,PLMG,0 days 00:02:12,-6,0,6
7,ULK,P006661,P008962,0 days 00:02:05,-3,2,5
7,ULK,P006661,P007182,0 days 00:02:05,-3,2,5
7,ULK,P002849,P008104,0 days 00:01:52,4,4,0
7,ULK,P004004,P010560,0 days 00:01:50,-3,4,7
7,ULK,P002968,P004004,0 days 00:01:50,-3,4,7
7,ULK,P007182,P009863,0 days 00:01:38,-2,2,4
7,ULK,P006661,P009783,0 days 00:01:32,-5,0,5
7,ULK,P006661,P011205,0 days 00:01:04,2,2,0
7,ULK,P004004,P006661,0 days 00:01:01,-5,0,5
7,ULK,P008104,P008962,0 days 00:00:43,-1,1,2
7,ULK,P006661,P010560,0 days 00:00:33,2,2,0
7,ULK,P002849,PLMG,0 days 00:00:29,-2,0,2
7,OLY,P003469,P012878,0 days 00:21:59,-2,41,43
7,OLY,P003469,P013380,0 days 00:20:18,-11,33,44
7,OLY,P003469,P007982,0 days 00:19:48,-8,33,41
7,OLY,P007853,P008855,0 days 00:18:12,-6,34,40
7,OLY,P008855,P011194,0 days 00:17:03,-12,25,37
7,OLY,P009849,P013380,0 days 00:16:27,-8,29,37
7,OLY,P003469,P009849,0 days 00:16:27,-8,29,37
7,OLY,P007982,P013380,0 days 00:16:21,-6,25,31
7,OLY,P012878,P013380,0 days 00:15:29,-11,24,35
7,OLY,P009849,P012878,0 days 00:15:29,-11,24,35
7,OLY,P007982,P009849,0 days 00:14:23,-6,23,29
7,OLY,P007853,P011194,0 days 00:13:30,-11,21,32
7,OLY,P007982,P012878,0 days 00:13:25,-9,18,27
7,OLY,P001255,P007853,0 days 00:12:58,0,23,23
7,OLY,P001255,P008855,0 days 00:12:45,-5,21,26
7,OLY,P003469,P008855,0 days 00:12:16,0,25,25
7,OLY,P003469,P007853,0 days 00:11:41,3,25,22
7,OLY,P008829,P008855,0 days 00:09:29,-7,13,20
7,OLY,P008829,P011194,0 days 00:09:29,-7,13,20
7,OLY,P003469,P011194,0 days 00:08:32,-2,17,19
7,OLY,P007853,P008829,0 days 00:08:19,-5,13,18
7,OLY,P001255,P011194,0 days 00:08:03,-10,8,18
7,OLY,P007982,P011194,0 days 00:07:33,-1,15,16
7,OLY,P001255,P008829,0 days 00:07:22,-11,6,17
7,OLY,P001255,P003469,0 days 00:07:11,10,19,9
7,OLY,P011194,P013380,0 days 00:06:56,4,16,12
7,OLY,P007982,P008855,0 days 00:06:35,-4,10,14
7,OLY,P001255,P012878,0 days 00:06:30,9,17,8
7,OLY,P007853,P012878,0 days 00:06:30,9,17,8
7,OLY,P008855,P013380,0 days 00:05:58,1,11,10
7,OLY,P008855,P012878,0 days 00:04:42,5,13,8
7,OLY,P007853,P013380,0 days 00:04:00,1,9,8
7,OLY,P003469,P007947,0 days 00:03:52,2,10,8
7,OLY,P007947,P012878,0 days 00:03:52,2,10,8
7,OLY,P007853,P007982,0 days 00:03:02,-3,6,9
7,OLY,P008829,P013380,0 days 00:02:07,4,7,3
7,OLY,P007947,P009849,0 days 00:02:04,-2,6,8
7,OLY,P007947,P013380,0 days 00:02:04,-2,6,8
7,OLY,P001255,P007947,0 days 00:01:48,4,4,0
7,OLY,P007853,P007947,0 days 00:01:48,4,4,0
7,OLY,P001255,P007982,0 days 00:01:35,-1,2,3
7,OLY,P007982,P008829,0 days 00:01:10,-2,0,2
7,OLY,P009849,P011194,0 days 00:00:58,3,5,2
8,PRS,P010390,P012610,0 days 00:28:34,2,50,48
8,PRS,P010390,P012608,0 days 00:27:51,4,50,46
8,PRS,P012608,P012610,0 days 00:27:51,4,50,46
8,PRS,P010390,P012613,0 days 00:21:32,2,37,35
8,PRS,P012610,P012613,0 days 00:21:32,2,37,35
8,PRS,P012608,P012613,0 days 00:20:49,4,37,33
8,PRS,P012640,P013373,0 days 00:14:09,-10,24,34
8,PRS,P004197,P010390,0 days 00:13:17,0,23,23
8,PRS,P004197,P012610,0 days 00:13:17,0,23,23
8,PRS,P004197,P012613,0 days 00:13:17,0,23,23
8,PRS,P004197,P012608,0 days 00:12:34,2,23,21
8,PRS,P007032,P012609,0 days 00:11:26,-5,27,32
8,PRS,P007032,P012640,0 days 00:11:26,-5,27,32
8,PRS,P012609,P012640,0 days 00:11:26,-5,27,32
8,PRS,P004512,P012609,0 days 00:11:26,-5,27,32
8,PRS,P004512,P012640,0 days 00:11:26,-5,27,32
8,PRS,P004512,P007032,0 days 00:11:26,-5,27,32
8,PRS,P007032,P012613,0 days 00:11:17,6,25,19
8,PRS,P012610,P012640,0 days 00:09:02,-1,18,19
8,PRS,P012608,P012640,0 days 00:09:02,-1,18,19
8,PRS,P010390,P012640,0 days 00:09:02,-1,18,19
8,PRS,P004512,P013373,0 days 00:07:07,-10,11,21
8,PRS,P012609,P013373,0 days 00:07:07,-10,11,21
8,PRS,P007032,P013373,0 days 00:07:07,-10,11,21
8,PRS,P010390,P013373,0 days 00:07:02,0,13,13
8,PRS,P012608,P013373,0 days 00:07:02,0,13,13
8,PRS,P012610,P013373,0 days 00:07:02,0,13,13
8,PRS,P007032,P010390,0 days 00:06:58,1,9,8
8,PRS,P007032,P012610,0 days 00:06:58,1,9,8
8,PRS,P012613,P012640,0 days 00:06:19,4,21,17
8,PRS,P007032,P012608,0 days 00:06:15,3,9,6
8,PRS,P004512,P012613,0 days 00:04:19,5,16,11
8,PRS,P012609,P012613,0 days 00:04:19,5,16,11
8,PRS,P004197,P007032,0 days 00:00:43,-2,0,2
8,RED,P000848,P009048,0 days 00:22:17,7,52,45
8,RED,P006436,P009048,0 days 00:20:01,-4,45,49
8,RED,P004866,P010612,0 days 00:19:37,11,37,26
8,RED,P002553,P009048,0 days 00:18:43,5,40,35
8,RED,P000848,P006436,0 days 00:17:32,-1,38,39
8,RED,P009048,P010612,0 days 00:16:45,15,46,31
8,RED,P004866,P009048,0 days 00:14:41,10,34,24
8,RED,P002553,P010612,0 days 00:14:40,4,32,28
8,RED,P000848,P002553,0 days 00:14:00,8,31,23
8,RED,P002553,P004866,0 days 00:13:50,6,30,24
8,RED,P004866,P009035,0 days 00:13:48,1,21,20
8,RED,P009035,P010612,0 days 00:13:24,12,28,16
8,RED,P006436,P010612,0 days 00:13:13,8,35,27
8,RED,P004866,P012044,0 days 00:12:57,-3,17,20
8,RED,P000848,P004866,0 days 00:12:46,4,28,24
8,RED,P010612,P012044,0 days 00:12:32,-1,17,18
8,RED,P002553,P006436,0 days 00:12:24,-4,24,28
8,RED,P000848,P010612,0 days 00:11:59,16,35,19
8,RED,P004866,P006436,0 days 00:11:09,3,23,20
8,RED,P009035,P012044,0 days 00:10:31,1,14,13
8,RED,P010612,P012786,0 days 00:09:14,0,12,12
8,RED,P004866,P012786,0 days 00:09:14,0,12,12
8,RED,P006436,P009035,0 days 00:08:36,8,22,14
8,RED,P012044,P012786,0 days 00:06:57,-2,8,10
8,RED,P000848,P009035,0 days 00:06:11,2,15,13
8,RED,P009035,P009048,0 days 00:05:49,6,17,11
8,RED,P006436,P012044,0 days 00:04:48,0,10,10
8,RED,P002553,P012786,0 days 00:04:43,-2,7,9
8,RED,P009035,P012786,0 days 00:04:31,2,5,3
8,RED,P004007,P006436,0 days 00:03:50,-9,5,14
8,RED,P004007,P009048,0 days 00:03:50,-9,5,14
8,RED,P002553,P004007,0 days 00:03:50,-9,5,14
8,RED,P000848,P006240,0 days 00:02:31,-5,6,11
8,RED,P006240,P006436,0 days 00:02:31,-5,6,11
8,RED,P006240,P009048,0 days 00:02:31,-5,6,11
8,RED,P004866,P007960,0 days 00:02:30,-4,2,6
8,RED,P007960,P009035,0 days 00:02:30,-4,2,6
8,RED,P007960,P012044,0 days 00:02:30,-4,2,6
8,RED,P002553,P012044,0 days 00:02:26,-4,3,7
8,RED,P004007,P010612,0 days 00:02:26,-5,5,10
8,RED,P009048,P012786,0 days 00:02:17,2,4,2
8,RED,P007960,P010612,0 days 00:02:05,-2,2,4
8,RED,P000848,P012044,0 days 00:01:43,-5,3,8
8,RED,P000848,P004007,0 days 00:01:24,-4,0,4
8,RED,P006240,P012044,0 days 00:01:18,-3,3,6
8,RED,P009048,P012044,0 days 00:01:18,-3,3,6
8,RED,P006240,P010612,0 days 00:01:13,-2,3,5
8,RED,P000848,P007960,0 days 00:00:25,-2,0,2
9,VIR,P001133,P009549,0 days 00:27:04,6,54,48
9,VIR,P004554,P009549,0 days 00:20:51,0,35,35
9,VIR,P001133,P001844,0 days 00:19:29,-7,36,43
9,VIR,P001844,P009549,0 days 00:19:29,-7,36,43
9,VIR,P001133,P004554,0 days 00:19:03,2,33,31
9,VIR,P001133,P004888,0 days 00:14:35,-11,19,30
9,VIR,P004888,P009549,0 days 00:14:35,-11,19,30
9,VIR,P004554,P004888,0 days 00:13:14,-7,17,24
9,VIR,P006739,PBCN,0 days 00:13:02,-11,17,28
9,VIR,P001844,P004554,0 days 00:12:06,-7,19,26
9,VIR,P001133,P012585,0 days 00:11:59,12,25,13
9,VIR,P006739,P013374,0 days 00:11:48,-9,17,26
9,VIR,P013374,PBCN,0 days 00:11:31,-9,15,24
9,VIR,P002084,P009549,0 days 00:10:43,-9,17,26
9,VIR,P001844,P004888,0 days 00:10:20,-12,15,27
9,VIR,P002084,P006739,0 days 00:10:12,-17,9,26
9,VIR,P002084,PBCN,0 days 00:10:10,-17,9,26
9,VIR,P009549,P012585,0 days 00:09:45,10,21,11
9,VIR,P002084,P013374,0 days 00:08:30,-15,7,22
9,VIR,P009549,PBCN,0 days 00:07:21,1,18,17
9,VIR,P012585,PBCN,0 days 00:06:46,6,14,8
9,VIR,P001844,P002084,0 days 00:06:31,2,13,11
9,VIR,P006739,P009549,0 days 00:06:28,-5,12,17
9,VIR,P001133,P002084,0 days 00:06:25,2,13,11
9,VIR,P002084,P012585,0 days 00:05:50,-1,9,10
9,VIR,P001133,PBCN,0 days 00:05:43,14,18,4
9,VIR,P004554,P012585,0 days 00:05:36,7,12,5
9,VIR,P004888,P006739,0 days 00:05:08,2,7,5
9,VIR,P009549,P012591,0 days 00:05:06,2,10,8
9,VIR,P001133,P012591,0 days 00:04:55,2,10,8
9,VIR,P001844,P012591,0 days 00:04:55,2,10,8
9,VIR,P001133,P006739,0 days 00:04:54,8,12,4
9,VIR,P004554,PBCN,0 days 00:04:22,6,12,6
9,VIR,P001844,P012585,0 days 00:04:09,3,9,6
9,VIR,P002084,P004888,0 days 00:04:06,-2,5,7
9,VIR,P012585,P013374,0 days 00:03:55,-2,4,6
9,VIR,P006739,P012585,0 days 00:03:55,-2,4,6
9,VIR,P004554,P012591,0 days 00:03:33,1,6,5
9,VIR,P004888,P013374,0 days 00:03:32,0,5,5
9,VIR,P004888,PBCN,0 days 00:03:26,0,5,5
9,VIR,P009549,P013374,0 days 00:03:19,-5,8,13
9,VIR,P001133,P013374,0 days 00:03:18,6,10,4
9,VIR,P004554,P006739,0 days 00:03:18,0,4,4
9,VIR,P002084,P012591,0 days 00:03:04,-1,4,5
9,VIR,P004888,P012585,0 days 00:02:45,-1,2,3
9,VIR,P002084,P004554,0 days 00:01:57,-2,2,4
9,VIR,P006739,P012591,0 days 00:01:22,-2,0,2
9,VIR,P012591,PBCN,0 days 00:01:11,-2,0,2
9,VIR,P012591,P013374,0 days 00:01:02,-2,0,2
9,VIR,P001133,P011816,0 days 00:00:47,-2,2,4
9,VIR,P001844,P011816,0 days 00:00:47,-2,2,4
9,VIR,P004888,P011816,0 days 00:00:47,-2,2,4
9,VIR,P009549,P011816,0 days 00:00:47,-2,2,4
9,VIR,P001844,P006739,0 days 00:00:17,0,2,2
9,VIR,P001844,P013374,0 days 00:00:17,0,2,2
9,IST,P009846,P012788,0 days 00:22:29,7,43,36
9,IST,P011078,P012788,0 days 00:20:29,14,46,32
9,IST,P009846,P011078,0 days 00:19:41,13,43,30
9,IST,P007109,P007200,0 days 00:18:17,4,33,29
9,IST,P006590,P007109,0 days 00:16:42,9,35,26
9,IST,P009846,P012710,0 days 00:16:09,3,30,27
9,IST,P012710,P012788,0 days 00:15:31,7,30,23
9,IST,P006590,P007200,0 days 00:15:23,6,31,25
9,IST,P004887,P007200,0 days 00:13:48,1,25,24
9,IST,P004887,P007109,0 days 00:13:10,5,25,20
9,IST,P011078,P012710,0 days 00:12:59,13,30,17
9,IST,P007109,P013363,0 days 00:12:09,-3,18,21
9,IST,P007200,P013363,0 days 00:12:09,-3,18,21
9,IST,P009664,P009846,0 days 00:12:00,8,26,18
9,IST,P009664,P012788,0 days 00:12:00,8,26,18
9,IST,P004887,P006590,0 days 00:11:24,5,23,18
9,IST,P009664,P011078,0 days 00:10:48,12,26,14
9,IST,P006590,P013363,0 days 00:10:23,-3,16,19
9,IST,P007200,P012788,0 days 00:09:31,-11,9,20
9,IST,P004887,P013363,0 days 00:09:14,-3,13,16
9,IST,P007109,P011078,0 days 00:08:41,11,22,11
9,IST,P009664,P012710,0 days 00:08:01,9,17,8
9,IST,P007200,P011078,0 days 00:07:44,3,16,13
9,IST,P007109,P012788,0 days 00:07:40,3,15,12
9,IST,P006590,P011078,0 days 00:07:28,14,24,10
9,IST,P006590,P012788,0 days 00:06:43,6,17,11
9,IST,P007200,P009846,0 days 00:06:26,-16,1,17
9,IST,P012788,P013364,0 days 00:05:54,0,13,13
9,IST,P012710,P013364,0 days 00:05:54,0,13,13
9,IST,P011078,P013364,0 days 00:05:54,0,13,13
9,IST,P009846,P013364,0 days 00:05:54,0,13,13
9,IST,P007200,P009513,0 days 00:04:00,-6,2,8
9,IST,P007109,P009846,0 days 00:03:57,2,7,5
9,IST,P004887,P011078,0 days 00:03:56,8,12,4
9,IST,P007200,P012710,0 days 00:03:10,-10,0,10
9,IST,P006590,P009846,0 days 00:03:00,5,9,4
9,IST,P012788,P013363,0 days 00:02:55,0,5,5
9,IST,P007200,P009664,0 days 00:02:48,-8,1,9
9,IST,P004887,P009513,0 days 00:02:24,-4,2,6
9,IST,P009513,P009846,0 days 00:02:14,-6,0,6
9,IST,P009513,P012710,0 days 00:02:14,-6,0,6
9,IST,P007109,P009513,0 days 00:01:46,0,2,2
9,IST,P009513,P013363,0 days 00:01:46,0,2,2
9,IST,P009513,P012788,0 days 00:01:36,-2,0,2
9,IST,P006590,P009664,0 days 00:01:25,2,5,3
9,IST,P007109,P009664,0 days 00:00:58,1,3,2
9,IST,P004887,P009846,0 days 00:00:38,-4,0,4
9,IST,P004887,P012710,0 days 00:00:38,-4,0,4
10,MCO,P002581,PLCZ,0 days 00:21:45,6,52,46
10,MCO,P011212,P011226,0 days 00:21:36,3,44,41
10,MCO,P002581,P005985,0 days 00:21:04,5,49,44
10,MCO,P005985,P011226,0 days 00:20:35,11,46,35
10,MCO,P005985,PLCZ,0 days 00:20:32,4,48,44
10,MCO,P005985,P011212,0 days 00:18:17,6,39,33
10,MCO,P005985,P008099,0 days 00:18:15,3,41,38
10,MCO,P008099,P011231,0 days 00:17:54,-2,37,39
10,MCO,P002581,P011226,0 days 00:16:57,9,41,32
10,MCO,P005844,P011212,0 days 00:16:47,-1,30,31
10,MCO,P011226,PLCZ,0 days 00:16:25,8,40,32
10,MCO,P008099,P011226,0 days 00:16:14,2,34,32
10,MCO,P005844,P011231,0 days 00:14:52,4,30,26
10,MCO,P011212,P011231,0 days 00:14:28,5,29,24
10,MCO,P005985,P011231,0 days 00:14:20,3,31,28
10,MCO,P008099,P011212,0 days 00:14:05,-3,27,30
10,MCO,P005844,P008099,0 days 00:13:39,-5,25,30
10,MCO,P008099,PLCZ,0 days 00:13:18,5,32,27
10,MCO,P002581,P008099,0 days 00:13:18,5,32,27
10,MCO,P005844,P011226,0 days 00:12:20,-1,21,22
10,MCO,P005844,P005985,0 days 00:10:14,4,20,16
10,MCO,P002581,P011212,0 days 00:10:12,4,25,21
10,MCO,P011226,P011231,0 days 00:10:01,5,20,15
10,MCO,P011212,PLCZ,0 days 00:09:40,3,24,21
10,MCO,P002581,P011231,0 days 00:05:52,-1,13,14
10,MCO,P011231,PLCZ,0 days 00:05:20,-2,12,14
10,MCO,P005844,P013365,0 days 00:02:51,-5,2,7
10,MCO,P011212,P013365,0 days 00:02:51,-5,2,7
10,MCO,P011226,P013365,0 days 00:02:51,-5,2,7
10,MCO,P005985,P013365,0 days 00:01:46,0,2,2
10,MCO,P008099,P013365,0 days 00:01:05,-5,0,5
10,MCO,P005844,P012515,0 days 00:00:09,0,0,0
10,MCO,P005985,P012515,0 days 00:00:09,0,0,0
10,MCO,P011226,P012515,0 days 00:00:09,0,0,0
10,MCO,P011231,P012515,0 days 00:00:09,0,0,0
10,TEL,P009754,P011193,0 days 00:22:40,-3,47,50
10,TEL,P006835,P013382,0 days 00:21:33,0,42,42
10,TEL,P011193,P013382,0 days 00:20:17,-1,39,40
10,TEL,P006835,P011193,0 days 00:19:04,-9,35,44
10,TEL,P011214,P013382,0 days 00:18:59,-1,38,39
10,TEL,P009754,P011214,0 days 00:18:55,-2,40,42
10,TEL,P009754,P013382,0 days 00:18:05,-1,36,37
10,TEL,P011193,P011214,0 days 00:18:01,0,38,38
10,TEL,P006835,P009754,0 days 00:16:52,-9,32,41
10,TEL,P009754,P011219,0 days 00:15:11,-1,29,30
10,TEL,P006835,P011214,0 days 00:14:57,-5,29,34
10,TEL,P006835,P007990,0 days 00:13:54,-3,26,29
10,TEL,P011193,P011219,0 days 00:13:16,-2,28,30
10,TEL,P011219,P013382,0 days 00:12:25,6,27,21
10,TEL,P007990,P013382,0 days 00:11:57,1,24,23
10,TEL,P007519,P007990,0 days 00:11:28,3,23,20
10,TEL,P006835,P011219,0 days 00:11:02,0,23,23
10,TEL,P007990,P011219,0 days 00:09:39,3,20,17
10,TEL,P006835,P007519,0 days 00:09:09,1,19,18
10,TEL,P007519,P013382,0 days 00:08:17,4,19,15
10,TEL,P007990,P011214,0 days 00:07:36,-3,12,15
10,TEL,P011214,P011219,0 days 00:06:53,2,14,12
10,TEL,P007519,P011219,0 days 00:06:40,5,13,8
10,TEL,P007519,P011214,0 days 00:06:38,-2,12,14
10,TEL,P007990,P009754,0 days 00:06:20,-3,10,13
10,TEL,P007990,P011193,0 days 00:06:13,-5,9,14
10,TEL,P007519,P009754,0 days 00:05:55,-2,10,12
10,TEL,P005145,P009754,0 days 00:05:52,-2,14,16
10,TEL,P005145,P011193,0 days 00:05:52,-2,14,16
10,TEL,P005145,P011214,0 days 00:05:52,-2,14,16
10,TEL,P005145,P006835,0 days 00:03:01,-2,7,9
10,TEL,P007519,P007855,0 days 00:02:53,-2,4,6
10,TEL,P007855,P007990,0 days 00:02:53,-2,4,6
10,TEL,P005145,P013382,0 days 00:02:51,0,7,7
10,TEL,P009754,P013381,0 days 00:02:37,-2,6,8
10,TEL,P011193,P013381,0 days 00:02:37,-2,6,8
10,TEL,P011219,P013381,0 days 00:02:37,-2,6,8
10,TEL,P006835,P013381,0 days 00:02:36,-6,3,9
10,TEL,P007855,P009754,0 days 00:02:01,1,4,3
10,TEL,P007855,P011219,0 days 00:02:01,1,4,3
10,TEL,P011214,P013381,0 days 00:00:53,1,3,2
10,TEL,P006835,P007855,0 days 00:00:52,-3,0,3
10,TEL,P007519,P013381,0 days 00:00:52,-3,0,3
10,TEL,P007855,P013381,0 days 00:00:52,-3,0,3
10,TEL,P007990,P013381,0 days 00:00:52,-3,0,3
11,RED,P004866,P009035,0 days 00:24:35,11,50,39
11,RED,P004866,P009048,0 days 00:24:20,6,51,45
11,RED,P009035,P009048,0 days 00:23:33,11,52,41
11,RED,P009048,P010612,0 days 00:23:26,8,49,41
11,RED,P004866,P010612,0 days 00:22:02,5,45,40
11,RED,P009035,P010612,0 days 00:19:44,14,44,30
11,RED,P004866,P012786,0 days 00:16:09,7,29,22
11,RED,P009035,P012786,0 days 00:16:09,7,29,22
11,RED,P009048,P012786,0 days 00:14:28,8,29,21
11,RED,P010612,P012786,0 days 00:13:43,11,29,18
11,RED,P004007,P009048,0 days 00:11:40,-2,23,25
11,RED,P002553,P006436,0 days 00:10:36,4,24,20
11,RED,P000848,P012044,0 days 00:10:26,9,20,11
11,RED,P004007,P006436,0 days 00:10:03,-1,23,24
11,RED,P006436,P012044,0 days 00:09:52,8,21,13
11,RED,P002553,P004007,0 days 00:09:34,-3,19,22
11,RED,P000848,P006436,0 days 00:08:29,8,20,12
11,RED,P004007,P009035,0 days 00:08:18,4,19,15
11,RED,P004007,P004866,0 days 00:08:18,2,17,15
11,RED,P002553,P012044,0 days 00:08:14,10,20,10
11,RED,P000848,P002553,0 days 00:08:12,8,20,12
11,RED,P004007,P010612,0 days 00:08:02,1,15,14
11,RED,P004007,P012044,0 days 00:06:03,5,15,10
11,RED,P007960,P009035,0 days 00:05:32,-1,10,11
11,RED,P000848,P004007,0 days 00:05:25,2,14,12
11,RED,P006436,P007960,0 days 00:05:22,3,9,6
11,RED,P006436,P009048,0 days 00:04:46,-9,10,19
11,RED,P002553,P010612,0 days 00:04:31,-9,5,14
11,RED,P007960,P009048,0 days 00:04:28,-2,9,11
11,RED,P002553,P009048,0 days 00:04:20,-9,5,14
11,RED,P006436,P009035,0 days 00:04:11,-7,7,14
11,RED,P004007,P007960,0 days 00:03:56,-2,7,9
11,RED,P007960,P012044,0 days 00:03:51,7,7,0
11,RED,P006436,P010612,0 days 00:03:42,-8,6,14
11,RED,P009035,P012044,0 days 00:03:37,-3,1,4
11,RED,P000848,P007960,0 days 00:03:15,6,6,0
11,RED,P000848,P009035,0 days 00:03:01,-4,0,4
11,RED,P004866,P007960,0 days 00:02:57,2,7,5
11,RED,P002553,P007960,0 days 00:02:47,6,6,0
11,RED,P000848,P004866,0 days 00:02:44,-4,0,4
11,RED,P004866,P012044,0 days 00:02:44,-4,0,4
11,RED,P000848,P012786,0 days 00:02:40,-4,0,4
11,RED,P002553,P004866,0 days 00:02:29,-9,1,10
11,RED,P004866,P006436,0 days 00:01:58,-8,4,12
11,RED,P012044,P012786,0 days 00:01:55,-1,0,1
11,RED,P007960,P010612,0 days 00:01:08,1,3,2
11,RED,P010612,P012044,0 days 00:01:03,-3,0,3
11,RED,P000848,P009048,0 days 00:00:52,-3,0,3
11,RED,P000848,PLUO,0 days 00:00:09,-2,0,2
11,RED,P002553,PLUO,0 days 00:00:09,-2,0,2
11,RED,P004007,PLUO,0 days 00:00:09,-2,0,2
11,RED,P006436,PLUO,0 days 00:00:09,-2,0,2
11,RED,P000848,P010612,0 days 00:00:07,0,0,0
11,RED,P009048,P012044,0 days 00:00:07,0,0,0
11,BAS,P011196,P012201,0 days 00:28:20,3,55,52
11,BAS,P007230,P012201,0 days 00:22:23,-6,35,41
11,BAS,P007230,P012080,0 days 00:21:25,-15,29,44
11,BAS,P007230,P011196,0 days 00:21:17,-6,33,39
11,BAS,P012201,P013367,0 days 00:20:38,-5,35,40
11,BAS,P011196,P013367,0 days 00:20:14,-3,35,38
11,BAS,P007230,P013367,0 days 00:17:20,-5,24,29
11,BAS,P012080,P012201,0 days 00:16:03,-11,23,34
11,BAS,P012201,P012597,0 days 00:15:42,3,36,33
11,BAS,P011196,P012080,0 days 00:15:29,-9,23,32
11,BAS,P012080,P013367,0 days 00:15:25,-6,23,29
11,BAS,P011948,P012201,0 days 00:14:47,13,41,28
11,BAS,P011085,P011948,0 days 00:13:25,1,25,24
11,BAS,P011948,P012597,0 days 00:12:09,5,33,28
11,BAS,P007230,P012597,0 days 00:11:13,-2,18,20
11,BAS,P011196,P012597,0 days 00:11:08,5,26,21
11,BAS,P011085,P012201,0 days 00:10:48,4,25,21
11,BAS,P008072,P011948,0 days 00:10:28,-8,16,24
11,BAS,P011196,P011948,0 days 00:10:13,15,31,16
11,BAS,P007230,P011948,0 days 00:09:36,-1,17,18
11,BAS,P007230,P008072,0 days 00:07:51,-7,8,15
11,BAS,P011085,P012597,0 days 00:07:43,-2,15,17
11,BAS,P008072,P012597,0 days 00:07:30,-7,12,19
11,BAS,P008072,P011085,0 days 00:07:27,-10,8,18
11,BAS,P011948,P013367,0 days 00:07:12,7,19,12
11,BAS,P011085,P011196,0 days 00:06:46,8,17,9
11,BAS,P008072,P012080,0 days 00:05:56,-6,6,12
11,BAS,P008072,P012201,0 days 00:05:51,-5,10,15
11,BAS,P011085,P013367,0 days 00:05:03,1,10,9
11,BAS,P011948,P012080,0 days 00:04:54,-4,6,10
11,BAS,P012080,P012597,0 days 00:04:03,-5,6,11
11,BAS,P007230,P011085,0 days 00:03:15,-6,0,6
11,BAS,P012597,P013367,0 days 00:02:52,-1,6,7
11,BAS,P008072,P013367,0 days 00:02:36,0,4,4
11,BAS,P011085,P012080,0 days 00:02:25,-4,0,4
11,BAS,P008072,P011196,0 days 00:00:33,-1,0,1
12,IST,P006590,P007200,0 days 00:21:04,1,45,44
12,IST,P011078,P012788,0 days 00:18:44,8,44,36
12,IST,P009846,P011078,0 days 00:17:10,2,33,31
12,IST,P012788,P013364,0 days 00:14:05,0,27,27
12,IST,P007200,P013363,0 days 00:13:48,-5,28,33
12,IST,P009846,P013364,0 days 00:13:38,7,26,19
12,IST,P009664,P009846,0 days 00:13:27,3,23,20
12,IST,P011078,P013364,0 days 00:13:05,9,26,17
12,IST,P006590,P013363,0 days 00:12:35,1,28,27
12,IST,P009846,P012788,0 days 00:12:15,-1,22,23
12,IST,P004887,P007200,0 days 00:11:53,-16,14,30
12,IST,P009846,P012710,0 days 00:11:25,-3,27,30
12,IST,P011078,P012710,0 days 00:10:35,-5,22,27
12,IST,P007200,P012788,0 days 00:10:00,4,27,23
12,IST,P006590,P012788,0 days 00:10:00,4,27,23
12,IST,P009664,P013364,0 days 00:09:43,4,17,13
12,IST,P006590,P009664,0 days 00:09:16,3,20,17
12,IST,P009664,P011078,0 days 00:09:03,4,14,10
12,IST,P004887,P006590,0 days 00:09:03,-6,10,16
12,IST,P007200,P009664,0 days 00:09:02,-2,17,19
12,IST,P012788,P013363,0 days 00:08:36,6,24,18
12,IST,P007109,P007200,0 days 00:08:34,-11,9,20
12,IST,P012710,P012788,0 days 00:08:11,-4,15,19
12,IST,P007200,P011078,0 days 00:08:06,5,26,21
12,IST,P006590,P011078,0 days 00:07:16,12,25,13
12,IST,P006590,P007109,0 days 00:07:13,-4,9,13
12,IST,P009664,P012788,0 days 00:07:09,-5,10,15
12,IST,P004887,P007109,0 days 00:06:50,-10,6,16
12,IST,P012710,P013364,0 days 00:06:30,2,15,13
12,IST,P011078,P013363,0 days 00:06:29,9,22,13
12,IST,P007109,P009664,0 days 00:06:18,3,9,6
12,IST,P007200,P009846,0 days 00:06:01,-5,13,18
12,IST,P007200,P013364,0 days 00:05:15,-6,8,14
12,IST,P004887,P013363,0 days 00:05:12,-11,4,15
12,IST,P004887,P009664,0 days 00:05:04,-1,6,7
12,IST,P007109,P013363,0 days 00:04:47,-10,4,14
12,IST,P006590,P013364,0 days 00:04:42,-4,8,12
12,IST,P006590,P009846,0 days 00:04:38,4,12,8
12,IST,P004887,P009846,0 days 00:04:38,-5,8,13
12,IST,P007109,P013364,0 days 00:04:15,3,7,4
12,IST,P009664,P012710,0 days 00:03:18,-1,8,9
12,IST,P007109,P009846,0 days 00:03:04,2,4,2
12,IST,P007200,P012710,0 days 00:02:52,-3,9,12
12,IST,P007109,P011078,0 days 00:02:31,4,4,0
12,IST,P013363,P013364,0 days 00:02:07,-3,2,5
12,IST,P004887,P012710,0 days 00:02:02,-5,4,9
12,IST,P004887,P011078,0 days 00:01:37,-4,4,8
12,IST,P006590,P012710,0 days 00:01:37,5,8,3
12,IST,P004887,P006640,0 days 00:01:13,-6,0,6
12,IST,P006640,P007200,0 days 00:01:13,-6,0,6
12,IST,P006640,P013363,0 days 00:01:13,-6,0,6
12,IST,P006640,P007109,0 days 00:00:48,-5,0,5
12,IST,P006640,P012710,0 days 00:00:25,-1,0,1
12,IST,P012710,P013363,0 days 00:00:25,-1,0,1
12,ULK,P008962,P009863,0 days 00:24:51,-13,42,55
12,ULK,P009783,P009863,0 days 00:20:26,-12,35,47
12,ULK,P008962,P009783,0 days 00:20:05,-10,35,45
12,ULK,P004004,P009863,0 days 00:18:30,0,41,41
12,ULK,P004004,P008962,0 days 00:17:25,2,39,37
12,ULK,P007182,P009863,0 days 00:17:21,-9,36,45
12,ULK,P004004,P009783,0 days 00:16:39,-5,33,38
12,ULK,P007182,P011205,0 days 00:16:31,16,45,29
12,ULK,P002849,P011205,0 days 00:16:17,18,37,19
12,ULK,P002849,P007182,0 days 00:14:25,18,39,21
12,ULK,P008104,P011205,0 days 00:13:57,14,34,20
12,ULK,P007182,P008104,0 days 00:13:14,13,31,18
12,ULK,P007182,P009783,0 days 00:12:24,-9,27,36
12,ULK,P007182,P008962,0 days 00:12:18,-11,24,35
12,ULK,P004004,P007182,0 days 00:12:14,-2,25,27
12,ULK,P002849,P009863,0 days 00:12:07,-1,18,19
12,ULK,P002849,P008104,0 days 00:11:54,18,30,12
12,ULK,P009863,P011205,0 days 00:10:49,-1,21,22
12,ULK,P002849,P006961,0 days 00:10:23,15,25,10
12,ULK,P006961,P011205,0 days 00:09:08,17,25,8
12,ULK,P006961,P007182,0 days 00:08:25,12,25,13
12,ULK,P008962,P011205,0 days 00:06:51,-5,11,16
12,ULK,P008104,P009863,0 days 00:06:45,0,16,16
12,ULK,P002849,P009783,0 days 00:06:29,-1,13,14
12,ULK,P002849,P008962,0 days 00:06:20,-3,4,7
12,ULK,P002968,P008962,0 days 00:06:14,0,13,13
12,ULK,P002968,P009783,0 days 00:06:14,0,13,13
12,ULK,P002968,P009863,0 days 00:06:14,0,13,13
12,ULK,P006961,P008962,0 days 00:06:13,-8,4,12
12,ULK,P006961,P008104,0 days 00:05:45,12,16,4
12,ULK,P002968,P004004,0 days 00:05:33,1,13,12
12,ULK,P006961,P009863,0 days 00:05:29,-8,2,10
12,ULK,P006961,P009783,0 days 00:05:20,-3,11,14
12,ULK,P002849,P004004,0 days 00:05:05,-4,6,10
12,ULK,P004004,P011205,0 days 00:04:24,1,10,9
12,ULK,P009783,P011205,0 days 00:02:47,0,9,9
12,ULK,P004004,P008104,0 days 00:02:10,3,5,2
12,ULK,P008104,P008962,0 days 00:02:03,-4,4,8
12,ULK,P002968,P006961,0 days 00:00:41,-1,0,1
13,ASV,P007027,P010545,0 days 00:26:08,6,60,54
13,ASV,P003526,P007027,0 days 00:20:36,10,51,41
13,ASV,P003526,P010545,0 days 00:19:19,12,48,36
13,ASV,P007027,P013372,0 days 00:16:10,6,39,33
13,ASV,P010545,P013372,0 days 00:16:10,6,39,33
13,ASV,P002100,P007027,0 days 00:15:54,-2,36,38
13,ASV,P007027,P013371,0 days 00:14:45,13,35,22
13,ASV,P002100,P010545,0 days 00:14:10,0,33,33
13,ASV,P002100,P004194,0 days 00:13:58,-2,29,31
13,ASV,P003526,P013372,0 days 00:13:18,6,34,28
13,ASV,P002100,P003526,0 days 00:12:37,4,35,31
13,ASV,P010545,P013371,0 days 00:11:58,6,27,21
13,ASV,P000229,P013371,0 days 00:11:45,-2,21,23
13,ASV,P003526,P013371,0 days 00:10:39,8,28,20
13,ASV,P000229,P008991,0 days 00:10:02,-3,16,19
13,ASV,P004194,P007027,0 days 00:10:02,-2,22,24
13,ASV,P008991,P013371,0 days 00:09:47,-3,16,19
13,ASV,P012731,P013371,0 days 00:09:40,0,24,24
13,ASV,P002100,P013371,0 days 00:09:21,-9,16,25
13,ASV,P000229,P002100,0 days 00:08:52,-12,10,22
13,ASV,P013371,P013372,0 days 00:08:48,8,23,15
13,ASV,P004194,P010545,0 days 00:08:18,0,19,19
13,ASV,P000229,P012731,0 days 00:08:08,-1,18,19
13,ASV,P003526,P004194,0 days 00:07:35,4,22,18
13,ASV,P002100,P012731,0 days 00:07:33,-8,18,26
13,ASV,P002100,P008991,0 days 00:07:27,-10,8,18
13,ASV,P002100,P013372,0 days 00:07:22,-2,16,18
13,ASV,P004194,P013371,0 days 00:06:56,-4,11,15
13,ASV,P008991,P012731,0 days 00:06:42,0,15,15
13,ASV,P007027,PKIR,0 days 00:06:31,-4,10,14
13,ASV,P010545,PKIR,0 days 00:06:19,-4,10,14
13,ASV,P000229,P004194,0 days 00:04:57,-5,3,8
13,ASV,P007027,P012731,0 days 00:04:41,4,12,8
13,ASV,P000229,P007027,0 days 00:04:35,6,11,5
13,ASV,P002100,PKIR,0 days 00:03:46,-3,7,10
13,ASV,P004194,P012731,0 days 00:03:38,-1,11,12
13,ASV,P004194,P008991,0 days 00:03:32,-3,1,4
13,ASV,P007027,P008991,0 days 00:03:14,7,8,1
13,ASV,P004194,PKIR,0 days 00:02:56,-3,6,9
13,ASV,P013371,PKIR,0 days 00:02:45,-1,3,4
13,ASV,P003526,P012731,0 days 00:02:37,-1,9,10
13,ASV,P013372,PKIR,0 days 00:02:20,-2,3,5
13,ASV,P000229,P010545,0 days 00:01:33,-1,3,4
13,ASV,P003526,PKIR,0 days 00:01:03,1,1,0
13,ASV,P010545,P012731,0 days 00:00:37,-1,1,2
13,ASV,P000229,P013372,0 days 00:00:32,2,2,0
13,ASV,P008991,PKIR,0 days 00:00:12,0,0,0
13,ASV,P012731,PKIR,0 days 00:00:12,0,0,0
13,VIR,P001133,P009549,0 days 00:27:55,-1,58,59
13,VIR,P004888,P009549,0 days 00:21:37,-7,46,53
13,VIR,P001133,P004888,0 days 00:20:29,-9,41,50
13,VIR,P006739,P009549,0 days 00:16:13,0,36,36
13,VIR,P001133,P006739,0 days 00:16:10,-4,31,35
13,VIR,P012585,PBCN,0 days 00:15:31,1,30,29
13,VIR,P001133,P004554,0 days 00:15:16,-10,33,43
13,VIR,P004554,P004888,0 days 00:15:16,-10,33,43
13,VIR,P004554,P009549,0 days 00:15:07,-10,33,43
13,VIR,P013374,PBCN,0 days 00:13:54,8,33,25
13,VIR,P006739,P013374,0 days 00:13:46,9,38,29
13,VIR,P004888,P006739,0 days 00:13:11,-6,27,33
13,VIR,P002084,P012585,0 days 00:13:00,-1,28,29
13,VIR,P002084,PBCN,0 days 00:12:12,0,28,28
13,VIR,P006739,PBCN,0 days 00:12:01,2,28,26
13,VIR,P002084,P006739,0 days 00:10:27,1,27,26
13,VIR,P012585,P013374,0 days 00:10:21,4,24,20
13,VIR,P009549,PBCN,0 days 00:10:14,9,20,11
13,VIR,P009549,P013374,0 days 00:10:13,11,24,13
13,VIR,P004554,P006739,0 days 00:10:01,-14,14,28
13,VIR,P009549,P012585,0 days 00:09:33,4,15,11
13,VIR,P001133,PBCN,0 days 00:09:30,6,17,11
13,VIR,P002084,P013374,0 days 00:09:09,5,27,22
13,VIR,P006739,P012585,0 days 00:08:37,-2,19,21
13,VIR,P001133,P012585,0 days 00:08:36,3,12,9
13,VIR,P001133,P013374,0 days 00:08:12,6,16,10
13,VIR,P002084,P009549,0 days 00:07:57,4,17,13
13,VIR,P001133,P001844,0 days 00:05:37,-4,15,19
13,VIR,P001844,P004554,0 days 00:05:15,-2,15,17
13,VIR,P001844,P009549,0 days 00:05:15,-2,15,17
13,VIR,P001844,P004888,0 days 00:05:15,-2,15,17
13,VIR,P001133,P002084,0 days 00:04:51,1,9,8
13,VIR,P004554,P012585,0 days 00:03:33,-2,4,6
13,VIR,P002084,P004888,0 days 00:03:30,2,8,6
13,VIR,P004888,P012585,0 days 00:03:29,1,4,3
13,VIR,P004888,P013374,0 days 00:03:27,3,10,7
13,VIR,P002084,P004554,0 days 00:01:42,-4,0,4
13,VIR,P004554,PBCN,0 days 00:01:42,-4,0,4
13,VIR,P004888,PBCN,0 days 00:00:50,0,0,0
13,VIR,P001844,P006739,0 days 00:00:22,-2,0,2
13,VIR,P001844,P013374,0 days 00:00:22,-2,0,2
13,VIR,P001844,PBCN,0 days 00:00:22,-2,0,2
14,PAN,P003842,P012774,0 days 00:23:36,17,59,42
14,PAN,P009622,P012712,0 days 00:18:39,16,45,29
14,PAN,P003842,P005161,0 days 00:13:22,1,31,30
14,PAN,P005161,P012774,0 days 00:13:22,1,31,30
14,PAN,P001926,P012774,0 days 00:13:21,-6,27,33
14,PAN,P011204,P012712,0 days 00:13:21,13,33,20
14,PAN,P012712,P012774,0 days 00:13:18,-4,24,28
14,PAN,P003842,P012712,0 days 00:12:49,11,31,20
14,PAN,P003842,P009622,0 days 00:12:03,9,29,20
14,PAN,P004088,P012774,0 days 00:12:00,6,29,23
14,PAN,P007866,P012774,0 days 00:11:49,10,29,19
14,PAN,P009622,P011204,0 days 00:11:36,12,31,19
14,PAN,P005353,P012712,0 days 00:10:57,-3,21,24
14,PAN,P003842,P004088,0 days 00:10:54,10,30,20
14,PAN,P001926,P003842,0 days 00:10:33,2,22,20
14,PAN,P003842,P007866,0 days 00:10:23,13,27,14
14,PAN,P002328,P012712,0 days 00:10:18,-2,19,21
14,PAN,P004088,P007866,0 days 00:09:55,10,25,15
14,PAN,P003842,P011204,0 days 00:09:43,17,35,18
14,PAN,P005353,P011204,0 days 00:09:40,1,18,17
14,PAN,P002328,P005353,0 days 00:09:37,-5,17,22
14,PAN,P011204,P012774,0 days 00:08:50,7,25,18
14,PAN,P001926,P004088,0 days 00:08:18,2,18,16
14,PAN,P009622,P012774,0 days 00:08:11,4,17,13
14,PAN,P001926,P007866,0 days 00:08:03,6,18,12
14,PAN,P002328,P011204,0 days 00:07:14,5,14,9
14,PAN,P005161,P012712,0 days 00:07:12,3,14,11
14,PAN,P005161,P009622,0 days 00:07:12,3,14,11
14,PAN,P005353,P009622,0 days 00:06:41,6,16,10
14,PAN,P005353,P012774,0 days 00:05:47,-13,7,20
14,PAN,P003842,P011209,0 days 00:05:43,6,18,12
14,PAN,P011204,P011209,0 days 00:05:43,6,18,12
14,PAN,P004088,P011204,0 days 00:05:35,6,18,12
14,PAN,P002328,P009622,0 days 00:05:20,5,12,7
14,PAN,P002328,P012774,0 days 00:05:07,-8,7,15
14,PAN,P001926,P005161,0 days 00:03:59,-4,8,12
14,PAN,P007866,P011204,0 days 00:03:51,3,11,8
14,PAN,P011209,P012712,0 days 00:03:32,4,9,5
14,PAN,P009622,P011209,0 days 00:03:32,4,9,5
14,PAN,P001926,P002328,0 days 00:03:17,-8,5,13
14,PAN,P001926,P012712,0 days 00:03:13,-8,5,13
14,PAN,P004088,P005353,0 days 00:02:51,-2,6,8
14,PAN,P001926,P005353,0 days 00:02:48,-8,5,13
14,PAN,P005161,P011204,0 days 00:02:11,2,9,7
14,PAN,P005161,P011209,0 days 00:02:11,2,9,7
14,PAN,P011209,P012774,0 days 00:02:11,2,9,7
14,PAN,P004088,P005161,0 days 00:02:05,-4,4,8
14,PAN,P005161,P007866,0 days 00:01:54,0,4,4
14,PAN,P004088,P009622,0 days 00:01:49,2,7,5
14,PAN,P004088,P012712,0 days 00:01:45,2,7,5
14,PAN,P005353,P007866,0 days 00:01:31,-4,2,6
14,PAN,P002328,P003842,0 days 00:00:46,2,2,0
14,PAN,P002328,P007866,0 days 00:00:05,-1,0,1
14,PAN,P007866,P009622,0 days 00:00:05,-1,0,1
14,PAN,P001926,P009622,0 days 00:00:04,0,0,0
14,PAN,P001926,P011204,0 days 00:00:04,0,0,0
14,PAN,P002328,P004088,0 days 00:00:04,0,0,0
14,MUN,P007056,P007201,0 days 00:22:36,-12,41,53
14,MUN,P001288,P007201,0 days 00:20:30,-11,36,47
14,MUN,P011224,P011987,0 days 00:18:20,-7,33,40
14,MUN,P007201,P011987,0 days 00:16:21,-9,27,36
14,MUN,P004508,P007201,0 days 00:15:44,-11,29,40
14,MUN,P007056,P011987,0 days 00:15:12,-3,30,33
14,MUN,P007201,P011224,0 days 00:15:01,-7,25,32
14,MUN,P007056,P011224,0 days 00:13:53,-1,28,29
14,MUN,P001288,P007056,0 days 00:13:43,-7,25,32
14,MUN,P007056,P010391,0 days 00:13:35,-9,23,32
14,MUN,P004508,P007056,0 days 00:13:25,-13,23,36
14,MUN,P004508,P011052,0 days 00:13:15,0,31,31
14,MUN,P004508,P010391,0 days 00:13:15,-6,25,31
14,MUN,P001288,P004508,0 days 00:10:58,-4,20,24
14,MUN,P007201,P011052,0 days 00:10:18,-1,24,25
14,MUN,P007201,P010391,0 days 00:10:15,-9,15,24
14,MUN,P007639,P011052,0 days 00:09:36,3,25,22
14,MUN,P001288,P011987,0 days 00:09:32,-7,16,23
14,MUN,P001288,P011224,0 days 00:09:32,-7,16,23
14,MUN,P010391,P011244,0 days 00:08:22,3,20,17
14,MUN,P007056,P011052,0 days 00:07:59,-3,18,21
14,MUN,P004508,P007639,0 days 00:07:21,5,18,13
14,MUN,P007639,P011244,0 days 00:07:17,1,19,18
14,MUN,P011052,P011244,0 days 00:07:17,1,19,18
14,MUN,P010391,P011052,0 days 00:07:06,0,17,17
14,MUN,P001288,P007639,0 days 00:06:47,-4,11,15
14,MUN,P007201,P007639,0 days 00:06:47,-4,11,15
14,MUN,P007639,P011987,0 days 00:06:43,-8,12,20
14,MUN,P001288,P010391,0 days 00:06:09,-6,8,14
14,MUN,P011052,P011987,0 days 00:05:40,-2,14,16
14,MUN,P011244,P011987,0 days 00:05:34,-2,15,17
14,MUN,P010391,P011224,0 days 00:05:22,0,10,10
14,MUN,P010391,P011987,0 days 00:05:21,0,10,10
14,MUN,P004508,P011244,0 days 00:05:02,3,12,9
14,MUN,P007639,P010391,0 days 00:05:02,3,12,9
14,MUN,P001288,P011052,0 days 00:04:49,2,12,10
14,MUN,P007639,P011224,0 days 00:04:28,-6,5,11
14,MUN,P011224,P011244,0 days 00:03:20,0,8,8
14,MUN,P007056,P011244,0 days 00:03:20,0,8,8
14,MUN,P004508,P011987,0 days 00:02:42,-4,4,8
14,MUN,P011244,P012123,0 days 00:02:16,-2,7,9
14,MUN,P007639,P012123,0 days 00:02:15,-2,7,9
14,MUN,P011052,P012123,0 days 00:02:15,-2,7,9
14,MUN,P011987,P012123,0 days 00:02:15,-2,7,9
14,MUN,P011052,P011224,0 days 00:02:05,2,5,3
14,MUN,P004508,P011224,0 days 00:01:22,-2,2,4
14,MUN,P007056,P012123,0 days 00:00:01,0,0,0
14,MUN,P010391,P012123,0 days 00:00:01,0,0,0
14,MUN,P011224,P012123,0 days 00:00:01,0,0,0
15,MAD,P003583,P005928,0 days 00:20:48,6,52,46
15,MAD,P009005,P013378,0 days 00:17:36,18,53,35
15,MAD,P005928,P009005,0 days 00:16:40,6,45,39
15,MAD,P006540,P009213,0 days 00:16:11,6,32,26
15,MAD,P003583,P009005,0 days 00:15:23,4,41,37
15,MAD,P005928,P013378,0 days 00:15:03,15,48,33
15,MAD,P005928,P009213,0 days 00:14:14,-2,28,30
15,MAD,P003108,P009213,0 days 00:14:07,1,27,26
15,MAD,P003583,P013378,0 days 00:13:10,11,40,29
15,MAD,P003108,P006540,0 days 00:12:19,-5,17,22
15,MAD,P003108,P005928,0 days 00:11:59,3,25,22
15,MAD,P009005,PTGB,0 days 00:11:33,-1,27,28
15,MAD,P009213,P013378,0 days 00:11:03,4,29,25
15,MAD,P005791,P009213,0 days 00:10:17,0,20,20
15,MAD,P003108,P005791,0 days 00:10:17,0,20,20
15,MAD,P005928,P006540,0 days 00:09:31,3,18,15
15,MAD,P003583,P009213,0 days 00:09:30,-8,16,24
15,MAD,P009005,P009213,0 days 00:09:28,0,22,22
15,MAD,P003733,P005928,0 days 00:09:18,8,26,18
15,MAD,P006540,P009005,0 days 00:09:02,5,24,19
15,MAD,P009213,PTGB,0 days 00:08:54,-2,20,22
15,MAD,P003733,P009005,0 days 00:08:38,6,24,18
15,MAD,P005791,P006540,0 days 00:07:55,-2,12,14
15,MAD,P006540,P013378,0 days 00:07:36,10,24,14
15,MAD,P003583,P003733,0 days 00:07:34,8,22,14
15,MAD,P005791,P005928,0 days 00:06:57,4,16,12
15,MAD,P003108,P003583,0 days 00:06:48,-1,13,14
15,MAD,P013378,PTGB,0 days 00:06:46,5,18,13
15,MAD,P003583,P006540,0 days 00:06:42,1,14,13
15,MAD,P005928,PTGB,0 days 00:06:30,-3,14,17
15,MAD,P005791,P011247,0 days 00:06:28,-7,10,17
15,MAD,P003733,P013378,0 days 00:05:30,9,18,9
15,MAD,P006540,PTGB,0 days 00:05:18,6,15,9
15,MAD,P003733,PTGB,0 days 00:05:12,-4,10,14
15,MAD,P003583,PTGB,0 days 00:05:11,-5,10,15
15,MAD,P006540,P011247,0 days 00:05:06,-4,8,12
15,MAD,P009213,P011247,0 days 00:05:06,-4,8,12
15,MAD,P003108,P011247,0 days 00:05:06,-4,8,12
15,MAD,P003108,P013378,0 days 00:04:12,2,14,12
15,MAD,P003733,P005791,0 days 00:03:08,-3,6,9
15,MAD,P005791,P009005,0 days 00:03:08,-3,6,9
15,MAD,P005791,PTGB,0 days 00:03:08,-3,6,9
15,MAD,P003108,P009005,0 days 00:02:24,-4,4,8
15,MAD,P005791,P013378,0 days 00:02:22,2,8,6
15,MAD,P003733,P009213,0 days 00:01:30,-3,2,5
15,MAD,P003733,P011247,0 days 00:01:24,-3,2,5
15,MAD,P009005,P011247,0 days 00:01:24,-3,2,5
15,MAD,P011247,PTGB,0 days 00:01:22,-3,2,5
15,MAD,P003108,P003733,0 days 00:00:34,2,2,0
15,MAD,P003108,PTGB,0 days 00:00:34,2,2,0
15,MAD,P003583,P011247,0 days 00:00:02,0,0,0
15,MAD,P011247,P013378,0 days 00:00:02,0,0,0
15,PAR,P006760,P013369,0 days 00:21:29,-10,39,49
15,PAR,P006760,P007870,0 days 00:21:26,0,51,51
15,PAR,P006760,P012720,0 days 00:20:42,1,49,48
15,PAR,P006591,P006760,0 days 00:18:44,-7,43,50
15,PAR,P011981,P013369,0 days 00:18:10,-9,32,41
15,PAR,P006591,P007870,0 days 00:17:40,1,44,43
15,PAR,P004761,P006760,0 days 00:16:58,-11,34,45
15,PAR,P007870,P012720,0 days 00:16:39,-5,35,40
15,PAR,P006760,P011981,0 days 00:16:37,-7,28,35
15,PAR,P004761,P013369,0 days 00:13:37,-5,29,34
15,PAR,P004761,P006591,0 days 00:13:14,-6,30,36
15,PAR,P011981,P012720,0 days 00:12:53,-2,32,34
15,PAR,P004761,P012720,0 days 00:12:07,-5,31,36
15,PAR,P004761,P011981,0 days 00:11:47,1,27,26
15,PAR,P004761,P007870,0 days 00:11:43,-1,30,31
15,PAR,P006591,P013369,0 days 00:11:42,2,29,27
15,PAR,P012720,P013369,0 days 00:11:39,-4,27,31
15,PAR,P006591,P012720,0 days 00:11:00,-2,27,29
15,PAR,P007870,P013369,0 days 00:10:55,3,27,24
15,PAR,P006760,P007632,0 days 00:10:53,0,17,17
15,PAR,P006760,P010781,0 days 00:10:03,2,19,17
15,PAR,P007632,P010781,0 days 00:08:39,-1,14,15
15,PAR,P007870,P010781,0 days 00:07:54,2,17,15
15,PAR,P010781,P011981,0 days 00:07:47,-2,14,16
15,PAR,P007870,P011981,0 days 00:07:31,1,16,15
15,PAR,P010781,P012720,0 days 00:06:23,6,17,11
15,PAR,P007632,P013369,0 days 00:05:47,-4,5,9
15,PAR,P007632,P011981,0 days 00:05:47,-4,5,9
15,PAR,P006591,P011981,0 days 00:05:30,2,13,11
15,PAR,P007632,P007870,0 days 00:05:06,4,12,8
15,PAR,P010781,P013369,0 days 00:03:35,-5,2,7
15,PAR,P008232,P011981,0 days 00:03:34,-4,9,13
15,PAR,P008232,P012720,0 days 00:03:34,-4,9,13
15,PAR,P006591,P010781,0 days 00:02:59,1,7,6
15,PAR,P006591,P007632,0 days 00:02:59,1,7,6
15,PAR,P008232,P010781,0 days 00:02:52,0,7,7
15,PAR,P004761,P007632,0 days 00:02:14,1,3,2
15,PAR,P004761,P008232,0 days 00:02:08,1,9,8
15,PAR,P007632,P012720,0 days 00:02:07,3,5,2
15,PAR,P004761,P010781,0 days 00:01:28,5,7,2
15,PAR,P007870,P008232,0 days 00:01:26,-5,0,5
15,PAR,P008232,P013369,0 days 00:00:42,-4,2,6
16,MIL,P000796,P007831,0 days 00:25:50,6,58,52
16,MIL,P006085,P007831,0 days 00:22:41,5,52,47
16,MIL,P000796,P006085,0 days 00:21:50,7,50,43
16,MIL,P007831,P008987,0 days 00:21:13,8,47,39
16,MIL,P000796,P008987,0 days 00:20:33,7,48,41
16,MIL,P006085,P008987,0 days 00:19:57,6,47,41
16,MIL,P001518,P007831,0 days 00:14:58,17,36,19
16,MIL,P001392,P007831,0 days 00:13:35,1,24,23
16,MIL,P000796,P001518,0 days 00:13:21,16,35,19
16,MIL,P001392,P008987,0 days 00:13:03,5,27,22
16,MIL,P006509,P008987,0 days 00:11:47,-3,22,25
16,MIL,P001518,P008987,0 days 00:10:44,13,23,10
16,MIL,P001518,P006085,0 days 00:10:27,13,29,16
16,MIL,P000796,P001392,0 days 00:09:13,2,19,17
16,MIL,P001392,P006085,0 days 00:09:08,1,19,18
16,MIL,P001392,P013385,0 days 00:08:10,1,17,16
16,MIL,P006085,P006509,0 days 00:08:09,-1,18,19
16,MIL,P006509,P013385,0 days 00:07:54,0,12,12
16,MIL,P007831,P013386,0 days 00:07:41,-4,13,17
16,MIL,P000796,P013386,0 days 00:07:41,-4,13,17
16,MIL,P001392,P001518,0 days 00:07:22,5,12,7
16,MIL,P008987,P013384,0 days 00:07:10,-5,5,10
16,MIL,P001392,P006509,0 days 00:07:04,0,14,14
16,MIL,P000796,P006509,0 days 00:06:48,-5,14,19
16,MIL,P001392,P013384,0 days 00:06:41,1,11,10
16,MIL,P006509,P007831,0 days 00:06:28,-4,13,17
16,MIL,P001518,P013384,0 days 00:06:22,4,10,6
16,MIL,P006085,P013386,0 days 00:06:20,0,12,12
16,MIL,P008987,P013385,0 days 00:06:16,0,10,10
16,MIL,P007831,P013384,0 days 00:06:05,-5,7,12
16,MIL,P000796,P013384,0 days 00:05:48,-13,5,18
16,MIL,P006509,P013384,0 days 00:04:58,-3,5,8
16,MIL,P013384,P013385,0 days 00:04:56,5,9,4
16,MIL,P006085,P013385,0 days 00:04:27,-1,9,10
16,MIL,P001518,P013386,0 days 00:04:24,3,12,9
16,MIL,P001518,P013385,0 days 00:03:43,2,8,6
16,MIL,P006701,P013384,0 days 00:03:41,-3,3,6
16,MIL,P006701,P008987,0 days 00:03:41,-3,3,6
16,MIL,P001518,P006509,0 days 00:03:01,-1,5,6
16,MIL,P007831,P013385,0 days 00:02:41,0,6,6
16,MIL,P006509,P006701,0 days 00:02:39,-3,1,4
16,MIL,P001392,P013386,0 days 00:02:24,-4,1,5
16,MIL,P013384,P013386,0 days 00:02:14,-7,1,8
16,MIL,P006085,P013384,0 days 00:02:09,-6,0,6
16,MIL,P000796,P006701,0 days 00:01:52,-4,2,6
16,MIL,P006701,P013385,0 days 00:01:49,1,1,0
16,MIL,P001518,P006701,0 days 00:01:02,0,2,2
16,PRS,P012608,P012613,0 days 00:27:05,-9,49,58
16,PRS,P012608,P012610,0 days 00:26:15,-13,45,58
16,PRS,P012610,P012613,0 days 00:26:15,-13,45,58
16,PRS,P010390,P012608,0 days 00:25:24,-9,43,52
16,PRS,P010390,P012613,0 days 00:25:24,-9,43,52
16,PRS,P010390,P012610,0 days 00:24:34,-13,39,52
16,PRS,P005793,P012609,0 days 00:14:36,4,31,27
16,PRS,P004197,P010390,0 days 00:14:10,1,27,26
16,PRS,P004197,P012610,0 days 00:14:10,1,27,26
16,PRS,P004197,P012613,0 days 00:14:10,1,27,26
16,PRS,P004197,P012608,0 days 00:14:10,1,27,26
16,PRS,P012609,P012640,0 days 00:13:45,8,29,21
16,PRS,P005793,P007032,0 days 00:12:55,4,25,21
16,PRS,P005793,P012640,0 days 00:12:55,4,25,21
16,PRS,P007032,P012609,0 days 00:12:55,4,25,21
16,PRS,P007032,P012640,0 days 00:12:55,4,25,21
16,PRS,P004512,P012609,0 days 00:10:39,5,22,17
16,PRS,P004512,P007032,0 days 00:10:39,5,22,17
16,PRS,P004512,P005793,0 days 00:10:39,5,22,17
16,PRS,P004512,P012640,0 days 00:10:39,5,22,17
16,PRS,P012608,P012609,0 days 00:08:39,-5,21,26
16,PRS,P012609,P012613,0 days 00:08:39,-5,21,26
16,PRS,P012609,P012610,0 days 00:07:49,-9,17,26
16,PRS,P010390,P012609,0 days 00:06:58,-5,15,20
16,PRS,P007032,P012610,0 days 00:02:47,-4,1,5
16,PRS,P007032,P012613,0 days 00:02:47,-4,1,5
16,PRS,P007032,P012608,0 days 00:02:47,-4,1,5
16,PRS,P007032,P010390,0 days 00:02:47,-4,1,5
16,PRS,P010390,P012640,0 days 00:02:19,3,4,1
16,PRS,P012608,P012640,0 days 00:02:19,3,4,1
16,PRS,P012613,P012640,0 days 00:02:19,3,4,1
16,PRS,P005793,P013373,0 days 00:02:16,-1,3,4
16,PRS,P007032,P013373,0 days 00:02:16,-1,3,4
16,PRS,P012609,P013373,0 days 00:02:16,-1,3,4
16,PRS,P012640,P013373,0 days 00:02:16,-1,3,4
16,PRS,P005793,P012608,0 days 00:01:41,0,6,6
16,PRS,P005793,P012610,0 days 00:01:41,0,6,6
16,PRS,P005793,P012613,0 days 00:01:41,0,6,6
16,PRS,P012610,P012640,0 days 00:01:29,-1,0,1
17,BAR,P009862,P012745,0 days 00:20:57,5,40,35
17,BAR,P000925,P012745,0 days 00:18:31,4,33,29
17,BAR,P000925,P009862,0 days 00:18:12,6,33,27
17,BAR,P003196,P009992,0 days 00:14:18,12,40,28
17,BAR,P006435,P012795,0 days 00:13:17,5,27,22
17,BAR,P003196,P013379,0 days 00:13:03,15,38,23
17,BAR,P002939,P013379,0 days 00:13:01,8,34,26
17,BAR,P009992,P013379,0 days 00:12:31,12,36,24
17,BAR,P003478,P012745,0 days 00:11:08,-1,21,22
17,BAR,P006435,P012745,0 days 00:10:11,6,21,15
17,BAR,P003478,P013379,0 days 00:10:10,13,28,15
17,BAR,P012745,P012795,0 days 00:10:02,1,16,15
17,BAR,P003478,P009992,0 days 00:09:51,12,25,13
17,BAR,P003478,P009862,0 days 00:09:49,3,21,18
17,BAR,P002939,P012795,0 days 00:09:48,-6,19,25
17,BAR,P009862,P012795,0 days 00:09:48,1,15,14
17,BAR,P006435,P009862,0 days 00:09:32,3,18,15
17,BAR,P000925,P012795,0 days 00:09:23,-2,13,15
17,BAR,P003196,P003478,0 days 00:09:12,14,25,11
17,BAR,P002939,P003478,0 days 00:09:04,10,23,13
17,BAR,P000925,P003478,0 days 00:08:50,4,18,14
17,BAR,P002939,P003196,0 days 00:08:39,12,27,15
17,BAR,P000925,P006435,0 days 00:08:33,4,15,11
17,BAR,P006435,P013379,0 days 00:08:16,-3,17,20
17,BAR,P012795,P013379,0 days 00:08:14,-3,20,23
17,BAR,P002939,P009992,0 days 00:08:07,9,25,16
17,BAR,P010106,P012745,0 days 00:07:31,3,17,14
17,BAR,P009862,P010106,0 days 00:06:32,7,17,10
17,BAR,P002939,P012745,0 days 00:06:30,-6,8,14
17,BAR,P003478,P010106,0 days 00:06:25,6,15,9
17,BAR,P002939,P009862,0 days 00:05:37,-4,7,11
17,BAR,P000925,P002939,0 days 00:05:12,-7,5,12
17,BAR,P000925,P010106,0 days 00:05:05,5,13,8
17,BAR,P002939,P006435,0 days 00:04:49,1,10,9
17,BAR,P003196,P012795,0 days 00:04:31,-1,13,14
17,BAR,P002939,P006568,0 days 00:04:22,1,10,9
17,BAR,P006435,P006568,0 days 00:04:22,1,10,9
17,BAR,P006568,P012795,0 days 00:04:22,1,10,9
17,BAR,P003478,P006435,0 days 00:04:11,-1,8,9
17,BAR,P009992,P010106,0 days 00:04:01,3,10,7
17,BAR,P006568,P013379,0 days 00:03:43,-2,7,9
17,BAR,P003196,P010106,0 days 00:03:43,1,8,7
17,BAR,P003196,P006435,0 days 00:03:34,0,7,7
17,BAR,P009992,P012745,0 days 00:03:23,-2,6,8
17,BAR,P009992,P012795,0 days 00:03:20,-2,11,13
17,BAR,P006435,P009992,0 days 00:03:07,0,7,7
17,BAR,P003196,P009862,0 days 00:02:30,1,6,5
17,BAR,P003196,P012745,0 days 00:02:26,-2,4,6
17,BAR,P009862,P009992,0 days 00:02:04,2,6,4
17,BAR,P009862,P013379,0 days 00:01:43,0,5,5
17,BAR,P012745,P013379,0 days 00:01:38,-3,3,6
17,BAR,P010106,P013379,0 days 00:01:17,3,4,1
17,BAR,P006568,P012745,0 days 00:00:39,3,3,0
17,BAR,P002939,P010106,0 days 00:00:19,-2,0,2
17,BAR,P010106,P012795,0 days 00:00:19,-2,0,2
17,BAR,P000925,P009992,0 days 00:00:18,2,2,0
17,BER,P008173,P008780,0 days 00:23:27,-4,39,43
17,BER,P006919,P008780,0 days 00:21:20,-6,40,46
17,BER,P006919,P008173,0 days 00:21:06,-8,34,42
17,BER,P008780,P010791,0 days 00:16:52,5,36,31
17,BER,P008173,P011934,0 days 00:16:36,-6,23,29
17,BER,P008780,P011934,0 days 00:14:54,-6,22,28
17,BER,P006919,P011934,0 days 00:14:22,-8,21,29
17,BER,P006919,P012604,0 days 00:13:50,-9,24,33
17,BER,P006919,P010791,0 days 00:13:46,0,27,27
17,BER,P008173,P012604,0 days 00:13:42,-3,23,26
17,BER,P008173,P010791,0 days 00:13:39,0,24,24
17,BER,P008780,P012604,0 days 00:13:08,-5,25,30
17,BER,P011934,P012604,0 days 00:11:05,-8,18,26
17,BER,P008062,P010791,0 days 00:11:04,3,28,25
17,BER,P010791,P012721,0 days 00:10:57,3,25,22
17,BER,P008062,P012721,0 days 00:10:46,-9,20,29
17,BER,P008384,P012721,0 days 00:10:43,-12,19,31
17,BER,P008062,P008384,0 days 00:10:06,-12,17,29
17,BER,P010791,P011631,0 days 00:09:06,-2,19,21
17,BER,P010791,P012604,0 days 00:08:46,1,20,19
17,BER,P008384,P010791,0 days 00:07:51,-2,16,18
17,BER,P008780,P011631,0 days 00:06:47,0,13,13
17,BER,P008062,P012604,0 days 00:06:09,-4,15,19
17,BER,P008173,P011631,0 days 00:06:07,-3,10,13
17,BER,P008780,P012721,0 days 00:06:06,5,13,8
17,BER,P012604,P012721,0 days 00:06:01,2,14,12
17,BER,P011631,P012721,0 days 00:05:33,1,9,8
17,BER,P011934,P012721,0 days 00:05:15,-10,5,15
17,BER,P006919,P011631,0 days 00:04:50,-3,10,13
17,BER,P008173,P012721,0 days 00:04:49,2,8,6
17,BER,P006251,P012721,0 days 00:04:38,-10,7,17
17,BER,P010791,P011934,0 days 00:04:20,0,5,5
17,BER,P008062,P011631,0 days 00:04:16,1,9,8
17,BER,P008384,P012604,0 days 00:04:15,0,10,10
17,BER,P008384,P011631,0 days 00:03:36,-2,6,8
17,BER,P008062,P008780,0 days 00:03:22,3,12,9
17,BER,P006251,P008780,0 days 00:03:11,4,10,6
17,BER,P006251,P008062,0 days 00:03:03,-6,5,11
17,BER,P006251,P011934,0 days 00:02:55,-10,3,13
17,BER,P006251,P008384,0 days 00:02:52,-10,3,13
17,BER,P008384,P011934,0 days 00:02:52,-10,3,13
17,BER,P006919,P008062,0 days 00:02:42,0,9,9
17,BER,P006251,P010791,0 days 00:02:31,4,8,4
17,BER,P007025,P011934,0 days 00:02:28,-2,3,5
17,BER,P007025,P012604,0 days 00:02:28,-2,3,5
17,BER,P007025,P008173,0 days 00:02:28,-2,3,5
17,BER,P006919,P007025,0 days 00:02:28,-2,3,5
17,BER,P008062,P011934,0 days 00:02:24,-12,1,13
17,BER,P006251,P008173,0 days 00:01:46,0,4,4
17,BER,P011631,P011934,0 days 00:01:17,0,0,0
17,BER,P006251,P006919,0 days 00:00:48,4,4,0
17,BER,P008384,P008780,0 days 00:00:37,0,2,2
18,OLY,P003469,P013380,0 days 00:22:35,5,43,38
18,OLY,P003469,P012878,0 days 00:17:37,2,28,26
18,OLY,P012878,P013380,0 days 00:17:17,12,32,20
18,OLY,P003469,P008855,0 days 00:17:10,-3,30,33
18,OLY,P008855,P013380,0 days 00:16:16,3,33,30
18,OLY,P007947,P013380,0 days 00:15:56,16,34,18
18,OLY,P003469,P007947,0 days 00:14:55,10,30,20
18,OLY,P007947,P012878,0 days 00:14:22,17,28,11
18,OLY,P008855,P012878,0 days 00:14:16,-1,22,23
18,OLY,P001255,P008829,0 days 00:14:14,7,29,22
18,OLY,P007947,P008855,0 days 00:12:43,4,20,16
18,OLY,P001255,P009849,0 days 00:12:15,-5,19,24
18,OLY,P008829,P009849,0 days 00:10:12,3,19,16
18,OLY,P007982,P008829,0 days 00:08:39,10,19,9
18,OLY,P007947,P008829,0 days 00:08:38,6,16,10
18,OLY,P001255,P011194,0 days 00:08:37,-5,14,19
18,OLY,P007982,P009849,0 days 00:08:18,-1,13,14
18,OLY,P001255,P007947,0 days 00:07:37,0,12,12
18,OLY,P001255,P008855,0 days 00:07:26,-9,15,24
18,OLY,P007982,P012878,0 days 00:07:25,14,19,5
18,OLY,P007982,P013380,0 days 00:07:17,5,13,8
18,OLY,P001255,P007982,0 days 00:07:17,6,15,9
18,OLY,P008829,P011194,0 days 00:07:02,-2,11,13
18,OLY,P007982,P011194,0 days 00:06:30,-1,9,10
18,OLY,P008811,P009849,0 days 00:06:28,-3,11,14
18,OLY,P003469,P009849,0 days 00:06:11,-11,7,18
18,OLY,P003469,P007982,0 days 00:05:55,1,9,8
18,OLY,P009849,P011194,0 days 00:05:52,-3,7,10
18,OLY,P001255,P012878,0 days 00:05:52,0,14,14
18,OLY,P007947,P008811,0 days 00:05:49,-1,11,12
18,OLY,P007947,P009849,0 days 00:05:49,-1,11,12
18,OLY,P011194,P013380,0 days 00:05:23,-4,12,16
18,OLY,P001255,P003469,0 days 00:05:20,-10,10,20
18,OLY,P008855,P011194,0 days 00:05:07,-5,11,16
18,OLY,P007947,P007982,0 days 00:05:01,13,15,2
18,OLY,P001255,P008811,0 days 00:04:37,-2,7,9
18,OLY,P003469,P011194,0 days 00:04:35,-4,9,13
18,OLY,P008811,P008829,0 days 00:04:16,0,7,7
18,OLY,P009849,P013380,0 days 00:04:08,-3,7,10
18,OLY,P001255,P013380,0 days 00:04:05,-2,13,15
18,OLY,P008829,P012878,0 days 00:04:04,11,13,2
18,OLY,P009849,P012878,0 days 00:04:03,-2,8,10
18,OLY,P007947,P011194,0 days 00:03:22,0,7,7
18,OLY,P008829,P008855,0 days 00:02:41,1,7,6
18,OLY,P008829,P013380,0 days 00:02:24,6,9,3
18,OLY,P008855,P009849,0 days 00:02:16,-6,2,8
18,OLY,P003469,P008811,0 days 00:02:12,-3,4,7
18,OLY,P008811,P013380,0 days 00:01:51,-1,4,5
18,OLY,P003469,P007853,0 days 00:01:48,-1,0,1
18,OLY,P007853,P012878,0 days 00:01:48,-1,0,1
18,OLY,P007853,P013380,0 days 00:01:48,-1,0,1
18,OLY,P007853,P007982,0 days 00:01:15,-1,0,1
18,OLY,P007982,P008811,0 days 00:00:39,-2,0,2
18,OLY,P007853,P008855,0 days 00:00:33,0,0,0
18,OLY,P003469,P008829,0 days 00:00:14,2,2,0
18,ZAL,P003048,P007975,0 days 00:17:38,-3,30,33
18,ZAL,P007513,P007975,0 days 00:16:03,5,37,32
18,ZAL,P002329,P003048,0 days 00:15:21,-12,15,27
18,ZAL,P002329,P007975,0 days 00:14:57,-11,19,30
18,ZAL,P007029,P007975,0 days 00:14:56,-5,35,40
18,ZAL,P002676,P007513,0 days 00:14:39,9,37,28
18,ZAL,P003048,P007513,0 days 00:14:30,8,26,18
18,ZAL,P007029,P007513,0 days 00:13:46,1,34,33
18,ZAL,P002329,P007513,0 days 00:13:40,-7,12,19
18,ZAL,P002676,P007029,0 days 00:12:52,14,40,26
18,ZAL,P003048,P007029,0 days 00:12:29,-4,22,26
18,ZAL,P007513,P011983,0 days 00:12:25,-5,10,15
18,ZAL,P002329,P007029,0 days 00:12:07,-17,13,30
18,ZAL,P002676,P011983,0 days 00:10:27,3,17,14
18,ZAL,P002676,P005504,0 days 00:09:13,-2,15,17
18,ZAL,P007029,P011051,0 days 00:08:57,1,21,20
18,ZAL,P002676,P007975,0 days 00:07:59,8,27,19
18,ZAL,P002329,P011051,0 days 00:07:29,-4,11,15
18,ZAL,P003210,P011983,0 days 00:07:16,6,14,8
18,ZAL,P007513,P011051,0 days 00:07:16,-4,12,16
18,ZAL,P003210,P007029,0 days 00:07:12,1,15,14
18,ZAL,P002329,P011983,0 days 00:07:06,-4,5,9
18,ZAL,P007975,P012622,0 days 00:06:47,-8,7,15
18,ZAL,P007029,P011983,0 days 00:06:44,0,12,12
18,ZAL,P005504,P011983,0 days 00:06:37,-5,4,9
18,ZAL,P003048,P012622,0 days 00:06:33,-6,7,13
18,ZAL,P002329,P012622,0 days 00:06:33,-6,7,13
18,ZAL,P005504,P007513,0 days 00:06:33,-2,11,13
18,ZAL,P002676,P003210,0 days 00:06:29,8,18,10
18,ZAL,P005504,P007029,0 days 00:05:56,-1,15,16
18,ZAL,P002676,P003048,0 days 00:05:55,8,18,10
18,ZAL,P003210,P007513,0 days 00:05:48,-1,9,10
18,ZAL,P011051,P011983,0 days 00:05:40,6,12,6
18,ZAL,P007513,P011925,0 days 00:05:20,-2,3,5
18,ZAL,P003048,P011983,0 days 00:05:16,-2,6,8
18,ZAL,P007975,P011983,0 days 00:05:04,0,8,8
18,ZAL,P003210,P011051,0 days 00:04:59,9,15,6
18,ZAL,P007975,P011051,0 days 00:04:45,-2,10,12
18,ZAL,P002676,P011925,0 days 00:04:31,-3,2,5
18,ZAL,P007513,P012622,0 days 00:04:12,-2,5,7
18,ZAL,P002676,P011051,0 days 00:03:51,7,14,7
18,ZAL,P011925,P011983,0 days 00:03:37,-3,0,3
18,ZAL,P005504,P011925,0 days 00:03:37,-3,0,3
18,ZAL,P002329,P003210,0 days 00:03:25,-3,1,4
18,ZAL,P003048,P011925,0 days 00:03:04,-2,3,5
18,ZAL,P007029,P011925,0 days 00:03:04,-2,3,5
18,ZAL,P003210,P005504,0 days 00:03:00,-2,4,6
18,ZAL,P005504,P007975,0 days 00:02:56,1,11,10
18,ZAL,P007029,P012622,0 days 00:02:49,-8,2,10
18,ZAL,P003048,P011051,0 days 00:02:23,-1,5,6
18,ZAL,P002329,P011925,0 days 00:02:10,-2,1,3
18,ZAL,P003048,P003210,0 days 00:01:55,-2,0,2
18,ZAL,P007975,P011925,0 days 00:01:21,-3,0,3
18,ZAL,P002329,P005504,0 days 00:00:20,-2,0,2
18,ZAL,P003210,P007975,0 days 00:00:14,-2,0,2
18,ZAL,P003210,P012622,0 days 00:00:14,-2,0,2
